HIT_ID,Sentence,Start_Offset,End_Offset,Complex_Phrase,Native_Annotators,Non_Native_Annotators,Total_Annotators
x,The original version of `` Costumbres '' was recorded for Selena 's hit album Dulce Amor in 1988 and was later included on Siempre Selena in a remix version .,13,20,version,0,1,1
39AYGO6AFFL0SLUU2DVOTFL68NON6L,The original version of `` Costumbres '' was recorded for Selena 's hit album Dulce Amor in 1988 and was later included on Siempre Selena in a remix version .,27,37,Costumbres,3,4,7
39AYGO6AFFL0SLUU2DVOTFL68NON6L,The original version of `` Costumbres '' was recorded for Selena 's hit album Dulce Amor in 1988 and was later included on Siempre Selena in a remix version .,45,53,recorded,0,2,2
39AYGO6AFFL0SLUU2DVOTFL68NON6L,The original version of `` Costumbres '' was recorded for Selena 's hit album Dulce Amor in 1988 and was later included on Siempre Selena in a remix version .,68,77,hit album,0,1,1
39AYGO6AFFL0SLUU2DVOTFL68NON6L,The original version of `` Costumbres '' was recorded for Selena 's hit album Dulce Amor in 1988 and was later included on Siempre Selena in a remix version .,78,83,Dulce,1,0,1
39AYGO6AFFL0SLUU2DVOTFL68NON6L,The original version of `` Costumbres '' was recorded for Selena 's hit album Dulce Amor in 1988 and was later included on Siempre Selena in a remix version .,123,130,Siempre,1,2,3
39AYGO6AFFL0SLUU2DVOTFL68NON6L,The original version of `` Costumbres '' was recorded for Selena 's hit album Dulce Amor in 1988 and was later included on Siempre Selena in a remix version .,143,148,remix,3,6,9
39AYGO6AFFL0SLUU2DVOTFL68NON6L,The original version of `` Costumbres '' was recorded for Selena 's hit album Dulce Amor in 1988 and was later included on Siempre Selena in a remix version .,143,156,remix version,0,3,3
39AYGO6AFFL0SLUU2DVOTFL68NON6L,"The ` small casinos ' will have a minimum customer area of 750 sq metres , up to 80 slot machines and a jackpot of # 4000 .",6,19,small casinos,0,1,1
39AYGO6AFFL0SLUU2DVOTFL68NON6L,"The ` small casinos ' will have a minimum customer area of 750 sq metres , up to 80 slot machines and a jackpot of # 4000 .",12,19,casinos,2,1,3
39AYGO6AFFL0SLUU2DVOTFL68NON6L,"The ` small casinos ' will have a minimum customer area of 750 sq metres , up to 80 slot machines and a jackpot of # 4000 .",34,41,minimum,4,0,4
39AYGO6AFFL0SLUU2DVOTFL68NON6L,"The ` small casinos ' will have a minimum customer area of 750 sq metres , up to 80 slot machines and a jackpot of # 4000 .",42,50,customer,0,1,1
39AYGO6AFFL0SLUU2DVOTFL68NON6L,"The ` small casinos ' will have a minimum customer area of 750 sq metres , up to 80 slot machines and a jackpot of # 4000 .",63,65,sq,0,1,1
39AYGO6AFFL0SLUU2DVOTFL68NON6L,"The ` small casinos ' will have a minimum customer area of 750 sq metres , up to 80 slot machines and a jackpot of # 4000 .",84,88,slot,0,1,1
39AYGO6AFFL0SLUU2DVOTFL68NON6L,"The ` small casinos ' will have a minimum customer area of 750 sq metres , up to 80 slot machines and a jackpot of # 4000 .",84,97,slot machines,3,2,5
39AYGO6AFFL0SLUU2DVOTFL68NON6L,"The ` small casinos ' will have a minimum customer area of 750 sq metres , up to 80 slot machines and a jackpot of # 4000 .",104,111,jackpot,2,8,10
39AYGO6AFFL0SLUU2DVOTFL68NON6L,Definitions have been determined such that the ` super casino ' will have a minimum customer area of 5000 square metres and at most 1250 unlimited-jackpot slot machines .,0,11,Definitions,1,1,2
39AYGO6AFFL0SLUU2DVOTFL68NON6L,Definitions have been determined such that the ` super casino ' will have a minimum customer area of 5000 square metres and at most 1250 unlimited-jackpot slot machines .,22,32,determined,5,1,6
39AYGO6AFFL0SLUU2DVOTFL68NON6L,Definitions have been determined such that the ` super casino ' will have a minimum customer area of 5000 square metres and at most 1250 unlimited-jackpot slot machines .,49,61,super casino,0,1,1
39AYGO6AFFL0SLUU2DVOTFL68NON6L,Definitions have been determined such that the ` super casino ' will have a minimum customer area of 5000 square metres and at most 1250 unlimited-jackpot slot machines .,76,83,minimum,1,0,1
39AYGO6AFFL0SLUU2DVOTFL68NON6L,Definitions have been determined such that the ` super casino ' will have a minimum customer area of 5000 square metres and at most 1250 unlimited-jackpot slot machines .,137,154,unlimited-jackpot,7,3,10
39AYGO6AFFL0SLUU2DVOTFL68NON6L,"Under the terms of the Gambling Act the Secretary of State is able to define each type of casino , with reference to any matter he or she chooses ; although the act specifically mentions as facts to consider the number , location and concentration of gaming tables , and the floor area designated for a specific purpose .",23,31,Gambling,0,6,6
39AYGO6AFFL0SLUU2DVOTFL68NON6L,"Under the terms of the Gambling Act the Secretary of State is able to define each type of casino , with reference to any matter he or she chooses ; although the act specifically mentions as facts to consider the number , location and concentration of gaming tables , and the floor area designated for a specific purpose .",23,35,Gambling Act,1,0,1
39AYGO6AFFL0SLUU2DVOTFL68NON6L,"Under the terms of the Gambling Act the Secretary of State is able to define each type of casino , with reference to any matter he or she chooses ; although the act specifically mentions as facts to consider the number , location and concentration of gaming tables , and the floor area designated for a specific purpose .",40,49,Secretary,1,0,1
39AYGO6AFFL0SLUU2DVOTFL68NON6L,"Under the terms of the Gambling Act the Secretary of State is able to define each type of casino , with reference to any matter he or she chooses ; although the act specifically mentions as facts to consider the number , location and concentration of gaming tables , and the floor area designated for a specific purpose .",90,96,casino,0,1,1
39AYGO6AFFL0SLUU2DVOTFL68NON6L,"Under the terms of the Gambling Act the Secretary of State is able to define each type of casino , with reference to any matter he or she chooses ; although the act specifically mentions as facts to consider the number , location and concentration of gaming tables , and the floor area designated for a specific purpose .",104,113,reference,2,1,3
39AYGO6AFFL0SLUU2DVOTFL68NON6L,"Under the terms of the Gambling Act the Secretary of State is able to define each type of casino , with reference to any matter he or she chooses ; although the act specifically mentions as facts to consider the number , location and concentration of gaming tables , and the floor area designated for a specific purpose .",104,116,reference to,1,0,1
39AYGO6AFFL0SLUU2DVOTFL68NON6L,"Under the terms of the Gambling Act the Secretary of State is able to define each type of casino , with reference to any matter he or she chooses ; although the act specifically mentions as facts to consider the number , location and concentration of gaming tables , and the floor area designated for a specific purpose .",138,145,chooses,0,1,1
39AYGO6AFFL0SLUU2DVOTFL68NON6L,"Under the terms of the Gambling Act the Secretary of State is able to define each type of casino , with reference to any matter he or she chooses ; although the act specifically mentions as facts to consider the number , location and concentration of gaming tables , and the floor area designated for a specific purpose .",165,177,specifically,3,2,5
39AYGO6AFFL0SLUU2DVOTFL68NON6L,"Under the terms of the Gambling Act the Secretary of State is able to define each type of casino , with reference to any matter he or she chooses ; although the act specifically mentions as facts to consider the number , location and concentration of gaming tables , and the floor area designated for a specific purpose .",165,186,specifically mentions,0,1,1
39AYGO6AFFL0SLUU2DVOTFL68NON6L,"Under the terms of the Gambling Act the Secretary of State is able to define each type of casino , with reference to any matter he or she chooses ; although the act specifically mentions as facts to consider the number , location and concentration of gaming tables , and the floor area designated for a specific purpose .",178,186,mentions,1,1,2
39AYGO6AFFL0SLUU2DVOTFL68NON6L,"Under the terms of the Gambling Act the Secretary of State is able to define each type of casino , with reference to any matter he or she chooses ; although the act specifically mentions as facts to consider the number , location and concentration of gaming tables , and the floor area designated for a specific purpose .",234,247,concentration,9,5,14
39AYGO6AFFL0SLUU2DVOTFL68NON6L,"Under the terms of the Gambling Act the Secretary of State is able to define each type of casino , with reference to any matter he or she chooses ; although the act specifically mentions as facts to consider the number , location and concentration of gaming tables , and the floor area designated for a specific purpose .",251,257,gaming,1,0,1
39AYGO6AFFL0SLUU2DVOTFL68NON6L,"Under the terms of the Gambling Act the Secretary of State is able to define each type of casino , with reference to any matter he or she chooses ; although the act specifically mentions as facts to consider the number , location and concentration of gaming tables , and the floor area designated for a specific purpose .",251,264,gaming tables,1,1,2
39AYGO6AFFL0SLUU2DVOTFL68NON6L,"Under the terms of the Gambling Act the Secretary of State is able to define each type of casino , with reference to any matter he or she chooses ; although the act specifically mentions as facts to consider the number , location and concentration of gaming tables , and the floor area designated for a specific purpose .",286,296,designated,10,9,19
39AYGO6AFFL0SLUU2DVOTFL68NON6L,"Under the terms of the Gambling Act the Secretary of State is able to define each type of casino , with reference to any matter he or she chooses ; although the act specifically mentions as facts to consider the number , location and concentration of gaming tables , and the floor area designated for a specific purpose .",312,319,purpose,1,2,3
33P2GD6NRNTFH4T81JUCYETSN6ZKHE,"The distance , chemical composition , and age of Teide 1 could be established because of its membership in the young Pleiades star cluster .",15,23,chemical,4,1,5
33P2GD6NRNTFH4T81JUCYETSN6ZKHE,"The distance , chemical composition , and age of Teide 1 could be established because of its membership in the young Pleiades star cluster .",15,35,chemical composition,3,4,7
33P2GD6NRNTFH4T81JUCYETSN6ZKHE,"The distance , chemical composition , and age of Teide 1 could be established because of its membership in the young Pleiades star cluster .",24,35,composition,5,3,8
33P2GD6NRNTFH4T81JUCYETSN6ZKHE,"The distance , chemical composition , and age of Teide 1 could be established because of its membership in the young Pleiades star cluster .",49,54,Teide,1,1,2
33P2GD6NRNTFH4T81JUCYETSN6ZKHE,"The distance , chemical composition , and age of Teide 1 could be established because of its membership in the young Pleiades star cluster .",66,77,established,5,3,8
33P2GD6NRNTFH4T81JUCYETSN6ZKHE,"The distance , chemical composition , and age of Teide 1 could be established because of its membership in the young Pleiades star cluster .",93,103,membership,1,1,2
33P2GD6NRNTFH4T81JUCYETSN6ZKHE,"The distance , chemical composition , and age of Teide 1 could be established because of its membership in the young Pleiades star cluster .",111,138,young Pleiades star cluster,1,0,1
33P2GD6NRNTFH4T81JUCYETSN6ZKHE,"The distance , chemical composition , and age of Teide 1 could be established because of its membership in the young Pleiades star cluster .",117,125,Pleiades,3,2,5
33P2GD6NRNTFH4T81JUCYETSN6ZKHE,"The distance , chemical composition , and age of Teide 1 could be established because of its membership in the young Pleiades star cluster .",117,138,Pleiades star cluster,0,1,1
33P2GD6NRNTFH4T81JUCYETSN6ZKHE,"The distance , chemical composition , and age of Teide 1 could be established because of its membership in the young Pleiades star cluster .",126,138,star cluster,1,1,2
33P2GD6NRNTFH4T81JUCYETSN6ZKHE,"The distance , chemical composition , and age of Teide 1 could be established because of its membership in the young Pleiades star cluster .",131,138,cluster,3,9,12
33P2GD6NRNTFH4T81JUCYETSN6ZKHE,"For some time , Teide 1 was the smallest known object outside the Solar System that had been identified by direct observation .",16,21,Teide,2,0,2
33P2GD6NRNTFH4T81JUCYETSN6ZKHE,"For some time , Teide 1 was the smallest known object outside the Solar System that had been identified by direct observation .",66,71,Solar,1,0,1
33P2GD6NRNTFH4T81JUCYETSN6ZKHE,"For some time , Teide 1 was the smallest known object outside the Solar System that had been identified by direct observation .",66,78,Solar System,1,1,2
33P2GD6NRNTFH4T81JUCYETSN6ZKHE,"For some time , Teide 1 was the smallest known object outside the Solar System that had been identified by direct observation .",93,103,identified,1,1,2
33P2GD6NRNTFH4T81JUCYETSN6ZKHE,"For some time , Teide 1 was the smallest known object outside the Solar System that had been identified by direct observation .",107,125,direct observation,1,1,2
33P2GD6NRNTFH4T81JUCYETSN6ZKHE,"For some time , Teide 1 was the smallest known object outside the Solar System that had been identified by direct observation .",114,125,observation,5,4,9
33P2GD6NRNTFH4T81JUCYETSN6ZKHE,"Brown dwarfs heavier than about 13 MJ are thought to fuse deuterium and those above ~ 65 MJ , fuse lithium as well .",0,5,Brown,0,1,1
33P2GD6NRNTFH4T81JUCYETSN6ZKHE,"Brown dwarfs heavier than about 13 MJ are thought to fuse deuterium and those above ~ 65 MJ , fuse lithium as well .",0,12,Brown dwarfs,2,2,4
33P2GD6NRNTFH4T81JUCYETSN6ZKHE,"Brown dwarfs heavier than about 13 MJ are thought to fuse deuterium and those above ~ 65 MJ , fuse lithium as well .",6,12,dwarfs,4,9,13
33P2GD6NRNTFH4T81JUCYETSN6ZKHE,"Brown dwarfs heavier than about 13 MJ are thought to fuse deuterium and those above ~ 65 MJ , fuse lithium as well .",35,37,MJ,1,0,1
33P2GD6NRNTFH4T81JUCYETSN6ZKHE,"Brown dwarfs heavier than about 13 MJ are thought to fuse deuterium and those above ~ 65 MJ , fuse lithium as well .",53,57,fuse,4,5,9
33P2GD6NRNTFH4T81JUCYETSN6ZKHE,"Brown dwarfs heavier than about 13 MJ are thought to fuse deuterium and those above ~ 65 MJ , fuse lithium as well .",53,67,fuse deuterium,0,1,1
33P2GD6NRNTFH4T81JUCYETSN6ZKHE,"Brown dwarfs heavier than about 13 MJ are thought to fuse deuterium and those above ~ 65 MJ , fuse lithium as well .",58,67,deuterium,10,7,17
33P2GD6NRNTFH4T81JUCYETSN6ZKHE,"Brown dwarfs heavier than about 13 MJ are thought to fuse deuterium and those above ~ 65 MJ , fuse lithium as well .",89,91,MJ,1,0,1
33P2GD6NRNTFH4T81JUCYETSN6ZKHE,"Brown dwarfs heavier than about 13 MJ are thought to fuse deuterium and those above ~ 65 MJ , fuse lithium as well .",94,98,fuse,2,1,3
33P2GD6NRNTFH4T81JUCYETSN6ZKHE,"Brown dwarfs heavier than about 13 MJ are thought to fuse deuterium and those above ~ 65 MJ , fuse lithium as well .",99,106,lithium,7,1,8
33P2GD6NRNTFH4T81JUCYETSN6ZKHE,"Since then , over 1,800 brown dwarfs have been identified , even some very close to Earth like Epsilon Indi Ba and Bb , a pair of brown dwarfs gravitationally bound to a sunlike star around 12 light-years from the Sun , and Luhman 16 , a binary system of brown dwarfs about 6.5 light-years away .",30,36,dwarfs,1,1,2
33P2GD6NRNTFH4T81JUCYETSN6ZKHE,"Since then , over 1,800 brown dwarfs have been identified , even some very close to Earth like Epsilon Indi Ba and Bb , a pair of brown dwarfs gravitationally bound to a sunlike star around 12 light-years from the Sun , and Luhman 16 , a binary system of brown dwarfs about 6.5 light-years away .",47,57,identified,0,1,1
33P2GD6NRNTFH4T81JUCYETSN6ZKHE,"Since then , over 1,800 brown dwarfs have been identified , even some very close to Earth like Epsilon Indi Ba and Bb , a pair of brown dwarfs gravitationally bound to a sunlike star around 12 light-years from the Sun , and Luhman 16 , a binary system of brown dwarfs about 6.5 light-years away .",95,110,Epsilon Indi Ba,1,0,1
33P2GD6NRNTFH4T81JUCYETSN6ZKHE,"Since then , over 1,800 brown dwarfs have been identified , even some very close to Earth like Epsilon Indi Ba and Bb , a pair of brown dwarfs gravitationally bound to a sunlike star around 12 light-years from the Sun , and Luhman 16 , a binary system of brown dwarfs about 6.5 light-years away .",130,142,brown dwarfs,0,1,1
33P2GD6NRNTFH4T81JUCYETSN6ZKHE,"Since then , over 1,800 brown dwarfs have been identified , even some very close to Earth like Epsilon Indi Ba and Bb , a pair of brown dwarfs gravitationally bound to a sunlike star around 12 light-years from the Sun , and Luhman 16 , a binary system of brown dwarfs about 6.5 light-years away .",143,158,gravitationally,10,8,18
33P2GD6NRNTFH4T81JUCYETSN6ZKHE,"Since then , over 1,800 brown dwarfs have been identified , even some very close to Earth like Epsilon Indi Ba and Bb , a pair of brown dwarfs gravitationally bound to a sunlike star around 12 light-years from the Sun , and Luhman 16 , a binary system of brown dwarfs about 6.5 light-years away .",143,164,gravitationally bound,0,2,2
33P2GD6NRNTFH4T81JUCYETSN6ZKHE,"Since then , over 1,800 brown dwarfs have been identified , even some very close to Earth like Epsilon Indi Ba and Bb , a pair of brown dwarfs gravitationally bound to a sunlike star around 12 light-years from the Sun , and Luhman 16 , a binary system of brown dwarfs about 6.5 light-years away .",159,164,bound,1,2,3
33P2GD6NRNTFH4T81JUCYETSN6ZKHE,"Since then , over 1,800 brown dwarfs have been identified , even some very close to Earth like Epsilon Indi Ba and Bb , a pair of brown dwarfs gravitationally bound to a sunlike star around 12 light-years from the Sun , and Luhman 16 , a binary system of brown dwarfs about 6.5 light-years away .",170,177,sunlike,1,3,4
33P2GD6NRNTFH4T81JUCYETSN6ZKHE,"Since then , over 1,800 brown dwarfs have been identified , even some very close to Earth like Epsilon Indi Ba and Bb , a pair of brown dwarfs gravitationally bound to a sunlike star around 12 light-years from the Sun , and Luhman 16 , a binary system of brown dwarfs about 6.5 light-years away .",193,204,light-years,1,0,1
33P2GD6NRNTFH4T81JUCYETSN6ZKHE,"Since then , over 1,800 brown dwarfs have been identified , even some very close to Earth like Epsilon Indi Ba and Bb , a pair of brown dwarfs gravitationally bound to a sunlike star around 12 light-years from the Sun , and Luhman 16 , a binary system of brown dwarfs about 6.5 light-years away .",224,230,Luhman,1,0,1
33P2GD6NRNTFH4T81JUCYETSN6ZKHE,"Since then , over 1,800 brown dwarfs have been identified , even some very close to Earth like Epsilon Indi Ba and Bb , a pair of brown dwarfs gravitationally bound to a sunlike star around 12 light-years from the Sun , and Luhman 16 , a binary system of brown dwarfs about 6.5 light-years away .",238,244,binary,6,7,13
33P2GD6NRNTFH4T81JUCYETSN6ZKHE,"Since then , over 1,800 brown dwarfs have been identified , even some very close to Earth like Epsilon Indi Ba and Bb , a pair of brown dwarfs gravitationally bound to a sunlike star around 12 light-years from the Sun , and Luhman 16 , a binary system of brown dwarfs about 6.5 light-years away .",238,251,binary system,1,1,2
33P2GD6NRNTFH4T81JUCYETSN6ZKHE,"Since then , over 1,800 brown dwarfs have been identified , even some very close to Earth like Epsilon Indi Ba and Bb , a pair of brown dwarfs gravitationally bound to a sunlike star around 12 light-years from the Sun , and Luhman 16 , a binary system of brown dwarfs about 6.5 light-years away .",255,267,brown dwarfs,0,1,1
33P2GD6NRNTFH4T81JUCYETSN6ZKHE,"Since then , over 1,800 brown dwarfs have been identified , even some very close to Earth like Epsilon Indi Ba and Bb , a pair of brown dwarfs gravitationally bound to a sunlike star around 12 light-years from the Sun , and Luhman 16 , a binary system of brown dwarfs about 6.5 light-years away .",261,267,dwarfs,0,1,1
33P2GD6NRNTFH4T81JUCYETSN6ZKHE,"Since then , over 1,800 brown dwarfs have been identified , even some very close to Earth like Epsilon Indi Ba and Bb , a pair of brown dwarfs gravitationally bound to a sunlike star around 12 light-years from the Sun , and Luhman 16 , a binary system of brown dwarfs about 6.5 light-years away .",278,289,light-years,1,2,3
32PT7WK7DMGS9QGZUHJNQ7XSKSKD3N,The tusks weigh from 23-45 kg ( 51-99 lb ) and can be from 1.5-2 .4 m ( 5-8 ft ) long .,4,9,tusks,5,7,12
32PT7WK7DMGS9QGZUHJNQ7XSKSKD3N,The tusks weigh from 23-45 kg ( 51-99 lb ) and can be from 1.5-2 .4 m ( 5-8 ft ) long .,10,15,weigh,1,1,2
32PT7WK7DMGS9QGZUHJNQ7XSKSKD3N,"The genus Agathis , commonly known as kauri or dammar , is a relatively small genus of 21 species of evergreen tree .",4,9,genus,5,4,9
32PT7WK7DMGS9QGZUHJNQ7XSKSKD3N,"The genus Agathis , commonly known as kauri or dammar , is a relatively small genus of 21 species of evergreen tree .",4,17,genus Agathis,3,0,3
32PT7WK7DMGS9QGZUHJNQ7XSKSKD3N,"The genus Agathis , commonly known as kauri or dammar , is a relatively small genus of 21 species of evergreen tree .",10,17,Agathis,2,0,2
32PT7WK7DMGS9QGZUHJNQ7XSKSKD3N,"The genus Agathis , commonly known as kauri or dammar , is a relatively small genus of 21 species of evergreen tree .",38,43,kauri,6,1,7
32PT7WK7DMGS9QGZUHJNQ7XSKSKD3N,"The genus Agathis , commonly known as kauri or dammar , is a relatively small genus of 21 species of evergreen tree .",47,53,dammar,8,1,9
32PT7WK7DMGS9QGZUHJNQ7XSKSKD3N,"The genus Agathis , commonly known as kauri or dammar , is a relatively small genus of 21 species of evergreen tree .",61,71,relatively,0,2,2
32PT7WK7DMGS9QGZUHJNQ7XSKSKD3N,"The genus Agathis , commonly known as kauri or dammar , is a relatively small genus of 21 species of evergreen tree .",78,83,genus,1,3,4
32PT7WK7DMGS9QGZUHJNQ7XSKSKD3N,"The genus Agathis , commonly known as kauri or dammar , is a relatively small genus of 21 species of evergreen tree .",90,97,species,3,2,5
32PT7WK7DMGS9QGZUHJNQ7XSKSKD3N,"The genus Agathis , commonly known as kauri or dammar , is a relatively small genus of 21 species of evergreen tree .",101,110,evergreen,0,7,7
32PT7WK7DMGS9QGZUHJNQ7XSKSKD3N,"The genus Agathis , commonly known as kauri or dammar , is a relatively small genus of 21 species of evergreen tree .",101,115,evergreen tree,2,0,2
32PT7WK7DMGS9QGZUHJNQ7XSKSKD3N,"The genus is part of the ancient Araucariaceae family of conifers , a group once widespread during the Jurassic period , but now largely restricted to the Southern Hemisphere except for a number of extant Malesian Agathis .",4,9,genus,2,2,4
32PT7WK7DMGS9QGZUHJNQ7XSKSKD3N,"The genus is part of the ancient Araucariaceae family of conifers , a group once widespread during the Jurassic period , but now largely restricted to the Southern Hemisphere except for a number of extant Malesian Agathis .",25,32,ancient,1,2,3
32PT7WK7DMGS9QGZUHJNQ7XSKSKD3N,"The genus is part of the ancient Araucariaceae family of conifers , a group once widespread during the Jurassic period , but now largely restricted to the Southern Hemisphere except for a number of extant Malesian Agathis .",33,46,Araucariaceae,5,1,6
32PT7WK7DMGS9QGZUHJNQ7XSKSKD3N,"The genus is part of the ancient Araucariaceae family of conifers , a group once widespread during the Jurassic period , but now largely restricted to the Southern Hemisphere except for a number of extant Malesian Agathis .",33,65,Araucariaceae family of conifers,1,0,1
32PT7WK7DMGS9QGZUHJNQ7XSKSKD3N,"The genus is part of the ancient Araucariaceae family of conifers , a group once widespread during the Jurassic period , but now largely restricted to the Southern Hemisphere except for a number of extant Malesian Agathis .",57,65,conifers,6,7,13
32PT7WK7DMGS9QGZUHJNQ7XSKSKD3N,"The genus is part of the ancient Araucariaceae family of conifers , a group once widespread during the Jurassic period , but now largely restricted to the Southern Hemisphere except for a number of extant Malesian Agathis .",81,91,widespread,1,5,6
32PT7WK7DMGS9QGZUHJNQ7XSKSKD3N,"The genus is part of the ancient Araucariaceae family of conifers , a group once widespread during the Jurassic period , but now largely restricted to the Southern Hemisphere except for a number of extant Malesian Agathis .",103,111,Jurassic,3,0,3
32PT7WK7DMGS9QGZUHJNQ7XSKSKD3N,"The genus is part of the ancient Araucariaceae family of conifers , a group once widespread during the Jurassic period , but now largely restricted to the Southern Hemisphere except for a number of extant Malesian Agathis .",103,118,Jurassic period,1,0,1
32PT7WK7DMGS9QGZUHJNQ7XSKSKD3N,"The genus is part of the ancient Araucariaceae family of conifers , a group once widespread during the Jurassic period , but now largely restricted to the Southern Hemisphere except for a number of extant Malesian Agathis .",137,147,restricted,3,3,6
32PT7WK7DMGS9QGZUHJNQ7XSKSKD3N,"The genus is part of the ancient Araucariaceae family of conifers , a group once widespread during the Jurassic period , but now largely restricted to the Southern Hemisphere except for a number of extant Malesian Agathis .",155,174,Southern Hemisphere,3,0,3
32PT7WK7DMGS9QGZUHJNQ7XSKSKD3N,"The genus is part of the ancient Araucariaceae family of conifers , a group once widespread during the Jurassic period , but now largely restricted to the Southern Hemisphere except for a number of extant Malesian Agathis .",164,174,Hemisphere,3,1,4
32PT7WK7DMGS9QGZUHJNQ7XSKSKD3N,"The genus is part of the ancient Araucariaceae family of conifers , a group once widespread during the Jurassic period , but now largely restricted to the Southern Hemisphere except for a number of extant Malesian Agathis .",198,204,extant,6,5,11
32PT7WK7DMGS9QGZUHJNQ7XSKSKD3N,"The genus is part of the ancient Araucariaceae family of conifers , a group once widespread during the Jurassic period , but now largely restricted to the Southern Hemisphere except for a number of extant Malesian Agathis .",205,213,Malesian,0,1,1
32PT7WK7DMGS9QGZUHJNQ7XSKSKD3N,"The genus is part of the ancient Araucariaceae family of conifers , a group once widespread during the Jurassic period , but now largely restricted to the Southern Hemisphere except for a number of extant Malesian Agathis .",205,221,Malesian Agathis,2,0,2
32PT7WK7DMGS9QGZUHJNQ7XSKSKD3N,"The genus is part of the ancient Araucariaceae family of conifers , a group once widespread during the Jurassic period , but now largely restricted to the Southern Hemisphere except for a number of extant Malesian Agathis .",214,221,Agathis,2,0,2
32PT7WK7DMGS9QGZUHJNQ7XSKSKD3N,"Mature kauri trees have characteristically large trunks , forming a bole with little or no branching below the crown .",0,6,Mature,1,0,1
32PT7WK7DMGS9QGZUHJNQ7XSKSKD3N,"Mature kauri trees have characteristically large trunks , forming a bole with little or no branching below the crown .",7,12,kauri,2,1,3
32PT7WK7DMGS9QGZUHJNQ7XSKSKD3N,"Mature kauri trees have characteristically large trunks , forming a bole with little or no branching below the crown .",7,18,kauri trees,1,0,1
32PT7WK7DMGS9QGZUHJNQ7XSKSKD3N,"Mature kauri trees have characteristically large trunks , forming a bole with little or no branching below the crown .",24,42,characteristically,3,4,7
32PT7WK7DMGS9QGZUHJNQ7XSKSKD3N,"Mature kauri trees have characteristically large trunks , forming a bole with little or no branching below the crown .",49,55,trunks,0,2,2
32PT7WK7DMGS9QGZUHJNQ7XSKSKD3N,"Mature kauri trees have characteristically large trunks , forming a bole with little or no branching below the crown .",68,72,bole,8,5,13
32PT7WK7DMGS9QGZUHJNQ7XSKSKD3N,"Mature kauri trees have characteristically large trunks , forming a bole with little or no branching below the crown .",91,100,branching,0,4,4
32PT7WK7DMGS9QGZUHJNQ7XSKSKD3N,"Mature kauri trees have characteristically large trunks , forming a bole with little or no branching below the crown .",111,116,crown,0,2,2
32PT7WK7DMGS9QGZUHJNQ7XSKSKD3N,"In contrast , young trees are normally conical in shape , forming a more rounded or irregularly shaped crown as they achieve maturity .",3,11,contrast,0,1,1
32PT7WK7DMGS9QGZUHJNQ7XSKSKD3N,"In contrast , young trees are normally conical in shape , forming a more rounded or irregularly shaped crown as they achieve maturity .",39,46,conical,8,1,9
32PT7WK7DMGS9QGZUHJNQ7XSKSKD3N,"In contrast , young trees are normally conical in shape , forming a more rounded or irregularly shaped crown as they achieve maturity .",39,55,conical in shape,0,1,1
32PT7WK7DMGS9QGZUHJNQ7XSKSKD3N,"In contrast , young trees are normally conical in shape , forming a more rounded or irregularly shaped crown as they achieve maturity .",84,95,irregularly,2,3,5
32PT7WK7DMGS9QGZUHJNQ7XSKSKD3N,"In contrast , young trees are normally conical in shape , forming a more rounded or irregularly shaped crown as they achieve maturity .",103,108,crown,1,2,3
32PT7WK7DMGS9QGZUHJNQ7XSKSKD3N,"In contrast , young trees are normally conical in shape , forming a more rounded or irregularly shaped crown as they achieve maturity .",117,124,achieve,2,1,3
32PT7WK7DMGS9QGZUHJNQ7XSKSKD3N,"In contrast , young trees are normally conical in shape , forming a more rounded or irregularly shaped crown as they achieve maturity .",117,133,achieve maturity,1,0,1
32PT7WK7DMGS9QGZUHJNQ7XSKSKD3N,"In contrast , young trees are normally conical in shape , forming a more rounded or irregularly shaped crown as they achieve maturity .",125,133,maturity,0,3,3
391FPZIE4CNTK0YKVXYE412QPXXHU8,"Tommy Ramone , also known as Thomas Erdelyi ( born Erdélyi Tamás ; January 29 , 1952 ) , is a Hungarian American record producer and musician .",51,64,Erdélyi Tamás,1,0,1
391FPZIE4CNTK0YKVXYE412QPXXHU8,"Tommy Ramone , also known as Thomas Erdelyi ( born Erdélyi Tamás ; January 29 , 1952 ) , is a Hungarian American record producer and musician .",94,103,Hungarian,1,0,1
391FPZIE4CNTK0YKVXYE412QPXXHU8,"Tommy Ramone , also known as Thomas Erdelyi ( born Erdélyi Tamás ; January 29 , 1952 ) , is a Hungarian American record producer and musician .",94,112,Hungarian American,1,0,1
391FPZIE4CNTK0YKVXYE412QPXXHU8,"Tommy Ramone , also known as Thomas Erdelyi ( born Erdélyi Tamás ; January 29 , 1952 ) , is a Hungarian American record producer and musician .",113,128,record producer,2,1,3
391FPZIE4CNTK0YKVXYE412QPXXHU8,"Tommy Ramone , also known as Thomas Erdelyi ( born Erdélyi Tamás ; January 29 , 1952 ) , is a Hungarian American record producer and musician .",113,141,record producer and musician,1,0,1
391FPZIE4CNTK0YKVXYE412QPXXHU8,"Tommy Ramone , also known as Thomas Erdelyi ( born Erdélyi Tamás ; January 29 , 1952 ) , is a Hungarian American record producer and musician .",120,128,producer,0,1,1
391FPZIE4CNTK0YKVXYE412QPXXHU8,He was the drummer of the influential punk rock band the Ramones and is the last surviving member of the original quartet .,11,18,drummer,1,3,4
391FPZIE4CNTK0YKVXYE412QPXXHU8,He was the drummer of the influential punk rock band the Ramones and is the last surviving member of the original quartet .,26,37,influential,9,9,18
391FPZIE4CNTK0YKVXYE412QPXXHU8,He was the drummer of the influential punk rock band the Ramones and is the last surviving member of the original quartet .,38,42,punk,1,0,1
391FPZIE4CNTK0YKVXYE412QPXXHU8,He was the drummer of the influential punk rock band the Ramones and is the last surviving member of the original quartet .,38,47,punk rock,1,0,1
391FPZIE4CNTK0YKVXYE412QPXXHU8,He was the drummer of the influential punk rock band the Ramones and is the last surviving member of the original quartet .,38,52,punk rock band,1,0,1
391FPZIE4CNTK0YKVXYE412QPXXHU8,He was the drummer of the influential punk rock band the Ramones and is the last surviving member of the original quartet .,57,64,Ramones,1,0,1
391FPZIE4CNTK0YKVXYE412QPXXHU8,He was the drummer of the influential punk rock band the Ramones and is the last surviving member of the original quartet .,81,90,surviving,5,7,12
391FPZIE4CNTK0YKVXYE412QPXXHU8,He was the drummer of the influential punk rock band the Ramones and is the last surviving member of the original quartet .,81,97,surviving member,0,1,1
391FPZIE4CNTK0YKVXYE412QPXXHU8,He was the drummer of the influential punk rock band the Ramones and is the last surviving member of the original quartet .,105,121,original quartet,1,0,1
391FPZIE4CNTK0YKVXYE412QPXXHU8,He was the drummer of the influential punk rock band the Ramones and is the last surviving member of the original quartet .,114,121,quartet,10,9,19
391FPZIE4CNTK0YKVXYE412QPXXHU8,Hayden later served as a minister in the Hawke Government before becoming Governor-General in 1988 .,25,33,minister,6,0,6
391FPZIE4CNTK0YKVXYE412QPXXHU8,Hayden later served as a minister in the Hawke Government before becoming Governor-General in 1988 .,47,57,Government,1,0,1
391FPZIE4CNTK0YKVXYE412QPXXHU8,Hayden later served as a minister in the Hawke Government before becoming Governor-General in 1988 .,65,73,becoming,0,1,1
391FPZIE4CNTK0YKVXYE412QPXXHU8,Hayden later served as a minister in the Hawke Government before becoming Governor-General in 1988 .,74,90,Governor-General,2,0,2
391FPZIE4CNTK0YKVXYE412QPXXHU8,"Oxley is located in south east Queensland , and covers the south western suburbs of Brisbane .",0,5,Oxley,1,0,1
391FPZIE4CNTK0YKVXYE412QPXXHU8,"Oxley is located in south east Queensland , and covers the south western suburbs of Brisbane .",9,16,located,0,1,1
391FPZIE4CNTK0YKVXYE412QPXXHU8,"Oxley is located in south east Queensland , and covers the south western suburbs of Brisbane .",65,80,western suburbs,0,1,1
391FPZIE4CNTK0YKVXYE412QPXXHU8,"Oxley is located in south east Queensland , and covers the south western suburbs of Brisbane .",73,80,suburbs,9,6,15
391FPZIE4CNTK0YKVXYE412QPXXHU8,"Its best-known member was Bill Hayden , the Labor Opposition Leader between 1977 and 1983 , when he resigned under pressure the same day that the 1983 election which swept Bob Hawke to power was called .",4,14,best-known,1,1,2
391FPZIE4CNTK0YKVXYE412QPXXHU8,"Its best-known member was Bill Hayden , the Labor Opposition Leader between 1977 and 1983 , when he resigned under pressure the same day that the 1983 election which swept Bob Hawke to power was called .",44,67,Labor Opposition Leader,1,0,1
391FPZIE4CNTK0YKVXYE412QPXXHU8,"Its best-known member was Bill Hayden , the Labor Opposition Leader between 1977 and 1983 , when he resigned under pressure the same day that the 1983 election which swept Bob Hawke to power was called .",50,60,Opposition,3,0,3
391FPZIE4CNTK0YKVXYE412QPXXHU8,"Its best-known member was Bill Hayden , the Labor Opposition Leader between 1977 and 1983 , when he resigned under pressure the same day that the 1983 election which swept Bob Hawke to power was called .",50,67,Opposition Leader,0,1,1
391FPZIE4CNTK0YKVXYE412QPXXHU8,"Its best-known member was Bill Hayden , the Labor Opposition Leader between 1977 and 1983 , when he resigned under pressure the same day that the 1983 election which swept Bob Hawke to power was called .",100,108,resigned,9,6,15
391FPZIE4CNTK0YKVXYE412QPXXHU8,"Its best-known member was Bill Hayden , the Labor Opposition Leader between 1977 and 1983 , when he resigned under pressure the same day that the 1983 election which swept Bob Hawke to power was called .",109,123,under pressure,0,1,1
391FPZIE4CNTK0YKVXYE412QPXXHU8,"Its best-known member was Bill Hayden , the Labor Opposition Leader between 1977 and 1983 , when he resigned under pressure the same day that the 1983 election which swept Bob Hawke to power was called .",115,123,pressure,0,2,2
391FPZIE4CNTK0YKVXYE412QPXXHU8,"Its best-known member was Bill Hayden , the Labor Opposition Leader between 1977 and 1983 , when he resigned under pressure the same day that the 1983 election which swept Bob Hawke to power was called .",166,171,swept,4,4,8
391FPZIE4CNTK0YKVXYE412QPXXHU8,"As this was not always practical , the Romans considered Doncaster to be an important staging post .",23,32,practical,4,5,9
391FPZIE4CNTK0YKVXYE412QPXXHU8,"As this was not always practical , the Romans considered Doncaster to be an important staging post .",46,56,considered,2,1,3
391FPZIE4CNTK0YKVXYE412QPXXHU8,"As this was not always practical , the Romans considered Doncaster to be an important staging post .",57,66,Doncaster,3,3,6
391FPZIE4CNTK0YKVXYE412QPXXHU8,"As this was not always practical , the Romans considered Doncaster to be an important staging post .",76,98,important staging post,0,1,1
391FPZIE4CNTK0YKVXYE412QPXXHU8,"As this was not always practical , the Romans considered Doncaster to be an important staging post .",86,93,staging,3,4,7
391FPZIE4CNTK0YKVXYE412QPXXHU8,"As this was not always practical , the Romans considered Doncaster to be an important staging post .",86,98,staging post,5,4,9
3IVKZBIBJ0AD5N6G6S3EP0K240CHSS,"However , the Blackpool bid organisers pledged to continue the work in getting government approval for a ` supercasino ' .",14,23,Blackpool,1,2,3
3IVKZBIBJ0AD5N6G6S3EP0K240CHSS,"However , the Blackpool bid organisers pledged to continue the work in getting government approval for a ` supercasino ' .",14,27,Blackpool bid,0,1,1
3IVKZBIBJ0AD5N6G6S3EP0K240CHSS,"However , the Blackpool bid organisers pledged to continue the work in getting government approval for a ` supercasino ' .",24,27,bid,2,2,4
3IVKZBIBJ0AD5N6G6S3EP0K240CHSS,"However , the Blackpool bid organisers pledged to continue the work in getting government approval for a ` supercasino ' .",24,38,bid organisers,1,0,1
3IVKZBIBJ0AD5N6G6S3EP0K240CHSS,"However , the Blackpool bid organisers pledged to continue the work in getting government approval for a ` supercasino ' .",28,38,organisers,5,1,6
3IVKZBIBJ0AD5N6G6S3EP0K240CHSS,"However , the Blackpool bid organisers pledged to continue the work in getting government approval for a ` supercasino ' .",28,46,organisers pledged,0,1,1
3IVKZBIBJ0AD5N6G6S3EP0K240CHSS,"However , the Blackpool bid organisers pledged to continue the work in getting government approval for a ` supercasino ' .",39,46,pledged,4,10,14
3IVKZBIBJ0AD5N6G6S3EP0K240CHSS,"However , the Blackpool bid organisers pledged to continue the work in getting government approval for a ` supercasino ' .",79,89,government,1,1,2
3IVKZBIBJ0AD5N6G6S3EP0K240CHSS,"However , the Blackpool bid organisers pledged to continue the work in getting government approval for a ` supercasino ' .",90,98,approval,1,0,1
3IVKZBIBJ0AD5N6G6S3EP0K240CHSS,"However , the Blackpool bid organisers pledged to continue the work in getting government approval for a ` supercasino ' .",107,118,supercasino,9,2,11
3IVKZBIBJ0AD5N6G6S3EP0K240CHSS,` Large casinos ' will have a minimum area of 1000 square metres and up to 150 slot machines with a maximum jackpot of # 4000 .,2,15,Large casinos,0,1,1
3IVKZBIBJ0AD5N6G6S3EP0K240CHSS,` Large casinos ' will have a minimum area of 1000 square metres and up to 150 slot machines with a maximum jackpot of # 4000 .,30,37,minimum,1,0,1
3IVKZBIBJ0AD5N6G6S3EP0K240CHSS,` Large casinos ' will have a minimum area of 1000 square metres and up to 150 slot machines with a maximum jackpot of # 4000 .,58,64,metres,2,0,2
3IVKZBIBJ0AD5N6G6S3EP0K240CHSS,` Large casinos ' will have a minimum area of 1000 square metres and up to 150 slot machines with a maximum jackpot of # 4000 .,79,92,slot machines,3,1,4
3IVKZBIBJ0AD5N6G6S3EP0K240CHSS,` Large casinos ' will have a minimum area of 1000 square metres and up to 150 slot machines with a maximum jackpot of # 4000 .,84,92,machines,0,2,2
3IVKZBIBJ0AD5N6G6S3EP0K240CHSS,` Large casinos ' will have a minimum area of 1000 square metres and up to 150 slot machines with a maximum jackpot of # 4000 .,100,107,maximum,1,0,1
3IVKZBIBJ0AD5N6G6S3EP0K240CHSS,` Large casinos ' will have a minimum area of 1000 square metres and up to 150 slot machines with a maximum jackpot of # 4000 .,100,115,maximum jackpot,2,0,2
3IVKZBIBJ0AD5N6G6S3EP0K240CHSS,` Large casinos ' will have a minimum area of 1000 square metres and up to 150 slot machines with a maximum jackpot of # 4000 .,108,115,jackpot,4,9,13
3IVKZBIBJ0AD5N6G6S3EP0K240CHSS,"A regional casino , more commonly known as a super casino ( or occasionally known as mega casino or other variants ) , is the term given to the largest category of casino that was to have been permitted under UK law - equivalent in size to the larger casinos in Las Vegas .",2,10,regional,1,0,1
3IVKZBIBJ0AD5N6G6S3EP0K240CHSS,"A regional casino , more commonly known as a super casino ( or occasionally known as mega casino or other variants ) , is the term given to the largest category of casino that was to have been permitted under UK law - equivalent in size to the larger casinos in Las Vegas .",11,17,casino,0,2,2
3IVKZBIBJ0AD5N6G6S3EP0K240CHSS,"A regional casino , more commonly known as a super casino ( or occasionally known as mega casino or other variants ) , is the term given to the largest category of casino that was to have been permitted under UK law - equivalent in size to the larger casinos in Las Vegas .",63,75,occasionally,1,2,3
3IVKZBIBJ0AD5N6G6S3EP0K240CHSS,"A regional casino , more commonly known as a super casino ( or occasionally known as mega casino or other variants ) , is the term given to the largest category of casino that was to have been permitted under UK law - equivalent in size to the larger casinos in Las Vegas .",85,89,mega,1,1,2
3IVKZBIBJ0AD5N6G6S3EP0K240CHSS,"A regional casino , more commonly known as a super casino ( or occasionally known as mega casino or other variants ) , is the term given to the largest category of casino that was to have been permitted under UK law - equivalent in size to the larger casinos in Las Vegas .",85,96,mega casino,1,0,1
3IVKZBIBJ0AD5N6G6S3EP0K240CHSS,"A regional casino , more commonly known as a super casino ( or occasionally known as mega casino or other variants ) , is the term given to the largest category of casino that was to have been permitted under UK law - equivalent in size to the larger casinos in Las Vegas .",106,114,variants,3,3,6
3IVKZBIBJ0AD5N6G6S3EP0K240CHSS,"A regional casino , more commonly known as a super casino ( or occasionally known as mega casino or other variants ) , is the term given to the largest category of casino that was to have been permitted under UK law - equivalent in size to the larger casinos in Las Vegas .",126,130,term,0,1,1
3IVKZBIBJ0AD5N6G6S3EP0K240CHSS,"A regional casino , more commonly known as a super casino ( or occasionally known as mega casino or other variants ) , is the term given to the largest category of casino that was to have been permitted under UK law - equivalent in size to the larger casinos in Las Vegas .",152,160,category,4,2,6
3IVKZBIBJ0AD5N6G6S3EP0K240CHSS,"A regional casino , more commonly known as a super casino ( or occasionally known as mega casino or other variants ) , is the term given to the largest category of casino that was to have been permitted under UK law - equivalent in size to the larger casinos in Las Vegas .",193,202,permitted,2,2,4
3IVKZBIBJ0AD5N6G6S3EP0K240CHSS,"A regional casino , more commonly known as a super casino ( or occasionally known as mega casino or other variants ) , is the term given to the largest category of casino that was to have been permitted under UK law - equivalent in size to the larger casinos in Las Vegas .",218,228,equivalent,9,3,12
3IVKZBIBJ0AD5N6G6S3EP0K240CHSS,"Prior to the act there were 140 casinos in the UK , the largest of which in Star City , Birmingham had a floor area of around 950 square metres ( 10,200 sq ft ) .",0,5,Prior,1,4,5
3IVKZBIBJ0AD5N6G6S3EP0K240CHSS,"Prior to the act there were 140 casinos in the UK , the largest of which in Star City , Birmingham had a floor area of around 950 square metres ( 10,200 sq ft ) .",32,39,casinos,0,1,1
3IVKZBIBJ0AD5N6G6S3EP0K240CHSS,"Prior to the act there were 140 casinos in the UK , the largest of which in Star City , Birmingham had a floor area of around 950 square metres ( 10,200 sq ft ) .",88,98,Birmingham,0,1,1
3IVKZBIBJ0AD5N6G6S3EP0K240CHSS,"Prior to the act there were 140 casinos in the UK , the largest of which in Star City , Birmingham had a floor area of around 950 square metres ( 10,200 sq ft ) .",105,110,floor,0,2,2
3IVKZBIBJ0AD5N6G6S3EP0K240CHSS,"Prior to the act there were 140 casinos in the UK , the largest of which in Star City , Birmingham had a floor area of around 950 square metres ( 10,200 sq ft ) .",105,115,floor area,1,0,1
3TLFH2L6Y9PA5XGDC75XC1AMH082TK,"Aegyptosaurus ( \/ iːˌdʒɪptɵˈsɔrəs \/ ) meaning ` Egypt 's lizard ' , for the country in which it was discovered ( Greek sauros meaning ` lizard ' ) is a genus of sauropod dinosaur believed to have lived in what is now Africa , around 95 million years ago , during the mid - and late-Cretaceous Period ( Albian to Cenomanian stages ) .",0,13,Aegyptosaurus,6,5,11
3TLFH2L6Y9PA5XGDC75XC1AMH082TK,"Aegyptosaurus ( \/ iːˌdʒɪptɵˈsɔrəs \/ ) meaning ` Egypt 's lizard ' , for the country in which it was discovered ( Greek sauros meaning ` lizard ' ) is a genus of sauropod dinosaur believed to have lived in what is now Africa , around 95 million years ago , during the mid - and late-Cretaceous Period ( Albian to Cenomanian stages ) .",59,65,lizard,1,2,3
3TLFH2L6Y9PA5XGDC75XC1AMH082TK,"Aegyptosaurus ( \/ iːˌdʒɪptɵˈsɔrəs \/ ) meaning ` Egypt 's lizard ' , for the country in which it was discovered ( Greek sauros meaning ` lizard ' ) is a genus of sauropod dinosaur believed to have lived in what is now Africa , around 95 million years ago , during the mid - and late-Cretaceous Period ( Albian to Cenomanian stages ) .",102,112,discovered,3,0,3
3TLFH2L6Y9PA5XGDC75XC1AMH082TK,"Aegyptosaurus ( \/ iːˌdʒɪptɵˈsɔrəs \/ ) meaning ` Egypt 's lizard ' , for the country in which it was discovered ( Greek sauros meaning ` lizard ' ) is a genus of sauropod dinosaur believed to have lived in what is now Africa , around 95 million years ago , during the mid - and late-Cretaceous Period ( Albian to Cenomanian stages ) .",121,127,sauros,1,0,1
3TLFH2L6Y9PA5XGDC75XC1AMH082TK,"Aegyptosaurus ( \/ iːˌdʒɪptɵˈsɔrəs \/ ) meaning ` Egypt 's lizard ' , for the country in which it was discovered ( Greek sauros meaning ` lizard ' ) is a genus of sauropod dinosaur believed to have lived in what is now Africa , around 95 million years ago , during the mid - and late-Cretaceous Period ( Albian to Cenomanian stages ) .",154,159,genus,7,7,14
3TLFH2L6Y9PA5XGDC75XC1AMH082TK,"Aegyptosaurus ( \/ iːˌdʒɪptɵˈsɔrəs \/ ) meaning ` Egypt 's lizard ' , for the country in which it was discovered ( Greek sauros meaning ` lizard ' ) is a genus of sauropod dinosaur believed to have lived in what is now Africa , around 95 million years ago , during the mid - and late-Cretaceous Period ( Albian to Cenomanian stages ) .",154,180,genus of sauropod dinosaur,1,0,1
3TLFH2L6Y9PA5XGDC75XC1AMH082TK,"Aegyptosaurus ( \/ iːˌdʒɪptɵˈsɔrəs \/ ) meaning ` Egypt 's lizard ' , for the country in which it was discovered ( Greek sauros meaning ` lizard ' ) is a genus of sauropod dinosaur believed to have lived in what is now Africa , around 95 million years ago , during the mid - and late-Cretaceous Period ( Albian to Cenomanian stages ) .",163,171,sauropod,7,2,9
3TLFH2L6Y9PA5XGDC75XC1AMH082TK,"Aegyptosaurus ( \/ iːˌdʒɪptɵˈsɔrəs \/ ) meaning ` Egypt 's lizard ' , for the country in which it was discovered ( Greek sauros meaning ` lizard ' ) is a genus of sauropod dinosaur believed to have lived in what is now Africa , around 95 million years ago , during the mid - and late-Cretaceous Period ( Albian to Cenomanian stages ) .",163,180,sauropod dinosaur,1,0,1
3TLFH2L6Y9PA5XGDC75XC1AMH082TK,"Aegyptosaurus ( \/ iːˌdʒɪptɵˈsɔrəs \/ ) meaning ` Egypt 's lizard ' , for the country in which it was discovered ( Greek sauros meaning ` lizard ' ) is a genus of sauropod dinosaur believed to have lived in what is now Africa , around 95 million years ago , during the mid - and late-Cretaceous Period ( Albian to Cenomanian stages ) .",172,180,dinosaur,1,0,1
3TLFH2L6Y9PA5XGDC75XC1AMH082TK,"Aegyptosaurus ( \/ iːˌdʒɪptɵˈsɔrəs \/ ) meaning ` Egypt 's lizard ' , for the country in which it was discovered ( Greek sauros meaning ` lizard ' ) is a genus of sauropod dinosaur believed to have lived in what is now Africa , around 95 million years ago , during the mid - and late-Cretaceous Period ( Albian to Cenomanian stages ) .",279,294,late-Cretaceous,2,0,2
3TLFH2L6Y9PA5XGDC75XC1AMH082TK,"Aegyptosaurus ( \/ iːˌdʒɪptɵˈsɔrəs \/ ) meaning ` Egypt 's lizard ' , for the country in which it was discovered ( Greek sauros meaning ` lizard ' ) is a genus of sauropod dinosaur believed to have lived in what is now Africa , around 95 million years ago , during the mid - and late-Cretaceous Period ( Albian to Cenomanian stages ) .",279,301,late-Cretaceous Period,2,2,4
3TLFH2L6Y9PA5XGDC75XC1AMH082TK,"Aegyptosaurus ( \/ iːˌdʒɪptɵˈsɔrəs \/ ) meaning ` Egypt 's lizard ' , for the country in which it was discovered ( Greek sauros meaning ` lizard ' ) is a genus of sauropod dinosaur believed to have lived in what is now Africa , around 95 million years ago , during the mid - and late-Cretaceous Period ( Albian to Cenomanian stages ) .",304,310,Albian,1,0,1
3TLFH2L6Y9PA5XGDC75XC1AMH082TK,"Aegyptosaurus ( \/ iːˌdʒɪptɵˈsɔrəs \/ ) meaning ` Egypt 's lizard ' , for the country in which it was discovered ( Greek sauros meaning ` lizard ' ) is a genus of sauropod dinosaur believed to have lived in what is now Africa , around 95 million years ago , during the mid - and late-Cretaceous Period ( Albian to Cenomanian stages ) .",304,324,Albian to Cenomanian,1,0,1
3TLFH2L6Y9PA5XGDC75XC1AMH082TK,"Aegyptosaurus ( \/ iːˌdʒɪptɵˈsɔrəs \/ ) meaning ` Egypt 's lizard ' , for the country in which it was discovered ( Greek sauros meaning ` lizard ' ) is a genus of sauropod dinosaur believed to have lived in what is now Africa , around 95 million years ago , during the mid - and late-Cretaceous Period ( Albian to Cenomanian stages ) .",304,331,Albian to Cenomanian stages,1,0,1
3TLFH2L6Y9PA5XGDC75XC1AMH082TK,"Aegyptosaurus ( \/ iːˌdʒɪptɵˈsɔrəs \/ ) meaning ` Egypt 's lizard ' , for the country in which it was discovered ( Greek sauros meaning ` lizard ' ) is a genus of sauropod dinosaur believed to have lived in what is now Africa , around 95 million years ago , during the mid - and late-Cretaceous Period ( Albian to Cenomanian stages ) .",314,324,Cenomanian,2,1,3
3TLFH2L6Y9PA5XGDC75XC1AMH082TK,"Aegyptosaurus ( \/ iːˌdʒɪptɵˈsɔrəs \/ ) meaning ` Egypt 's lizard ' , for the country in which it was discovered ( Greek sauros meaning ` lizard ' ) is a genus of sauropod dinosaur believed to have lived in what is now Africa , around 95 million years ago , during the mid - and late-Cretaceous Period ( Albian to Cenomanian stages ) .",325,331,stages,0,2,2
3TLFH2L6Y9PA5XGDC75XC1AMH082TK,The animal 's long tail probably acted as a counterweight to its body mass .,24,32,probably,2,1,3
3TLFH2L6Y9PA5XGDC75XC1AMH082TK,The animal 's long tail probably acted as a counterweight to its body mass .,44,57,counterweight,10,10,20
3TLFH2L6Y9PA5XGDC75XC1AMH082TK,The animal 's long tail probably acted as a counterweight to its body mass .,65,74,body mass,1,1,2
3TLFH2L6Y9PA5XGDC75XC1AMH082TK,The animal 's long tail probably acted as a counterweight to its body mass .,70,74,mass,1,1,2
3TLFH2L6Y9PA5XGDC75XC1AMH082TK,"Aegyptosaurus was a close relative of Argentinosaurus , a much larger dinosaur found in South America .",0,13,Aegyptosaurus,1,3,4
3TLFH2L6Y9PA5XGDC75XC1AMH082TK,"Aegyptosaurus was a close relative of Argentinosaurus , a much larger dinosaur found in South America .",38,53,Argentinosaurus,4,3,7
3TLFH2L6Y9PA5XGDC75XC1AMH082TK,"Aegyptosaurus was a close relative of Argentinosaurus , a much larger dinosaur found in South America .",70,78,dinosaur,2,1,3
3TLFH2L6Y9PA5XGDC75XC1AMH082TK,"Its fossils have been found in Egypt , Niger and in several different locations in the Sahara Desert .",4,11,fossils,6,9,15
3TLFH2L6Y9PA5XGDC75XC1AMH082TK,"Its fossils have been found in Egypt , Niger and in several different locations in the Sahara Desert .",70,79,locations,0,1,1
3TLFH2L6Y9PA5XGDC75XC1AMH082TK,"The fossils were stored together in Munich , but were obliterated when an Allied bombing raid destroyed the museum where they were kept in 1944 , during World War II .",4,11,fossils,2,1,3
3TLFH2L6Y9PA5XGDC75XC1AMH082TK,"The fossils were stored together in Munich , but were obliterated when an Allied bombing raid destroyed the museum where they were kept in 1944 , during World War II .",17,23,stored,0,1,1
3TLFH2L6Y9PA5XGDC75XC1AMH082TK,"The fossils were stored together in Munich , but were obliterated when an Allied bombing raid destroyed the museum where they were kept in 1944 , during World War II .",54,65,obliterated,9,10,19
3TLFH2L6Y9PA5XGDC75XC1AMH082TK,"The fossils were stored together in Munich , but were obliterated when an Allied bombing raid destroyed the museum where they were kept in 1944 , during World War II .",74,80,Allied,0,2,2
3TLFH2L6Y9PA5XGDC75XC1AMH082TK,"The fossils were stored together in Munich , but were obliterated when an Allied bombing raid destroyed the museum where they were kept in 1944 , during World War II .",81,88,bombing,1,0,1
3TLFH2L6Y9PA5XGDC75XC1AMH082TK,"The fossils were stored together in Munich , but were obliterated when an Allied bombing raid destroyed the museum where they were kept in 1944 , during World War II .",81,93,bombing raid,2,1,3
3TLFH2L6Y9PA5XGDC75XC1AMH082TK,"The fossils were stored together in Munich , but were obliterated when an Allied bombing raid destroyed the museum where they were kept in 1944 , during World War II .",89,93,raid,1,2,3
3TLFH2L6Y9PA5XGDC75XC1AMH082TK,"The fossils were stored together in Munich , but were obliterated when an Allied bombing raid destroyed the museum where they were kept in 1944 , during World War II .",94,103,destroyed,1,1,2
3TLFH2L6Y9PA5XGDC75XC1AMH082TK,"The fossils were stored together in Munich , but were obliterated when an Allied bombing raid destroyed the museum where they were kept in 1944 , during World War II .",108,114,museum,3,1,4
31N9JPQXIPJGPAEBYWMSQ6AWH14HNG,"The publisher organizes literary , musical and artistic events especially in Upper Austria and Salzburg , to a lesser extent also in Vienna .",4,13,publisher,5,0,5
31N9JPQXIPJGPAEBYWMSQ6AWH14HNG,"The publisher organizes literary , musical and artistic events especially in Upper Austria and Salzburg , to a lesser extent also in Vienna .",14,23,organizes,2,2,4
31N9JPQXIPJGPAEBYWMSQ6AWH14HNG,"The publisher organizes literary , musical and artistic events especially in Upper Austria and Salzburg , to a lesser extent also in Vienna .",24,32,literary,6,5,11
31N9JPQXIPJGPAEBYWMSQ6AWH14HNG,"The publisher organizes literary , musical and artistic events especially in Upper Austria and Salzburg , to a lesser extent also in Vienna .",24,62,"literary , musical and artistic events",1,0,1
31N9JPQXIPJGPAEBYWMSQ6AWH14HNG,"The publisher organizes literary , musical and artistic events especially in Upper Austria and Salzburg , to a lesser extent also in Vienna .",47,55,artistic,0,2,2
31N9JPQXIPJGPAEBYWMSQ6AWH14HNG,"The publisher organizes literary , musical and artistic events especially in Upper Austria and Salzburg , to a lesser extent also in Vienna .",77,82,Upper,0,1,1
31N9JPQXIPJGPAEBYWMSQ6AWH14HNG,"The publisher organizes literary , musical and artistic events especially in Upper Austria and Salzburg , to a lesser extent also in Vienna .",111,117,lesser,0,5,5
31N9JPQXIPJGPAEBYWMSQ6AWH14HNG,"The publisher organizes literary , musical and artistic events especially in Upper Austria and Salzburg , to a lesser extent also in Vienna .",111,124,lesser extent,1,0,1
31N9JPQXIPJGPAEBYWMSQ6AWH14HNG,"The publisher organizes literary , musical and artistic events especially in Upper Austria and Salzburg , to a lesser extent also in Vienna .",118,124,extent,1,3,4
31N9JPQXIPJGPAEBYWMSQ6AWH14HNG,Arovell 's headquarter lies in Gosau in Upper Austria and has subsidiaries in Vienna and Salzburg .,11,22,headquarter,2,2,4
31N9JPQXIPJGPAEBYWMSQ6AWH14HNG,Arovell 's headquarter lies in Gosau in Upper Austria and has subsidiaries in Vienna and Salzburg .,23,27,lies,0,3,3
31N9JPQXIPJGPAEBYWMSQ6AWH14HNG,Arovell 's headquarter lies in Gosau in Upper Austria and has subsidiaries in Vienna and Salzburg .,62,74,subsidiaries,10,10,20
31N9JPQXIPJGPAEBYWMSQ6AWH14HNG,The American Federation of Musicians defines arranging as `` the art of preparing and adapting an already written composition for presentation in other than its original form .,13,23,Federation,0,2,2
31N9JPQXIPJGPAEBYWMSQ6AWH14HNG,The American Federation of Musicians defines arranging as `` the art of preparing and adapting an already written composition for presentation in other than its original form .,27,36,Musicians,0,1,1
31N9JPQXIPJGPAEBYWMSQ6AWH14HNG,The American Federation of Musicians defines arranging as `` the art of preparing and adapting an already written composition for presentation in other than its original form .,37,44,defines,0,1,1
31N9JPQXIPJGPAEBYWMSQ6AWH14HNG,The American Federation of Musicians defines arranging as `` the art of preparing and adapting an already written composition for presentation in other than its original form .,45,54,arranging,1,3,4
31N9JPQXIPJGPAEBYWMSQ6AWH14HNG,The American Federation of Musicians defines arranging as `` the art of preparing and adapting an already written composition for presentation in other than its original form .,72,94,preparing and adapting,1,0,1
31N9JPQXIPJGPAEBYWMSQ6AWH14HNG,The American Federation of Musicians defines arranging as `` the art of preparing and adapting an already written composition for presentation in other than its original form .,86,94,adapting,4,1,5
31N9JPQXIPJGPAEBYWMSQ6AWH14HNG,The American Federation of Musicians defines arranging as `` the art of preparing and adapting an already written composition for presentation in other than its original form .,106,125,written composition,1,0,1
31N9JPQXIPJGPAEBYWMSQ6AWH14HNG,The American Federation of Musicians defines arranging as `` the art of preparing and adapting an already written composition for presentation in other than its original form .,114,125,composition,7,3,10
31N9JPQXIPJGPAEBYWMSQ6AWH14HNG,The American Federation of Musicians defines arranging as `` the art of preparing and adapting an already written composition for presentation in other than its original form .,130,142,presentation,0,1,1
31N9JPQXIPJGPAEBYWMSQ6AWH14HNG,It is prepared by a reaction of arsenic trichloride and potassium iodide : Hydrolysis occurs only slowly in water forming arsenic trioxide and hydroiodic acid .,20,28,reaction,2,2,4
31N9JPQXIPJGPAEBYWMSQ6AWH14HNG,It is prepared by a reaction of arsenic trichloride and potassium iodide : Hydrolysis occurs only slowly in water forming arsenic trioxide and hydroiodic acid .,32,39,arsenic,0,1,1
31N9JPQXIPJGPAEBYWMSQ6AWH14HNG,It is prepared by a reaction of arsenic trichloride and potassium iodide : Hydrolysis occurs only slowly in water forming arsenic trioxide and hydroiodic acid .,32,51,arsenic trichloride,9,2,11
31N9JPQXIPJGPAEBYWMSQ6AWH14HNG,It is prepared by a reaction of arsenic trichloride and potassium iodide : Hydrolysis occurs only slowly in water forming arsenic trioxide and hydroiodic acid .,32,72,arsenic trichloride and potassium iodide,2,0,2
31N9JPQXIPJGPAEBYWMSQ6AWH14HNG,It is prepared by a reaction of arsenic trichloride and potassium iodide : Hydrolysis occurs only slowly in water forming arsenic trioxide and hydroiodic acid .,40,51,trichloride,2,0,2
31N9JPQXIPJGPAEBYWMSQ6AWH14HNG,It is prepared by a reaction of arsenic trichloride and potassium iodide : Hydrolysis occurs only slowly in water forming arsenic trioxide and hydroiodic acid .,56,65,potassium,4,0,4
31N9JPQXIPJGPAEBYWMSQ6AWH14HNG,It is prepared by a reaction of arsenic trichloride and potassium iodide : Hydrolysis occurs only slowly in water forming arsenic trioxide and hydroiodic acid .,56,72,potassium iodide,9,1,10
31N9JPQXIPJGPAEBYWMSQ6AWH14HNG,It is prepared by a reaction of arsenic trichloride and potassium iodide : Hydrolysis occurs only slowly in water forming arsenic trioxide and hydroiodic acid .,66,72,iodide,1,2,3
31N9JPQXIPJGPAEBYWMSQ6AWH14HNG,It is prepared by a reaction of arsenic trichloride and potassium iodide : Hydrolysis occurs only slowly in water forming arsenic trioxide and hydroiodic acid .,75,85,Hydrolysis,10,2,12
31N9JPQXIPJGPAEBYWMSQ6AWH14HNG,It is prepared by a reaction of arsenic trichloride and potassium iodide : Hydrolysis occurs only slowly in water forming arsenic trioxide and hydroiodic acid .,122,138,arsenic trioxide,7,1,8
31N9JPQXIPJGPAEBYWMSQ6AWH14HNG,It is prepared by a reaction of arsenic trichloride and potassium iodide : Hydrolysis occurs only slowly in water forming arsenic trioxide and hydroiodic acid .,130,138,trioxide,2,0,2
31N9JPQXIPJGPAEBYWMSQ6AWH14HNG,It is prepared by a reaction of arsenic trichloride and potassium iodide : Hydrolysis occurs only slowly in water forming arsenic trioxide and hydroiodic acid .,143,153,hydroiodic,5,0,5
31N9JPQXIPJGPAEBYWMSQ6AWH14HNG,It is prepared by a reaction of arsenic trichloride and potassium iodide : Hydrolysis occurs only slowly in water forming arsenic trioxide and hydroiodic acid .,143,158,hydroiodic acid,4,0,4
31N9JPQXIPJGPAEBYWMSQ6AWH14HNG,"The aqueous solution is highly acidic , pH of 0.1 N solution is 1.1 .",4,11,aqueous,7,4,11
31N9JPQXIPJGPAEBYWMSQ6AWH14HNG,"The aqueous solution is highly acidic , pH of 0.1 N solution is 1.1 .",4,20,aqueous solution,4,0,4
31N9JPQXIPJGPAEBYWMSQ6AWH14HNG,"The aqueous solution is highly acidic , pH of 0.1 N solution is 1.1 .",12,20,solution,1,0,1
31N9JPQXIPJGPAEBYWMSQ6AWH14HNG,"The aqueous solution is highly acidic , pH of 0.1 N solution is 1.1 .",31,37,acidic,1,0,1
31N9JPQXIPJGPAEBYWMSQ6AWH14HNG,"It decomposes to arsenic trioxide , elemental arsenic and iodine when heated in air at 200 ° C. The decomposition , however , commences at 100 ° C and occurs with the liberation of iodine .",3,13,decomposes,7,6,13
31N9JPQXIPJGPAEBYWMSQ6AWH14HNG,"It decomposes to arsenic trioxide , elemental arsenic and iodine when heated in air at 200 ° C. The decomposition , however , commences at 100 ° C and occurs with the liberation of iodine .",17,24,arsenic,1,0,1
31N9JPQXIPJGPAEBYWMSQ6AWH14HNG,"It decomposes to arsenic trioxide , elemental arsenic and iodine when heated in air at 200 ° C. The decomposition , however , commences at 100 ° C and occurs with the liberation of iodine .",17,33,arsenic trioxide,1,1,2
31N9JPQXIPJGPAEBYWMSQ6AWH14HNG,"It decomposes to arsenic trioxide , elemental arsenic and iodine when heated in air at 200 ° C. The decomposition , however , commences at 100 ° C and occurs with the liberation of iodine .",17,64,"arsenic trioxide , elemental arsenic and iodine",1,0,1
31N9JPQXIPJGPAEBYWMSQ6AWH14HNG,"It decomposes to arsenic trioxide , elemental arsenic and iodine when heated in air at 200 ° C. The decomposition , however , commences at 100 ° C and occurs with the liberation of iodine .",25,33,trioxide,0,1,1
31N9JPQXIPJGPAEBYWMSQ6AWH14HNG,"It decomposes to arsenic trioxide , elemental arsenic and iodine when heated in air at 200 ° C. The decomposition , however , commences at 100 ° C and occurs with the liberation of iodine .",36,45,elemental,1,0,1
31N9JPQXIPJGPAEBYWMSQ6AWH14HNG,"It decomposes to arsenic trioxide , elemental arsenic and iodine when heated in air at 200 ° C. The decomposition , however , commences at 100 ° C and occurs with the liberation of iodine .",36,53,elemental arsenic,1,0,1
31N9JPQXIPJGPAEBYWMSQ6AWH14HNG,"It decomposes to arsenic trioxide , elemental arsenic and iodine when heated in air at 200 ° C. The decomposition , however , commences at 100 ° C and occurs with the liberation of iodine .",46,53,arsenic,1,1,2
31N9JPQXIPJGPAEBYWMSQ6AWH14HNG,"It decomposes to arsenic trioxide , elemental arsenic and iodine when heated in air at 200 ° C. The decomposition , however , commences at 100 ° C and occurs with the liberation of iodine .",58,64,iodine,2,1,3
31N9JPQXIPJGPAEBYWMSQ6AWH14HNG,"It decomposes to arsenic trioxide , elemental arsenic and iodine when heated in air at 200 ° C. The decomposition , however , commences at 100 ° C and occurs with the liberation of iodine .",100,113,decomposition,5,1,6
31N9JPQXIPJGPAEBYWMSQ6AWH14HNG,"It decomposes to arsenic trioxide , elemental arsenic and iodine when heated in air at 200 ° C. The decomposition , however , commences at 100 ° C and occurs with the liberation of iodine .",126,135,commences,4,2,6
31N9JPQXIPJGPAEBYWMSQ6AWH14HNG,"It decomposes to arsenic trioxide , elemental arsenic and iodine when heated in air at 200 ° C. The decomposition , however , commences at 100 ° C and occurs with the liberation of iodine .",167,177,liberation,7,3,10
31N9JPQXIPJGPAEBYWMSQ6AWH14HNG,"It decomposes to arsenic trioxide , elemental arsenic and iodine when heated in air at 200 ° C. The decomposition , however , commences at 100 ° C and occurs with the liberation of iodine .",167,187,liberation of iodine,1,0,1
31N9JPQXIPJGPAEBYWMSQ6AWH14HNG,"It decomposes to arsenic trioxide , elemental arsenic and iodine when heated in air at 200 ° C. The decomposition , however , commences at 100 ° C and occurs with the liberation of iodine .",181,187,iodine,2,1,3
3K3IX1W4S6S1I8IA85PSD9SN4LFAPU,Most administrators consider such an unblock request a sure sign of a sock account ( particularly one with very few edits otherwise ) and will decline on that basis .,5,19,administrators,7,5,12
3K3IX1W4S6S1I8IA85PSD9SN4LFAPU,Most administrators consider such an unblock request a sure sign of a sock account ( particularly one with very few edits otherwise ) and will decline on that basis .,20,28,consider,0,1,1
3K3IX1W4S6S1I8IA85PSD9SN4LFAPU,Most administrators consider such an unblock request a sure sign of a sock account ( particularly one with very few edits otherwise ) and will decline on that basis .,37,44,unblock,2,7,9
3K3IX1W4S6S1I8IA85PSD9SN4LFAPU,Most administrators consider such an unblock request a sure sign of a sock account ( particularly one with very few edits otherwise ) and will decline on that basis .,37,52,unblock request,2,1,3
3K3IX1W4S6S1I8IA85PSD9SN4LFAPU,Most administrators consider such an unblock request a sure sign of a sock account ( particularly one with very few edits otherwise ) and will decline on that basis .,70,74,sock,2,2,4
3K3IX1W4S6S1I8IA85PSD9SN4LFAPU,Most administrators consider such an unblock request a sure sign of a sock account ( particularly one with very few edits otherwise ) and will decline on that basis .,70,82,sock account,7,5,12
3K3IX1W4S6S1I8IA85PSD9SN4LFAPU,Most administrators consider such an unblock request a sure sign of a sock account ( particularly one with very few edits otherwise ) and will decline on that basis .,85,97,particularly,1,0,1
3K3IX1W4S6S1I8IA85PSD9SN4LFAPU,Most administrators consider such an unblock request a sure sign of a sock account ( particularly one with very few edits otherwise ) and will decline on that basis .,116,121,edits,0,2,2
3K3IX1W4S6S1I8IA85PSD9SN4LFAPU,Most administrators consider such an unblock request a sure sign of a sock account ( particularly one with very few edits otherwise ) and will decline on that basis .,122,131,otherwise,0,1,1
3K3IX1W4S6S1I8IA85PSD9SN4LFAPU,Most administrators consider such an unblock request a sure sign of a sock account ( particularly one with very few edits otherwise ) and will decline on that basis .,143,150,decline,2,3,5
3K3IX1W4S6S1I8IA85PSD9SN4LFAPU,Most administrators consider such an unblock request a sure sign of a sock account ( particularly one with very few edits otherwise ) and will decline on that basis .,159,164,basis,1,0,1
3K3IX1W4S6S1I8IA85PSD9SN4LFAPU,"Most such accounts are soft-blocked , meaning a new account may be created while the old one is blocked .",23,35,soft-blocked,10,9,19
3K3IX1W4S6S1I8IA85PSD9SN4LFAPU,"It may help with your unblock request if you understand how they are reviewed , and by whom .",22,29,unblock,1,0,1
3K3IX1W4S6S1I8IA85PSD9SN4LFAPU,"It may help with your unblock request if you understand how they are reviewed , and by whom .",30,37,request,1,0,1
3K3IX1W4S6S1I8IA85PSD9SN4LFAPU,"It may help with your unblock request if you understand how they are reviewed , and by whom .",69,77,reviewed,2,8,10
3K3IX1W4S6S1I8IA85PSD9SN4LFAPU,"It may help with your unblock request if you understand how they are reviewed , and by whom .",87,91,whom,0,1,1
3K3IX1W4S6S1I8IA85PSD9SN4LFAPU,"First , the blocking administrator provides a brief reason that you will see when you try to make an edit .",12,34,blocking administrator,1,0,1
3K3IX1W4S6S1I8IA85PSD9SN4LFAPU,"First , the blocking administrator provides a brief reason that you will see when you try to make an edit .",21,34,administrator,2,0,2
3K3IX1W4S6S1I8IA85PSD9SN4LFAPU,"First , the blocking administrator provides a brief reason that you will see when you try to make an edit .",46,51,brief,1,1,2
3K3IX1W4S6S1I8IA85PSD9SN4LFAPU,"First , the blocking administrator provides a brief reason that you will see when you try to make an edit .",46,58,brief reason,0,1,1
3K3IX1W4S6S1I8IA85PSD9SN4LFAPU,"First , the blocking administrator provides a brief reason that you will see when you try to make an edit .",101,105,edit,1,0,1
3K3IX1W4S6S1I8IA85PSD9SN4LFAPU,"Second , the administrator may leave a message explaining your block on your user talk page .",47,57,explaining,1,0,1
3K3IX1W4S6S1I8IA85PSD9SN4LFAPU,"Second , the administrator may leave a message explaining your block on your user talk page .",77,81,user,1,0,1
3K3IX1W4S6S1I8IA85PSD9SN4LFAPU,"Second , the administrator may leave a message explaining your block on your user talk page .",77,91,user talk page,1,0,1
3K3IX1W4S6S1I8IA85PSD9SN4LFAPU,"Accusations of sockpuppetry result in many blocks and almost as many unblock requests , as Wikipedia policy calls for the sockpuppet account to be blocked indefinitely and the sockpuppeteer to be blocked for some length of time ( possibly also indefinitely ) .",0,11,Accusations,7,7,14
3K3IX1W4S6S1I8IA85PSD9SN4LFAPU,"Accusations of sockpuppetry result in many blocks and almost as many unblock requests , as Wikipedia policy calls for the sockpuppet account to be blocked indefinitely and the sockpuppeteer to be blocked for some length of time ( possibly also indefinitely ) .",15,27,sockpuppetry,10,10,20
3K3IX1W4S6S1I8IA85PSD9SN4LFAPU,"Accusations of sockpuppetry result in many blocks and almost as many unblock requests , as Wikipedia policy calls for the sockpuppet account to be blocked indefinitely and the sockpuppeteer to be blocked for some length of time ( possibly also indefinitely ) .",91,100,Wikipedia,2,0,2
3K3IX1W4S6S1I8IA85PSD9SN4LFAPU,"Accusations of sockpuppetry result in many blocks and almost as many unblock requests , as Wikipedia policy calls for the sockpuppet account to be blocked indefinitely and the sockpuppeteer to be blocked for some length of time ( possibly also indefinitely ) .",101,107,policy,0,1,1
3K3IX1W4S6S1I8IA85PSD9SN4LFAPU,"Accusations of sockpuppetry result in many blocks and almost as many unblock requests , as Wikipedia policy calls for the sockpuppet account to be blocked indefinitely and the sockpuppeteer to be blocked for some length of time ( possibly also indefinitely ) .",122,132,sockpuppet,3,4,7
3K3IX1W4S6S1I8IA85PSD9SN4LFAPU,"Accusations of sockpuppetry result in many blocks and almost as many unblock requests , as Wikipedia policy calls for the sockpuppet account to be blocked indefinitely and the sockpuppeteer to be blocked for some length of time ( possibly also indefinitely ) .",122,140,sockpuppet account,1,0,1
3K3IX1W4S6S1I8IA85PSD9SN4LFAPU,"Accusations of sockpuppetry result in many blocks and almost as many unblock requests , as Wikipedia policy calls for the sockpuppet account to be blocked indefinitely and the sockpuppeteer to be blocked for some length of time ( possibly also indefinitely ) .",155,167,indefinitely,5,5,10
3K3IX1W4S6S1I8IA85PSD9SN4LFAPU,"Accusations of sockpuppetry result in many blocks and almost as many unblock requests , as Wikipedia policy calls for the sockpuppet account to be blocked indefinitely and the sockpuppeteer to be blocked for some length of time ( possibly also indefinitely ) .",176,189,sockpuppeteer,6,4,10
3K3IX1W4S6S1I8IA85PSD9SN4LFAPU,"Accusations of sockpuppetry result in many blocks and almost as many unblock requests , as Wikipedia policy calls for the sockpuppet account to be blocked indefinitely and the sockpuppeteer to be blocked for some length of time ( possibly also indefinitely ) .",244,256,indefinitely,1,0,1
3GMLHYZ0LEYF6VO95X22Q1XTFTAUYK,"The largest river in the state is the Rhine River , which forms the border with Baden-Württemberg and Hesse in the southeast before flowing through the northern part of Rhineland-Palatinate .",4,11,largest,1,0,1
3GMLHYZ0LEYF6VO95X22Q1XTFTAUYK,"The largest river in the state is the Rhine River , which forms the border with Baden-Württemberg and Hesse in the southeast before flowing through the northern part of Rhineland-Palatinate .",12,17,river,1,0,1
3GMLHYZ0LEYF6VO95X22Q1XTFTAUYK,"The largest river in the state is the Rhine River , which forms the border with Baden-Württemberg and Hesse in the southeast before flowing through the northern part of Rhineland-Palatinate .",68,74,border,2,4,6
3GMLHYZ0LEYF6VO95X22Q1XTFTAUYK,"The largest river in the state is the Rhine River , which forms the border with Baden-Württemberg and Hesse in the southeast before flowing through the northern part of Rhineland-Palatinate .",80,97,Baden-Württemberg,2,0,2
3GMLHYZ0LEYF6VO95X22Q1XTFTAUYK,"The largest river in the state is the Rhine River , which forms the border with Baden-Württemberg and Hesse in the southeast before flowing through the northern part of Rhineland-Palatinate .",80,107,Baden-Württemberg and Hesse,1,0,1
3GMLHYZ0LEYF6VO95X22Q1XTFTAUYK,"The largest river in the state is the Rhine River , which forms the border with Baden-Württemberg and Hesse in the southeast before flowing through the northern part of Rhineland-Palatinate .",115,124,southeast,2,3,5
3GMLHYZ0LEYF6VO95X22Q1XTFTAUYK,"The largest river in the state is the Rhine River , which forms the border with Baden-Württemberg and Hesse in the southeast before flowing through the northern part of Rhineland-Palatinate .",132,139,flowing,2,5,7
3GMLHYZ0LEYF6VO95X22Q1XTFTAUYK,"The largest river in the state is the Rhine River , which forms the border with Baden-Württemberg and Hesse in the southeast before flowing through the northern part of Rhineland-Palatinate .",152,160,northern,1,0,1
3GMLHYZ0LEYF6VO95X22Q1XTFTAUYK,"The largest river in the state is the Rhine River , which forms the border with Baden-Württemberg and Hesse in the southeast before flowing through the northern part of Rhineland-Palatinate .",169,189,Rhineland-Palatinate,3,1,4
3GMLHYZ0LEYF6VO95X22Q1XTFTAUYK,"Rhineland-Palatinate is divided into 24 districts , formerly grouped into the three administrative regions : Koblenz , Trier and Rheinhessen-Pfalz .",0,20,Rhineland-Palatinate,2,0,2
3GMLHYZ0LEYF6VO95X22Q1XTFTAUYK,"Rhineland-Palatinate is divided into 24 districts , formerly grouped into the three administrative regions : Koblenz , Trier and Rheinhessen-Pfalz .",40,49,districts,4,2,6
3GMLHYZ0LEYF6VO95X22Q1XTFTAUYK,"Rhineland-Palatinate is divided into 24 districts , formerly grouped into the three administrative regions : Koblenz , Trier and Rheinhessen-Pfalz .",52,60,formerly,0,3,3
3GMLHYZ0LEYF6VO95X22Q1XTFTAUYK,"Rhineland-Palatinate is divided into 24 districts , formerly grouped into the three administrative regions : Koblenz , Trier and Rheinhessen-Pfalz .",52,68,formerly grouped,0,1,1
3GMLHYZ0LEYF6VO95X22Q1XTFTAUYK,"Rhineland-Palatinate is divided into 24 districts , formerly grouped into the three administrative regions : Koblenz , Trier and Rheinhessen-Pfalz .",84,98,administrative,10,3,13
3GMLHYZ0LEYF6VO95X22Q1XTFTAUYK,"Rhineland-Palatinate is divided into 24 districts , formerly grouped into the three administrative regions : Koblenz , Trier and Rheinhessen-Pfalz .",84,106,administrative regions,3,2,5
3GMLHYZ0LEYF6VO95X22Q1XTFTAUYK,"Rhineland-Palatinate is divided into 24 districts , formerly grouped into the three administrative regions : Koblenz , Trier and Rheinhessen-Pfalz .",99,106,regions,4,0,4
3GMLHYZ0LEYF6VO95X22Q1XTFTAUYK,"Rhineland-Palatinate is divided into 24 districts , formerly grouped into the three administrative regions : Koblenz , Trier and Rheinhessen-Pfalz .",109,116,Koblenz,1,0,1
3GMLHYZ0LEYF6VO95X22Q1XTFTAUYK,"Rhineland-Palatinate is divided into 24 districts , formerly grouped into the three administrative regions : Koblenz , Trier and Rheinhessen-Pfalz .",109,146,"Koblenz , Trier and Rheinhessen-Pfalz",1,0,1
3GMLHYZ0LEYF6VO95X22Q1XTFTAUYK,"Rhineland-Palatinate is divided into 24 districts , formerly grouped into the three administrative regions : Koblenz , Trier and Rheinhessen-Pfalz .",129,146,Rheinhessen-Pfalz,3,0,3
3GMLHYZ0LEYF6VO95X22Q1XTFTAUYK,"It was formed from the northern part of the French Occupation Zone , which included parts of Bavaria ( the Rhenish Palatinate ) , the southern parts of the Prussian Rhine Province ( including the District of Birkenfeld , which formerly belonged to Oldenburg ) , parts of the Prussian Province of Nassau ( see Hesse-Nassau ) , and parts of Hesse-Darmstadt ( Rhinehessen on the western bank of the Rhine ) .",23,31,northern,0,1,1
3GMLHYZ0LEYF6VO95X22Q1XTFTAUYK,"It was formed from the northern part of the French Occupation Zone , which included parts of Bavaria ( the Rhenish Palatinate ) , the southern parts of the Prussian Rhine Province ( including the District of Birkenfeld , which formerly belonged to Oldenburg ) , parts of the Prussian Province of Nassau ( see Hesse-Nassau ) , and parts of Hesse-Darmstadt ( Rhinehessen on the western bank of the Rhine ) .",44,66,French Occupation Zone,4,1,5
3GMLHYZ0LEYF6VO95X22Q1XTFTAUYK,"It was formed from the northern part of the French Occupation Zone , which included parts of Bavaria ( the Rhenish Palatinate ) , the southern parts of the Prussian Rhine Province ( including the District of Birkenfeld , which formerly belonged to Oldenburg ) , parts of the Prussian Province of Nassau ( see Hesse-Nassau ) , and parts of Hesse-Darmstadt ( Rhinehessen on the western bank of the Rhine ) .",51,61,Occupation,1,2,3
3GMLHYZ0LEYF6VO95X22Q1XTFTAUYK,"It was formed from the northern part of the French Occupation Zone , which included parts of Bavaria ( the Rhenish Palatinate ) , the southern parts of the Prussian Rhine Province ( including the District of Birkenfeld , which formerly belonged to Oldenburg ) , parts of the Prussian Province of Nassau ( see Hesse-Nassau ) , and parts of Hesse-Darmstadt ( Rhinehessen on the western bank of the Rhine ) .",51,66,Occupation Zone,2,1,3
3GMLHYZ0LEYF6VO95X22Q1XTFTAUYK,"It was formed from the northern part of the French Occupation Zone , which included parts of Bavaria ( the Rhenish Palatinate ) , the southern parts of the Prussian Rhine Province ( including the District of Birkenfeld , which formerly belonged to Oldenburg ) , parts of the Prussian Province of Nassau ( see Hesse-Nassau ) , and parts of Hesse-Darmstadt ( Rhinehessen on the western bank of the Rhine ) .",62,66,Zone,0,1,1
3GMLHYZ0LEYF6VO95X22Q1XTFTAUYK,"It was formed from the northern part of the French Occupation Zone , which included parts of Bavaria ( the Rhenish Palatinate ) , the southern parts of the Prussian Rhine Province ( including the District of Birkenfeld , which formerly belonged to Oldenburg ) , parts of the Prussian Province of Nassau ( see Hesse-Nassau ) , and parts of Hesse-Darmstadt ( Rhinehessen on the western bank of the Rhine ) .",75,83,included,2,0,2
3GMLHYZ0LEYF6VO95X22Q1XTFTAUYK,"It was formed from the northern part of the French Occupation Zone , which included parts of Bavaria ( the Rhenish Palatinate ) , the southern parts of the Prussian Rhine Province ( including the District of Birkenfeld , which formerly belonged to Oldenburg ) , parts of the Prussian Province of Nassau ( see Hesse-Nassau ) , and parts of Hesse-Darmstadt ( Rhinehessen on the western bank of the Rhine ) .",107,114,Rhenish,1,0,1
3GMLHYZ0LEYF6VO95X22Q1XTFTAUYK,"It was formed from the northern part of the French Occupation Zone , which included parts of Bavaria ( the Rhenish Palatinate ) , the southern parts of the Prussian Rhine Province ( including the District of Birkenfeld , which formerly belonged to Oldenburg ) , parts of the Prussian Province of Nassau ( see Hesse-Nassau ) , and parts of Hesse-Darmstadt ( Rhinehessen on the western bank of the Rhine ) .",107,125,Rhenish Palatinate,1,0,1
3GMLHYZ0LEYF6VO95X22Q1XTFTAUYK,"It was formed from the northern part of the French Occupation Zone , which included parts of Bavaria ( the Rhenish Palatinate ) , the southern parts of the Prussian Rhine Province ( including the District of Birkenfeld , which formerly belonged to Oldenburg ) , parts of the Prussian Province of Nassau ( see Hesse-Nassau ) , and parts of Hesse-Darmstadt ( Rhinehessen on the western bank of the Rhine ) .",134,142,southern,0,1,1
3GMLHYZ0LEYF6VO95X22Q1XTFTAUYK,"It was formed from the northern part of the French Occupation Zone , which included parts of Bavaria ( the Rhenish Palatinate ) , the southern parts of the Prussian Rhine Province ( including the District of Birkenfeld , which formerly belonged to Oldenburg ) , parts of the Prussian Province of Nassau ( see Hesse-Nassau ) , and parts of Hesse-Darmstadt ( Rhinehessen on the western bank of the Rhine ) .",156,164,Prussian,1,0,1
3GMLHYZ0LEYF6VO95X22Q1XTFTAUYK,"It was formed from the northern part of the French Occupation Zone , which included parts of Bavaria ( the Rhenish Palatinate ) , the southern parts of the Prussian Rhine Province ( including the District of Birkenfeld , which formerly belonged to Oldenburg ) , parts of the Prussian Province of Nassau ( see Hesse-Nassau ) , and parts of Hesse-Darmstadt ( Rhinehessen on the western bank of the Rhine ) .",156,170,Prussian Rhine,1,0,1
3GMLHYZ0LEYF6VO95X22Q1XTFTAUYK,"It was formed from the northern part of the French Occupation Zone , which included parts of Bavaria ( the Rhenish Palatinate ) , the southern parts of the Prussian Rhine Province ( including the District of Birkenfeld , which formerly belonged to Oldenburg ) , parts of the Prussian Province of Nassau ( see Hesse-Nassau ) , and parts of Hesse-Darmstadt ( Rhinehessen on the western bank of the Rhine ) .",156,179,Prussian Rhine Province,1,0,1
3GMLHYZ0LEYF6VO95X22Q1XTFTAUYK,"It was formed from the northern part of the French Occupation Zone , which included parts of Bavaria ( the Rhenish Palatinate ) , the southern parts of the Prussian Rhine Province ( including the District of Birkenfeld , which formerly belonged to Oldenburg ) , parts of the Prussian Province of Nassau ( see Hesse-Nassau ) , and parts of Hesse-Darmstadt ( Rhinehessen on the western bank of the Rhine ) .",171,179,Province,2,4,6
3GMLHYZ0LEYF6VO95X22Q1XTFTAUYK,"It was formed from the northern part of the French Occupation Zone , which included parts of Bavaria ( the Rhenish Palatinate ) , the southern parts of the Prussian Rhine Province ( including the District of Birkenfeld , which formerly belonged to Oldenburg ) , parts of the Prussian Province of Nassau ( see Hesse-Nassau ) , and parts of Hesse-Darmstadt ( Rhinehessen on the western bank of the Rhine ) .",196,204,District,1,0,1
3GMLHYZ0LEYF6VO95X22Q1XTFTAUYK,"It was formed from the northern part of the French Occupation Zone , which included parts of Bavaria ( the Rhenish Palatinate ) , the southern parts of the Prussian Rhine Province ( including the District of Birkenfeld , which formerly belonged to Oldenburg ) , parts of the Prussian Province of Nassau ( see Hesse-Nassau ) , and parts of Hesse-Darmstadt ( Rhinehessen on the western bank of the Rhine ) .",208,218,Birkenfeld,1,1,2
3GMLHYZ0LEYF6VO95X22Q1XTFTAUYK,"It was formed from the northern part of the French Occupation Zone , which included parts of Bavaria ( the Rhenish Palatinate ) , the southern parts of the Prussian Rhine Province ( including the District of Birkenfeld , which formerly belonged to Oldenburg ) , parts of the Prussian Province of Nassau ( see Hesse-Nassau ) , and parts of Hesse-Darmstadt ( Rhinehessen on the western bank of the Rhine ) .",227,235,formerly,3,3,6
3GMLHYZ0LEYF6VO95X22Q1XTFTAUYK,"It was formed from the northern part of the French Occupation Zone , which included parts of Bavaria ( the Rhenish Palatinate ) , the southern parts of the Prussian Rhine Province ( including the District of Birkenfeld , which formerly belonged to Oldenburg ) , parts of the Prussian Province of Nassau ( see Hesse-Nassau ) , and parts of Hesse-Darmstadt ( Rhinehessen on the western bank of the Rhine ) .",227,244,formerly belonged,1,1,2
3GMLHYZ0LEYF6VO95X22Q1XTFTAUYK,"It was formed from the northern part of the French Occupation Zone , which included parts of Bavaria ( the Rhenish Palatinate ) , the southern parts of the Prussian Rhine Province ( including the District of Birkenfeld , which formerly belonged to Oldenburg ) , parts of the Prussian Province of Nassau ( see Hesse-Nassau ) , and parts of Hesse-Darmstadt ( Rhinehessen on the western bank of the Rhine ) .",236,244,belonged,1,4,5
3GMLHYZ0LEYF6VO95X22Q1XTFTAUYK,"It was formed from the northern part of the French Occupation Zone , which included parts of Bavaria ( the Rhenish Palatinate ) , the southern parts of the Prussian Rhine Province ( including the District of Birkenfeld , which formerly belonged to Oldenburg ) , parts of the Prussian Province of Nassau ( see Hesse-Nassau ) , and parts of Hesse-Darmstadt ( Rhinehessen on the western bank of the Rhine ) .",275,292,Prussian Province,1,0,1
3GMLHYZ0LEYF6VO95X22Q1XTFTAUYK,"It was formed from the northern part of the French Occupation Zone , which included parts of Bavaria ( the Rhenish Palatinate ) , the southern parts of the Prussian Rhine Province ( including the District of Birkenfeld , which formerly belonged to Oldenburg ) , parts of the Prussian Province of Nassau ( see Hesse-Nassau ) , and parts of Hesse-Darmstadt ( Rhinehessen on the western bank of the Rhine ) .",275,302,Prussian Province of Nassau,1,0,1
3GMLHYZ0LEYF6VO95X22Q1XTFTAUYK,"It was formed from the northern part of the French Occupation Zone , which included parts of Bavaria ( the Rhenish Palatinate ) , the southern parts of the Prussian Rhine Province ( including the District of Birkenfeld , which formerly belonged to Oldenburg ) , parts of the Prussian Province of Nassau ( see Hesse-Nassau ) , and parts of Hesse-Darmstadt ( Rhinehessen on the western bank of the Rhine ) .",284,292,Province,0,1,1
3GMLHYZ0LEYF6VO95X22Q1XTFTAUYK,"It was formed from the northern part of the French Occupation Zone , which included parts of Bavaria ( the Rhenish Palatinate ) , the southern parts of the Prussian Rhine Province ( including the District of Birkenfeld , which formerly belonged to Oldenburg ) , parts of the Prussian Province of Nassau ( see Hesse-Nassau ) , and parts of Hesse-Darmstadt ( Rhinehessen on the western bank of the Rhine ) .",309,321,Hesse-Nassau,1,0,1
3GMLHYZ0LEYF6VO95X22Q1XTFTAUYK,"It was formed from the northern part of the French Occupation Zone , which included parts of Bavaria ( the Rhenish Palatinate ) , the southern parts of the Prussian Rhine Province ( including the District of Birkenfeld , which formerly belonged to Oldenburg ) , parts of the Prussian Province of Nassau ( see Hesse-Nassau ) , and parts of Hesse-Darmstadt ( Rhinehessen on the western bank of the Rhine ) .",339,354,Hesse-Darmstadt,3,1,4
3GMLHYZ0LEYF6VO95X22Q1XTFTAUYK,"It was formed from the northern part of the French Occupation Zone , which included parts of Bavaria ( the Rhenish Palatinate ) , the southern parts of the Prussian Rhine Province ( including the District of Birkenfeld , which formerly belonged to Oldenburg ) , parts of the Prussian Province of Nassau ( see Hesse-Nassau ) , and parts of Hesse-Darmstadt ( Rhinehessen on the western bank of the Rhine ) .",376,388,western bank,0,1,1
3GMLHYZ0LEYF6VO95X22Q1XTFTAUYK,"It was formed from the northern part of the French Occupation Zone , which included parts of Bavaria ( the Rhenish Palatinate ) , the southern parts of the Prussian Rhine Province ( including the District of Birkenfeld , which formerly belonged to Oldenburg ) , parts of the Prussian Province of Nassau ( see Hesse-Nassau ) , and parts of Hesse-Darmstadt ( Rhinehessen on the western bank of the Rhine ) .",384,388,bank,1,0,1
366FYU4PTGQ3XU26BIM6DBWFVQ7KEY,"If you state in your request that the edits which led to your block were made by someone else ( for example , your little brother ) who accessed your account without your knowledge or permission , we will have to leave it blocked .",21,28,request,0,1,1
366FYU4PTGQ3XU26BIM6DBWFVQ7KEY,"If you state in your request that the edits which led to your block were made by someone else ( for example , your little brother ) who accessed your account without your knowledge or permission , we will have to leave it blocked .",38,43,edits,3,1,4
366FYU4PTGQ3XU26BIM6DBWFVQ7KEY,"If you state in your request that the edits which led to your block were made by someone else ( for example , your little brother ) who accessed your account without your knowledge or permission , we will have to leave it blocked .",62,67,block,1,0,1
366FYU4PTGQ3XU26BIM6DBWFVQ7KEY,"If you state in your request that the edits which led to your block were made by someone else ( for example , your little brother ) who accessed your account without your knowledge or permission , we will have to leave it blocked .",100,107,example,1,0,1
366FYU4PTGQ3XU26BIM6DBWFVQ7KEY,"If you state in your request that the edits which led to your block were made by someone else ( for example , your little brother ) who accessed your account without your knowledge or permission , we will have to leave it blocked .",136,144,accessed,10,4,14
366FYU4PTGQ3XU26BIM6DBWFVQ7KEY,"If you state in your request that the edits which led to your block were made by someone else ( for example , your little brother ) who accessed your account without your knowledge or permission , we will have to leave it blocked .",136,157,accessed your account,1,0,1
366FYU4PTGQ3XU26BIM6DBWFVQ7KEY,"If you state in your request that the edits which led to your block were made by someone else ( for example , your little brother ) who accessed your account without your knowledge or permission , we will have to leave it blocked .",171,180,knowledge,0,3,3
366FYU4PTGQ3XU26BIM6DBWFVQ7KEY,"If you state in your request that the edits which led to your block were made by someone else ( for example , your little brother ) who accessed your account without your knowledge or permission , we will have to leave it blocked .",184,194,permission,5,4,9
366FYU4PTGQ3XU26BIM6DBWFVQ7KEY,"If you state in your request that the edits which led to your block were made by someone else ( for example , your little brother ) who accessed your account without your knowledge or permission , we will have to leave it blocked .",222,229,blocked,1,1,2
366FYU4PTGQ3XU26BIM6DBWFVQ7KEY,"The Arbitration Committee has explained the procedure to be followed with respect to the review of blocks based on CheckUser data as follows : Do not make an unblock request that includes a request for checkuser to `` prove your innocence '' ... as indicated at Sockpuppet investigations those are so rarely done that you 're better off not asking ( besides , it is difficult to use it to prove that two editors are different people ) .",4,15,Arbitration,8,4,12
366FYU4PTGQ3XU26BIM6DBWFVQ7KEY,"The Arbitration Committee has explained the procedure to be followed with respect to the review of blocks based on CheckUser data as follows : Do not make an unblock request that includes a request for checkuser to `` prove your innocence '' ... as indicated at Sockpuppet investigations those are so rarely done that you 're better off not asking ( besides , it is difficult to use it to prove that two editors are different people ) .",4,25,Arbitration Committee,2,2,4
366FYU4PTGQ3XU26BIM6DBWFVQ7KEY,"The Arbitration Committee has explained the procedure to be followed with respect to the review of blocks based on CheckUser data as follows : Do not make an unblock request that includes a request for checkuser to `` prove your innocence '' ... as indicated at Sockpuppet investigations those are so rarely done that you 're better off not asking ( besides , it is difficult to use it to prove that two editors are different people ) .",16,25,Committee,2,2,4
366FYU4PTGQ3XU26BIM6DBWFVQ7KEY,"The Arbitration Committee has explained the procedure to be followed with respect to the review of blocks based on CheckUser data as follows : Do not make an unblock request that includes a request for checkuser to `` prove your innocence '' ... as indicated at Sockpuppet investigations those are so rarely done that you 're better off not asking ( besides , it is difficult to use it to prove that two editors are different people ) .",44,53,procedure,8,3,11
366FYU4PTGQ3XU26BIM6DBWFVQ7KEY,"The Arbitration Committee has explained the procedure to be followed with respect to the review of blocks based on CheckUser data as follows : Do not make an unblock request that includes a request for checkuser to `` prove your innocence '' ... as indicated at Sockpuppet investigations those are so rarely done that you 're better off not asking ( besides , it is difficult to use it to prove that two editors are different people ) .",89,95,review,0,2,2
366FYU4PTGQ3XU26BIM6DBWFVQ7KEY,"The Arbitration Committee has explained the procedure to be followed with respect to the review of blocks based on CheckUser data as follows : Do not make an unblock request that includes a request for checkuser to `` prove your innocence '' ... as indicated at Sockpuppet investigations those are so rarely done that you 're better off not asking ( besides , it is difficult to use it to prove that two editors are different people ) .",99,105,blocks,1,0,1
366FYU4PTGQ3XU26BIM6DBWFVQ7KEY,"The Arbitration Committee has explained the procedure to be followed with respect to the review of blocks based on CheckUser data as follows : Do not make an unblock request that includes a request for checkuser to `` prove your innocence '' ... as indicated at Sockpuppet investigations those are so rarely done that you 're better off not asking ( besides , it is difficult to use it to prove that two editors are different people ) .",115,124,CheckUser,3,1,4
366FYU4PTGQ3XU26BIM6DBWFVQ7KEY,"The Arbitration Committee has explained the procedure to be followed with respect to the review of blocks based on CheckUser data as follows : Do not make an unblock request that includes a request for checkuser to `` prove your innocence '' ... as indicated at Sockpuppet investigations those are so rarely done that you 're better off not asking ( besides , it is difficult to use it to prove that two editors are different people ) .",125,129,data,1,2,3
366FYU4PTGQ3XU26BIM6DBWFVQ7KEY,"The Arbitration Committee has explained the procedure to be followed with respect to the review of blocks based on CheckUser data as follows : Do not make an unblock request that includes a request for checkuser to `` prove your innocence '' ... as indicated at Sockpuppet investigations those are so rarely done that you 're better off not asking ( besides , it is difficult to use it to prove that two editors are different people ) .",133,140,follows,0,1,1
366FYU4PTGQ3XU26BIM6DBWFVQ7KEY,"The Arbitration Committee has explained the procedure to be followed with respect to the review of blocks based on CheckUser data as follows : Do not make an unblock request that includes a request for checkuser to `` prove your innocence '' ... as indicated at Sockpuppet investigations those are so rarely done that you 're better off not asking ( besides , it is difficult to use it to prove that two editors are different people ) .",158,165,unblock,1,0,1
366FYU4PTGQ3XU26BIM6DBWFVQ7KEY,"The Arbitration Committee has explained the procedure to be followed with respect to the review of blocks based on CheckUser data as follows : Do not make an unblock request that includes a request for checkuser to `` prove your innocence '' ... as indicated at Sockpuppet investigations those are so rarely done that you 're better off not asking ( besides , it is difficult to use it to prove that two editors are different people ) .",202,211,checkuser,4,4,8
366FYU4PTGQ3XU26BIM6DBWFVQ7KEY,"The Arbitration Committee has explained the procedure to be followed with respect to the review of blocks based on CheckUser data as follows : Do not make an unblock request that includes a request for checkuser to `` prove your innocence '' ... as indicated at Sockpuppet investigations those are so rarely done that you 're better off not asking ( besides , it is difficult to use it to prove that two editors are different people ) .",229,238,innocence,4,6,10
366FYU4PTGQ3XU26BIM6DBWFVQ7KEY,"The Arbitration Committee has explained the procedure to be followed with respect to the review of blocks based on CheckUser data as follows : Do not make an unblock request that includes a request for checkuser to `` prove your innocence '' ... as indicated at Sockpuppet investigations those are so rarely done that you 're better off not asking ( besides , it is difficult to use it to prove that two editors are different people ) .",249,258,indicated,2,1,3
366FYU4PTGQ3XU26BIM6DBWFVQ7KEY,"The Arbitration Committee has explained the procedure to be followed with respect to the review of blocks based on CheckUser data as follows : Do not make an unblock request that includes a request for checkuser to `` prove your innocence '' ... as indicated at Sockpuppet investigations those are so rarely done that you 're better off not asking ( besides , it is difficult to use it to prove that two editors are different people ) .",262,272,Sockpuppet,5,10,15
366FYU4PTGQ3XU26BIM6DBWFVQ7KEY,"The Arbitration Committee has explained the procedure to be followed with respect to the review of blocks based on CheckUser data as follows : Do not make an unblock request that includes a request for checkuser to `` prove your innocence '' ... as indicated at Sockpuppet investigations those are so rarely done that you 're better off not asking ( besides , it is difficult to use it to prove that two editors are different people ) .",262,287,Sockpuppet investigations,2,1,3
366FYU4PTGQ3XU26BIM6DBWFVQ7KEY,"The Arbitration Committee has explained the procedure to be followed with respect to the review of blocks based on CheckUser data as follows : Do not make an unblock request that includes a request for checkuser to `` prove your innocence '' ... as indicated at Sockpuppet investigations those are so rarely done that you 're better off not asking ( besides , it is difficult to use it to prove that two editors are different people ) .",273,287,investigations,7,4,11
366FYU4PTGQ3XU26BIM6DBWFVQ7KEY,"The Arbitration Committee has explained the procedure to be followed with respect to the review of blocks based on CheckUser data as follows : Do not make an unblock request that includes a request for checkuser to `` prove your innocence '' ... as indicated at Sockpuppet investigations those are so rarely done that you 're better off not asking ( besides , it is difficult to use it to prove that two editors are different people ) .",350,357,besides,0,1,1
366FYU4PTGQ3XU26BIM6DBWFVQ7KEY,"The Arbitration Committee has explained the procedure to be followed with respect to the review of blocks based on CheckUser data as follows : Do not make an unblock request that includes a request for checkuser to `` prove your innocence '' ... as indicated at Sockpuppet investigations those are so rarely done that you 're better off not asking ( besides , it is difficult to use it to prove that two editors are different people ) .",366,375,difficult,1,0,1
366FYU4PTGQ3XU26BIM6DBWFVQ7KEY,"The Arbitration Committee has explained the procedure to be followed with respect to the review of blocks based on CheckUser data as follows : Do not make an unblock request that includes a request for checkuser to `` prove your innocence '' ... as indicated at Sockpuppet investigations those are so rarely done that you 're better off not asking ( besides , it is difficult to use it to prove that two editors are different people ) .",404,411,editors,3,0,3
3AXFSPQOYQZ0SOWKO860UEH2S2MFJC,"The historic center of Quito has one of the largest , least-altered and best-preserved historic centers in the Americas .",4,12,historic,3,0,3
3AXFSPQOYQZ0SOWKO860UEH2S2MFJC,"The historic center of Quito has one of the largest , least-altered and best-preserved historic centers in the Americas .",23,28,Quito,1,0,1
3AXFSPQOYQZ0SOWKO860UEH2S2MFJC,"The historic center of Quito has one of the largest , least-altered and best-preserved historic centers in the Americas .",54,67,least-altered,8,9,17
3AXFSPQOYQZ0SOWKO860UEH2S2MFJC,"The historic center of Quito has one of the largest , least-altered and best-preserved historic centers in the Americas .",72,86,best-preserved,4,5,9
3AXFSPQOYQZ0SOWKO860UEH2S2MFJC,"The historic center of Quito has one of the largest , least-altered and best-preserved historic centers in the Americas .",87,95,historic,1,0,1
3AXFSPQOYQZ0SOWKO860UEH2S2MFJC,"Church of Santo Domingo Although they arrived in Quito in 1541 , in 1580 the Dominicans started to build their temple , using the plans and direction of Francisco Becerra .",77,87,Dominicans,1,2,3
3AXFSPQOYQZ0SOWKO860UEH2S2MFJC,"Church of Santo Domingo Although they arrived in Quito in 1541 , in 1580 the Dominicans started to build their temple , using the plans and direction of Francisco Becerra .",99,104,build,0,1,1
3AXFSPQOYQZ0SOWKO860UEH2S2MFJC,"Church of Santo Domingo Although they arrived in Quito in 1541 , in 1580 the Dominicans started to build their temple , using the plans and direction of Francisco Becerra .",111,117,temple,2,1,3
3AXFSPQOYQZ0SOWKO860UEH2S2MFJC,"Church of Santo Domingo Although they arrived in Quito in 1541 , in 1580 the Dominicans started to build their temple , using the plans and direction of Francisco Becerra .",140,149,direction,0,1,1
3AXFSPQOYQZ0SOWKO860UEH2S2MFJC,"This church began its construction in 1562 , seventeen years after the diocese of Quito was created ( 1545 ) .",22,34,construction,2,3,5
3AXFSPQOYQZ0SOWKO860UEH2S2MFJC,"This church began its construction in 1562 , seventeen years after the diocese of Quito was created ( 1545 ) .",71,78,diocese,10,6,16
3AXFSPQOYQZ0SOWKO860UEH2S2MFJC,"During the Republican era , almost all the presidents ( constitutional , internees and dictators ) have dispatched from this building , which is the seat of Government of the Republic of Ecuador .",11,21,Republican,4,0,4
3AXFSPQOYQZ0SOWKO860UEH2S2MFJC,"During the Republican era , almost all the presidents ( constitutional , internees and dictators ) have dispatched from this building , which is the seat of Government of the Republic of Ecuador .",11,25,Republican era,0,1,1
3AXFSPQOYQZ0SOWKO860UEH2S2MFJC,"During the Republican era , almost all the presidents ( constitutional , internees and dictators ) have dispatched from this building , which is the seat of Government of the Republic of Ecuador .",22,25,era,2,1,3
3AXFSPQOYQZ0SOWKO860UEH2S2MFJC,"During the Republican era , almost all the presidents ( constitutional , internees and dictators ) have dispatched from this building , which is the seat of Government of the Republic of Ecuador .",43,53,presidents,0,1,1
3AXFSPQOYQZ0SOWKO860UEH2S2MFJC,"During the Republican era , almost all the presidents ( constitutional , internees and dictators ) have dispatched from this building , which is the seat of Government of the Republic of Ecuador .",56,70,constitutional,0,4,4
3AXFSPQOYQZ0SOWKO860UEH2S2MFJC,"During the Republican era , almost all the presidents ( constitutional , internees and dictators ) have dispatched from this building , which is the seat of Government of the Republic of Ecuador .",56,96,"constitutional , internees and dictators",1,0,1
3AXFSPQOYQZ0SOWKO860UEH2S2MFJC,"During the Republican era , almost all the presidents ( constitutional , internees and dictators ) have dispatched from this building , which is the seat of Government of the Republic of Ecuador .",73,82,internees,10,8,18
3AXFSPQOYQZ0SOWKO860UEH2S2MFJC,"During the Republican era , almost all the presidents ( constitutional , internees and dictators ) have dispatched from this building , which is the seat of Government of the Republic of Ecuador .",87,96,dictators,5,5,10
3AXFSPQOYQZ0SOWKO860UEH2S2MFJC,"During the Republican era , almost all the presidents ( constitutional , internees and dictators ) have dispatched from this building , which is the seat of Government of the Republic of Ecuador .",104,114,dispatched,9,10,19
3AXFSPQOYQZ0SOWKO860UEH2S2MFJC,"During the Republican era , almost all the presidents ( constitutional , internees and dictators ) have dispatched from this building , which is the seat of Government of the Republic of Ecuador .",149,153,seat,0,2,2
3AXFSPQOYQZ0SOWKO860UEH2S2MFJC,"Quito , along with Kraków , were the first World Cultural Heritage Sites declared by UNESCO in 1978 .",0,5,Quito,1,0,1
3AXFSPQOYQZ0SOWKO860UEH2S2MFJC,"Quito , along with Kraków , were the first World Cultural Heritage Sites declared by UNESCO in 1978 .",19,25,Kraków,1,0,1
3AXFSPQOYQZ0SOWKO860UEH2S2MFJC,"Quito , along with Kraków , were the first World Cultural Heritage Sites declared by UNESCO in 1978 .",43,72,World Cultural Heritage Sites,2,0,2
3AXFSPQOYQZ0SOWKO860UEH2S2MFJC,"Quito , along with Kraków , were the first World Cultural Heritage Sites declared by UNESCO in 1978 .",49,66,Cultural Heritage,1,0,1
3AXFSPQOYQZ0SOWKO860UEH2S2MFJC,"Quito , along with Kraków , were the first World Cultural Heritage Sites declared by UNESCO in 1978 .",49,72,Cultural Heritage Sites,1,0,1
3AXFSPQOYQZ0SOWKO860UEH2S2MFJC,"Quito , along with Kraków , were the first World Cultural Heritage Sites declared by UNESCO in 1978 .",58,66,Heritage,3,3,6
3AXFSPQOYQZ0SOWKO860UEH2S2MFJC,"Quito , along with Kraków , were the first World Cultural Heritage Sites declared by UNESCO in 1978 .",58,72,Heritage Sites,0,1,1
3AXFSPQOYQZ0SOWKO860UEH2S2MFJC,"Quito , along with Kraków , were the first World Cultural Heritage Sites declared by UNESCO in 1978 .",85,91,UNESCO,1,0,1
