HIT_ID,Sentence,Start_Offset,End_Offset,Complex_Phrase,Native_Annotators,Non_Native_Annotators,Total_Annotators
371DNNCG443LRCI2SOEYMSNP2TRT8Q,"#10-31 In a Wall Street Journal interview published on Friday Trump indicated he wishes to maintain sanctions against Russia ""at least for a period of time,"" but ultimately remove them as relations improve.",42,51,published,2,0,2
371DNNCG443LRCI2SOEYMSNP2TRT8Q,"#10-31 In a Wall Street Journal interview published on Friday Trump indicated he wishes to maintain sanctions against Russia ""at least for a period of time,"" but ultimately remove them as relations improve.",68,77,indicated,2,5,7
371DNNCG443LRCI2SOEYMSNP2TRT8Q,"#10-31 In a Wall Street Journal interview published on Friday Trump indicated he wishes to maintain sanctions against Russia ""at least for a period of time,"" but ultimately remove them as relations improve.",91,99,maintain,1,1,2
371DNNCG443LRCI2SOEYMSNP2TRT8Q,"#10-31 In a Wall Street Journal interview published on Friday Trump indicated he wishes to maintain sanctions against Russia ""at least for a period of time,"" but ultimately remove them as relations improve.",91,109,maintain sanctions,1,0,1
371DNNCG443LRCI2SOEYMSNP2TRT8Q,"#10-31 In a Wall Street Journal interview published on Friday Trump indicated he wishes to maintain sanctions against Russia ""at least for a period of time,"" but ultimately remove them as relations improve.",100,109,sanctions,9,6,15
371DNNCG443LRCI2SOEYMSNP2TRT8Q,"#10-31 In a Wall Street Journal interview published on Friday Trump indicated he wishes to maintain sanctions against Russia ""at least for a period of time,"" but ultimately remove them as relations improve.",162,172,ultimately,5,7,12
371DNNCG443LRCI2SOEYMSNP2TRT8Q,"#10-31 In a Wall Street Journal interview published on Friday Trump indicated he wishes to maintain sanctions against Russia ""at least for a period of time,"" but ultimately remove them as relations improve.",188,197,relations,2,1,3
371DNNCG443LRCI2SOEYMSNP2TRT8Q,"#10-31 In a Wall Street Journal interview published on Friday Trump indicated he wishes to maintain sanctions against Russia ""at least for a period of time,"" but ultimately remove them as relations improve.",188,205,relations improve,0,1,1
371DNNCG443LRCI2SOEYMSNP2TRT8Q,"#10-31 In a Wall Street Journal interview published on Friday Trump indicated he wishes to maintain sanctions against Russia ""at least for a period of time,"" but ultimately remove them as relations improve.",198,205,improve,0,2,2
371DNNCG443LRCI2SOEYMSNP2TRT8Q,"#10-32 ""If you get along and if Russia is really helping us, why would anybody have sanctions if somebodyâ€™s doing some really great things?""",84,93,sanctions,5,1,6
371DNNCG443LRCI2SOEYMSNP2TRT8Q,"#10-34 Outgoing CIA director John Brennan said yesterday Trump ""doesn't understand Russia"" and expressed concerns the US President-Elect's spontaneity would damage US national security.",7,15,Outgoing,0,2,2
371DNNCG443LRCI2SOEYMSNP2TRT8Q,"#10-34 Outgoing CIA director John Brennan said yesterday Trump ""doesn't understand Russia"" and expressed concerns the US President-Elect's spontaneity would damage US national security.",95,104,expressed,3,3,6
371DNNCG443LRCI2SOEYMSNP2TRT8Q,"#10-34 Outgoing CIA director John Brennan said yesterday Trump ""doesn't understand Russia"" and expressed concerns the US President-Elect's spontaneity would damage US national security.",105,113,concerns,1,3,4
371DNNCG443LRCI2SOEYMSNP2TRT8Q,"#10-34 Outgoing CIA director John Brennan said yesterday Trump ""doesn't understand Russia"" and expressed concerns the US President-Elect's spontaneity would damage US national security.",139,150,spontaneity,10,9,19
371DNNCG443LRCI2SOEYMSNP2TRT8Q,"#10-34 Outgoing CIA director John Brennan said yesterday Trump ""doesn't understand Russia"" and expressed concerns the US President-Elect's spontaneity would damage US national security.",157,163,damage,0,3,3
371DNNCG443LRCI2SOEYMSNP2TRT8Q,"#10-34 Outgoing CIA director John Brennan said yesterday Trump ""doesn't understand Russia"" and expressed concerns the US President-Elect's spontaneity would damage US national security.",167,184,national security,1,0,1
371DNNCG443LRCI2SOEYMSNP2TRT8Q,"#10-35 A total of around 4,000 troops are pledged to the region.",31,37,troops,1,1,2
371DNNCG443LRCI2SOEYMSNP2TRT8Q,"#10-35 A total of around 4,000 troops are pledged to the region.",42,49,pledged,5,9,14
371DNNCG443LRCI2SOEYMSNP2TRT8Q,"#10-35 A total of around 4,000 troops are pledged to the region.",42,63,pledged to the region,1,0,1
371DNNCG443LRCI2SOEYMSNP2TRT8Q,"#11-1 Geneticists produce laser-activated killer mice In research released on Thursday in Cell, scientists from Yale University report they managed to trigger instinctive hunting behavior in mice using optogenetics, a manner of priming cells within an organism's brain to switch on when exposed to a laser.",6,17,Geneticists,9,5,14
371DNNCG443LRCI2SOEYMSNP2TRT8Q,"#11-1 Geneticists produce laser-activated killer mice In research released on Thursday in Cell, scientists from Yale University report they managed to trigger instinctive hunting behavior in mice using optogenetics, a manner of priming cells within an organism's brain to switch on when exposed to a laser.",26,41,laser-activated,5,4,9
371DNNCG443LRCI2SOEYMSNP2TRT8Q,"#11-1 Geneticists produce laser-activated killer mice In research released on Thursday in Cell, scientists from Yale University report they managed to trigger instinctive hunting behavior in mice using optogenetics, a manner of priming cells within an organism's brain to switch on when exposed to a laser.",140,147,managed,1,0,1
371DNNCG443LRCI2SOEYMSNP2TRT8Q,"#11-1 Geneticists produce laser-activated killer mice In research released on Thursday in Cell, scientists from Yale University report they managed to trigger instinctive hunting behavior in mice using optogenetics, a manner of priming cells within an organism's brain to switch on when exposed to a laser.",148,158,to trigger,1,0,1
371DNNCG443LRCI2SOEYMSNP2TRT8Q,"#11-1 Geneticists produce laser-activated killer mice In research released on Thursday in Cell, scientists from Yale University report they managed to trigger instinctive hunting behavior in mice using optogenetics, a manner of priming cells within an organism's brain to switch on when exposed to a laser.",151,158,trigger,2,8,10
371DNNCG443LRCI2SOEYMSNP2TRT8Q,"#11-1 Geneticists produce laser-activated killer mice In research released on Thursday in Cell, scientists from Yale University report they managed to trigger instinctive hunting behavior in mice using optogenetics, a manner of priming cells within an organism's brain to switch on when exposed to a laser.",151,170,trigger instinctive,1,1,2
371DNNCG443LRCI2SOEYMSNP2TRT8Q,"#11-1 Geneticists produce laser-activated killer mice In research released on Thursday in Cell, scientists from Yale University report they managed to trigger instinctive hunting behavior in mice using optogenetics, a manner of priming cells within an organism's brain to switch on when exposed to a laser.",159,170,instinctive,8,7,15
371DNNCG443LRCI2SOEYMSNP2TRT8Q,"#11-1 Geneticists produce laser-activated killer mice In research released on Thursday in Cell, scientists from Yale University report they managed to trigger instinctive hunting behavior in mice using optogenetics, a manner of priming cells within an organism's brain to switch on when exposed to a laser.",171,178,hunting,1,0,1
371DNNCG443LRCI2SOEYMSNP2TRT8Q,"#11-1 Geneticists produce laser-activated killer mice In research released on Thursday in Cell, scientists from Yale University report they managed to trigger instinctive hunting behavior in mice using optogenetics, a manner of priming cells within an organism's brain to switch on when exposed to a laser.",191,195,mice,0,1,1
371DNNCG443LRCI2SOEYMSNP2TRT8Q,"#11-1 Geneticists produce laser-activated killer mice In research released on Thursday in Cell, scientists from Yale University report they managed to trigger instinctive hunting behavior in mice using optogenetics, a manner of priming cells within an organism's brain to switch on when exposed to a laser.",202,214,optogenetics,10,8,18
371DNNCG443LRCI2SOEYMSNP2TRT8Q,"#11-1 Geneticists produce laser-activated killer mice In research released on Thursday in Cell, scientists from Yale University report they managed to trigger instinctive hunting behavior in mice using optogenetics, a manner of priming cells within an organism's brain to switch on when exposed to a laser.",228,235,priming,3,3,6
371DNNCG443LRCI2SOEYMSNP2TRT8Q,"#11-1 Geneticists produce laser-activated killer mice In research released on Thursday in Cell, scientists from Yale University report they managed to trigger instinctive hunting behavior in mice using optogenetics, a manner of priming cells within an organism's brain to switch on when exposed to a laser.",228,241,priming cells,0,2,2
371DNNCG443LRCI2SOEYMSNP2TRT8Q,"#11-1 Geneticists produce laser-activated killer mice In research released on Thursday in Cell, scientists from Yale University report they managed to trigger instinctive hunting behavior in mice using optogenetics, a manner of priming cells within an organism's brain to switch on when exposed to a laser.",252,261,organisms,3,2,5
371DNNCG443LRCI2SOEYMSNP2TRT8Q,"#11-1 Geneticists produce laser-activated killer mice In research released on Thursday in Cell, scientists from Yale University report they managed to trigger instinctive hunting behavior in mice using optogenetics, a manner of priming cells within an organism's brain to switch on when exposed to a laser.",272,281,switch on,0,1,1
371DNNCG443LRCI2SOEYMSNP2TRT8Q,"#11-1 Geneticists produce laser-activated killer mice In research released on Thursday in Cell, scientists from Yale University report they managed to trigger instinctive hunting behavior in mice using optogenetics, a manner of priming cells within an organism's brain to switch on when exposed to a laser.",287,294,exposed,1,3,4
3UQVX1UPFSI9POJME5HNSQ8HJI320L,"#32-6 However, he is listed on the Republican Party's website as one of 18 candidates and filed a Federal Election Commission (FEC) complaint against Fox News for his exclusion from the August 6 debate.",21,27,listed,0,1,1
3UQVX1UPFSI9POJME5HNSQ8HJI320L,"#32-6 However, he is listed on the Republican Party's website as one of 18 candidates and filed a Federal Election Commission (FEC) complaint against Fox News for his exclusion from the August 6 debate.",21,45,listed on the Republican,0,1,1
3UQVX1UPFSI9POJME5HNSQ8HJI320L,"#32-6 However, he is listed on the Republican Party's website as one of 18 candidates and filed a Federal Election Commission (FEC) complaint against Fox News for his exclusion from the August 6 debate.",35,45,Republican,1,1,2
3UQVX1UPFSI9POJME5HNSQ8HJI320L,"#32-6 However, he is listed on the Republican Party's website as one of 18 candidates and filed a Federal Election Commission (FEC) complaint against Fox News for his exclusion from the August 6 debate.",35,51,Republican Party,1,0,1
3UQVX1UPFSI9POJME5HNSQ8HJI320L,"#32-6 However, he is listed on the Republican Party's website as one of 18 candidates and filed a Federal Election Commission (FEC) complaint against Fox News for his exclusion from the August 6 debate.",75,85,candidates,3,1,4
3UQVX1UPFSI9POJME5HNSQ8HJI320L,"#32-6 However, he is listed on the Republican Party's website as one of 18 candidates and filed a Federal Election Commission (FEC) complaint against Fox News for his exclusion from the August 6 debate.",98,105,Federal,0,1,1
3UQVX1UPFSI9POJME5HNSQ8HJI320L,"#32-6 However, he is listed on the Republican Party's website as one of 18 candidates and filed a Federal Election Commission (FEC) complaint against Fox News for his exclusion from the August 6 debate.",98,125,Federal Election Commission,2,0,2
3UQVX1UPFSI9POJME5HNSQ8HJI320L,"#32-6 However, he is listed on the Republican Party's website as one of 18 candidates and filed a Federal Election Commission (FEC) complaint against Fox News for his exclusion from the August 6 debate.",115,125,Commission,3,0,3
3UQVX1UPFSI9POJME5HNSQ8HJI320L,"#32-6 However, he is listed on the Republican Party's website as one of 18 candidates and filed a Federal Election Commission (FEC) complaint against Fox News for his exclusion from the August 6 debate.",132,141,complaint,1,3,4
3UQVX1UPFSI9POJME5HNSQ8HJI320L,"#32-6 However, he is listed on the Republican Party's website as one of 18 candidates and filed a Federal Election Commission (FEC) complaint against Fox News for his exclusion from the August 6 debate.",167,176,exclusion,8,6,14
3UQVX1UPFSI9POJME5HNSQ8HJI320L,"#32-6 However, he is listed on the Republican Party's website as one of 18 candidates and filed a Federal Election Commission (FEC) complaint against Fox News for his exclusion from the August 6 debate.",195,201,debate,0,2,2
3UQVX1UPFSI9POJME5HNSQ8HJI320L,"#32-7 With Wikinews reporter William S. Saturnâ€Ž, Everson discusses his 2016 campaign, the media blackout of his campaign, and his views on the presidency and the possible Everson administration.",11,19,Wikinews,2,0,2
3UQVX1UPFSI9POJME5HNSQ8HJI320L,"#32-7 With Wikinews reporter William S. Saturnâ€Ž, Everson discusses his 2016 campaign, the media blackout of his campaign, and his views on the presidency and the possible Everson administration.",20,28,reporter,0,1,1
3UQVX1UPFSI9POJME5HNSQ8HJI320L,"#32-7 With Wikinews reporter William S. Saturnâ€Ž, Everson discusses his 2016 campaign, the media blackout of his campaign, and his views on the presidency and the possible Everson administration.",40,56,"Saturnâ€Ž, Everson",0,1,1
3UQVX1UPFSI9POJME5HNSQ8HJI320L,"#32-7 With Wikinews reporter William S. Saturnâ€Ž, Everson discusses his 2016 campaign, the media blackout of his campaign, and his views on the presidency and the possible Everson administration.",57,66,discusses,0,1,1
3UQVX1UPFSI9POJME5HNSQ8HJI320L,"#32-7 With Wikinews reporter William S. Saturnâ€Ž, Everson discusses his 2016 campaign, the media blackout of his campaign, and his views on the presidency and the possible Everson administration.",76,84,campaign,0,3,3
3UQVX1UPFSI9POJME5HNSQ8HJI320L,"#32-7 With Wikinews reporter William S. Saturnâ€Ž, Everson discusses his 2016 campaign, the media blackout of his campaign, and his views on the presidency and the possible Everson administration.",90,104,media blackout,0,1,1
3UQVX1UPFSI9POJME5HNSQ8HJI320L,"#32-7 With Wikinews reporter William S. Saturnâ€Ž, Everson discusses his 2016 campaign, the media blackout of his campaign, and his views on the presidency and the possible Everson administration.",96,104,blackout,3,6,9
3UQVX1UPFSI9POJME5HNSQ8HJI320L,"#32-7 With Wikinews reporter William S. Saturnâ€Ž, Everson discusses his 2016 campaign, the media blackout of his campaign, and his views on the presidency and the possible Everson administration.",112,120,campaign,2,3,5
3UQVX1UPFSI9POJME5HNSQ8HJI320L,"#32-7 With Wikinews reporter William S. Saturnâ€Ž, Everson discusses his 2016 campaign, the media blackout of his campaign, and his views on the presidency and the possible Everson administration.",143,153,presidency,4,1,5
3UQVX1UPFSI9POJME5HNSQ8HJI320L,"#32-7 With Wikinews reporter William S. Saturnâ€Ž, Everson discusses his 2016 campaign, the media blackout of his campaign, and his views on the presidency and the possible Everson administration.",171,178,Everson,0,1,1
3UQVX1UPFSI9POJME5HNSQ8HJI320L,"#32-7 With Wikinews reporter William S. Saturnâ€Ž, Everson discusses his 2016 campaign, the media blackout of his campaign, and his views on the presidency and the possible Everson administration.",179,193,administration,6,4,10
3UQVX1UPFSI9POJME5HNSQ8HJI320L,#33-1 Cilla Black funeral held in Liverpool Stars from the world of showbusiness joined fans and mourners yesterday at the funeral of the popular entertainer Cilla Black.,18,25,funeral,5,4,9
3UQVX1UPFSI9POJME5HNSQ8HJI320L,#33-1 Cilla Black funeral held in Liverpool Stars from the world of showbusiness joined fans and mourners yesterday at the funeral of the popular entertainer Cilla Black.,26,30,held,0,1,1
3UQVX1UPFSI9POJME5HNSQ8HJI320L,#33-1 Cilla Black funeral held in Liverpool Stars from the world of showbusiness joined fans and mourners yesterday at the funeral of the popular entertainer Cilla Black.,68,80,showbusiness,5,4,9
3UQVX1UPFSI9POJME5HNSQ8HJI320L,#33-1 Cilla Black funeral held in Liverpool Stars from the world of showbusiness joined fans and mourners yesterday at the funeral of the popular entertainer Cilla Black.,97,105,mourners,6,8,14
3UQVX1UPFSI9POJME5HNSQ8HJI320L,#33-1 Cilla Black funeral held in Liverpool Stars from the world of showbusiness joined fans and mourners yesterday at the funeral of the popular entertainer Cilla Black.,123,130,funeral,2,1,3
3UQVX1UPFSI9POJME5HNSQ8HJI320L,#33-1 Cilla Black funeral held in Liverpool Stars from the world of showbusiness joined fans and mourners yesterday at the funeral of the popular entertainer Cilla Black.,146,157,entertainer,2,4,6
3UQVX1UPFSI9POJME5HNSQ8HJI320L,"#33-2 Her coffin was transported in a cortege in Liverpool where she grew up, with hundreds of people paying their respects.",10,16,coffin,3,3,6
3UQVX1UPFSI9POJME5HNSQ8HJI320L,"#33-2 Her coffin was transported in a cortege in Liverpool where she grew up, with hundreds of people paying their respects.",21,32,transported,3,3,6
3UQVX1UPFSI9POJME5HNSQ8HJI320L,"#33-2 Her coffin was transported in a cortege in Liverpool where she grew up, with hundreds of people paying their respects.",21,45,transported in a cortege,0,1,1
3UQVX1UPFSI9POJME5HNSQ8HJI320L,"#33-2 Her coffin was transported in a cortege in Liverpool where she grew up, with hundreds of people paying their respects.",38,45,cortege,9,9,18
3UQVX1UPFSI9POJME5HNSQ8HJI320L,"#33-2 Her coffin was transported in a cortege in Liverpool where she grew up, with hundreds of people paying their respects.",69,73,grew,0,1,1
3UQVX1UPFSI9POJME5HNSQ8HJI320L,"#33-2 Her coffin was transported in a cortege in Liverpool where she grew up, with hundreds of people paying their respects.",115,123,respects,0,1,1
3UQVX1UPFSI9POJME5HNSQ8HJI320L,"#33-3 Some were holding memorabilia related to Black's 50-year long career in entertainment, which included singing and presenting television programmes such as Blind Date.",16,35,holding memorabilia,0,1,1
3UQVX1UPFSI9POJME5HNSQ8HJI320L,"#33-3 Some were holding memorabilia related to Black's 50-year long career in entertainment, which included singing and presenting television programmes such as Blind Date.",24,35,memorabilia,10,8,18
3UQVX1UPFSI9POJME5HNSQ8HJI320L,"#33-3 Some were holding memorabilia related to Black's 50-year long career in entertainment, which included singing and presenting television programmes such as Blind Date.",78,91,entertainment,2,1,3
3UQVX1UPFSI9POJME5HNSQ8HJI320L,"#33-3 Some were holding memorabilia related to Black's 50-year long career in entertainment, which included singing and presenting television programmes such as Blind Date.",142,152,programmes,2,2,4
3EHIMLB7F70VM3R7SUX989K1RZXH85,"#24-7 Pictures taken of the objects recovered in the Maldives on, reportedly, May 31, were posted to Facebook by an employee of the resort.",28,35,objects,1,0,1
3EHIMLB7F70VM3R7SUX989K1RZXH85,"#24-7 Pictures taken of the objects recovered in the Maldives on, reportedly, May 31, were posted to Facebook by an employee of the resort.",36,45,recovered,1,4,5
3EHIMLB7F70VM3R7SUX989K1RZXH85,"#24-7 Pictures taken of the objects recovered in the Maldives on, reportedly, May 31, were posted to Facebook by an employee of the resort.",53,61,Maldives,4,0,4
3EHIMLB7F70VM3R7SUX989K1RZXH85,"#24-7 Pictures taken of the objects recovered in the Maldives on, reportedly, May 31, were posted to Facebook by an employee of the resort.",66,76,reportedly,1,1,2
3EHIMLB7F70VM3R7SUX989K1RZXH85,"#24-7 Pictures taken of the objects recovered in the Maldives on, reportedly, May 31, were posted to Facebook by an employee of the resort.",116,124,employee,2,0,2
3EHIMLB7F70VM3R7SUX989K1RZXH85,"#24-7 Pictures taken of the objects recovered in the Maldives on, reportedly, May 31, were posted to Facebook by an employee of the resort.",132,138,resort,2,0,2
3EHIMLB7F70VM3R7SUX989K1RZXH85,"#24-8 That prompted authorities to launch an investigation into the debris, but before it could be examined, it had already been sent away for disposal.",11,19,prompted,8,8,16
3EHIMLB7F70VM3R7SUX989K1RZXH85,"#24-8 That prompted authorities to launch an investigation into the debris, but before it could be examined, it had already been sent away for disposal.",11,31,prompted authorities,2,0,2
3EHIMLB7F70VM3R7SUX989K1RZXH85,"#24-8 That prompted authorities to launch an investigation into the debris, but before it could be examined, it had already been sent away for disposal.",20,31,authorities,3,0,3
3EHIMLB7F70VM3R7SUX989K1RZXH85,"#24-8 That prompted authorities to launch an investigation into the debris, but before it could be examined, it had already been sent away for disposal.",35,41,launch,2,0,2
3EHIMLB7F70VM3R7SUX989K1RZXH85,"#24-8 That prompted authorities to launch an investigation into the debris, but before it could be examined, it had already been sent away for disposal.",45,58,investigation,7,4,11
3EHIMLB7F70VM3R7SUX989K1RZXH85,"#24-8 That prompted authorities to launch an investigation into the debris, but before it could be examined, it had already been sent away for disposal.",68,74,debris,7,6,13
3EHIMLB7F70VM3R7SUX989K1RZXH85,"#24-8 That prompted authorities to launch an investigation into the debris, but before it could be examined, it had already been sent away for disposal.",99,107,examined,1,1,2
3EHIMLB7F70VM3R7SUX989K1RZXH85,"#24-8 That prompted authorities to launch an investigation into the debris, but before it could be examined, it had already been sent away for disposal.",143,151,disposal,6,8,14
3EHIMLB7F70VM3R7SUX989K1RZXH85,"#24-9 The photographs show a large white object, possibly two, stained with algae and appear to be made of a fiberglass and honeycomb material.",10,21,photographs,3,1,4
3EHIMLB7F70VM3R7SUX989K1RZXH85,"#24-9 The photographs show a large white object, possibly two, stained with algae and appear to be made of a fiberglass and honeycomb material.",63,70,stained,2,10,12
3EHIMLB7F70VM3R7SUX989K1RZXH85,"#24-9 The photographs show a large white object, possibly two, stained with algae and appear to be made of a fiberglass and honeycomb material.",76,81,algae,8,2,10
3EHIMLB7F70VM3R7SUX989K1RZXH85,"#24-9 The photographs show a large white object, possibly two, stained with algae and appear to be made of a fiberglass and honeycomb material.",109,119,fiberglass,9,2,11
3EHIMLB7F70VM3R7SUX989K1RZXH85,"#24-9 The photographs show a large white object, possibly two, stained with algae and appear to be made of a fiberglass and honeycomb material.",109,142,fiberglass and honeycomb material,1,0,1
3EHIMLB7F70VM3R7SUX989K1RZXH85,"#24-9 The photographs show a large white object, possibly two, stained with algae and appear to be made of a fiberglass and honeycomb material.",124,133,honeycomb,7,3,10
3EHIMLB7F70VM3R7SUX989K1RZXH85,"#24-9 The photographs show a large white object, possibly two, stained with algae and appear to be made of a fiberglass and honeycomb material.",124,142,honeycomb material,2,1,3
3EHIMLB7F70VM3R7SUX989K1RZXH85,"#24-9 The photographs show a large white object, possibly two, stained with algae and appear to be made of a fiberglass and honeycomb material.",134,142,material,1,0,1
3EHIMLB7F70VM3R7SUX989K1RZXH85,"#24-10 The objects appear to be several feet in length and width and in one photo where the paint is severely peeled, red letters ""IC"" can be seen.",19,25,appear,0,1,1
3EHIMLB7F70VM3R7SUX989K1RZXH85,"#24-10 The objects appear to be several feet in length and width and in one photo where the paint is severely peeled, red letters ""IC"" can be seen.",101,109,severely,2,1,3
3EHIMLB7F70VM3R7SUX989K1RZXH85,"#24-10 The objects appear to be several feet in length and width and in one photo where the paint is severely peeled, red letters ""IC"" can be seen.",101,116,severely peeled,0,1,1
3EHIMLB7F70VM3R7SUX989K1RZXH85,"#24-10 The objects appear to be several feet in length and width and in one photo where the paint is severely peeled, red letters ""IC"" can be seen.",110,116,peeled,2,5,7
3EHIMLB7F70VM3R7SUX989K1RZXH85,"#24-11 Those pieces, along with others, were taken away and disposed of as trash.",60,68,disposed,4,3,7
3EHIMLB7F70VM3R7SUX989K1RZXH85,"#24-11 Those pieces, along with others, were taken away and disposed of as trash.",75,80,trash,0,2,2
3EHIMLB7F70VM3R7SUX989K1RZXH85,"#24-12 When authorities discovered the photographs, they returned to the site, but only found a small, five to seven inch (about 13â€“18 cm) piece of debris they say doesn't appear to be part of a plane.",12,23,authorities,4,3,7
3EHIMLB7F70VM3R7SUX989K1RZXH85,"#24-12 When authorities discovered the photographs, they returned to the site, but only found a small, five to seven inch (about 13â€“18 cm) piece of debris they say doesn't appear to be part of a plane.",12,34,authorities discovered,0,1,1
3EHIMLB7F70VM3R7SUX989K1RZXH85,"#24-12 When authorities discovered the photographs, they returned to the site, but only found a small, five to seven inch (about 13â€“18 cm) piece of debris they say doesn't appear to be part of a plane.",24,34,discovered,0,1,1
3EHIMLB7F70VM3R7SUX989K1RZXH85,"#24-12 When authorities discovered the photographs, they returned to the site, but only found a small, five to seven inch (about 13â€“18 cm) piece of debris they say doesn't appear to be part of a plane.",39,50,photographs,2,1,3
3EHIMLB7F70VM3R7SUX989K1RZXH85,"#24-12 When authorities discovered the photographs, they returned to the site, but only found a small, five to seven inch (about 13â€“18 cm) piece of debris they say doesn't appear to be part of a plane.",148,154,debris,4,5,9
3EHIMLB7F70VM3R7SUX989K1RZXH85,"#24-12 When authorities discovered the photographs, they returned to the site, but only found a small, five to seven inch (about 13â€“18 cm) piece of debris they say doesn't appear to be part of a plane.",172,178,appear,0,1,1
302OLP89DZ8IOJ96303MT9TG4VSCAV,"#9-27 Camila Nunes, a sociologist of the Federal University of ABC, told the AFP ""medium- and long-term policies to reduce the vulnerability of certain social groups [and] to prioritize prevention rather than repression"" are needed.",6,18,Camila Nunes,0,1,1
302OLP89DZ8IOJ96303MT9TG4VSCAV,"#9-27 Camila Nunes, a sociologist of the Federal University of ABC, told the AFP ""medium- and long-term policies to reduce the vulnerability of certain social groups [and] to prioritize prevention rather than repression"" are needed.",20,33,a sociologist,1,0,1
302OLP89DZ8IOJ96303MT9TG4VSCAV,"#9-27 Camila Nunes, a sociologist of the Federal University of ABC, told the AFP ""medium- and long-term policies to reduce the vulnerability of certain social groups [and] to prioritize prevention rather than repression"" are needed.",22,33,sociologist,10,4,14
302OLP89DZ8IOJ96303MT9TG4VSCAV,"#9-27 Camila Nunes, a sociologist of the Federal University of ABC, told the AFP ""medium- and long-term policies to reduce the vulnerability of certain social groups [and] to prioritize prevention rather than repression"" are needed.",41,48,Federal,0,1,1
302OLP89DZ8IOJ96303MT9TG4VSCAV,"#9-27 Camila Nunes, a sociologist of the Federal University of ABC, told the AFP ""medium- and long-term policies to reduce the vulnerability of certain social groups [and] to prioritize prevention rather than repression"" are needed.",41,59,Federal University,1,0,1
302OLP89DZ8IOJ96303MT9TG4VSCAV,"#9-27 Camila Nunes, a sociologist of the Federal University of ABC, told the AFP ""medium- and long-term policies to reduce the vulnerability of certain social groups [and] to prioritize prevention rather than repression"" are needed.",104,112,policies,1,0,1
302OLP89DZ8IOJ96303MT9TG4VSCAV,"#9-27 Camila Nunes, a sociologist of the Federal University of ABC, told the AFP ""medium- and long-term policies to reduce the vulnerability of certain social groups [and] to prioritize prevention rather than repression"" are needed.",116,140,reduce the vulnerability,1,0,1
302OLP89DZ8IOJ96303MT9TG4VSCAV,"#9-27 Camila Nunes, a sociologist of the Federal University of ABC, told the AFP ""medium- and long-term policies to reduce the vulnerability of certain social groups [and] to prioritize prevention rather than repression"" are needed.",127,140,vulnerability,10,10,20
302OLP89DZ8IOJ96303MT9TG4VSCAV,"#9-27 Camila Nunes, a sociologist of the Federal University of ABC, told the AFP ""medium- and long-term policies to reduce the vulnerability of certain social groups [and] to prioritize prevention rather than repression"" are needed.",175,185,prioritize,10,6,16
302OLP89DZ8IOJ96303MT9TG4VSCAV,"#9-27 Camila Nunes, a sociologist of the Federal University of ABC, told the AFP ""medium- and long-term policies to reduce the vulnerability of certain social groups [and] to prioritize prevention rather than repression"" are needed.",175,196,prioritize prevention,1,0,1
302OLP89DZ8IOJ96303MT9TG4VSCAV,"#9-27 Camila Nunes, a sociologist of the Federal University of ABC, told the AFP ""medium- and long-term policies to reduce the vulnerability of certain social groups [and] to prioritize prevention rather than repression"" are needed.",175,219,prioritize prevention rather than repression,1,0,1
302OLP89DZ8IOJ96303MT9TG4VSCAV,"#9-27 Camila Nunes, a sociologist of the Federal University of ABC, told the AFP ""medium- and long-term policies to reduce the vulnerability of certain social groups [and] to prioritize prevention rather than repression"" are needed.",186,196,prevention,0,1,1
302OLP89DZ8IOJ96303MT9TG4VSCAV,"#9-27 Camila Nunes, a sociologist of the Federal University of ABC, told the AFP ""medium- and long-term policies to reduce the vulnerability of certain social groups [and] to prioritize prevention rather than repression"" are needed.",209,219,repression,10,7,17
302OLP89DZ8IOJ96303MT9TG4VSCAV,"#9-28 Reuters reported Alexandre de Moraes, minister of the Justice Department, recently authorized the state of Rio Grande do Norte to spend 13 million Brazilian reals to upgrade and expand prison equipment.",6,13,Reuters,0,2,2
302OLP89DZ8IOJ96303MT9TG4VSCAV,"#9-28 Reuters reported Alexandre de Moraes, minister of the Justice Department, recently authorized the state of Rio Grande do Norte to spend 13 million Brazilian reals to upgrade and expand prison equipment.",36,42,Moraes,1,0,1
302OLP89DZ8IOJ96303MT9TG4VSCAV,"#9-28 Reuters reported Alexandre de Moraes, minister of the Justice Department, recently authorized the state of Rio Grande do Norte to spend 13 million Brazilian reals to upgrade and expand prison equipment.",60,78,Justice Department,1,0,1
302OLP89DZ8IOJ96303MT9TG4VSCAV,"#9-28 Reuters reported Alexandre de Moraes, minister of the Justice Department, recently authorized the state of Rio Grande do Norte to spend 13 million Brazilian reals to upgrade and expand prison equipment.",89,99,authorized,7,3,10
302OLP89DZ8IOJ96303MT9TG4VSCAV,"#9-28 Reuters reported Alexandre de Moraes, minister of the Justice Department, recently authorized the state of Rio Grande do Norte to spend 13 million Brazilian reals to upgrade and expand prison equipment.",153,168,Brazilian reals,1,0,1
302OLP89DZ8IOJ96303MT9TG4VSCAV,"#9-28 Reuters reported Alexandre de Moraes, minister of the Justice Department, recently authorized the state of Rio Grande do Norte to spend 13 million Brazilian reals to upgrade and expand prison equipment.",163,168,reals,2,1,3
302OLP89DZ8IOJ96303MT9TG4VSCAV,"#9-28 Reuters reported Alexandre de Moraes, minister of the Justice Department, recently authorized the state of Rio Grande do Norte to spend 13 million Brazilian reals to upgrade and expand prison equipment.",172,179,upgrade,0,1,1
302OLP89DZ8IOJ96303MT9TG4VSCAV,"#9-28 Reuters reported Alexandre de Moraes, minister of the Justice Department, recently authorized the state of Rio Grande do Norte to spend 13 million Brazilian reals to upgrade and expand prison equipment.",172,190,upgrade and expand,0,1,1
302OLP89DZ8IOJ96303MT9TG4VSCAV,"#9-28 Reuters reported Alexandre de Moraes, minister of the Justice Department, recently authorized the state of Rio Grande do Norte to spend 13 million Brazilian reals to upgrade and expand prison equipment.",184,190,expand,1,1,2
302OLP89DZ8IOJ96303MT9TG4VSCAV,"#9-28 Reuters reported Alexandre de Moraes, minister of the Justice Department, recently authorized the state of Rio Grande do Norte to spend 13 million Brazilian reals to upgrade and expand prison equipment.",198,207,equipment,1,0,1
302OLP89DZ8IOJ96303MT9TG4VSCAV,#9-29 De Moraes promised to prevent more prison riots by increasing funds and prison security.,6,15,De Moraes,0,1,1
302OLP89DZ8IOJ96303MT9TG4VSCAV,#9-29 De Moraes promised to prevent more prison riots by increasing funds and prison security.,16,24,promised,0,1,1
302OLP89DZ8IOJ96303MT9TG4VSCAV,#9-29 De Moraes promised to prevent more prison riots by increasing funds and prison security.,28,35,prevent,1,0,1
302OLP89DZ8IOJ96303MT9TG4VSCAV,#9-29 De Moraes promised to prevent more prison riots by increasing funds and prison security.,41,53,prison riots,0,1,1
302OLP89DZ8IOJ96303MT9TG4VSCAV,#9-29 De Moraes promised to prevent more prison riots by increasing funds and prison security.,48,53,riots,1,4,5
302OLP89DZ8IOJ96303MT9TG4VSCAV,#9-29 De Moraes promised to prevent more prison riots by increasing funds and prison security.,57,67,increasing,1,1,2
302OLP89DZ8IOJ96303MT9TG4VSCAV,#9-29 De Moraes promised to prevent more prison riots by increasing funds and prison security.,85,93,security,1,1,2
302OLP89DZ8IOJ96303MT9TG4VSCAV,"#9-30 Meanwhile, Luiz Alberto Cartaxo, the prison chief for the southern ParanÃ¡ state, said an explosion on Sunday broke a guarding wall of a Piraquara prison, prompting at least 21 inmates to escape.",73,79,ParanÃ¡,1,1,2
302OLP89DZ8IOJ96303MT9TG4VSCAV,"#9-30 Meanwhile, Luiz Alberto Cartaxo, the prison chief for the southern ParanÃ¡ state, said an explosion on Sunday broke a guarding wall of a Piraquara prison, prompting at least 21 inmates to escape.",95,104,explosion,4,3,7
302OLP89DZ8IOJ96303MT9TG4VSCAV,"#9-30 Meanwhile, Luiz Alberto Cartaxo, the prison chief for the southern ParanÃ¡ state, said an explosion on Sunday broke a guarding wall of a Piraquara prison, prompting at least 21 inmates to escape.",123,131,guarding,1,0,1
302OLP89DZ8IOJ96303MT9TG4VSCAV,"#9-30 Meanwhile, Luiz Alberto Cartaxo, the prison chief for the southern ParanÃ¡ state, said an explosion on Sunday broke a guarding wall of a Piraquara prison, prompting at least 21 inmates to escape.",123,136,guarding wall,1,1,2
302OLP89DZ8IOJ96303MT9TG4VSCAV,"#9-30 Meanwhile, Luiz Alberto Cartaxo, the prison chief for the southern ParanÃ¡ state, said an explosion on Sunday broke a guarding wall of a Piraquara prison, prompting at least 21 inmates to escape.",132,136,wall,1,0,1
302OLP89DZ8IOJ96303MT9TG4VSCAV,"#9-30 Meanwhile, Luiz Alberto Cartaxo, the prison chief for the southern ParanÃ¡ state, said an explosion on Sunday broke a guarding wall of a Piraquara prison, prompting at least 21 inmates to escape.",142,151,Piraquara,2,1,3
302OLP89DZ8IOJ96303MT9TG4VSCAV,"#9-30 Meanwhile, Luiz Alberto Cartaxo, the prison chief for the southern ParanÃ¡ state, said an explosion on Sunday broke a guarding wall of a Piraquara prison, prompting at least 21 inmates to escape.",160,169,prompting,4,7,11
302OLP89DZ8IOJ96303MT9TG4VSCAV,"#9-30 Meanwhile, Luiz Alberto Cartaxo, the prison chief for the southern ParanÃ¡ state, said an explosion on Sunday broke a guarding wall of a Piraquara prison, prompting at least 21 inmates to escape.",182,189,inmates,1,4,5
302OLP89DZ8IOJ96303MT9TG4VSCAV,"#9-30 Meanwhile, Luiz Alberto Cartaxo, the prison chief for the southern ParanÃ¡ state, said an explosion on Sunday broke a guarding wall of a Piraquara prison, prompting at least 21 inmates to escape.",193,199,escape,1,0,1
302OLP89DZ8IOJ96303MT9TG4VSCAV,#9-31 Cartaxo also reported that two other inmates were killed by police during their escape attempt.,6,13,Cartaxo,0,1,1
302OLP89DZ8IOJ96303MT9TG4VSCAV,#9-31 Cartaxo also reported that two other inmates were killed by police during their escape attempt.,19,27,reported,0,1,1
302OLP89DZ8IOJ96303MT9TG4VSCAV,#9-31 Cartaxo also reported that two other inmates were killed by police during their escape attempt.,43,50,inmates,3,5,8
302OLP89DZ8IOJ96303MT9TG4VSCAV,#9-31 Cartaxo also reported that two other inmates were killed by police during their escape attempt.,86,92,escape,4,0,4
302OLP89DZ8IOJ96303MT9TG4VSCAV,#9-31 Cartaxo also reported that two other inmates were killed by police during their escape attempt.,86,100,escape attempt,1,1,2
302OLP89DZ8IOJ96303MT9TG4VSCAV,#9-31 Cartaxo also reported that two other inmates were killed by police during their escape attempt.,93,100,attempt,1,3,4
3DWNFENNE3WQU8ZV4RAH3AKB255J45,#34-2 The report comes after North and South Korea exchanged artillery fire yesterday.,51,60,exchanged,1,2,3
3DWNFENNE3WQU8ZV4RAH3AKB255J45,#34-2 The report comes after North and South Korea exchanged artillery fire yesterday.,51,70,exchanged artillery,1,2,3
3DWNFENNE3WQU8ZV4RAH3AKB255J45,#34-2 The report comes after North and South Korea exchanged artillery fire yesterday.,61,70,artillery,9,10,19
3DWNFENNE3WQU8ZV4RAH3AKB255J45,#34-2 The report comes after North and South Korea exchanged artillery fire yesterday.,61,75,artillery fire,0,1,1
3DWNFENNE3WQU8ZV4RAH3AKB255J45,"#34-3 ""War maniacs of the South Korean puppet military made another grave provocation to the DPRK in the central western sector of the front on Thursday afternoon.",7,18,War maniacs,1,1,2
3DWNFENNE3WQU8ZV4RAH3AKB255J45,"#34-3 ""War maniacs of the South Korean puppet military made another grave provocation to the DPRK in the central western sector of the front on Thursday afternoon.",11,18,maniacs,8,9,17
3DWNFENNE3WQU8ZV4RAH3AKB255J45,"#34-3 ""War maniacs of the South Korean puppet military made another grave provocation to the DPRK in the central western sector of the front on Thursday afternoon.",26,38,South Korean,0,1,1
3DWNFENNE3WQU8ZV4RAH3AKB255J45,"#34-3 ""War maniacs of the South Korean puppet military made another grave provocation to the DPRK in the central western sector of the front on Thursday afternoon.",26,54,South Korean puppet military,1,0,1
3DWNFENNE3WQU8ZV4RAH3AKB255J45,"#34-3 ""War maniacs of the South Korean puppet military made another grave provocation to the DPRK in the central western sector of the front on Thursday afternoon.",39,45,puppet,0,4,4
3DWNFENNE3WQU8ZV4RAH3AKB255J45,"#34-3 ""War maniacs of the South Korean puppet military made another grave provocation to the DPRK in the central western sector of the front on Thursday afternoon.",39,54,puppet military,2,3,5
3DWNFENNE3WQU8ZV4RAH3AKB255J45,"#34-3 ""War maniacs of the South Korean puppet military made another grave provocation to the DPRK in the central western sector of the front on Thursday afternoon.",68,73,grave,2,0,2
3DWNFENNE3WQU8ZV4RAH3AKB255J45,"#34-3 ""War maniacs of the South Korean puppet military made another grave provocation to the DPRK in the central western sector of the front on Thursday afternoon.",68,85,grave provocation,2,3,5
3DWNFENNE3WQU8ZV4RAH3AKB255J45,"#34-3 ""War maniacs of the South Korean puppet military made another grave provocation to the DPRK in the central western sector of the front on Thursday afternoon.",74,85,provocation,10,7,17
3DWNFENNE3WQU8ZV4RAH3AKB255J45,"#34-3 ""War maniacs of the South Korean puppet military made another grave provocation to the DPRK in the central western sector of the front on Thursday afternoon.",93,97,DPRK,1,0,1
3DWNFENNE3WQU8ZV4RAH3AKB255J45,"#34-3 ""War maniacs of the South Korean puppet military made another grave provocation to the DPRK in the central western sector of the front on Thursday afternoon.",121,127,sector,2,0,2
3DWNFENNE3WQU8ZV4RAH3AKB255J45,#34-4 They perpetrated such reckless action as firing 36 shells at KPA civil police posts under the absurd pretext that the KPA fired one shell at the south side.,11,22,perpetrated,10,10,20
3DWNFENNE3WQU8ZV4RAH3AKB255J45,#34-4 They perpetrated such reckless action as firing 36 shells at KPA civil police posts under the absurd pretext that the KPA fired one shell at the south side.,28,36,reckless,3,7,10
3DWNFENNE3WQU8ZV4RAH3AKB255J45,#34-4 They perpetrated such reckless action as firing 36 shells at KPA civil police posts under the absurd pretext that the KPA fired one shell at the south side.,28,43,reckless action,0,2,2
3DWNFENNE3WQU8ZV4RAH3AKB255J45,#34-4 They perpetrated such reckless action as firing 36 shells at KPA civil police posts under the absurd pretext that the KPA fired one shell at the south side.,100,106,absurd,2,3,5
3DWNFENNE3WQU8ZV4RAH3AKB255J45,#34-4 They perpetrated such reckless action as firing 36 shells at KPA civil police posts under the absurd pretext that the KPA fired one shell at the south side.,100,114,absurd pretext,2,2,4
3DWNFENNE3WQU8ZV4RAH3AKB255J45,#34-4 They perpetrated such reckless action as firing 36 shells at KPA civil police posts under the absurd pretext that the KPA fired one shell at the south side.,107,114,pretext,2,4,6
3DWNFENNE3WQU8ZV4RAH3AKB255J45,#34-4 They perpetrated such reckless action as firing 36 shells at KPA civil police posts under the absurd pretext that the KPA fired one shell at the south side.,138,143,shell,0,1,1
3DWNFENNE3WQU8ZV4RAH3AKB255J45,"#34-5 Six shells of them hit the area near KPA civil police posts 542 and 543 and other 15 shells fell near KPA civil police posts 250 and 251,"" said KCNA.",47,52,civil,0,1,1
3DWNFENNE3WQU8ZV4RAH3AKB255J45,"#34-5 Six shells of them hit the area near KPA civil police posts 542 and 543 and other 15 shells fell near KPA civil police posts 250 and 251,"" said KCNA.",112,117,civil,1,0,1
3DWNFENNE3WQU8ZV4RAH3AKB255J45,"#34-6 ""Foolhardy provocation deserves harsh punishment,"" it added; and, later, ""Kim Jong-un issued an order of the supreme commander of the Korean Peopleâ€™s Army [KPA] that the front-line large combined units of the KPA should enter a wartime state to be fully battle ready to launch surprise operations.""",7,16,Foolhardy,7,8,15
3DWNFENNE3WQU8ZV4RAH3AKB255J45,"#34-6 ""Foolhardy provocation deserves harsh punishment,"" it added; and, later, ""Kim Jong-un issued an order of the supreme commander of the Korean Peopleâ€™s Army [KPA] that the front-line large combined units of the KPA should enter a wartime state to be fully battle ready to launch surprise operations.""",7,28,Foolhardy provocation,2,2,4
3DWNFENNE3WQU8ZV4RAH3AKB255J45,"#34-6 ""Foolhardy provocation deserves harsh punishment,"" it added; and, later, ""Kim Jong-un issued an order of the supreme commander of the Korean Peopleâ€™s Army [KPA] that the front-line large combined units of the KPA should enter a wartime state to be fully battle ready to launch surprise operations.""",17,28,provocation,4,1,5
3DWNFENNE3WQU8ZV4RAH3AKB255J45,"#34-6 ""Foolhardy provocation deserves harsh punishment,"" it added; and, later, ""Kim Jong-un issued an order of the supreme commander of the Korean Peopleâ€™s Army [KPA] that the front-line large combined units of the KPA should enter a wartime state to be fully battle ready to launch surprise operations.""",29,37,deserves,0,1,1
3DWNFENNE3WQU8ZV4RAH3AKB255J45,"#34-6 ""Foolhardy provocation deserves harsh punishment,"" it added; and, later, ""Kim Jong-un issued an order of the supreme commander of the Korean Peopleâ€™s Army [KPA] that the front-line large combined units of the KPA should enter a wartime state to be fully battle ready to launch surprise operations.""",38,43,harsh,1,1,2
3DWNFENNE3WQU8ZV4RAH3AKB255J45,"#34-6 ""Foolhardy provocation deserves harsh punishment,"" it added; and, later, ""Kim Jong-un issued an order of the supreme commander of the Korean Peopleâ€™s Army [KPA] that the front-line large combined units of the KPA should enter a wartime state to be fully battle ready to launch surprise operations.""",38,54,harsh punishment,0,1,1
3DWNFENNE3WQU8ZV4RAH3AKB255J45,"#34-6 ""Foolhardy provocation deserves harsh punishment,"" it added; and, later, ""Kim Jong-un issued an order of the supreme commander of the Korean Peopleâ€™s Army [KPA] that the front-line large combined units of the KPA should enter a wartime state to be fully battle ready to launch surprise operations.""",44,54,punishment,1,0,1
3DWNFENNE3WQU8ZV4RAH3AKB255J45,"#34-6 ""Foolhardy provocation deserves harsh punishment,"" it added; and, later, ""Kim Jong-un issued an order of the supreme commander of the Korean Peopleâ€™s Army [KPA] that the front-line large combined units of the KPA should enter a wartime state to be fully battle ready to launch surprise operations.""",80,91,Kim Jong-un,0,1,1
3DWNFENNE3WQU8ZV4RAH3AKB255J45,"#34-6 ""Foolhardy provocation deserves harsh punishment,"" it added; and, later, ""Kim Jong-un issued an order of the supreme commander of the Korean Peopleâ€™s Army [KPA] that the front-line large combined units of the KPA should enter a wartime state to be fully battle ready to launch surprise operations.""",92,98,issued,0,1,1
3DWNFENNE3WQU8ZV4RAH3AKB255J45,"#34-6 ""Foolhardy provocation deserves harsh punishment,"" it added; and, later, ""Kim Jong-un issued an order of the supreme commander of the Korean Peopleâ€™s Army [KPA] that the front-line large combined units of the KPA should enter a wartime state to be fully battle ready to launch surprise operations.""",111,132,the supreme commander,0,1,1
3DWNFENNE3WQU8ZV4RAH3AKB255J45,"#34-6 ""Foolhardy provocation deserves harsh punishment,"" it added; and, later, ""Kim Jong-un issued an order of the supreme commander of the Korean Peopleâ€™s Army [KPA] that the front-line large combined units of the KPA should enter a wartime state to be fully battle ready to launch surprise operations.""",115,122,supreme,1,0,1
3DWNFENNE3WQU8ZV4RAH3AKB255J45,"#34-6 ""Foolhardy provocation deserves harsh punishment,"" it added; and, later, ""Kim Jong-un issued an order of the supreme commander of the Korean Peopleâ€™s Army [KPA] that the front-line large combined units of the KPA should enter a wartime state to be fully battle ready to launch surprise operations.""",123,132,commander,2,0,2
3DWNFENNE3WQU8ZV4RAH3AKB255J45,"#34-6 ""Foolhardy provocation deserves harsh punishment,"" it added; and, later, ""Kim Jong-un issued an order of the supreme commander of the Korean Peopleâ€™s Army [KPA] that the front-line large combined units of the KPA should enter a wartime state to be fully battle ready to launch surprise operations.""",176,186,front-line,1,2,3
3DWNFENNE3WQU8ZV4RAH3AKB255J45,"#34-6 ""Foolhardy provocation deserves harsh punishment,"" it added; and, later, ""Kim Jong-un issued an order of the supreme commander of the Korean Peopleâ€™s Army [KPA] that the front-line large combined units of the KPA should enter a wartime state to be fully battle ready to launch surprise operations.""",234,241,wartime,1,1,2
3DWNFENNE3WQU8ZV4RAH3AKB255J45,"#34-6 ""Foolhardy provocation deserves harsh punishment,"" it added; and, later, ""Kim Jong-un issued an order of the supreme commander of the Korean Peopleâ€™s Army [KPA] that the front-line large combined units of the KPA should enter a wartime state to be fully battle ready to launch surprise operations.""",234,247,wartime state,0,2,2
3DWNFENNE3WQU8ZV4RAH3AKB255J45,"#34-6 ""Foolhardy provocation deserves harsh punishment,"" it added; and, later, ""Kim Jong-un issued an order of the supreme commander of the Korean Peopleâ€™s Army [KPA] that the front-line large combined units of the KPA should enter a wartime state to be fully battle ready to launch surprise operations.""",260,272,battle ready,1,0,1
3DWNFENNE3WQU8ZV4RAH3AKB255J45,"#34-6 ""Foolhardy provocation deserves harsh punishment,"" it added; and, later, ""Kim Jong-un issued an order of the supreme commander of the Korean Peopleâ€™s Army [KPA] that the front-line large combined units of the KPA should enter a wartime state to be fully battle ready to launch surprise operations.""",276,282,launch,2,1,3
3DWNFENNE3WQU8ZV4RAH3AKB255J45,"#34-6 ""Foolhardy provocation deserves harsh punishment,"" it added; and, later, ""Kim Jong-un issued an order of the supreme commander of the Korean Peopleâ€™s Army [KPA] that the front-line large combined units of the KPA should enter a wartime state to be fully battle ready to launch surprise operations.""",283,302,surprise operations,1,1,2
3DWNFENNE3WQU8ZV4RAH3AKB255J45,"#34-6 ""Foolhardy provocation deserves harsh punishment,"" it added; and, later, ""Kim Jong-un issued an order of the supreme commander of the Korean Peopleâ€™s Army [KPA] that the front-line large combined units of the KPA should enter a wartime state to be fully battle ready to launch surprise operations.""",292,302,operations,1,1,2
39WSF6KUV2MMNLNL9AEZKSDOEO9EOP,"#4-2 Cernan, who commanded the Apollo 17 mission to the Moon in 1972, was in Houston, Texas, at the time of his death.",5,11,Cernan,0,1,1
39WSF6KUV2MMNLNL9AEZKSDOEO9EOP,"#4-2 Cernan, who commanded the Apollo 17 mission to the Moon in 1972, was in Houston, Texas, at the time of his death.",17,26,commanded,7,6,13
39WSF6KUV2MMNLNL9AEZKSDOEO9EOP,"#4-2 Cernan, who commanded the Apollo 17 mission to the Moon in 1972, was in Houston, Texas, at the time of his death.",41,48,mission,1,1,2
39WSF6KUV2MMNLNL9AEZKSDOEO9EOP,"#4-2 Cernan, who commanded the Apollo 17 mission to the Moon in 1972, was in Houston, Texas, at the time of his death.",77,84,Houston,0,1,1
39WSF6KUV2MMNLNL9AEZKSDOEO9EOP,"#4-3 Cernan, who was born in Chicago, Illinois, on March 14, 1934, earned engineering degrees from Purdue University in 1956 and the Naval Postgraduate School in 1963.",67,73,earned,0,3,3
39WSF6KUV2MMNLNL9AEZKSDOEO9EOP,"#4-3 Cernan, who was born in Chicago, Illinois, on March 14, 1934, earned engineering degrees from Purdue University in 1956 and the Naval Postgraduate School in 1963.",74,85,engineering,10,0,10
39WSF6KUV2MMNLNL9AEZKSDOEO9EOP,"#4-3 Cernan, who was born in Chicago, Illinois, on March 14, 1934, earned engineering degrees from Purdue University in 1956 and the Naval Postgraduate School in 1963.",86,93,degrees,1,1,2
39WSF6KUV2MMNLNL9AEZKSDOEO9EOP,"#4-3 Cernan, who was born in Chicago, Illinois, on March 14, 1934, earned engineering degrees from Purdue University in 1956 and the Naval Postgraduate School in 1963.",99,116,Purdue University,1,0,1
39WSF6KUV2MMNLNL9AEZKSDOEO9EOP,"#4-3 Cernan, who was born in Chicago, Illinois, on March 14, 1934, earned engineering degrees from Purdue University in 1956 and the Naval Postgraduate School in 1963.",139,151,Postgraduate,4,0,4
39WSF6KUV2MMNLNL9AEZKSDOEO9EOP,#4-4 He was an aviator in the United States Navy and logged more than 200 landings on aircraft carriers before becoming an astronaut in 1963.,15,22,aviator,10,5,15
39WSF6KUV2MMNLNL9AEZKSDOEO9EOP,#4-4 He was an aviator in the United States Navy and logged more than 200 landings on aircraft carriers before becoming an astronaut in 1963.,53,59,logged,4,7,11
39WSF6KUV2MMNLNL9AEZKSDOEO9EOP,#4-4 He was an aviator in the United States Navy and logged more than 200 landings on aircraft carriers before becoming an astronaut in 1963.,74,82,landings,1,1,2
39WSF6KUV2MMNLNL9AEZKSDOEO9EOP,#4-4 He was an aviator in the United States Navy and logged more than 200 landings on aircraft carriers before becoming an astronaut in 1963.,86,103,aircraft carriers,0,2,2
39WSF6KUV2MMNLNL9AEZKSDOEO9EOP,#4-4 He was an aviator in the United States Navy and logged more than 200 landings on aircraft carriers before becoming an astronaut in 1963.,95,103,carriers,2,0,2
39WSF6KUV2MMNLNL9AEZKSDOEO9EOP,#4-4 He was an aviator in the United States Navy and logged more than 200 landings on aircraft carriers before becoming an astronaut in 1963.,120,132,an astronaut,1,0,1
39WSF6KUV2MMNLNL9AEZKSDOEO9EOP,#4-4 He was an aviator in the United States Navy and logged more than 200 landings on aircraft carriers before becoming an astronaut in 1963.,123,132,astronaut,7,6,13
39WSF6KUV2MMNLNL9AEZKSDOEO9EOP,#4-5 He flew in space for the first time aboard Gemini 9 in 1966.,8,12,flew,0,1,1
39WSF6KUV2MMNLNL9AEZKSDOEO9EOP,#4-5 He flew in space for the first time aboard Gemini 9 in 1966.,41,47,aboard,1,3,4
39WSF6KUV2MMNLNL9AEZKSDOEO9EOP,#4-5 He flew in space for the first time aboard Gemini 9 in 1966.,48,54,Gemini,1,0,1
39WSF6KUV2MMNLNL9AEZKSDOEO9EOP,"#4-6 In 1969 Cernan flew aboard Apollo 10, a flight to the Moon that rehearsed a descent but purposefully did not land in preparation for the Apollo 11 landing.",13,19,Cernan,1,0,1
39WSF6KUV2MMNLNL9AEZKSDOEO9EOP,"#4-6 In 1969 Cernan flew aboard Apollo 10, a flight to the Moon that rehearsed a descent but purposefully did not land in preparation for the Apollo 11 landing.",20,24,flew,0,2,2
39WSF6KUV2MMNLNL9AEZKSDOEO9EOP,"#4-6 In 1969 Cernan flew aboard Apollo 10, a flight to the Moon that rehearsed a descent but purposefully did not land in preparation for the Apollo 11 landing.",25,31,aboard,0,2,2
39WSF6KUV2MMNLNL9AEZKSDOEO9EOP,"#4-6 In 1969 Cernan flew aboard Apollo 10, a flight to the Moon that rehearsed a descent but purposefully did not land in preparation for the Apollo 11 landing.",32,38,Apollo,1,0,1
39WSF6KUV2MMNLNL9AEZKSDOEO9EOP,"#4-6 In 1969 Cernan flew aboard Apollo 10, a flight to the Moon that rehearsed a descent but purposefully did not land in preparation for the Apollo 11 landing.",69,78,rehearsed,10,7,17
39WSF6KUV2MMNLNL9AEZKSDOEO9EOP,"#4-6 In 1969 Cernan flew aboard Apollo 10, a flight to the Moon that rehearsed a descent but purposefully did not land in preparation for the Apollo 11 landing.",81,88,descent,10,5,15
39WSF6KUV2MMNLNL9AEZKSDOEO9EOP,"#4-6 In 1969 Cernan flew aboard Apollo 10, a flight to the Moon that rehearsed a descent but purposefully did not land in preparation for the Apollo 11 landing.",93,105,purposefully,8,6,14
39WSF6KUV2MMNLNL9AEZKSDOEO9EOP,"#4-6 In 1969 Cernan flew aboard Apollo 10, a flight to the Moon that rehearsed a descent but purposefully did not land in preparation for the Apollo 11 landing.",122,133,preparation,2,0,2
39WSF6KUV2MMNLNL9AEZKSDOEO9EOP,"#4-6 In 1969 Cernan flew aboard Apollo 10, a flight to the Moon that rehearsed a descent but purposefully did not land in preparation for the Apollo 11 landing.",152,159,landing,0,1,1
39WSF6KUV2MMNLNL9AEZKSDOEO9EOP,"#4-7 Cernan's final flight into space was as commander of Apollo 17, the final lunar landing mission of the Apollo program, in which he spent three days exploring the lunar surface along with Harrison Schmitt.",45,54,commander,1,0,1
39WSF6KUV2MMNLNL9AEZKSDOEO9EOP,"#4-7 Cernan's final flight into space was as commander of Apollo 17, the final lunar landing mission of the Apollo program, in which he spent three days exploring the lunar surface along with Harrison Schmitt.",79,84,lunar,5,1,6
39WSF6KUV2MMNLNL9AEZKSDOEO9EOP,"#4-7 Cernan's final flight into space was as commander of Apollo 17, the final lunar landing mission of the Apollo program, in which he spent three days exploring the lunar surface along with Harrison Schmitt.",79,92,lunar landing,1,0,1
39WSF6KUV2MMNLNL9AEZKSDOEO9EOP,"#4-7 Cernan's final flight into space was as commander of Apollo 17, the final lunar landing mission of the Apollo program, in which he spent three days exploring the lunar surface along with Harrison Schmitt.",85,92,landing,0,2,2
39WSF6KUV2MMNLNL9AEZKSDOEO9EOP,"#4-7 Cernan's final flight into space was as commander of Apollo 17, the final lunar landing mission of the Apollo program, in which he spent three days exploring the lunar surface along with Harrison Schmitt.",93,100,mission,0,2,2
39WSF6KUV2MMNLNL9AEZKSDOEO9EOP,"#4-7 Cernan's final flight into space was as commander of Apollo 17, the final lunar landing mission of the Apollo program, in which he spent three days exploring the lunar surface along with Harrison Schmitt.",153,162,exploring,4,3,7
39WSF6KUV2MMNLNL9AEZKSDOEO9EOP,"#4-7 Cernan's final flight into space was as commander of Apollo 17, the final lunar landing mission of the Apollo program, in which he spent three days exploring the lunar surface along with Harrison Schmitt.",167,180,lunar surface,0,1,1
39WSF6KUV2MMNLNL9AEZKSDOEO9EOP,"#4-7 Cernan's final flight into space was as commander of Apollo 17, the final lunar landing mission of the Apollo program, in which he spent three days exploring the lunar surface along with Harrison Schmitt.",173,180,surface,0,1,1
39WSF6KUV2MMNLNL9AEZKSDOEO9EOP,"#4-7 Cernan's final flight into space was as commander of Apollo 17, the final lunar landing mission of the Apollo program, in which he spent three days exploring the lunar surface along with Harrison Schmitt.",192,208,Harrison Schmitt,0,1,1
359AP8GAGGL05HB8WXR2JIRQ3NMC74,#6-20 He also pardoned 63 people outright.,14,22,pardoned,10,10,20
359AP8GAGGL05HB8WXR2JIRQ3NMC74,#6-20 He also pardoned 63 people outright.,33,41,outright,2,9,11
359AP8GAGGL05HB8WXR2JIRQ3NMC74,"#7-1 Cargo plane crashes in Kyrgyzstan, killing over 30 A Turkish cargo plane crashed just outside of Manas Airport in Kyrgyzstan en route from Hong Kong to Ä°stanbul early on Monday morning.",17,24,crashes,0,1,1
359AP8GAGGL05HB8WXR2JIRQ3NMC74,"#7-1 Cargo plane crashes in Kyrgyzstan, killing over 30 A Turkish cargo plane crashed just outside of Manas Airport in Kyrgyzstan en route from Hong Kong to Ä°stanbul early on Monday morning.",28,38,Kyrgyzstan,0,1,1
359AP8GAGGL05HB8WXR2JIRQ3NMC74,"#7-1 Cargo plane crashes in Kyrgyzstan, killing over 30 A Turkish cargo plane crashed just outside of Manas Airport in Kyrgyzstan en route from Hong Kong to Ä°stanbul early on Monday morning.",78,85,crashed,0,1,1
359AP8GAGGL05HB8WXR2JIRQ3NMC74,"#7-1 Cargo plane crashes in Kyrgyzstan, killing over 30 A Turkish cargo plane crashed just outside of Manas Airport in Kyrgyzstan en route from Hong Kong to Ä°stanbul early on Monday morning.",119,129,Kyrgyzstan,1,0,1
359AP8GAGGL05HB8WXR2JIRQ3NMC74,"#7-1 Cargo plane crashes in Kyrgyzstan, killing over 30 A Turkish cargo plane crashed just outside of Manas Airport in Kyrgyzstan en route from Hong Kong to Ä°stanbul early on Monday morning.",130,138,en route,2,4,6
359AP8GAGGL05HB8WXR2JIRQ3NMC74,"#7-1 Cargo plane crashes in Kyrgyzstan, killing over 30 A Turkish cargo plane crashed just outside of Manas Airport in Kyrgyzstan en route from Hong Kong to Ä°stanbul early on Monday morning.",133,138,route,1,0,1
359AP8GAGGL05HB8WXR2JIRQ3NMC74,"#7-1 Cargo plane crashes in Kyrgyzstan, killing over 30 A Turkish cargo plane crashed just outside of Manas Airport in Kyrgyzstan en route from Hong Kong to Ä°stanbul early on Monday morning.",157,165,Ä°stanbul,0,1,1
359AP8GAGGL05HB8WXR2JIRQ3NMC74,"#7-2 The crash destroyed approximately fifteen buildings and resulted in the death of over 30 people, including four crew members, according to the Kyrgyz emergencies ministry.",15,24,destroyed,1,1,2
359AP8GAGGL05HB8WXR2JIRQ3NMC74,"#7-2 The crash destroyed approximately fifteen buildings and resulted in the death of over 30 people, including four crew members, according to the Kyrgyz emergencies ministry.",25,38,approximately,7,3,10
359AP8GAGGL05HB8WXR2JIRQ3NMC74,"#7-2 The crash destroyed approximately fifteen buildings and resulted in the death of over 30 people, including four crew members, according to the Kyrgyz emergencies ministry.",61,69,resulted,1,1,2
359AP8GAGGL05HB8WXR2JIRQ3NMC74,"#7-2 The crash destroyed approximately fifteen buildings and resulted in the death of over 30 people, including four crew members, according to the Kyrgyz emergencies ministry.",117,121,crew,0,2,2
359AP8GAGGL05HB8WXR2JIRQ3NMC74,"#7-2 The crash destroyed approximately fifteen buildings and resulted in the death of over 30 people, including four crew members, according to the Kyrgyz emergencies ministry.",117,129,crew members,0,1,1
359AP8GAGGL05HB8WXR2JIRQ3NMC74,"#7-2 The crash destroyed approximately fifteen buildings and resulted in the death of over 30 people, including four crew members, according to the Kyrgyz emergencies ministry.",148,154,Kyrgyz,1,1,2
359AP8GAGGL05HB8WXR2JIRQ3NMC74,"#7-2 The crash destroyed approximately fifteen buildings and resulted in the death of over 30 people, including four crew members, according to the Kyrgyz emergencies ministry.",155,166,emergencies,1,1,2
359AP8GAGGL05HB8WXR2JIRQ3NMC74,"#7-2 The crash destroyed approximately fifteen buildings and resulted in the death of over 30 people, including four crew members, according to the Kyrgyz emergencies ministry.",155,175,emergencies ministry,1,0,1
359AP8GAGGL05HB8WXR2JIRQ3NMC74,"#7-2 The crash destroyed approximately fifteen buildings and resulted in the death of over 30 people, including four crew members, according to the Kyrgyz emergencies ministry.",167,175,ministry,3,0,3
359AP8GAGGL05HB8WXR2JIRQ3NMC74,#7-3 A Kyrgyz official tentatively ascribed the crash to pilot error.,23,34,tentatively,10,8,18
359AP8GAGGL05HB8WXR2JIRQ3NMC74,#7-3 A Kyrgyz official tentatively ascribed the crash to pilot error.,23,43,tentatively ascribed,2,0,2
359AP8GAGGL05HB8WXR2JIRQ3NMC74,#7-3 A Kyrgyz official tentatively ascribed the crash to pilot error.,35,43,ascribed,9,7,16
359AP8GAGGL05HB8WXR2JIRQ3NMC74,#7-3 A Kyrgyz official tentatively ascribed the crash to pilot error.,57,68,pilot error,1,0,1
359AP8GAGGL05HB8WXR2JIRQ3NMC74,#7-4 The conditions at the time were foggy.,9,19,conditions,2,0,2
359AP8GAGGL05HB8WXR2JIRQ3NMC74,#7-4 The conditions at the time were foggy.,37,42,foggy,0,3,3
359AP8GAGGL05HB8WXR2JIRQ3NMC74,#7-5 The Boeing 747 plane was supposed to make a stop-over at Manas Airport on its way to Ä°stanbul.,9,15,Boeing,0,1,1
359AP8GAGGL05HB8WXR2JIRQ3NMC74,#7-5 The Boeing 747 plane was supposed to make a stop-over at Manas Airport on its way to Ä°stanbul.,30,38,supposed,1,1,2
359AP8GAGGL05HB8WXR2JIRQ3NMC74,#7-5 The Boeing 747 plane was supposed to make a stop-over at Manas Airport on its way to Ä°stanbul.,49,58,stop-over,0,4,4
359AP8GAGGL05HB8WXR2JIRQ3NMC74,"#7-6 The crash occurred in the village of Dacha-Suu, Kyrgyzstan, while many people were still sleeping.",15,23,occurred,0,2,2
359AP8GAGGL05HB8WXR2JIRQ3NMC74,"#7-6 The crash occurred in the village of Dacha-Suu, Kyrgyzstan, while many people were still sleeping.",42,51,Dacha-Suu,1,1,2
359AP8GAGGL05HB8WXR2JIRQ3NMC74,"#7-6 The crash occurred in the village of Dacha-Suu, Kyrgyzstan, while many people were still sleeping.",94,102,sleeping,1,0,1
359AP8GAGGL05HB8WXR2JIRQ3NMC74,#7-7 The casualties are reported to have included children.,9,19,casualties,10,7,17
359AP8GAGGL05HB8WXR2JIRQ3NMC74,#7-7 The casualties are reported to have included children.,41,49,included,1,0,1
359AP8GAGGL05HB8WXR2JIRQ3NMC74,"#7-8 Despite the fog, other flights are reported to have landed safely leading up to the collision.",5,12,Despite,1,0,1
359AP8GAGGL05HB8WXR2JIRQ3NMC74,"#7-8 Despite the fog, other flights are reported to have landed safely leading up to the collision.",17,20,fog,1,1,2
359AP8GAGGL05HB8WXR2JIRQ3NMC74,"#7-8 Despite the fog, other flights are reported to have landed safely leading up to the collision.",57,63,landed,1,1,2
359AP8GAGGL05HB8WXR2JIRQ3NMC74,"#7-8 Despite the fog, other flights are reported to have landed safely leading up to the collision.",71,78,leading,1,1,2
359AP8GAGGL05HB8WXR2JIRQ3NMC74,"#7-8 Despite the fog, other flights are reported to have landed safely leading up to the collision.",71,81,leading up,0,1,1
359AP8GAGGL05HB8WXR2JIRQ3NMC74,"#7-8 Despite the fog, other flights are reported to have landed safely leading up to the collision.",71,84,leading up to,1,0,1
359AP8GAGGL05HB8WXR2JIRQ3NMC74,"#7-8 Despite the fog, other flights are reported to have landed safely leading up to the collision.",89,98,collision,5,6,11
3TKXBROM5TBK2FYAPGCLXBUU7N6JIK,"#9-14 Reports about authorities killed or injured in the riots are not yet confirmed, says the BBC.",6,13,Reports,0,1,1
3TKXBROM5TBK2FYAPGCLXBUU7N6JIK,"#9-14 Reports about authorities killed or injured in the riots are not yet confirmed, says the BBC.",20,31,authorities,9,5,14
3TKXBROM5TBK2FYAPGCLXBUU7N6JIK,"#9-14 Reports about authorities killed or injured in the riots are not yet confirmed, says the BBC.",42,49,injured,2,2,4
3TKXBROM5TBK2FYAPGCLXBUU7N6JIK,"#9-14 Reports about authorities killed or injured in the riots are not yet confirmed, says the BBC.",57,62,riots,4,5,9
3TKXBROM5TBK2FYAPGCLXBUU7N6JIK,"#9-14 Reports about authorities killed or injured in the riots are not yet confirmed, says the BBC.",75,84,confirmed,3,5,8
3TKXBROM5TBK2FYAPGCLXBUU7N6JIK,#9-15 O Globo also reported that one inmate attempted to escape but was quickly recaptured.,6,13,O Globo,1,0,1
3TKXBROM5TBK2FYAPGCLXBUU7N6JIK,#9-15 O Globo also reported that one inmate attempted to escape but was quickly recaptured.,8,13,Globo,1,0,1
3TKXBROM5TBK2FYAPGCLXBUU7N6JIK,#9-15 O Globo also reported that one inmate attempted to escape but was quickly recaptured.,19,27,reported,0,1,1
3TKXBROM5TBK2FYAPGCLXBUU7N6JIK,#9-15 O Globo also reported that one inmate attempted to escape but was quickly recaptured.,37,43,inmate,4,5,9
3TKXBROM5TBK2FYAPGCLXBUU7N6JIK,#9-15 O Globo also reported that one inmate attempted to escape but was quickly recaptured.,37,53,inmate attempted,1,1,2
3TKXBROM5TBK2FYAPGCLXBUU7N6JIK,#9-15 O Globo also reported that one inmate attempted to escape but was quickly recaptured.,44,53,attempted,0,4,4
3TKXBROM5TBK2FYAPGCLXBUU7N6JIK,#9-15 O Globo also reported that one inmate attempted to escape but was quickly recaptured.,57,63,escape,1,0,1
3TKXBROM5TBK2FYAPGCLXBUU7N6JIK,#9-15 O Globo also reported that one inmate attempted to escape but was quickly recaptured.,80,90,recaptured,10,5,15
3TKXBROM5TBK2FYAPGCLXBUU7N6JIK,"#9-16 No other inmates have been reported missing, but nine injured inmates were sent to hospital.",15,22,inmates,3,3,6
3TKXBROM5TBK2FYAPGCLXBUU7N6JIK,"#9-16 No other inmates have been reported missing, but nine injured inmates were sent to hospital.",33,41,reported,1,0,1
3TKXBROM5TBK2FYAPGCLXBUU7N6JIK,"#9-16 No other inmates have been reported missing, but nine injured inmates were sent to hospital.",42,49,missing,0,1,1
3TKXBROM5TBK2FYAPGCLXBUU7N6JIK,"#9-16 No other inmates have been reported missing, but nine injured inmates were sent to hospital.",60,67,injured,2,0,2
3TKXBROM5TBK2FYAPGCLXBUU7N6JIK,"#9-16 No other inmates have been reported missing, but nine injured inmates were sent to hospital.",68,75,inmates,1,4,5
3TKXBROM5TBK2FYAPGCLXBUU7N6JIK,"#9-16 No other inmates have been reported missing, but nine injured inmates were sent to hospital.",89,97,hospital,1,0,1
3TKXBROM5TBK2FYAPGCLXBUU7N6JIK,#9-17 O Globo says the cause of the riot was drug-related.,23,28,cause,0,1,1
3TKXBROM5TBK2FYAPGCLXBUU7N6JIK,#9-17 O Globo says the cause of the riot was drug-related.,36,40,riot,2,1,3
3TKXBROM5TBK2FYAPGCLXBUU7N6JIK,#9-17 O Globo says the cause of the riot was drug-related.,45,57,drug-related,5,3,8
3TKXBROM5TBK2FYAPGCLXBUU7N6JIK,#9-18 PCC and Comando Vermelho cooperated on drug trade from mid-1990s to reportedly summer 2016.,14,21,Comando,0,1,1
3TKXBROM5TBK2FYAPGCLXBUU7N6JIK,#9-18 PCC and Comando Vermelho cooperated on drug trade from mid-1990s to reportedly summer 2016.,22,30,Vermelho,0,1,1
3TKXBROM5TBK2FYAPGCLXBUU7N6JIK,#9-18 PCC and Comando Vermelho cooperated on drug trade from mid-1990s to reportedly summer 2016.,31,41,cooperated,6,3,9
3TKXBROM5TBK2FYAPGCLXBUU7N6JIK,#9-18 PCC and Comando Vermelho cooperated on drug trade from mid-1990s to reportedly summer 2016.,45,55,drug trade,2,0,2
3TKXBROM5TBK2FYAPGCLXBUU7N6JIK,#9-18 PCC and Comando Vermelho cooperated on drug trade from mid-1990s to reportedly summer 2016.,74,84,reportedly,2,2,4
3TKXBROM5TBK2FYAPGCLXBUU7N6JIK,"#9-19 Their split led Comando Vermelho to team up with five other gang organizations ""to counter the PCC's growing might.""",12,17,split,1,2,3
3TKXBROM5TBK2FYAPGCLXBUU7N6JIK,"#9-19 Their split led Comando Vermelho to team up with five other gang organizations ""to counter the PCC's growing might.""",30,38,Vermelho,1,0,1
3TKXBROM5TBK2FYAPGCLXBUU7N6JIK,"#9-19 Their split led Comando Vermelho to team up with five other gang organizations ""to counter the PCC's growing might.""",66,70,gang,0,2,2
3TKXBROM5TBK2FYAPGCLXBUU7N6JIK,"#9-19 Their split led Comando Vermelho to team up with five other gang organizations ""to counter the PCC's growing might.""",66,84,gang organizations,1,0,1
3TKXBROM5TBK2FYAPGCLXBUU7N6JIK,"#9-19 Their split led Comando Vermelho to team up with five other gang organizations ""to counter the PCC's growing might.""",71,84,organizations,3,2,5
3TKXBROM5TBK2FYAPGCLXBUU7N6JIK,"#9-19 Their split led Comando Vermelho to team up with five other gang organizations ""to counter the PCC's growing might.""",89,96,counter,0,2,2
3TKXBROM5TBK2FYAPGCLXBUU7N6JIK,"#9-19 Their split led Comando Vermelho to team up with five other gang organizations ""to counter the PCC's growing might.""",107,120,growing might,2,0,2
3TKXBROM5TBK2FYAPGCLXBUU7N6JIK,"#9-19 Their split led Comando Vermelho to team up with five other gang organizations ""to counter the PCC's growing might.""",115,120,might,1,0,1
3TKXBROM5TBK2FYAPGCLXBUU7N6JIK,#9-20 The AlcaÃ§uz prison riot is part of a series of Brazilian prison riots this year.,10,17,AlcaÃ§uz,1,1,2
3TKXBROM5TBK2FYAPGCLXBUU7N6JIK,#9-20 The AlcaÃ§uz prison riot is part of a series of Brazilian prison riots this year.,18,29,prison riot,1,2,3
3TKXBROM5TBK2FYAPGCLXBUU7N6JIK,#9-20 The AlcaÃ§uz prison riot is part of a series of Brazilian prison riots this year.,25,29,riot,2,2,4
3TKXBROM5TBK2FYAPGCLXBUU7N6JIK,#9-20 The AlcaÃ§uz prison riot is part of a series of Brazilian prison riots this year.,53,62,Brazilian,0,1,1
3TKXBROM5TBK2FYAPGCLXBUU7N6JIK,#9-20 The AlcaÃ§uz prison riot is part of a series of Brazilian prison riots this year.,63,75,prison riots,1,0,1
3TKXBROM5TBK2FYAPGCLXBUU7N6JIK,#9-20 The AlcaÃ§uz prison riot is part of a series of Brazilian prison riots this year.,70,75,riots,0,1,1
3TKXBROM5TBK2FYAPGCLXBUU7N6JIK,"#9-21 At least 100 inmates died in this month's previous two riots, one in Amazonas and another in Roraima.",48,56,previous,1,0,1
3TKXBROM5TBK2FYAPGCLXBUU7N6JIK,"#9-21 At least 100 inmates died in this month's previous two riots, one in Amazonas and another in Roraima.",61,66,riots,0,1,1
3TKXBROM5TBK2FYAPGCLXBUU7N6JIK,"#9-21 At least 100 inmates died in this month's previous two riots, one in Amazonas and another in Roraima.",75,83,Amazonas,0,1,1
3TKXBROM5TBK2FYAPGCLXBUU7N6JIK,"#9-21 At least 100 inmates died in this month's previous two riots, one in Amazonas and another in Roraima.",99,106,Roraima,1,1,2
33P2GD6NRNTFH4T81JUCYETSMZRHKO,"#42-62 NB: Legally, no.",11,18,Legally,3,2,5
33P2GD6NRNTFH4T81JUCYETSMZRHKO,#42-63 Insects do not have any 'rights' as such regarding ethics.,7,14,Insects,2,0,2
33P2GD6NRNTFH4T81JUCYETSMZRHKO,#42-63 Insects do not have any 'rights' as such regarding ethics.,48,57,regarding,0,2,2
33P2GD6NRNTFH4T81JUCYETSMZRHKO,#42-63 Insects do not have any 'rights' as such regarding ethics.,48,64,regarding ethics,0,1,1
33P2GD6NRNTFH4T81JUCYETSMZRHKO,#42-63 Insects do not have any 'rights' as such regarding ethics.,58,64,ethics,10,8,18
33P2GD6NRNTFH4T81JUCYETSMZRHKO,"#42-64 That said, we do take measures to not make them 'suffer unnecessarily'.",24,37,take measures,1,0,1
33P2GD6NRNTFH4T81JUCYETSMZRHKO,"#42-64 That said, we do take measures to not make them 'suffer unnecessarily'.",29,37,measures,1,2,3
33P2GD6NRNTFH4T81JUCYETSMZRHKO,"#42-64 That said, we do take measures to not make them 'suffer unnecessarily'.",56,62,suffer,1,0,1
33P2GD6NRNTFH4T81JUCYETSMZRHKO,"#42-64 That said, we do take measures to not make them 'suffer unnecessarily'.",56,76,suffer unnecessarily,1,0,1
33P2GD6NRNTFH4T81JUCYETSMZRHKO,"#42-64 That said, we do take measures to not make them 'suffer unnecessarily'.",63,76,unnecessarily,4,3,7
33P2GD6NRNTFH4T81JUCYETSMZRHKO,"#42-65 For example, dissections are done when the ants are anesthetized (either by CO2 or Ice), and when ants need to be killed, we do it in alcohol, which kills the ants in a matter of seconds.",20,31,dissections,10,10,20
33P2GD6NRNTFH4T81JUCYETSMZRHKO,"#42-65 For example, dissections are done when the ants are anesthetized (either by CO2 or Ice), and when ants need to be killed, we do it in alcohol, which kills the ants in a matter of seconds.",50,54,ants,0,1,1
33P2GD6NRNTFH4T81JUCYETSMZRHKO,"#42-65 For example, dissections are done when the ants are anesthetized (either by CO2 or Ice), and when ants need to be killed, we do it in alcohol, which kills the ants in a matter of seconds.",59,71,anesthetized,10,10,20
33P2GD6NRNTFH4T81JUCYETSMZRHKO,"#42-65 For example, dissections are done when the ants are anesthetized (either by CO2 or Ice), and when ants need to be killed, we do it in alcohol, which kills the ants in a matter of seconds.",141,148,alcohol,1,0,1
33P2GD6NRNTFH4T81JUCYETSMZRHKO,"#42-65 For example, dissections are done when the ants are anesthetized (either by CO2 or Ice), and when ants need to be killed, we do it in alcohol, which kills the ants in a matter of seconds.",176,193,matter of seconds,0,1,1
33P2GD6NRNTFH4T81JUCYETSMZRHKO,"#42-66 So while the ants do not have 'rights' as such, we still try to handle them with as much respect as possible (even though the experiment involves infecting them with a deadly fungus).",96,103,respect,1,0,1
33P2GD6NRNTFH4T81JUCYETSMZRHKO,"#42-66 So while the ants do not have 'rights' as such, we still try to handle them with as much respect as possible (even though the experiment involves infecting them with a deadly fungus).",133,143,experiment,5,0,5
33P2GD6NRNTFH4T81JUCYETSMZRHKO,"#42-66 So while the ants do not have 'rights' as such, we still try to handle them with as much respect as possible (even though the experiment involves infecting them with a deadly fungus).",153,162,infecting,3,2,5
33P2GD6NRNTFH4T81JUCYETSMZRHKO,"#42-66 So while the ants do not have 'rights' as such, we still try to handle them with as much respect as possible (even though the experiment involves infecting them with a deadly fungus).",175,188,deadly fungus,0,1,1
33P2GD6NRNTFH4T81JUCYETSMZRHKO,"#42-66 So while the ants do not have 'rights' as such, we still try to handle them with as much respect as possible (even though the experiment involves infecting them with a deadly fungus).",182,188,fungus,3,0,3
33P2GD6NRNTFH4T81JUCYETSMZRHKO,"#42-67 But even though the 12,000 ants in our study sounds like a lot (and it is), this is negligible in the 'grand scheme of things'.",52,63,sounds like,0,1,1
33P2GD6NRNTFH4T81JUCYETSMZRHKO,"#42-67 But even though the 12,000 ants in our study sounds like a lot (and it is), this is negligible in the 'grand scheme of things'.",91,101,negligible,10,9,19
33P2GD6NRNTFH4T81JUCYETSMZRHKO,"#42-67 But even though the 12,000 ants in our study sounds like a lot (and it is), this is negligible in the 'grand scheme of things'.",110,115,grand,0,1,1
33P2GD6NRNTFH4T81JUCYETSMZRHKO,"#42-67 But even though the 12,000 ants in our study sounds like a lot (and it is), this is negligible in the 'grand scheme of things'.",110,122,grand scheme,0,2,2
33P2GD6NRNTFH4T81JUCYETSMZRHKO,"#42-67 But even though the 12,000 ants in our study sounds like a lot (and it is), this is negligible in the 'grand scheme of things'.",110,132,grand scheme of things,3,0,3
33P2GD6NRNTFH4T81JUCYETSMZRHKO,"#42-67 But even though the 12,000 ants in our study sounds like a lot (and it is), this is negligible in the 'grand scheme of things'.",116,122,scheme,3,0,3
33P2GD6NRNTFH4T81JUCYETSMZRHKO,"#42-68 It has been calculated that in the Netherlands alone, nearly a trillion insects die against just the licence-plates of cars every six months.",19,29,calculated,3,1,4
33P2GD6NRNTFH4T81JUCYETSMZRHKO,"#42-68 It has been calculated that in the Netherlands alone, nearly a trillion insects die against just the licence-plates of cars every six months.",70,78,trillion,3,4,7
33P2GD6NRNTFH4T81JUCYETSMZRHKO,"#42-68 It has been calculated that in the Netherlands alone, nearly a trillion insects die against just the licence-plates of cars every six months.",108,122,licence-plates,1,2,3
3UDTAB6HH60KP84LZEW22DGVPOD90K,#2-14 Irabor promised an investigation.,13,21,promised,1,2,3
3UDTAB6HH60KP84LZEW22DGVPOD90K,#2-14 Irabor promised an investigation.,25,38,investigation,8,3,11
3UDTAB6HH60KP84LZEW22DGVPOD90K,"#2-15 President Muhammadu Buhari said he was saddened by ""this regrettable operational mistake"" and sought calm.",45,53,saddened,5,8,13
3UDTAB6HH60KP84LZEW22DGVPOD90K,"#2-15 President Muhammadu Buhari said he was saddened by ""this regrettable operational mistake"" and sought calm.",58,94,this regrettable operational mistake,1,0,1
3UDTAB6HH60KP84LZEW22DGVPOD90K,"#2-15 President Muhammadu Buhari said he was saddened by ""this regrettable operational mistake"" and sought calm.",63,74,regrettable,7,10,17
3UDTAB6HH60KP84LZEW22DGVPOD90K,"#2-15 President Muhammadu Buhari said he was saddened by ""this regrettable operational mistake"" and sought calm.",63,86,regrettable operational,1,0,1
3UDTAB6HH60KP84LZEW22DGVPOD90K,"#2-15 President Muhammadu Buhari said he was saddened by ""this regrettable operational mistake"" and sought calm.",63,94,regrettable operational mistake,2,1,3
3UDTAB6HH60KP84LZEW22DGVPOD90K,"#2-15 President Muhammadu Buhari said he was saddened by ""this regrettable operational mistake"" and sought calm.",75,86,operational,1,0,1
3UDTAB6HH60KP84LZEW22DGVPOD90K,"#2-15 President Muhammadu Buhari said he was saddened by ""this regrettable operational mistake"" and sought calm.",100,106,sought,1,4,5
3UDTAB6HH60KP84LZEW22DGVPOD90K,"#2-15 President Muhammadu Buhari said he was saddened by ""this regrettable operational mistake"" and sought calm.",100,111,sought calm,1,1,2
3UDTAB6HH60KP84LZEW22DGVPOD90K,"#2-16 ""This large-scale attack on vulnerable people who have already fled from extreme violence is shocking and unacceptable,"" MSF operational chief Dr Jean-ClÃ©ment Cabrol said.",12,23,large-scale,3,0,3
3UDTAB6HH60KP84LZEW22DGVPOD90K,"#2-16 ""This large-scale attack on vulnerable people who have already fled from extreme violence is shocking and unacceptable,"" MSF operational chief Dr Jean-ClÃ©ment Cabrol said.",12,30,large-scale attack,0,1,1
3UDTAB6HH60KP84LZEW22DGVPOD90K,"#2-16 ""This large-scale attack on vulnerable people who have already fled from extreme violence is shocking and unacceptable,"" MSF operational chief Dr Jean-ClÃ©ment Cabrol said.",34,44,vulnerable,9,7,16
3UDTAB6HH60KP84LZEW22DGVPOD90K,"#2-16 ""This large-scale attack on vulnerable people who have already fled from extreme violence is shocking and unacceptable,"" MSF operational chief Dr Jean-ClÃ©ment Cabrol said.",34,51,vulnerable people,1,1,2
3UDTAB6HH60KP84LZEW22DGVPOD90K,"#2-16 ""This large-scale attack on vulnerable people who have already fled from extreme violence is shocking and unacceptable,"" MSF operational chief Dr Jean-ClÃ©ment Cabrol said.",69,73,fled,0,6,6
3UDTAB6HH60KP84LZEW22DGVPOD90K,"#2-16 ""This large-scale attack on vulnerable people who have already fled from extreme violence is shocking and unacceptable,"" MSF operational chief Dr Jean-ClÃ©ment Cabrol said.",79,86,extreme,0,1,1
3UDTAB6HH60KP84LZEW22DGVPOD90K,"#2-16 ""This large-scale attack on vulnerable people who have already fled from extreme violence is shocking and unacceptable,"" MSF operational chief Dr Jean-ClÃ©ment Cabrol said.",79,95,extreme violence,0,1,1
3UDTAB6HH60KP84LZEW22DGVPOD90K,"#2-16 ""This large-scale attack on vulnerable people who have already fled from extreme violence is shocking and unacceptable,"" MSF operational chief Dr Jean-ClÃ©ment Cabrol said.",87,95,violence,1,0,1
3UDTAB6HH60KP84LZEW22DGVPOD90K,"#2-16 ""This large-scale attack on vulnerable people who have already fled from extreme violence is shocking and unacceptable,"" MSF operational chief Dr Jean-ClÃ©ment Cabrol said.",99,107,shocking,0,1,1
3UDTAB6HH60KP84LZEW22DGVPOD90K,"#2-16 ""This large-scale attack on vulnerable people who have already fled from extreme violence is shocking and unacceptable,"" MSF operational chief Dr Jean-ClÃ©ment Cabrol said.",99,124,shocking and unacceptable,0,1,1
3UDTAB6HH60KP84LZEW22DGVPOD90K,"#2-16 ""This large-scale attack on vulnerable people who have already fled from extreme violence is shocking and unacceptable,"" MSF operational chief Dr Jean-ClÃ©ment Cabrol said.",112,124,unacceptable,3,1,4
3UDTAB6HH60KP84LZEW22DGVPOD90K,"#2-16 ""This large-scale attack on vulnerable people who have already fled from extreme violence is shocking and unacceptable,"" MSF operational chief Dr Jean-ClÃ©ment Cabrol said.",131,142,operational,2,1,3
3UDTAB6HH60KP84LZEW22DGVPOD90K,#2-17 The Red Cross said it has staff and facilities ready in neighbouring Cameroon and Chad to assist.,42,52,facilities,2,1,3
3UDTAB6HH60KP84LZEW22DGVPOD90K,#2-17 The Red Cross said it has staff and facilities ready in neighbouring Cameroon and Chad to assist.,62,74,neighbouring,8,3,11
3UDTAB6HH60KP84LZEW22DGVPOD90K,#2-17 The Red Cross said it has staff and facilities ready in neighbouring Cameroon and Chad to assist.,75,83,Cameroon,0,1,1
3UDTAB6HH60KP84LZEW22DGVPOD90K,#2-17 The Red Cross said it has staff and facilities ready in neighbouring Cameroon and Chad to assist.,88,92,Chad,1,0,1
3UDTAB6HH60KP84LZEW22DGVPOD90K,"#2-18 ""The whole camp is controlled by the army and no one can come in or out without being checked,"" said MSF head of emergencies Hugues Robert.",119,130,emergencies,4,2,6
3UDTAB6HH60KP84LZEW22DGVPOD90K,"#2-18 ""The whole camp is controlled by the army and no one can come in or out without being checked,"" said MSF head of emergencies Hugues Robert.",131,137,Hugues,1,0,1
3UDTAB6HH60KP84LZEW22DGVPOD90K,"#2-19 Robert added the group knew travel and work in the area was dangerous, and took precautions.",66,75,dangerous,0,1,1
3UDTAB6HH60KP84LZEW22DGVPOD90K,"#2-19 Robert added the group knew travel and work in the area was dangerous, and took precautions.",86,97,precautions,6,7,13
3UDTAB6HH60KP84LZEW22DGVPOD90K,"#2-20 Helicopters have been evacuating the wounded, including a United Nations helicopter which brought four medical personnel and 400kg (900lb) of emergency medical aid, and left with eight wounded Red Cross workers.",6,17,Helicopters,1,0,1
3UDTAB6HH60KP84LZEW22DGVPOD90K,"#2-20 Helicopters have been evacuating the wounded, including a United Nations helicopter which brought four medical personnel and 400kg (900lb) of emergency medical aid, and left with eight wounded Red Cross workers.",28,38,evacuating,10,9,19
3UDTAB6HH60KP84LZEW22DGVPOD90K,"#2-20 Helicopters have been evacuating the wounded, including a United Nations helicopter which brought four medical personnel and 400kg (900lb) of emergency medical aid, and left with eight wounded Red Cross workers.",28,50,evacuating the wounded,1,0,1
3UDTAB6HH60KP84LZEW22DGVPOD90K,"#2-20 Helicopters have been evacuating the wounded, including a United Nations helicopter which brought four medical personnel and 400kg (900lb) of emergency medical aid, and left with eight wounded Red Cross workers.",43,50,wounded,1,1,2
3UDTAB6HH60KP84LZEW22DGVPOD90K,"#2-20 Helicopters have been evacuating the wounded, including a United Nations helicopter which brought four medical personnel and 400kg (900lb) of emergency medical aid, and left with eight wounded Red Cross workers.",79,89,helicopter,2,0,2
3UDTAB6HH60KP84LZEW22DGVPOD90K,"#2-20 Helicopters have been evacuating the wounded, including a United Nations helicopter which brought four medical personnel and 400kg (900lb) of emergency medical aid, and left with eight wounded Red Cross workers.",96,103,brought,0,1,1
3UDTAB6HH60KP84LZEW22DGVPOD90K,"#2-20 Helicopters have been evacuating the wounded, including a United Nations helicopter which brought four medical personnel and 400kg (900lb) of emergency medical aid, and left with eight wounded Red Cross workers.",117,126,personnel,4,1,5
3UDTAB6HH60KP84LZEW22DGVPOD90K,"#2-20 Helicopters have been evacuating the wounded, including a United Nations helicopter which brought four medical personnel and 400kg (900lb) of emergency medical aid, and left with eight wounded Red Cross workers.",148,169,emergency medical aid,1,0,1
3UDTAB6HH60KP84LZEW22DGVPOD90K,"#2-20 Helicopters have been evacuating the wounded, including a United Nations helicopter which brought four medical personnel and 400kg (900lb) of emergency medical aid, and left with eight wounded Red Cross workers.",191,198,wounded,2,0,2
3TZDZ3Y0JS7KWXP3VX02GIZ5UGJ91N,#2-21 The UN is in the midst of an appeal for aid to the famine-hit region.,23,28,midst,5,5,10
3TZDZ3Y0JS7KWXP3VX02GIZ5UGJ91N,#2-21 The UN is in the midst of an appeal for aid to the famine-hit region.,35,41,appeal,1,2,3
3TZDZ3Y0JS7KWXP3VX02GIZ5UGJ91N,#2-21 The UN is in the midst of an appeal for aid to the famine-hit region.,46,49,aid,0,1,1
3TZDZ3Y0JS7KWXP3VX02GIZ5UGJ91N,#2-21 The UN is in the midst of an appeal for aid to the famine-hit region.,57,67,famine-hit,10,9,19
3TZDZ3Y0JS7KWXP3VX02GIZ5UGJ91N,#2-21 The UN is in the midst of an appeal for aid to the famine-hit region.,57,74,famine-hit region,2,0,2
3TZDZ3Y0JS7KWXP3VX02GIZ5UGJ91N,"#20-1 NASA's New Horizons space probe performs first close planetary flyby of Pluto On Tuesday, NASA's space probe New Horizons reached near Pluto.",17,25,Horizons,0,1,1
3TZDZ3Y0JS7KWXP3VX02GIZ5UGJ91N,"#20-1 NASA's New Horizons space probe performs first close planetary flyby of Pluto On Tuesday, NASA's space probe New Horizons reached near Pluto.",26,37,space probe,2,1,3
3TZDZ3Y0JS7KWXP3VX02GIZ5UGJ91N,"#20-1 NASA's New Horizons space probe performs first close planetary flyby of Pluto On Tuesday, NASA's space probe New Horizons reached near Pluto.",32,37,probe,3,6,9
3TZDZ3Y0JS7KWXP3VX02GIZ5UGJ91N,"#20-1 NASA's New Horizons space probe performs first close planetary flyby of Pluto On Tuesday, NASA's space probe New Horizons reached near Pluto.",38,46,performs,0,1,1
3TZDZ3Y0JS7KWXP3VX02GIZ5UGJ91N,"#20-1 NASA's New Horizons space probe performs first close planetary flyby of Pluto On Tuesday, NASA's space probe New Horizons reached near Pluto.",59,68,planetary,3,3,6
3TZDZ3Y0JS7KWXP3VX02GIZ5UGJ91N,"#20-1 NASA's New Horizons space probe performs first close planetary flyby of Pluto On Tuesday, NASA's space probe New Horizons reached near Pluto.",59,74,planetary flyby,6,2,8
3TZDZ3Y0JS7KWXP3VX02GIZ5UGJ91N,"#20-1 NASA's New Horizons space probe performs first close planetary flyby of Pluto On Tuesday, NASA's space probe New Horizons reached near Pluto.",69,74,flyby,2,3,5
3TZDZ3Y0JS7KWXP3VX02GIZ5UGJ91N,"#20-1 NASA's New Horizons space probe performs first close planetary flyby of Pluto On Tuesday, NASA's space probe New Horizons reached near Pluto.",109,114,probe,1,1,2
3TZDZ3Y0JS7KWXP3VX02GIZ5UGJ91N,"#20-2 It was launched about nine-and-a-half years ago on January 19, 2006 to collect data about the dwarf planet, amongst other targets.",13,21,launched,1,2,3
3TZDZ3Y0JS7KWXP3VX02GIZ5UGJ91N,"#20-2 It was launched about nine-and-a-half years ago on January 19, 2006 to collect data about the dwarf planet, amongst other targets.",28,43,nine-and-a-half,2,0,2
3TZDZ3Y0JS7KWXP3VX02GIZ5UGJ91N,"#20-2 It was launched about nine-and-a-half years ago on January 19, 2006 to collect data about the dwarf planet, amongst other targets.",100,105,dwarf,4,5,9
3TZDZ3Y0JS7KWXP3VX02GIZ5UGJ91N,"#20-2 It was launched about nine-and-a-half years ago on January 19, 2006 to collect data about the dwarf planet, amongst other targets.",100,112,dwarf planet,2,4,6
3TZDZ3Y0JS7KWXP3VX02GIZ5UGJ91N,"#20-2 It was launched about nine-and-a-half years ago on January 19, 2006 to collect data about the dwarf planet, amongst other targets.",114,121,amongst,3,1,4
3TZDZ3Y0JS7KWXP3VX02GIZ5UGJ91N,#20-3 With its flyby on Tuesday it became the first spacecraft to explore Pluto closely.,15,20,flyby,2,1,3
3TZDZ3Y0JS7KWXP3VX02GIZ5UGJ91N,#20-3 With its flyby on Tuesday it became the first spacecraft to explore Pluto closely.,52,62,spacecraft,3,4,7
3TZDZ3Y0JS7KWXP3VX02GIZ5UGJ91N,#20-3 With its flyby on Tuesday it became the first spacecraft to explore Pluto closely.,66,73,explore,0,1,1
3TZDZ3Y0JS7KWXP3VX02GIZ5UGJ91N,#20-4 NASA collected data regarding the geology of the planet.,26,35,regarding,0,2,2
3TZDZ3Y0JS7KWXP3VX02GIZ5UGJ91N,#20-4 NASA collected data regarding the geology of the planet.,40,47,geology,9,4,13
3TZDZ3Y0JS7KWXP3VX02GIZ5UGJ91N,#20-5 The space probe had seven scientific instruments and massed about 450 kilograms (about 1000 lb).,16,21,probe,0,1,1
3TZDZ3Y0JS7KWXP3VX02GIZ5UGJ91N,#20-5 The space probe had seven scientific instruments and massed about 450 kilograms (about 1000 lb).,32,42,scientific,6,0,6
3TZDZ3Y0JS7KWXP3VX02GIZ5UGJ91N,#20-5 The space probe had seven scientific instruments and massed about 450 kilograms (about 1000 lb).,32,54,scientific instruments,2,0,2
3TZDZ3Y0JS7KWXP3VX02GIZ5UGJ91N,#20-5 The space probe had seven scientific instruments and massed about 450 kilograms (about 1000 lb).,43,54,instruments,2,3,5
3TZDZ3Y0JS7KWXP3VX02GIZ5UGJ91N,#20-5 The space probe had seven scientific instruments and massed about 450 kilograms (about 1000 lb).,59,65,massed,2,5,7
3TZDZ3Y0JS7KWXP3VX02GIZ5UGJ91N,#20-5 The space probe had seven scientific instruments and massed about 450 kilograms (about 1000 lb).,76,85,kilograms,3,0,3
3TZDZ3Y0JS7KWXP3VX02GIZ5UGJ91N,#20-6 The probe has Pluto and the Kuiper Belt as its highest priorities.,10,15,probe,0,1,1
3TZDZ3Y0JS7KWXP3VX02GIZ5UGJ91N,#20-6 The probe has Pluto and the Kuiper Belt as its highest priorities.,34,40,Kuiper,0,1,1
3TZDZ3Y0JS7KWXP3VX02GIZ5UGJ91N,#20-6 The probe has Pluto and the Kuiper Belt as its highest priorities.,34,45,Kuiper Belt,2,0,2
3TZDZ3Y0JS7KWXP3VX02GIZ5UGJ91N,#20-6 The probe has Pluto and the Kuiper Belt as its highest priorities.,61,71,priorities,2,5,7
3TZDZ3Y0JS7KWXP3VX02GIZ5UGJ91N,#20-7 Scientists released images from the flyby on Wednesday.,17,25,released,1,0,1
3TZDZ3Y0JS7KWXP3VX02GIZ5UGJ91N,#20-7 Scientists released images from the flyby on Wednesday.,42,47,flyby,1,0,1
3TZDZ3Y0JS7KWXP3VX02GIZ5UGJ91N,"#20-8 Mission scientist John Spencer said, ""We have not found a single impact crater on this image.",6,13,Mission,1,0,1
3TZDZ3Y0JS7KWXP3VX02GIZ5UGJ91N,"#20-8 Mission scientist John Spencer said, ""We have not found a single impact crater on this image.",14,23,scientist,0,1,1
3TZDZ3Y0JS7KWXP3VX02GIZ5UGJ91N,"#20-8 Mission scientist John Spencer said, ""We have not found a single impact crater on this image.",71,77,impact,1,2,3
3TZDZ3Y0JS7KWXP3VX02GIZ5UGJ91N,"#20-8 Mission scientist John Spencer said, ""We have not found a single impact crater on this image.",71,84,impact crater,3,1,4
3TZDZ3Y0JS7KWXP3VX02GIZ5UGJ91N,"#20-8 Mission scientist John Spencer said, ""We have not found a single impact crater on this image.",78,84,crater,3,7,10
3MZ3TAMYTLO103HNXLLUZ2GLH40IRB,#15-40 Trump has made clear he intends to seek a closer relationship with Russia.,31,38,intends,4,5,9
3MZ3TAMYTLO103HNXLLUZ2GLH40IRB,#15-40 Trump has made clear he intends to seek a closer relationship with Russia.,31,46,intends to seek,0,1,1
3MZ3TAMYTLO103HNXLLUZ2GLH40IRB,#15-40 Trump has made clear he intends to seek a closer relationship with Russia.,42,46,seek,0,1,1
3MZ3TAMYTLO103HNXLLUZ2GLH40IRB,"#15-41 Rex Tillerson, proposed Secretary of State for the Trump administration, implied the troops would be staying put.",22,30,proposed,6,2,8
3MZ3TAMYTLO103HNXLLUZ2GLH40IRB,"#15-41 Rex Tillerson, proposed Secretary of State for the Trump administration, implied the troops would be staying put.",31,49,Secretary of State,2,0,2
3MZ3TAMYTLO103HNXLLUZ2GLH40IRB,"#15-41 Rex Tillerson, proposed Secretary of State for the Trump administration, implied the troops would be staying put.",64,78,administration,8,3,11
3MZ3TAMYTLO103HNXLLUZ2GLH40IRB,"#15-41 Rex Tillerson, proposed Secretary of State for the Trump administration, implied the troops would be staying put.",80,87,implied,10,10,20
3MZ3TAMYTLO103HNXLLUZ2GLH40IRB,"#15-41 Rex Tillerson, proposed Secretary of State for the Trump administration, implied the troops would be staying put.",92,98,troops,0,3,3
3MZ3TAMYTLO103HNXLLUZ2GLH40IRB,"#15-41 Rex Tillerson, proposed Secretary of State for the Trump administration, implied the troops would be staying put.",108,115,staying,0,2,2
3MZ3TAMYTLO103HNXLLUZ2GLH40IRB,"#15-41 Rex Tillerson, proposed Secretary of State for the Trump administration, implied the troops would be staying put.",108,119,staying put,0,2,2
3MZ3TAMYTLO103HNXLLUZ2GLH40IRB,"#15-42 He said Russia had claimed Crimea ""as an act of force"" requiring the US to offer ""a proportional show of force"".",26,33,claimed,1,1,2
3MZ3TAMYTLO103HNXLLUZ2GLH40IRB,"#15-42 He said Russia had claimed Crimea ""as an act of force"" requiring the US to offer ""a proportional show of force"".",34,40,Crimea,2,1,3
3MZ3TAMYTLO103HNXLLUZ2GLH40IRB,"#15-42 He said Russia had claimed Crimea ""as an act of force"" requiring the US to offer ""a proportional show of force"".",42,60,as an act of force,1,0,1
3MZ3TAMYTLO103HNXLLUZ2GLH40IRB,"#15-42 He said Russia had claimed Crimea ""as an act of force"" requiring the US to offer ""a proportional show of force"".",62,71,requiring,2,0,2
3MZ3TAMYTLO103HNXLLUZ2GLH40IRB,"#15-42 He said Russia had claimed Crimea ""as an act of force"" requiring the US to offer ""a proportional show of force"".",89,117,a proportional show of force,2,0,2
3MZ3TAMYTLO103HNXLLUZ2GLH40IRB,"#15-42 He said Russia had claimed Crimea ""as an act of force"" requiring the US to offer ""a proportional show of force"".",91,103,proportional,10,8,18
3MZ3TAMYTLO103HNXLLUZ2GLH40IRB,"#15-42 He said Russia had claimed Crimea ""as an act of force"" requiring the US to offer ""a proportional show of force"".",91,108,proportional show,0,1,1
3MZ3TAMYTLO103HNXLLUZ2GLH40IRB,"#15-42 He said Russia had claimed Crimea ""as an act of force"" requiring the US to offer ""a proportional show of force"".",91,117,proportional show of force,1,0,1
3MZ3TAMYTLO103HNXLLUZ2GLH40IRB,"#15-43 Trump's proposed Secretary of Defense, James Mattis, backed NATO before the US Senate yesterday.",15,23,proposed,3,0,3
3MZ3TAMYTLO103HNXLLUZ2GLH40IRB,"#15-43 Trump's proposed Secretary of Defense, James Mattis, backed NATO before the US Senate yesterday.",24,44,Secretary of Defense,1,0,1
3MZ3TAMYTLO103HNXLLUZ2GLH40IRB,"#15-43 Trump's proposed Secretary of Defense, James Mattis, backed NATO before the US Senate yesterday.",67,71,NATO,1,0,1
3MZ3TAMYTLO103HNXLLUZ2GLH40IRB,#15-44 He said Putin aimed to weaken the NATO alliance.,21,26,aimed,0,1,1
3MZ3TAMYTLO103HNXLLUZ2GLH40IRB,#15-44 He said Putin aimed to weaken the NATO alliance.,30,36,weaken,1,3,4
3MZ3TAMYTLO103HNXLLUZ2GLH40IRB,#15-44 He said Putin aimed to weaken the NATO alliance.,41,54,NATO alliance,3,1,4
3MZ3TAMYTLO103HNXLLUZ2GLH40IRB,#15-44 He said Putin aimed to weaken the NATO alliance.,46,54,alliance,3,4,7
3MZ3TAMYTLO103HNXLLUZ2GLH40IRB,"#15-45 Witold Waszczykowski, Polish foreign minister, earlier this week remarked any improvement in US-Russia relations should avoid harming Polish interests.",14,27,Waszczykowski,0,1,1
3MZ3TAMYTLO103HNXLLUZ2GLH40IRB,"#15-45 Witold Waszczykowski, Polish foreign minister, earlier this week remarked any improvement in US-Russia relations should avoid harming Polish interests.",36,43,foreign,2,0,2
3MZ3TAMYTLO103HNXLLUZ2GLH40IRB,"#15-45 Witold Waszczykowski, Polish foreign minister, earlier this week remarked any improvement in US-Russia relations should avoid harming Polish interests.",36,52,foreign minister,2,0,2
3MZ3TAMYTLO103HNXLLUZ2GLH40IRB,"#15-45 Witold Waszczykowski, Polish foreign minister, earlier this week remarked any improvement in US-Russia relations should avoid harming Polish interests.",72,80,remarked,4,3,7
3MZ3TAMYTLO103HNXLLUZ2GLH40IRB,"#15-45 Witold Waszczykowski, Polish foreign minister, earlier this week remarked any improvement in US-Russia relations should avoid harming Polish interests.",85,96,improvement,2,2,4
3MZ3TAMYTLO103HNXLLUZ2GLH40IRB,"#15-45 Witold Waszczykowski, Polish foreign minister, earlier this week remarked any improvement in US-Russia relations should avoid harming Polish interests.",127,132,avoid,1,0,1
3MZ3TAMYTLO103HNXLLUZ2GLH40IRB,"#15-45 Witold Waszczykowski, Polish foreign minister, earlier this week remarked any improvement in US-Russia relations should avoid harming Polish interests.",127,140,avoid harming,0,1,1
3MZ3TAMYTLO103HNXLLUZ2GLH40IRB,"#15-45 Witold Waszczykowski, Polish foreign minister, earlier this week remarked any improvement in US-Russia relations should avoid harming Polish interests.",133,140,harming,0,5,5
3MZ3TAMYTLO103HNXLLUZ2GLH40IRB,"#16-1 Obama surprises 'brother' Joe Biden with Presidential Medal of Freedom Yesterday afternoon United States President Barack Obama surprised his two-term vice president Joe Biden in the White House State Dining Room with the country's highest civilian honor, the Presidential Medal of Freedom with distinction.",47,76,Presidential Medal of Freedom,1,0,1
3MZ3TAMYTLO103HNXLLUZ2GLH40IRB,"#16-1 Obama surprises 'brother' Joe Biden with Presidential Medal of Freedom Yesterday afternoon United States President Barack Obama surprised his two-term vice president Joe Biden in the White House State Dining Room with the country's highest civilian honor, the Presidential Medal of Freedom with distinction.",134,143,surprised,1,0,1
3MZ3TAMYTLO103HNXLLUZ2GLH40IRB,"#16-1 Obama surprises 'brother' Joe Biden with Presidential Medal of Freedom Yesterday afternoon United States President Barack Obama surprised his two-term vice president Joe Biden in the White House State Dining Room with the country's highest civilian honor, the Presidential Medal of Freedom with distinction.",238,260,highest civilian honor,0,1,1
3MZ3TAMYTLO103HNXLLUZ2GLH40IRB,"#16-1 Obama surprises 'brother' Joe Biden with Presidential Medal of Freedom Yesterday afternoon United States President Barack Obama surprised his two-term vice president Joe Biden in the White House State Dining Room with the country's highest civilian honor, the Presidential Medal of Freedom with distinction.",246,254,civilian,7,0,7
3MZ3TAMYTLO103HNXLLUZ2GLH40IRB,"#16-1 Obama surprises 'brother' Joe Biden with Presidential Medal of Freedom Yesterday afternoon United States President Barack Obama surprised his two-term vice president Joe Biden in the White House State Dining Room with the country's highest civilian honor, the Presidential Medal of Freedom with distinction.",246,260,civilian honor,1,0,1
3MZ3TAMYTLO103HNXLLUZ2GLH40IRB,"#16-1 Obama surprises 'brother' Joe Biden with Presidential Medal of Freedom Yesterday afternoon United States President Barack Obama surprised his two-term vice president Joe Biden in the White House State Dining Room with the country's highest civilian honor, the Presidential Medal of Freedom with distinction.",255,260,honor,1,1,2
3MZ3TAMYTLO103HNXLLUZ2GLH40IRB,"#16-1 Obama surprises 'brother' Joe Biden with Presidential Medal of Freedom Yesterday afternoon United States President Barack Obama surprised his two-term vice president Joe Biden in the White House State Dining Room with the country's highest civilian honor, the Presidential Medal of Freedom with distinction.",266,295,Presidential Medal of Freedom,2,0,2
3MZ3TAMYTLO103HNXLLUZ2GLH40IRB,"#16-1 Obama surprises 'brother' Joe Biden with Presidential Medal of Freedom Yesterday afternoon United States President Barack Obama surprised his two-term vice president Joe Biden in the White House State Dining Room with the country's highest civilian honor, the Presidential Medal of Freedom with distinction.",301,312,distinction,10,4,14
3CVBMEMMXBHRMPMOIP53U9O6GFRH7I,"#24-1 Suspected plane debris washes ashore on several Maldives islands Authorities are investigating what's left of debris believed to belong to a plane, that washed ashore several small islands in the Maldives.",6,15,Suspected,4,4,8
3CVBMEMMXBHRMPMOIP53U9O6GFRH7I,"#24-1 Suspected plane debris washes ashore on several Maldives islands Authorities are investigating what's left of debris believed to belong to a plane, that washed ashore several small islands in the Maldives.",22,28,debris,10,10,20
3CVBMEMMXBHRMPMOIP53U9O6GFRH7I,"#24-1 Suspected plane debris washes ashore on several Maldives islands Authorities are investigating what's left of debris believed to belong to a plane, that washed ashore several small islands in the Maldives.",29,42,washes ashore,0,1,1
3CVBMEMMXBHRMPMOIP53U9O6GFRH7I,"#24-1 Suspected plane debris washes ashore on several Maldives islands Authorities are investigating what's left of debris believed to belong to a plane, that washed ashore several small islands in the Maldives.",36,42,ashore,3,6,9
3CVBMEMMXBHRMPMOIP53U9O6GFRH7I,"#24-1 Suspected plane debris washes ashore on several Maldives islands Authorities are investigating what's left of debris believed to belong to a plane, that washed ashore several small islands in the Maldives.",46,70,several Maldives islands,1,0,1
3CVBMEMMXBHRMPMOIP53U9O6GFRH7I,"#24-1 Suspected plane debris washes ashore on several Maldives islands Authorities are investigating what's left of debris believed to belong to a plane, that washed ashore several small islands in the Maldives.",71,82,Authorities,1,1,2
3CVBMEMMXBHRMPMOIP53U9O6GFRH7I,"#24-1 Suspected plane debris washes ashore on several Maldives islands Authorities are investigating what's left of debris believed to belong to a plane, that washed ashore several small islands in the Maldives.",87,100,investigating,5,5,10
3CVBMEMMXBHRMPMOIP53U9O6GFRH7I,"#24-1 Suspected plane debris washes ashore on several Maldives islands Authorities are investigating what's left of debris believed to belong to a plane, that washed ashore several small islands in the Maldives.",116,122,debris,3,4,7
3CVBMEMMXBHRMPMOIP53U9O6GFRH7I,"#24-1 Suspected plane debris washes ashore on several Maldives islands Authorities are investigating what's left of debris believed to belong to a plane, that washed ashore several small islands in the Maldives.",123,131,believed,0,1,1
3CVBMEMMXBHRMPMOIP53U9O6GFRH7I,"#24-1 Suspected plane debris washes ashore on several Maldives islands Authorities are investigating what's left of debris believed to belong to a plane, that washed ashore several small islands in the Maldives.",159,172,washed ashore,1,0,1
3CVBMEMMXBHRMPMOIP53U9O6GFRH7I,"#24-1 Suspected plane debris washes ashore on several Maldives islands Authorities are investigating what's left of debris believed to belong to a plane, that washed ashore several small islands in the Maldives.",166,172,ashore,2,5,7
3CVBMEMMXBHRMPMOIP53U9O6GFRH7I,"#24-1 Suspected plane debris washes ashore on several Maldives islands Authorities are investigating what's left of debris believed to belong to a plane, that washed ashore several small islands in the Maldives.",202,210,Maldives,1,0,1
3CVBMEMMXBHRMPMOIP53U9O6GFRH7I,#24-2 The investigation began as a result of photos of the debris being uploaded to the social networking website Facebook.,10,23,investigation,5,3,8
3CVBMEMMXBHRMPMOIP53U9O6GFRH7I,#24-2 The investigation began as a result of photos of the debris being uploaded to the social networking website Facebook.,59,65,debris,2,2,4
3CVBMEMMXBHRMPMOIP53U9O6GFRH7I,#24-2 The investigation began as a result of photos of the debris being uploaded to the social networking website Facebook.,72,80,uploaded,2,3,5
3CVBMEMMXBHRMPMOIP53U9O6GFRH7I,#24-2 The investigation began as a result of photos of the debris being uploaded to the social networking website Facebook.,88,105,social networking,2,0,2
3CVBMEMMXBHRMPMOIP53U9O6GFRH7I,#24-2 The investigation began as a result of photos of the debris being uploaded to the social networking website Facebook.,88,113,social networking website,0,1,1
3CVBMEMMXBHRMPMOIP53U9O6GFRH7I,#24-2 The investigation began as a result of photos of the debris being uploaded to the social networking website Facebook.,88,122,social networking website Facebook,2,0,2
3CVBMEMMXBHRMPMOIP53U9O6GFRH7I,#24-2 The investigation began as a result of photos of the debris being uploaded to the social networking website Facebook.,95,105,networking,3,0,3
3CVBMEMMXBHRMPMOIP53U9O6GFRH7I,"#24-3 Some of the debris is reported to have washed ashore as early as May 31 and was found on a beach owned by the Banyan Tree Vabbinfaru resort, located in Kaafu Atoll.",18,24,debris,2,2,4
3CVBMEMMXBHRMPMOIP53U9O6GFRH7I,"#24-3 Some of the debris is reported to have washed ashore as early as May 31 and was found on a beach owned by the Banyan Tree Vabbinfaru resort, located in Kaafu Atoll.",28,36,reported,0,1,1
3CVBMEMMXBHRMPMOIP53U9O6GFRH7I,"#24-3 Some of the debris is reported to have washed ashore as early as May 31 and was found on a beach owned by the Banyan Tree Vabbinfaru resort, located in Kaafu Atoll.",45,58,washed ashore,1,0,1
3CVBMEMMXBHRMPMOIP53U9O6GFRH7I,"#24-3 Some of the debris is reported to have washed ashore as early as May 31 and was found on a beach owned by the Banyan Tree Vabbinfaru resort, located in Kaafu Atoll.",52,58,ashore,2,4,6
3CVBMEMMXBHRMPMOIP53U9O6GFRH7I,"#24-3 Some of the debris is reported to have washed ashore as early as May 31 and was found on a beach owned by the Banyan Tree Vabbinfaru resort, located in Kaafu Atoll.",116,122,Banyan,1,0,1
3CVBMEMMXBHRMPMOIP53U9O6GFRH7I,"#24-3 Some of the debris is reported to have washed ashore as early as May 31 and was found on a beach owned by the Banyan Tree Vabbinfaru resort, located in Kaafu Atoll.",116,138,Banyan Tree Vabbinfaru,1,0,1
3CVBMEMMXBHRMPMOIP53U9O6GFRH7I,"#24-3 Some of the debris is reported to have washed ashore as early as May 31 and was found on a beach owned by the Banyan Tree Vabbinfaru resort, located in Kaafu Atoll.",116,145,Banyan Tree Vabbinfaru resort,1,0,1
3CVBMEMMXBHRMPMOIP53U9O6GFRH7I,"#24-3 Some of the debris is reported to have washed ashore as early as May 31 and was found on a beach owned by the Banyan Tree Vabbinfaru resort, located in Kaafu Atoll.",128,138,Vabbinfaru,1,0,1
3CVBMEMMXBHRMPMOIP53U9O6GFRH7I,"#24-3 Some of the debris is reported to have washed ashore as early as May 31 and was found on a beach owned by the Banyan Tree Vabbinfaru resort, located in Kaafu Atoll.",139,145,resort,1,0,1
3CVBMEMMXBHRMPMOIP53U9O6GFRH7I,"#24-3 Some of the debris is reported to have washed ashore as early as May 31 and was found on a beach owned by the Banyan Tree Vabbinfaru resort, located in Kaafu Atoll.",147,154,located,0,1,1
3CVBMEMMXBHRMPMOIP53U9O6GFRH7I,"#24-3 Some of the debris is reported to have washed ashore as early as May 31 and was found on a beach owned by the Banyan Tree Vabbinfaru resort, located in Kaafu Atoll.",158,169,Kaafu Atoll,2,0,2
3CVBMEMMXBHRMPMOIP53U9O6GFRH7I,"#24-4 In the past few days, several other pieces of debris were recovered on at least three other islands.",52,58,debris,3,2,5
3CVBMEMMXBHRMPMOIP53U9O6GFRH7I,"#24-4 In the past few days, several other pieces of debris were recovered on at least three other islands.",64,73,recovered,0,2,2
3CVBMEMMXBHRMPMOIP53U9O6GFRH7I,"#24-4 In the past few days, several other pieces of debris were recovered on at least three other islands.",98,105,islands,1,0,1
3CVBMEMMXBHRMPMOIP53U9O6GFRH7I,#24-5 Authorities are trying to determine if it may be part of Malaysia Airlines Flight 370 (MH370).,6,17,Authorities,4,2,6
3CVBMEMMXBHRMPMOIP53U9O6GFRH7I,#24-5 Authorities are trying to determine if it may be part of Malaysia Airlines Flight 370 (MH370).,32,41,determine,2,6,8
3CVBMEMMXBHRMPMOIP53U9O6GFRH7I,#24-5 Authorities are trying to determine if it may be part of Malaysia Airlines Flight 370 (MH370).,63,71,Malaysia,1,0,1
3CVBMEMMXBHRMPMOIP53U9O6GFRH7I,"#24-6 Last week, a piece of a wing known as a flaperon, reported to be from MH370, was found washed ashore on RÃ©union Island.",30,34,wing,0,1,1
3CVBMEMMXBHRMPMOIP53U9O6GFRH7I,"#24-6 Last week, a piece of a wing known as a flaperon, reported to be from MH370, was found washed ashore on RÃ©union Island.",30,54,wing known as a flaperon,1,0,1
3CVBMEMMXBHRMPMOIP53U9O6GFRH7I,"#24-6 Last week, a piece of a wing known as a flaperon, reported to be from MH370, was found washed ashore on RÃ©union Island.",46,54,flaperon,10,6,16
3CVBMEMMXBHRMPMOIP53U9O6GFRH7I,"#24-6 Last week, a piece of a wing known as a flaperon, reported to be from MH370, was found washed ashore on RÃ©union Island.",93,106,washed ashore,1,0,1
3CVBMEMMXBHRMPMOIP53U9O6GFRH7I,"#24-6 Last week, a piece of a wing known as a flaperon, reported to be from MH370, was found washed ashore on RÃ©union Island.",100,106,ashore,1,2,3
3CVBMEMMXBHRMPMOIP53U9O6GFRH7I,"#24-6 Last week, a piece of a wing known as a flaperon, reported to be from MH370, was found washed ashore on RÃ©union Island.",110,117,RÃ©union,2,0,2
