3QREJ3J433YH30CYS49AQ6MZ3G0LKZ,"#37-1 Guatemalan Supreme Court approves impeachment of President Molina Yesterday in Guatemala, the Supreme Court approved the attorney general's request to impeach President Otto Pérez Molina.",6,16,Guatemalan,1,1.1,2
3QREJ3J433YH30CYS49AQ6MZ3G0LKZ,"#37-1 Guatemalan Supreme Court approves impeachment of President Molina Yesterday in Guatemala, the Supreme Court approved the attorney general's request to impeach President Otto Pérez Molina.",31,39,approves,0,1,1
3QREJ3J433YH30CYS49AQ6MZ3G0LKZ,"#37-1 Guatemalan Supreme Court approves impeachment of President Molina Yesterday in Guatemala, the Supreme Court approved the attorney general's request to impeach President Otto Pérez Molina.",31,51,approves impeachment,1,0,1
3QREJ3J433YH30CYS49AQ6MZ3G0LKZ,"#37-1 Guatemalan Supreme Court approves impeachment of President Molina Yesterday in Guatemala, the Supreme Court approved the attorney general's request to impeach President Otto Pérez Molina.",40,51,impeachment,10,10,20
3QREJ3J433YH30CYS49AQ6MZ3G0LKZ,"#37-1 Guatemalan Supreme Court approves impeachment of President Molina Yesterday in Guatemala, the Supreme Court approved the attorney general's request to impeach President Otto Pérez Molina.",100,113,Supreme Court,1,0,1
3QREJ3J433YH30CYS49AQ6MZ3G0LKZ,"#37-1 Guatemalan Supreme Court approves impeachment of President Molina Yesterday in Guatemala, the Supreme Court approved the attorney general's request to impeach President Otto Pérez Molina.",127,135,attorney,1,1,2
3QREJ3J433YH30CYS49AQ6MZ3G0LKZ,"#37-1 Guatemalan Supreme Court approves impeachment of President Molina Yesterday in Guatemala, the Supreme Court approved the attorney general's request to impeach President Otto Pérez Molina.",127,143,attorney general,1,1,2
3QREJ3J433YH30CYS49AQ6MZ3G0LKZ,"#37-1 Guatemalan Supreme Court approves impeachment of President Molina Yesterday in Guatemala, the Supreme Court approved the attorney general's request to impeach President Otto Pérez Molina.",127,144,attorney generals,1,1,2
3QREJ3J433YH30CYS49AQ6MZ3G0LKZ,"#37-1 Guatemalan Supreme Court approves impeachment of President Molina Yesterday in Guatemala, the Supreme Court approved the attorney general's request to impeach President Otto Pérez Molina.",157,164,impeach,7,3,10
3QREJ3J433YH30CYS49AQ6MZ3G0LKZ,"#37-1 Guatemalan Supreme Court approves impeachment of President Molina Yesterday in Guatemala, the Supreme Court approved the attorney general's request to impeach President Otto Pérez Molina.",175,185,Otto Pérez,0,1,1
3QREJ3J433YH30CYS49AQ6MZ3G0LKZ,"#37-1 Guatemalan Supreme Court approves impeachment of President Molina Yesterday in Guatemala, the Supreme Court approved the attorney general's request to impeach President Otto Pérez Molina.",180,185,Pérez,1,0,1
3QREJ3J433YH30CYS49AQ6MZ3G0LKZ,"#37-2 President Molina, pictured here in 2013, is accused of corruption.",24,32,pictured,0,2,2
3QREJ3J433YH30CYS49AQ6MZ3G0LKZ,"#37-2 President Molina, pictured here in 2013, is accused of corruption.",50,57,accused,3,3,6
3QREJ3J433YH30CYS49AQ6MZ3G0LKZ,"#37-2 President Molina, pictured here in 2013, is accused of corruption.",50,71,accused of corruption,0,1,1
3QREJ3J433YH30CYS49AQ6MZ3G0LKZ,"#37-2 President Molina, pictured here in 2013, is accused of corruption.",61,71,corruption,8,4,12
3QREJ3J433YH30CYS49AQ6MZ3G0LKZ,#37-3 The final decision on lifting Presidential immunity now falls to Congress.,16,24,decision,1,0,1
3QREJ3J433YH30CYS49AQ6MZ3G0LKZ,#37-3 The final decision on lifting Presidential immunity now falls to Congress.,28,35,lifting,0,1,1
3QREJ3J433YH30CYS49AQ6MZ3G0LKZ,#37-3 The final decision on lifting Presidential immunity now falls to Congress.,28,57,lifting Presidential immunity,0,1,1
3QREJ3J433YH30CYS49AQ6MZ3G0LKZ,#37-3 The final decision on lifting Presidential immunity now falls to Congress.,49,57,immunity,10,8,18
3QREJ3J433YH30CYS49AQ6MZ3G0LKZ,#37-3 The final decision on lifting Presidential immunity now falls to Congress.,62,67,falls,0,1,1
3QREJ3J433YH30CYS49AQ6MZ3G0LKZ,#37-4 The case relates to a corruption scandal known locally as La Linea((en)) which has seen Vice President Roxana Baldetti arrested and charged with fraud and receiving bribes.,28,38,corruption,4,1,5
3QREJ3J433YH30CYS49AQ6MZ3G0LKZ,#37-4 The case relates to a corruption scandal known locally as La Linea((en)) which has seen Vice President Roxana Baldetti arrested and charged with fraud and receiving bribes.,28,46,corruption scandal,1,0,1
3QREJ3J433YH30CYS49AQ6MZ3G0LKZ,#37-4 The case relates to a corruption scandal known locally as La Linea((en)) which has seen Vice President Roxana Baldetti arrested and charged with fraud and receiving bribes.,39,46,scandal,1,6,7
3QREJ3J433YH30CYS49AQ6MZ3G0LKZ,#37-4 The case relates to a corruption scandal known locally as La Linea((en)) which has seen Vice President Roxana Baldetti arrested and charged with fraud and receiving bribes.,64,76,La Linea((en,0,1,1
3QREJ3J433YH30CYS49AQ6MZ3G0LKZ,#37-4 The case relates to a corruption scandal known locally as La Linea((en)) which has seen Vice President Roxana Baldetti arrested and charged with fraud and receiving bribes.,109,124,Roxana Baldetti,0,1,1
3QREJ3J433YH30CYS49AQ6MZ3G0LKZ,#37-4 The case relates to a corruption scandal known locally as La Linea((en)) which has seen Vice President Roxana Baldetti arrested and charged with fraud and receiving bribes.,116,124,Baldetti,1,0,1
3QREJ3J433YH30CYS49AQ6MZ3G0LKZ,#37-4 The case relates to a corruption scandal known locally as La Linea((en)) which has seen Vice President Roxana Baldetti arrested and charged with fraud and receiving bribes.,151,156,fraud,5,3,8
3QREJ3J433YH30CYS49AQ6MZ3G0LKZ,#37-4 The case relates to a corruption scandal known locally as La Linea((en)) which has seen Vice President Roxana Baldetti arrested and charged with fraud and receiving bribes.,161,177,receiving bribes,0,1,1
3QREJ3J433YH30CYS49AQ6MZ3G0LKZ,#37-4 The case relates to a corruption scandal known locally as La Linea((en)) which has seen Vice President Roxana Baldetti arrested and charged with fraud and receiving bribes.,171,177,bribes,6,7,13
3QREJ3J433YH30CYS49AQ6MZ3G0LKZ,#37-5 Prosecutors allege Baldetti and Molina between them received half of all bribes in the case.,6,17,Prosecutors,2,2,4
3QREJ3J433YH30CYS49AQ6MZ3G0LKZ,#37-5 Prosecutors allege Baldetti and Molina between them received half of all bribes in the case.,6,24,Prosecutors allege,0,1,1
3QREJ3J433YH30CYS49AQ6MZ3G0LKZ,#37-5 Prosecutors allege Baldetti and Molina between them received half of all bribes in the case.,18,24,allege,1,3,4
3QREJ3J433YH30CYS49AQ6MZ3G0LKZ,#37-5 Prosecutors allege Baldetti and Molina between them received half of all bribes in the case.,25,33,Baldetti,1,1,2
3QREJ3J433YH30CYS49AQ6MZ3G0LKZ,#37-5 Prosecutors allege Baldetti and Molina between them received half of all bribes in the case.,79,85,bribes,1,4,5
3QREJ3J433YH30CYS49AQ6MZ3G0LKZ,"#37-6 Congress previously refused to impeach Molina but the investigation has since broadened, with ministerial resignations.",37,44,impeach,3,1,4
3QREJ3J433YH30CYS49AQ6MZ3G0LKZ,"#37-6 Congress previously refused to impeach Molina but the investigation has since broadened, with ministerial resignations.",60,73,investigation,2,2,4
3QREJ3J433YH30CYS49AQ6MZ3G0LKZ,"#37-6 Congress previously refused to impeach Molina but the investigation has since broadened, with ministerial resignations.",84,93,broadened,4,6,10
3QREJ3J433YH30CYS49AQ6MZ3G0LKZ,"#37-6 Congress previously refused to impeach Molina but the investigation has since broadened, with ministerial resignations.",100,111,ministerial,3,0,3
3QREJ3J433YH30CYS49AQ6MZ3G0LKZ,"#37-6 Congress previously refused to impeach Molina but the investigation has since broadened, with ministerial resignations.",100,124,ministerial resignations,6,1,7
3QREJ3J433YH30CYS49AQ6MZ3G0LKZ,"#37-6 Congress previously refused to impeach Molina but the investigation has since broadened, with ministerial resignations.",112,124,resignations,8,2,10
3QREJ3J433YH30CYS49AQ6MZ3G0LKZ,"#37-7 Molina, however, has stood firm in the face of widespread popular protests demanding he leave office.",27,32,stood,0,1,1
3QREJ3J433YH30CYS49AQ6MZ3G0LKZ,"#37-7 Molina, however, has stood firm in the face of widespread popular protests demanding he leave office.",53,63,widespread,2,4,6
3QREJ3J433YH30CYS49AQ6MZ3G0LKZ,"#37-7 Molina, however, has stood firm in the face of widespread popular protests demanding he leave office.",72,80,protests,2,0,2
3QREJ3J433YH30CYS49AQ6MZ3G0LKZ,"#37-7 Molina, however, has stood firm in the face of widespread popular protests demanding he leave office.",81,90,demanding,1,1,2
3QREJ3J433YH30CYS49AQ6MZ3G0LKZ,#37-8 Elections are scheduled for September 6.,6,15,Elections,1,0,1
3QREJ3J433YH30CYS49AQ6MZ3G0LKZ,#37-8 Elections are scheduled for September 6.,20,29,scheduled,3,2,5
3DWGDA5POF5IT426YY5Y80O2L821VV,#3-11 Pavlensky commented the rape charges had a political motivation behind it and denied the allegations.,16,25,commented,0,3,3
3DWGDA5POF5IT426YY5Y80O2L821VV,#3-11 Pavlensky commented the rape charges had a political motivation behind it and denied the allegations.,30,34,rape,2,0,2
3DWGDA5POF5IT426YY5Y80O2L821VV,#3-11 Pavlensky commented the rape charges had a political motivation behind it and denied the allegations.,30,42,rape charges,0,1,1
3DWGDA5POF5IT426YY5Y80O2L821VV,#3-11 Pavlensky commented the rape charges had a political motivation behind it and denied the allegations.,35,42,charges,0,1,1
3DWGDA5POF5IT426YY5Y80O2L821VV,#3-11 Pavlensky commented the rape charges had a political motivation behind it and denied the allegations.,49,69,political motivation,1,2,3
3DWGDA5POF5IT426YY5Y80O2L821VV,#3-11 Pavlensky commented the rape charges had a political motivation behind it and denied the allegations.,59,69,motivation,4,6,10
3DWGDA5POF5IT426YY5Y80O2L821VV,#3-11 Pavlensky commented the rape charges had a political motivation behind it and denied the allegations.,84,90,denied,2,3,5
3DWGDA5POF5IT426YY5Y80O2L821VV,#3-11 Pavlensky commented the rape charges had a political motivation behind it and denied the allegations.,95,106,allegations,10,8,18
3DWGDA5POF5IT426YY5Y80O2L821VV,"#3-12 Olga Papernaya, former art director at Moscow's film club said, ""Alas, yesterday a national hero and a great performance artist, today — it’s true — a criminal, a psychopath and a rapist"".",11,20,Papernaya,1,0,1
3DWGDA5POF5IT426YY5Y80O2L821VV,"#3-12 Olga Papernaya, former art director at Moscow's film club said, ""Alas, yesterday a national hero and a great performance artist, today — it’s true — a criminal, a psychopath and a rapist"".",71,75,Alas,2,0,2
3DWGDA5POF5IT426YY5Y80O2L821VV,"#3-12 Olga Papernaya, former art director at Moscow's film club said, ""Alas, yesterday a national hero and a great performance artist, today — it’s true — a criminal, a psychopath and a rapist"".",89,97,national,0,1,1
3DWGDA5POF5IT426YY5Y80O2L821VV,"#3-12 Olga Papernaya, former art director at Moscow's film club said, ""Alas, yesterday a national hero and a great performance artist, today — it’s true — a criminal, a psychopath and a rapist"".",115,126,performance,1,0,1
3DWGDA5POF5IT426YY5Y80O2L821VV,"#3-12 Olga Papernaya, former art director at Moscow's film club said, ""Alas, yesterday a national hero and a great performance artist, today — it’s true — a criminal, a psychopath and a rapist"".",115,133,performance artist,1,0,1
3DWGDA5POF5IT426YY5Y80O2L821VV,"#3-12 Olga Papernaya, former art director at Moscow's film club said, ""Alas, yesterday a national hero and a great performance artist, today — it’s true — a criminal, a psychopath and a rapist"".",157,165,criminal,1,0,1
3DWGDA5POF5IT426YY5Y80O2L821VV,"#3-12 Olga Papernaya, former art director at Moscow's film club said, ""Alas, yesterday a national hero and a great performance artist, today — it’s true — a criminal, a psychopath and a rapist"".",169,179,psychopath,10,9,19
3DWGDA5POF5IT426YY5Y80O2L821VV,"#3-12 Olga Papernaya, former art director at Moscow's film club said, ""Alas, yesterday a national hero and a great performance artist, today — it’s true — a criminal, a psychopath and a rapist"".",169,192,psychopath and a rapist,1,0,1
3DWGDA5POF5IT426YY5Y80O2L821VV,"#3-12 Olga Papernaya, former art director at Moscow's film club said, ""Alas, yesterday a national hero and a great performance artist, today — it’s true — a criminal, a psychopath and a rapist"".",186,192,rapist,4,4,8
3DWGDA5POF5IT426YY5Y80O2L821VV,"#3-13 Pavlensky, Oksana, and their two daughters left for Ukraine in mid-December before flying to France.",58,65,Ukraine,1,0,1
3DWGDA5POF5IT426YY5Y80O2L821VV,"#3-15 In one of several painful performances, Pyotr Pavlensky sewed his lips to support members of musical band Pussy Riot who were imprisoned that time.",24,44,painful performances,0,3,3
3DWGDA5POF5IT426YY5Y80O2L821VV,"#3-15 In one of several painful performances, Pyotr Pavlensky sewed his lips to support members of musical band Pussy Riot who were imprisoned that time.",32,44,performances,2,1,3
3DWGDA5POF5IT426YY5Y80O2L821VV,"#3-15 In one of several painful performances, Pyotr Pavlensky sewed his lips to support members of musical band Pussy Riot who were imprisoned that time.",46,61,Pyotr Pavlensky,1,0,1
3DWGDA5POF5IT426YY5Y80O2L821VV,"#3-15 In one of several painful performances, Pyotr Pavlensky sewed his lips to support members of musical band Pussy Riot who were imprisoned that time.",62,67,sewed,0,4,4
3DWGDA5POF5IT426YY5Y80O2L821VV,"#3-15 In one of several painful performances, Pyotr Pavlensky sewed his lips to support members of musical band Pussy Riot who were imprisoned that time.",62,76,sewed his lips,3,2,5
3DWGDA5POF5IT426YY5Y80O2L821VV,"#3-15 In one of several painful performances, Pyotr Pavlensky sewed his lips to support members of musical band Pussy Riot who were imprisoned that time.",72,76,lips,0,1,1
3DWGDA5POF5IT426YY5Y80O2L821VV,"#3-15 In one of several painful performances, Pyotr Pavlensky sewed his lips to support members of musical band Pussy Riot who were imprisoned that time.",99,106,musical,0,1,1
3DWGDA5POF5IT426YY5Y80O2L821VV,"#3-15 In one of several painful performances, Pyotr Pavlensky sewed his lips to support members of musical band Pussy Riot who were imprisoned that time.",112,122,Pussy Riot,1,0,1
3DWGDA5POF5IT426YY5Y80O2L821VV,"#3-15 In one of several painful performances, Pyotr Pavlensky sewed his lips to support members of musical band Pussy Riot who were imprisoned that time.",118,122,Riot,1,0,1
3DWGDA5POF5IT426YY5Y80O2L821VV,"#3-15 In one of several painful performances, Pyotr Pavlensky sewed his lips to support members of musical band Pussy Riot who were imprisoned that time.",132,142,imprisoned,7,5,12
3DWGDA5POF5IT426YY5Y80O2L821VV,#3-16 The band members were charged with hooliganism for performing an anti-Putin song in a church.,41,52,hooliganism,10,10,20
3DWGDA5POF5IT426YY5Y80O2L821VV,#3-16 The band members were charged with hooliganism for performing an anti-Putin song in a church.,71,81,anti-Putin,1,0,1
3DWGDA5POF5IT426YY5Y80O2L821VV,"#3-17 In 2013, he nailed his scrotum in Moscow's Red Square naming the art as ""Fixation"".",18,24,nailed,0,3,3
3DWGDA5POF5IT426YY5Y80O2L821VV,"#3-17 In 2013, he nailed his scrotum in Moscow's Red Square naming the art as ""Fixation"".",18,36,nailed his scrotum,1,1,2
3DWGDA5POF5IT426YY5Y80O2L821VV,"#3-17 In 2013, he nailed his scrotum in Moscow's Red Square naming the art as ""Fixation"".",29,36,scrotum,9,5,14
3DWGDA5POF5IT426YY5Y80O2L821VV,"#3-17 In 2013, he nailed his scrotum in Moscow's Red Square naming the art as ""Fixation"".",79,87,Fixation,8,3,11
368IUKXGA590V667IS8GX4Q17VH6PD,"#13-17 Matt O'Brien of The Washington Post claims a large tax cut that would result for the wealthiest 1% of citizens if Obamacare funds were not converted to other purposes, estimated at about $32,820 annually per person by the Tax Policy Center, is also a significant motive.",7,18,Matt OBrien,0,1,1
368IUKXGA590V667IS8GX4Q17VH6PD,"#13-17 Matt O'Brien of The Washington Post claims a large tax cut that would result for the wealthiest 1% of citizens if Obamacare funds were not converted to other purposes, estimated at about $32,820 annually per person by the Tax Policy Center, is also a significant motive.",27,42,Washington Post,1,0,1
368IUKXGA590V667IS8GX4Q17VH6PD,"#13-17 Matt O'Brien of The Washington Post claims a large tax cut that would result for the wealthiest 1% of citizens if Obamacare funds were not converted to other purposes, estimated at about $32,820 annually per person by the Tax Policy Center, is also a significant motive.",43,49,claims,3,0,3
368IUKXGA590V667IS8GX4Q17VH6PD,"#13-17 Matt O'Brien of The Washington Post claims a large tax cut that would result for the wealthiest 1% of citizens if Obamacare funds were not converted to other purposes, estimated at about $32,820 annually per person by the Tax Policy Center, is also a significant motive.",58,65,tax cut,2,0,2
368IUKXGA590V667IS8GX4Q17VH6PD,"#13-17 Matt O'Brien of The Washington Post claims a large tax cut that would result for the wealthiest 1% of citizens if Obamacare funds were not converted to other purposes, estimated at about $32,820 annually per person by the Tax Policy Center, is also a significant motive.",92,102,wealthiest,3,6,9
368IUKXGA590V667IS8GX4Q17VH6PD,"#13-17 Matt O'Brien of The Washington Post claims a large tax cut that would result for the wealthiest 1% of citizens if Obamacare funds were not converted to other purposes, estimated at about $32,820 annually per person by the Tax Policy Center, is also a significant motive.",109,117,citizens,1,0,1
368IUKXGA590V667IS8GX4Q17VH6PD,"#13-17 Matt O'Brien of The Washington Post claims a large tax cut that would result for the wealthiest 1% of citizens if Obamacare funds were not converted to other purposes, estimated at about $32,820 annually per person by the Tax Policy Center, is also a significant motive.",121,130,Obamacare,2,1,3
368IUKXGA590V667IS8GX4Q17VH6PD,"#13-17 Matt O'Brien of The Washington Post claims a large tax cut that would result for the wealthiest 1% of citizens if Obamacare funds were not converted to other purposes, estimated at about $32,820 annually per person by the Tax Policy Center, is also a significant motive.",131,136,funds,1,0,1
368IUKXGA590V667IS8GX4Q17VH6PD,"#13-17 Matt O'Brien of The Washington Post claims a large tax cut that would result for the wealthiest 1% of citizens if Obamacare funds were not converted to other purposes, estimated at about $32,820 annually per person by the Tax Policy Center, is also a significant motive.",146,155,converted,6,2,8
368IUKXGA590V667IS8GX4Q17VH6PD,"#13-17 Matt O'Brien of The Washington Post claims a large tax cut that would result for the wealthiest 1% of citizens if Obamacare funds were not converted to other purposes, estimated at about $32,820 annually per person by the Tax Policy Center, is also a significant motive.",165,173,purposes,0,1,1
368IUKXGA590V667IS8GX4Q17VH6PD,"#13-17 Matt O'Brien of The Washington Post claims a large tax cut that would result for the wealthiest 1% of citizens if Obamacare funds were not converted to other purposes, estimated at about $32,820 annually per person by the Tax Policy Center, is also a significant motive.",175,184,estimated,6,3,9
368IUKXGA590V667IS8GX4Q17VH6PD,"#13-17 Matt O'Brien of The Washington Post claims a large tax cut that would result for the wealthiest 1% of citizens if Obamacare funds were not converted to other purposes, estimated at about $32,820 annually per person by the Tax Policy Center, is also a significant motive.",202,210,annually,2,3,5
368IUKXGA590V667IS8GX4Q17VH6PD,"#13-17 Matt O'Brien of The Washington Post claims a large tax cut that would result for the wealthiest 1% of citizens if Obamacare funds were not converted to other purposes, estimated at about $32,820 annually per person by the Tax Policy Center, is also a significant motive.",233,239,Policy,0,1,1
368IUKXGA590V667IS8GX4Q17VH6PD,"#13-17 Matt O'Brien of The Washington Post claims a large tax cut that would result for the wealthiest 1% of citizens if Obamacare funds were not converted to other purposes, estimated at about $32,820 annually per person by the Tax Policy Center, is also a significant motive.",258,269,significant,8,4,12
368IUKXGA590V667IS8GX4Q17VH6PD,"#13-17 Matt O'Brien of The Washington Post claims a large tax cut that would result for the wealthiest 1% of citizens if Obamacare funds were not converted to other purposes, estimated at about $32,820 annually per person by the Tax Policy Center, is also a significant motive.",258,276,significant motive,1,1,2
368IUKXGA590V667IS8GX4Q17VH6PD,"#13-17 Matt O'Brien of The Washington Post claims a large tax cut that would result for the wealthiest 1% of citizens if Obamacare funds were not converted to other purposes, estimated at about $32,820 annually per person by the Tax Policy Center, is also a significant motive.",270,276,motive,1,5,6
368IUKXGA590V667IS8GX4Q17VH6PD,"#13-18 Republican Senators set a date of January 27 to repeal Obamacare, according to NBC News.",7,17,Republican,1,0,1
368IUKXGA590V667IS8GX4Q17VH6PD,"#13-18 Republican Senators set a date of January 27 to repeal Obamacare, according to NBC News.",7,26,Republican Senators,2,0,2
368IUKXGA590V667IS8GX4Q17VH6PD,"#13-18 Republican Senators set a date of January 27 to repeal Obamacare, according to NBC News.",18,26,Senators,0,1,1
368IUKXGA590V667IS8GX4Q17VH6PD,"#13-18 Republican Senators set a date of January 27 to repeal Obamacare, according to NBC News.",55,61,repeal,5,6,11
368IUKXGA590V667IS8GX4Q17VH6PD,"#13-18 Republican Senators set a date of January 27 to repeal Obamacare, according to NBC News.",62,71,Obamacare,2,1,3
368IUKXGA590V667IS8GX4Q17VH6PD,#13-19 House Majority Leader Kevin McCarthy of California says legislation repealing Obamacare and replacing it could ready by late February.,7,21,House Majority,1,0,1
368IUKXGA590V667IS8GX4Q17VH6PD,#13-19 House Majority Leader Kevin McCarthy of California says legislation repealing Obamacare and replacing it could ready by late February.,13,21,Majority,0,1,1
368IUKXGA590V667IS8GX4Q17VH6PD,#13-19 House Majority Leader Kevin McCarthy of California says legislation repealing Obamacare and replacing it could ready by late February.,29,43,Kevin McCarthy,0,1,1
368IUKXGA590V667IS8GX4Q17VH6PD,#13-19 House Majority Leader Kevin McCarthy of California says legislation repealing Obamacare and replacing it could ready by late February.,63,74,legislation,6,3,9
368IUKXGA590V667IS8GX4Q17VH6PD,#13-19 House Majority Leader Kevin McCarthy of California says legislation repealing Obamacare and replacing it could ready by late February.,63,84,legislation repealing,2,2,4
368IUKXGA590V667IS8GX4Q17VH6PD,#13-19 House Majority Leader Kevin McCarthy of California says legislation repealing Obamacare and replacing it could ready by late February.,75,84,repealing,4,7,11
368IUKXGA590V667IS8GX4Q17VH6PD,#13-19 House Majority Leader Kevin McCarthy of California says legislation repealing Obamacare and replacing it could ready by late February.,85,94,Obamacare,2,1,3
368IUKXGA590V667IS8GX4Q17VH6PD,#13-19 House Majority Leader Kevin McCarthy of California says legislation repealing Obamacare and replacing it could ready by late February.,99,108,replacing,0,2,2
368IUKXGA590V667IS8GX4Q17VH6PD,"#13-20 According to Democratic Senator Bernie Sanders, as many as 30 million people could lose their health insurance if the ACA is repealed",20,30,Democratic,2,0,2
368IUKXGA590V667IS8GX4Q17VH6PD,"#13-20 According to Democratic Senator Bernie Sanders, as many as 30 million people could lose their health insurance if the ACA is repealed",31,38,Senator,0,1,1
368IUKXGA590V667IS8GX4Q17VH6PD,"#13-20 According to Democratic Senator Bernie Sanders, as many as 30 million people could lose their health insurance if the ACA is repealed",69,76,million,0,1,1
368IUKXGA590V667IS8GX4Q17VH6PD,"#13-20 According to Democratic Senator Bernie Sanders, as many as 30 million people could lose their health insurance if the ACA is repealed",101,117,health insurance,1,0,1
368IUKXGA590V667IS8GX4Q17VH6PD,"#13-20 According to Democratic Senator Bernie Sanders, as many as 30 million people could lose their health insurance if the ACA is repealed",108,117,insurance,2,1,3
368IUKXGA590V667IS8GX4Q17VH6PD,"#13-20 According to Democratic Senator Bernie Sanders, as many as 30 million people could lose their health insurance if the ACA is repealed",125,128,ACA,0,2,2
368IUKXGA590V667IS8GX4Q17VH6PD,"#14-1 Fighter jet crashes during Children's Day airshow in Thailand A fighter jet crashed, killing the pilot, at Hat Yai International Airport, Songkhla​, Thailand this morning during an annual Children's Day airshow.",14,25,jet crashes,0,1,1
368IUKXGA590V667IS8GX4Q17VH6PD,"#14-1 Fighter jet crashes during Children's Day airshow in Thailand A fighter jet crashed, killing the pilot, at Hat Yai International Airport, Songkhla​, Thailand this morning during an annual Children's Day airshow.",18,25,crashes,0,1,1
368IUKXGA590V667IS8GX4Q17VH6PD,"#14-1 Fighter jet crashes during Children's Day airshow in Thailand A fighter jet crashed, killing the pilot, at Hat Yai International Airport, Songkhla​, Thailand this morning during an annual Children's Day airshow.",48,55,airshow,2,5,7
368IUKXGA590V667IS8GX4Q17VH6PD,"#14-1 Fighter jet crashes during Children's Day airshow in Thailand A fighter jet crashed, killing the pilot, at Hat Yai International Airport, Songkhla​, Thailand this morning during an annual Children's Day airshow.",59,67,Thailand,0,1,1
368IUKXGA590V667IS8GX4Q17VH6PD,"#14-1 Fighter jet crashes during Children's Day airshow in Thailand A fighter jet crashed, killing the pilot, at Hat Yai International Airport, Songkhla​, Thailand this morning during an annual Children's Day airshow.",82,89,crashed,0,1,1
368IUKXGA590V667IS8GX4Q17VH6PD,"#14-1 Fighter jet crashes during Children's Day airshow in Thailand A fighter jet crashed, killing the pilot, at Hat Yai International Airport, Songkhla​, Thailand this morning during an annual Children's Day airshow.",103,108,pilot,2,0,2
368IUKXGA590V667IS8GX4Q17VH6PD,"#14-1 Fighter jet crashes during Children's Day airshow in Thailand A fighter jet crashed, killing the pilot, at Hat Yai International Airport, Songkhla​, Thailand this morning during an annual Children's Day airshow.",121,134,International,1,0,1
368IUKXGA590V667IS8GX4Q17VH6PD,"#14-1 Fighter jet crashes during Children's Day airshow in Thailand A fighter jet crashed, killing the pilot, at Hat Yai International Airport, Songkhla​, Thailand this morning during an annual Children's Day airshow.",144,153,Songkhla​,0,1,1
368IUKXGA590V667IS8GX4Q17VH6PD,"#14-1 Fighter jet crashes during Children's Day airshow in Thailand A fighter jet crashed, killing the pilot, at Hat Yai International Airport, Songkhla​, Thailand this morning during an annual Children's Day airshow.",187,193,annual,1,0,1
368IUKXGA590V667IS8GX4Q17VH6PD,"#14-1 Fighter jet crashes during Children's Day airshow in Thailand A fighter jet crashed, killing the pilot, at Hat Yai International Airport, Songkhla​, Thailand this morning during an annual Children's Day airshow.",209,216,airshow,3,3,6
33NOQL7T9O0HDOR1YG3G8GO6NPE8ZM,"#14-2 The JAS 39C Gripen crashed onto a runway at around 9:30 am local time (0230 UTC) and exploded, closing the airport to commercial flights.",18,24,Gripen,3,1,4
33NOQL7T9O0HDOR1YG3G8GO6NPE8ZM,"#14-2 The JAS 39C Gripen crashed onto a runway at around 9:30 am local time (0230 UTC) and exploded, closing the airport to commercial flights.",25,32,crashed,2,1,3
33NOQL7T9O0HDOR1YG3G8GO6NPE8ZM,"#14-2 The JAS 39C Gripen crashed onto a runway at around 9:30 am local time (0230 UTC) and exploded, closing the airport to commercial flights.",40,46,runway,1,3,4
33NOQL7T9O0HDOR1YG3G8GO6NPE8ZM,"#14-2 The JAS 39C Gripen crashed onto a runway at around 9:30 am local time (0230 UTC) and exploded, closing the airport to commercial flights.",91,99,exploded,3,6,9
33NOQL7T9O0HDOR1YG3G8GO6NPE8ZM,"#14-2 The JAS 39C Gripen crashed onto a runway at around 9:30 am local time (0230 UTC) and exploded, closing the airport to commercial flights.",124,134,commercial,9,1,10
33NOQL7T9O0HDOR1YG3G8GO6NPE8ZM,#14-3 The pilot was identified as Squadron Leader Dilokrit Pattavee.,20,30,identified,2,1,3
33NOQL7T9O0HDOR1YG3G8GO6NPE8ZM,#14-3 The pilot was identified as Squadron Leader Dilokrit Pattavee.,34,42,Squadron,2,2,4
33NOQL7T9O0HDOR1YG3G8GO6NPE8ZM,#14-3 The pilot was identified as Squadron Leader Dilokrit Pattavee.,34,49,Squadron Leader,5,0,5
33NOQL7T9O0HDOR1YG3G8GO6NPE8ZM,#14-3 The pilot was identified as Squadron Leader Dilokrit Pattavee.,50,67,Dilokrit Pattavee,0,1,1
33NOQL7T9O0HDOR1YG3G8GO6NPE8ZM,#14-4 Local media reports an airport fire vehicle rolled over while responding.,42,49,vehicle,1,0,1
33NOQL7T9O0HDOR1YG3G8GO6NPE8ZM,#14-4 Local media reports an airport fire vehicle rolled over while responding.,42,61,vehicle rolled over,0,1,1
33NOQL7T9O0HDOR1YG3G8GO6NPE8ZM,#14-4 Local media reports an airport fire vehicle rolled over while responding.,50,56,rolled,1,3,4
33NOQL7T9O0HDOR1YG3G8GO6NPE8ZM,#14-4 Local media reports an airport fire vehicle rolled over while responding.,50,61,rolled over,1,0,1
33NOQL7T9O0HDOR1YG3G8GO6NPE8ZM,#14-4 Local media reports an airport fire vehicle rolled over while responding.,68,78,responding,1,3,4
33NOQL7T9O0HDOR1YG3G8GO6NPE8ZM,#14-5 Children screamed in video footage of the crash.,15,23,screamed,3,5,8
33NOQL7T9O0HDOR1YG3G8GO6NPE8ZM,#14-5 Children screamed in video footage of the crash.,27,40,video footage,0,2,2
33NOQL7T9O0HDOR1YG3G8GO6NPE8ZM,#14-5 Children screamed in video footage of the crash.,33,40,footage,3,2,5
33NOQL7T9O0HDOR1YG3G8GO6NPE8ZM,#14-5 Children screamed in video footage of the crash.,48,53,crash,0,1,1
33NOQL7T9O0HDOR1YG3G8GO6NPE8ZM,"#14-6 The Royal Thai Air Force asked that images of the accident not be shared, but this has not deterred the press.",10,30,Royal Thai Air Force,1,0,1
33NOQL7T9O0HDOR1YG3G8GO6NPE8ZM,"#14-6 The Royal Thai Air Force asked that images of the accident not be shared, but this has not deterred the press.",56,64,accident,2,0,2
33NOQL7T9O0HDOR1YG3G8GO6NPE8ZM,"#14-6 The Royal Thai Air Force asked that images of the accident not be shared, but this has not deterred the press.",97,105,deterred,10,10,20
33NOQL7T9O0HDOR1YG3G8GO6NPE8ZM,#14-7 Air Force spokesperson Pongsak Semachai said an investigatory commission would be formed.,16,28,spokesperson,5,2,7
33NOQL7T9O0HDOR1YG3G8GO6NPE8ZM,#14-7 Air Force spokesperson Pongsak Semachai said an investigatory commission would be formed.,29,45,Pongsak Semachai,0,1,1
33NOQL7T9O0HDOR1YG3G8GO6NPE8ZM,#14-7 Air Force spokesperson Pongsak Semachai said an investigatory commission would be formed.,54,67,investigatory,3,3,6
33NOQL7T9O0HDOR1YG3G8GO6NPE8ZM,#14-7 Air Force spokesperson Pongsak Semachai said an investigatory commission would be formed.,54,78,investigatory commission,9,3,12
33NOQL7T9O0HDOR1YG3G8GO6NPE8ZM,#14-7 Air Force spokesperson Pongsak Semachai said an investigatory commission would be formed.,68,78,commission,1,0,1
33NOQL7T9O0HDOR1YG3G8GO6NPE8ZM,#14-7 Air Force spokesperson Pongsak Semachai said an investigatory commission would be formed.,88,94,formed,1,0,1
33NOQL7T9O0HDOR1YG3G8GO6NPE8ZM,#14-8 Prime Minister Prayut Chan-o-cha offered his sympathies to Pattavee's relatives.,21,38,Prayut Chan-o-cha,0,1,1
33NOQL7T9O0HDOR1YG3G8GO6NPE8ZM,#14-8 Prime Minister Prayut Chan-o-cha offered his sympathies to Pattavee's relatives.,39,46,offered,0,1,1
33NOQL7T9O0HDOR1YG3G8GO6NPE8ZM,#14-8 Prime Minister Prayut Chan-o-cha offered his sympathies to Pattavee's relatives.,39,61,offered his sympathies,0,1,1
33NOQL7T9O0HDOR1YG3G8GO6NPE8ZM,#14-8 Prime Minister Prayut Chan-o-cha offered his sympathies to Pattavee's relatives.,51,61,sympathies,10,6,16
33NOQL7T9O0HDOR1YG3G8GO6NPE8ZM,#14-8 Prime Minister Prayut Chan-o-cha offered his sympathies to Pattavee's relatives.,65,74,Pattavees,0,1,1
33NOQL7T9O0HDOR1YG3G8GO6NPE8ZM,#14-8 Prime Minister Prayut Chan-o-cha offered his sympathies to Pattavee's relatives.,76,85,relatives,1,1,2
33NOQL7T9O0HDOR1YG3G8GO6NPE8ZM,#14-9 Thailand began purchasing the Swedish-built Gripen jets in 2008 and has twelve.,21,31,purchasing,0,2,2
33NOQL7T9O0HDOR1YG3G8GO6NPE8ZM,#14-9 Thailand began purchasing the Swedish-built Gripen jets in 2008 and has twelve.,50,61,Gripen jets,1,0,1
33NOQL7T9O0HDOR1YG3G8GO6NPE8ZM,"#14-10 None of its neighbours have similar aircraft, which cost the nation around 2.5 billion baht (US$70 million) each.",19,29,neighbours,3,0,3
33NOQL7T9O0HDOR1YG3G8GO6NPE8ZM,"#14-10 None of its neighbours have similar aircraft, which cost the nation around 2.5 billion baht (US$70 million) each.",43,51,aircraft,0,1,1
33NOQL7T9O0HDOR1YG3G8GO6NPE8ZM,"#14-10 None of its neighbours have similar aircraft, which cost the nation around 2.5 billion baht (US$70 million) each.",94,98,baht,4,0,4
34O39PNDK69RDV3HRBTDDFC8MEGBRV,#11-2 These experiments were performed on laboratory mice.,12,23,experiments,7,1,8
34O39PNDK69RDV3HRBTDDFC8MEGBRV,#11-2 These experiments were performed on laboratory mice.,29,38,performed,3,1,4
34O39PNDK69RDV3HRBTDDFC8MEGBRV,#11-2 These experiments were performed on laboratory mice.,42,52,laboratory,8,1,9
34O39PNDK69RDV3HRBTDDFC8MEGBRV,#11-2 These experiments were performed on laboratory mice.,42,57,laboratory mice,0,1,1
34O39PNDK69RDV3HRBTDDFC8MEGBRV,#11-2 These experiments were performed on laboratory mice.,53,57,mice,0,2,2
34O39PNDK69RDV3HRBTDDFC8MEGBRV,#11-3 The research team used an engineered virus to target and alter specific sets of neurons.,10,18,research,0,1,1
34O39PNDK69RDV3HRBTDDFC8MEGBRV,#11-3 The research team used an engineered virus to target and alter specific sets of neurons.,32,42,engineered,4,2,6
34O39PNDK69RDV3HRBTDDFC8MEGBRV,#11-3 The research team used an engineered virus to target and alter specific sets of neurons.,32,48,engineered virus,2,1,3
34O39PNDK69RDV3HRBTDDFC8MEGBRV,#11-3 The research team used an engineered virus to target and alter specific sets of neurons.,43,48,virus,1,0,1
34O39PNDK69RDV3HRBTDDFC8MEGBRV,#11-3 The research team used an engineered virus to target and alter specific sets of neurons.,52,58,target,0,1,1
34O39PNDK69RDV3HRBTDDFC8MEGBRV,#11-3 The research team used an engineered virus to target and alter specific sets of neurons.,63,68,alter,1,0,1
34O39PNDK69RDV3HRBTDDFC8MEGBRV,#11-3 The research team used an engineered virus to target and alter specific sets of neurons.,69,77,specific,1,0,1
34O39PNDK69RDV3HRBTDDFC8MEGBRV,#11-3 The research team used an engineered virus to target and alter specific sets of neurons.,69,82,specific sets,0,2,2
34O39PNDK69RDV3HRBTDDFC8MEGBRV,#11-3 The research team used an engineered virus to target and alter specific sets of neurons.,86,93,neurons,10,3,13
34O39PNDK69RDV3HRBTDDFC8MEGBRV,#11-4 Then they fitted the mice with intracranial optical fibers so they could expose their brains to blue light at will.,16,22,fitted,0,2,2
34O39PNDK69RDV3HRBTDDFC8MEGBRV,#11-4 Then they fitted the mice with intracranial optical fibers so they could expose their brains to blue light at will.,37,49,intracranial,9,9,18
34O39PNDK69RDV3HRBTDDFC8MEGBRV,#11-4 Then they fitted the mice with intracranial optical fibers so they could expose their brains to blue light at will.,37,64,intracranial optical fibers,4,3,7
34O39PNDK69RDV3HRBTDDFC8MEGBRV,#11-4 Then they fitted the mice with intracranial optical fibers so they could expose their brains to blue light at will.,50,57,optical,4,0,4
34O39PNDK69RDV3HRBTDDFC8MEGBRV,#11-4 Then they fitted the mice with intracranial optical fibers so they could expose their brains to blue light at will.,58,64,fibers,1,1,2
34O39PNDK69RDV3HRBTDDFC8MEGBRV,#11-4 Then they fitted the mice with intracranial optical fibers so they could expose their brains to blue light at will.,79,85,expose,1,0,1
34O39PNDK69RDV3HRBTDDFC8MEGBRV,"#11-5 The system excited two different sets of neurons, both located in the amygdala, which is the part of the brain associated with emotion and aggression.",17,24,excited,1,2,3
34O39PNDK69RDV3HRBTDDFC8MEGBRV,"#11-5 The system excited two different sets of neurons, both located in the amygdala, which is the part of the brain associated with emotion and aggression.",47,54,neurons,3,1,4
34O39PNDK69RDV3HRBTDDFC8MEGBRV,"#11-5 The system excited two different sets of neurons, both located in the amygdala, which is the part of the brain associated with emotion and aggression.",76,84,amygdala,10,6,16
34O39PNDK69RDV3HRBTDDFC8MEGBRV,"#11-5 The system excited two different sets of neurons, both located in the amygdala, which is the part of the brain associated with emotion and aggression.",133,155,emotion and aggression,1,0,1
34O39PNDK69RDV3HRBTDDFC8MEGBRV,"#11-5 The system excited two different sets of neurons, both located in the amygdala, which is the part of the brain associated with emotion and aggression.",145,155,aggression,3,6,9
34O39PNDK69RDV3HRBTDDFC8MEGBRV,"#11-6 One set stimulated prey pursuit behavior, such as stalking, and the other stimulated the animal to use its jaw and neck muscles.",14,24,stimulated,3,5,8
34O39PNDK69RDV3HRBTDDFC8MEGBRV,"#11-6 One set stimulated prey pursuit behavior, such as stalking, and the other stimulated the animal to use its jaw and neck muscles.",14,37,stimulated prey pursuit,1,0,1
34O39PNDK69RDV3HRBTDDFC8MEGBRV,"#11-6 One set stimulated prey pursuit behavior, such as stalking, and the other stimulated the animal to use its jaw and neck muscles.",14,46,stimulated prey pursuit behavior,2,1,3
34O39PNDK69RDV3HRBTDDFC8MEGBRV,"#11-6 One set stimulated prey pursuit behavior, such as stalking, and the other stimulated the animal to use its jaw and neck muscles.",25,29,prey,2,1,3
34O39PNDK69RDV3HRBTDDFC8MEGBRV,"#11-6 One set stimulated prey pursuit behavior, such as stalking, and the other stimulated the animal to use its jaw and neck muscles.",25,37,prey pursuit,0,1,1
34O39PNDK69RDV3HRBTDDFC8MEGBRV,"#11-6 One set stimulated prey pursuit behavior, such as stalking, and the other stimulated the animal to use its jaw and neck muscles.",25,46,prey pursuit behavior,0,2,2
34O39PNDK69RDV3HRBTDDFC8MEGBRV,"#11-6 One set stimulated prey pursuit behavior, such as stalking, and the other stimulated the animal to use its jaw and neck muscles.",30,37,pursuit,5,4,9
34O39PNDK69RDV3HRBTDDFC8MEGBRV,"#11-6 One set stimulated prey pursuit behavior, such as stalking, and the other stimulated the animal to use its jaw and neck muscles.",38,46,behavior,2,0,2
34O39PNDK69RDV3HRBTDDFC8MEGBRV,"#11-6 One set stimulated prey pursuit behavior, such as stalking, and the other stimulated the animal to use its jaw and neck muscles.",56,64,stalking,3,5,8
34O39PNDK69RDV3HRBTDDFC8MEGBRV,"#11-6 One set stimulated prey pursuit behavior, such as stalking, and the other stimulated the animal to use its jaw and neck muscles.",80,90,stimulated,2,5,7
34O39PNDK69RDV3HRBTDDFC8MEGBRV,"#11-6 One set stimulated prey pursuit behavior, such as stalking, and the other stimulated the animal to use its jaw and neck muscles.",113,116,jaw,0,1,1
34O39PNDK69RDV3HRBTDDFC8MEGBRV,"#11-7 When exposed to the laser, the primed mice would first stalk and then pounce on and bite any object in their enclosure, even objects without any food scent or prey value, like sticks and bottle caps.",11,18,exposed,0,1,1
34O39PNDK69RDV3HRBTDDFC8MEGBRV,"#11-7 When exposed to the laser, the primed mice would first stalk and then pounce on and bite any object in their enclosure, even objects without any food scent or prey value, like sticks and bottle caps.",37,43,primed,5,3,8
34O39PNDK69RDV3HRBTDDFC8MEGBRV,"#11-7 When exposed to the laser, the primed mice would first stalk and then pounce on and bite any object in their enclosure, even objects without any food scent or prey value, like sticks and bottle caps.",37,48,primed mice,0,1,1
34O39PNDK69RDV3HRBTDDFC8MEGBRV,"#11-7 When exposed to the laser, the primed mice would first stalk and then pounce on and bite any object in their enclosure, even objects without any food scent or prey value, like sticks and bottle caps.",61,66,stalk,1,2,3
34O39PNDK69RDV3HRBTDDFC8MEGBRV,"#11-7 When exposed to the laser, the primed mice would first stalk and then pounce on and bite any object in their enclosure, even objects without any food scent or prey value, like sticks and bottle caps.",61,82,stalk and then pounce,0,1,1
34O39PNDK69RDV3HRBTDDFC8MEGBRV,"#11-7 When exposed to the laser, the primed mice would first stalk and then pounce on and bite any object in their enclosure, even objects without any food scent or prey value, like sticks and bottle caps.",76,82,pounce,4,5,9
34O39PNDK69RDV3HRBTDDFC8MEGBRV,"#11-7 When exposed to the laser, the primed mice would first stalk and then pounce on and bite any object in their enclosure, even objects without any food scent or prey value, like sticks and bottle caps.",76,85,pounce on,0,1,1
34O39PNDK69RDV3HRBTDDFC8MEGBRV,"#11-7 When exposed to the laser, the primed mice would first stalk and then pounce on and bite any object in their enclosure, even objects without any food scent or prey value, like sticks and bottle caps.",115,124,enclosure,1,5,6
34O39PNDK69RDV3HRBTDDFC8MEGBRV,"#11-7 When exposed to the laser, the primed mice would first stalk and then pounce on and bite any object in their enclosure, even objects without any food scent or prey value, like sticks and bottle caps.",156,161,scent,1,0,1
34O39PNDK69RDV3HRBTDDFC8MEGBRV,"#11-7 When exposed to the laser, the primed mice would first stalk and then pounce on and bite any object in their enclosure, even objects without any food scent or prey value, like sticks and bottle caps.",165,169,prey,0,1,1
3EHVO81VN5MDB37MT9OUTZXTDTRH1L,"#13-11 Representative Tom MacArthur of New Jersey agreed, saying, ""We're loading a gun here.",7,21,Representative,9,3,12
3EHVO81VN5MDB37MT9OUTZXTDTRH1L,"#13-12 I want to know where it's pointed before we start the process.""",22,39,where its pointed,1,0,1
3EHVO81VN5MDB37MT9OUTZXTDTRH1L,"#13-12 I want to know where it's pointed before we start the process.""",61,68,process,3,1,4
3EHVO81VN5MDB37MT9OUTZXTDTRH1L,"#13-13 Anna Merlan of Jezebel and Anthony Taylor of the Associated Press dismiss Trump's timeline as ""impossible"" given the complicated nature of U.S. congressional workings.",22,29,Jezebel,1,0,1
3EHVO81VN5MDB37MT9OUTZXTDTRH1L,"#13-13 Anna Merlan of Jezebel and Anthony Taylor of the Associated Press dismiss Trump's timeline as ""impossible"" given the complicated nature of U.S. congressional workings.",56,66,Associated,1,0,1
3EHVO81VN5MDB37MT9OUTZXTDTRH1L,"#13-13 Anna Merlan of Jezebel and Anthony Taylor of the Associated Press dismiss Trump's timeline as ""impossible"" given the complicated nature of U.S. congressional workings.",56,72,Associated Press,1,0,1
3EHVO81VN5MDB37MT9OUTZXTDTRH1L,"#13-13 Anna Merlan of Jezebel and Anthony Taylor of the Associated Press dismiss Trump's timeline as ""impossible"" given the complicated nature of U.S. congressional workings.",73,80,dismiss,3,4,7
3EHVO81VN5MDB37MT9OUTZXTDTRH1L,"#13-13 Anna Merlan of Jezebel and Anthony Taylor of the Associated Press dismiss Trump's timeline as ""impossible"" given the complicated nature of U.S. congressional workings.",89,97,timeline,0,4,4
3EHVO81VN5MDB37MT9OUTZXTDTRH1L,"#13-13 Anna Merlan of Jezebel and Anthony Taylor of the Associated Press dismiss Trump's timeline as ""impossible"" given the complicated nature of U.S. congressional workings.",102,112,impossible,0,1,1
3EHVO81VN5MDB37MT9OUTZXTDTRH1L,"#13-13 Anna Merlan of Jezebel and Anthony Taylor of the Associated Press dismiss Trump's timeline as ""impossible"" given the complicated nature of U.S. congressional workings.",124,135,complicated,2,2,4
3EHVO81VN5MDB37MT9OUTZXTDTRH1L,"#13-13 Anna Merlan of Jezebel and Anthony Taylor of the Associated Press dismiss Trump's timeline as ""impossible"" given the complicated nature of U.S. congressional workings.",124,142,complicated nature,1,2,3
3EHVO81VN5MDB37MT9OUTZXTDTRH1L,"#13-13 Anna Merlan of Jezebel and Anthony Taylor of the Associated Press dismiss Trump's timeline as ""impossible"" given the complicated nature of U.S. congressional workings.",151,164,congressional,7,3,10
3EHVO81VN5MDB37MT9OUTZXTDTRH1L,"#13-13 Anna Merlan of Jezebel and Anthony Taylor of the Associated Press dismiss Trump's timeline as ""impossible"" given the complicated nature of U.S. congressional workings.",151,173,congressional workings,2,1,3
3EHVO81VN5MDB37MT9OUTZXTDTRH1L,"#13-13 Anna Merlan of Jezebel and Anthony Taylor of the Associated Press dismiss Trump's timeline as ""impossible"" given the complicated nature of U.S. congressional workings.",165,173,workings,1,0,1
3EHVO81VN5MDB37MT9OUTZXTDTRH1L,"#13-14 Senator Collins agreed, saying ""I don't see any possibility of our being able to come up with a comprehensive reform bill that would replace Obamacare by the end of this month.",55,66,possibility,3,0,3
3EHVO81VN5MDB37MT9OUTZXTDTRH1L,"#13-14 Senator Collins agreed, saying ""I don't see any possibility of our being able to come up with a comprehensive reform bill that would replace Obamacare by the end of this month.",103,116,comprehensive,9,8,17
3EHVO81VN5MDB37MT9OUTZXTDTRH1L,"#13-14 Senator Collins agreed, saying ""I don't see any possibility of our being able to come up with a comprehensive reform bill that would replace Obamacare by the end of this month.",103,123,comprehensive reform,3,2,5
3EHVO81VN5MDB37MT9OUTZXTDTRH1L,"#13-14 Senator Collins agreed, saying ""I don't see any possibility of our being able to come up with a comprehensive reform bill that would replace Obamacare by the end of this month.",103,128,comprehensive reform bill,3,0,3
3EHVO81VN5MDB37MT9OUTZXTDTRH1L,"#13-14 Senator Collins agreed, saying ""I don't see any possibility of our being able to come up with a comprehensive reform bill that would replace Obamacare by the end of this month.",117,123,reform,1,1,2
3EHVO81VN5MDB37MT9OUTZXTDTRH1L,"#13-14 Senator Collins agreed, saying ""I don't see any possibility of our being able to come up with a comprehensive reform bill that would replace Obamacare by the end of this month.",117,128,reform bill,1,0,1
3EHVO81VN5MDB37MT9OUTZXTDTRH1L,"#13-14 Senator Collins agreed, saying ""I don't see any possibility of our being able to come up with a comprehensive reform bill that would replace Obamacare by the end of this month.",124,128,bill,0,1,1
3EHVO81VN5MDB37MT9OUTZXTDTRH1L,"#13-14 Senator Collins agreed, saying ""I don't see any possibility of our being able to come up with a comprehensive reform bill that would replace Obamacare by the end of this month.",148,157,Obamacare,2,0,2
3EHVO81VN5MDB37MT9OUTZXTDTRH1L,"#13-15 I just don't see that as being feasible.""",38,46,feasible,8,10,18
3EHVO81VN5MDB37MT9OUTZXTDTRH1L,"#13-16 The Affordable Care Act, which is often cited as a key accomplishment of the Obama administration, has had a mixed reputation, and many conservatives believe a market-based health care system would be more flexible and efficient and less costly, and many believe that the Affordable Care Act only passed because of Obama's later discredited pledge that no one who liked their current health plan would have to switch.",7,30,The Affordable Care Act,1,0,1
3EHVO81VN5MDB37MT9OUTZXTDTRH1L,"#13-16 The Affordable Care Act, which is often cited as a key accomplishment of the Obama administration, has had a mixed reputation, and many conservatives believe a market-based health care system would be more flexible and efficient and less costly, and many believe that the Affordable Care Act only passed because of Obama's later discredited pledge that no one who liked their current health plan would have to switch.",11,21,Affordable,0,3,3
3EHVO81VN5MDB37MT9OUTZXTDTRH1L,"#13-16 The Affordable Care Act, which is often cited as a key accomplishment of the Obama administration, has had a mixed reputation, and many conservatives believe a market-based health care system would be more flexible and efficient and less costly, and many believe that the Affordable Care Act only passed because of Obama's later discredited pledge that no one who liked their current health plan would have to switch.",47,52,cited,0,1,1
3EHVO81VN5MDB37MT9OUTZXTDTRH1L,"#13-16 The Affordable Care Act, which is often cited as a key accomplishment of the Obama administration, has had a mixed reputation, and many conservatives believe a market-based health care system would be more flexible and efficient and less costly, and many believe that the Affordable Care Act only passed because of Obama's later discredited pledge that no one who liked their current health plan would have to switch.",58,76,key accomplishment,0,1,1
3EHVO81VN5MDB37MT9OUTZXTDTRH1L,"#13-16 The Affordable Care Act, which is often cited as a key accomplishment of the Obama administration, has had a mixed reputation, and many conservatives believe a market-based health care system would be more flexible and efficient and less costly, and many believe that the Affordable Care Act only passed because of Obama's later discredited pledge that no one who liked their current health plan would have to switch.",62,76,accomplishment,6,8,14
3EHVO81VN5MDB37MT9OUTZXTDTRH1L,"#13-16 The Affordable Care Act, which is often cited as a key accomplishment of the Obama administration, has had a mixed reputation, and many conservatives believe a market-based health care system would be more flexible and efficient and less costly, and many believe that the Affordable Care Act only passed because of Obama's later discredited pledge that no one who liked their current health plan would have to switch.",90,104,administration,1,0,1
3EHVO81VN5MDB37MT9OUTZXTDTRH1L,"#13-16 The Affordable Care Act, which is often cited as a key accomplishment of the Obama administration, has had a mixed reputation, and many conservatives believe a market-based health care system would be more flexible and efficient and less costly, and many believe that the Affordable Care Act only passed because of Obama's later discredited pledge that no one who liked their current health plan would have to switch.",116,132,mixed reputation,1,0,1
3EHVO81VN5MDB37MT9OUTZXTDTRH1L,"#13-16 The Affordable Care Act, which is often cited as a key accomplishment of the Obama administration, has had a mixed reputation, and many conservatives believe a market-based health care system would be more flexible and efficient and less costly, and many believe that the Affordable Care Act only passed because of Obama's later discredited pledge that no one who liked their current health plan would have to switch.",122,132,reputation,4,4,8
3EHVO81VN5MDB37MT9OUTZXTDTRH1L,"#13-16 The Affordable Care Act, which is often cited as a key accomplishment of the Obama administration, has had a mixed reputation, and many conservatives believe a market-based health care system would be more flexible and efficient and less costly, and many believe that the Affordable Care Act only passed because of Obama's later discredited pledge that no one who liked their current health plan would have to switch.",143,156,conservatives,3,4,7
3EHVO81VN5MDB37MT9OUTZXTDTRH1L,"#13-16 The Affordable Care Act, which is often cited as a key accomplishment of the Obama administration, has had a mixed reputation, and many conservatives believe a market-based health care system would be more flexible and efficient and less costly, and many believe that the Affordable Care Act only passed because of Obama's later discredited pledge that no one who liked their current health plan would have to switch.",167,179,market-based,3,1,4
3EHVO81VN5MDB37MT9OUTZXTDTRH1L,"#13-16 The Affordable Care Act, which is often cited as a key accomplishment of the Obama administration, has had a mixed reputation, and many conservatives believe a market-based health care system would be more flexible and efficient and less costly, and many believe that the Affordable Care Act only passed because of Obama's later discredited pledge that no one who liked their current health plan would have to switch.",167,198,market-based health care system,1,0,1
3EHVO81VN5MDB37MT9OUTZXTDTRH1L,"#13-16 The Affordable Care Act, which is often cited as a key accomplishment of the Obama administration, has had a mixed reputation, and many conservatives believe a market-based health care system would be more flexible and efficient and less costly, and many believe that the Affordable Care Act only passed because of Obama's later discredited pledge that no one who liked their current health plan would have to switch.",213,221,flexible,0,3,3
3EHVO81VN5MDB37MT9OUTZXTDTRH1L,"#13-16 The Affordable Care Act, which is often cited as a key accomplishment of the Obama administration, has had a mixed reputation, and many conservatives believe a market-based health care system would be more flexible and efficient and less costly, and many believe that the Affordable Care Act only passed because of Obama's later discredited pledge that no one who liked their current health plan would have to switch.",226,235,efficient,1,2,3
3EHVO81VN5MDB37MT9OUTZXTDTRH1L,"#13-16 The Affordable Care Act, which is often cited as a key accomplishment of the Obama administration, has had a mixed reputation, and many conservatives believe a market-based health care system would be more flexible and efficient and less costly, and many believe that the Affordable Care Act only passed because of Obama's later discredited pledge that no one who liked their current health plan would have to switch.",245,251,costly,1,0,1
3EHVO81VN5MDB37MT9OUTZXTDTRH1L,"#13-16 The Affordable Care Act, which is often cited as a key accomplishment of the Obama administration, has had a mixed reputation, and many conservatives believe a market-based health care system would be more flexible and efficient and less costly, and many believe that the Affordable Care Act only passed because of Obama's later discredited pledge that no one who liked their current health plan would have to switch.",279,289,Affordable,0,1,1
3EHVO81VN5MDB37MT9OUTZXTDTRH1L,"#13-16 The Affordable Care Act, which is often cited as a key accomplishment of the Obama administration, has had a mixed reputation, and many conservatives believe a market-based health care system would be more flexible and efficient and less costly, and many believe that the Affordable Care Act only passed because of Obama's later discredited pledge that no one who liked their current health plan would have to switch.",279,298,Affordable Care Act,1,0,1
3EHVO81VN5MDB37MT9OUTZXTDTRH1L,"#13-16 The Affordable Care Act, which is often cited as a key accomplishment of the Obama administration, has had a mixed reputation, and many conservatives believe a market-based health care system would be more flexible and efficient and less costly, and many believe that the Affordable Care Act only passed because of Obama's later discredited pledge that no one who liked their current health plan would have to switch.",336,347,discredited,6,5,11
3EHVO81VN5MDB37MT9OUTZXTDTRH1L,"#13-16 The Affordable Care Act, which is often cited as a key accomplishment of the Obama administration, has had a mixed reputation, and many conservatives believe a market-based health care system would be more flexible and efficient and less costly, and many believe that the Affordable Care Act only passed because of Obama's later discredited pledge that no one who liked their current health plan would have to switch.",336,354,discredited pledge,4,2,6
3EHVO81VN5MDB37MT9OUTZXTDTRH1L,"#13-16 The Affordable Care Act, which is often cited as a key accomplishment of the Obama administration, has had a mixed reputation, and many conservatives believe a market-based health care system would be more flexible and efficient and less costly, and many believe that the Affordable Care Act only passed because of Obama's later discredited pledge that no one who liked their current health plan would have to switch.",348,354,pledge,2,5,7
3EHVO81VN5MDB37MT9OUTZXTDTRH1L,"#13-16 The Affordable Care Act, which is often cited as a key accomplishment of the Obama administration, has had a mixed reputation, and many conservatives believe a market-based health care system would be more flexible and efficient and less costly, and many believe that the Affordable Care Act only passed because of Obama's later discredited pledge that no one who liked their current health plan would have to switch.",417,423,switch,1,2,3
37VHPF5VYC445VGR62J8XINLE7SC8R,"#7-9 Following the collision Manas airport was closed, and yesterday was declared a day of national mourning in Kyrgyzstan.",19,28,collision,9,6,15
37VHPF5VYC445VGR62J8XINLE7SC8R,"#7-9 Following the collision Manas airport was closed, and yesterday was declared a day of national mourning in Kyrgyzstan.",35,42,airport,1,0,1
37VHPF5VYC445VGR62J8XINLE7SC8R,"#7-9 Following the collision Manas airport was closed, and yesterday was declared a day of national mourning in Kyrgyzstan.",59,68,yesterday,1,0,1
37VHPF5VYC445VGR62J8XINLE7SC8R,"#7-9 Following the collision Manas airport was closed, and yesterday was declared a day of national mourning in Kyrgyzstan.",91,108,national mourning,1,1,2
37VHPF5VYC445VGR62J8XINLE7SC8R,"#7-9 Following the collision Manas airport was closed, and yesterday was declared a day of national mourning in Kyrgyzstan.",100,108,mourning,9,6,15
37VHPF5VYC445VGR62J8XINLE7SC8R,"#7-9 Following the collision Manas airport was closed, and yesterday was declared a day of national mourning in Kyrgyzstan.",112,122,Kyrgyzstan,3,1,4
37VHPF5VYC445VGR62J8XINLE7SC8R,#7-10 The flight was operated by ACT Airlines.,10,16,flight,1,0,1
37VHPF5VYC445VGR62J8XINLE7SC8R,#7-10 The flight was operated by ACT Airlines.,21,29,operated,2,1,3
37VHPF5VYC445VGR62J8XINLE7SC8R,"#7-11 Manas international airport is located outside the capital city of Bishkek, and has been the location of other fatal crashes.",12,25,international,3,0,3
37VHPF5VYC445VGR62J8XINLE7SC8R,"#7-11 Manas international airport is located outside the capital city of Bishkek, and has been the location of other fatal crashes.",73,80,Bishkek,2,0,2
37VHPF5VYC445VGR62J8XINLE7SC8R,"#7-11 Manas international airport is located outside the capital city of Bishkek, and has been the location of other fatal crashes.",117,122,fatal,6,4,10
37VHPF5VYC445VGR62J8XINLE7SC8R,"#7-11 Manas international airport is located outside the capital city of Bishkek, and has been the location of other fatal crashes.",117,130,fatal crashes,0,2,2
37VHPF5VYC445VGR62J8XINLE7SC8R,"#7-11 Manas international airport is located outside the capital city of Bishkek, and has been the location of other fatal crashes.",123,130,crashes,0,2,2
37VHPF5VYC445VGR62J8XINLE7SC8R,"#7-12 These include a Boeing 737 en route to Iran, which crashed shortly after take-off in 2008, killing 68 of at least 90 people on board.",33,41,en route,0,3,3
37VHPF5VYC445VGR62J8XINLE7SC8R,"#7-12 These include a Boeing 737 en route to Iran, which crashed shortly after take-off in 2008, killing 68 of at least 90 people on board.",57,64,crashed,0,2,2
37VHPF5VYC445VGR62J8XINLE7SC8R,"#7-12 These include a Boeing 737 en route to Iran, which crashed shortly after take-off in 2008, killing 68 of at least 90 people on board.",65,87,shortly after take-off,1,0,1
37VHPF5VYC445VGR62J8XINLE7SC8R,"#7-12 These include a Boeing 737 en route to Iran, which crashed shortly after take-off in 2008, killing 68 of at least 90 people on board.",79,87,take-off,1,3,4
37VHPF5VYC445VGR62J8XINLE7SC8R,"#7-12 These include a Boeing 737 en route to Iran, which crashed shortly after take-off in 2008, killing 68 of at least 90 people on board.",123,138,people on board,0,1,1
37VHPF5VYC445VGR62J8XINLE7SC8R,"#7-12 These include a Boeing 737 en route to Iran, which crashed shortly after take-off in 2008, killing 68 of at least 90 people on board.",130,138,on board,1,0,1
37VHPF5VYC445VGR62J8XINLE7SC8R,"#7-12 These include a Boeing 737 en route to Iran, which crashed shortly after take-off in 2008, killing 68 of at least 90 people on board.",133,138,board,1,0,1
37VHPF5VYC445VGR62J8XINLE7SC8R,#8-1 Robben signs contract extension with Bayern German football club FC Bayern Munich yesterday announced Dutch winger Arjen Robben has signed a one contract extension until June 2018.,18,26,contract,2,2,4
37VHPF5VYC445VGR62J8XINLE7SC8R,#8-1 Robben signs contract extension with Bayern German football club FC Bayern Munich yesterday announced Dutch winger Arjen Robben has signed a one contract extension until June 2018.,18,36,contract extension,2,1,3
37VHPF5VYC445VGR62J8XINLE7SC8R,#8-1 Robben signs contract extension with Bayern German football club FC Bayern Munich yesterday announced Dutch winger Arjen Robben has signed a one contract extension until June 2018.,27,36,extension,3,5,8
37VHPF5VYC445VGR62J8XINLE7SC8R,#8-1 Robben signs contract extension with Bayern German football club FC Bayern Munich yesterday announced Dutch winger Arjen Robben has signed a one contract extension until June 2018.,42,70,Bayern  German football club,1,0,1
37VHPF5VYC445VGR62J8XINLE7SC8R,#8-1 Robben signs contract extension with Bayern German football club FC Bayern Munich yesterday announced Dutch winger Arjen Robben has signed a one contract extension until June 2018.,97,106,announced,2,0,2
37VHPF5VYC445VGR62J8XINLE7SC8R,#8-1 Robben signs contract extension with Bayern German football club FC Bayern Munich yesterday announced Dutch winger Arjen Robben has signed a one contract extension until June 2018.,107,119,Dutch winger,0,2,2
37VHPF5VYC445VGR62J8XINLE7SC8R,#8-1 Robben signs contract extension with Bayern German football club FC Bayern Munich yesterday announced Dutch winger Arjen Robben has signed a one contract extension until June 2018.,113,119,winger,3,1,4
37VHPF5VYC445VGR62J8XINLE7SC8R,#8-1 Robben signs contract extension with Bayern German football club FC Bayern Munich yesterday announced Dutch winger Arjen Robben has signed a one contract extension until June 2018.,120,125,Arjen,1,0,1
37VHPF5VYC445VGR62J8XINLE7SC8R,#8-1 Robben signs contract extension with Bayern German football club FC Bayern Munich yesterday announced Dutch winger Arjen Robben has signed a one contract extension until June 2018.,146,168,one contract extension,1,0,1
37VHPF5VYC445VGR62J8XINLE7SC8R,#8-1 Robben signs contract extension with Bayern German football club FC Bayern Munich yesterday announced Dutch winger Arjen Robben has signed a one contract extension until June 2018.,150,168,contract extension,1,0,1
37VHPF5VYC445VGR62J8XINLE7SC8R,#8-1 Robben signs contract extension with Bayern German football club FC Bayern Munich yesterday announced Dutch winger Arjen Robben has signed a one contract extension until June 2018.,159,168,extension,6,2,8
37VHPF5VYC445VGR62J8XINLE7SC8R,"#8-3 Spending seven years with Munich, Robben has scored 82 goals in 152 Bundesliga appearances and netted 23 goals in 53 UEFA Champions League matches.",5,13,Spending,1,0,1
37VHPF5VYC445VGR62J8XINLE7SC8R,"#8-3 Spending seven years with Munich, Robben has scored 82 goals in 152 Bundesliga appearances and netted 23 goals in 53 UEFA Champions League matches.",31,37,Munich,0,1,1
37VHPF5VYC445VGR62J8XINLE7SC8R,"#8-3 Spending seven years with Munich, Robben has scored 82 goals in 152 Bundesliga appearances and netted 23 goals in 53 UEFA Champions League matches.",50,56,scored,1,0,1
37VHPF5VYC445VGR62J8XINLE7SC8R,"#8-3 Spending seven years with Munich, Robben has scored 82 goals in 152 Bundesliga appearances and netted 23 goals in 53 UEFA Champions League matches.",73,83,Bundesliga,2,1,3
37VHPF5VYC445VGR62J8XINLE7SC8R,"#8-3 Spending seven years with Munich, Robben has scored 82 goals in 152 Bundesliga appearances and netted 23 goals in 53 UEFA Champions League matches.",73,95,Bundesliga appearances,1,0,1
37VHPF5VYC445VGR62J8XINLE7SC8R,"#8-3 Spending seven years with Munich, Robben has scored 82 goals in 152 Bundesliga appearances and netted 23 goals in 53 UEFA Champions League matches.",84,95,appearances,4,3,7
37VHPF5VYC445VGR62J8XINLE7SC8R,"#8-3 Spending seven years with Munich, Robben has scored 82 goals in 152 Bundesliga appearances and netted 23 goals in 53 UEFA Champions League matches.",100,106,netted,3,10,13
37VHPF5VYC445VGR62J8XINLE7SC8R,"#8-3 Spending seven years with Munich, Robben has scored 82 goals in 152 Bundesliga appearances and netted 23 goals in 53 UEFA Champions League matches.",137,143,League,2,0,2
3OEWW2KGQJCHVF9LDF3FEAV3EC8OD6,"#42-105 For example, once we find the source of the medicine in nature... would species without access to this source also have evolved the same behaviour in the lab?",38,44,source,0,1,1
3OEWW2KGQJCHVF9LDF3FEAV3EC8OD6,"#42-105 For example, once we find the source of the medicine in nature... would species without access to this source also have evolved the same behaviour in the lab?",52,60,medicine,0,1,1
3OEWW2KGQJCHVF9LDF3FEAV3EC8OD6,"#42-105 For example, once we find the source of the medicine in nature... would species without access to this source also have evolved the same behaviour in the lab?",52,70,medicine in nature,1,0,1
3OEWW2KGQJCHVF9LDF3FEAV3EC8OD6,"#42-105 For example, once we find the source of the medicine in nature... would species without access to this source also have evolved the same behaviour in the lab?",80,87,species,3,4,7
3OEWW2KGQJCHVF9LDF3FEAV3EC8OD6,"#42-105 For example, once we find the source of the medicine in nature... would species without access to this source also have evolved the same behaviour in the lab?",96,102,access,2,2,4
3OEWW2KGQJCHVF9LDF3FEAV3EC8OD6,"#42-105 For example, once we find the source of the medicine in nature... would species without access to this source also have evolved the same behaviour in the lab?",111,117,source,0,1,1
3OEWW2KGQJCHVF9LDF3FEAV3EC8OD6,"#42-105 For example, once we find the source of the medicine in nature... would species without access to this source also have evolved the same behaviour in the lab?",128,135,evolved,7,3,10
3OEWW2KGQJCHVF9LDF3FEAV3EC8OD6,"#42-105 For example, once we find the source of the medicine in nature... would species without access to this source also have evolved the same behaviour in the lab?",128,154,evolved the same behaviour,1,0,1
3OEWW2KGQJCHVF9LDF3FEAV3EC8OD6,"#42-105 For example, once we find the source of the medicine in nature... would species without access to this source also have evolved the same behaviour in the lab?",145,154,behaviour,4,1,5
3OEWW2KGQJCHVF9LDF3FEAV3EC8OD6,#42-107 Also... can ants medicate their friends?,25,33,medicate,5,5,10
3OEWW2KGQJCHVF9LDF3FEAV3EC8OD6,#42-108 :) Wikinews: What other research are you working on right now?,32,40,research,1,1,2
3OEWW2KGQJCHVF9LDF3FEAV3EC8OD6,#42-109 NB Phew...lots!,11,15,Phew,1,1,2
3OEWW2KGQJCHVF9LDF3FEAV3EC8OD6,#42-110 I still have some questions left unanswered from my Ph.D. work related to how ants recognize who is a friend and who isn't.,26,35,questions,1,0,1
3OEWW2KGQJCHVF9LDF3FEAV3EC8OD6,#42-110 I still have some questions left unanswered from my Ph.D. work related to how ants recognize who is a friend and who isn't.,41,51,unanswered,4,5,9
3OEWW2KGQJCHVF9LDF3FEAV3EC8OD6,#42-110 I still have some questions left unanswered from my Ph.D. work related to how ants recognize who is a friend and who isn't.,60,64,Ph.D,1,0,1
3OEWW2KGQJCHVF9LDF3FEAV3EC8OD6,#42-110 I still have some questions left unanswered from my Ph.D. work related to how ants recognize who is a friend and who isn't.,86,90,ants,0,1,1
3OEWW2KGQJCHVF9LDF3FEAV3EC8OD6,#42-110 I still have some questions left unanswered from my Ph.D. work related to how ants recognize who is a friend and who isn't.,91,100,recognize,5,5,10
3OEWW2KGQJCHVF9LDF3FEAV3EC8OD6,"#42-111 I also started collaborating with Prof. Michael Poulsen from the University of Copenhagen on immunity in fungus-growing termites, as well as their chemical recognition abilities.",23,36,collaborating,8,8,16
3OEWW2KGQJCHVF9LDF3FEAV3EC8OD6,"#42-111 I also started collaborating with Prof. Michael Poulsen from the University of Copenhagen on immunity in fungus-growing termites, as well as their chemical recognition abilities.",87,97,Copenhagen,0,2,2
3OEWW2KGQJCHVF9LDF3FEAV3EC8OD6,"#42-111 I also started collaborating with Prof. Michael Poulsen from the University of Copenhagen on immunity in fungus-growing termites, as well as their chemical recognition abilities.",101,109,immunity,8,7,15
3OEWW2KGQJCHVF9LDF3FEAV3EC8OD6,"#42-111 I also started collaborating with Prof. Michael Poulsen from the University of Copenhagen on immunity in fungus-growing termites, as well as their chemical recognition abilities.",101,136,immunity in fungus-growing termites,1,0,1
3OEWW2KGQJCHVF9LDF3FEAV3EC8OD6,"#42-111 I also started collaborating with Prof. Michael Poulsen from the University of Copenhagen on immunity in fungus-growing termites, as well as their chemical recognition abilities.",113,127,fungus-growing,6,3,9
3OEWW2KGQJCHVF9LDF3FEAV3EC8OD6,"#42-111 I also started collaborating with Prof. Michael Poulsen from the University of Copenhagen on immunity in fungus-growing termites, as well as their chemical recognition abilities.",113,136,fungus-growing termites,0,2,2
3OEWW2KGQJCHVF9LDF3FEAV3EC8OD6,"#42-111 I also started collaborating with Prof. Michael Poulsen from the University of Copenhagen on immunity in fungus-growing termites, as well as their chemical recognition abilities.",128,136,termites,6,7,13
3OEWW2KGQJCHVF9LDF3FEAV3EC8OD6,"#42-111 I also started collaborating with Prof. Michael Poulsen from the University of Copenhagen on immunity in fungus-growing termites, as well as their chemical recognition abilities.",155,163,chemical,2,0,2
3OEWW2KGQJCHVF9LDF3FEAV3EC8OD6,"#42-111 I also started collaborating with Prof. Michael Poulsen from the University of Copenhagen on immunity in fungus-growing termites, as well as their chemical recognition abilities.",155,175,chemical recognition,1,0,1
3OEWW2KGQJCHVF9LDF3FEAV3EC8OD6,"#42-111 I also started collaborating with Prof. Michael Poulsen from the University of Copenhagen on immunity in fungus-growing termites, as well as their chemical recognition abilities.",155,185,chemical recognition abilities,4,0,4
3OEWW2KGQJCHVF9LDF3FEAV3EC8OD6,"#42-111 I also started collaborating with Prof. Michael Poulsen from the University of Copenhagen on immunity in fungus-growing termites, as well as their chemical recognition abilities.",164,175,recognition,4,2,6
3OEWW2KGQJCHVF9LDF3FEAV3EC8OD6,"#42-111 I also started collaborating with Prof. Michael Poulsen from the University of Copenhagen on immunity in fungus-growing termites, as well as their chemical recognition abilities.",164,185,recognition abilities,0,2,2
3OEWW2KGQJCHVF9LDF3FEAV3EC8OD6,"#42-112 Furthermore we're working on social parasitism in wood-ants (ants have lots of animals exploiting the nest for shelter and resources, which all somehow have to get in to the fortress without getting killed).",8,19,Furthermore,2,1,3
3OEWW2KGQJCHVF9LDF3FEAV3EC8OD6,"#42-112 Furthermore we're working on social parasitism in wood-ants (ants have lots of animals exploiting the nest for shelter and resources, which all somehow have to get in to the fortress without getting killed).",37,54,social parasitism,4,2,6
3OEWW2KGQJCHVF9LDF3FEAV3EC8OD6,"#42-112 Furthermore we're working on social parasitism in wood-ants (ants have lots of animals exploiting the nest for shelter and resources, which all somehow have to get in to the fortress without getting killed).",44,54,parasitism,10,8,18
3OEWW2KGQJCHVF9LDF3FEAV3EC8OD6,"#42-112 Furthermore we're working on social parasitism in wood-ants (ants have lots of animals exploiting the nest for shelter and resources, which all somehow have to get in to the fortress without getting killed).",58,67,wood-ants,1,2,3
3OEWW2KGQJCHVF9LDF3FEAV3EC8OD6,"#42-112 Furthermore we're working on social parasitism in wood-ants (ants have lots of animals exploiting the nest for shelter and resources, which all somehow have to get in to the fortress without getting killed).",95,105,exploiting,6,4,10
3OEWW2KGQJCHVF9LDF3FEAV3EC8OD6,"#42-112 Furthermore we're working on social parasitism in wood-ants (ants have lots of animals exploiting the nest for shelter and resources, which all somehow have to get in to the fortress without getting killed).",110,114,nest,0,1,1
3OEWW2KGQJCHVF9LDF3FEAV3EC8OD6,"#42-112 Furthermore we're working on social parasitism in wood-ants (ants have lots of animals exploiting the nest for shelter and resources, which all somehow have to get in to the fortress without getting killed).",119,126,shelter,1,2,3
3OEWW2KGQJCHVF9LDF3FEAV3EC8OD6,"#42-112 Furthermore we're working on social parasitism in wood-ants (ants have lots of animals exploiting the nest for shelter and resources, which all somehow have to get in to the fortress without getting killed).",131,140,resources,1,2,3
3OEWW2KGQJCHVF9LDF3FEAV3EC8OD6,"#42-112 Furthermore we're working on social parasitism in wood-ants (ants have lots of animals exploiting the nest for shelter and resources, which all somehow have to get in to the fortress without getting killed).",152,159,somehow,0,1,1
3OEWW2KGQJCHVF9LDF3FEAV3EC8OD6,"#42-112 Furthermore we're working on social parasitism in wood-ants (ants have lots of animals exploiting the nest for shelter and resources, which all somehow have to get in to the fortress without getting killed).",182,190,fortress,7,6,13
3AXFSPQOYQZ0SOWKO860UEH2RVEJFT,#42-26 WWikinews: What methods and equipment were used for this investigation?,23,30,methods,2,0,2
3AXFSPQOYQZ0SOWKO860UEH2RVEJFT,#42-26 WWikinews: What methods and equipment were used for this investigation?,35,44,equipment,8,5,13
3AXFSPQOYQZ0SOWKO860UEH2RVEJFT,"#42-28 I try to work on a very low budget, and like to build most of the experimental setups myself (we actually have equipment in the lab nicknamed the 'Nickinator', 'i-Nick' and the 'Nicktendo64').",31,41,low budget,0,2,2
3AXFSPQOYQZ0SOWKO860UEH2RVEJFT,"#42-28 I try to work on a very low budget, and like to build most of the experimental setups myself (we actually have equipment in the lab nicknamed the 'Nickinator', 'i-Nick' and the 'Nicktendo64').",35,41,budget,6,4,10
3AXFSPQOYQZ0SOWKO860UEH2RVEJFT,"#42-28 I try to work on a very low budget, and like to build most of the experimental setups myself (we actually have equipment in the lab nicknamed the 'Nickinator', 'i-Nick' and the 'Nicktendo64').",73,85,experimental,10,1,11
3AXFSPQOYQZ0SOWKO860UEH2RVEJFT,"#42-28 I try to work on a very low budget, and like to build most of the experimental setups myself (we actually have equipment in the lab nicknamed the 'Nickinator', 'i-Nick' and the 'Nicktendo64').",73,92,experimental setups,1,2,3
3AXFSPQOYQZ0SOWKO860UEH2RVEJFT,"#42-28 I try to work on a very low budget, and like to build most of the experimental setups myself (we actually have equipment in the lab nicknamed the 'Nickinator', 'i-Nick' and the 'Nicktendo64').",86,92,setups,0,4,4
3AXFSPQOYQZ0SOWKO860UEH2RVEJFT,"#42-28 I try to work on a very low budget, and like to build most of the experimental setups myself (we actually have equipment in the lab nicknamed the 'Nickinator', 'i-Nick' and the 'Nicktendo64').",118,127,equipment,4,1,5
3AXFSPQOYQZ0SOWKO860UEH2RVEJFT,"#42-28 I try to work on a very low budget, and like to build most of the experimental setups myself (we actually have equipment in the lab nicknamed the 'Nickinator', 'i-Nick' and the 'Nicktendo64').",139,148,nicknamed,2,6,8
3AXFSPQOYQZ0SOWKO860UEH2RVEJFT,"#42-28 I try to work on a very low budget, and like to build most of the experimental setups myself (we actually have equipment in the lab nicknamed the 'Nickinator', 'i-Nick' and the 'Nicktendo64').",154,164,Nickinator,2,1,3
3AXFSPQOYQZ0SOWKO860UEH2RVEJFT,"#42-28 I try to work on a very low budget, and like to build most of the experimental setups myself (we actually have equipment in the lab nicknamed the 'Nickinator', 'i-Nick' and the 'Nicktendo64').",168,174,i-Nick,1,0,1
3AXFSPQOYQZ0SOWKO860UEH2RVEJFT,"#42-29 There's not that much money in fundamental science at the moment, so I try to cut the costs wherever possible.",38,49,fundamental,10,7,17
3AXFSPQOYQZ0SOWKO860UEH2RVEJFT,"#42-29 There's not that much money in fundamental science at the moment, so I try to cut the costs wherever possible.",38,57,fundamental science,2,1,3
3AXFSPQOYQZ0SOWKO860UEH2RVEJFT,"#42-29 There's not that much money in fundamental science at the moment, so I try to cut the costs wherever possible.",50,57,science,2,0,2
3AXFSPQOYQZ0SOWKO860UEH2RVEJFT,"#42-29 There's not that much money in fundamental science at the moment, so I try to cut the costs wherever possible.",99,107,wherever,0,1,1
3AXFSPQOYQZ0SOWKO860UEH2RVEJFT,#42-30 We collected wild colonies of Formica fusca by searching through old tree-trunks in old logging sites in southern Finland.,20,24,wild,0,1,1
3AXFSPQOYQZ0SOWKO860UEH2RVEJFT,#42-30 We collected wild colonies of Formica fusca by searching through old tree-trunks in old logging sites in southern Finland.,20,33,wild colonies,1,1,2
3AXFSPQOYQZ0SOWKO860UEH2RVEJFT,#42-30 We collected wild colonies of Formica fusca by searching through old tree-trunks in old logging sites in southern Finland.,25,33,colonies,5,3,8
3AXFSPQOYQZ0SOWKO860UEH2RVEJFT,#42-30 We collected wild colonies of Formica fusca by searching through old tree-trunks in old logging sites in southern Finland.,37,50,Formica fusca,4,1,5
3AXFSPQOYQZ0SOWKO860UEH2RVEJFT,#42-30 We collected wild colonies of Formica fusca by searching through old tree-trunks in old logging sites in southern Finland.,45,50,fusca,2,3,5
3AXFSPQOYQZ0SOWKO860UEH2RVEJFT,#42-30 We collected wild colonies of Formica fusca by searching through old tree-trunks in old logging sites in southern Finland.,54,63,searching,0,1,1
3AXFSPQOYQZ0SOWKO860UEH2RVEJFT,#42-30 We collected wild colonies of Formica fusca by searching through old tree-trunks in old logging sites in southern Finland.,76,87,tree-trunks,1,4,5
3AXFSPQOYQZ0SOWKO860UEH2RVEJFT,#42-30 We collected wild colonies of Formica fusca by searching through old tree-trunks in old logging sites in southern Finland.,95,102,logging,2,6,8
3AXFSPQOYQZ0SOWKO860UEH2RVEJFT,#42-30 We collected wild colonies of Formica fusca by searching through old tree-trunks in old logging sites in southern Finland.,95,108,logging sites,1,3,4
3AXFSPQOYQZ0SOWKO860UEH2RVEJFT,#42-31 We then housed the ants in nests I made using Y-tong [aerated concrete].,15,21,housed,0,3,3
3AXFSPQOYQZ0SOWKO860UEH2RVEJFT,#42-31 We then housed the ants in nests I made using Y-tong [aerated concrete].,26,30,ants,0,1,1
3AXFSPQOYQZ0SOWKO860UEH2RVEJFT,#42-31 We then housed the ants in nests I made using Y-tong [aerated concrete].,34,39,nests,0,3,3
3AXFSPQOYQZ0SOWKO860UEH2RVEJFT,#42-31 We then housed the ants in nests I made using Y-tong [aerated concrete].,53,59,Y-tong,2,0,2
3AXFSPQOYQZ0SOWKO860UEH2RVEJFT,#42-31 We then housed the ants in nests I made using Y-tong [aerated concrete].,53,77,Y-tong [aerated concrete,0,1,1
3AXFSPQOYQZ0SOWKO860UEH2RVEJFT,#42-31 We then housed the ants in nests I made using Y-tong [aerated concrete].,61,68,aerated,1,1,2
3AXFSPQOYQZ0SOWKO860UEH2RVEJFT,#42-31 We then housed the ants in nests I made using Y-tong [aerated concrete].,61,77,aerated concrete,1,1,2
3AXFSPQOYQZ0SOWKO860UEH2RVEJFT,#42-31 We then housed the ants in nests I made using Y-tong [aerated concrete].,69,77,concrete,1,0,1
3AXFSPQOYQZ0SOWKO860UEH2RVEJFT,#42-32 It's very soft stone that you can easily carve.,48,53,carve,1,8,9
3AXFSPQOYQZ0SOWKO860UEH2RVEJFT,#42-33 We carved out little squares for the ants to live in (covered with old CD covers to prevent them escaping).,10,16,carved,0,2,2
3AXFSPQOYQZ0SOWKO860UEH2RVEJFT,#42-33 We carved out little squares for the ants to live in (covered with old CD covers to prevent them escaping).,74,87,old CD covers,1,0,1
3AXFSPQOYQZ0SOWKO860UEH2RVEJFT,#42-33 We carved out little squares for the ants to live in (covered with old CD covers to prevent them escaping).,91,98,prevent,1,1,2
3AXFSPQOYQZ0SOWKO860UEH2RVEJFT,#42-33 We carved out little squares for the ants to live in (covered with old CD covers to prevent them escaping).,104,112,escaping,2,1,3
3IQ9O0AYW60EGIUF1AQPZHH35PXITO,#21-11 He joined F1 team Force India in 2012.,25,36,Force India,1,0,1
3IQ9O0AYW60EGIUF1AQPZHH35PXITO,"#21-12 In 2013, he joined Marussia F1; the following year, at the 2014 Monaco Grand Prix, he scored his and Marussia's first points with a ninth-place finish.",19,25,joined,0,1,1
3IQ9O0AYW60EGIUF1AQPZHH35PXITO,"#21-12 In 2013, he joined Marussia F1; the following year, at the 2014 Monaco Grand Prix, he scored his and Marussia's first points with a ninth-place finish.",26,34,Marussia,2,2,4
3IQ9O0AYW60EGIUF1AQPZHH35PXITO,"#21-12 In 2013, he joined Marussia F1; the following year, at the 2014 Monaco Grand Prix, he scored his and Marussia's first points with a ninth-place finish.",43,52,following,1,2,3
3IQ9O0AYW60EGIUF1AQPZHH35PXITO,"#21-12 In 2013, he joined Marussia F1; the following year, at the 2014 Monaco Grand Prix, he scored his and Marussia's first points with a ninth-place finish.",71,77,Monaco,1,0,1
3IQ9O0AYW60EGIUF1AQPZHH35PXITO,"#21-12 In 2013, he joined Marussia F1; the following year, at the 2014 Monaco Grand Prix, he scored his and Marussia's first points with a ninth-place finish.",71,88,Monaco Grand Prix,1,1,2
3IQ9O0AYW60EGIUF1AQPZHH35PXITO,"#21-12 In 2013, he joined Marussia F1; the following year, at the 2014 Monaco Grand Prix, he scored his and Marussia's first points with a ninth-place finish.",78,88,Grand Prix,1,0,1
3IQ9O0AYW60EGIUF1AQPZHH35PXITO,"#21-12 In 2013, he joined Marussia F1; the following year, at the 2014 Monaco Grand Prix, he scored his and Marussia's first points with a ninth-place finish.",93,99,scored,0,2,2
3IQ9O0AYW60EGIUF1AQPZHH35PXITO,"#21-12 In 2013, he joined Marussia F1; the following year, at the 2014 Monaco Grand Prix, he scored his and Marussia's first points with a ninth-place finish.",108,117,Marussias,1,1,2
3IQ9O0AYW60EGIUF1AQPZHH35PXITO,"#21-12 In 2013, he joined Marussia F1; the following year, at the 2014 Monaco Grand Prix, he scored his and Marussia's first points with a ninth-place finish.",139,150,ninth-place,1,1,2
3IQ9O0AYW60EGIUF1AQPZHH35PXITO,"#21-12 In 2013, he joined Marussia F1; the following year, at the 2014 Monaco Grand Prix, he scored his and Marussia's first points with a ninth-place finish.",139,157,ninth-place finish,0,1,1
3IQ9O0AYW60EGIUF1AQPZHH35PXITO,"#21-13 After the accident, the FIA, which sanctions Formula One racing, formed a panel to investigate the crash.",17,25,accident,2,1,3
3IQ9O0AYW60EGIUF1AQPZHH35PXITO,"#21-13 After the accident, the FIA, which sanctions Formula One racing, formed a panel to investigate the crash.",42,51,sanctions,10,5,15
3IQ9O0AYW60EGIUF1AQPZHH35PXITO,"#21-13 After the accident, the FIA, which sanctions Formula One racing, formed a panel to investigate the crash.",52,63,Formula One,1,0,1
3IQ9O0AYW60EGIUF1AQPZHH35PXITO,"#21-13 After the accident, the FIA, which sanctions Formula One racing, formed a panel to investigate the crash.",52,70,Formula One racing,0,1,1
3IQ9O0AYW60EGIUF1AQPZHH35PXITO,"#21-13 After the accident, the FIA, which sanctions Formula One racing, formed a panel to investigate the crash.",64,70,racing,0,1,1
3IQ9O0AYW60EGIUF1AQPZHH35PXITO,"#21-13 After the accident, the FIA, which sanctions Formula One racing, formed a panel to investigate the crash.",81,86,panel,4,4,8
3IQ9O0AYW60EGIUF1AQPZHH35PXITO,"#21-13 After the accident, the FIA, which sanctions Formula One racing, formed a panel to investigate the crash.",90,101,investigate,8,5,13
3IQ9O0AYW60EGIUF1AQPZHH35PXITO,"#21-13 After the accident, the FIA, which sanctions Formula One racing, formed a panel to investigate the crash.",106,111,crash,0,2,2
3IQ9O0AYW60EGIUF1AQPZHH35PXITO,"#21-14 Afterwards, the group revealed its findings: as Bianchi entered the run-off area of the track, he disabled the failsafe mechanism by ""[applying] both throttle and brake together, using both feet"", while his front wheels were locked; the panel also stated he did not slow down enough to control his car.",7,17,Afterwards,1,2,3
3IQ9O0AYW60EGIUF1AQPZHH35PXITO,"#21-14 Afterwards, the group revealed its findings: as Bianchi entered the run-off area of the track, he disabled the failsafe mechanism by ""[applying] both throttle and brake together, using both feet"", while his front wheels were locked; the panel also stated he did not slow down enough to control his car.",29,37,revealed,2,4,6
3IQ9O0AYW60EGIUF1AQPZHH35PXITO,"#21-14 Afterwards, the group revealed its findings: as Bianchi entered the run-off area of the track, he disabled the failsafe mechanism by ""[applying] both throttle and brake together, using both feet"", while his front wheels were locked; the panel also stated he did not slow down enough to control his car.",29,50,revealed its findings,0,1,1
3IQ9O0AYW60EGIUF1AQPZHH35PXITO,"#21-14 Afterwards, the group revealed its findings: as Bianchi entered the run-off area of the track, he disabled the failsafe mechanism by ""[applying] both throttle and brake together, using both feet"", while his front wheels were locked; the panel also stated he did not slow down enough to control his car.",55,62,Bianchi,0,2,2
3IQ9O0AYW60EGIUF1AQPZHH35PXITO,"#21-14 Afterwards, the group revealed its findings: as Bianchi entered the run-off area of the track, he disabled the failsafe mechanism by ""[applying] both throttle and brake together, using both feet"", while his front wheels were locked; the panel also stated he did not slow down enough to control his car.",63,70,entered,0,1,1
3IQ9O0AYW60EGIUF1AQPZHH35PXITO,"#21-14 Afterwards, the group revealed its findings: as Bianchi entered the run-off area of the track, he disabled the failsafe mechanism by ""[applying] both throttle and brake together, using both feet"", while his front wheels were locked; the panel also stated he did not slow down enough to control his car.",75,82,run-off,1,3,4
3IQ9O0AYW60EGIUF1AQPZHH35PXITO,"#21-14 Afterwards, the group revealed its findings: as Bianchi entered the run-off area of the track, he disabled the failsafe mechanism by ""[applying] both throttle and brake together, using both feet"", while his front wheels were locked; the panel also stated he did not slow down enough to control his car.",75,87,run-off area,2,0,2
3IQ9O0AYW60EGIUF1AQPZHH35PXITO,"#21-14 Afterwards, the group revealed its findings: as Bianchi entered the run-off area of the track, he disabled the failsafe mechanism by ""[applying] both throttle and brake together, using both feet"", while his front wheels were locked; the panel also stated he did not slow down enough to control his car.",95,100,track,0,1,1
3IQ9O0AYW60EGIUF1AQPZHH35PXITO,"#21-14 Afterwards, the group revealed its findings: as Bianchi entered the run-off area of the track, he disabled the failsafe mechanism by ""[applying] both throttle and brake together, using both feet"", while his front wheels were locked; the panel also stated he did not slow down enough to control his car.",105,113,disabled,5,4,9
3IQ9O0AYW60EGIUF1AQPZHH35PXITO,"#21-14 Afterwards, the group revealed its findings: as Bianchi entered the run-off area of the track, he disabled the failsafe mechanism by ""[applying] both throttle and brake together, using both feet"", while his front wheels were locked; the panel also stated he did not slow down enough to control his car.",118,126,failsafe,8,9,17
3IQ9O0AYW60EGIUF1AQPZHH35PXITO,"#21-14 Afterwards, the group revealed its findings: as Bianchi entered the run-off area of the track, he disabled the failsafe mechanism by ""[applying] both throttle and brake together, using both feet"", while his front wheels were locked; the panel also stated he did not slow down enough to control his car.",118,136,failsafe mechanism,5,2,7
3IQ9O0AYW60EGIUF1AQPZHH35PXITO,"#21-14 Afterwards, the group revealed its findings: as Bianchi entered the run-off area of the track, he disabled the failsafe mechanism by ""[applying] both throttle and brake together, using both feet"", while his front wheels were locked; the panel also stated he did not slow down enough to control his car.",127,136,mechanism,4,2,6
3IQ9O0AYW60EGIUF1AQPZHH35PXITO,"#21-14 Afterwards, the group revealed its findings: as Bianchi entered the run-off area of the track, he disabled the failsafe mechanism by ""[applying] both throttle and brake together, using both feet"", while his front wheels were locked; the panel also stated he did not slow down enough to control his car.",157,165,throttle,10,9,19
3IQ9O0AYW60EGIUF1AQPZHH35PXITO,"#21-14 Afterwards, the group revealed its findings: as Bianchi entered the run-off area of the track, he disabled the failsafe mechanism by ""[applying] both throttle and brake together, using both feet"", while his front wheels were locked; the panel also stated he did not slow down enough to control his car.",157,184,throttle and brake together,0,1,1
3IQ9O0AYW60EGIUF1AQPZHH35PXITO,"#21-14 Afterwards, the group revealed its findings: as Bianchi entered the run-off area of the track, he disabled the failsafe mechanism by ""[applying] both throttle and brake together, using both feet"", while his front wheels were locked; the panel also stated he did not slow down enough to control his car.",170,175,brake,0,3,3
3IQ9O0AYW60EGIUF1AQPZHH35PXITO,"#21-15 Eventually, F1 mandated the use of the ""virtual safety car"", which requires drivers to enter the pit lane at slower speeds instead of proceeding around the track.",7,17,Eventually,0,3,3
3IQ9O0AYW60EGIUF1AQPZHH35PXITO,"#21-15 Eventually, F1 mandated the use of the ""virtual safety car"", which requires drivers to enter the pit lane at slower speeds instead of proceeding around the track.",22,30,mandated,10,10,20
3IQ9O0AYW60EGIUF1AQPZHH35PXITO,"#21-15 Eventually, F1 mandated the use of the ""virtual safety car"", which requires drivers to enter the pit lane at slower speeds instead of proceeding around the track.",47,65,virtual safety car,2,2,4
3IQ9O0AYW60EGIUF1AQPZHH35PXITO,"#21-15 Eventually, F1 mandated the use of the ""virtual safety car"", which requires drivers to enter the pit lane at slower speeds instead of proceeding around the track.",47,54,virtual,1,0,1
3IQ9O0AYW60EGIUF1AQPZHH35PXITO,"#21-15 Eventually, F1 mandated the use of the ""virtual safety car"", which requires drivers to enter the pit lane at slower speeds instead of proceeding around the track.",74,82,requires,0,1,1
3IQ9O0AYW60EGIUF1AQPZHH35PXITO,"#21-15 Eventually, F1 mandated the use of the ""virtual safety car"", which requires drivers to enter the pit lane at slower speeds instead of proceeding around the track.",94,112,enter the pit lane,0,1,1
3IQ9O0AYW60EGIUF1AQPZHH35PXITO,"#21-15 Eventually, F1 mandated the use of the ""virtual safety car"", which requires drivers to enter the pit lane at slower speeds instead of proceeding around the track.",100,107,the pit,1,0,1
3IQ9O0AYW60EGIUF1AQPZHH35PXITO,"#21-15 Eventually, F1 mandated the use of the ""virtual safety car"", which requires drivers to enter the pit lane at slower speeds instead of proceeding around the track.",104,107,pit,0,1,1
3IQ9O0AYW60EGIUF1AQPZHH35PXITO,"#21-15 Eventually, F1 mandated the use of the ""virtual safety car"", which requires drivers to enter the pit lane at slower speeds instead of proceeding around the track.",141,151,proceeding,9,3,12
3G9UA71JVVVNDVHE6P8O6M4LT7VJ7P,#34-12 The broadcasts began on August 10 and South Korea says the broadcasts will continue.,11,21,broadcasts,8,4,12
3G9UA71JVVVNDVHE6P8O6M4LT7VJ7P,#34-12 The broadcasts began on August 10 and South Korea says the broadcasts will continue.,66,76,broadcasts,1,2,3
3G9UA71JVVVNDVHE6P8O6M4LT7VJ7P,"#34-13 After the exchange of fire, North Korea stated it would attack any loudspeakers broadcasting propaganda and would respond, militarily, within 48 hours if the broadcasts do not stop.",17,25,exchange,3,2,5
3G9UA71JVVVNDVHE6P8O6M4LT7VJ7P,"#34-13 After the exchange of fire, North Korea stated it would attack any loudspeakers broadcasting propaganda and would respond, militarily, within 48 hours if the broadcasts do not stop.",29,33,fire,1,0,1
3G9UA71JVVVNDVHE6P8O6M4LT7VJ7P,"#34-13 After the exchange of fire, North Korea stated it would attack any loudspeakers broadcasting propaganda and would respond, militarily, within 48 hours if the broadcasts do not stop.",74,86,loudspeakers,1,1,2
3G9UA71JVVVNDVHE6P8O6M4LT7VJ7P,"#34-13 After the exchange of fire, North Korea stated it would attack any loudspeakers broadcasting propaganda and would respond, militarily, within 48 hours if the broadcasts do not stop.",74,99,loudspeakers broadcasting,0,1,1
3G9UA71JVVVNDVHE6P8O6M4LT7VJ7P,"#34-13 After the exchange of fire, North Korea stated it would attack any loudspeakers broadcasting propaganda and would respond, militarily, within 48 hours if the broadcasts do not stop.",74,110,loudspeakers broadcasting propaganda,1,0,1
3G9UA71JVVVNDVHE6P8O6M4LT7VJ7P,"#34-13 After the exchange of fire, North Korea stated it would attack any loudspeakers broadcasting propaganda and would respond, militarily, within 48 hours if the broadcasts do not stop.",87,99,broadcasting,0,1,1
3G9UA71JVVVNDVHE6P8O6M4LT7VJ7P,"#34-13 After the exchange of fire, North Korea stated it would attack any loudspeakers broadcasting propaganda and would respond, militarily, within 48 hours if the broadcasts do not stop.",100,110,propaganda,10,9,19
3G9UA71JVVVNDVHE6P8O6M4LT7VJ7P,"#34-13 After the exchange of fire, North Korea stated it would attack any loudspeakers broadcasting propaganda and would respond, militarily, within 48 hours if the broadcasts do not stop.",121,128,respond,1,1,2
3G9UA71JVVVNDVHE6P8O6M4LT7VJ7P,"#34-13 After the exchange of fire, North Korea stated it would attack any loudspeakers broadcasting propaganda and would respond, militarily, within 48 hours if the broadcasts do not stop.",130,140,militarily,4,2,6
3G9UA71JVVVNDVHE6P8O6M4LT7VJ7P,"#34-13 After the exchange of fire, North Korea stated it would attack any loudspeakers broadcasting propaganda and would respond, militarily, within 48 hours if the broadcasts do not stop.",165,175,broadcasts,1,0,1
3G9UA71JVVVNDVHE6P8O6M4LT7VJ7P,#34-14 Both countries have put their militaries on high levels of alert.,37,47,militaries,3,0,3
3G9UA71JVVVNDVHE6P8O6M4LT7VJ7P,#34-14 Both countries have put their militaries on high levels of alert.,66,71,alert,0,2,2
3G9UA71JVVVNDVHE6P8O6M4LT7VJ7P,"#35-1 UK judge withholds report from Thai death penalty defendants In a judgement released today Mr Justice Green, sitting in the High Court in London, spoke of his ""very considerable unease"" as he rejected an application by two defendants in a Thai death penalty case.",15,24,withholds,1,5,6
3G9UA71JVVVNDVHE6P8O6M4LT7VJ7P,"#35-1 UK judge withholds report from Thai death penalty defendants In a judgement released today Mr Justice Green, sitting in the High Court in London, spoke of his ""very considerable unease"" as he rejected an application by two defendants in a Thai death penalty case.",42,47,death,1,0,1
3G9UA71JVVVNDVHE6P8O6M4LT7VJ7P,"#35-1 UK judge withholds report from Thai death penalty defendants In a judgement released today Mr Justice Green, sitting in the High Court in London, spoke of his ""very considerable unease"" as he rejected an application by two defendants in a Thai death penalty case.",42,55,death penalty,0,1,1
3G9UA71JVVVNDVHE6P8O6M4LT7VJ7P,"#35-1 UK judge withholds report from Thai death penalty defendants In a judgement released today Mr Justice Green, sitting in the High Court in London, spoke of his ""very considerable unease"" as he rejected an application by two defendants in a Thai death penalty case.",48,66,penalty defendants,1,0,1
3G9UA71JVVVNDVHE6P8O6M4LT7VJ7P,"#35-1 UK judge withholds report from Thai death penalty defendants In a judgement released today Mr Justice Green, sitting in the High Court in London, spoke of his ""very considerable unease"" as he rejected an application by two defendants in a Thai death penalty case.",56,66,defendants,1,5,6
3G9UA71JVVVNDVHE6P8O6M4LT7VJ7P,"#35-1 UK judge withholds report from Thai death penalty defendants In a judgement released today Mr Justice Green, sitting in the High Court in London, spoke of his ""very considerable unease"" as he rejected an application by two defendants in a Thai death penalty case.",72,81,judgement,4,0,4
3G9UA71JVVVNDVHE6P8O6M4LT7VJ7P,"#35-1 UK judge withholds report from Thai death penalty defendants In a judgement released today Mr Justice Green, sitting in the High Court in London, spoke of his ""very considerable unease"" as he rejected an application by two defendants in a Thai death penalty case.",82,90,released,1,0,1
3G9UA71JVVVNDVHE6P8O6M4LT7VJ7P,"#35-1 UK judge withholds report from Thai death penalty defendants In a judgement released today Mr Justice Green, sitting in the High Court in London, spoke of his ""very considerable unease"" as he rejected an application by two defendants in a Thai death penalty case.",166,190,very considerable unease,1,0,1
3G9UA71JVVVNDVHE6P8O6M4LT7VJ7P,"#35-1 UK judge withholds report from Thai death penalty defendants In a judgement released today Mr Justice Green, sitting in the High Court in London, spoke of his ""very considerable unease"" as he rejected an application by two defendants in a Thai death penalty case.",171,183,considerable,2,2,4
3G9UA71JVVVNDVHE6P8O6M4LT7VJ7P,"#35-1 UK judge withholds report from Thai death penalty defendants In a judgement released today Mr Justice Green, sitting in the High Court in London, spoke of his ""very considerable unease"" as he rejected an application by two defendants in a Thai death penalty case.",171,190,considerable unease,1,2,3
3G9UA71JVVVNDVHE6P8O6M4LT7VJ7P,"#35-1 UK judge withholds report from Thai death penalty defendants In a judgement released today Mr Justice Green, sitting in the High Court in London, spoke of his ""very considerable unease"" as he rejected an application by two defendants in a Thai death penalty case.",184,190,unease,6,4,10
3G9UA71JVVVNDVHE6P8O6M4LT7VJ7P,"#35-1 UK judge withholds report from Thai death penalty defendants In a judgement released today Mr Justice Green, sitting in the High Court in London, spoke of his ""very considerable unease"" as he rejected an application by two defendants in a Thai death penalty case.",198,206,rejected,4,0,4
3G9UA71JVVVNDVHE6P8O6M4LT7VJ7P,"#35-1 UK judge withholds report from Thai death penalty defendants In a judgement released today Mr Justice Green, sitting in the High Court in London, spoke of his ""very considerable unease"" as he rejected an application by two defendants in a Thai death penalty case.",210,221,application,3,1,4
3G9UA71JVVVNDVHE6P8O6M4LT7VJ7P,"#35-1 UK judge withholds report from Thai death penalty defendants In a judgement released today Mr Justice Green, sitting in the High Court in London, spoke of his ""very considerable unease"" as he rejected an application by two defendants in a Thai death penalty case.",229,239,defendants,4,1,5
3G9UA71JVVVNDVHE6P8O6M4LT7VJ7P,"#35-1 UK judge withholds report from Thai death penalty defendants In a judgement released today Mr Justice Green, sitting in the High Court in London, spoke of his ""very considerable unease"" as he rejected an application by two defendants in a Thai death penalty case.",256,263,penalty,1,2,3
3G9UA71JVVVNDVHE6P8O6M4LT7VJ7P,#35-2 The pair sought a Metropolitan Police report they hoped could assist their defence.,15,21,sought,0,3,3
3G9UA71JVVVNDVHE6P8O6M4LT7VJ7P,#35-2 The pair sought a Metropolitan Police report they hoped could assist their defence.,24,36,Metropolitan,4,1,5
3G9UA71JVVVNDVHE6P8O6M4LT7VJ7P,#35-2 The pair sought a Metropolitan Police report they hoped could assist their defence.,68,74,assist,2,2,4
3G9UA71JVVVNDVHE6P8O6M4LT7VJ7P,#35-2 The pair sought a Metropolitan Police report they hoped could assist their defence.,68,88,assist their defence,1,0,1
3G9UA71JVVVNDVHE6P8O6M4LT7VJ7P,#35-2 The pair sought a Metropolitan Police report they hoped could assist their defence.,81,88,defence,4,0,4
3G9UA71JVVVNDVHE6P8O6M4LT7VJ7P,"#35-3 The murders occurred on the picturesque resort island of Koh Tao, pictured here from file.",10,17,murders,1,1,2
3G9UA71JVVVNDVHE6P8O6M4LT7VJ7P,"#35-3 The murders occurred on the picturesque resort island of Koh Tao, pictured here from file.",18,26,occurred,3,0,3
3G9UA71JVVVNDVHE6P8O6M4LT7VJ7P,"#35-3 The murders occurred on the picturesque resort island of Koh Tao, pictured here from file.",34,45,picturesque,10,8,18
3G9UA71JVVVNDVHE6P8O6M4LT7VJ7P,"#35-3 The murders occurred on the picturesque resort island of Koh Tao, pictured here from file.",34,59,picturesque resort island,2,0,2
3G9UA71JVVVNDVHE6P8O6M4LT7VJ7P,"#35-3 The murders occurred on the picturesque resort island of Koh Tao, pictured here from file.",63,70,Koh Tao,0,1,1
3G9UA71JVVVNDVHE6P8O6M4LT7VJ7P,"#35-3 The murders occurred on the picturesque resort island of Koh Tao, pictured here from file.",72,80,pictured,0,1,1
32W3UF2EZOM3MUTPUZTVG67GCLWC4K,"#35-23 Thai Prime Minister Chan-o-cha, pictured here in December, was directly involved in negotiations that led to the report being produced.",18,26,Minister,1,0,1
32W3UF2EZOM3MUTPUZTVG67GCLWC4K,"#35-23 Thai Prime Minister Chan-o-cha, pictured here in December, was directly involved in negotiations that led to the report being produced.",39,47,pictured,0,3,3
32W3UF2EZOM3MUTPUZTVG67GCLWC4K,"#35-23 Thai Prime Minister Chan-o-cha, pictured here in December, was directly involved in negotiations that led to the report being produced.",91,103,negotiations,10,7,17
32W3UF2EZOM3MUTPUZTVG67GCLWC4K,"#35-23 Thai Prime Minister Chan-o-cha, pictured here in December, was directly involved in negotiations that led to the report being produced.",109,112,led,0,1,1
32W3UF2EZOM3MUTPUZTVG67GCLWC4K,"#35-24 Both men say they were starved, suffocated, stripped naked, exposed to cold temperatures, beaten, threatened, and denied legal representation.",30,37,starved,1,8,9
32W3UF2EZOM3MUTPUZTVG67GCLWC4K,"#35-24 Both men say they were starved, suffocated, stripped naked, exposed to cold temperatures, beaten, threatened, and denied legal representation.",30,65,"starved, suffocated, stripped naked",1,0,1
32W3UF2EZOM3MUTPUZTVG67GCLWC4K,"#35-24 Both men say they were starved, suffocated, stripped naked, exposed to cold temperatures, beaten, threatened, and denied legal representation.",39,49,suffocated,9,8,17
32W3UF2EZOM3MUTPUZTVG67GCLWC4K,"#35-24 Both men say they were starved, suffocated, stripped naked, exposed to cold temperatures, beaten, threatened, and denied legal representation.",51,59,stripped,2,8,10
32W3UF2EZOM3MUTPUZTVG67GCLWC4K,"#35-24 Both men say they were starved, suffocated, stripped naked, exposed to cold temperatures, beaten, threatened, and denied legal representation.",51,65,stripped naked,0,1,1
32W3UF2EZOM3MUTPUZTVG67GCLWC4K,"#35-24 Both men say they were starved, suffocated, stripped naked, exposed to cold temperatures, beaten, threatened, and denied legal representation.",67,74,exposed,0,1,1
32W3UF2EZOM3MUTPUZTVG67GCLWC4K,"#35-24 Both men say they were starved, suffocated, stripped naked, exposed to cold temperatures, beaten, threatened, and denied legal representation.",83,95,temperatures,3,0,3
32W3UF2EZOM3MUTPUZTVG67GCLWC4K,"#35-24 Both men say they were starved, suffocated, stripped naked, exposed to cold temperatures, beaten, threatened, and denied legal representation.",97,103,beaten,0,1,1
32W3UF2EZOM3MUTPUZTVG67GCLWC4K,"#35-24 Both men say they were starved, suffocated, stripped naked, exposed to cold temperatures, beaten, threatened, and denied legal representation.",105,115,threatened,7,6,13
32W3UF2EZOM3MUTPUZTVG67GCLWC4K,"#35-24 Both men say they were starved, suffocated, stripped naked, exposed to cold temperatures, beaten, threatened, and denied legal representation.",121,127,denied,2,1,3
32W3UF2EZOM3MUTPUZTVG67GCLWC4K,"#35-24 Both men say they were starved, suffocated, stripped naked, exposed to cold temperatures, beaten, threatened, and denied legal representation.",121,148,denied legal representation,1,0,1
32W3UF2EZOM3MUTPUZTVG67GCLWC4K,"#35-24 Both men say they were starved, suffocated, stripped naked, exposed to cold temperatures, beaten, threatened, and denied legal representation.",128,148,legal representation,1,1,2
32W3UF2EZOM3MUTPUZTVG67GCLWC4K,"#35-24 Both men say they were starved, suffocated, stripped naked, exposed to cold temperatures, beaten, threatened, and denied legal representation.",134,148,representation,2,0,2
32W3UF2EZOM3MUTPUZTVG67GCLWC4K,#35-25 The Royal Thai Police deny any misconduct.,11,21,Royal Thai,0,1,1
32W3UF2EZOM3MUTPUZTVG67GCLWC4K,#35-25 The Royal Thai Police deny any misconduct.,38,48,misconduct,10,6,16
32W3UF2EZOM3MUTPUZTVG67GCLWC4K,#35-26 Mr Justice Green read the report himself and decided not to release it as it was of no assistance to the pair.,7,23,Mr Justice Green,0,1,1
32W3UF2EZOM3MUTPUZTVG67GCLWC4K,#35-26 Mr Justice Green read the report himself and decided not to release it as it was of no assistance to the pair.,94,104,assistance,3,0,3
32W3UF2EZOM3MUTPUZTVG67GCLWC4K,#35-27 The report is known to contain some material disputed by Lin and Phyo.,11,37,report is known to contain,0,1,1
32W3UF2EZOM3MUTPUZTVG67GCLWC4K,#35-27 The report is known to contain some material disputed by Lin and Phyo.,43,51,material,1,0,1
32W3UF2EZOM3MUTPUZTVG67GCLWC4K,#35-27 The report is known to contain some material disputed by Lin and Phyo.,52,60,disputed,5,7,12
32W3UF2EZOM3MUTPUZTVG67GCLWC4K,#35-27 The report is known to contain some material disputed by Lin and Phyo.,72,76,Phyo,1,1,2
32W3UF2EZOM3MUTPUZTVG67GCLWC4K,"#35-28 It says they repeated their confessions at various times, including in court with legal representation, before retracting them.",35,46,confessions,5,6,11
32W3UF2EZOM3MUTPUZTVG67GCLWC4K,"#35-28 It says they repeated their confessions at various times, including in court with legal representation, before retracting them.",95,109,representation,4,0,4
32W3UF2EZOM3MUTPUZTVG67GCLWC4K,"#35-28 It says they repeated their confessions at various times, including in court with legal representation, before retracting them.",118,128,retracting,10,8,18
32W3UF2EZOM3MUTPUZTVG67GCLWC4K,"#35-29 It also says they have not backed up their torture claims with evidence, medical or otherwise.",34,43,backed up,1,2,3
32W3UF2EZOM3MUTPUZTVG67GCLWC4K,"#35-29 It also says they have not backed up their torture claims with evidence, medical or otherwise.",50,57,torture,4,5,9
32W3UF2EZOM3MUTPUZTVG67GCLWC4K,"#35-29 It also says they have not backed up their torture claims with evidence, medical or otherwise.",70,78,evidence,3,0,3
32W3UF2EZOM3MUTPUZTVG67GCLWC4K,"#35-30 Mr Justice Green said the report described ""in many respects [...] no more than the routine conduct of a serious crime investigation.",29,49,the report described,0,1,1
32W3UF2EZOM3MUTPUZTVG67GCLWC4K,"#35-30 Mr Justice Green said the report described ""in many respects [...] no more than the routine conduct of a serious crime investigation.",40,49,described,2,0,2
32W3UF2EZOM3MUTPUZTVG67GCLWC4K,"#35-30 Mr Justice Green said the report described ""in many respects [...] no more than the routine conduct of a serious crime investigation.",91,98,routine,3,3,6
32W3UF2EZOM3MUTPUZTVG67GCLWC4K,"#35-30 Mr Justice Green said the report described ""in many respects [...] no more than the routine conduct of a serious crime investigation.",91,106,routine conduct,0,1,1
32W3UF2EZOM3MUTPUZTVG67GCLWC4K,"#35-30 Mr Justice Green said the report described ""in many respects [...] no more than the routine conduct of a serious crime investigation.",99,106,conduct,3,0,3
32W3UF2EZOM3MUTPUZTVG67GCLWC4K,"#35-30 Mr Justice Green said the report described ""in many respects [...] no more than the routine conduct of a serious crime investigation.",120,139,crime investigation,0,1,1
32W3UF2EZOM3MUTPUZTVG67GCLWC4K,"#35-30 Mr Justice Green said the report described ""in many respects [...] no more than the routine conduct of a serious crime investigation.",126,139,investigation,2,1,3
3PKJ68EHDNXK6KNQJYU0XZTF7ARHJP,#41-11 Extradition to Austria is possible.,7,18,Extradition,10,10,20
3PKJ68EHDNXK6KNQJYU0XZTF7ARHJP,"#41-13 The children are thought to be aged three, eight, and ten years, alongside an eighteen-month-old baby.",20,31,are thought,0,1,1
3PKJ68EHDNXK6KNQJYU0XZTF7ARHJP,"#41-13 The children are thought to be aged three, eight, and ten years, alongside an eighteen-month-old baby.",72,81,alongside,4,3,7
3PKJ68EHDNXK6KNQJYU0XZTF7ARHJP,"#41-13 The children are thought to be aged three, eight, and ten years, alongside an eighteen-month-old baby.",85,103,eighteen-month-old,1,1,2
3PKJ68EHDNXK6KNQJYU0XZTF7ARHJP,"#41-14 ""There was also a Syrian travel document found"" police spokesman Hans Peter Doskozil told journalists ""so of course our first assumption is that these people were migrants, and likely a group of Syrian migrants.",25,31,Syrian,0,1,1
3PKJ68EHDNXK6KNQJYU0XZTF7ARHJP,"#41-14 ""There was also a Syrian travel document found"" police spokesman Hans Peter Doskozil told journalists ""so of course our first assumption is that these people were migrants, and likely a group of Syrian migrants.",32,47,travel document,1,0,1
3PKJ68EHDNXK6KNQJYU0XZTF7ARHJP,"#41-14 ""There was also a Syrian travel document found"" police spokesman Hans Peter Doskozil told journalists ""so of course our first assumption is that these people were migrants, and likely a group of Syrian migrants.",39,47,document,2,1,3
3PKJ68EHDNXK6KNQJYU0XZTF7ARHJP,"#41-14 ""There was also a Syrian travel document found"" police spokesman Hans Peter Doskozil told journalists ""so of course our first assumption is that these people were migrants, and likely a group of Syrian migrants.",62,71,spokesman,1,3,4
3PKJ68EHDNXK6KNQJYU0XZTF7ARHJP,"#41-14 ""There was also a Syrian travel document found"" police spokesman Hans Peter Doskozil told journalists ""so of course our first assumption is that these people were migrants, and likely a group of Syrian migrants.",72,76,Hans,0,1,1
3PKJ68EHDNXK6KNQJYU0XZTF7ARHJP,"#41-14 ""There was also a Syrian travel document found"" police spokesman Hans Peter Doskozil told journalists ""so of course our first assumption is that these people were migrants, and likely a group of Syrian migrants.",77,91,Peter Doskozil,0,1,1
3PKJ68EHDNXK6KNQJYU0XZTF7ARHJP,"#41-14 ""There was also a Syrian travel document found"" police spokesman Hans Peter Doskozil told journalists ""so of course our first assumption is that these people were migrants, and likely a group of Syrian migrants.",83,91,Doskozil,1,0,1
3PKJ68EHDNXK6KNQJYU0XZTF7ARHJP,"#41-14 ""There was also a Syrian travel document found"" police spokesman Hans Peter Doskozil told journalists ""so of course our first assumption is that these people were migrants, and likely a group of Syrian migrants.",97,108,journalists,3,1,4
3PKJ68EHDNXK6KNQJYU0XZTF7ARHJP,"#41-14 ""There was also a Syrian travel document found"" police spokesman Hans Peter Doskozil told journalists ""so of course our first assumption is that these people were migrants, and likely a group of Syrian migrants.",127,143,first assumption,0,1,1
3PKJ68EHDNXK6KNQJYU0XZTF7ARHJP,"#41-14 ""There was also a Syrian travel document found"" police spokesman Hans Peter Doskozil told journalists ""so of course our first assumption is that these people were migrants, and likely a group of Syrian migrants.",133,143,assumption,10,6,16
3PKJ68EHDNXK6KNQJYU0XZTF7ARHJP,"#41-14 ""There was also a Syrian travel document found"" police spokesman Hans Peter Doskozil told journalists ""so of course our first assumption is that these people were migrants, and likely a group of Syrian migrants.",170,178,migrants,8,6,14
3PKJ68EHDNXK6KNQJYU0XZTF7ARHJP,"#41-14 ""There was also a Syrian travel document found"" police spokesman Hans Peter Doskozil told journalists ""so of course our first assumption is that these people were migrants, and likely a group of Syrian migrants.",202,208,Syrian,0,1,1
3PKJ68EHDNXK6KNQJYU0XZTF7ARHJP,"#41-14 ""There was also a Syrian travel document found"" police spokesman Hans Peter Doskozil told journalists ""so of course our first assumption is that these people were migrants, and likely a group of Syrian migrants.",209,217,migrants,3,0,3
3PKJ68EHDNXK6KNQJYU0XZTF7ARHJP,"#41-15 We can rule out that they were Africans"".",14,22,rule out,1,1,2
3PKJ68EHDNXK6KNQJYU0XZTF7ARHJP,"#41-16 The four accused were escorted into court in Kecskemet, central Hungary, by a police convoy.",16,23,accused,3,3,6
3PKJ68EHDNXK6KNQJYU0XZTF7ARHJP,"#41-16 The four accused were escorted into court in Kecskemet, central Hungary, by a police convoy.",29,37,escorted,8,10,18
3PKJ68EHDNXK6KNQJYU0XZTF7ARHJP,"#41-16 The four accused were escorted into court in Kecskemet, central Hungary, by a police convoy.",52,61,Kecskemet,2,0,2
3PKJ68EHDNXK6KNQJYU0XZTF7ARHJP,"#41-16 The four accused were escorted into court in Kecskemet, central Hungary, by a police convoy.",63,70,central,1,0,1
3PKJ68EHDNXK6KNQJYU0XZTF7ARHJP,"#41-16 The four accused were escorted into court in Kecskemet, central Hungary, by a police convoy.",85,98,police convoy,0,1,1
3PKJ68EHDNXK6KNQJYU0XZTF7ARHJP,"#41-16 The four accused were escorted into court in Kecskemet, central Hungary, by a police convoy.",92,98,convoy,8,5,13
3PKJ68EHDNXK6KNQJYU0XZTF7ARHJP,#41-17 Reportedly the lorry traveled from Kecskemet.,7,17,Reportedly,1,1,2
3PKJ68EHDNXK6KNQJYU0XZTF7ARHJP,#41-17 Reportedly the lorry traveled from Kecskemet.,22,27,lorry,2,1,3
3PKJ68EHDNXK6KNQJYU0XZTF7ARHJP,#41-17 Reportedly the lorry traveled from Kecskemet.,28,36,traveled,0,1,1
3PKJ68EHDNXK6KNQJYU0XZTF7ARHJP,#41-17 Reportedly the lorry traveled from Kecskemet.,42,51,Kecskemet,1,1,2
3PKJ68EHDNXK6KNQJYU0XZTF7ARHJP,"#41-18 Hungary is presently building a border fence across the Serbian frontier, as migrants from war-torn Syria and other regions seek access to the Schengen Area of free movement, which covers most of the EU.",18,27,presently,2,0,2
3PKJ68EHDNXK6KNQJYU0XZTF7ARHJP,"#41-18 Hungary is presently building a border fence across the Serbian frontier, as migrants from war-torn Syria and other regions seek access to the Schengen Area of free movement, which covers most of the EU.",28,45,building a border,1,0,1
3PKJ68EHDNXK6KNQJYU0XZTF7ARHJP,"#41-18 Hungary is presently building a border fence across the Serbian frontier, as migrants from war-torn Syria and other regions seek access to the Schengen Area of free movement, which covers most of the EU.",46,51,fence,0,2,2
3PKJ68EHDNXK6KNQJYU0XZTF7ARHJP,"#41-18 Hungary is presently building a border fence across the Serbian frontier, as migrants from war-torn Syria and other regions seek access to the Schengen Area of free movement, which covers most of the EU.",63,70,Serbian,1,0,1
3PKJ68EHDNXK6KNQJYU0XZTF7ARHJP,"#41-18 Hungary is presently building a border fence across the Serbian frontier, as migrants from war-torn Syria and other regions seek access to the Schengen Area of free movement, which covers most of the EU.",63,79,Serbian frontier,1,0,1
3PKJ68EHDNXK6KNQJYU0XZTF7ARHJP,"#41-18 Hungary is presently building a border fence across the Serbian frontier, as migrants from war-torn Syria and other regions seek access to the Schengen Area of free movement, which covers most of the EU.",71,79,frontier,5,3,8
3PKJ68EHDNXK6KNQJYU0XZTF7ARHJP,"#41-18 Hungary is presently building a border fence across the Serbian frontier, as migrants from war-torn Syria and other regions seek access to the Schengen Area of free movement, which covers most of the EU.",84,92,migrants,3,1,4
3PKJ68EHDNXK6KNQJYU0XZTF7ARHJP,"#41-18 Hungary is presently building a border fence across the Serbian frontier, as migrants from war-torn Syria and other regions seek access to the Schengen Area of free movement, which covers most of the EU.",98,106,war-torn,2,0,2
3PKJ68EHDNXK6KNQJYU0XZTF7ARHJP,"#41-18 Hungary is presently building a border fence across the Serbian frontier, as migrants from war-torn Syria and other regions seek access to the Schengen Area of free movement, which covers most of the EU.",98,112,war-torn Syria,0,1,1
3PKJ68EHDNXK6KNQJYU0XZTF7ARHJP,"#41-18 Hungary is presently building a border fence across the Serbian frontier, as migrants from war-torn Syria and other regions seek access to the Schengen Area of free movement, which covers most of the EU.",136,142,access,2,0,2
3PKJ68EHDNXK6KNQJYU0XZTF7ARHJP,"#41-18 Hungary is presently building a border fence across the Serbian frontier, as migrants from war-torn Syria and other regions seek access to the Schengen Area of free movement, which covers most of the EU.",136,145,access to,0,1,1
3PKJ68EHDNXK6KNQJYU0XZTF7ARHJP,"#41-18 Hungary is presently building a border fence across the Serbian frontier, as migrants from war-torn Syria and other regions seek access to the Schengen Area of free movement, which covers most of the EU.",150,158,Schengen,2,0,2
3PKJ68EHDNXK6KNQJYU0XZTF7ARHJP,"#41-18 Hungary is presently building a border fence across the Serbian frontier, as migrants from war-torn Syria and other regions seek access to the Schengen Area of free movement, which covers most of the EU.",172,180,movement,1,2,3
3DWNFENNE3WQU8ZV4RAH3AKB2554JQ,"#39-6 The lorry is on the so-called ""Eastern Motorway"", the A4, close to the Hungarian border.",10,15,lorry,5,3,8
3DWNFENNE3WQU8ZV4RAH3AKB2554JQ,"#39-6 The lorry is on the so-called ""Eastern Motorway"", the A4, close to the Hungarian border.",26,35,so-called,1,0,1
3DWNFENNE3WQU8ZV4RAH3AKB2554JQ,"#39-6 The lorry is on the so-called ""Eastern Motorway"", the A4, close to the Hungarian border.",37,53,Eastern Motorway,0,1,1
3DWNFENNE3WQU8ZV4RAH3AKB2554JQ,"#39-6 The lorry is on the so-called ""Eastern Motorway"", the A4, close to the Hungarian border.",45,53,Motorway,1,0,1
3DWNFENNE3WQU8ZV4RAH3AKB2554JQ,"#39-6 The lorry is on the so-called ""Eastern Motorway"", the A4, close to the Hungarian border.",77,86,Hungarian,2,1,3
3DWNFENNE3WQU8ZV4RAH3AKB2554JQ,"#39-7 It was on the hard shoulder between Neusiedl and Parndorf, closer to Parndorf.",20,33,hard shoulder,1,1,2
3DWNFENNE3WQU8ZV4RAH3AKB2554JQ,"#39-7 It was on the hard shoulder between Neusiedl and Parndorf, closer to Parndorf.",42,50,Neusiedl,2,1,3
3DWNFENNE3WQU8ZV4RAH3AKB2554JQ,"#39-7 It was on the hard shoulder between Neusiedl and Parndorf, closer to Parndorf.",55,63,Parndorf,2,1,3
3DWNFENNE3WQU8ZV4RAH3AKB2554JQ,"#39-7 It was on the hard shoulder between Neusiedl and Parndorf, closer to Parndorf.",65,71,closer,0,1,1
3DWNFENNE3WQU8ZV4RAH3AKB2554JQ,#39-8 The victims are thought to have suffocated.,10,17,victims,1,2,3
3DWNFENNE3WQU8ZV4RAH3AKB2554JQ,#39-8 The victims are thought to have suffocated.,38,48,suffocated,10,9,19
3DWNFENNE3WQU8ZV4RAH3AKB2554JQ,#39-9 Police are seeking the driver.,17,24,seeking,0,3,3
3DWNFENNE3WQU8ZV4RAH3AKB2554JQ,"#39-10 The Krone published an image of a non-articulated food lorry on the hard shoulder, which they report is the vehicle in question.",11,16,Krone,0,1,1
3DWNFENNE3WQU8ZV4RAH3AKB2554JQ,"#39-10 The Krone published an image of a non-articulated food lorry on the hard shoulder, which they report is the vehicle in question.",17,26,published,3,1,4
3DWNFENNE3WQU8ZV4RAH3AKB2554JQ,"#39-10 The Krone published an image of a non-articulated food lorry on the hard shoulder, which they report is the vehicle in question.",41,56,non-articulated,10,9,19
3DWNFENNE3WQU8ZV4RAH3AKB2554JQ,"#39-10 The Krone published an image of a non-articulated food lorry on the hard shoulder, which they report is the vehicle in question.",62,67,lorry,3,1,4
3DWNFENNE3WQU8ZV4RAH3AKB2554JQ,"#39-10 The Krone published an image of a non-articulated food lorry on the hard shoulder, which they report is the vehicle in question.",75,88,hard shoulder,0,1,1
3DWNFENNE3WQU8ZV4RAH3AKB2554JQ,"#39-10 The Krone published an image of a non-articulated food lorry on the hard shoulder, which they report is the vehicle in question.",115,122,vehicle,2,0,2
3DWNFENNE3WQU8ZV4RAH3AKB2554JQ,#39-11 The photo shows a pool of dark liquid on the ground beside the vehicle.,38,44,liquid,1,0,1
3DWNFENNE3WQU8ZV4RAH3AKB2554JQ,#39-12 Video from a passing motorist shows at least one helicopter on-scene.,20,36,passing motorist,1,0,1
3DWNFENNE3WQU8ZV4RAH3AKB2554JQ,#39-12 Video from a passing motorist shows at least one helicopter on-scene.,28,36,motorist,0,3,3
3DWNFENNE3WQU8ZV4RAH3AKB2554JQ,#39-12 Video from a passing motorist shows at least one helicopter on-scene.,56,66,helicopter,4,1,5
3DWNFENNE3WQU8ZV4RAH3AKB2554JQ,#39-12 Video from a passing motorist shows at least one helicopter on-scene.,67,75,on-scene,1,2,3
3DWNFENNE3WQU8ZV4RAH3AKB2554JQ,"#39-13 The truck, which has pictures of meat on the side, shows branding for Slovakian food firm Hyza.",64,72,branding,1,6,7
3DWNFENNE3WQU8ZV4RAH3AKB2554JQ,"#39-13 The truck, which has pictures of meat on the side, shows branding for Slovakian food firm Hyza.",77,86,Slovakian,2,0,2
3DWNFENNE3WQU8ZV4RAH3AKB2554JQ,"#39-13 The truck, which has pictures of meat on the side, shows branding for Slovakian food firm Hyza.",97,101,Hyza,2,0,2
3DWNFENNE3WQU8ZV4RAH3AKB2554JQ,"#39-14 Earlier today the company's website sported an apparent anti-immigration graphic, which has since been removed.",25,41,companys website,1,0,1
3DWNFENNE3WQU8ZV4RAH3AKB2554JQ,"#39-14 Earlier today the company's website sported an apparent anti-immigration graphic, which has since been removed.",43,50,sported,1,3,4
3DWNFENNE3WQU8ZV4RAH3AKB2554JQ,"#39-14 Earlier today the company's website sported an apparent anti-immigration graphic, which has since been removed.",54,62,apparent,6,2,8
3DWNFENNE3WQU8ZV4RAH3AKB2554JQ,"#39-14 Earlier today the company's website sported an apparent anti-immigration graphic, which has since been removed.",54,79,apparent anti-immigration,2,0,2
3DWNFENNE3WQU8ZV4RAH3AKB2554JQ,"#39-14 Earlier today the company's website sported an apparent anti-immigration graphic, which has since been removed.",54,87,apparent anti-immigration graphic,0,2,2
3DWNFENNE3WQU8ZV4RAH3AKB2554JQ,"#39-14 Earlier today the company's website sported an apparent anti-immigration graphic, which has since been removed.",63,79,anti-immigration,6,4,10
3DWNFENNE3WQU8ZV4RAH3AKB2554JQ,"#39-14 Earlier today the company's website sported an apparent anti-immigration graphic, which has since been removed.",63,87,anti-immigration graphic,2,1,3
3DWNFENNE3WQU8ZV4RAH3AKB2554JQ,"#39-14 Earlier today the company's website sported an apparent anti-immigration graphic, which has since been removed.",80,87,graphic,3,2,5
3DWNFENNE3WQU8ZV4RAH3AKB2554JQ,#39-15 Wikinews got in touch with Hyza.,7,15,Wikinews,3,0,3
3EKTG13IZU4CTOC1DGMQ5JE3SLVLM4,#41-2 Their detention relates to Thursday's discovery of a lorry full of corpses in Austria.,12,21,detention,9,6,15
3EKTG13IZU4CTOC1DGMQ5JE3SLVLM4,#41-2 Their detention relates to Thursday's discovery of a lorry full of corpses in Austria.,12,29,detention relates,1,0,1
3EKTG13IZU4CTOC1DGMQ5JE3SLVLM4,#41-2 Their detention relates to Thursday's discovery of a lorry full of corpses in Austria.,22,29,relates,0,1,1
3EKTG13IZU4CTOC1DGMQ5JE3SLVLM4,#41-2 Their detention relates to Thursday's discovery of a lorry full of corpses in Austria.,44,53,discovery,2,1,3
3EKTG13IZU4CTOC1DGMQ5JE3SLVLM4,#41-2 Their detention relates to Thursday's discovery of a lorry full of corpses in Austria.,59,64,lorry,5,2,7
3EKTG13IZU4CTOC1DGMQ5JE3SLVLM4,#41-2 Their detention relates to Thursday's discovery of a lorry full of corpses in Austria.,73,80,corpses,4,10,14
3EKTG13IZU4CTOC1DGMQ5JE3SLVLM4,#41-3 The death toll was yesterday finalised at 71.,10,20,death toll,1,1,2
3EKTG13IZU4CTOC1DGMQ5JE3SLVLM4,#41-3 The death toll was yesterday finalised at 71.,16,20,toll,0,2,2
3EKTG13IZU4CTOC1DGMQ5JE3SLVLM4,#41-3 The death toll was yesterday finalised at 71.,25,34,yesterday,0,1,1
3EKTG13IZU4CTOC1DGMQ5JE3SLVLM4,#41-3 The death toll was yesterday finalised at 71.,35,44,finalised,4,0,4
3EKTG13IZU4CTOC1DGMQ5JE3SLVLM4,"#41-4 Today's hearing took place at the Palace of Justice in Kecskemet, pictured here from file.",14,21,hearing,0,3,3
3EKTG13IZU4CTOC1DGMQ5JE3SLVLM4,"#41-4 Today's hearing took place at the Palace of Justice in Kecskemet, pictured here from file.",61,70,Kecskemet,4,1,5
3EKTG13IZU4CTOC1DGMQ5JE3SLVLM4,"#41-4 Today's hearing took place at the Palace of Justice in Kecskemet, pictured here from file.",72,80,pictured,0,1,1
3EKTG13IZU4CTOC1DGMQ5JE3SLVLM4,"#41-5 The lorry had been abandoned since Wednesday on the hard shoulder of the ""Eastern Motorway"", near the Hungarian border.",10,15,lorry,3,1,4
3EKTG13IZU4CTOC1DGMQ5JE3SLVLM4,"#41-5 The lorry had been abandoned since Wednesday on the hard shoulder of the ""Eastern Motorway"", near the Hungarian border.",25,34,abandoned,6,7,13
3EKTG13IZU4CTOC1DGMQ5JE3SLVLM4,"#41-5 The lorry had been abandoned since Wednesday on the hard shoulder of the ""Eastern Motorway"", near the Hungarian border.",58,71,hard shoulder,2,1,3
3EKTG13IZU4CTOC1DGMQ5JE3SLVLM4,"#41-5 The lorry had been abandoned since Wednesday on the hard shoulder of the ""Eastern Motorway"", near the Hungarian border.",63,71,shoulder,1,1,2
3EKTG13IZU4CTOC1DGMQ5JE3SLVLM4,"#41-5 The lorry had been abandoned since Wednesday on the hard shoulder of the ""Eastern Motorway"", near the Hungarian border.",80,96,Eastern Motorway,2,1,3
3EKTG13IZU4CTOC1DGMQ5JE3SLVLM4,"#41-5 The lorry had been abandoned since Wednesday on the hard shoulder of the ""Eastern Motorway"", near the Hungarian border.",108,117,Hungarian,0,1,1
3EKTG13IZU4CTOC1DGMQ5JE3SLVLM4,"#41-6 Roadworkers became suspicious of dark liquid seeping from the vehicle, and responding police found the bodies.",6,17,Roadworkers,3,3,6
3EKTG13IZU4CTOC1DGMQ5JE3SLVLM4,"#41-6 Roadworkers became suspicious of dark liquid seeping from the vehicle, and responding police found the bodies.",25,35,suspicious,8,5,13
3EKTG13IZU4CTOC1DGMQ5JE3SLVLM4,"#41-6 Roadworkers became suspicious of dark liquid seeping from the vehicle, and responding police found the bodies.",51,58,seeping,3,4,7
3EKTG13IZU4CTOC1DGMQ5JE3SLVLM4,"#41-6 Roadworkers became suspicious of dark liquid seeping from the vehicle, and responding police found the bodies.",68,75,vehicle,1,0,1
3EKTG13IZU4CTOC1DGMQ5JE3SLVLM4,"#41-6 Roadworkers became suspicious of dark liquid seeping from the vehicle, and responding police found the bodies.",81,91,responding,1,2,3
3EKTG13IZU4CTOC1DGMQ5JE3SLVLM4,#41-7 Initial police estimates were that 20–50 were suffocated in the back of the lorry which was near Parndorf.,21,30,estimates,2,3,5
3EKTG13IZU4CTOC1DGMQ5JE3SLVLM4,#41-7 Initial police estimates were that 20–50 were suffocated in the back of the lorry which was near Parndorf.,52,62,suffocated,10,7,17
3EKTG13IZU4CTOC1DGMQ5JE3SLVLM4,#41-7 Initial police estimates were that 20–50 were suffocated in the back of the lorry which was near Parndorf.,82,87,lorry,1,1,2
3EKTG13IZU4CTOC1DGMQ5JE3SLVLM4,#41-7 Initial police estimates were that 20–50 were suffocated in the back of the lorry which was near Parndorf.,103,111,Parndorf,1,1,2
3EKTG13IZU4CTOC1DGMQ5JE3SLVLM4,#41-8 The arrested men are thought to include the vehicle's owner and at least two drivers.,10,18,arrested,2,0,2
3EKTG13IZU4CTOC1DGMQ5JE3SLVLM4,#41-9 Three are Bulgarian and one is from Afghanistan.,16,25,Bulgarian,0,1,1
3EKTG13IZU4CTOC1DGMQ5JE3SLVLM4,"#41-10 Criminal suspects in Hungary can generally be held for 72 hours before charge but prosecutors, citing the seriousness of the case, want the period extended.",7,15,Criminal,1,0,1
3EKTG13IZU4CTOC1DGMQ5JE3SLVLM4,"#41-10 Criminal suspects in Hungary can generally be held for 72 hours before charge but prosecutors, citing the seriousness of the case, want the period extended.",7,24,Criminal suspects,1,2,3
3EKTG13IZU4CTOC1DGMQ5JE3SLVLM4,"#41-10 Criminal suspects in Hungary can generally be held for 72 hours before charge but prosecutors, citing the seriousness of the case, want the period extended.",16,24,suspects,0,2,2
3EKTG13IZU4CTOC1DGMQ5JE3SLVLM4,"#41-10 Criminal suspects in Hungary can generally be held for 72 hours before charge but prosecutors, citing the seriousness of the case, want the period extended.",89,100,prosecutors,10,8,18
3EKTG13IZU4CTOC1DGMQ5JE3SLVLM4,"#41-10 Criminal suspects in Hungary can generally be held for 72 hours before charge but prosecutors, citing the seriousness of the case, want the period extended.",102,108,citing,1,1,2
3EKTG13IZU4CTOC1DGMQ5JE3SLVLM4,"#41-10 Criminal suspects in Hungary can generally be held for 72 hours before charge but prosecutors, citing the seriousness of the case, want the period extended.",113,124,seriousness,3,3,6
3EKTG13IZU4CTOC1DGMQ5JE3SLVLM4,"#41-10 Criminal suspects in Hungary can generally be held for 72 hours before charge but prosecutors, citing the seriousness of the case, want the period extended.",154,162,extended,4,1,5
35JDMRECC4AYV86NLR1RFJ4MN2IEG2,"#30-12 It was dubbed the ""gag law""((es)) or the ""gagging law"".",14,20,dubbed,6,10,16
35JDMRECC4AYV86NLR1RFJ4MN2IEG2,"#30-12 It was dubbed the ""gag law""((es)) or the ""gagging law"".",26,29,gag,1,2,3
35JDMRECC4AYV86NLR1RFJ4MN2IEG2,"#30-12 It was dubbed the ""gag law""((es)) or the ""gagging law"".",26,33,gag law,3,2,5
35JDMRECC4AYV86NLR1RFJ4MN2IEG2,"#30-12 It was dubbed the ""gag law""((es)) or the ""gagging law"".",36,38,es,1,0,1
35JDMRECC4AYV86NLR1RFJ4MN2IEG2,"#30-12 It was dubbed the ""gag law""((es)) or the ""gagging law"".",49,56,gagging,2,4,6
35JDMRECC4AYV86NLR1RFJ4MN2IEG2,"#30-12 It was dubbed the ""gag law""((es)) or the ""gagging law"".",49,60,gagging law,2,2,4
35JDMRECC4AYV86NLR1RFJ4MN2IEG2,"#30-13 The law prohibits ""the unauthorized use of images of police officers that might jeopardize their or their family's safety or that of protected facilities or police operations"".",15,24,prohibits,3,5,8
35JDMRECC4AYV86NLR1RFJ4MN2IEG2,"#30-13 The law prohibits ""the unauthorized use of images of police officers that might jeopardize their or their family's safety or that of protected facilities or police operations"".",30,42,unauthorized,8,6,14
35JDMRECC4AYV86NLR1RFJ4MN2IEG2,"#30-13 The law prohibits ""the unauthorized use of images of police officers that might jeopardize their or their family's safety or that of protected facilities or police operations"".",87,97,jeopardize,10,10,20
35JDMRECC4AYV86NLR1RFJ4MN2IEG2,"#30-13 The law prohibits ""the unauthorized use of images of police officers that might jeopardize their or their family's safety or that of protected facilities or police operations"".",140,149,protected,2,0,2
35JDMRECC4AYV86NLR1RFJ4MN2IEG2,"#30-13 The law prohibits ""the unauthorized use of images of police officers that might jeopardize their or their family's safety or that of protected facilities or police operations"".",150,160,facilities,4,1,5
35JDMRECC4AYV86NLR1RFJ4MN2IEG2,"#30-13 The law prohibits ""the unauthorized use of images of police officers that might jeopardize their or their family's safety or that of protected facilities or police operations"".",171,181,operations,2,0,2
35JDMRECC4AYV86NLR1RFJ4MN2IEG2,"#30-14 Judge Joaquim Bosch, Judges for Democracy spokesperson, said: ""It is not a law for citizens' security, but a law for the government to avoid citizens’ protests.",13,26,Joaquim Bosch,1,1,2
35JDMRECC4AYV86NLR1RFJ4MN2IEG2,"#30-14 Judge Joaquim Bosch, Judges for Democracy spokesperson, said: ""It is not a law for citizens' security, but a law for the government to avoid citizens’ protests.",39,61,Democracy spokesperson,0,1,1
35JDMRECC4AYV86NLR1RFJ4MN2IEG2,"#30-14 Judge Joaquim Bosch, Judges for Democracy spokesperson, said: ""It is not a law for citizens' security, but a law for the government to avoid citizens’ protests.",49,61,spokesperson,1,2,3
35JDMRECC4AYV86NLR1RFJ4MN2IEG2,"#30-14 Judge Joaquim Bosch, Judges for Democracy spokesperson, said: ""It is not a law for citizens' security, but a law for the government to avoid citizens’ protests.",90,98,citizens,1,0,1
35JDMRECC4AYV86NLR1RFJ4MN2IEG2,"#30-14 Judge Joaquim Bosch, Judges for Democracy spokesperson, said: ""It is not a law for citizens' security, but a law for the government to avoid citizens’ protests.",90,107,citizens security,1,0,1
35JDMRECC4AYV86NLR1RFJ4MN2IEG2,"#30-14 Judge Joaquim Bosch, Judges for Democracy spokesperson, said: ""It is not a law for citizens' security, but a law for the government to avoid citizens’ protests.",158,166,protests,1,2,3
35JDMRECC4AYV86NLR1RFJ4MN2IEG2,"#30-15 All opinion polls indicate that the Spanish society is not at all preoccupied by security but by the economic situation and political corruption.""",25,42,indicate that the,0,1,1
35JDMRECC4AYV86NLR1RFJ4MN2IEG2,"#30-15 All opinion polls indicate that the Spanish society is not at all preoccupied by security but by the economic situation and political corruption.""",73,84,preoccupied,8,6,14
35JDMRECC4AYV86NLR1RFJ4MN2IEG2,"#30-15 All opinion polls indicate that the Spanish society is not at all preoccupied by security but by the economic situation and political corruption.""",108,126,economic situation,1,1,2
35JDMRECC4AYV86NLR1RFJ4MN2IEG2,"#30-15 All opinion polls indicate that the Spanish society is not at all preoccupied by security but by the economic situation and political corruption.""",131,151,political corruption,2,0,2
35JDMRECC4AYV86NLR1RFJ4MN2IEG2,"#30-15 All opinion polls indicate that the Spanish society is not at all preoccupied by security but by the economic situation and political corruption.""",141,151,corruption,5,2,7
35JDMRECC4AYV86NLR1RFJ4MN2IEG2,"#30-16 Amnesty International condemned the law in a report: ""With threats of fines or threats of being beaten, the government is trying to stigmatize and criminalize people who are just practicing their rights.""",7,28,Amnesty International,1,0,1
35JDMRECC4AYV86NLR1RFJ4MN2IEG2,"#30-16 Amnesty International condemned the law in a report: ""With threats of fines or threats of being beaten, the government is trying to stigmatize and criminalize people who are just practicing their rights.""",15,38,International condemned,1,0,1
35JDMRECC4AYV86NLR1RFJ4MN2IEG2,"#30-16 Amnesty International condemned the law in a report: ""With threats of fines or threats of being beaten, the government is trying to stigmatize and criminalize people who are just practicing their rights.""",29,38,condemned,6,6,12
35JDMRECC4AYV86NLR1RFJ4MN2IEG2,"#30-16 Amnesty International condemned the law in a report: ""With threats of fines or threats of being beaten, the government is trying to stigmatize and criminalize people who are just practicing their rights.""",66,73,threats,1,1,2
35JDMRECC4AYV86NLR1RFJ4MN2IEG2,"#30-16 Amnesty International condemned the law in a report: ""With threats of fines or threats of being beaten, the government is trying to stigmatize and criminalize people who are just practicing their rights.""",136,149,to stigmatize,1,0,1
35JDMRECC4AYV86NLR1RFJ4MN2IEG2,"#30-16 Amnesty International condemned the law in a report: ""With threats of fines or threats of being beaten, the government is trying to stigmatize and criminalize people who are just practicing their rights.""",139,149,stigmatize,10,10,20
35JDMRECC4AYV86NLR1RFJ4MN2IEG2,"#30-16 Amnesty International condemned the law in a report: ""With threats of fines or threats of being beaten, the government is trying to stigmatize and criminalize people who are just practicing their rights.""",139,165,stigmatize and criminalize,1,0,1
35JDMRECC4AYV86NLR1RFJ4MN2IEG2,"#30-16 Amnesty International condemned the law in a report: ""With threats of fines or threats of being beaten, the government is trying to stigmatize and criminalize people who are just practicing their rights.""",154,165,criminalize,10,2,12
35JDMRECC4AYV86NLR1RFJ4MN2IEG2,"#30-17 Virginia Álvarez, who wrote the report, noted, ""instead of listening to their demands, instead of starting a dialogue, authorities are doing everything they can to impede people from protesting"".",7,23,Virginia Álvarez,1,0,1
35JDMRECC4AYV86NLR1RFJ4MN2IEG2,"#30-17 Virginia Álvarez, who wrote the report, noted, ""instead of listening to their demands, instead of starting a dialogue, authorities are doing everything they can to impede people from protesting"".",55,92,instead of listening to their demands,0,1,1
35JDMRECC4AYV86NLR1RFJ4MN2IEG2,"#30-17 Virginia Álvarez, who wrote the report, noted, ""instead of listening to their demands, instead of starting a dialogue, authorities are doing everything they can to impede people from protesting"".",116,124,dialogue,4,2,6
35JDMRECC4AYV86NLR1RFJ4MN2IEG2,"#30-17 Virginia Álvarez, who wrote the report, noted, ""instead of listening to their demands, instead of starting a dialogue, authorities are doing everything they can to impede people from protesting"".",126,137,authorities,1,0,1
35JDMRECC4AYV86NLR1RFJ4MN2IEG2,"#30-17 Virginia Álvarez, who wrote the report, noted, ""instead of listening to their demands, instead of starting a dialogue, authorities are doing everything they can to impede people from protesting"".",171,177,impede,8,8,16
35JDMRECC4AYV86NLR1RFJ4MN2IEG2,"#30-17 Virginia Álvarez, who wrote the report, noted, ""instead of listening to their demands, instead of starting a dialogue, authorities are doing everything they can to impede people from protesting"".",171,200,impede people from protesting,1,0,1
35JDMRECC4AYV86NLR1RFJ4MN2IEG2,"#30-17 Virginia Álvarez, who wrote the report, noted, ""instead of listening to their demands, instead of starting a dialogue, authorities are doing everything they can to impede people from protesting"".",190,200,protesting,1,0,1
3IYI9285WS1TPCCAX6GZM8WZUIMJCI,#38-4 Around fifteen shots were reported fired.,21,26,shots,0,1,1
3IYI9285WS1TPCCAX6GZM8WZUIMJCI,#38-4 Around fifteen shots were reported fired.,32,40,reported,1,2,3
3IYI9285WS1TPCCAX6GZM8WZUIMJCI,"#38-5 Parker and Ward were killed, while the interviewee, Vicki Gardner, was transported to hospital and underwent surgery for her injuries, later listed in stable condition.",45,56,interviewee,10,9,19
3IYI9285WS1TPCCAX6GZM8WZUIMJCI,"#38-5 Parker and Ward were killed, while the interviewee, Vicki Gardner, was transported to hospital and underwent surgery for her injuries, later listed in stable condition.",58,71,Vicki Gardner,0,1,1
3IYI9285WS1TPCCAX6GZM8WZUIMJCI,"#38-5 Parker and Ward were killed, while the interviewee, Vicki Gardner, was transported to hospital and underwent surgery for her injuries, later listed in stable condition.",77,88,transported,3,2,5
3IYI9285WS1TPCCAX6GZM8WZUIMJCI,"#38-5 Parker and Ward were killed, while the interviewee, Vicki Gardner, was transported to hospital and underwent surgery for her injuries, later listed in stable condition.",105,114,underwent,4,7,11
3IYI9285WS1TPCCAX6GZM8WZUIMJCI,"#38-5 Parker and Ward were killed, while the interviewee, Vicki Gardner, was transported to hospital and underwent surgery for her injuries, later listed in stable condition.",105,122,underwent surgery,1,2,3
3IYI9285WS1TPCCAX6GZM8WZUIMJCI,"#38-5 Parker and Ward were killed, while the interviewee, Vicki Gardner, was transported to hospital and underwent surgery for her injuries, later listed in stable condition.",115,122,surgery,1,1,2
3IYI9285WS1TPCCAX6GZM8WZUIMJCI,"#38-5 Parker and Ward were killed, while the interviewee, Vicki Gardner, was transported to hospital and underwent surgery for her injuries, later listed in stable condition.",131,139,injuries,1,1,2
3IYI9285WS1TPCCAX6GZM8WZUIMJCI,"#38-5 Parker and Ward were killed, while the interviewee, Vicki Gardner, was transported to hospital and underwent surgery for her injuries, later listed in stable condition.",157,163,stable,1,1,2
3IYI9285WS1TPCCAX6GZM8WZUIMJCI,"#38-5 Parker and Ward were killed, while the interviewee, Vicki Gardner, was transported to hospital and underwent surgery for her injuries, later listed in stable condition.",157,173,stable condition,0,2,2
3IYI9285WS1TPCCAX6GZM8WZUIMJCI,"#38-6 The gunman, later identified as 41 year-old Vester Lee Flanagan II, fled the scene.",10,16,gunman,0,1,1
3IYI9285WS1TPCCAX6GZM8WZUIMJCI,"#38-6 The gunman, later identified as 41 year-old Vester Lee Flanagan II, fled the scene.",24,34,identified,1,1,2
3IYI9285WS1TPCCAX6GZM8WZUIMJCI,"#38-6 The gunman, later identified as 41 year-old Vester Lee Flanagan II, fled the scene.",50,69,Vester Lee Flanagan,0,1,1
3IYI9285WS1TPCCAX6GZM8WZUIMJCI,"#38-6 The gunman, later identified as 41 year-old Vester Lee Flanagan II, fled the scene.",74,78,fled,0,5,5
3IYI9285WS1TPCCAX6GZM8WZUIMJCI,"#38-6 The gunman, later identified as 41 year-old Vester Lee Flanagan II, fled the scene.",83,88,scene,0,1,1
3IYI9285WS1TPCCAX6GZM8WZUIMJCI,#38-7 A brief police chase ensued several hours later when law enforcement attempted unsuccessfully to pull Flanagan over on Interstate 66 in Fauquier County.,8,13,brief,0,1,1
3IYI9285WS1TPCCAX6GZM8WZUIMJCI,#38-7 A brief police chase ensued several hours later when law enforcement attempted unsuccessfully to pull Flanagan over on Interstate 66 in Fauquier County.,21,26,chase,0,3,3
3IYI9285WS1TPCCAX6GZM8WZUIMJCI,#38-7 A brief police chase ensued several hours later when law enforcement attempted unsuccessfully to pull Flanagan over on Interstate 66 in Fauquier County.,27,33,ensued,9,10,19
3IYI9285WS1TPCCAX6GZM8WZUIMJCI,#38-7 A brief police chase ensued several hours later when law enforcement attempted unsuccessfully to pull Flanagan over on Interstate 66 in Fauquier County.,59,74,law enforcement,1,3,4
3IYI9285WS1TPCCAX6GZM8WZUIMJCI,#38-7 A brief police chase ensued several hours later when law enforcement attempted unsuccessfully to pull Flanagan over on Interstate 66 in Fauquier County.,63,74,enforcement,8,3,11
3IYI9285WS1TPCCAX6GZM8WZUIMJCI,#38-7 A brief police chase ensued several hours later when law enforcement attempted unsuccessfully to pull Flanagan over on Interstate 66 in Fauquier County.,63,84,enforcement attempted,1,1,2
3IYI9285WS1TPCCAX6GZM8WZUIMJCI,#38-7 A brief police chase ensued several hours later when law enforcement attempted unsuccessfully to pull Flanagan over on Interstate 66 in Fauquier County.,75,84,attempted,1,2,3
3IYI9285WS1TPCCAX6GZM8WZUIMJCI,#38-7 A brief police chase ensued several hours later when law enforcement attempted unsuccessfully to pull Flanagan over on Interstate 66 in Fauquier County.,85,99,unsuccessfully,6,2,8
3IYI9285WS1TPCCAX6GZM8WZUIMJCI,#38-7 A brief police chase ensued several hours later when law enforcement attempted unsuccessfully to pull Flanagan over on Interstate 66 in Fauquier County.,108,116,Flanagan,2,0,2
3IYI9285WS1TPCCAX6GZM8WZUIMJCI,#38-7 A brief police chase ensued several hours later when law enforcement attempted unsuccessfully to pull Flanagan over on Interstate 66 in Fauquier County.,125,135,Interstate,1,2,3
3IYI9285WS1TPCCAX6GZM8WZUIMJCI,#38-7 A brief police chase ensued several hours later when law enforcement attempted unsuccessfully to pull Flanagan over on Interstate 66 in Fauquier County.,142,150,Fauquier,2,0,2
3IYI9285WS1TPCCAX6GZM8WZUIMJCI,"#38-8 Shortly after, Flanagan pulled off the road and shot himself.",30,40,pulled off,1,0,1
3IYI9285WS1TPCCAX6GZM8WZUIMJCI,#38-9 He was pronounced dead at a Fairfax-area hospital around 1:30 PM local time (1730 UTC).,13,23,pronounced,8,7,15
3IYI9285WS1TPCCAX6GZM8WZUIMJCI,#38-9 He was pronounced dead at a Fairfax-area hospital around 1:30 PM local time (1730 UTC).,34,46,Fairfax-area,1,1,2
3IYI9285WS1TPCCAX6GZM8WZUIMJCI,"#38-10 Flanagan, who reported under the alias ""Bryce Williams"", was fired by the station in 2013.",21,29,reported,0,1,1
3IYI9285WS1TPCCAX6GZM8WZUIMJCI,"#38-10 Flanagan, who reported under the alias ""Bryce Williams"", was fired by the station in 2013.",40,45,alias,5,1,6
3IYI9285WS1TPCCAX6GZM8WZUIMJCI,"#38-10 Flanagan, who reported under the alias ""Bryce Williams"", was fired by the station in 2013.",47,61,Bryce Williams,0,1,1
3IYI9285WS1TPCCAX6GZM8WZUIMJCI,"#38-11 According to WDBJ president and general manager Jeffrey Marks, speaking to CBS News, Flanagan was ""an unhappy man"" and ""difficult to work with"".",20,24,WDBJ,1,0,1
3IYI9285WS1TPCCAX6GZM8WZUIMJCI,"#38-11 According to WDBJ president and general manager Jeffrey Marks, speaking to CBS News, Flanagan was ""an unhappy man"" and ""difficult to work with"".",92,100,Flanagan,0,1,1
3IYI9285WS1TPCCAX6GZM8WZUIMJCI,"#38-11 According to WDBJ president and general manager Jeffrey Marks, speaking to CBS News, Flanagan was ""an unhappy man"" and ""difficult to work with"".",127,136,difficult,1,1,2
3PMR2DOWOO2IN9KAFP6N2016K4A454,"#21-4 Cquote2.svg This is the first F1 race-related driver death since the 1994 San Marino Grand Prix, when Ayrton Senna was killed.",39,51,race-related,2,3,5
3PMR2DOWOO2IN9KAFP6N2016K4A454,"#21-4 Cquote2.svg This is the first F1 race-related driver death since the 1994 San Marino Grand Prix, when Ayrton Senna was killed.",39,64,race-related driver death,1,0,1
3PMR2DOWOO2IN9KAFP6N2016K4A454,"#21-4 Cquote2.svg This is the first F1 race-related driver death since the 1994 San Marino Grand Prix, when Ayrton Senna was killed.",84,101,Marino Grand Prix,0,1,1
3PMR2DOWOO2IN9KAFP6N2016K4A454,"#21-4 Cquote2.svg This is the first F1 race-related driver death since the 1994 San Marino Grand Prix, when Ayrton Senna was killed.",91,101,Grand Prix,1,0,1
3PMR2DOWOO2IN9KAFP6N2016K4A454,"#21-4 Cquote2.svg This is the first F1 race-related driver death since the 1994 San Marino Grand Prix, when Ayrton Senna was killed.",108,114,Ayrton,1,1,2
3PMR2DOWOO2IN9KAFP6N2016K4A454,"#21-5 On October 5, 2014, at the late portion of the Japanese Grand Prix at Suzuka Circuit, Bianchi collided with a tractor crane that had been attending to the crashed car of Adrian Sutil.",33,45,late portion,1,3,4
3PMR2DOWOO2IN9KAFP6N2016K4A454,"#21-5 On October 5, 2014, at the late portion of the Japanese Grand Prix at Suzuka Circuit, Bianchi collided with a tractor crane that had been attending to the crashed car of Adrian Sutil.",38,45,portion,2,0,2
3PMR2DOWOO2IN9KAFP6N2016K4A454,"#21-5 On October 5, 2014, at the late portion of the Japanese Grand Prix at Suzuka Circuit, Bianchi collided with a tractor crane that had been attending to the crashed car of Adrian Sutil.",62,72,Grand Prix,0,1,1
3PMR2DOWOO2IN9KAFP6N2016K4A454,"#21-5 On October 5, 2014, at the late portion of the Japanese Grand Prix at Suzuka Circuit, Bianchi collided with a tractor crane that had been attending to the crashed car of Adrian Sutil.",76,82,Suzuka,0,1,1
3PMR2DOWOO2IN9KAFP6N2016K4A454,"#21-5 On October 5, 2014, at the late portion of the Japanese Grand Prix at Suzuka Circuit, Bianchi collided with a tractor crane that had been attending to the crashed car of Adrian Sutil.",83,90,Circuit,2,0,2
3PMR2DOWOO2IN9KAFP6N2016K4A454,"#21-5 On October 5, 2014, at the late portion of the Japanese Grand Prix at Suzuka Circuit, Bianchi collided with a tractor crane that had been attending to the crashed car of Adrian Sutil.",92,99,Bianchi,1,0,1
3PMR2DOWOO2IN9KAFP6N2016K4A454,"#21-5 On October 5, 2014, at the late portion of the Japanese Grand Prix at Suzuka Circuit, Bianchi collided with a tractor crane that had been attending to the crashed car of Adrian Sutil.",92,108,Bianchi collided,0,1,1
3PMR2DOWOO2IN9KAFP6N2016K4A454,"#21-5 On October 5, 2014, at the late portion of the Japanese Grand Prix at Suzuka Circuit, Bianchi collided with a tractor crane that had been attending to the crashed car of Adrian Sutil.",100,108,collided,9,8,17
3PMR2DOWOO2IN9KAFP6N2016K4A454,"#21-5 On October 5, 2014, at the late portion of the Japanese Grand Prix at Suzuka Circuit, Bianchi collided with a tractor crane that had been attending to the crashed car of Adrian Sutil.",116,129,tractor crane,1,0,1
3PMR2DOWOO2IN9KAFP6N2016K4A454,"#21-5 On October 5, 2014, at the late portion of the Japanese Grand Prix at Suzuka Circuit, Bianchi collided with a tractor crane that had been attending to the crashed car of Adrian Sutil.",124,129,crane,0,2,2
3PMR2DOWOO2IN9KAFP6N2016K4A454,"#21-5 On October 5, 2014, at the late portion of the Japanese Grand Prix at Suzuka Circuit, Bianchi collided with a tractor crane that had been attending to the crashed car of Adrian Sutil.",144,153,attending,1,0,1
3PMR2DOWOO2IN9KAFP6N2016K4A454,"#21-5 On October 5, 2014, at the late portion of the Japanese Grand Prix at Suzuka Circuit, Bianchi collided with a tractor crane that had been attending to the crashed car of Adrian Sutil.",161,168,crashed,0,2,2
3PMR2DOWOO2IN9KAFP6N2016K4A454,"#21-6 Bianchi's helmet became wedged underneath the tractor, causing a diffuse axonal injury, and he fell into a coma.",6,14,Bianchis,0,1,1
3PMR2DOWOO2IN9KAFP6N2016K4A454,"#21-6 Bianchi's helmet became wedged underneath the tractor, causing a diffuse axonal injury, and he fell into a coma.",30,36,wedged,5,10,15
3PMR2DOWOO2IN9KAFP6N2016K4A454,"#21-6 Bianchi's helmet became wedged underneath the tractor, causing a diffuse axonal injury, and he fell into a coma.",30,47,wedged underneath,1,3,4
3PMR2DOWOO2IN9KAFP6N2016K4A454,"#21-6 Bianchi's helmet became wedged underneath the tractor, causing a diffuse axonal injury, and he fell into a coma.",37,47,underneath,0,3,3
3PMR2DOWOO2IN9KAFP6N2016K4A454,"#21-6 Bianchi's helmet became wedged underneath the tractor, causing a diffuse axonal injury, and he fell into a coma.",71,78,diffuse,6,2,8
3PMR2DOWOO2IN9KAFP6N2016K4A454,"#21-6 Bianchi's helmet became wedged underneath the tractor, causing a diffuse axonal injury, and he fell into a coma.",71,85,diffuse axonal,2,0,2
3PMR2DOWOO2IN9KAFP6N2016K4A454,"#21-6 Bianchi's helmet became wedged underneath the tractor, causing a diffuse axonal injury, and he fell into a coma.",71,92,diffuse axonal injury,5,5,10
3PMR2DOWOO2IN9KAFP6N2016K4A454,"#21-6 Bianchi's helmet became wedged underneath the tractor, causing a diffuse axonal injury, and he fell into a coma.",79,85,axonal,5,5,10
3PMR2DOWOO2IN9KAFP6N2016K4A454,"#21-6 Bianchi's helmet became wedged underneath the tractor, causing a diffuse axonal injury, and he fell into a coma.",79,92,axonal injury,1,1,2
3PMR2DOWOO2IN9KAFP6N2016K4A454,"#21-6 Bianchi's helmet became wedged underneath the tractor, causing a diffuse axonal injury, and he fell into a coma.",86,92,injury,3,0,3
3PMR2DOWOO2IN9KAFP6N2016K4A454,"#21-6 Bianchi's helmet became wedged underneath the tractor, causing a diffuse axonal injury, and he fell into a coma.",113,117,coma,4,5,9
3PMR2DOWOO2IN9KAFP6N2016K4A454,"#21-7 After being treated at a Japanese medical centre, he was moved about two months after the accident to a hospital in Nice.",96,104,accident,1,0,1
3PMR2DOWOO2IN9KAFP6N2016K4A454,"#21-8 Placed in the intensive care unit, in December he began rehabilitation therapy.",20,29,intensive,2,3,5
3PMR2DOWOO2IN9KAFP6N2016K4A454,"#21-8 Placed in the intensive care unit, in December he began rehabilitation therapy.",20,39,intensive care unit,1,1,2
3PMR2DOWOO2IN9KAFP6N2016K4A454,"#21-8 Placed in the intensive care unit, in December he began rehabilitation therapy.",62,76,rehabilitation,9,6,15
3PMR2DOWOO2IN9KAFP6N2016K4A454,"#21-8 Placed in the intensive care unit, in December he began rehabilitation therapy.",62,84,rehabilitation therapy,2,4,6
3PMR2DOWOO2IN9KAFP6N2016K4A454,"#21-8 Placed in the intensive care unit, in December he began rehabilitation therapy.",77,84,therapy,0,1,1
3PMR2DOWOO2IN9KAFP6N2016K4A454,"#21-9 Bianchi's father, Philippe, described his non-progress as a ""daily torture"".",24,32,Philippe,0,1,1
3PMR2DOWOO2IN9KAFP6N2016K4A454,"#21-9 Bianchi's father, Philippe, described his non-progress as a ""daily torture"".",34,43,described,1,0,1
3PMR2DOWOO2IN9KAFP6N2016K4A454,"#21-9 Bianchi's father, Philippe, described his non-progress as a ""daily torture"".",48,60,non-progress,2,2,4
3PMR2DOWOO2IN9KAFP6N2016K4A454,"#21-9 Bianchi's father, Philippe, described his non-progress as a ""daily torture"".",67,80,daily torture,2,3,5
3PMR2DOWOO2IN9KAFP6N2016K4A454,"#21-9 Bianchi's father, Philippe, described his non-progress as a ""daily torture"".",73,80,torture,4,2,6
3PMR2DOWOO2IN9KAFP6N2016K4A454,"#21-10 Bianchi, the 2007 French Formula Renault and 2009 Formula 3 Euro Series champion, was the inaugural member of the Ferrari Driver Academy.",40,47,Renault,0,1,1
3PMR2DOWOO2IN9KAFP6N2016K4A454,"#21-10 Bianchi, the 2007 French Formula Renault and 2009 Formula 3 Euro Series champion, was the inaugural member of the Ferrari Driver Academy.",97,106,inaugural,8,4,12
3PMR2DOWOO2IN9KAFP6N2016K4A454,"#21-10 Bianchi, the 2007 French Formula Renault and 2009 Formula 3 Euro Series champion, was the inaugural member of the Ferrari Driver Academy.",97,113,inaugural member,3,1,4
3PMR2DOWOO2IN9KAFP6N2016K4A454,"#21-10 Bianchi, the 2007 French Formula Renault and 2009 Formula 3 Euro Series champion, was the inaugural member of the Ferrari Driver Academy.",121,128,Ferrari,0,1,1
3WYZV0QBFJEBARPT0AZ52XYWNV1BXR,#3-3 The 32-year-old artist has been charged on several occasions.,37,44,charged,1,4,5
3WYZV0QBFJEBARPT0AZ52XYWNV1BXR,#3-3 The 32-year-old artist has been charged on several occasions.,56,65,occasions,5,2,7
3WYZV0QBFJEBARPT0AZ52XYWNV1BXR,"#3-4 In the November 2015, Pavlensky set Russia's Federal Security Service's headquarters' door on fire in Moscow.",27,36,Pavlensky,1,2,3
3WYZV0QBFJEBARPT0AZ52XYWNV1BXR,"#3-4 In the November 2015, Pavlensky set Russia's Federal Security Service's headquarters' door on fire in Moscow.",41,48,Russias,0,1,1
3WYZV0QBFJEBARPT0AZ52XYWNV1BXR,"#3-4 In the November 2015, Pavlensky set Russia's Federal Security Service's headquarters' door on fire in Moscow.",50,57,Federal,1,0,1
3WYZV0QBFJEBARPT0AZ52XYWNV1BXR,"#3-4 In the November 2015, Pavlensky set Russia's Federal Security Service's headquarters' door on fire in Moscow.",50,74,Federal Security Service,1,0,1
3WYZV0QBFJEBARPT0AZ52XYWNV1BXR,"#3-4 In the November 2015, Pavlensky set Russia's Federal Security Service's headquarters' door on fire in Moscow.",77,89,headquarters,5,1,6
3WYZV0QBFJEBARPT0AZ52XYWNV1BXR,"#3-5 Pavlensky called this an artwork named ""Threat"" and was sentenced to a prison term for vandalism.",5,14,Pavlensky,0,1,1
3WYZV0QBFJEBARPT0AZ52XYWNV1BXR,"#3-5 Pavlensky called this an artwork named ""Threat"" and was sentenced to a prison term for vandalism.",30,37,artwork,1,1,2
3WYZV0QBFJEBARPT0AZ52XYWNV1BXR,"#3-5 Pavlensky called this an artwork named ""Threat"" and was sentenced to a prison term for vandalism.",45,51,Threat,3,3,6
3WYZV0QBFJEBARPT0AZ52XYWNV1BXR,"#3-5 Pavlensky called this an artwork named ""Threat"" and was sentenced to a prison term for vandalism.",61,70,sentenced,2,3,5
3WYZV0QBFJEBARPT0AZ52XYWNV1BXR,"#3-5 Pavlensky called this an artwork named ""Threat"" and was sentenced to a prison term for vandalism.",76,82,prison,0,1,1
3WYZV0QBFJEBARPT0AZ52XYWNV1BXR,"#3-5 Pavlensky called this an artwork named ""Threat"" and was sentenced to a prison term for vandalism.",83,87,term,0,1,1
3WYZV0QBFJEBARPT0AZ52XYWNV1BXR,"#3-5 Pavlensky called this an artwork named ""Threat"" and was sentenced to a prison term for vandalism.",92,101,vandalism,10,10,20
3WYZV0QBFJEBARPT0AZ52XYWNV1BXR,"#3-6 He was released seven months later, in June.",12,20,released,0,1,1
3WYZV0QBFJEBARPT0AZ52XYWNV1BXR,"#3-7 Anastasia Slonina, an actress working in a theatre in Moscow called Teatr.doc, known for liberal plays, filed rape charges on Pavlensky and his partner Oksana.",5,22,Anastasia Slonina,0,1,1
3WYZV0QBFJEBARPT0AZ52XYWNV1BXR,"#3-7 Anastasia Slonina, an actress working in a theatre in Moscow called Teatr.doc, known for liberal plays, filed rape charges on Pavlensky and his partner Oksana.",27,34,actress,1,0,1
3WYZV0QBFJEBARPT0AZ52XYWNV1BXR,"#3-7 Anastasia Slonina, an actress working in a theatre in Moscow called Teatr.doc, known for liberal plays, filed rape charges on Pavlensky and his partner Oksana.",48,55,theatre,1,0,1
3WYZV0QBFJEBARPT0AZ52XYWNV1BXR,"#3-7 Anastasia Slonina, an actress working in a theatre in Moscow called Teatr.doc, known for liberal plays, filed rape charges on Pavlensky and his partner Oksana.",73,78,Teatr,0,1,1
3WYZV0QBFJEBARPT0AZ52XYWNV1BXR,"#3-7 Anastasia Slonina, an actress working in a theatre in Moscow called Teatr.doc, known for liberal plays, filed rape charges on Pavlensky and his partner Oksana.",73,82,Teatr.doc,0,1,1
3WYZV0QBFJEBARPT0AZ52XYWNV1BXR,"#3-7 Anastasia Slonina, an actress working in a theatre in Moscow called Teatr.doc, known for liberal plays, filed rape charges on Pavlensky and his partner Oksana.",94,101,liberal,7,2,9
3WYZV0QBFJEBARPT0AZ52XYWNV1BXR,"#3-7 Anastasia Slonina, an actress working in a theatre in Moscow called Teatr.doc, known for liberal plays, filed rape charges on Pavlensky and his partner Oksana.",94,107,liberal plays,0,1,1
3WYZV0QBFJEBARPT0AZ52XYWNV1BXR,"#3-7 Anastasia Slonina, an actress working in a theatre in Moscow called Teatr.doc, known for liberal plays, filed rape charges on Pavlensky and his partner Oksana.",109,114,filed,0,1,1
3WYZV0QBFJEBARPT0AZ52XYWNV1BXR,"#3-7 Anastasia Slonina, an actress working in a theatre in Moscow called Teatr.doc, known for liberal plays, filed rape charges on Pavlensky and his partner Oksana.",109,127,filed rape charges,0,1,1
3WYZV0QBFJEBARPT0AZ52XYWNV1BXR,"#3-7 Anastasia Slonina, an actress working in a theatre in Moscow called Teatr.doc, known for liberal plays, filed rape charges on Pavlensky and his partner Oksana.",115,119,rape,1,1,2
3WYZV0QBFJEBARPT0AZ52XYWNV1BXR,"#3-7 Anastasia Slonina, an actress working in a theatre in Moscow called Teatr.doc, known for liberal plays, filed rape charges on Pavlensky and his partner Oksana.",120,127,charges,0,1,1
3WYZV0QBFJEBARPT0AZ52XYWNV1BXR,"#3-7 Anastasia Slonina, an actress working in a theatre in Moscow called Teatr.doc, known for liberal plays, filed rape charges on Pavlensky and his partner Oksana.",131,140,Pavlensky,0,1,1
3WYZV0QBFJEBARPT0AZ52XYWNV1BXR,"#3-7 Anastasia Slonina, an actress working in a theatre in Moscow called Teatr.doc, known for liberal plays, filed rape charges on Pavlensky and his partner Oksana.",157,163,Oksana,0,3,3
3WYZV0QBFJEBARPT0AZ52XYWNV1BXR,#3-8 The theatre claims to have a CCTV video footage of Pavlensky and other men beating Slonina's boyfriend in the parking lot on October 31.,17,23,claims,1,1,2
3WYZV0QBFJEBARPT0AZ52XYWNV1BXR,#3-8 The theatre claims to have a CCTV video footage of Pavlensky and other men beating Slonina's boyfriend in the parking lot on October 31.,34,52,CCTV video footage,1,0,1
3WYZV0QBFJEBARPT0AZ52XYWNV1BXR,#3-8 The theatre claims to have a CCTV video footage of Pavlensky and other men beating Slonina's boyfriend in the parking lot on October 31.,39,52,video footage,1,1,2
3WYZV0QBFJEBARPT0AZ52XYWNV1BXR,#3-8 The theatre claims to have a CCTV video footage of Pavlensky and other men beating Slonina's boyfriend in the parking lot on October 31.,45,52,footage,2,4,6
3WYZV0QBFJEBARPT0AZ52XYWNV1BXR,#3-8 The theatre claims to have a CCTV video footage of Pavlensky and other men beating Slonina's boyfriend in the parking lot on October 31.,56,65,Pavlensky,0,1,1
3WYZV0QBFJEBARPT0AZ52XYWNV1BXR,#3-8 The theatre claims to have a CCTV video footage of Pavlensky and other men beating Slonina's boyfriend in the parking lot on October 31.,80,87,beating,0,1,1
3WYZV0QBFJEBARPT0AZ52XYWNV1BXR,#3-8 The theatre claims to have a CCTV video footage of Pavlensky and other men beating Slonina's boyfriend in the parking lot on October 31.,88,95,Slonina,1,0,1
3WYZV0QBFJEBARPT0AZ52XYWNV1BXR,#3-8 The theatre claims to have a CCTV video footage of Pavlensky and other men beating Slonina's boyfriend in the parking lot on October 31.,88,96,Sloninas,0,1,1
3WYZV0QBFJEBARPT0AZ52XYWNV1BXR,#3-9 Pavlensky said he does not appear in the video.,32,38,appear,0,1,1
3WYZV0QBFJEBARPT0AZ52XYWNV1BXR,"#3-10 Pavlensky and Oksana were detained in December at Sheremetyevo airport for questioning, which went on for seven hours.",32,40,detained,10,8,18
3WYZV0QBFJEBARPT0AZ52XYWNV1BXR,"#3-10 Pavlensky and Oksana were detained in December at Sheremetyevo airport for questioning, which went on for seven hours.",56,68,Sheremetyevo,2,3,5
3WYZV0QBFJEBARPT0AZ52XYWNV1BXR,"#3-10 Pavlensky and Oksana were detained in December at Sheremetyevo airport for questioning, which went on for seven hours.",81,92,questioning,4,2,6
39I4RL8QGJIU3245GR7WRX4WPD14HL,"#36-7 The following day, Indianapolis Motor Speedway president Doug Boles and Hulman & Company Mark Miles officially announced Wilson's death.",25,37,Indianapolis,0,1,1
39I4RL8QGJIU3245GR7WRX4WPD14HL,"#36-7 The following day, Indianapolis Motor Speedway president Doug Boles and Hulman & Company Mark Miles officially announced Wilson's death.",25,52,Indianapolis Motor Speedway,1,0,1
39I4RL8QGJIU3245GR7WRX4WPD14HL,"#36-7 The following day, Indianapolis Motor Speedway president Doug Boles and Hulman & Company Mark Miles officially announced Wilson's death.",63,73,Doug Boles,0,1,1
39I4RL8QGJIU3245GR7WRX4WPD14HL,"#36-7 The following day, Indianapolis Motor Speedway president Doug Boles and Hulman & Company Mark Miles officially announced Wilson's death.",78,84,Hulman,0,1,1
39I4RL8QGJIU3245GR7WRX4WPD14HL,"#36-7 The following day, Indianapolis Motor Speedway president Doug Boles and Hulman & Company Mark Miles officially announced Wilson's death.",95,105,Mark Miles,0,1,1
39I4RL8QGJIU3245GR7WRX4WPD14HL,"#36-7 The following day, Indianapolis Motor Speedway president Doug Boles and Hulman & Company Mark Miles officially announced Wilson's death.",106,116,officially,5,1,6
39I4RL8QGJIU3245GR7WRX4WPD14HL,"#36-7 The following day, Indianapolis Motor Speedway president Doug Boles and Hulman & Company Mark Miles officially announced Wilson's death.",106,126,officially announced,0,1,1
39I4RL8QGJIU3245GR7WRX4WPD14HL,"#36-7 The following day, Indianapolis Motor Speedway president Doug Boles and Hulman & Company Mark Miles officially announced Wilson's death.",117,126,announced,7,0,7
39I4RL8QGJIU3245GR7WRX4WPD14HL,"#36-7 The following day, Indianapolis Motor Speedway president Doug Boles and Hulman & Company Mark Miles officially announced Wilson's death.",127,134,Wilsons,0,1,1
39I4RL8QGJIU3245GR7WRX4WPD14HL,"#36-8 Karam was able to walk away from the accident, and was evaluated for a right foot injury; he was released from the hospital the same day.",43,51,accident,3,1,4
39I4RL8QGJIU3245GR7WRX4WPD14HL,"#36-8 Karam was able to walk away from the accident, and was evaluated for a right foot injury; he was released from the hospital the same day.",61,70,evaluated,10,10,20
39I4RL8QGJIU3245GR7WRX4WPD14HL,"#36-8 Karam was able to walk away from the accident, and was evaluated for a right foot injury; he was released from the hospital the same day.",83,94,foot injury,0,1,1
39I4RL8QGJIU3245GR7WRX4WPD14HL,"#36-8 Karam was able to walk away from the accident, and was evaluated for a right foot injury; he was released from the hospital the same day.",88,94,injury,1,0,1
39I4RL8QGJIU3245GR7WRX4WPD14HL,"#36-8 Karam was able to walk away from the accident, and was evaluated for a right foot injury; he was released from the hospital the same day.",103,111,released,1,2,3
39I4RL8QGJIU3245GR7WRX4WPD14HL,"#36-9 Wilson's Andretti Autosport teammate Ryan Hunter-Reay won the race, though he did not celebrate upon finding out about Wilson's accident.",15,23,Andretti,0,1,1
39I4RL8QGJIU3245GR7WRX4WPD14HL,"#36-9 Wilson's Andretti Autosport teammate Ryan Hunter-Reay won the race, though he did not celebrate upon finding out about Wilson's accident.",24,33,Autosport,2,0,2
39I4RL8QGJIU3245GR7WRX4WPD14HL,"#36-9 Wilson's Andretti Autosport teammate Ryan Hunter-Reay won the race, though he did not celebrate upon finding out about Wilson's accident.",34,42,teammate,3,5,8
39I4RL8QGJIU3245GR7WRX4WPD14HL,"#36-9 Wilson's Andretti Autosport teammate Ryan Hunter-Reay won the race, though he did not celebrate upon finding out about Wilson's accident.",34,47,teammate Ryan,0,1,1
39I4RL8QGJIU3245GR7WRX4WPD14HL,"#36-9 Wilson's Andretti Autosport teammate Ryan Hunter-Reay won the race, though he did not celebrate upon finding out about Wilson's accident.",48,59,Hunter-Reay,0,1,1
39I4RL8QGJIU3245GR7WRX4WPD14HL,"#36-9 Wilson's Andretti Autosport teammate Ryan Hunter-Reay won the race, though he did not celebrate upon finding out about Wilson's accident.",92,101,celebrate,5,0,5
39I4RL8QGJIU3245GR7WRX4WPD14HL,"#36-10 In Victory Lane, he stated, ""My first thoughts are with Justin, for sure[...] He's a friend, a teammate, and it's a bit hard not knowing anything.""",10,22,Victory Lane,1,0,1
39I4RL8QGJIU3245GR7WRX4WPD14HL,"#36-10 In Victory Lane, he stated, ""My first thoughts are with Justin, for sure[...] He's a friend, a teammate, and it's a bit hard not knowing anything.""",27,33,stated,1,1,2
39I4RL8QGJIU3245GR7WRX4WPD14HL,"#36-10 In Victory Lane, he stated, ""My first thoughts are with Justin, for sure[...] He's a friend, a teammate, and it's a bit hard not knowing anything.""",102,110,teammate,2,4,6
39I4RL8QGJIU3245GR7WRX4WPD14HL,"#36-10 In Victory Lane, he stated, ""My first thoughts are with Justin, for sure[...] He's a friend, a teammate, and it's a bit hard not knowing anything.""",127,131,hard,0,1,1
39I4RL8QGJIU3245GR7WRX4WPD14HL,"#36-11 Wilson, a former Formula One and Champ Car driver, did not have a ride entering the 2015 season, and joined Andretti on a seven-race deal.",24,35,Formula One,2,1,3
39I4RL8QGJIU3245GR7WRX4WPD14HL,"#36-11 Wilson, a former Formula One and Champ Car driver, did not have a ride entering the 2015 season, and joined Andretti on a seven-race deal.",40,56,Champ Car driver,0,1,1
39I4RL8QGJIU3245GR7WRX4WPD14HL,"#36-11 Wilson, a former Formula One and Champ Car driver, did not have a ride entering the 2015 season, and joined Andretti on a seven-race deal.",73,77,ride,0,1,1
39I4RL8QGJIU3245GR7WRX4WPD14HL,"#36-11 Wilson, a former Formula One and Champ Car driver, did not have a ride entering the 2015 season, and joined Andretti on a seven-race deal.",78,86,entering,0,1,1
39I4RL8QGJIU3245GR7WRX4WPD14HL,"#36-11 Wilson, a former Formula One and Champ Car driver, did not have a ride entering the 2015 season, and joined Andretti on a seven-race deal.",115,123,Andretti,1,2,3
39I4RL8QGJIU3245GR7WRX4WPD14HL,"#36-11 Wilson, a former Formula One and Champ Car driver, did not have a ride entering the 2015 season, and joined Andretti on a seven-race deal.",129,139,seven-race,0,2,2
39I4RL8QGJIU3245GR7WRX4WPD14HL,"#36-11 Wilson, a former Formula One and Champ Car driver, did not have a ride entering the 2015 season, and joined Andretti on a seven-race deal.",129,144,seven-race deal,2,0,2
39I4RL8QGJIU3245GR7WRX4WPD14HL,"#36-11 Wilson, a former Formula One and Champ Car driver, did not have a ride entering the 2015 season, and joined Andretti on a seven-race deal.",140,144,deal,0,2,2
39I4RL8QGJIU3245GR7WRX4WPD14HL,"#36-12 The contract had previously been for two races, but after acquiring sponsorship, the deal was increased by five events; earlier in August, Wilson recorded a best finish of second at Mid-Ohio Sports Car Course.",11,19,contract,6,2,8
39I4RL8QGJIU3245GR7WRX4WPD14HL,"#36-12 The contract had previously been for two races, but after acquiring sponsorship, the deal was increased by five events; earlier in August, Wilson recorded a best finish of second at Mid-Ohio Sports Car Course.",24,34,previously,4,2,6
39I4RL8QGJIU3245GR7WRX4WPD14HL,"#36-12 The contract had previously been for two races, but after acquiring sponsorship, the deal was increased by five events; earlier in August, Wilson recorded a best finish of second at Mid-Ohio Sports Car Course.",65,74,acquiring,6,8,14
39I4RL8QGJIU3245GR7WRX4WPD14HL,"#36-12 The contract had previously been for two races, but after acquiring sponsorship, the deal was increased by five events; earlier in August, Wilson recorded a best finish of second at Mid-Ohio Sports Car Course.",65,86,acquiring sponsorship,4,0,4
39I4RL8QGJIU3245GR7WRX4WPD14HL,"#36-12 The contract had previously been for two races, but after acquiring sponsorship, the deal was increased by five events; earlier in August, Wilson recorded a best finish of second at Mid-Ohio Sports Car Course.",75,86,sponsorship,9,5,14
39I4RL8QGJIU3245GR7WRX4WPD14HL,"#36-12 The contract had previously been for two races, but after acquiring sponsorship, the deal was increased by five events; earlier in August, Wilson recorded a best finish of second at Mid-Ohio Sports Car Course.",101,110,increased,0,1,1
39I4RL8QGJIU3245GR7WRX4WPD14HL,"#36-12 The contract had previously been for two races, but after acquiring sponsorship, the deal was increased by five events; earlier in August, Wilson recorded a best finish of second at Mid-Ohio Sports Car Course.",119,125,events,1,0,1
39I4RL8QGJIU3245GR7WRX4WPD14HL,"#36-12 The contract had previously been for two races, but after acquiring sponsorship, the deal was increased by five events; earlier in August, Wilson recorded a best finish of second at Mid-Ohio Sports Car Course.",153,161,recorded,1,2,3
39I4RL8QGJIU3245GR7WRX4WPD14HL,"#36-12 The contract had previously been for two races, but after acquiring sponsorship, the deal was increased by five events; earlier in August, Wilson recorded a best finish of second at Mid-Ohio Sports Car Course.",164,175,best finish,1,0,1
39I4RL8QGJIU3245GR7WRX4WPD14HL,"#36-12 The contract had previously been for two races, but after acquiring sponsorship, the deal was increased by five events; earlier in August, Wilson recorded a best finish of second at Mid-Ohio Sports Car Course.",189,215,Mid-Ohio Sports Car Course,0,1,1
388CL5C1RJOQ1ABQMJ6DDE67BZWHLR,"#42-69 I don't own a car, so that means I'm excused right?",44,51,excused,5,4,9
388CL5C1RJOQ1ABQMJ6DDE67BZWHLR,#42-70 ;) Wikinews: This is the first evidence for self-medicating insects.,38,46,evidence,4,1,5
388CL5C1RJOQ1ABQMJ6DDE67BZWHLR,#42-70 ;) Wikinews: This is the first evidence for self-medicating insects.,51,66,self-medicating,9,6,15
388CL5C1RJOQ1ABQMJ6DDE67BZWHLR,#42-70 ;) Wikinews: This is the first evidence for self-medicating insects.,51,74,self-medicating insects,1,1,2
388CL5C1RJOQ1ABQMJ6DDE67BZWHLR,#42-70 ;) Wikinews: This is the first evidence for self-medicating insects.,67,74,insects,1,0,1
388CL5C1RJOQ1ABQMJ6DDE67BZWHLR,#42-71 How widespread do you think this phenomenon could be in reality?,11,21,widespread,5,9,14
388CL5C1RJOQ1ABQMJ6DDE67BZWHLR,#42-71 How widespread do you think this phenomenon could be in reality?,11,50,widespread do you think this phenomenon,1,0,1
388CL5C1RJOQ1ABQMJ6DDE67BZWHLR,#42-71 How widespread do you think this phenomenon could be in reality?,40,50,phenomenon,10,10,20
388CL5C1RJOQ1ABQMJ6DDE67BZWHLR,#42-72 NB: It's not actually the first evidence for self-medication in insects.,33,47,first evidence,1,0,1
388CL5C1RJOQ1ABQMJ6DDE67BZWHLR,#42-72 NB: It's not actually the first evidence for self-medication in insects.,39,47,evidence,1,2,3
388CL5C1RJOQ1ABQMJ6DDE67BZWHLR,#42-72 NB: It's not actually the first evidence for self-medication in insects.,52,67,self-medication,4,1,5
388CL5C1RJOQ1ABQMJ6DDE67BZWHLR,"#42-73 Moths and fruit flies definitely do it, and there's evidence in honey bees and bumble-bees as well.",7,12,Moths,0,4,4
388CL5C1RJOQ1ABQMJ6DDE67BZWHLR,"#42-73 Moths and fruit flies definitely do it, and there's evidence in honey bees and bumble-bees as well.",29,39,definitely,0,2,2
388CL5C1RJOQ1ABQMJ6DDE67BZWHLR,"#42-73 Moths and fruit flies definitely do it, and there's evidence in honey bees and bumble-bees as well.",59,67,evidence,3,2,5
388CL5C1RJOQ1ABQMJ6DDE67BZWHLR,"#42-73 Moths and fruit flies definitely do it, and there's evidence in honey bees and bumble-bees as well.",59,105,evidence in honey bees and bumble-bees as well,1,0,1
388CL5C1RJOQ1ABQMJ6DDE67BZWHLR,"#42-73 Moths and fruit flies definitely do it, and there's evidence in honey bees and bumble-bees as well.",86,97,bumble-bees,3,5,8
388CL5C1RJOQ1ABQMJ6DDE67BZWHLR,#42-74 So it seems to be quite wide-spread in the insect world.,31,42,wide-spread,2,2,4
388CL5C1RJOQ1ABQMJ6DDE67BZWHLR,#42-74 So it seems to be quite wide-spread in the insect world.,50,56,insect,1,0,1
388CL5C1RJOQ1ABQMJ6DDE67BZWHLR,#42-74 So it seems to be quite wide-spread in the insect world.,50,62,insect world,0,1,1
388CL5C1RJOQ1ABQMJ6DDE67BZWHLR,"#42-75 I have no doubt that as time goes on, there will be more and more cases documented.",17,22,doubt,0,1,1
388CL5C1RJOQ1ABQMJ6DDE67BZWHLR,"#42-75 I have no doubt that as time goes on, there will be more and more cases documented.",73,89,cases documented,1,0,1
388CL5C1RJOQ1ABQMJ6DDE67BZWHLR,"#42-75 I have no doubt that as time goes on, there will be more and more cases documented.",79,89,documented,7,6,13
388CL5C1RJOQ1ABQMJ6DDE67BZWHLR,#42-76 Insects (and animals in general) seem to be quite good at taking care of themselves.,65,90,taking care of themselves,1,0,1
388CL5C1RJOQ1ABQMJ6DDE67BZWHLR,#42-77 Wikinews: How might ants locate healing substances in the wild?,32,38,locate,1,0,1
388CL5C1RJOQ1ABQMJ6DDE67BZWHLR,#42-77 Wikinews: How might ants locate healing substances in the wild?,39,46,healing,1,5,6
388CL5C1RJOQ1ABQMJ6DDE67BZWHLR,#42-77 Wikinews: How might ants locate healing substances in the wild?,39,57,healing substances,2,3,5
388CL5C1RJOQ1ABQMJ6DDE67BZWHLR,#42-77 Wikinews: How might ants locate healing substances in the wild?,47,57,substances,2,2,4
3MVY4USGB6OD1IH0CALZPCLH36JISZ,"#16-2 The Obamas and Bidens, pictured together from file, have enjoyed an unusually close and warm relationship.",21,27,Bidens,0,1,1
3MVY4USGB6OD1IH0CALZPCLH36JISZ,"#16-2 The Obamas and Bidens, pictured together from file, have enjoyed an unusually close and warm relationship.",29,37,pictured,1,3,4
3MVY4USGB6OD1IH0CALZPCLH36JISZ,"#16-2 The Obamas and Bidens, pictured together from file, have enjoyed an unusually close and warm relationship.",29,46,pictured together,1,0,1
3MVY4USGB6OD1IH0CALZPCLH36JISZ,"#16-2 The Obamas and Bidens, pictured together from file, have enjoyed an unusually close and warm relationship.",52,56,file,0,1,1
3MVY4USGB6OD1IH0CALZPCLH36JISZ,"#16-2 The Obamas and Bidens, pictured together from file, have enjoyed an unusually close and warm relationship.",63,70,enjoyed,0,1,1
3MVY4USGB6OD1IH0CALZPCLH36JISZ,"#16-2 The Obamas and Bidens, pictured together from file, have enjoyed an unusually close and warm relationship.",74,83,unusually,3,3,6
3MVY4USGB6OD1IH0CALZPCLH36JISZ,"#16-2 The Obamas and Bidens, pictured together from file, have enjoyed an unusually close and warm relationship.",94,111,warm relationship,0,1,1
3MVY4USGB6OD1IH0CALZPCLH36JISZ,"#16-3 In a ceremony described by the press as highly emotional, Obama cited his choice of Biden as a running mate as one of the best of his career and described their few arguments as the sort that brothers would have and Biden himself as ""a lion of American history.""",11,19,ceremony,4,6,10
3MVY4USGB6OD1IH0CALZPCLH36JISZ,"#16-3 In a ceremony described by the press as highly emotional, Obama cited his choice of Biden as a running mate as one of the best of his career and described their few arguments as the sort that brothers would have and Biden himself as ""a lion of American history.""",20,29,described,0,1,1
3MVY4USGB6OD1IH0CALZPCLH36JISZ,"#16-3 In a ceremony described by the press as highly emotional, Obama cited his choice of Biden as a running mate as one of the best of his career and described their few arguments as the sort that brothers would have and Biden himself as ""a lion of American history.""",46,62,highly emotional,1,1,2
3MVY4USGB6OD1IH0CALZPCLH36JISZ,"#16-3 In a ceremony described by the press as highly emotional, Obama cited his choice of Biden as a running mate as one of the best of his career and described their few arguments as the sort that brothers would have and Biden himself as ""a lion of American history.""",53,62,emotional,1,2,3
3MVY4USGB6OD1IH0CALZPCLH36JISZ,"#16-3 In a ceremony described by the press as highly emotional, Obama cited his choice of Biden as a running mate as one of the best of his career and described their few arguments as the sort that brothers would have and Biden himself as ""a lion of American history.""",70,75,cited,3,2,5
3MVY4USGB6OD1IH0CALZPCLH36JISZ,"#16-3 In a ceremony described by the press as highly emotional, Obama cited his choice of Biden as a running mate as one of the best of his career and described their few arguments as the sort that brothers would have and Biden himself as ""a lion of American history.""",101,113,running mate,1,2,3
3MVY4USGB6OD1IH0CALZPCLH36JISZ,"#16-3 In a ceremony described by the press as highly emotional, Obama cited his choice of Biden as a running mate as one of the best of his career and described their few arguments as the sort that brothers would have and Biden himself as ""a lion of American history.""",109,113,mate,0,2,2
3MVY4USGB6OD1IH0CALZPCLH36JISZ,"#16-3 In a ceremony described by the press as highly emotional, Obama cited his choice of Biden as a running mate as one of the best of his career and described their few arguments as the sort that brothers would have and Biden himself as ""a lion of American history.""",140,146,career,1,0,1
3MVY4USGB6OD1IH0CALZPCLH36JISZ,"#16-3 In a ceremony described by the press as highly emotional, Obama cited his choice of Biden as a running mate as one of the best of his career and described their few arguments as the sort that brothers would have and Biden himself as ""a lion of American history.""",151,160,described,1,1,2
3MVY4USGB6OD1IH0CALZPCLH36JISZ,"#16-3 In a ceremony described by the press as highly emotional, Obama cited his choice of Biden as a running mate as one of the best of his career and described their few arguments as the sort that brothers would have and Biden himself as ""a lion of American history.""",171,180,arguments,5,4,9
3MVY4USGB6OD1IH0CALZPCLH36JISZ,"#16-3 In a ceremony described by the press as highly emotional, Obama cited his choice of Biden as a running mate as one of the best of his career and described their few arguments as the sort that brothers would have and Biden himself as ""a lion of American history.""",240,266,a lion of American history,1,0,1
3MVY4USGB6OD1IH0CALZPCLH36JISZ,"#16-4 This made only the fourth time in U.S. history that this modified form, the Medal of Freedom with distinction, has been awarded.",63,71,modified,8,4,12
3MVY4USGB6OD1IH0CALZPCLH36JISZ,"#16-4 This made only the fourth time in U.S. history that this modified form, the Medal of Freedom with distinction, has been awarded.",63,76,modified form,2,2,4
3MVY4USGB6OD1IH0CALZPCLH36JISZ,"#16-4 This made only the fourth time in U.S. history that this modified form, the Medal of Freedom with distinction, has been awarded.",82,98,Medal of Freedom,1,0,1
3MVY4USGB6OD1IH0CALZPCLH36JISZ,"#16-4 This made only the fourth time in U.S. history that this modified form, the Medal of Freedom with distinction, has been awarded.",104,115,distinction,10,7,17
3MVY4USGB6OD1IH0CALZPCLH36JISZ,"#16-4 This made only the fourth time in U.S. history that this modified form, the Medal of Freedom with distinction, has been awarded.",126,133,awarded,0,2,2
3MVY4USGB6OD1IH0CALZPCLH36JISZ,"#16-5 Biden joined Pope John Paul II, then-former President Ronald Reagan, and former General and Secretary of State Colin Powell.",19,33,Pope John Paul,0,1,1
3MVY4USGB6OD1IH0CALZPCLH36JISZ,"#16-5 Biden joined Pope John Paul II, then-former President Ronald Reagan, and former General and Secretary of State Colin Powell.",38,49,then-former,0,1,1
3MVY4USGB6OD1IH0CALZPCLH36JISZ,"#16-5 Biden joined Pope John Paul II, then-former President Ronald Reagan, and former General and Secretary of State Colin Powell.",98,107,Secretary,1,0,1
3MVY4USGB6OD1IH0CALZPCLH36JISZ,"#16-5 Biden joined Pope John Paul II, then-former President Ronald Reagan, and former General and Secretary of State Colin Powell.",98,116,Secretary of State,1,0,1
3MVY4USGB6OD1IH0CALZPCLH36JISZ,"#16-5 Biden joined Pope John Paul II, then-former President Ronald Reagan, and former General and Secretary of State Colin Powell.",117,129,Colin Powell,0,1,1
3MVY4USGB6OD1IH0CALZPCLH36JISZ,"#16-6 Early during the ceremony, Obama noted comically ""this also gives the Internet one last chance to talk about our 'bromance.'""",23,31,ceremony,1,0,1
3MVY4USGB6OD1IH0CALZPCLH36JISZ,"#16-6 Early during the ceremony, Obama noted comically ""this also gives the Internet one last chance to talk about our 'bromance.'""",45,54,comically,10,7,17
3MVY4USGB6OD1IH0CALZPCLH36JISZ,"#16-6 Early during the ceremony, Obama noted comically ""this also gives the Internet one last chance to talk about our 'bromance.'""",120,128,bromance,10,9,19
3HO4MYYR12PDNBE3ZE7A7AD0FC96U9,"#29-5 Martin, best known for spreading multiple conspiracy theories concerning the birth and religion of U.S. President Barack Obama, previously ran for the Democratic Party presidential nomination in 1988, and unsuccessfully sought the backing of the Republican Party in 2000 and 2012.",29,38,spreading,1,5,6
3HO4MYYR12PDNBE3ZE7A7AD0FC96U9,"#29-5 Martin, best known for spreading multiple conspiracy theories concerning the birth and religion of U.S. President Barack Obama, previously ran for the Democratic Party presidential nomination in 1988, and unsuccessfully sought the backing of the Republican Party in 2000 and 2012.",29,47,spreading multiple,0,1,1
3HO4MYYR12PDNBE3ZE7A7AD0FC96U9,"#29-5 Martin, best known for spreading multiple conspiracy theories concerning the birth and religion of U.S. President Barack Obama, previously ran for the Democratic Party presidential nomination in 1988, and unsuccessfully sought the backing of the Republican Party in 2000 and 2012.",39,47,multiple,3,0,3
3HO4MYYR12PDNBE3ZE7A7AD0FC96U9,"#29-5 Martin, best known for spreading multiple conspiracy theories concerning the birth and religion of U.S. President Barack Obama, previously ran for the Democratic Party presidential nomination in 1988, and unsuccessfully sought the backing of the Republican Party in 2000 and 2012.",39,67,multiple conspiracy theories,1,1,2
3HO4MYYR12PDNBE3ZE7A7AD0FC96U9,"#29-5 Martin, best known for spreading multiple conspiracy theories concerning the birth and religion of U.S. President Barack Obama, previously ran for the Democratic Party presidential nomination in 1988, and unsuccessfully sought the backing of the Republican Party in 2000 and 2012.",48,58,conspiracy,7,8,15
3HO4MYYR12PDNBE3ZE7A7AD0FC96U9,"#29-5 Martin, best known for spreading multiple conspiracy theories concerning the birth and religion of U.S. President Barack Obama, previously ran for the Democratic Party presidential nomination in 1988, and unsuccessfully sought the backing of the Republican Party in 2000 and 2012.",48,67,conspiracy theories,4,1,5
3HO4MYYR12PDNBE3ZE7A7AD0FC96U9,"#29-5 Martin, best known for spreading multiple conspiracy theories concerning the birth and religion of U.S. President Barack Obama, previously ran for the Democratic Party presidential nomination in 1988, and unsuccessfully sought the backing of the Republican Party in 2000 and 2012.",59,67,theories,3,0,3
3HO4MYYR12PDNBE3ZE7A7AD0FC96U9,"#29-5 Martin, best known for spreading multiple conspiracy theories concerning the birth and religion of U.S. President Barack Obama, previously ran for the Democratic Party presidential nomination in 1988, and unsuccessfully sought the backing of the Republican Party in 2000 and 2012.",68,78,concerning,3,1,4
3HO4MYYR12PDNBE3ZE7A7AD0FC96U9,"#29-5 Martin, best known for spreading multiple conspiracy theories concerning the birth and religion of U.S. President Barack Obama, previously ran for the Democratic Party presidential nomination in 1988, and unsuccessfully sought the backing of the Republican Party in 2000 and 2012.",110,119,President,1,0,1
3HO4MYYR12PDNBE3ZE7A7AD0FC96U9,"#29-5 Martin, best known for spreading multiple conspiracy theories concerning the birth and religion of U.S. President Barack Obama, previously ran for the Democratic Party presidential nomination in 1988, and unsuccessfully sought the backing of the Republican Party in 2000 and 2012.",110,132,President Barack Obama,0,1,1
3HO4MYYR12PDNBE3ZE7A7AD0FC96U9,"#29-5 Martin, best known for spreading multiple conspiracy theories concerning the birth and religion of U.S. President Barack Obama, previously ran for the Democratic Party presidential nomination in 1988, and unsuccessfully sought the backing of the Republican Party in 2000 and 2012.",134,144,previously,0,1,1
3HO4MYYR12PDNBE3ZE7A7AD0FC96U9,"#29-5 Martin, best known for spreading multiple conspiracy theories concerning the birth and religion of U.S. President Barack Obama, previously ran for the Democratic Party presidential nomination in 1988, and unsuccessfully sought the backing of the Republican Party in 2000 and 2012.",157,167,Democratic,1,0,1
3HO4MYYR12PDNBE3ZE7A7AD0FC96U9,"#29-5 Martin, best known for spreading multiple conspiracy theories concerning the birth and religion of U.S. President Barack Obama, previously ran for the Democratic Party presidential nomination in 1988, and unsuccessfully sought the backing of the Republican Party in 2000 and 2012.",174,186,presidential,3,1,4
3HO4MYYR12PDNBE3ZE7A7AD0FC96U9,"#29-5 Martin, best known for spreading multiple conspiracy theories concerning the birth and religion of U.S. President Barack Obama, previously ran for the Democratic Party presidential nomination in 1988, and unsuccessfully sought the backing of the Republican Party in 2000 and 2012.",174,197,presidential nomination,1,0,1
3HO4MYYR12PDNBE3ZE7A7AD0FC96U9,"#29-5 Martin, best known for spreading multiple conspiracy theories concerning the birth and religion of U.S. President Barack Obama, previously ran for the Democratic Party presidential nomination in 1988, and unsuccessfully sought the backing of the Republican Party in 2000 and 2012.",187,197,nomination,7,4,11
3HO4MYYR12PDNBE3ZE7A7AD0FC96U9,"#29-5 Martin, best known for spreading multiple conspiracy theories concerning the birth and religion of U.S. President Barack Obama, previously ran for the Democratic Party presidential nomination in 1988, and unsuccessfully sought the backing of the Republican Party in 2000 and 2012.",211,225,unsuccessfully,7,1,8
3HO4MYYR12PDNBE3ZE7A7AD0FC96U9,"#29-5 Martin, best known for spreading multiple conspiracy theories concerning the birth and religion of U.S. President Barack Obama, previously ran for the Democratic Party presidential nomination in 1988, and unsuccessfully sought the backing of the Republican Party in 2000 and 2012.",211,232,unsuccessfully sought,0,1,1
3HO4MYYR12PDNBE3ZE7A7AD0FC96U9,"#29-5 Martin, best known for spreading multiple conspiracy theories concerning the birth and religion of U.S. President Barack Obama, previously ran for the Democratic Party presidential nomination in 1988, and unsuccessfully sought the backing of the Republican Party in 2000 and 2012.",226,232,sought,5,5,10
3HO4MYYR12PDNBE3ZE7A7AD0FC96U9,"#29-5 Martin, best known for spreading multiple conspiracy theories concerning the birth and religion of U.S. President Barack Obama, previously ran for the Democratic Party presidential nomination in 1988, and unsuccessfully sought the backing of the Republican Party in 2000 and 2012.",252,262,Republican,1,1,2
3HO4MYYR12PDNBE3ZE7A7AD0FC96U9,"#29-5 Martin, best known for spreading multiple conspiracy theories concerning the birth and religion of U.S. President Barack Obama, previously ran for the Democratic Party presidential nomination in 1988, and unsuccessfully sought the backing of the Republican Party in 2000 and 2012.",252,268,Republican Party,0,1,1
3HO4MYYR12PDNBE3ZE7A7AD0FC96U9,"#29-6 In 2012, he received a total of 19 votes in the New Hampshire Primary, the only primary ballot on which he appeared.",68,75,Primary,0,1,1
3HO4MYYR12PDNBE3ZE7A7AD0FC96U9,"#29-6 In 2012, he received a total of 19 votes in the New Hampshire Primary, the only primary ballot on which he appeared.",86,93,primary,1,0,1
3HO4MYYR12PDNBE3ZE7A7AD0FC96U9,"#29-6 In 2012, he received a total of 19 votes in the New Hampshire Primary, the only primary ballot on which he appeared.",94,100,ballot,5,4,9
3HO4MYYR12PDNBE3ZE7A7AD0FC96U9,"#29-6 In 2012, he received a total of 19 votes in the New Hampshire Primary, the only primary ballot on which he appeared.",113,121,appeared,0,1,1
3HO4MYYR12PDNBE3ZE7A7AD0FC96U9,"#29-7 For 2016, Martin does not harbor high expectations of electoral success, though he hopes to receive an invitation to the debates.",32,38,harbor,3,6,9
3HO4MYYR12PDNBE3ZE7A7AD0FC96U9,"#29-7 For 2016, Martin does not harbor high expectations of electoral success, though he hopes to receive an invitation to the debates.",32,56,harbor high expectations,0,1,1
3HO4MYYR12PDNBE3ZE7A7AD0FC96U9,"#29-7 For 2016, Martin does not harbor high expectations of electoral success, though he hopes to receive an invitation to the debates.",44,56,expectations,4,1,5
3HO4MYYR12PDNBE3ZE7A7AD0FC96U9,"#29-7 For 2016, Martin does not harbor high expectations of electoral success, though he hopes to receive an invitation to the debates.",60,69,electoral,6,1,7
3HO4MYYR12PDNBE3ZE7A7AD0FC96U9,"#29-7 For 2016, Martin does not harbor high expectations of electoral success, though he hopes to receive an invitation to the debates.",60,77,electoral success,2,0,2
3HO4MYYR12PDNBE3ZE7A7AD0FC96U9,"#29-7 For 2016, Martin does not harbor high expectations of electoral success, though he hopes to receive an invitation to the debates.",127,134,debates,2,2,4
3HO4MYYR12PDNBE3ZE7A7AD0FC96U9,"#29-8 In reference to the seventeen candidates invited to the two August 6 Fox News debates, Martin casts himself as the ""eighteenth candidate,"" willing to participate in the second-tier debate.",9,18,reference,0,1,1
3HO4MYYR12PDNBE3ZE7A7AD0FC96U9,"#29-8 In reference to the seventeen candidates invited to the two August 6 Fox News debates, Martin casts himself as the ""eighteenth candidate,"" willing to participate in the second-tier debate.",26,46,seventeen candidates,0,1,1
3HO4MYYR12PDNBE3ZE7A7AD0FC96U9,"#29-8 In reference to the seventeen candidates invited to the two August 6 Fox News debates, Martin casts himself as the ""eighteenth candidate,"" willing to participate in the second-tier debate.",84,91,debates,2,0,2
3HO4MYYR12PDNBE3ZE7A7AD0FC96U9,"#29-8 In reference to the seventeen candidates invited to the two August 6 Fox News debates, Martin casts himself as the ""eighteenth candidate,"" willing to participate in the second-tier debate.",100,105,casts,0,4,4
3HO4MYYR12PDNBE3ZE7A7AD0FC96U9,"#29-8 In reference to the seventeen candidates invited to the two August 6 Fox News debates, Martin casts himself as the ""eighteenth candidate,"" willing to participate in the second-tier debate.",122,132,eighteenth,1,1,2
3HO4MYYR12PDNBE3ZE7A7AD0FC96U9,"#29-8 In reference to the seventeen candidates invited to the two August 6 Fox News debates, Martin casts himself as the ""eighteenth candidate,"" willing to participate in the second-tier debate.",122,142,eighteenth candidate,2,0,2
3HO4MYYR12PDNBE3ZE7A7AD0FC96U9,"#29-8 In reference to the seventeen candidates invited to the two August 6 Fox News debates, Martin casts himself as the ""eighteenth candidate,"" willing to participate in the second-tier debate.",145,152,willing,1,1,2
3HO4MYYR12PDNBE3ZE7A7AD0FC96U9,"#29-8 In reference to the seventeen candidates invited to the two August 6 Fox News debates, Martin casts himself as the ""eighteenth candidate,"" willing to participate in the second-tier debate.",156,167,participate,1,1,2
3HO4MYYR12PDNBE3ZE7A7AD0FC96U9,"#29-8 In reference to the seventeen candidates invited to the two August 6 Fox News debates, Martin casts himself as the ""eighteenth candidate,"" willing to participate in the second-tier debate.",175,186,second-tier,5,3,8
3HO4MYYR12PDNBE3ZE7A7AD0FC96U9,"#29-8 In reference to the seventeen candidates invited to the two August 6 Fox News debates, Martin casts himself as the ""eighteenth candidate,"" willing to participate in the second-tier debate.",175,193,second-tier debate,1,0,1
3HO4MYYR12PDNBE3ZE7A7AD0FC96U9,"#29-8 In reference to the seventeen candidates invited to the two August 6 Fox News debates, Martin casts himself as the ""eighteenth candidate,"" willing to participate in the second-tier debate.",187,193,debate,2,0,2
3HO4MYYR12PDNBE3ZE7A7AD0FC96U9,"#29-9 Moreover, he declares himself as the ""second-most exciting"" candidate, reserving first place for Trump, whom Martin praises throughout his announcement.",6,14,Moreover,1,0,1
3HO4MYYR12PDNBE3ZE7A7AD0FC96U9,"#29-9 Moreover, he declares himself as the ""second-most exciting"" candidate, reserving first place for Trump, whom Martin praises throughout his announcement.",44,55,second-most,0,1,1
3HO4MYYR12PDNBE3ZE7A7AD0FC96U9,"#29-9 Moreover, he declares himself as the ""second-most exciting"" candidate, reserving first place for Trump, whom Martin praises throughout his announcement.",56,64,exciting,2,0,2
3HO4MYYR12PDNBE3ZE7A7AD0FC96U9,"#29-9 Moreover, he declares himself as the ""second-most exciting"" candidate, reserving first place for Trump, whom Martin praises throughout his announcement.",77,86,reserving,1,0,1
3HO4MYYR12PDNBE3ZE7A7AD0FC96U9,"#29-9 Moreover, he declares himself as the ""second-most exciting"" candidate, reserving first place for Trump, whom Martin praises throughout his announcement.",122,129,praises,2,2,4
3HO4MYYR12PDNBE3ZE7A7AD0FC96U9,"#29-9 Moreover, he declares himself as the ""second-most exciting"" candidate, reserving first place for Trump, whom Martin praises throughout his announcement.",130,140,throughout,1,1,2
3HO4MYYR12PDNBE3ZE7A7AD0FC96U9,"#29-9 Moreover, he declares himself as the ""second-most exciting"" candidate, reserving first place for Trump, whom Martin praises throughout his announcement.",145,157,announcement,6,4,10
3KQC8JMJGCT9L6L1GD2DHSCQBD5H3D,"#19-5 According to Agus Supriatna, chief of the Air Force, the pilot reported technical problems and requested return to base.",6,18,According to,0,1,1
3KQC8JMJGCT9L6L1GD2DHSCQBD5H3D,"#19-5 According to Agus Supriatna, chief of the Air Force, the pilot reported technical problems and requested return to base.",19,23,Agus,1,0,1
3KQC8JMJGCT9L6L1GD2DHSCQBD5H3D,"#19-5 According to Agus Supriatna, chief of the Air Force, the pilot reported technical problems and requested return to base.",19,33,Agus Supriatna,1,0,1
3KQC8JMJGCT9L6L1GD2DHSCQBD5H3D,"#19-5 According to Agus Supriatna, chief of the Air Force, the pilot reported technical problems and requested return to base.",24,33,Supriatna,3,0,3
3KQC8JMJGCT9L6L1GD2DHSCQBD5H3D,"#19-5 According to Agus Supriatna, chief of the Air Force, the pilot reported technical problems and requested return to base.",35,40,chief,1,0,1
3KQC8JMJGCT9L6L1GD2DHSCQBD5H3D,"#19-5 According to Agus Supriatna, chief of the Air Force, the pilot reported technical problems and requested return to base.",63,68,pilot,1,0,1
3KQC8JMJGCT9L6L1GD2DHSCQBD5H3D,"#19-5 According to Agus Supriatna, chief of the Air Force, the pilot reported technical problems and requested return to base.",69,77,reported,1,1,2
3KQC8JMJGCT9L6L1GD2DHSCQBD5H3D,"#19-5 According to Agus Supriatna, chief of the Air Force, the pilot reported technical problems and requested return to base.",78,87,technical,4,2,6
3KQC8JMJGCT9L6L1GD2DHSCQBD5H3D,"#19-5 According to Agus Supriatna, chief of the Air Force, the pilot reported technical problems and requested return to base.",78,96,technical problems,2,1,3
3KQC8JMJGCT9L6L1GD2DHSCQBD5H3D,"#19-5 According to Agus Supriatna, chief of the Air Force, the pilot reported technical problems and requested return to base.",101,110,requested,1,2,3
3KQC8JMJGCT9L6L1GD2DHSCQBD5H3D,"#19-5 According to Agus Supriatna, chief of the Air Force, the pilot reported technical problems and requested return to base.",111,125,return to base,0,1,1
3KQC8JMJGCT9L6L1GD2DHSCQBD5H3D,"#19-5 According to Agus Supriatna, chief of the Air Force, the pilot reported technical problems and requested return to base.",121,125,base,0,1,1
3KQC8JMJGCT9L6L1GD2DHSCQBD5H3D,#19-6 The aircraft was en route from Soewondo Air Force Base to Natuna.,23,25,en,0,1,1
3KQC8JMJGCT9L6L1GD2DHSCQBD5H3D,#19-6 The aircraft was en route from Soewondo Air Force Base to Natuna.,23,31,en route,7,4,11
3KQC8JMJGCT9L6L1GD2DHSCQBD5H3D,#19-6 The aircraft was en route from Soewondo Air Force Base to Natuna.,26,31,route,1,0,1
3KQC8JMJGCT9L6L1GD2DHSCQBD5H3D,#19-6 The aircraft was en route from Soewondo Air Force Base to Natuna.,37,45,Soewondo,3,0,3
3KQC8JMJGCT9L6L1GD2DHSCQBD5H3D,#19-6 The aircraft was en route from Soewondo Air Force Base to Natuna.,64,70,Natuna,3,0,3
3KQC8JMJGCT9L6L1GD2DHSCQBD5H3D,"#19-7 The air force first said there were twelve crew members on board, but the total number of reported fatalities continued to change with later reports.",49,53,crew,3,2,5
3KQC8JMJGCT9L6L1GD2DHSCQBD5H3D,"#19-7 The air force first said there were twelve crew members on board, but the total number of reported fatalities continued to change with later reports.",49,61,crew members,0,1,1
3KQC8JMJGCT9L6L1GD2DHSCQBD5H3D,"#19-7 The air force first said there were twelve crew members on board, but the total number of reported fatalities continued to change with later reports.",62,70,on board,1,2,3
3KQC8JMJGCT9L6L1GD2DHSCQBD5H3D,"#19-7 The air force first said there were twelve crew members on board, but the total number of reported fatalities continued to change with later reports.",105,115,fatalities,10,9,19
3KQC8JMJGCT9L6L1GD2DHSCQBD5H3D,"#19-7 The air force first said there were twelve crew members on board, but the total number of reported fatalities continued to change with later reports.",116,125,continued,0,1,1
3KQC8JMJGCT9L6L1GD2DHSCQBD5H3D,"#19-8 Police found even more dead bodies from the crash on the ground, raising the reported death toll as high as 142 people.",83,91,reported,1,0,1
3KQC8JMJGCT9L6L1GD2DHSCQBD5H3D,"#19-8 Police found even more dead bodies from the crash on the ground, raising the reported death toll as high as 142 people.",92,102,death toll,2,0,2
3KQC8JMJGCT9L6L1GD2DHSCQBD5H3D,"#19-8 Police found even more dead bodies from the crash on the ground, raising the reported death toll as high as 142 people.",98,102,toll,1,1,2
3KQC8JMJGCT9L6L1GD2DHSCQBD5H3D,"#19-9 Some bodies have been identified by blood sampling, an official told newspaper Jakarta Globe.",28,38,identified,1,1,2
3KQC8JMJGCT9L6L1GD2DHSCQBD5H3D,"#19-9 Some bodies have been identified by blood sampling, an official told newspaper Jakarta Globe.",42,56,blood sampling,4,2,6
3KQC8JMJGCT9L6L1GD2DHSCQBD5H3D,"#19-9 Some bodies have been identified by blood sampling, an official told newspaper Jakarta Globe.",48,56,sampling,2,6,8
3KQC8JMJGCT9L6L1GD2DHSCQBD5H3D,"#19-9 Some bodies have been identified by blood sampling, an official told newspaper Jakarta Globe.",75,84,newspaper,1,0,1
3KQC8JMJGCT9L6L1GD2DHSCQBD5H3D,"#19-9 Some bodies have been identified by blood sampling, an official told newspaper Jakarta Globe.",85,92,Jakarta,1,0,1
3KQC8JMJGCT9L6L1GD2DHSCQBD5H3D,#19-10 There were some allegations that passengers on the aircraft were not limited to military families.,23,34,allegations,10,9,19
3KQC8JMJGCT9L6L1GD2DHSCQBD5H3D,#19-10 There were some allegations that passengers on the aircraft were not limited to military families.,40,50,passengers,1,0,1
3KQC8JMJGCT9L6L1GD2DHSCQBD5H3D,#19-10 There were some allegations that passengers on the aircraft were not limited to military families.,58,66,aircraft,0,1,1
3KQC8JMJGCT9L6L1GD2DHSCQBD5H3D,#19-10 There were some allegations that passengers on the aircraft were not limited to military families.,76,83,limited,0,1,1
3KQC8JMJGCT9L6L1GD2DHSCQBD5H3D,#19-10 There were some allegations that passengers on the aircraft were not limited to military families.,87,95,military,0,1,1
3KQC8JMJGCT9L6L1GD2DHSCQBD5H3D,"#19-11 The military is not allowed to fly civilian passengers, according to the air force chief, unless they are related to military personnel, or under some special circumstances.",42,50,civilian,5,1,6
3KQC8JMJGCT9L6L1GD2DHSCQBD5H3D,"#19-11 The military is not allowed to fly civilian passengers, according to the air force chief, unless they are related to military personnel, or under some special circumstances.",42,61,civilian passengers,1,1,2
3KQC8JMJGCT9L6L1GD2DHSCQBD5H3D,"#19-11 The military is not allowed to fly civilian passengers, according to the air force chief, unless they are related to military personnel, or under some special circumstances.",51,61,passengers,1,0,1
3KQC8JMJGCT9L6L1GD2DHSCQBD5H3D,"#19-11 The military is not allowed to fly civilian passengers, according to the air force chief, unless they are related to military personnel, or under some special circumstances.",113,132,related to military,0,1,1
3KQC8JMJGCT9L6L1GD2DHSCQBD5H3D,"#19-11 The military is not allowed to fly civilian passengers, according to the air force chief, unless they are related to military personnel, or under some special circumstances.",124,142,military personnel,1,0,1
3KQC8JMJGCT9L6L1GD2DHSCQBD5H3D,"#19-11 The military is not allowed to fly civilian passengers, according to the air force chief, unless they are related to military personnel, or under some special circumstances.",133,142,personnel,1,2,3
3KQC8JMJGCT9L6L1GD2DHSCQBD5H3D,"#19-11 The military is not allowed to fly civilian passengers, according to the air force chief, unless they are related to military personnel, or under some special circumstances.",158,179,special circumstances,4,0,4
3KQC8JMJGCT9L6L1GD2DHSCQBD5H3D,"#19-11 The military is not allowed to fly civilian passengers, according to the air force chief, unless they are related to military personnel, or under some special circumstances.",166,179,circumstances,7,9,16
308KJXFUJR7ZA0BHPMYCIJTKSHRTAU,"#24-33 I could even make out the doors on the plane clearly"", one resident was quoted as saying to the newspaper Haveeru Daily.",20,28,make out,0,1,1
308KJXFUJR7ZA0BHPMYCIJTKSHRTAU,"#24-33 I could even make out the doors on the plane clearly"", one resident was quoted as saying to the newspaper Haveeru Daily.",66,74,resident,3,3,6
308KJXFUJR7ZA0BHPMYCIJTKSHRTAU,"#24-33 I could even make out the doors on the plane clearly"", one resident was quoted as saying to the newspaper Haveeru Daily.",79,85,quoted,4,4,8
308KJXFUJR7ZA0BHPMYCIJTKSHRTAU,"#24-33 I could even make out the doors on the plane clearly"", one resident was quoted as saying to the newspaper Haveeru Daily.",103,112,newspaper,1,0,1
308KJXFUJR7ZA0BHPMYCIJTKSHRTAU,"#24-33 I could even make out the doors on the plane clearly"", one resident was quoted as saying to the newspaper Haveeru Daily.",113,126,Haveeru Daily,0,1,1
308KJXFUJR7ZA0BHPMYCIJTKSHRTAU,#24-34 Some claim the plane appeared to be headed in the direction of Diego Garcia.,28,36,appeared,2,1,3
308KJXFUJR7ZA0BHPMYCIJTKSHRTAU,#24-34 Some claim the plane appeared to be headed in the direction of Diego Garcia.,28,49,appeared to be headed,0,1,1
308KJXFUJR7ZA0BHPMYCIJTKSHRTAU,#24-34 Some claim the plane appeared to be headed in the direction of Diego Garcia.,43,49,headed,2,4,6
308KJXFUJR7ZA0BHPMYCIJTKSHRTAU,#24-34 Some claim the plane appeared to be headed in the direction of Diego Garcia.,70,75,Diego,1,0,1
308KJXFUJR7ZA0BHPMYCIJTKSHRTAU,#24-34 Some claim the plane appeared to be headed in the direction of Diego Garcia.,70,82,Diego Garcia,0,1,1
308KJXFUJR7ZA0BHPMYCIJTKSHRTAU,"#24-35 According to The Huffington Post, Haveeru reported the witnesses were interviewed by authorities who deemed their statements to be truthful, but Maldive military officials along with Malaysian officials say no such aircraft was in Maldive airspace at the time MH370 went missing.",7,16,According,1,0,1
308KJXFUJR7ZA0BHPMYCIJTKSHRTAU,"#24-35 According to The Huffington Post, Haveeru reported the witnesses were interviewed by authorities who deemed their statements to be truthful, but Maldive military officials along with Malaysian officials say no such aircraft was in Maldive airspace at the time MH370 went missing.",24,34,Huffington,0,1,1
308KJXFUJR7ZA0BHPMYCIJTKSHRTAU,"#24-35 According to The Huffington Post, Haveeru reported the witnesses were interviewed by authorities who deemed their statements to be truthful, but Maldive military officials along with Malaysian officials say no such aircraft was in Maldive airspace at the time MH370 went missing.",41,48,Haveeru,0,1,1
308KJXFUJR7ZA0BHPMYCIJTKSHRTAU,"#24-35 According to The Huffington Post, Haveeru reported the witnesses were interviewed by authorities who deemed their statements to be truthful, but Maldive military officials along with Malaysian officials say no such aircraft was in Maldive airspace at the time MH370 went missing.",49,57,reported,0,1,1
308KJXFUJR7ZA0BHPMYCIJTKSHRTAU,"#24-35 According to The Huffington Post, Haveeru reported the witnesses were interviewed by authorities who deemed their statements to be truthful, but Maldive military officials along with Malaysian officials say no such aircraft was in Maldive airspace at the time MH370 went missing.",62,71,witnesses,4,3,7
308KJXFUJR7ZA0BHPMYCIJTKSHRTAU,"#24-35 According to The Huffington Post, Haveeru reported the witnesses were interviewed by authorities who deemed their statements to be truthful, but Maldive military officials along with Malaysian officials say no such aircraft was in Maldive airspace at the time MH370 went missing.",77,88,interviewed,9,3,12
308KJXFUJR7ZA0BHPMYCIJTKSHRTAU,"#24-35 According to The Huffington Post, Haveeru reported the witnesses were interviewed by authorities who deemed their statements to be truthful, but Maldive military officials along with Malaysian officials say no such aircraft was in Maldive airspace at the time MH370 went missing.",92,103,authorities,5,2,7
308KJXFUJR7ZA0BHPMYCIJTKSHRTAU,"#24-35 According to The Huffington Post, Haveeru reported the witnesses were interviewed by authorities who deemed their statements to be truthful, but Maldive military officials along with Malaysian officials say no such aircraft was in Maldive airspace at the time MH370 went missing.",108,114,deemed,3,8,11
308KJXFUJR7ZA0BHPMYCIJTKSHRTAU,"#24-35 According to The Huffington Post, Haveeru reported the witnesses were interviewed by authorities who deemed their statements to be truthful, but Maldive military officials along with Malaysian officials say no such aircraft was in Maldive airspace at the time MH370 went missing.",138,146,truthful,0,1,1
308KJXFUJR7ZA0BHPMYCIJTKSHRTAU,"#24-35 According to The Huffington Post, Haveeru reported the witnesses were interviewed by authorities who deemed their statements to be truthful, but Maldive military officials along with Malaysian officials say no such aircraft was in Maldive airspace at the time MH370 went missing.",152,178,Maldive military officials,1,0,1
308KJXFUJR7ZA0BHPMYCIJTKSHRTAU,"#24-35 According to The Huffington Post, Haveeru reported the witnesses were interviewed by authorities who deemed their statements to be truthful, but Maldive military officials along with Malaysian officials say no such aircraft was in Maldive airspace at the time MH370 went missing.",190,199,Malaysian,0,1,1
308KJXFUJR7ZA0BHPMYCIJTKSHRTAU,"#24-35 According to The Huffington Post, Haveeru reported the witnesses were interviewed by authorities who deemed their statements to be truthful, but Maldive military officials along with Malaysian officials say no such aircraft was in Maldive airspace at the time MH370 went missing.",200,209,officials,1,0,1
308KJXFUJR7ZA0BHPMYCIJTKSHRTAU,"#24-35 According to The Huffington Post, Haveeru reported the witnesses were interviewed by authorities who deemed their statements to be truthful, but Maldive military officials along with Malaysian officials say no such aircraft was in Maldive airspace at the time MH370 went missing.",222,230,aircraft,0,2,2
308KJXFUJR7ZA0BHPMYCIJTKSHRTAU,"#24-35 According to The Huffington Post, Haveeru reported the witnesses were interviewed by authorities who deemed their statements to be truthful, but Maldive military officials along with Malaysian officials say no such aircraft was in Maldive airspace at the time MH370 went missing.",246,254,airspace,2,4,6
308KJXFUJR7ZA0BHPMYCIJTKSHRTAU,"#24-35 According to The Huffington Post, Haveeru reported the witnesses were interviewed by authorities who deemed their statements to be truthful, but Maldive military officials along with Malaysian officials say no such aircraft was in Maldive airspace at the time MH370 went missing.",273,285,went missing,0,1,1
308KJXFUJR7ZA0BHPMYCIJTKSHRTAU,"#24-35 According to The Huffington Post, Haveeru reported the witnesses were interviewed by authorities who deemed their statements to be truthful, but Maldive military officials along with Malaysian officials say no such aircraft was in Maldive airspace at the time MH370 went missing.",278,285,missing,0,1,1
308KJXFUJR7ZA0BHPMYCIJTKSHRTAU,"#24-36 ""Based on the monitoring up to date, no indication of Flight MH370 has been observed on any military radars in the country [Maldives].",21,31,monitoring,8,8,16
308KJXFUJR7ZA0BHPMYCIJTKSHRTAU,"#24-36 ""Based on the monitoring up to date, no indication of Flight MH370 has been observed on any military radars in the country [Maldives].",47,57,indication,4,4,8
308KJXFUJR7ZA0BHPMYCIJTKSHRTAU,"#24-36 ""Based on the monitoring up to date, no indication of Flight MH370 has been observed on any military radars in the country [Maldives].",83,91,observed,3,1,4
308KJXFUJR7ZA0BHPMYCIJTKSHRTAU,"#24-36 ""Based on the monitoring up to date, no indication of Flight MH370 has been observed on any military radars in the country [Maldives].",99,114,military radars,3,2,5
308KJXFUJR7ZA0BHPMYCIJTKSHRTAU,"#24-36 ""Based on the monitoring up to date, no indication of Flight MH370 has been observed on any military radars in the country [Maldives].",108,114,radars,1,3,4
308KJXFUJR7ZA0BHPMYCIJTKSHRTAU,"#24-37 Furthermore, the data of radars at Maldives airports have also been analysed and shows no indication of the said flight"", said Malaysian Transport Minister Hishamuddin Hussein.",7,18,Furthermore,4,0,4
308KJXFUJR7ZA0BHPMYCIJTKSHRTAU,"#24-37 Furthermore, the data of radars at Maldives airports have also been analysed and shows no indication of the said flight"", said Malaysian Transport Minister Hishamuddin Hussein.",24,28,data,1,0,1
308KJXFUJR7ZA0BHPMYCIJTKSHRTAU,"#24-37 Furthermore, the data of radars at Maldives airports have also been analysed and shows no indication of the said flight"", said Malaysian Transport Minister Hishamuddin Hussein.",32,38,radars,0,2,2
308KJXFUJR7ZA0BHPMYCIJTKSHRTAU,"#24-37 Furthermore, the data of radars at Maldives airports have also been analysed and shows no indication of the said flight"", said Malaysian Transport Minister Hishamuddin Hussein.",75,83,analysed,10,5,15
308KJXFUJR7ZA0BHPMYCIJTKSHRTAU,"#24-37 Furthermore, the data of radars at Maldives airports have also been analysed and shows no indication of the said flight"", said Malaysian Transport Minister Hishamuddin Hussein.",97,107,indication,4,4,8
308KJXFUJR7ZA0BHPMYCIJTKSHRTAU,"#24-37 Furthermore, the data of radars at Maldives airports have also been analysed and shows no indication of the said flight"", said Malaysian Transport Minister Hishamuddin Hussein.",115,126,said flight,0,1,1
308KJXFUJR7ZA0BHPMYCIJTKSHRTAU,"#24-37 Furthermore, the data of radars at Maldives airports have also been analysed and shows no indication of the said flight"", said Malaysian Transport Minister Hishamuddin Hussein.",120,126,flight,1,0,1
308KJXFUJR7ZA0BHPMYCIJTKSHRTAU,"#24-37 Furthermore, the data of radars at Maldives airports have also been analysed and shows no indication of the said flight"", said Malaysian Transport Minister Hishamuddin Hussein.",144,162,Transport Minister,1,0,1
308KJXFUJR7ZA0BHPMYCIJTKSHRTAU,"#24-37 Furthermore, the data of radars at Maldives airports have also been analysed and shows no indication of the said flight"", said Malaysian Transport Minister Hishamuddin Hussein.",163,174,Hishamuddin,0,1,1
308KJXFUJR7ZA0BHPMYCIJTKSHRTAU,"#24-37 Furthermore, the data of radars at Maldives airports have also been analysed and shows no indication of the said flight"", said Malaysian Transport Minister Hishamuddin Hussein.",163,182,Hishamuddin Hussein,1,1,2
3S8A4GJRD34D0Q3344HF3WFJTJI6VY,#30-3 She was located and fined within two days of posting the photograph.,14,21,located,0,3,3
3S8A4GJRD34D0Q3344HF3WFJTJI6VY,#30-3 She was located and fined within two days of posting the photograph.,26,31,fined,4,5,9
3S8A4GJRD34D0Q3344HF3WFJTJI6VY,#30-3 She was located and fined within two days of posting the photograph.,51,58,posting,0,1,1
3S8A4GJRD34D0Q3344HF3WFJTJI6VY,#30-3 She was located and fined within two days of posting the photograph.,63,73,photograph,2,0,2
3S8A4GJRD34D0Q3344HF3WFJTJI6VY,#30-4 The incident has now gained international attention.,10,18,incident,2,1,3
3S8A4GJRD34D0Q3344HF3WFJTJI6VY,#30-4 The incident has now gained international attention.,27,33,gained,1,3,4
3S8A4GJRD34D0Q3344HF3WFJTJI6VY,#30-4 The incident has now gained international attention.,27,57,gained international attention,0,1,1
3S8A4GJRD34D0Q3344HF3WFJTJI6VY,#30-4 The incident has now gained international attention.,34,47,international,3,1,4
3S8A4GJRD34D0Q3344HF3WFJTJI6VY,#30-4 The incident has now gained international attention.,34,57,international attention,0,1,1
3S8A4GJRD34D0Q3344HF3WFJTJI6VY,#30-4 The incident has now gained international attention.,48,57,attention,1,0,1
3S8A4GJRD34D0Q3344HF3WFJTJI6VY,"#30-5 The woman, who has not been named, saw the police vehicle parked in a reserved spot in Petrer and snapped a photo.",64,70,parked,1,1,2
3S8A4GJRD34D0Q3344HF3WFJTJI6VY,"#30-5 The woman, who has not been named, saw the police vehicle parked in a reserved spot in Petrer and snapped a photo.",76,84,reserved,3,2,5
3S8A4GJRD34D0Q3344HF3WFJTJI6VY,"#30-5 The woman, who has not been named, saw the police vehicle parked in a reserved spot in Petrer and snapped a photo.",76,89,reserved spot,1,2,3
3S8A4GJRD34D0Q3344HF3WFJTJI6VY,"#30-5 The woman, who has not been named, saw the police vehicle parked in a reserved spot in Petrer and snapped a photo.",85,89,spot,0,1,1
3S8A4GJRD34D0Q3344HF3WFJTJI6VY,"#30-5 The woman, who has not been named, saw the police vehicle parked in a reserved spot in Petrer and snapped a photo.",93,99,Petrer,2,1,3
3S8A4GJRD34D0Q3344HF3WFJTJI6VY,"#30-5 The woman, who has not been named, saw the police vehicle parked in a reserved spot in Petrer and snapped a photo.",104,111,snapped,4,9,13
3S8A4GJRD34D0Q3344HF3WFJTJI6VY,"#30-5 The woman, who has not been named, saw the police vehicle parked in a reserved spot in Petrer and snapped a photo.",104,119,snapped a photo,1,1,2
3S8A4GJRD34D0Q3344HF3WFJTJI6VY,"#30-6 She posted the photo with the caption: ""Park where you bloody well please and you won't even be fined.",36,43,caption,0,1,1
3S8A4GJRD34D0Q3344HF3WFJTJI6VY,"#30-6 She posted the photo with the caption: ""Park where you bloody well please and you won't even be fined.",61,67,bloody,3,0,3
3S8A4GJRD34D0Q3344HF3WFJTJI6VY,"#30-6 She posted the photo with the caption: ""Park where you bloody well please and you won't even be fined.",61,79,bloody well please,2,1,3
3S8A4GJRD34D0Q3344HF3WFJTJI6VY,"#30-6 She posted the photo with the caption: ""Park where you bloody well please and you won't even be fined.",102,107,fined,0,1,1
3S8A4GJRD34D0Q3344HF3WFJTJI6VY,"#30-7 Fernando Portillo, a local police spokesperson, told local media the vehicle was parked there because police were responding to an emergency.",15,23,Portillo,0,1,1
3S8A4GJRD34D0Q3344HF3WFJTJI6VY,"#30-7 Fernando Portillo, a local police spokesperson, told local media the vehicle was parked there because police were responding to an emergency.",40,52,spokesperson,4,4,8
3S8A4GJRD34D0Q3344HF3WFJTJI6VY,"#30-7 Fernando Portillo, a local police spokesperson, told local media the vehicle was parked there because police were responding to an emergency.",75,82,vehicle,1,0,1
3S8A4GJRD34D0Q3344HF3WFJTJI6VY,"#30-7 Fernando Portillo, a local police spokesperson, told local media the vehicle was parked there because police were responding to an emergency.",120,130,responding,4,6,10
3S8A4GJRD34D0Q3344HF3WFJTJI6VY,"#30-7 Fernando Portillo, a local police spokesperson, told local media the vehicle was parked there because police were responding to an emergency.",137,146,emergency,3,1,4
3S8A4GJRD34D0Q3344HF3WFJTJI6VY,"#30-8 After the story was reported on a local news website, it began to be reported internationally.",26,34,reported,1,0,1
3S8A4GJRD34D0Q3344HF3WFJTJI6VY,"#30-8 After the story was reported on a local news website, it began to be reported internationally.",84,99,internationally,5,3,8
3S8A4GJRD34D0Q3344HF3WFJTJI6VY,"#30-9 On July 1, the ""Citizens' Security law"" went into effect.",22,30,Citizens,1,0,1
3S8A4GJRD34D0Q3344HF3WFJTJI6VY,"#30-9 On July 1, the ""Citizens' Security law"" went into effect.",22,43,Citizens Security law,4,1,5
3S8A4GJRD34D0Q3344HF3WFJTJI6VY,"#30-9 On July 1, the ""Citizens' Security law"" went into effect.",46,62,went into effect,0,1,1
3S8A4GJRD34D0Q3344HF3WFJTJI6VY,#30-10 The law was written in response to violent protests.,30,38,response,1,0,1
3S8A4GJRD34D0Q3344HF3WFJTJI6VY,#30-10 The law was written in response to violent protests.,42,49,violent,2,2,4
3S8A4GJRD34D0Q3344HF3WFJTJI6VY,#30-10 The law was written in response to violent protests.,42,58,violent protests,1,2,3
3S8A4GJRD34D0Q3344HF3WFJTJI6VY,#30-10 The law was written in response to violent protests.,50,58,protests,3,2,5
3S8A4GJRD34D0Q3344HF3WFJTJI6VY,#30-11 Even before its enactment it saw widespread criticism.,23,32,enactment,10,10,20
3S8A4GJRD34D0Q3344HF3WFJTJI6VY,#30-11 Even before its enactment it saw widespread criticism.,40,50,widespread,2,5,7
3S8A4GJRD34D0Q3344HF3WFJTJI6VY,#30-11 Even before its enactment it saw widespread criticism.,40,60,widespread criticism,5,2,7
3S8A4GJRD34D0Q3344HF3WFJTJI6VY,#30-11 Even before its enactment it saw widespread criticism.,51,60,criticism,5,6,11
3QO7EE372OOR1UOHEW4D8P23QSEBQU,#10-7 It was agreed at a NATO summit in Warsaw last year.,25,29,NATO,1,0,1
3QO7EE372OOR1UOHEW4D8P23QSEBQU,#10-7 It was agreed at a NATO summit in Warsaw last year.,25,36,NATO summit,1,1,2
3QO7EE372OOR1UOHEW4D8P23QSEBQU,#10-7 It was agreed at a NATO summit in Warsaw last year.,30,36,summit,8,6,14
3QO7EE372OOR1UOHEW4D8P23QSEBQU,#10-7 It was agreed at a NATO summit in Warsaw last year.,40,46,Warsaw,0,1,1
3QO7EE372OOR1UOHEW4D8P23QSEBQU,#10-8 Defence Minister Antoni Macierewicz was also at the ceremony.,6,13,Defence,1,0,1
3QO7EE372OOR1UOHEW4D8P23QSEBQU,#10-8 Defence Minister Antoni Macierewicz was also at the ceremony.,30,41,Macierewicz,2,0,2
3QO7EE372OOR1UOHEW4D8P23QSEBQU,#10-8 Defence Minister Antoni Macierewicz was also at the ceremony.,58,66,ceremony,4,8,12
3QO7EE372OOR1UOHEW4D8P23QSEBQU,"#10-9 ""We have waited for you for a very long time,"" he told the troops.",65,71,troops,0,2,2
3QO7EE372OOR1UOHEW4D8P23QSEBQU,"#10-10 ""We waited for decades, sometimes feeling we had been left alone, sometimes almost losing hope, sometimes feeling that we were the only one who protected civilization from aggression that came from the east.""",22,29,decades,5,6,11
3QO7EE372OOR1UOHEW4D8P23QSEBQU,"#10-10 ""We waited for decades, sometimes feeling we had been left alone, sometimes almost losing hope, sometimes feeling that we were the only one who protected civilization from aggression that came from the east.""",103,112,sometimes,1,0,1
3QO7EE372OOR1UOHEW4D8P23QSEBQU,"#10-10 ""We waited for decades, sometimes feeling we had been left alone, sometimes almost losing hope, sometimes feeling that we were the only one who protected civilization from aggression that came from the east.""",151,173,protected civilization,3,0,3
3QO7EE372OOR1UOHEW4D8P23QSEBQU,"#10-10 ""We waited for decades, sometimes feeling we had been left alone, sometimes almost losing hope, sometimes feeling that we were the only one who protected civilization from aggression that came from the east.""",161,173,civilization,6,3,9
3QO7EE372OOR1UOHEW4D8P23QSEBQU,"#10-10 ""We waited for decades, sometimes feeling we had been left alone, sometimes almost losing hope, sometimes feeling that we were the only one who protected civilization from aggression that came from the east.""",179,189,aggression,10,7,17
3QO7EE372OOR1UOHEW4D8P23QSEBQU,"#10-11 Hundreds of members of the public attended the ceremony, near the German border; the soldiers crossed in from Germany.",41,49,attended,1,2,3
3QO7EE372OOR1UOHEW4D8P23QSEBQU,"#10-11 Hundreds of members of the public attended the ceremony, near the German border; the soldiers crossed in from Germany.",54,62,ceremony,3,0,3
3QO7EE372OOR1UOHEW4D8P23QSEBQU,"#10-11 Hundreds of members of the public attended the ceremony, near the German border; the soldiers crossed in from Germany.",101,108,crossed,0,2,2
3QO7EE372OOR1UOHEW4D8P23QSEBQU,"#10-11 Hundreds of members of the public attended the ceremony, near the German border; the soldiers crossed in from Germany.",101,111,crossed in,0,1,1
3QO7EE372OOR1UOHEW4D8P23QSEBQU,"#10-12 Part of Operation Atlantic Resolve, the deployment is set to include Abrams tanks, Bradley Fighting Vehicles, and Paladin artillery.",15,24,Operation,1,0,1
3QO7EE372OOR1UOHEW4D8P23QSEBQU,"#10-12 Part of Operation Atlantic Resolve, the deployment is set to include Abrams tanks, Bradley Fighting Vehicles, and Paladin artillery.",15,41,Operation Atlantic Resolve,0,2,2
3QO7EE372OOR1UOHEW4D8P23QSEBQU,"#10-12 Part of Operation Atlantic Resolve, the deployment is set to include Abrams tanks, Bradley Fighting Vehicles, and Paladin artillery.",25,33,Atlantic,1,0,1
3QO7EE372OOR1UOHEW4D8P23QSEBQU,"#10-12 Part of Operation Atlantic Resolve, the deployment is set to include Abrams tanks, Bradley Fighting Vehicles, and Paladin artillery.",34,41,Resolve,5,1,6
3QO7EE372OOR1UOHEW4D8P23QSEBQU,"#10-12 Part of Operation Atlantic Resolve, the deployment is set to include Abrams tanks, Bradley Fighting Vehicles, and Paladin artillery.",47,57,deployment,8,9,17
3QO7EE372OOR1UOHEW4D8P23QSEBQU,"#10-12 Part of Operation Atlantic Resolve, the deployment is set to include Abrams tanks, Bradley Fighting Vehicles, and Paladin artillery.",76,88,Abrams tanks,1,0,1
3QO7EE372OOR1UOHEW4D8P23QSEBQU,"#10-12 Part of Operation Atlantic Resolve, the deployment is set to include Abrams tanks, Bradley Fighting Vehicles, and Paladin artillery.",90,115,Bradley Fighting Vehicles,1,0,1
3QO7EE372OOR1UOHEW4D8P23QSEBQU,"#10-12 Part of Operation Atlantic Resolve, the deployment is set to include Abrams tanks, Bradley Fighting Vehicles, and Paladin artillery.",107,115,Vehicles,2,0,2
3QO7EE372OOR1UOHEW4D8P23QSEBQU,"#10-12 Part of Operation Atlantic Resolve, the deployment is set to include Abrams tanks, Bradley Fighting Vehicles, and Paladin artillery.",121,128,Paladin,1,0,1
3QO7EE372OOR1UOHEW4D8P23QSEBQU,"#10-12 Part of Operation Atlantic Resolve, the deployment is set to include Abrams tanks, Bradley Fighting Vehicles, and Paladin artillery.",121,138,Paladin artillery,2,0,2
3QO7EE372OOR1UOHEW4D8P23QSEBQU,"#10-12 Part of Operation Atlantic Resolve, the deployment is set to include Abrams tanks, Bradley Fighting Vehicles, and Paladin artillery.",129,138,artillery,10,7,17
3QO7EE372OOR1UOHEW4D8P23QSEBQU,#10-13 It is the largest deployment of US troops to Europe since the Cold War ended.,25,35,deployment,5,3,8
3QO7EE372OOR1UOHEW4D8P23QSEBQU,#10-13 It is the largest deployment of US troops to Europe since the Cold War ended.,69,77,Cold War,0,2,2
3T8DUCXY0N7L5H1CXGKCMOI0MZ9T9F,#12-2 The unidentified man has been summonsed to appear at Maidstone Magistrates' Court on February 17.,10,22,unidentified,7,3,10
3T8DUCXY0N7L5H1CXGKCMOI0MZ9T9F,#12-2 The unidentified man has been summonsed to appear at Maidstone Magistrates' Court on February 17.,10,26,unidentified man,0,1,1
3T8DUCXY0N7L5H1CXGKCMOI0MZ9T9F,#12-2 The unidentified man has been summonsed to appear at Maidstone Magistrates' Court on February 17.,36,45,summonsed,10,10,20
3T8DUCXY0N7L5H1CXGKCMOI0MZ9T9F,#12-2 The unidentified man has been summonsed to appear at Maidstone Magistrates' Court on February 17.,49,55,appear,1,0,1
3T8DUCXY0N7L5H1CXGKCMOI0MZ9T9F,#12-2 The unidentified man has been summonsed to appear at Maidstone Magistrates' Court on February 17.,59,80,Maidstone Magistrates,0,1,1
3T8DUCXY0N7L5H1CXGKCMOI0MZ9T9F,#12-2 The unidentified man has been summonsed to appear at Maidstone Magistrates' Court on February 17.,59,86,Maidstone Magistrates Court,1,0,1
3T8DUCXY0N7L5H1CXGKCMOI0MZ9T9F,#12-2 The unidentified man has been summonsed to appear at Maidstone Magistrates' Court on February 17.,69,80,Magistrates,1,0,1
3T8DUCXY0N7L5H1CXGKCMOI0MZ9T9F,#12-3 As well as dangerous driving and causing serious injury by dangerous driving he also faces three counts of criminal damage covering the bridge and damaged vehicles.,17,34,dangerous driving,0,1,1
3T8DUCXY0N7L5H1CXGKCMOI0MZ9T9F,#12-3 As well as dangerous driving and causing serious injury by dangerous driving he also faces three counts of criminal damage covering the bridge and damaged vehicles.,55,61,injury,2,1,3
3T8DUCXY0N7L5H1CXGKCMOI0MZ9T9F,#12-3 As well as dangerous driving and causing serious injury by dangerous driving he also faces three counts of criminal damage covering the bridge and damaged vehicles.,65,82,dangerous driving,1,0,1
3T8DUCXY0N7L5H1CXGKCMOI0MZ9T9F,#12-3 As well as dangerous driving and causing serious injury by dangerous driving he also faces three counts of criminal damage covering the bridge and damaged vehicles.,113,121,criminal,1,1,2
3T8DUCXY0N7L5H1CXGKCMOI0MZ9T9F,#12-3 As well as dangerous driving and causing serious injury by dangerous driving he also faces three counts of criminal damage covering the bridge and damaged vehicles.,113,128,criminal damage,1,1,2
3T8DUCXY0N7L5H1CXGKCMOI0MZ9T9F,#12-3 As well as dangerous driving and causing serious injury by dangerous driving he also faces three counts of criminal damage covering the bridge and damaged vehicles.,122,128,damage,1,0,1
3T8DUCXY0N7L5H1CXGKCMOI0MZ9T9F,#12-3 As well as dangerous driving and causing serious injury by dangerous driving he also faces three counts of criminal damage covering the bridge and damaged vehicles.,153,160,damaged,1,0,1
3T8DUCXY0N7L5H1CXGKCMOI0MZ9T9F,#12-4 The nonfatal accident left an elderly motorcyclist with broken ribs after he came off his bike avoiding the 170 tonnes of falling debris.,10,18,nonfatal,7,6,13
3T8DUCXY0N7L5H1CXGKCMOI0MZ9T9F,#12-4 The nonfatal accident left an elderly motorcyclist with broken ribs after he came off his bike avoiding the 170 tonnes of falling debris.,10,27,nonfatal accident,0,2,2
3T8DUCXY0N7L5H1CXGKCMOI0MZ9T9F,#12-4 The nonfatal accident left an elderly motorcyclist with broken ribs after he came off his bike avoiding the 170 tonnes of falling debris.,36,43,elderly,0,2,2
3T8DUCXY0N7L5H1CXGKCMOI0MZ9T9F,#12-4 The nonfatal accident left an elderly motorcyclist with broken ribs after he came off his bike avoiding the 170 tonnes of falling debris.,36,56,elderly motorcyclist,1,0,1
3T8DUCXY0N7L5H1CXGKCMOI0MZ9T9F,#12-4 The nonfatal accident left an elderly motorcyclist with broken ribs after he came off his bike avoiding the 170 tonnes of falling debris.,44,56,motorcyclist,2,1,3
3T8DUCXY0N7L5H1CXGKCMOI0MZ9T9F,#12-4 The nonfatal accident left an elderly motorcyclist with broken ribs after he came off his bike avoiding the 170 tonnes of falling debris.,44,68,motorcyclist with broken,0,1,1
3T8DUCXY0N7L5H1CXGKCMOI0MZ9T9F,#12-4 The nonfatal accident left an elderly motorcyclist with broken ribs after he came off his bike avoiding the 170 tonnes of falling debris.,69,73,ribs,1,2,3
3T8DUCXY0N7L5H1CXGKCMOI0MZ9T9F,#12-4 The nonfatal accident left an elderly motorcyclist with broken ribs after he came off his bike avoiding the 170 tonnes of falling debris.,101,109,avoiding,2,1,3
3T8DUCXY0N7L5H1CXGKCMOI0MZ9T9F,#12-4 The nonfatal accident left an elderly motorcyclist with broken ribs after he came off his bike avoiding the 170 tonnes of falling debris.,118,124,tonnes,3,0,3
3T8DUCXY0N7L5H1CXGKCMOI0MZ9T9F,#12-4 The nonfatal accident left an elderly motorcyclist with broken ribs after he came off his bike avoiding the 170 tonnes of falling debris.,128,142,falling debris,0,2,2
3T8DUCXY0N7L5H1CXGKCMOI0MZ9T9F,#12-4 The nonfatal accident left an elderly motorcyclist with broken ribs after he came off his bike avoiding the 170 tonnes of falling debris.,136,142,debris,8,9,17
3T8DUCXY0N7L5H1CXGKCMOI0MZ9T9F,"#12-5 Two lorries were partially crushed by the collapse, which was triggered when a digger on the back of a lorry struck the concrete bridge.",10,17,lorries,3,2,5
3T8DUCXY0N7L5H1CXGKCMOI0MZ9T9F,"#12-5 Two lorries were partially crushed by the collapse, which was triggered when a digger on the back of a lorry struck the concrete bridge.",23,32,partially,5,0,5
3T8DUCXY0N7L5H1CXGKCMOI0MZ9T9F,"#12-5 Two lorries were partially crushed by the collapse, which was triggered when a digger on the back of a lorry struck the concrete bridge.",33,40,crushed,0,1,1
3T8DUCXY0N7L5H1CXGKCMOI0MZ9T9F,"#12-5 Two lorries were partially crushed by the collapse, which was triggered when a digger on the back of a lorry struck the concrete bridge.",48,56,collapse,4,2,6
3T8DUCXY0N7L5H1CXGKCMOI0MZ9T9F,"#12-5 Two lorries were partially crushed by the collapse, which was triggered when a digger on the back of a lorry struck the concrete bridge.",68,77,triggered,3,9,12
3T8DUCXY0N7L5H1CXGKCMOI0MZ9T9F,"#12-5 Two lorries were partially crushed by the collapse, which was triggered when a digger on the back of a lorry struck the concrete bridge.",68,91,triggered when a digger,0,1,1
3T8DUCXY0N7L5H1CXGKCMOI0MZ9T9F,"#12-5 Two lorries were partially crushed by the collapse, which was triggered when a digger on the back of a lorry struck the concrete bridge.",85,91,digger,2,5,7
3T8DUCXY0N7L5H1CXGKCMOI0MZ9T9F,"#12-5 Two lorries were partially crushed by the collapse, which was triggered when a digger on the back of a lorry struck the concrete bridge.",109,114,lorry,1,1,2
3T8DUCXY0N7L5H1CXGKCMOI0MZ9T9F,"#12-5 Two lorries were partially crushed by the collapse, which was triggered when a digger on the back of a lorry struck the concrete bridge.",109,121,lorry struck,1,0,1
3T8DUCXY0N7L5H1CXGKCMOI0MZ9T9F,"#12-5 Two lorries were partially crushed by the collapse, which was triggered when a digger on the back of a lorry struck the concrete bridge.",115,121,struck,0,1,1
3T8DUCXY0N7L5H1CXGKCMOI0MZ9T9F,"#12-5 Two lorries were partially crushed by the collapse, which was triggered when a digger on the back of a lorry struck the concrete bridge.",126,134,concrete,4,0,4
3T8DUCXY0N7L5H1CXGKCMOI0MZ9T9F,#12-6 Kent Police continue to investigate; Highways England have said they will await that probe's results before deciding if they will launch their own.,30,41,investigate,6,3,9
3T8DUCXY0N7L5H1CXGKCMOI0MZ9T9F,#12-6 Kent Police continue to investigate; Highways England have said they will await that probe's results before deciding if they will launch their own.,80,85,await,2,1,3
3T8DUCXY0N7L5H1CXGKCMOI0MZ9T9F,#12-6 Kent Police continue to investigate; Highways England have said they will await that probe's results before deciding if they will launch their own.,91,96,probe,0,1,1
3T8DUCXY0N7L5H1CXGKCMOI0MZ9T9F,#12-6 Kent Police continue to investigate; Highways England have said they will await that probe's results before deciding if they will launch their own.,91,97,probes,1,4,5
3T8DUCXY0N7L5H1CXGKCMOI0MZ9T9F,#12-6 Kent Police continue to investigate; Highways England have said they will await that probe's results before deciding if they will launch their own.,114,122,deciding,0,2,2
3T8DUCXY0N7L5H1CXGKCMOI0MZ9T9F,#12-6 Kent Police continue to investigate; Highways England have said they will await that probe's results before deciding if they will launch their own.,136,142,launch,3,2,5
3T8DUCXY0N7L5H1CXGKCMOI0MZ9T9F,"#12-7 The August 27 collapse caused millions of pounds of damage, and closed a major route for more than 24 hours.",20,28,collapse,1,2,3
3T8DUCXY0N7L5H1CXGKCMOI0MZ9T9F,"#12-7 The August 27 collapse caused millions of pounds of damage, and closed a major route for more than 24 hours.",36,44,millions,1,0,1
3T8DUCXY0N7L5H1CXGKCMOI0MZ9T9F,"#12-7 The August 27 collapse caused millions of pounds of damage, and closed a major route for more than 24 hours.",48,54,pounds,1,0,1
3T8DUCXY0N7L5H1CXGKCMOI0MZ9T9F,"#12-7 The August 27 collapse caused millions of pounds of damage, and closed a major route for more than 24 hours.",58,76,"damage, and closed",0,1,1
3T8DUCXY0N7L5H1CXGKCMOI0MZ9T9F,"#12-7 The August 27 collapse caused millions of pounds of damage, and closed a major route for more than 24 hours.",79,90,major route,0,1,1
3T8DUCXY0N7L5H1CXGKCMOI0MZ9T9F,"#12-7 The August 27 collapse caused millions of pounds of damage, and closed a major route for more than 24 hours.",85,90,route,2,1,3
3CMV9YRYP32MSG6GAJ9YPRMMOR0LJ0,#36-13 The accident led to discussions regarding the safety of the cars.,11,19,accident,1,0,1
3CMV9YRYP32MSG6GAJ9YPRMMOR0LJ0,#36-13 The accident led to discussions regarding the safety of the cars.,20,23,led,0,2,2
3CMV9YRYP32MSG6GAJ9YPRMMOR0LJ0,#36-13 The accident led to discussions regarding the safety of the cars.,27,38,discussions,6,3,9
3CMV9YRYP32MSG6GAJ9YPRMMOR0LJ0,#36-13 The accident led to discussions regarding the safety of the cars.,27,48,discussions regarding,0,1,1
3CMV9YRYP32MSG6GAJ9YPRMMOR0LJ0,#36-13 The accident led to discussions regarding the safety of the cars.,39,48,regarding,1,2,3
3CMV9YRYP32MSG6GAJ9YPRMMOR0LJ0,#36-14 A suggestion had been the addition of a canopy over the car's cockpit.,9,19,suggestion,2,4,6
3CMV9YRYP32MSG6GAJ9YPRMMOR0LJ0,#36-14 A suggestion had been the addition of a canopy over the car's cockpit.,33,41,addition,1,0,1
3CMV9YRYP32MSG6GAJ9YPRMMOR0LJ0,#36-14 A suggestion had been the addition of a canopy over the car's cockpit.,47,53,canopy,7,10,17
3CMV9YRYP32MSG6GAJ9YPRMMOR0LJ0,#36-14 A suggestion had been the addition of a canopy over the car's cockpit.,63,75,cars cockpit,1,0,1
3CMV9YRYP32MSG6GAJ9YPRMMOR0LJ0,#36-14 A suggestion had been the addition of a canopy over the car's cockpit.,69,76,cockpit,9,9,18
3CMV9YRYP32MSG6GAJ9YPRMMOR0LJ0,"#36-15 The topic had been controversial: while some supported it for safety reasons, others opposed it because of history, possibly affecting the aerodynamics of the car, limiting one's peripheral vision and movement inside the car, and worry about escaping an upside-down or burning car.",26,39,controversial,8,3,11
3CMV9YRYP32MSG6GAJ9YPRMMOR0LJ0,"#36-15 The topic had been controversial: while some supported it for safety reasons, others opposed it because of history, possibly affecting the aerodynamics of the car, limiting one's peripheral vision and movement inside the car, and worry about escaping an upside-down or burning car.",92,99,opposed,1,1,2
3CMV9YRYP32MSG6GAJ9YPRMMOR0LJ0,"#36-15 The topic had been controversial: while some supported it for safety reasons, others opposed it because of history, possibly affecting the aerodynamics of the car, limiting one's peripheral vision and movement inside the car, and worry about escaping an upside-down or burning car.",132,141,affecting,1,0,1
3CMV9YRYP32MSG6GAJ9YPRMMOR0LJ0,"#36-15 The topic had been controversial: while some supported it for safety reasons, others opposed it because of history, possibly affecting the aerodynamics of the car, limiting one's peripheral vision and movement inside the car, and worry about escaping an upside-down or burning car.",146,158,aerodynamics,10,10,20
3CMV9YRYP32MSG6GAJ9YPRMMOR0LJ0,"#36-15 The topic had been controversial: while some supported it for safety reasons, others opposed it because of history, possibly affecting the aerodynamics of the car, limiting one's peripheral vision and movement inside the car, and worry about escaping an upside-down or burning car.",184,196,s peripheral,1,0,1
3CMV9YRYP32MSG6GAJ9YPRMMOR0LJ0,"#36-15 The topic had been controversial: while some supported it for safety reasons, others opposed it because of history, possibly affecting the aerodynamics of the car, limiting one's peripheral vision and movement inside the car, and worry about escaping an upside-down or burning car.",186,196,peripheral,5,6,11
3CMV9YRYP32MSG6GAJ9YPRMMOR0LJ0,"#36-15 The topic had been controversial: while some supported it for safety reasons, others opposed it because of history, possibly affecting the aerodynamics of the car, limiting one's peripheral vision and movement inside the car, and worry about escaping an upside-down or burning car.",186,203,peripheral vision,5,2,7
3CMV9YRYP32MSG6GAJ9YPRMMOR0LJ0,"#36-15 The topic had been controversial: while some supported it for safety reasons, others opposed it because of history, possibly affecting the aerodynamics of the car, limiting one's peripheral vision and movement inside the car, and worry about escaping an upside-down or burning car.",197,203,vision,0,1,1
3CMV9YRYP32MSG6GAJ9YPRMMOR0LJ0,"#36-15 The topic had been controversial: while some supported it for safety reasons, others opposed it because of history, possibly affecting the aerodynamics of the car, limiting one's peripheral vision and movement inside the car, and worry about escaping an upside-down or burning car.",208,216,movement,1,0,1
3CMV9YRYP32MSG6GAJ9YPRMMOR0LJ0,"#36-15 The topic had been controversial: while some supported it for safety reasons, others opposed it because of history, possibly affecting the aerodynamics of the car, limiting one's peripheral vision and movement inside the car, and worry about escaping an upside-down or burning car.",249,257,escaping,0,1,1
3CMV9YRYP32MSG6GAJ9YPRMMOR0LJ0,"#36-15 The topic had been controversial: while some supported it for safety reasons, others opposed it because of history, possibly affecting the aerodynamics of the car, limiting one's peripheral vision and movement inside the car, and worry about escaping an upside-down or burning car.",261,272,upside-down,0,1,1
3CMV9YRYP32MSG6GAJ9YPRMMOR0LJ0,#36-16 Another had been to tether the nose cone to the car; Hunter-Reay mentioned renderings developed of a boomerang-like debris-deflector positioned in front of the driver.,27,33,tether,4,6,10
3CMV9YRYP32MSG6GAJ9YPRMMOR0LJ0,#36-16 Another had been to tether the nose cone to the car; Hunter-Reay mentioned renderings developed of a boomerang-like debris-deflector positioned in front of the driver.,38,47,nose cone,0,1,1
3CMV9YRYP32MSG6GAJ9YPRMMOR0LJ0,#36-16 Another had been to tether the nose cone to the car; Hunter-Reay mentioned renderings developed of a boomerang-like debris-deflector positioned in front of the driver.,43,47,cone,0,2,2
3CMV9YRYP32MSG6GAJ9YPRMMOR0LJ0,#36-16 Another had been to tether the nose cone to the car; Hunter-Reay mentioned renderings developed of a boomerang-like debris-deflector positioned in front of the driver.,60,71,Hunter-Reay,0,1,1
3CMV9YRYP32MSG6GAJ9YPRMMOR0LJ0,#36-16 Another had been to tether the nose cone to the car; Hunter-Reay mentioned renderings developed of a boomerang-like debris-deflector positioned in front of the driver.,72,92,mentioned renderings,1,0,1
3CMV9YRYP32MSG6GAJ9YPRMMOR0LJ0,#36-16 Another had been to tether the nose cone to the car; Hunter-Reay mentioned renderings developed of a boomerang-like debris-deflector positioned in front of the driver.,82,92,renderings,6,10,16
3CMV9YRYP32MSG6GAJ9YPRMMOR0LJ0,#36-16 Another had been to tether the nose cone to the car; Hunter-Reay mentioned renderings developed of a boomerang-like debris-deflector positioned in front of the driver.,82,102,renderings developed,1,0,1
3CMV9YRYP32MSG6GAJ9YPRMMOR0LJ0,#36-16 Another had been to tether the nose cone to the car; Hunter-Reay mentioned renderings developed of a boomerang-like debris-deflector positioned in front of the driver.,108,122,boomerang-like,5,4,9
3CMV9YRYP32MSG6GAJ9YPRMMOR0LJ0,#36-16 Another had been to tether the nose cone to the car; Hunter-Reay mentioned renderings developed of a boomerang-like debris-deflector positioned in front of the driver.,108,139,boomerang-like debris-deflector,4,2,6
3CMV9YRYP32MSG6GAJ9YPRMMOR0LJ0,#36-16 Another had been to tether the nose cone to the car; Hunter-Reay mentioned renderings developed of a boomerang-like debris-deflector positioned in front of the driver.,123,139,debris-deflector,6,6,12
3CMV9YRYP32MSG6GAJ9YPRMMOR0LJ0,#36-16 Another had been to tether the nose cone to the car; Hunter-Reay mentioned renderings developed of a boomerang-like debris-deflector positioned in front of the driver.,140,150,positioned,2,1,3
3CMV9YRYP32MSG6GAJ9YPRMMOR0LJ0,"#36-17 A further question raised had been regarding Wilson's height: at 6 feet, 3.5 inches (1.92 m) tall, Wilson was the tallest IndyCar Series driver; however, driver Josef Newgarden refuted the statement, saying, ""They make a regulation for how tall you can be inside the car sitting compared to the roll hoop [...] It's safe for any height for any driver that gets in the car.""",121,128,tallest,0,1,1
3CMV9YRYP32MSG6GAJ9YPRMMOR0LJ0,"#36-17 A further question raised had been regarding Wilson's height: at 6 feet, 3.5 inches (1.92 m) tall, Wilson was the tallest IndyCar Series driver; however, driver Josef Newgarden refuted the statement, saying, ""They make a regulation for how tall you can be inside the car sitting compared to the roll hoop [...] It's safe for any height for any driver that gets in the car.""",129,136,IndyCar,1,1,2
3CMV9YRYP32MSG6GAJ9YPRMMOR0LJ0,"#36-17 A further question raised had been regarding Wilson's height: at 6 feet, 3.5 inches (1.92 m) tall, Wilson was the tallest IndyCar Series driver; however, driver Josef Newgarden refuted the statement, saying, ""They make a regulation for how tall you can be inside the car sitting compared to the roll hoop [...] It's safe for any height for any driver that gets in the car.""",174,183,Newgarden,0,1,1
3CMV9YRYP32MSG6GAJ9YPRMMOR0LJ0,"#36-17 A further question raised had been regarding Wilson's height: at 6 feet, 3.5 inches (1.92 m) tall, Wilson was the tallest IndyCar Series driver; however, driver Josef Newgarden refuted the statement, saying, ""They make a regulation for how tall you can be inside the car sitting compared to the roll hoop [...] It's safe for any height for any driver that gets in the car.""",184,191,refuted,7,6,13
3CMV9YRYP32MSG6GAJ9YPRMMOR0LJ0,"#36-17 A further question raised had been regarding Wilson's height: at 6 feet, 3.5 inches (1.92 m) tall, Wilson was the tallest IndyCar Series driver; however, driver Josef Newgarden refuted the statement, saying, ""They make a regulation for how tall you can be inside the car sitting compared to the roll hoop [...] It's safe for any height for any driver that gets in the car.""",184,205,refuted the statement,0,1,1
3CMV9YRYP32MSG6GAJ9YPRMMOR0LJ0,"#36-17 A further question raised had been regarding Wilson's height: at 6 feet, 3.5 inches (1.92 m) tall, Wilson was the tallest IndyCar Series driver; however, driver Josef Newgarden refuted the statement, saying, ""They make a regulation for how tall you can be inside the car sitting compared to the roll hoop [...] It's safe for any height for any driver that gets in the car.""",196,205,statement,1,0,1
3CMV9YRYP32MSG6GAJ9YPRMMOR0LJ0,"#36-17 A further question raised had been regarding Wilson's height: at 6 feet, 3.5 inches (1.92 m) tall, Wilson was the tallest IndyCar Series driver; however, driver Josef Newgarden refuted the statement, saying, ""They make a regulation for how tall you can be inside the car sitting compared to the roll hoop [...] It's safe for any height for any driver that gets in the car.""",228,238,regulation,3,1,4
3CMV9YRYP32MSG6GAJ9YPRMMOR0LJ0,"#36-17 A further question raised had been regarding Wilson's height: at 6 feet, 3.5 inches (1.92 m) tall, Wilson was the tallest IndyCar Series driver; however, driver Josef Newgarden refuted the statement, saying, ""They make a regulation for how tall you can be inside the car sitting compared to the roll hoop [...] It's safe for any height for any driver that gets in the car.""",302,306,roll,0,1,1
3CMV9YRYP32MSG6GAJ9YPRMMOR0LJ0,"#36-17 A further question raised had been regarding Wilson's height: at 6 feet, 3.5 inches (1.92 m) tall, Wilson was the tallest IndyCar Series driver; however, driver Josef Newgarden refuted the statement, saying, ""They make a regulation for how tall you can be inside the car sitting compared to the roll hoop [...] It's safe for any height for any driver that gets in the car.""",302,311,roll hoop,1,1,2
3CMV9YRYP32MSG6GAJ9YPRMMOR0LJ0,"#36-17 A further question raised had been regarding Wilson's height: at 6 feet, 3.5 inches (1.92 m) tall, Wilson was the tallest IndyCar Series driver; however, driver Josef Newgarden refuted the statement, saying, ""They make a regulation for how tall you can be inside the car sitting compared to the roll hoop [...] It's safe for any height for any driver that gets in the car.""",307,311,hoop,0,1,1
3XU80RHWHZH0RQGA1KNDX8VSK8F44Z,"#18-12 As a result of his activity, since 1997 Adnan has been arrested reportedly around ten times, and has gone on several hunger strikes, one of which lasted 28 days, while another lasted 66 days and after his release he went on strike for another 12 days as a token of sympathy for the remaining Palestinian detainees in Israeli prisons.",26,34,activity,0,2,2
3XU80RHWHZH0RQGA1KNDX8VSK8F44Z,"#18-12 As a result of his activity, since 1997 Adnan has been arrested reportedly around ten times, and has gone on several hunger strikes, one of which lasted 28 days, while another lasted 66 days and after his release he went on strike for another 12 days as a token of sympathy for the remaining Palestinian detainees in Israeli prisons.",47,52,Adnan,1,0,1
3XU80RHWHZH0RQGA1KNDX8VSK8F44Z,"#18-12 As a result of his activity, since 1997 Adnan has been arrested reportedly around ten times, and has gone on several hunger strikes, one of which lasted 28 days, while another lasted 66 days and after his release he went on strike for another 12 days as a token of sympathy for the remaining Palestinian detainees in Israeli prisons.",62,70,arrested,3,1,4
3XU80RHWHZH0RQGA1KNDX8VSK8F44Z,"#18-12 As a result of his activity, since 1997 Adnan has been arrested reportedly around ten times, and has gone on several hunger strikes, one of which lasted 28 days, while another lasted 66 days and after his release he went on strike for another 12 days as a token of sympathy for the remaining Palestinian detainees in Israeli prisons.",62,81,arrested reportedly,1,1,2
3XU80RHWHZH0RQGA1KNDX8VSK8F44Z,"#18-12 As a result of his activity, since 1997 Adnan has been arrested reportedly around ten times, and has gone on several hunger strikes, one of which lasted 28 days, while another lasted 66 days and after his release he went on strike for another 12 days as a token of sympathy for the remaining Palestinian detainees in Israeli prisons.",71,81,reportedly,1,3,4
3XU80RHWHZH0RQGA1KNDX8VSK8F44Z,"#18-12 As a result of his activity, since 1997 Adnan has been arrested reportedly around ten times, and has gone on several hunger strikes, one of which lasted 28 days, while another lasted 66 days and after his release he went on strike for another 12 days as a token of sympathy for the remaining Palestinian detainees in Israeli prisons.",124,138,hunger strikes,4,4,8
3XU80RHWHZH0RQGA1KNDX8VSK8F44Z,"#18-12 As a result of his activity, since 1997 Adnan has been arrested reportedly around ten times, and has gone on several hunger strikes, one of which lasted 28 days, while another lasted 66 days and after his release he went on strike for another 12 days as a token of sympathy for the remaining Palestinian detainees in Israeli prisons.",131,138,strikes,2,0,2
3XU80RHWHZH0RQGA1KNDX8VSK8F44Z,"#18-12 As a result of his activity, since 1997 Adnan has been arrested reportedly around ten times, and has gone on several hunger strikes, one of which lasted 28 days, while another lasted 66 days and after his release he went on strike for another 12 days as a token of sympathy for the remaining Palestinian detainees in Israeli prisons.",153,159,lasted,0,1,1
3XU80RHWHZH0RQGA1KNDX8VSK8F44Z,"#18-12 As a result of his activity, since 1997 Adnan has been arrested reportedly around ten times, and has gone on several hunger strikes, one of which lasted 28 days, while another lasted 66 days and after his release he went on strike for another 12 days as a token of sympathy for the remaining Palestinian detainees in Israeli prisons.",183,189,lasted,0,2,2
3XU80RHWHZH0RQGA1KNDX8VSK8F44Z,"#18-12 As a result of his activity, since 1997 Adnan has been arrested reportedly around ten times, and has gone on several hunger strikes, one of which lasted 28 days, while another lasted 66 days and after his release he went on strike for another 12 days as a token of sympathy for the remaining Palestinian detainees in Israeli prisons.",212,219,release,1,2,3
3XU80RHWHZH0RQGA1KNDX8VSK8F44Z,"#18-12 As a result of his activity, since 1997 Adnan has been arrested reportedly around ten times, and has gone on several hunger strikes, one of which lasted 28 days, while another lasted 66 days and after his release he went on strike for another 12 days as a token of sympathy for the remaining Palestinian detainees in Israeli prisons.",263,268,token,4,1,5
3XU80RHWHZH0RQGA1KNDX8VSK8F44Z,"#18-12 As a result of his activity, since 1997 Adnan has been arrested reportedly around ten times, and has gone on several hunger strikes, one of which lasted 28 days, while another lasted 66 days and after his release he went on strike for another 12 days as a token of sympathy for the remaining Palestinian detainees in Israeli prisons.",263,280,token of sympathy,4,1,5
3XU80RHWHZH0RQGA1KNDX8VSK8F44Z,"#18-12 As a result of his activity, since 1997 Adnan has been arrested reportedly around ten times, and has gone on several hunger strikes, one of which lasted 28 days, while another lasted 66 days and after his release he went on strike for another 12 days as a token of sympathy for the remaining Palestinian detainees in Israeli prisons.",272,280,sympathy,6,5,11
3XU80RHWHZH0RQGA1KNDX8VSK8F44Z,"#18-12 As a result of his activity, since 1997 Adnan has been arrested reportedly around ten times, and has gone on several hunger strikes, one of which lasted 28 days, while another lasted 66 days and after his release he went on strike for another 12 days as a token of sympathy for the remaining Palestinian detainees in Israeli prisons.",289,298,remaining,2,1,3
3XU80RHWHZH0RQGA1KNDX8VSK8F44Z,"#18-12 As a result of his activity, since 1997 Adnan has been arrested reportedly around ten times, and has gone on several hunger strikes, one of which lasted 28 days, while another lasted 66 days and after his release he went on strike for another 12 days as a token of sympathy for the remaining Palestinian detainees in Israeli prisons.",289,320,remaining Palestinian detainees,1,0,1
3XU80RHWHZH0RQGA1KNDX8VSK8F44Z,"#18-12 As a result of his activity, since 1997 Adnan has been arrested reportedly around ten times, and has gone on several hunger strikes, one of which lasted 28 days, while another lasted 66 days and after his release he went on strike for another 12 days as a token of sympathy for the remaining Palestinian detainees in Israeli prisons.",299,320,Palestinian detainees,1,1,2
3XU80RHWHZH0RQGA1KNDX8VSK8F44Z,"#18-12 As a result of his activity, since 1997 Adnan has been arrested reportedly around ten times, and has gone on several hunger strikes, one of which lasted 28 days, while another lasted 66 days and after his release he went on strike for another 12 days as a token of sympathy for the remaining Palestinian detainees in Israeli prisons.",311,320,detainees,10,10,20
3XU80RHWHZH0RQGA1KNDX8VSK8F44Z,"#19-1 C-130 Hercules crashes in Medan, Indonesia On Tuesday, an Indonesian Air Force C-130 Hercules crashed in the city of Medan, Indonesia.",21,28,crashes,2,0,2
3XU80RHWHZH0RQGA1KNDX8VSK8F44Z,"#19-1 C-130 Hercules crashes in Medan, Indonesia On Tuesday, an Indonesian Air Force C-130 Hercules crashed in the city of Medan, Indonesia.",64,74,Indonesian,1,0,1
3XU80RHWHZH0RQGA1KNDX8VSK8F44Z,"#19-1 C-130 Hercules crashes in Medan, Indonesia On Tuesday, an Indonesian Air Force C-130 Hercules crashed in the city of Medan, Indonesia.",100,107,crashed,1,5,6
3XU80RHWHZH0RQGA1KNDX8VSK8F44Z,"#19-2 All 122 people on board were killed as well as people on the ground in the city in North Sumatra, according to North Sumatra police Major A. Tarigan.",24,29,board,0,1,1
3XU80RHWHZH0RQGA1KNDX8VSK8F44Z,"#19-2 All 122 people on board were killed as well as people on the ground in the city in North Sumatra, according to North Sumatra police Major A. Tarigan.",95,102,Sumatra,1,0,1
3XU80RHWHZH0RQGA1KNDX8VSK8F44Z,"#19-2 All 122 people on board were killed as well as people on the ground in the city in North Sumatra, according to North Sumatra police Major A. Tarigan.",104,113,according,0,1,1
3XU80RHWHZH0RQGA1KNDX8VSK8F44Z,"#19-2 All 122 people on board were killed as well as people on the ground in the city in North Sumatra, according to North Sumatra police Major A. Tarigan.",117,130,North Sumatra,1,0,1
3XU80RHWHZH0RQGA1KNDX8VSK8F44Z,"#19-2 All 122 people on board were killed as well as people on the ground in the city in North Sumatra, according to North Sumatra police Major A. Tarigan.",147,154,Tarigan,1,0,1
3XU80RHWHZH0RQGA1KNDX8VSK8F44Z,#19-3 Officials said the plane exploded on impact into a big fireball.,6,15,Officials,1,0,1
3XU80RHWHZH0RQGA1KNDX8VSK8F44Z,#19-3 Officials said the plane exploded on impact into a big fireball.,31,39,exploded,4,7,11
3XU80RHWHZH0RQGA1KNDX8VSK8F44Z,#19-3 Officials said the plane exploded on impact into a big fireball.,43,49,impact,2,6,8
3XU80RHWHZH0RQGA1KNDX8VSK8F44Z,#19-3 Officials said the plane exploded on impact into a big fireball.,57,69,big fireball,1,0,1
3XU80RHWHZH0RQGA1KNDX8VSK8F44Z,#19-3 Officials said the plane exploded on impact into a big fireball.,61,69,fireball,2,5,7
3XU80RHWHZH0RQGA1KNDX8VSK8F44Z,#19-4 The military said the plane took off at 12:08 pm local time (0508 UTC) and crashed five kilometers away a couple of minutes later.,10,18,military,1,0,1
3XU80RHWHZH0RQGA1KNDX8VSK8F44Z,#19-4 The military said the plane took off at 12:08 pm local time (0508 UTC) and crashed five kilometers away a couple of minutes later.,34,42,took off,0,2,2
3XU80RHWHZH0RQGA1KNDX8VSK8F44Z,#19-4 The military said the plane took off at 12:08 pm local time (0508 UTC) and crashed five kilometers away a couple of minutes later.,81,88,crashed,0,3,3
3XU80RHWHZH0RQGA1KNDX8VSK8F44Z,#19-4 The military said the plane took off at 12:08 pm local time (0508 UTC) and crashed five kilometers away a couple of minutes later.,94,104,kilometers,3,0,3
3XU80RHWHZH0RQGA1KNDX8VSK8F44Z,#19-4 The military said the plane took off at 12:08 pm local time (0508 UTC) and crashed five kilometers away a couple of minutes later.,110,121,a couple of,0,1,1
3C8QQOM6JP2QX5MAS1OYDQ7MBCBLIO,#35-19 That decision was the one challenged unsuccessfully in the High Court.,12,20,decision,4,0,4
3C8QQOM6JP2QX5MAS1OYDQ7MBCBLIO,#35-19 That decision was the one challenged unsuccessfully in the High Court.,33,43,challenged,4,3,7
3C8QQOM6JP2QX5MAS1OYDQ7MBCBLIO,#35-19 That decision was the one challenged unsuccessfully in the High Court.,44,58,unsuccessfully,7,3,10
3C8QQOM6JP2QX5MAS1OYDQ7MBCBLIO,#35-19 That decision was the one challenged unsuccessfully in the High Court.,66,76,High Court,1,0,1
3C8QQOM6JP2QX5MAS1OYDQ7MBCBLIO,"#35-20 The case pits the two accused trying to defend a death penalty case against the possibility of jeopardising international relations; Thai police co-operated, but only in light of an agreement the report would be confidential.",16,20,pits,0,6,6
3C8QQOM6JP2QX5MAS1OYDQ7MBCBLIO,"#35-20 The case pits the two accused trying to defend a death penalty case against the possibility of jeopardising international relations; Thai police co-operated, but only in light of an agreement the report would be confidential.",16,36,pits the two accused,1,0,1
3C8QQOM6JP2QX5MAS1OYDQ7MBCBLIO,"#35-20 The case pits the two accused trying to defend a death penalty case against the possibility of jeopardising international relations; Thai police co-operated, but only in light of an agreement the report would be confidential.",29,36,accused,4,3,7
3C8QQOM6JP2QX5MAS1OYDQ7MBCBLIO,"#35-20 The case pits the two accused trying to defend a death penalty case against the possibility of jeopardising international relations; Thai police co-operated, but only in light of an agreement the report would be confidential.",47,53,defend,0,1,1
3C8QQOM6JP2QX5MAS1OYDQ7MBCBLIO,"#35-20 The case pits the two accused trying to defend a death penalty case against the possibility of jeopardising international relations; Thai police co-operated, but only in light of an agreement the report would be confidential.",56,69,death penalty,0,1,1
3C8QQOM6JP2QX5MAS1OYDQ7MBCBLIO,"#35-20 The case pits the two accused trying to defend a death penalty case against the possibility of jeopardising international relations; Thai police co-operated, but only in light of an agreement the report would be confidential.",87,98,possibility,1,1,2
3C8QQOM6JP2QX5MAS1OYDQ7MBCBLIO,"#35-20 The case pits the two accused trying to defend a death penalty case against the possibility of jeopardising international relations; Thai police co-operated, but only in light of an agreement the report would be confidential.",102,114,jeopardising,10,10,20
3C8QQOM6JP2QX5MAS1OYDQ7MBCBLIO,"#35-20 The case pits the two accused trying to defend a death penalty case against the possibility of jeopardising international relations; Thai police co-operated, but only in light of an agreement the report would be confidential.",115,128,international,2,0,2
3C8QQOM6JP2QX5MAS1OYDQ7MBCBLIO,"#35-20 The case pits the two accused trying to defend a death penalty case against the possibility of jeopardising international relations; Thai police co-operated, but only in light of an agreement the report would be confidential.",115,138,international relations,1,0,1
3C8QQOM6JP2QX5MAS1OYDQ7MBCBLIO,"#35-20 The case pits the two accused trying to defend a death penalty case against the possibility of jeopardising international relations; Thai police co-operated, but only in light of an agreement the report would be confidential.",129,138,relations,1,0,1
3C8QQOM6JP2QX5MAS1OYDQ7MBCBLIO,"#35-20 The case pits the two accused trying to defend a death penalty case against the possibility of jeopardising international relations; Thai police co-operated, but only in light of an agreement the report would be confidential.",152,163,co-operated,2,0,2
3C8QQOM6JP2QX5MAS1OYDQ7MBCBLIO,"#35-20 The case pits the two accused trying to defend a death penalty case against the possibility of jeopardising international relations; Thai police co-operated, but only in light of an agreement the report would be confidential.",177,182,light,0,1,1
3C8QQOM6JP2QX5MAS1OYDQ7MBCBLIO,"#35-20 The case pits the two accused trying to defend a death penalty case against the possibility of jeopardising international relations; Thai police co-operated, but only in light of an agreement the report would be confidential.",219,231,confidential,7,7,14
3C8QQOM6JP2QX5MAS1OYDQ7MBCBLIO,"#35-21 Legal charity Reprieve, who assisted the two men, said in a statement ""Concerns about the conduct of the Thai investigation and the safety of any convictions resulting have been raised from the very beginning[...] only the defence lawyers in Thailand are in a position to judge whether the information could be of assistance.""",13,20,charity,2,1,3
3C8QQOM6JP2QX5MAS1OYDQ7MBCBLIO,"#35-21 Legal charity Reprieve, who assisted the two men, said in a statement ""Concerns about the conduct of the Thai investigation and the safety of any convictions resulting have been raised from the very beginning[...] only the defence lawyers in Thailand are in a position to judge whether the information could be of assistance.""",21,29,Reprieve,4,4,8
3C8QQOM6JP2QX5MAS1OYDQ7MBCBLIO,"#35-21 Legal charity Reprieve, who assisted the two men, said in a statement ""Concerns about the conduct of the Thai investigation and the safety of any convictions resulting have been raised from the very beginning[...] only the defence lawyers in Thailand are in a position to judge whether the information could be of assistance.""",78,86,Concerns,1,1,2
3C8QQOM6JP2QX5MAS1OYDQ7MBCBLIO,"#35-21 Legal charity Reprieve, who assisted the two men, said in a statement ""Concerns about the conduct of the Thai investigation and the safety of any convictions resulting have been raised from the very beginning[...] only the defence lawyers in Thailand are in a position to judge whether the information could be of assistance.""",97,104,conduct,1,0,1
3C8QQOM6JP2QX5MAS1OYDQ7MBCBLIO,"#35-21 Legal charity Reprieve, who assisted the two men, said in a statement ""Concerns about the conduct of the Thai investigation and the safety of any convictions resulting have been raised from the very beginning[...] only the defence lawyers in Thailand are in a position to judge whether the information could be of assistance.""",117,130,investigation,3,0,3
3C8QQOM6JP2QX5MAS1OYDQ7MBCBLIO,"#35-21 Legal charity Reprieve, who assisted the two men, said in a statement ""Concerns about the conduct of the Thai investigation and the safety of any convictions resulting have been raised from the very beginning[...] only the defence lawyers in Thailand are in a position to judge whether the information could be of assistance.""",153,164,convictions,7,7,14
3C8QQOM6JP2QX5MAS1OYDQ7MBCBLIO,"#35-21 Legal charity Reprieve, who assisted the two men, said in a statement ""Concerns about the conduct of the Thai investigation and the safety of any convictions resulting have been raised from the very beginning[...] only the defence lawyers in Thailand are in a position to judge whether the information could be of assistance.""",185,191,raised,0,1,1
3C8QQOM6JP2QX5MAS1OYDQ7MBCBLIO,"#35-21 Legal charity Reprieve, who assisted the two men, said in a statement ""Concerns about the conduct of the Thai investigation and the safety of any convictions resulting have been raised from the very beginning[...] only the defence lawyers in Thailand are in a position to judge whether the information could be of assistance.""",230,237,defence,3,1,4
3C8QQOM6JP2QX5MAS1OYDQ7MBCBLIO,"#35-21 Legal charity Reprieve, who assisted the two men, said in a statement ""Concerns about the conduct of the Thai investigation and the safety of any convictions resulting have been raised from the very beginning[...] only the defence lawyers in Thailand are in a position to judge whether the information could be of assistance.""",230,245,defence lawyers,1,0,1
3C8QQOM6JP2QX5MAS1OYDQ7MBCBLIO,"#35-21 Legal charity Reprieve, who assisted the two men, said in a statement ""Concerns about the conduct of the Thai investigation and the safety of any convictions resulting have been raised from the very beginning[...] only the defence lawyers in Thailand are in a position to judge whether the information could be of assistance.""",249,257,Thailand,0,1,1
3C8QQOM6JP2QX5MAS1OYDQ7MBCBLIO,"#35-21 Legal charity Reprieve, who assisted the two men, said in a statement ""Concerns about the conduct of the Thai investigation and the safety of any convictions resulting have been raised from the very beginning[...] only the defence lawyers in Thailand are in a position to judge whether the information could be of assistance.""",279,284,judge,0,1,1
3C8QQOM6JP2QX5MAS1OYDQ7MBCBLIO,"#35-21 Legal charity Reprieve, who assisted the two men, said in a statement ""Concerns about the conduct of the Thai investigation and the safety of any convictions resulting have been raised from the very beginning[...] only the defence lawyers in Thailand are in a position to judge whether the information could be of assistance.""",321,331,assistance,1,2,3
3C8QQOM6JP2QX5MAS1OYDQ7MBCBLIO,"#35-22 Mr Justice Green's judgement acknowledges he did not know ""how the accused might structure their defences"" or details about what evidence had been or would be involved.",36,48,acknowledges,9,5,14
3C8QQOM6JP2QX5MAS1OYDQ7MBCBLIO,"#35-22 Mr Justice Green's judgement acknowledges he did not know ""how the accused might structure their defences"" or details about what evidence had been or would be involved.",66,112,how the accused might structure their defences,1,0,1
3C8QQOM6JP2QX5MAS1OYDQ7MBCBLIO,"#35-22 Mr Justice Green's judgement acknowledges he did not know ""how the accused might structure their defences"" or details about what evidence had been or would be involved.",74,81,accused,3,1,4
3C8QQOM6JP2QX5MAS1OYDQ7MBCBLIO,"#35-22 Mr Justice Green's judgement acknowledges he did not know ""how the accused might structure their defences"" or details about what evidence had been or would be involved.",88,97,structure,1,1,2
3C8QQOM6JP2QX5MAS1OYDQ7MBCBLIO,"#35-22 Mr Justice Green's judgement acknowledges he did not know ""how the accused might structure their defences"" or details about what evidence had been or would be involved.",104,112,defences,1,1,2
3C8QQOM6JP2QX5MAS1OYDQ7MBCBLIO,"#35-22 Mr Justice Green's judgement acknowledges he did not know ""how the accused might structure their defences"" or details about what evidence had been or would be involved.",136,144,evidence,4,4,8
3C8QQOM6JP2QX5MAS1OYDQ7MBCBLIO,"#35-22 Mr Justice Green's judgement acknowledges he did not know ""how the accused might structure their defences"" or details about what evidence had been or would be involved.",166,174,involved,0,2,2
3BPP3MA3TCLEH0KOWIY7SB9UJJ4EL8,"#35-12 Cameron and Chan-o-cha arranged for an observer team from the Metropolitan Police to conduct an inspection of the Thai probe, based on powers in the Police Act 1996.",19,29,Chan-o-cha,0,1,1
3BPP3MA3TCLEH0KOWIY7SB9UJJ4EL8,"#35-12 Cameron and Chan-o-cha arranged for an observer team from the Metropolitan Police to conduct an inspection of the Thai probe, based on powers in the Police Act 1996.",30,38,arranged,2,3,5
3BPP3MA3TCLEH0KOWIY7SB9UJJ4EL8,"#35-12 Cameron and Chan-o-cha arranged for an observer team from the Metropolitan Police to conduct an inspection of the Thai probe, based on powers in the Police Act 1996.",46,54,observer,6,0,6
3BPP3MA3TCLEH0KOWIY7SB9UJJ4EL8,"#35-12 Cameron and Chan-o-cha arranged for an observer team from the Metropolitan Police to conduct an inspection of the Thai probe, based on powers in the Police Act 1996.",46,59,observer team,1,0,1
3BPP3MA3TCLEH0KOWIY7SB9UJJ4EL8,"#35-12 Cameron and Chan-o-cha arranged for an observer team from the Metropolitan Police to conduct an inspection of the Thai probe, based on powers in the Police Act 1996.",69,81,Metropolitan,1,0,1
3BPP3MA3TCLEH0KOWIY7SB9UJJ4EL8,"#35-12 Cameron and Chan-o-cha arranged for an observer team from the Metropolitan Police to conduct an inspection of the Thai probe, based on powers in the Police Act 1996.",69,88,Metropolitan Police,1,0,1
3BPP3MA3TCLEH0KOWIY7SB9UJJ4EL8,"#35-12 Cameron and Chan-o-cha arranged for an observer team from the Metropolitan Police to conduct an inspection of the Thai probe, based on powers in the Police Act 1996.",92,99,conduct,2,1,3
3BPP3MA3TCLEH0KOWIY7SB9UJJ4EL8,"#35-12 Cameron and Chan-o-cha arranged for an observer team from the Metropolitan Police to conduct an inspection of the Thai probe, based on powers in the Police Act 1996.",92,113,conduct an inspection,1,0,1
3BPP3MA3TCLEH0KOWIY7SB9UJJ4EL8,"#35-12 Cameron and Chan-o-cha arranged for an observer team from the Metropolitan Police to conduct an inspection of the Thai probe, based on powers in the Police Act 1996.",103,113,inspection,4,2,6
3BPP3MA3TCLEH0KOWIY7SB9UJJ4EL8,"#35-12 Cameron and Chan-o-cha arranged for an observer team from the Metropolitan Police to conduct an inspection of the Thai probe, based on powers in the Police Act 1996.",121,131,Thai probe,1,1,2
3BPP3MA3TCLEH0KOWIY7SB9UJJ4EL8,"#35-12 Cameron and Chan-o-cha arranged for an observer team from the Metropolitan Police to conduct an inspection of the Thai probe, based on powers in the Police Act 1996.",126,131,probe,4,6,10
3BPP3MA3TCLEH0KOWIY7SB9UJJ4EL8,#35-13 A team was duly dispatched and prepared a report with the intent to use it for assisting the victims' families.,18,22,duly,0,1,1
3BPP3MA3TCLEH0KOWIY7SB9UJJ4EL8,#35-13 A team was duly dispatched and prepared a report with the intent to use it for assisting the victims' families.,18,33,duly dispatched,2,1,3
3BPP3MA3TCLEH0KOWIY7SB9UJJ4EL8,#35-13 A team was duly dispatched and prepared a report with the intent to use it for assisting the victims' families.,23,33,dispatched,10,6,16
3BPP3MA3TCLEH0KOWIY7SB9UJJ4EL8,#35-13 A team was duly dispatched and prepared a report with the intent to use it for assisting the victims' families.,65,71,intent,4,4,8
3BPP3MA3TCLEH0KOWIY7SB9UJJ4EL8,#35-13 A team was duly dispatched and prepared a report with the intent to use it for assisting the victims' families.,86,95,assisting,1,1,2
3BPP3MA3TCLEH0KOWIY7SB9UJJ4EL8,#35-13 A team was duly dispatched and prepared a report with the intent to use it for assisting the victims' families.,86,107,assisting the victims,0,1,1
3BPP3MA3TCLEH0KOWIY7SB9UJJ4EL8,#35-13 A team was duly dispatched and prepared a report with the intent to use it for assisting the victims' families.,100,107,victims,2,1,3
3BPP3MA3TCLEH0KOWIY7SB9UJJ4EL8,"#35-14 UK police were expressly forbidden, at a ministerial level, to provide any assistance to Thai authorities as the case involves the death penalty.",22,31,expressly,5,2,7
3BPP3MA3TCLEH0KOWIY7SB9UJJ4EL8,"#35-14 UK police were expressly forbidden, at a ministerial level, to provide any assistance to Thai authorities as the case involves the death penalty.",22,41,expressly forbidden,2,2,4
3BPP3MA3TCLEH0KOWIY7SB9UJJ4EL8,"#35-14 UK police were expressly forbidden, at a ministerial level, to provide any assistance to Thai authorities as the case involves the death penalty.",32,41,forbidden,5,6,11
3BPP3MA3TCLEH0KOWIY7SB9UJJ4EL8,"#35-14 UK police were expressly forbidden, at a ministerial level, to provide any assistance to Thai authorities as the case involves the death penalty.",48,59,ministerial,10,1,11
3BPP3MA3TCLEH0KOWIY7SB9UJJ4EL8,"#35-14 UK police were expressly forbidden, at a ministerial level, to provide any assistance to Thai authorities as the case involves the death penalty.",48,65,ministerial level,1,0,1
3BPP3MA3TCLEH0KOWIY7SB9UJJ4EL8,"#35-14 UK police were expressly forbidden, at a ministerial level, to provide any assistance to Thai authorities as the case involves the death penalty.",82,92,assistance,1,1,2
3BPP3MA3TCLEH0KOWIY7SB9UJJ4EL8,"#35-14 UK police were expressly forbidden, at a ministerial level, to provide any assistance to Thai authorities as the case involves the death penalty.",101,112,authorities,6,2,8
3BPP3MA3TCLEH0KOWIY7SB9UJJ4EL8,"#35-14 UK police were expressly forbidden, at a ministerial level, to provide any assistance to Thai authorities as the case involves the death penalty.",125,133,involves,0,1,1
3BPP3MA3TCLEH0KOWIY7SB9UJJ4EL8,"#35-14 UK police were expressly forbidden, at a ministerial level, to provide any assistance to Thai authorities as the case involves the death penalty.",138,151,death penalty,0,1,1
3BPP3MA3TCLEH0KOWIY7SB9UJJ4EL8,"#35-14 UK police were expressly forbidden, at a ministerial level, to provide any assistance to Thai authorities as the case involves the death penalty.",144,151,penalty,0,1,1
3BPP3MA3TCLEH0KOWIY7SB9UJJ4EL8,"#35-15 Due to established UK policy on foreign death penalty cases, the report was also not shared with Thailand.",14,25,established,2,0,2
3BPP3MA3TCLEH0KOWIY7SB9UJJ4EL8,"#35-15 Due to established UK policy on foreign death penalty cases, the report was also not shared with Thailand.",39,46,foreign,2,0,2
3BPP3MA3TCLEH0KOWIY7SB9UJJ4EL8,"#35-15 Due to established UK policy on foreign death penalty cases, the report was also not shared with Thailand.",39,60,foreign death penalty,0,1,1
3BPP3MA3TCLEH0KOWIY7SB9UJJ4EL8,"#35-15 Due to established UK policy on foreign death penalty cases, the report was also not shared with Thailand.",53,60,penalty,1,1,2
3BPP3MA3TCLEH0KOWIY7SB9UJJ4EL8,#35-16 It is this report that Lin and Phyo were seeking.,38,42,Phyo,1,0,1
3BPP3MA3TCLEH0KOWIY7SB9UJJ4EL8,#35-16 It is this report that Lin and Phyo were seeking.,48,55,seeking,0,3,3
3BPP3MA3TCLEH0KOWIY7SB9UJJ4EL8,"#35-17 The Royal Courts of Justice complex in London, where the case was heard.",35,42,complex,1,0,1
3BPP3MA3TCLEH0KOWIY7SB9UJJ4EL8,"#35-17 The Royal Courts of Justice complex in London, where the case was heard.",73,78,heard,0,1,1
3BPP3MA3TCLEH0KOWIY7SB9UJJ4EL8,"#35-18 Using the Data Protection Act 1998 the defendants asked police for this report to assist their defence, and were denied.",46,56,defendants,6,8,14
3BPP3MA3TCLEH0KOWIY7SB9UJJ4EL8,"#35-18 Using the Data Protection Act 1998 the defendants asked police for this report to assist their defence, and were denied.",89,95,assist,0,1,1
3BPP3MA3TCLEH0KOWIY7SB9UJJ4EL8,"#35-18 Using the Data Protection Act 1998 the defendants asked police for this report to assist their defence, and were denied.",89,109,assist their defence,1,0,1
3BPP3MA3TCLEH0KOWIY7SB9UJJ4EL8,"#35-18 Using the Data Protection Act 1998 the defendants asked police for this report to assist their defence, and were denied.",102,109,defence,5,0,5
3BPP3MA3TCLEH0KOWIY7SB9UJJ4EL8,"#35-18 Using the Data Protection Act 1998 the defendants asked police for this report to assist their defence, and were denied.",120,126,denied,1,3,4
39I4RL8QGJIU3245GR7WRX4WPD1H4Y,"#20-9 This means it must be a very young surface"".",35,48,young surface,0,2,2
39I4RL8QGJIU3245GR7WRX4WPD1H4Y,"#20-9 This means it must be a very young surface"".",41,48,surface,2,1,3
39I4RL8QGJIU3245GR7WRX4WPD1H4Y,#20-10 He put the age of the current surface at no more than 100 million years.,29,36,current,1,2,3
39I4RL8QGJIU3245GR7WRX4WPD1H4Y,#20-10 He put the age of the current surface at no more than 100 million years.,37,44,surface,1,0,1
39I4RL8QGJIU3245GR7WRX4WPD1H4Y,#20-10 He put the age of the current surface at no more than 100 million years.,65,72,million,1,0,1
39I4RL8QGJIU3245GR7WRX4WPD1H4Y,"#20-11 The images also did not show craters on its natural satellite, Charon.",36,43,craters,6,9,15
39I4RL8QGJIU3245GR7WRX4WPD1H4Y,"#20-11 The images also did not show craters on its natural satellite, Charon.",51,68,natural satellite,2,1,3
39I4RL8QGJIU3245GR7WRX4WPD1H4Y,"#20-11 The images also did not show craters on its natural satellite, Charon.",59,68,satellite,8,1,9
39I4RL8QGJIU3245GR7WRX4WPD1H4Y,"#20-11 The images also did not show craters on its natural satellite, Charon.",70,76,Charon,0,1,1
39I4RL8QGJIU3245GR7WRX4WPD1H4Y,#20-12 NASA said mountains on the planet may be made of water-ice.,17,26,mountains,1,0,1
39I4RL8QGJIU3245GR7WRX4WPD1H4Y,#20-12 NASA said mountains on the planet may be made of water-ice.,56,65,water-ice,3,3,6
39I4RL8QGJIU3245GR7WRX4WPD1H4Y,#20-13 In February 2007 the space probe flew by Jupiter.,28,39,space probe,1,0,1
39I4RL8QGJIU3245GR7WRX4WPD1H4Y,#20-13 In February 2007 the space probe flew by Jupiter.,34,39,probe,6,8,14
39I4RL8QGJIU3245GR7WRX4WPD1H4Y,#20-13 In February 2007 the space probe flew by Jupiter.,40,44,flew,0,1,1
39I4RL8QGJIU3245GR7WRX4WPD1H4Y,#20-13 In February 2007 the space probe flew by Jupiter.,48,55,Jupiter,3,0,3
39I4RL8QGJIU3245GR7WRX4WPD1H4Y,#20-14 The future mission is to explore the Kuiper Belt.,11,25,future mission,0,1,1
39I4RL8QGJIU3245GR7WRX4WPD1H4Y,#20-14 The future mission is to explore the Kuiper Belt.,18,25,mission,2,2,4
39I4RL8QGJIU3245GR7WRX4WPD1H4Y,#20-14 The future mission is to explore the Kuiper Belt.,32,39,explore,3,5,8
39I4RL8QGJIU3245GR7WRX4WPD1H4Y,#20-14 The future mission is to explore the Kuiper Belt.,44,50,Kuiper,1,0,1
39I4RL8QGJIU3245GR7WRX4WPD1H4Y,#20-14 The future mission is to explore the Kuiper Belt.,44,55,Kuiper Belt,3,1,4
39I4RL8QGJIU3245GR7WRX4WPD1H4Y,#21-1 Formula One driver Jules Bianchi dies aged 25 Bianchi at the Nürburgring's World Series by Renault race in 2012.,31,38,Bianchi,1,0,1
39I4RL8QGJIU3245GR7WRX4WPD1H4Y,#21-1 Formula One driver Jules Bianchi dies aged 25 Bianchi at the Nürburgring's World Series by Renault race in 2012.,52,59,Bianchi,0,1,1
39I4RL8QGJIU3245GR7WRX4WPD1H4Y,#21-1 Formula One driver Jules Bianchi dies aged 25 Bianchi at the Nürburgring's World Series by Renault race in 2012.,67,79,Nürburgrings,1,1,2
39I4RL8QGJIU3245GR7WRX4WPD1H4Y,#21-1 Formula One driver Jules Bianchi dies aged 25 Bianchi at the Nürburgring's World Series by Renault race in 2012.,67,92,Nürburgrings World Series,2,0,2
39I4RL8QGJIU3245GR7WRX4WPD1H4Y,#21-1 Formula One driver Jules Bianchi dies aged 25 Bianchi at the Nürburgring's World Series by Renault race in 2012.,67,103,Nürburgrings World Series by Renault,1,0,1
39I4RL8QGJIU3245GR7WRX4WPD1H4Y,#21-1 Formula One driver Jules Bianchi dies aged 25 Bianchi at the Nürburgring's World Series by Renault race in 2012.,97,104,Renault,0,1,1
39I4RL8QGJIU3245GR7WRX4WPD1H4Y,"#21-2 French Formula One (F1) driver Jules Bianchi died on Friday night at age 25, nine months after his serious accident at the 2014 Japanese Grand Prix.",105,112,serious,1,0,1
39I4RL8QGJIU3245GR7WRX4WPD1H4Y,"#21-2 French Formula One (F1) driver Jules Bianchi died on Friday night at age 25, nine months after his serious accident at the 2014 Japanese Grand Prix.",113,121,accident,2,1,3
39I4RL8QGJIU3245GR7WRX4WPD1H4Y,"#21-2 French Formula One (F1) driver Jules Bianchi died on Friday night at age 25, nine months after his serious accident at the 2014 Japanese Grand Prix.",134,142,Japanese,1,0,1
39I4RL8QGJIU3245GR7WRX4WPD1H4Y,"#21-2 French Formula One (F1) driver Jules Bianchi died on Friday night at age 25, nine months after his serious accident at the 2014 Japanese Grand Prix.",134,153,Japanese Grand Prix,1,0,1
39I4RL8QGJIU3245GR7WRX4WPD1H4Y,"#21-3 News of his death was announced by his family the following morning: Cquote1.svg It is with deep sadness that the parents of Jules Bianchi, Philippe and Christine, his brother Tom and sister Mélanie, wish to make it known that Jules passed away last night at the Centre Hospitalier Universitaire (CHU) in Nice, (France) where he was admitted following the accident of 5th October 2014 at Suzuka Circuit during the Japanese Formula 1 Grand Prix.",28,37,announced,3,2,5
39I4RL8QGJIU3245GR7WRX4WPD1H4Y,"#21-3 News of his death was announced by his family the following morning: Cquote1.svg It is with deep sadness that the parents of Jules Bianchi, Philippe and Christine, his brother Tom and sister Mélanie, wish to make it known that Jules passed away last night at the Centre Hospitalier Universitaire (CHU) in Nice, (France) where he was admitted following the accident of 5th October 2014 at Suzuka Circuit during the Japanese Formula 1 Grand Prix.",98,110,deep sadness,0,1,1
39I4RL8QGJIU3245GR7WRX4WPD1H4Y,"#21-3 News of his death was announced by his family the following morning: Cquote1.svg It is with deep sadness that the parents of Jules Bianchi, Philippe and Christine, his brother Tom and sister Mélanie, wish to make it known that Jules passed away last night at the Centre Hospitalier Universitaire (CHU) in Nice, (France) where he was admitted following the accident of 5th October 2014 at Suzuka Circuit during the Japanese Formula 1 Grand Prix.",103,110,sadness,0,2,2
39I4RL8QGJIU3245GR7WRX4WPD1H4Y,"#21-3 News of his death was announced by his family the following morning: Cquote1.svg It is with deep sadness that the parents of Jules Bianchi, Philippe and Christine, his brother Tom and sister Mélanie, wish to make it known that Jules passed away last night at the Centre Hospitalier Universitaire (CHU) in Nice, (France) where he was admitted following the accident of 5th October 2014 at Suzuka Circuit during the Japanese Formula 1 Grand Prix.",146,154,Philippe,0,1,1
39I4RL8QGJIU3245GR7WRX4WPD1H4Y,"#21-3 News of his death was announced by his family the following morning: Cquote1.svg It is with deep sadness that the parents of Jules Bianchi, Philippe and Christine, his brother Tom and sister Mélanie, wish to make it known that Jules passed away last night at the Centre Hospitalier Universitaire (CHU) in Nice, (France) where he was admitted following the accident of 5th October 2014 at Suzuka Circuit during the Japanese Formula 1 Grand Prix.",159,168,Christine,0,1,1
39I4RL8QGJIU3245GR7WRX4WPD1H4Y,"#21-3 News of his death was announced by his family the following morning: Cquote1.svg It is with deep sadness that the parents of Jules Bianchi, Philippe and Christine, his brother Tom and sister Mélanie, wish to make it known that Jules passed away last night at the Centre Hospitalier Universitaire (CHU) in Nice, (France) where he was admitted following the accident of 5th October 2014 at Suzuka Circuit during the Japanese Formula 1 Grand Prix.",197,204,Mélanie,1,1,2
39I4RL8QGJIU3245GR7WRX4WPD1H4Y,"#21-3 News of his death was announced by his family the following morning: Cquote1.svg It is with deep sadness that the parents of Jules Bianchi, Philippe and Christine, his brother Tom and sister Mélanie, wish to make it known that Jules passed away last night at the Centre Hospitalier Universitaire (CHU) in Nice, (France) where he was admitted following the accident of 5th October 2014 at Suzuka Circuit during the Japanese Formula 1 Grand Prix.",239,245,passed,1,0,1
39I4RL8QGJIU3245GR7WRX4WPD1H4Y,"#21-3 News of his death was announced by his family the following morning: Cquote1.svg It is with deep sadness that the parents of Jules Bianchi, Philippe and Christine, his brother Tom and sister Mélanie, wish to make it known that Jules passed away last night at the Centre Hospitalier Universitaire (CHU) in Nice, (France) where he was admitted following the accident of 5th October 2014 at Suzuka Circuit during the Japanese Formula 1 Grand Prix.",239,250,passed away,4,2,6
39I4RL8QGJIU3245GR7WRX4WPD1H4Y,"#21-3 News of his death was announced by his family the following morning: Cquote1.svg It is with deep sadness that the parents of Jules Bianchi, Philippe and Christine, his brother Tom and sister Mélanie, wish to make it known that Jules passed away last night at the Centre Hospitalier Universitaire (CHU) in Nice, (France) where he was admitted following the accident of 5th October 2014 at Suzuka Circuit during the Japanese Formula 1 Grand Prix.",339,347,admitted,5,2,7
39I4RL8QGJIU3245GR7WRX4WPD1H4Y,"#21-3 News of his death was announced by his family the following morning: Cquote1.svg It is with deep sadness that the parents of Jules Bianchi, Philippe and Christine, his brother Tom and sister Mélanie, wish to make it known that Jules passed away last night at the Centre Hospitalier Universitaire (CHU) in Nice, (France) where he was admitted following the accident of 5th October 2014 at Suzuka Circuit during the Japanese Formula 1 Grand Prix.",348,357,following,1,0,1
39I4RL8QGJIU3245GR7WRX4WPD1H4Y,"#21-3 News of his death was announced by his family the following morning: Cquote1.svg It is with deep sadness that the parents of Jules Bianchi, Philippe and Christine, his brother Tom and sister Mélanie, wish to make it known that Jules passed away last night at the Centre Hospitalier Universitaire (CHU) in Nice, (France) where he was admitted following the accident of 5th October 2014 at Suzuka Circuit during the Japanese Formula 1 Grand Prix.",394,408,Suzuka Circuit,1,1,2
39I4RL8QGJIU3245GR7WRX4WPD1H4Y,"#21-3 News of his death was announced by his family the following morning: Cquote1.svg It is with deep sadness that the parents of Jules Bianchi, Philippe and Christine, his brother Tom and sister Mélanie, wish to make it known that Jules passed away last night at the Centre Hospitalier Universitaire (CHU) in Nice, (France) where he was admitted following the accident of 5th October 2014 at Suzuka Circuit during the Japanese Formula 1 Grand Prix.",401,408,Circuit,1,0,1
39I4RL8QGJIU3245GR7WRX4WPD1H4Y,"#21-3 News of his death was announced by his family the following morning: Cquote1.svg It is with deep sadness that the parents of Jules Bianchi, Philippe and Christine, his brother Tom and sister Mélanie, wish to make it known that Jules passed away last night at the Centre Hospitalier Universitaire (CHU) in Nice, (France) where he was admitted following the accident of 5th October 2014 at Suzuka Circuit during the Japanese Formula 1 Grand Prix.",420,428,Japanese,0,1,1
39I4RL8QGJIU3245GR7WRX4WPD1H4Y,"#21-3 News of his death was announced by his family the following morning: Cquote1.svg It is with deep sadness that the parents of Jules Bianchi, Philippe and Christine, his brother Tom and sister Mélanie, wish to make it known that Jules passed away last night at the Centre Hospitalier Universitaire (CHU) in Nice, (France) where he was admitted following the accident of 5th October 2014 at Suzuka Circuit during the Japanese Formula 1 Grand Prix.",439,449,Grand Prix,1,0,1
3L60IFZKF3JOFES0VYRFLMD0UINHHK,#35-4 The court has expedited the case.,20,29,expedited,10,10,20
3L60IFZKF3JOFES0VYRFLMD0UINHHK,"#35-5 Burmese nationals Zaw Lin and Wai Phyo, both 22, are currently on trial accused of murdering David Miller, 24, from Jersey, and Hannah Witheridge, 23, from England.",6,13,Burmese,1,0,1
3L60IFZKF3JOFES0VYRFLMD0UINHHK,"#35-5 Burmese nationals Zaw Lin and Wai Phyo, both 22, are currently on trial accused of murdering David Miller, 24, from Jersey, and Hannah Witheridge, 23, from England.",14,23,nationals,1,1,2
3L60IFZKF3JOFES0VYRFLMD0UINHHK,"#35-5 Burmese nationals Zaw Lin and Wai Phyo, both 22, are currently on trial accused of murdering David Miller, 24, from Jersey, and Hannah Witheridge, 23, from England.",72,85,trial accused,1,0,1
3L60IFZKF3JOFES0VYRFLMD0UINHHK,"#35-5 Burmese nationals Zaw Lin and Wai Phyo, both 22, are currently on trial accused of murdering David Miller, 24, from Jersey, and Hannah Witheridge, 23, from England.",78,85,accused,2,4,6
3L60IFZKF3JOFES0VYRFLMD0UINHHK,"#35-5 Burmese nationals Zaw Lin and Wai Phyo, both 22, are currently on trial accused of murdering David Miller, 24, from Jersey, and Hannah Witheridge, 23, from England.",78,98,accused of murdering,0,1,1
3L60IFZKF3JOFES0VYRFLMD0UINHHK,"#35-5 Burmese nationals Zaw Lin and Wai Phyo, both 22, are currently on trial accused of murdering David Miller, 24, from Jersey, and Hannah Witheridge, 23, from England.",89,98,murdering,1,2,3
3L60IFZKF3JOFES0VYRFLMD0UINHHK,"#35-5 Burmese nationals Zaw Lin and Wai Phyo, both 22, are currently on trial accused of murdering David Miller, 24, from Jersey, and Hannah Witheridge, 23, from England.",141,151,Witheridge,1,0,1
3L60IFZKF3JOFES0VYRFLMD0UINHHK,#35-6 With the defence case due to begin shortly and continue until mid- or late September the court has issued its judgement today following a hearing on Friday.,15,22,defence,5,2,7
3L60IFZKF3JOFES0VYRFLMD0UINHHK,#35-6 With the defence case due to begin shortly and continue until mid- or late September the court has issued its judgement today following a hearing on Friday.,15,27,defence case,0,1,1
3L60IFZKF3JOFES0VYRFLMD0UINHHK,#35-6 With the defence case due to begin shortly and continue until mid- or late September the court has issued its judgement today following a hearing on Friday.,105,111,issued,1,1,2
3L60IFZKF3JOFES0VYRFLMD0UINHHK,#35-6 With the defence case due to begin shortly and continue until mid- or late September the court has issued its judgement today following a hearing on Friday.,105,125,issued its judgement,0,1,1
3L60IFZKF3JOFES0VYRFLMD0UINHHK,#35-6 With the defence case due to begin shortly and continue until mid- or late September the court has issued its judgement today following a hearing on Friday.,116,125,judgement,6,4,10
3L60IFZKF3JOFES0VYRFLMD0UINHHK,#35-6 With the defence case due to begin shortly and continue until mid- or late September the court has issued its judgement today following a hearing on Friday.,132,141,following,1,0,1
3L60IFZKF3JOFES0VYRFLMD0UINHHK,#35-6 With the defence case due to begin shortly and continue until mid- or late September the court has issued its judgement today following a hearing on Friday.,144,151,hearing,1,1,2
3L60IFZKF3JOFES0VYRFLMD0UINHHK,#35-7 The case dates to September last year when the victims were found murdered on a Koh Tao beach.,53,60,victims,3,4,7
3L60IFZKF3JOFES0VYRFLMD0UINHHK,#35-7 The case dates to September last year when the victims were found murdered on a Koh Tao beach.,72,80,murdered,1,0,1
3L60IFZKF3JOFES0VYRFLMD0UINHHK,#35-7 The case dates to September last year when the victims were found murdered on a Koh Tao beach.,86,89,Koh,1,0,1
3L60IFZKF3JOFES0VYRFLMD0UINHHK,#35-7 The case dates to September last year when the victims were found murdered on a Koh Tao beach.,90,93,Tao,1,0,1
3L60IFZKF3JOFES0VYRFLMD0UINHHK,#35-8 Witheridge had been raped.,6,16,Witheridge,1,3,4
3L60IFZKF3JOFES0VYRFLMD0UINHHK,#35-8 Witheridge had been raped.,26,31,raped,1,0,1
3L60IFZKF3JOFES0VYRFLMD0UINHHK,"#35-9 The case attracted worldwide attention with Lin and Phyo confessing, before re-enacting the killing in front of the press.",15,24,attracted,0,1,1
3L60IFZKF3JOFES0VYRFLMD0UINHHK,"#35-9 The case attracted worldwide attention with Lin and Phyo confessing, before re-enacting the killing in front of the press.",25,34,worldwide,1,1,2
3L60IFZKF3JOFES0VYRFLMD0UINHHK,"#35-9 The case attracted worldwide attention with Lin and Phyo confessing, before re-enacting the killing in front of the press.",25,44,worldwide attention,1,0,1
3L60IFZKF3JOFES0VYRFLMD0UINHHK,"#35-9 The case attracted worldwide attention with Lin and Phyo confessing, before re-enacting the killing in front of the press.",63,73,confessing,8,3,11
3L60IFZKF3JOFES0VYRFLMD0UINHHK,"#35-9 The case attracted worldwide attention with Lin and Phyo confessing, before re-enacting the killing in front of the press.",82,93,re-enacting,10,8,18
3L60IFZKF3JOFES0VYRFLMD0UINHHK,#35-10 The accused claim the confessions were tortured out of them and the ongoing trial is unfair.,11,18,accused,2,0,2
3L60IFZKF3JOFES0VYRFLMD0UINHHK,#35-10 The accused claim the confessions were tortured out of them and the ongoing trial is unfair.,29,40,confessions,5,5,10
3L60IFZKF3JOFES0VYRFLMD0UINHHK,#35-10 The accused claim the confessions were tortured out of them and the ongoing trial is unfair.,46,54,tortured,5,6,11
3L60IFZKF3JOFES0VYRFLMD0UINHHK,#35-10 The accused claim the confessions were tortured out of them and the ongoing trial is unfair.,75,82,ongoing,2,6,8
3L60IFZKF3JOFES0VYRFLMD0UINHHK,#35-10 The accused claim the confessions were tortured out of them and the ongoing trial is unfair.,83,88,trial,1,1,2
3L60IFZKF3JOFES0VYRFLMD0UINHHK,"#35-11 UK Prime Minister David Cameron intervened, speaking to Thai Prime Minister Prayut Chan-o-cha.",39,49,intervened,8,9,17
3L60IFZKF3JOFES0VYRFLMD0UINHHK,"#35-11 UK Prime Minister David Cameron intervened, speaking to Thai Prime Minister Prayut Chan-o-cha.",83,89,Prayut,2,0,2
3L60IFZKF3JOFES0VYRFLMD0UINHHK,"#35-11 UK Prime Minister David Cameron intervened, speaking to Thai Prime Minister Prayut Chan-o-cha.",90,100,Chan-o-cha,1,0,1
3LCXHSGDLT71LDFEGRV84XNPBDCESM,"#42-97 So basically it seems like they collect it in order to keep diseases out of the nest, so they stop the disease before it can actually infect them.",10,19,basically,3,1,4
3LCXHSGDLT71LDFEGRV84XNPBDCESM,"#42-97 So basically it seems like they collect it in order to keep diseases out of the nest, so they stop the disease before it can actually infect them.",67,75,diseases,3,4,7
3LCXHSGDLT71LDFEGRV84XNPBDCESM,"#42-97 So basically it seems like they collect it in order to keep diseases out of the nest, so they stop the disease before it can actually infect them.",87,91,nest,0,1,1
3LCXHSGDLT71LDFEGRV84XNPBDCESM,"#42-97 So basically it seems like they collect it in order to keep diseases out of the nest, so they stop the disease before it can actually infect them.",110,117,disease,0,1,1
3LCXHSGDLT71LDFEGRV84XNPBDCESM,"#42-97 So basically it seems like they collect it in order to keep diseases out of the nest, so they stop the disease before it can actually infect them.",132,140,actually,1,1,2
3LCXHSGDLT71LDFEGRV84XNPBDCESM,"#42-97 So basically it seems like they collect it in order to keep diseases out of the nest, so they stop the disease before it can actually infect them.",141,147,infect,4,4,8
3LCXHSGDLT71LDFEGRV84XNPBDCESM,#42-98 Wikinews: Are there plans to follow this research up?,7,15,Wikinews,1,1,2
3LCXHSGDLT71LDFEGRV84XNPBDCESM,#42-98 Wikinews: Are there plans to follow this research up?,48,56,research,2,5,7
3LCXHSGDLT71LDFEGRV84XNPBDCESM,#42-99 Might you research other species?,17,25,research,2,0,2
3LCXHSGDLT71LDFEGRV84XNPBDCESM,#42-102 There might be many sources of medicine (recent evidence suggests that tobacco plays a similar role for bumble bees).,28,35,sources,1,4,5
3LCXHSGDLT71LDFEGRV84XNPBDCESM,#42-102 There might be many sources of medicine (recent evidence suggests that tobacco plays a similar role for bumble bees).,39,47,medicine,1,0,1
3LCXHSGDLT71LDFEGRV84XNPBDCESM,#42-102 There might be many sources of medicine (recent evidence suggests that tobacco plays a similar role for bumble bees).,56,64,evidence,3,6,9
3LCXHSGDLT71LDFEGRV84XNPBDCESM,#42-102 There might be many sources of medicine (recent evidence suggests that tobacco plays a similar role for bumble bees).,79,86,tobacco,5,0,5
3LCXHSGDLT71LDFEGRV84XNPBDCESM,#42-102 There might be many sources of medicine (recent evidence suggests that tobacco plays a similar role for bumble bees).,112,118,bumble,0,3,3
3LCXHSGDLT71LDFEGRV84XNPBDCESM,#42-102 There might be many sources of medicine (recent evidence suggests that tobacco plays a similar role for bumble bees).,112,123,bumble bees,0,1,1
3LCXHSGDLT71LDFEGRV84XNPBDCESM,"#42-103 Dalial Freitak, who is also on this paper is currently running tests with Ph.D. student Siiri Fuchs (who is also on the paper) with other substances to see if any have the same effect as H2O2 [hydrogen peroxide].",8,22,Dalial Freitak,1,0,1
3LCXHSGDLT71LDFEGRV84XNPBDCESM,"#42-103 Dalial Freitak, who is also on this paper is currently running tests with Ph.D. student Siiri Fuchs (who is also on the paper) with other substances to see if any have the same effect as H2O2 [hydrogen peroxide].",53,76,currently running tests,0,1,1
3LCXHSGDLT71LDFEGRV84XNPBDCESM,"#42-103 Dalial Freitak, who is also on this paper is currently running tests with Ph.D. student Siiri Fuchs (who is also on the paper) with other substances to see if any have the same effect as H2O2 [hydrogen peroxide].",63,70,running,0,1,1
3LCXHSGDLT71LDFEGRV84XNPBDCESM,"#42-103 Dalial Freitak, who is also on this paper is currently running tests with Ph.D. student Siiri Fuchs (who is also on the paper) with other substances to see if any have the same effect as H2O2 [hydrogen peroxide].",63,76,running tests,0,1,1
3LCXHSGDLT71LDFEGRV84XNPBDCESM,"#42-103 Dalial Freitak, who is also on this paper is currently running tests with Ph.D. student Siiri Fuchs (who is also on the paper) with other substances to see if any have the same effect as H2O2 [hydrogen peroxide].",82,86,Ph.D,1,1,2
3LCXHSGDLT71LDFEGRV84XNPBDCESM,"#42-103 Dalial Freitak, who is also on this paper is currently running tests with Ph.D. student Siiri Fuchs (who is also on the paper) with other substances to see if any have the same effect as H2O2 [hydrogen peroxide].",96,107,Siiri Fuchs,1,0,1
3LCXHSGDLT71LDFEGRV84XNPBDCESM,"#42-103 Dalial Freitak, who is also on this paper is currently running tests with Ph.D. student Siiri Fuchs (who is also on the paper) with other substances to see if any have the same effect as H2O2 [hydrogen peroxide].",146,156,substances,7,7,14
3LCXHSGDLT71LDFEGRV84XNPBDCESM,"#42-104 Once the behaviour has been well described in this species of ant, I might do a comparison with other species.",17,26,behaviour,7,7,14
3LCXHSGDLT71LDFEGRV84XNPBDCESM,"#42-104 Once the behaviour has been well described in this species of ant, I might do a comparison with other species.",41,50,described,2,2,4
3LCXHSGDLT71LDFEGRV84XNPBDCESM,"#42-104 Once the behaviour has been well described in this species of ant, I might do a comparison with other species.",59,66,species,3,6,9
3LCXHSGDLT71LDFEGRV84XNPBDCESM,"#42-104 Once the behaviour has been well described in this species of ant, I might do a comparison with other species.",88,98,comparison,5,7,12
3LCXHSGDLT71LDFEGRV84XNPBDCESM,"#42-104 Once the behaviour has been well described in this species of ant, I might do a comparison with other species.",110,117,species,5,5,10
3E24UO25QZRIA6U63SV184LBXQL6OW,"#13-3 ""We're working with legislative leaders at this very moment to begin to craft legislation that will repeal the most corrosive elements of Obamacare — the individual mandate, the taxes, the penalties — but at the same time, moving separate legislation that will allow us to introduce the kind of reforms in American health care that'll lower the cost of health insurance without growing the size of government,"" said Vice President-elect Mike Pence.",26,37,legislative,8,5,13
3E24UO25QZRIA6U63SV184LBXQL6OW,"#13-3 ""We're working with legislative leaders at this very moment to begin to craft legislation that will repeal the most corrosive elements of Obamacare — the individual mandate, the taxes, the penalties — but at the same time, moving separate legislation that will allow us to introduce the kind of reforms in American health care that'll lower the cost of health insurance without growing the size of government,"" said Vice President-elect Mike Pence.",26,45,legislative leaders,1,0,1
3E24UO25QZRIA6U63SV184LBXQL6OW,"#13-3 ""We're working with legislative leaders at this very moment to begin to craft legislation that will repeal the most corrosive elements of Obamacare — the individual mandate, the taxes, the penalties — but at the same time, moving separate legislation that will allow us to introduce the kind of reforms in American health care that'll lower the cost of health insurance without growing the size of government,"" said Vice President-elect Mike Pence.",59,65,moment,0,1,1
3E24UO25QZRIA6U63SV184LBXQL6OW,"#13-3 ""We're working with legislative leaders at this very moment to begin to craft legislation that will repeal the most corrosive elements of Obamacare — the individual mandate, the taxes, the penalties — but at the same time, moving separate legislation that will allow us to introduce the kind of reforms in American health care that'll lower the cost of health insurance without growing the size of government,"" said Vice President-elect Mike Pence.",78,83,craft,0,3,3
3E24UO25QZRIA6U63SV184LBXQL6OW,"#13-3 ""We're working with legislative leaders at this very moment to begin to craft legislation that will repeal the most corrosive elements of Obamacare — the individual mandate, the taxes, the penalties — but at the same time, moving separate legislation that will allow us to introduce the kind of reforms in American health care that'll lower the cost of health insurance without growing the size of government,"" said Vice President-elect Mike Pence.",78,95,craft legislation,2,3,5
3E24UO25QZRIA6U63SV184LBXQL6OW,"#13-3 ""We're working with legislative leaders at this very moment to begin to craft legislation that will repeal the most corrosive elements of Obamacare — the individual mandate, the taxes, the penalties — but at the same time, moving separate legislation that will allow us to introduce the kind of reforms in American health care that'll lower the cost of health insurance without growing the size of government,"" said Vice President-elect Mike Pence.",84,95,legislation,5,1,6
3E24UO25QZRIA6U63SV184LBXQL6OW,"#13-3 ""We're working with legislative leaders at this very moment to begin to craft legislation that will repeal the most corrosive elements of Obamacare — the individual mandate, the taxes, the penalties — but at the same time, moving separate legislation that will allow us to introduce the kind of reforms in American health care that'll lower the cost of health insurance without growing the size of government,"" said Vice President-elect Mike Pence.",106,112,repeal,3,6,9
3E24UO25QZRIA6U63SV184LBXQL6OW,"#13-3 ""We're working with legislative leaders at this very moment to begin to craft legislation that will repeal the most corrosive elements of Obamacare — the individual mandate, the taxes, the penalties — but at the same time, moving separate legislation that will allow us to introduce the kind of reforms in American health care that'll lower the cost of health insurance without growing the size of government,"" said Vice President-elect Mike Pence.",122,131,corrosive,9,10,19
3E24UO25QZRIA6U63SV184LBXQL6OW,"#13-3 ""We're working with legislative leaders at this very moment to begin to craft legislation that will repeal the most corrosive elements of Obamacare — the individual mandate, the taxes, the penalties — but at the same time, moving separate legislation that will allow us to introduce the kind of reforms in American health care that'll lower the cost of health insurance without growing the size of government,"" said Vice President-elect Mike Pence.",122,140,corrosive elements,3,2,5
3E24UO25QZRIA6U63SV184LBXQL6OW,"#13-3 ""We're working with legislative leaders at this very moment to begin to craft legislation that will repeal the most corrosive elements of Obamacare — the individual mandate, the taxes, the penalties — but at the same time, moving separate legislation that will allow us to introduce the kind of reforms in American health care that'll lower the cost of health insurance without growing the size of government,"" said Vice President-elect Mike Pence.",132,140,elements,1,0,1
3E24UO25QZRIA6U63SV184LBXQL6OW,"#13-3 ""We're working with legislative leaders at this very moment to begin to craft legislation that will repeal the most corrosive elements of Obamacare — the individual mandate, the taxes, the penalties — but at the same time, moving separate legislation that will allow us to introduce the kind of reforms in American health care that'll lower the cost of health insurance without growing the size of government,"" said Vice President-elect Mike Pence.",144,153,Obamacare,0,3,3
3E24UO25QZRIA6U63SV184LBXQL6OW,"#13-3 ""We're working with legislative leaders at this very moment to begin to craft legislation that will repeal the most corrosive elements of Obamacare — the individual mandate, the taxes, the penalties — but at the same time, moving separate legislation that will allow us to introduce the kind of reforms in American health care that'll lower the cost of health insurance without growing the size of government,"" said Vice President-elect Mike Pence.",160,170,individual,2,0,2
3E24UO25QZRIA6U63SV184LBXQL6OW,"#13-3 ""We're working with legislative leaders at this very moment to begin to craft legislation that will repeal the most corrosive elements of Obamacare — the individual mandate, the taxes, the penalties — but at the same time, moving separate legislation that will allow us to introduce the kind of reforms in American health care that'll lower the cost of health insurance without growing the size of government,"" said Vice President-elect Mike Pence.",160,178,individual mandate,1,0,1
3E24UO25QZRIA6U63SV184LBXQL6OW,"#13-3 ""We're working with legislative leaders at this very moment to begin to craft legislation that will repeal the most corrosive elements of Obamacare — the individual mandate, the taxes, the penalties — but at the same time, moving separate legislation that will allow us to introduce the kind of reforms in American health care that'll lower the cost of health insurance without growing the size of government,"" said Vice President-elect Mike Pence.",171,178,mandate,8,5,13
3E24UO25QZRIA6U63SV184LBXQL6OW,"#13-3 ""We're working with legislative leaders at this very moment to begin to craft legislation that will repeal the most corrosive elements of Obamacare — the individual mandate, the taxes, the penalties — but at the same time, moving separate legislation that will allow us to introduce the kind of reforms in American health care that'll lower the cost of health insurance without growing the size of government,"" said Vice President-elect Mike Pence.",195,204,penalties,4,2,6
3E24UO25QZRIA6U63SV184LBXQL6OW,"#13-3 ""We're working with legislative leaders at this very moment to begin to craft legislation that will repeal the most corrosive elements of Obamacare — the individual mandate, the taxes, the penalties — but at the same time, moving separate legislation that will allow us to introduce the kind of reforms in American health care that'll lower the cost of health insurance without growing the size of government,"" said Vice President-elect Mike Pence.",245,256,legislation,5,2,7
3E24UO25QZRIA6U63SV184LBXQL6OW,"#13-3 ""We're working with legislative leaders at this very moment to begin to craft legislation that will repeal the most corrosive elements of Obamacare — the individual mandate, the taxes, the penalties — but at the same time, moving separate legislation that will allow us to introduce the kind of reforms in American health care that'll lower the cost of health insurance without growing the size of government,"" said Vice President-elect Mike Pence.",301,308,reforms,2,3,5
3E24UO25QZRIA6U63SV184LBXQL6OW,"#13-3 ""We're working with legislative leaders at this very moment to begin to craft legislation that will repeal the most corrosive elements of Obamacare — the individual mandate, the taxes, the penalties — but at the same time, moving separate legislation that will allow us to introduce the kind of reforms in American health care that'll lower the cost of health insurance without growing the size of government,"" said Vice President-elect Mike Pence.",366,375,insurance,2,0,2
3E24UO25QZRIA6U63SV184LBXQL6OW,"#13-3 ""We're working with legislative leaders at this very moment to begin to craft legislation that will repeal the most corrosive elements of Obamacare — the individual mandate, the taxes, the penalties — but at the same time, moving separate legislation that will allow us to introduce the kind of reforms in American health care that'll lower the cost of health insurance without growing the size of government,"" said Vice President-elect Mike Pence.",384,414,growing the size of government,1,0,1
3E24UO25QZRIA6U63SV184LBXQL6OW,"#13-3 ""We're working with legislative leaders at this very moment to begin to craft legislation that will repeal the most corrosive elements of Obamacare — the individual mandate, the taxes, the penalties — but at the same time, moving separate legislation that will allow us to introduce the kind of reforms in American health care that'll lower the cost of health insurance without growing the size of government,"" said Vice President-elect Mike Pence.",404,414,government,1,1,2
3E24UO25QZRIA6U63SV184LBXQL6OW,"#13-3 ""We're working with legislative leaders at this very moment to begin to craft legislation that will repeal the most corrosive elements of Obamacare — the individual mandate, the taxes, the penalties — but at the same time, moving separate legislation that will allow us to introduce the kind of reforms in American health care that'll lower the cost of health insurance without growing the size of government,"" said Vice President-elect Mike Pence.",422,442,Vice President-elect,1,1,2
3E24UO25QZRIA6U63SV184LBXQL6OW,"#13-4 Democratic Senator Maria Cantwell of Washington had a different view, going so far as to call this ""stealing health care from Americans.""",17,24,Senator,1,0,1
3E24UO25QZRIA6U63SV184LBXQL6OW,"#13-4 Democratic Senator Maria Cantwell of Washington had a different view, going so far as to call this ""stealing health care from Americans.""",31,39,Cantwell,1,1,2
3E24UO25QZRIA6U63SV184LBXQL6OW,"#13-4 Democratic Senator Maria Cantwell of Washington had a different view, going so far as to call this ""stealing health care from Americans.""",106,114,stealing,2,4,6
3E24UO25QZRIA6U63SV184LBXQL6OW,"#13-4 Democratic Senator Maria Cantwell of Washington had a different view, going so far as to call this ""stealing health care from Americans.""",106,126,stealing health care,0,1,1
3E24UO25QZRIA6U63SV184LBXQL6OW,#13-5 The filibuster is a last-ditch tactic in which parties opposed to a certain motion refuse to relinquish the floor until their opponents give in or compromise.,10,20,filibuster,10,10,20
3E24UO25QZRIA6U63SV184LBXQL6OW,#13-5 The filibuster is a last-ditch tactic in which parties opposed to a certain motion refuse to relinquish the floor until their opponents give in or compromise.,26,36,last-ditch,2,6,8
3E24UO25QZRIA6U63SV184LBXQL6OW,#13-5 The filibuster is a last-ditch tactic in which parties opposed to a certain motion refuse to relinquish the floor until their opponents give in or compromise.,26,43,last-ditch tactic,3,2,5
3E24UO25QZRIA6U63SV184LBXQL6OW,#13-5 The filibuster is a last-ditch tactic in which parties opposed to a certain motion refuse to relinquish the floor until their opponents give in or compromise.,37,43,tactic,3,4,7
3E24UO25QZRIA6U63SV184LBXQL6OW,#13-5 The filibuster is a last-ditch tactic in which parties opposed to a certain motion refuse to relinquish the floor until their opponents give in or compromise.,61,68,opposed,1,1,2
3E24UO25QZRIA6U63SV184LBXQL6OW,#13-5 The filibuster is a last-ditch tactic in which parties opposed to a certain motion refuse to relinquish the floor until their opponents give in or compromise.,82,88,motion,1,2,3
3E24UO25QZRIA6U63SV184LBXQL6OW,#13-5 The filibuster is a last-ditch tactic in which parties opposed to a certain motion refuse to relinquish the floor until their opponents give in or compromise.,89,95,refuse,0,1,1
3E24UO25QZRIA6U63SV184LBXQL6OW,#13-5 The filibuster is a last-ditch tactic in which parties opposed to a certain motion refuse to relinquish the floor until their opponents give in or compromise.,99,109,relinquish,9,10,19
3E24UO25QZRIA6U63SV184LBXQL6OW,#13-5 The filibuster is a last-ditch tactic in which parties opposed to a certain motion refuse to relinquish the floor until their opponents give in or compromise.,132,141,opponents,2,1,3
3E24UO25QZRIA6U63SV184LBXQL6OW,#13-5 The filibuster is a last-ditch tactic in which parties opposed to a certain motion refuse to relinquish the floor until their opponents give in or compromise.,142,149,give in,0,2,2
3E24UO25QZRIA6U63SV184LBXQL6OW,#13-5 The filibuster is a last-ditch tactic in which parties opposed to a certain motion refuse to relinquish the floor until their opponents give in or compromise.,153,163,compromise,4,4,8
3LXX8KJXPWA5SPW41ZYDSECDNRTO9P,"#42-8 Infected ants chose food laced with toxic hydrogen peroxide, whereas healthy ants avoided it.",6,14,Infected,3,2,5
3LXX8KJXPWA5SPW41ZYDSECDNRTO9P,"#42-8 Infected ants chose food laced with toxic hydrogen peroxide, whereas healthy ants avoided it.",26,36,food laced,1,0,1
3LXX8KJXPWA5SPW41ZYDSECDNRTO9P,"#42-8 Infected ants chose food laced with toxic hydrogen peroxide, whereas healthy ants avoided it.",31,36,laced,0,6,6
3LXX8KJXPWA5SPW41ZYDSECDNRTO9P,"#42-8 Infected ants chose food laced with toxic hydrogen peroxide, whereas healthy ants avoided it.",31,41,laced with,0,2,2
3LXX8KJXPWA5SPW41ZYDSECDNRTO9P,"#42-8 Infected ants chose food laced with toxic hydrogen peroxide, whereas healthy ants avoided it.",42,47,toxic,1,4,5
3LXX8KJXPWA5SPW41ZYDSECDNRTO9P,"#42-8 Infected ants chose food laced with toxic hydrogen peroxide, whereas healthy ants avoided it.",42,65,toxic hydrogen peroxide,4,1,5
3LXX8KJXPWA5SPW41ZYDSECDNRTO9P,"#42-8 Infected ants chose food laced with toxic hydrogen peroxide, whereas healthy ants avoided it.",48,56,hydrogen,2,0,2
3LXX8KJXPWA5SPW41ZYDSECDNRTO9P,"#42-8 Infected ants chose food laced with toxic hydrogen peroxide, whereas healthy ants avoided it.",48,65,hydrogen peroxide,7,0,7
3LXX8KJXPWA5SPW41ZYDSECDNRTO9P,"#42-8 Infected ants chose food laced with toxic hydrogen peroxide, whereas healthy ants avoided it.",57,65,peroxide,2,0,2
3LXX8KJXPWA5SPW41ZYDSECDNRTO9P,"#42-8 Infected ants chose food laced with toxic hydrogen peroxide, whereas healthy ants avoided it.",67,74,whereas,3,0,3
3LXX8KJXPWA5SPW41ZYDSECDNRTO9P,"#42-9 Hydrogen peroxide reduced infected ant fatalities by 15%, and the ants varied their intake depending upon how high the peroxide concentration was.",6,14,Hydrogen,1,0,1
3LXX8KJXPWA5SPW41ZYDSECDNRTO9P,"#42-9 Hydrogen peroxide reduced infected ant fatalities by 15%, and the ants varied their intake depending upon how high the peroxide concentration was.",6,23,Hydrogen peroxide,2,0,2
3LXX8KJXPWA5SPW41ZYDSECDNRTO9P,"#42-9 Hydrogen peroxide reduced infected ant fatalities by 15%, and the ants varied their intake depending upon how high the peroxide concentration was.",32,40,infected,2,0,2
3LXX8KJXPWA5SPW41ZYDSECDNRTO9P,"#42-9 Hydrogen peroxide reduced infected ant fatalities by 15%, and the ants varied their intake depending upon how high the peroxide concentration was.",45,55,fatalities,3,8,11
3LXX8KJXPWA5SPW41ZYDSECDNRTO9P,"#42-9 Hydrogen peroxide reduced infected ant fatalities by 15%, and the ants varied their intake depending upon how high the peroxide concentration was.",77,83,varied,0,1,1
3LXX8KJXPWA5SPW41ZYDSECDNRTO9P,"#42-9 Hydrogen peroxide reduced infected ant fatalities by 15%, and the ants varied their intake depending upon how high the peroxide concentration was.",77,96,varied their intake,0,1,1
3LXX8KJXPWA5SPW41ZYDSECDNRTO9P,"#42-9 Hydrogen peroxide reduced infected ant fatalities by 15%, and the ants varied their intake depending upon how high the peroxide concentration was.",90,96,intake,2,3,5
3LXX8KJXPWA5SPW41ZYDSECDNRTO9P,"#42-9 Hydrogen peroxide reduced infected ant fatalities by 15%, and the ants varied their intake depending upon how high the peroxide concentration was.",97,106,depending,1,0,1
3LXX8KJXPWA5SPW41ZYDSECDNRTO9P,"#42-9 Hydrogen peroxide reduced infected ant fatalities by 15%, and the ants varied their intake depending upon how high the peroxide concentration was.",125,133,peroxide,2,0,2
3LXX8KJXPWA5SPW41ZYDSECDNRTO9P,"#42-9 Hydrogen peroxide reduced infected ant fatalities by 15%, and the ants varied their intake depending upon how high the peroxide concentration was.",125,147,peroxide concentration,1,1,2
3LXX8KJXPWA5SPW41ZYDSECDNRTO9P,"#42-9 Hydrogen peroxide reduced infected ant fatalities by 15%, and the ants varied their intake depending upon how high the peroxide concentration was.",134,147,concentration,7,0,7
3LXX8KJXPWA5SPW41ZYDSECDNRTO9P,"#42-10 In the wild, Formica fusca can encounter similar chemicals in aphids and dead ants.",20,27,Formica,0,1,1
3LXX8KJXPWA5SPW41ZYDSECDNRTO9P,"#42-10 In the wild, Formica fusca can encounter similar chemicals in aphids and dead ants.",20,33,Formica fusca,5,2,7
3LXX8KJXPWA5SPW41ZYDSECDNRTO9P,"#42-10 In the wild, Formica fusca can encounter similar chemicals in aphids and dead ants.",28,33,fusca,0,2,2
3LXX8KJXPWA5SPW41ZYDSECDNRTO9P,"#42-10 In the wild, Formica fusca can encounter similar chemicals in aphids and dead ants.",38,47,encounter,1,4,5
3LXX8KJXPWA5SPW41ZYDSECDNRTO9P,"#42-10 In the wild, Formica fusca can encounter similar chemicals in aphids and dead ants.",56,65,chemicals,2,0,2
3LXX8KJXPWA5SPW41ZYDSECDNRTO9P,"#42-10 In the wild, Formica fusca can encounter similar chemicals in aphids and dead ants.",69,75,aphids,8,7,15
3LXX8KJXPWA5SPW41ZYDSECDNRTO9P,#42-11 The Independent reported self-medicating ants a first among insects.,11,22,Independent,1,0,1
3LXX8KJXPWA5SPW41ZYDSECDNRTO9P,#42-11 The Independent reported self-medicating ants a first among insects.,32,47,self-medicating,5,5,10
3LXX8KJXPWA5SPW41ZYDSECDNRTO9P,#42-12 Bos obtained his doctorate from the University of Copenhagen.,7,10,Bos,0,1,1
3LXX8KJXPWA5SPW41ZYDSECDNRTO9P,#42-12 Bos obtained his doctorate from the University of Copenhagen.,11,19,obtained,0,1,1
3LXX8KJXPWA5SPW41ZYDSECDNRTO9P,#42-12 Bos obtained his doctorate from the University of Copenhagen.,24,33,doctorate,10,2,12
3LXX8KJXPWA5SPW41ZYDSECDNRTO9P,#42-12 Bos obtained his doctorate from the University of Copenhagen.,57,67,Copenhagen,1,1,2
3LXX8KJXPWA5SPW41ZYDSECDNRTO9P,#42-13 He began postdoctoral research at Helsinki in 2012.,16,28,postdoctoral,10,3,13
3LXX8KJXPWA5SPW41ZYDSECDNRTO9P,#42-13 He began postdoctoral research at Helsinki in 2012.,16,37,postdoctoral research,0,3,3
3LXX8KJXPWA5SPW41ZYDSECDNRTO9P,#42-13 He began postdoctoral research at Helsinki in 2012.,29,37,research,1,1,2
3LXX8KJXPWA5SPW41ZYDSECDNRTO9P,#42-13 He began postdoctoral research at Helsinki in 2012.,41,49,Helsinki,2,1,3
3LXX8KJXPWA5SPW41ZYDSECDNRTO9P,#42-14 He also runs the AntyScience blog.,24,35,AntyScience,1,4,5
3LXX8KJXPWA5SPW41ZYDSECDNRTO9P,#42-14 He also runs the AntyScience blog.,36,40,blog,1,0,1
3LXX8KJXPWA5SPW41ZYDSECDNRTO9P,"#42-15 The blog aims to help address ""a gap between scientists and 'the general public'.""",11,15,blog,1,0,1
3LXX8KJXPWA5SPW41ZYDSECDNRTO9P,"#42-15 The blog aims to help address ""a gap between scientists and 'the general public'.""",38,62,a gap between scientists,0,1,1
3LXX8KJXPWA5SPW41ZYDSECDNRTO9P,"#42-15 The blog aims to help address ""a gap between scientists and 'the general public'.""",40,43,gap,0,1,1
3LXX8KJXPWA5SPW41ZYDSECDNRTO9P,"#42-15 The blog aims to help address ""a gap between scientists and 'the general public'.""",52,62,scientists,2,0,2
3LXX8KJXPWA5SPW41ZYDSECDNRTO9P,"#42-16 The name is a pun referencing ants, its primary topic, science, and ""non-scientific"" jargon-free communication.",21,24,pun,2,4,6
3LXX8KJXPWA5SPW41ZYDSECDNRTO9P,"#42-16 The name is a pun referencing ants, its primary topic, science, and ""non-scientific"" jargon-free communication.",21,36,pun referencing,0,1,1
3LXX8KJXPWA5SPW41ZYDSECDNRTO9P,"#42-16 The name is a pun referencing ants, its primary topic, science, and ""non-scientific"" jargon-free communication.",25,36,referencing,1,2,3
3LXX8KJXPWA5SPW41ZYDSECDNRTO9P,"#42-16 The name is a pun referencing ants, its primary topic, science, and ""non-scientific"" jargon-free communication.",75,115,non-scientific jargon-free communication,1,0,1
3LXX8KJXPWA5SPW41ZYDSECDNRTO9P,"#42-16 The name is a pun referencing ants, its primary topic, science, and ""non-scientific"" jargon-free communication.",76,90,non-scientific,1,1,2
3LXX8KJXPWA5SPW41ZYDSECDNRTO9P,"#42-16 The name is a pun referencing ants, its primary topic, science, and ""non-scientific"" jargon-free communication.",92,103,jargon-free,5,6,11
3LXX8KJXPWA5SPW41ZYDSECDNRTO9P,"#42-16 The name is a pun referencing ants, its primary topic, science, and ""non-scientific"" jargon-free communication.",92,117,jargon-free communication,3,1,4
3LXX8KJXPWA5SPW41ZYDSECDNRTO9P,"#42-16 The name is a pun referencing ants, its primary topic, science, and ""non-scientific"" jargon-free communication.",104,117,communication,2,0,2
3LXX8KJXPWA5SPW41ZYDSECDNRTO9P,#42-17 He now discusses his work with Wikinews.,14,23,discusses,0,1,1
3LXX8KJXPWA5SPW41ZYDSECDNRTO9P,#42-17 He now discusses his work with Wikinews.,38,46,Wikinews,1,0,1
3LXX8KJXPWA5SPW41ZYDSECDNRTO9P,#42-18 Wikinews: What first attracted you to researching ants?,28,37,attracted,1,0,1
3LXX8KJXPWA5SPW41ZYDSECDNRTO9P,#42-18 Wikinews: What first attracted you to researching ants?,45,56,researching,1,0,1
371QPA24C2P3GCYHT35J7I0HONM1TF,#19-12 The chief is looking into these allegations to see if there were paying passengers.,11,16,chief,1,0,1
371QPA24C2P3GCYHT35J7I0HONM1TF,#19-12 The chief is looking into these allegations to see if there were paying passengers.,39,50,allegations,10,10,20
371QPA24C2P3GCYHT35J7I0HONM1TF,#19-12 The chief is looking into these allegations to see if there were paying passengers.,79,89,passengers,4,1,5
371QPA24C2P3GCYHT35J7I0HONM1TF,"#19-13 An AirAsia jet crashed in the Java Sea last December, killing everyone aboard.",10,17,AirAsia,1,1,2
371QPA24C2P3GCYHT35J7I0HONM1TF,"#19-13 An AirAsia jet crashed in the Java Sea last December, killing everyone aboard.",22,29,crashed,1,2,3
371QPA24C2P3GCYHT35J7I0HONM1TF,"#19-13 An AirAsia jet crashed in the Java Sea last December, killing everyone aboard.",78,84,aboard,1,6,7
371QPA24C2P3GCYHT35J7I0HONM1TF,#19-14 The cause of this C-130 crash has yet to be determined.,51,61,determined,3,4,7
371QPA24C2P3GCYHT35J7I0HONM1TF,"#2-1 Nigerian jet attacks refugee camp, killing dozens A Nigerian Air Force jet fighter mistook refugees for rebels yesterday, Nigerian military said, firing on a camp in Rann, Borno State.",5,13,Nigerian,0,1,1
371QPA24C2P3GCYHT35J7I0HONM1TF,"#2-1 Nigerian jet attacks refugee camp, killing dozens A Nigerian Air Force jet fighter mistook refugees for rebels yesterday, Nigerian military said, firing on a camp in Rann, Borno State.",26,33,refugee,5,5,10
371QPA24C2P3GCYHT35J7I0HONM1TF,"#2-1 Nigerian jet attacks refugee camp, killing dozens A Nigerian Air Force jet fighter mistook refugees for rebels yesterday, Nigerian military said, firing on a camp in Rann, Borno State.",26,38,refugee camp,2,0,2
371QPA24C2P3GCYHT35J7I0HONM1TF,"#2-1 Nigerian jet attacks refugee camp, killing dozens A Nigerian Air Force jet fighter mistook refugees for rebels yesterday, Nigerian military said, firing on a camp in Rann, Borno State.",88,95,mistook,5,6,11
371QPA24C2P3GCYHT35J7I0HONM1TF,"#2-1 Nigerian jet attacks refugee camp, killing dozens A Nigerian Air Force jet fighter mistook refugees for rebels yesterday, Nigerian military said, firing on a camp in Rann, Borno State.",96,104,refugees,3,3,6
371QPA24C2P3GCYHT35J7I0HONM1TF,"#2-1 Nigerian jet attacks refugee camp, killing dozens A Nigerian Air Force jet fighter mistook refugees for rebels yesterday, Nigerian military said, firing on a camp in Rann, Borno State.",109,115,rebels,3,3,6
371QPA24C2P3GCYHT35J7I0HONM1TF,"#2-1 Nigerian jet attacks refugee camp, killing dozens A Nigerian Air Force jet fighter mistook refugees for rebels yesterday, Nigerian military said, firing on a camp in Rann, Borno State.",136,144,military,1,0,1
371QPA24C2P3GCYHT35J7I0HONM1TF,"#2-1 Nigerian jet attacks refugee camp, killing dozens A Nigerian Air Force jet fighter mistook refugees for rebels yesterday, Nigerian military said, firing on a camp in Rann, Borno State.",151,157,firing,1,1,2
371QPA24C2P3GCYHT35J7I0HONM1TF,"#2-1 Nigerian jet attacks refugee camp, killing dozens A Nigerian Air Force jet fighter mistook refugees for rebels yesterday, Nigerian military said, firing on a camp in Rann, Borno State.",171,175,Rann,1,1,2
371QPA24C2P3GCYHT35J7I0HONM1TF,"#2-1 Nigerian jet attacks refugee camp, killing dozens A Nigerian Air Force jet fighter mistook refugees for rebels yesterday, Nigerian military said, firing on a camp in Rann, Borno State.",177,188,Borno State,1,1,2
371QPA24C2P3GCYHT35J7I0HONM1TF,#2-2 Dozens of refugees and aid workers died.,5,11,Dozens,1,1,2
371QPA24C2P3GCYHT35J7I0HONM1TF,#2-2 Dozens of refugees and aid workers died.,15,23,refugees,5,2,7
371QPA24C2P3GCYHT35J7I0HONM1TF,#2-2 Dozens of refugees and aid workers died.,28,39,aid workers,0,1,1
371QPA24C2P3GCYHT35J7I0HONM1TF,#2-3 The lowest estimate from Médecins Sans Frontières (MSF) is of 50 dead.,16,24,estimate,6,2,8
371QPA24C2P3GCYHT35J7I0HONM1TF,#2-3 The lowest estimate from Médecins Sans Frontières (MSF) is of 50 dead.,30,38,Médecins,1,1,2
371QPA24C2P3GCYHT35J7I0HONM1TF,#2-3 The lowest estimate from Médecins Sans Frontières (MSF) is of 50 dead.,30,54,Médecins Sans Frontières,2,0,2
371QPA24C2P3GCYHT35J7I0HONM1TF,#2-3 The lowest estimate from Médecins Sans Frontières (MSF) is of 50 dead.,39,54,Sans Frontières,0,1,1
371QPA24C2P3GCYHT35J7I0HONM1TF,#2-3 The lowest estimate from Médecins Sans Frontières (MSF) is of 50 dead.,44,54,Frontières,1,0,1
371QPA24C2P3GCYHT35J7I0HONM1TF,"#2-4 The BBC estimates at least 52 dead, while one Borno State official is attributed by AP as saying over 100 are dead.",13,22,estimates,1,1,2
371QPA24C2P3GCYHT35J7I0HONM1TF,"#2-4 The BBC estimates at least 52 dead, while one Borno State official is attributed by AP as saying over 100 are dead.",51,56,Borno,1,1,2
371QPA24C2P3GCYHT35J7I0HONM1TF,"#2-4 The BBC estimates at least 52 dead, while one Borno State official is attributed by AP as saying over 100 are dead.",75,85,attributed,10,9,19
371QPA24C2P3GCYHT35J7I0HONM1TF,"#2-4 The BBC estimates at least 52 dead, while one Borno State official is attributed by AP as saying over 100 are dead.",89,91,AP,1,0,1
371QPA24C2P3GCYHT35J7I0HONM1TF,#2-5 MSF say at least 200 were wounded.,31,38,wounded,2,5,7
371QPA24C2P3GCYHT35J7I0HONM1TF,#2-6 The Red Cross said at least six of its staff died and twelve more injured.,71,78,injured,3,3,6
3X2LT8FDHWJDJTMWNTJ99CUO6NA8WW,#10-23 US–Russian relations are also strained.,18,27,relations,1,0,1
3X2LT8FDHWJDJTMWNTJ99CUO6NA8WW,#10-23 US–Russian relations are also strained.,37,45,strained,8,10,18
3X2LT8FDHWJDJTMWNTJ99CUO6NA8WW,"#10-24 Last month the US expelled 35 Russian diplomats accused of espionage, and sanctioned Russian intelligence agencies.",25,33,expelled,5,6,11
3X2LT8FDHWJDJTMWNTJ99CUO6NA8WW,"#10-24 Last month the US expelled 35 Russian diplomats accused of espionage, and sanctioned Russian intelligence agencies.",45,54,diplomats,7,2,9
3X2LT8FDHWJDJTMWNTJ99CUO6NA8WW,"#10-24 Last month the US expelled 35 Russian diplomats accused of espionage, and sanctioned Russian intelligence agencies.",55,62,accused,2,1,3
3X2LT8FDHWJDJTMWNTJ99CUO6NA8WW,"#10-24 Last month the US expelled 35 Russian diplomats accused of espionage, and sanctioned Russian intelligence agencies.",66,75,espionage,10,10,20
3X2LT8FDHWJDJTMWNTJ99CUO6NA8WW,"#10-24 Last month the US expelled 35 Russian diplomats accused of espionage, and sanctioned Russian intelligence agencies.",81,91,sanctioned,10,3,13
3X2LT8FDHWJDJTMWNTJ99CUO6NA8WW,"#10-24 Last month the US expelled 35 Russian diplomats accused of espionage, and sanctioned Russian intelligence agencies.",100,112,intelligence,1,0,1
3X2LT8FDHWJDJTMWNTJ99CUO6NA8WW,"#10-24 Last month the US expelled 35 Russian diplomats accused of espionage, and sanctioned Russian intelligence agencies.",100,121,intelligence agencies,1,0,1
3X2LT8FDHWJDJTMWNTJ99CUO6NA8WW,"#10-24 Last month the US expelled 35 Russian diplomats accused of espionage, and sanctioned Russian intelligence agencies.",113,121,agencies,1,0,1
3X2LT8FDHWJDJTMWNTJ99CUO6NA8WW,#10-25 This was in response to a CIA report issued two weeks earlier that concluded the Russian government hacked servers belonging to the U.S. Republican and Democratic parties.,44,50,issued,0,1,1
3X2LT8FDHWJDJTMWNTJ99CUO6NA8WW,#10-25 This was in response to a CIA report issued two weeks earlier that concluded the Russian government hacked servers belonging to the U.S. Republican and Democratic parties.,74,83,concluded,3,2,5
3X2LT8FDHWJDJTMWNTJ99CUO6NA8WW,#10-25 This was in response to a CIA report issued two weeks earlier that concluded the Russian government hacked servers belonging to the U.S. Republican and Democratic parties.,107,113,hacked,2,6,8
3X2LT8FDHWJDJTMWNTJ99CUO6NA8WW,#10-25 This was in response to a CIA report issued two weeks earlier that concluded the Russian government hacked servers belonging to the U.S. Republican and Democratic parties.,107,121,hacked servers,1,1,2
3X2LT8FDHWJDJTMWNTJ99CUO6NA8WW,#10-25 This was in response to a CIA report issued two weeks earlier that concluded the Russian government hacked servers belonging to the U.S. Republican and Democratic parties.,170,177,parties,1,0,1
3X2LT8FDHWJDJTMWNTJ99CUO6NA8WW,#10-26 The CIA report said this was to turn the 2016 presidential election toward president-elect Donald Trump.,53,65,presidential,1,0,1
3X2LT8FDHWJDJTMWNTJ99CUO6NA8WW,#10-26 The CIA report said this was to turn the 2016 presidential election toward president-elect Donald Trump.,53,74,presidential election,1,0,1
3X2LT8FDHWJDJTMWNTJ99CUO6NA8WW,#10-26 The CIA report said this was to turn the 2016 presidential election toward president-elect Donald Trump.,82,97,president-elect,1,0,1
3X2LT8FDHWJDJTMWNTJ99CUO6NA8WW,#10-27 Trump has indicated he seeks closer ties with Russia.,17,26,indicated,2,1,3
3X2LT8FDHWJDJTMWNTJ99CUO6NA8WW,#10-27 Trump has indicated he seeks closer ties with Russia.,43,47,ties,1,2,3
3X2LT8FDHWJDJTMWNTJ99CUO6NA8WW,"#10-29 ""This is America's most capable fighting force: A combat-ready, highly trained US armoured brigade, with our most advanced equipment and weaponry,"" according to Paul James, US ambassador to Poland.",31,38,capable,1,1,2
3X2LT8FDHWJDJTMWNTJ99CUO6NA8WW,"#10-29 ""This is America's most capable fighting force: A combat-ready, highly trained US armoured brigade, with our most advanced equipment and weaponry,"" according to Paul James, US ambassador to Poland.",57,69,combat-ready,4,2,6
3X2LT8FDHWJDJTMWNTJ99CUO6NA8WW,"#10-29 ""This is America's most capable fighting force: A combat-ready, highly trained US armoured brigade, with our most advanced equipment and weaponry,"" according to Paul James, US ambassador to Poland.",86,105,US armoured brigade,0,1,1
3X2LT8FDHWJDJTMWNTJ99CUO6NA8WW,"#10-29 ""This is America's most capable fighting force: A combat-ready, highly trained US armoured brigade, with our most advanced equipment and weaponry,"" according to Paul James, US ambassador to Poland.",89,97,armoured,5,2,7
3X2LT8FDHWJDJTMWNTJ99CUO6NA8WW,"#10-29 ""This is America's most capable fighting force: A combat-ready, highly trained US armoured brigade, with our most advanced equipment and weaponry,"" according to Paul James, US ambassador to Poland.",89,105,armoured brigade,3,2,5
3X2LT8FDHWJDJTMWNTJ99CUO6NA8WW,"#10-29 ""This is America's most capable fighting force: A combat-ready, highly trained US armoured brigade, with our most advanced equipment and weaponry,"" according to Paul James, US ambassador to Poland.",98,105,brigade,4,2,6
3X2LT8FDHWJDJTMWNTJ99CUO6NA8WW,"#10-29 ""This is America's most capable fighting force: A combat-ready, highly trained US armoured brigade, with our most advanced equipment and weaponry,"" according to Paul James, US ambassador to Poland.",130,139,equipment,0,2,2
3X2LT8FDHWJDJTMWNTJ99CUO6NA8WW,"#10-29 ""This is America's most capable fighting force: A combat-ready, highly trained US armoured brigade, with our most advanced equipment and weaponry,"" according to Paul James, US ambassador to Poland.",144,152,weaponry,5,8,13
3X2LT8FDHWJDJTMWNTJ99CUO6NA8WW,"#10-29 ""This is America's most capable fighting force: A combat-ready, highly trained US armoured brigade, with our most advanced equipment and weaponry,"" according to Paul James, US ambassador to Poland.",183,193,ambassador,3,2,5
3X2LT8FDHWJDJTMWNTJ99CUO6NA8WW,"#10-30 James, who attended the ceremony, said the troops represent ""America's iron-clad commitment to honor our NATO treaty obligation to defend our NATO allies.""",31,39,ceremony,2,2,4
3X2LT8FDHWJDJTMWNTJ99CUO6NA8WW,"#10-30 James, who attended the ceremony, said the troops represent ""America's iron-clad commitment to honor our NATO treaty obligation to defend our NATO allies.""",78,87,iron-clad,4,4,8
3X2LT8FDHWJDJTMWNTJ99CUO6NA8WW,"#10-30 James, who attended the ceremony, said the troops represent ""America's iron-clad commitment to honor our NATO treaty obligation to defend our NATO allies.""",78,98,iron-clad commitment,1,1,2
3X2LT8FDHWJDJTMWNTJ99CUO6NA8WW,"#10-30 James, who attended the ceremony, said the troops represent ""America's iron-clad commitment to honor our NATO treaty obligation to defend our NATO allies.""",88,98,commitment,1,2,3
3X2LT8FDHWJDJTMWNTJ99CUO6NA8WW,"#10-30 James, who attended the ceremony, said the troops represent ""America's iron-clad commitment to honor our NATO treaty obligation to defend our NATO allies.""",112,134,NATO treaty obligation,1,0,1
3X2LT8FDHWJDJTMWNTJ99CUO6NA8WW,"#10-30 James, who attended the ceremony, said the troops represent ""America's iron-clad commitment to honor our NATO treaty obligation to defend our NATO allies.""",117,134,treaty obligation,1,0,1
3X2LT8FDHWJDJTMWNTJ99CUO6NA8WW,"#10-30 James, who attended the ceremony, said the troops represent ""America's iron-clad commitment to honor our NATO treaty obligation to defend our NATO allies.""",124,134,obligation,4,6,10
3X2LT8FDHWJDJTMWNTJ99CUO6NA8WW,"#10-30 James, who attended the ceremony, said the troops represent ""America's iron-clad commitment to honor our NATO treaty obligation to defend our NATO allies.""",149,160,NATO allies,1,2,3
382GHPVPHSSF9UX616IUN33M68J43E,"#15-31 Russia has refused to return wreckage, encouraging conspiracy theories about the crash.",18,25,refused,2,0,2
382GHPVPHSSF9UX616IUN33M68J43E,"#15-31 Russia has refused to return wreckage, encouraging conspiracy theories about the crash.",29,44,return wreckage,0,1,1
382GHPVPHSSF9UX616IUN33M68J43E,"#15-31 Russia has refused to return wreckage, encouraging conspiracy theories about the crash.",36,44,wreckage,10,10,20
382GHPVPHSSF9UX616IUN33M68J43E,"#15-31 Russia has refused to return wreckage, encouraging conspiracy theories about the crash.",46,57,encouraging,1,2,3
382GHPVPHSSF9UX616IUN33M68J43E,"#15-31 Russia has refused to return wreckage, encouraging conspiracy theories about the crash.",46,68,encouraging conspiracy,2,0,2
382GHPVPHSSF9UX616IUN33M68J43E,"#15-31 Russia has refused to return wreckage, encouraging conspiracy theories about the crash.",46,77,encouraging conspiracy theories,1,1,2
382GHPVPHSSF9UX616IUN33M68J43E,"#15-31 Russia has refused to return wreckage, encouraging conspiracy theories about the crash.",58,68,conspiracy,7,5,12
382GHPVPHSSF9UX616IUN33M68J43E,"#15-31 Russia has refused to return wreckage, encouraging conspiracy theories about the crash.",58,77,conspiracy theories,3,2,5
382GHPVPHSSF9UX616IUN33M68J43E,"#15-31 Russia has refused to return wreckage, encouraging conspiracy theories about the crash.",69,77,theories,3,0,3
382GHPVPHSSF9UX616IUN33M68J43E,"#15-32 In 2015 Szydło said in response to the vanishing investigatory findings ""the website has been closed and will simply remain closed.""",27,41,in response to,0,1,1
382GHPVPHSSF9UX616IUN33M68J43E,"#15-32 In 2015 Szydło said in response to the vanishing investigatory findings ""the website has been closed and will simply remain closed.""",46,55,vanishing,7,8,15
382GHPVPHSSF9UX616IUN33M68J43E,"#15-32 In 2015 Szydło said in response to the vanishing investigatory findings ""the website has been closed and will simply remain closed.""",46,78,vanishing investigatory findings,1,2,3
382GHPVPHSSF9UX616IUN33M68J43E,"#15-32 In 2015 Szydło said in response to the vanishing investigatory findings ""the website has been closed and will simply remain closed.""",56,69,investigatory,4,2,6
382GHPVPHSSF9UX616IUN33M68J43E,"#15-32 In 2015 Szydło said in response to the vanishing investigatory findings ""the website has been closed and will simply remain closed.""",56,78,investigatory findings,1,0,1
382GHPVPHSSF9UX616IUN33M68J43E,#15-33 In recent months tension has mounted further as Russia deployed missiles to Kalingrad.,24,31,tension,3,0,3
382GHPVPHSSF9UX616IUN33M68J43E,#15-33 In recent months tension has mounted further as Russia deployed missiles to Kalingrad.,36,43,mounted,3,2,5
382GHPVPHSSF9UX616IUN33M68J43E,#15-33 In recent months tension has mounted further as Russia deployed missiles to Kalingrad.,62,70,deployed,7,6,13
382GHPVPHSSF9UX616IUN33M68J43E,#15-33 In recent months tension has mounted further as Russia deployed missiles to Kalingrad.,71,79,missiles,1,0,1
382GHPVPHSSF9UX616IUN33M68J43E,#15-33 In recent months tension has mounted further as Russia deployed missiles to Kalingrad.,83,92,Kalingrad,1,0,1
382GHPVPHSSF9UX616IUN33M68J43E,"#15-34 The enclave, Russian territory lying between Poland and Lithuania, now has nuclear-capable Iskanders and anti-ship Bastion equipment.",11,18,enclave,6,5,11
382GHPVPHSSF9UX616IUN33M68J43E,"#15-34 The enclave, Russian territory lying between Poland and Lithuania, now has nuclear-capable Iskanders and anti-ship Bastion equipment.",28,37,territory,0,2,2
382GHPVPHSSF9UX616IUN33M68J43E,"#15-34 The enclave, Russian territory lying between Poland and Lithuania, now has nuclear-capable Iskanders and anti-ship Bastion equipment.",38,43,lying,0,1,1
382GHPVPHSSF9UX616IUN33M68J43E,"#15-34 The enclave, Russian territory lying between Poland and Lithuania, now has nuclear-capable Iskanders and anti-ship Bastion equipment.",82,97,nuclear-capable,8,2,10
382GHPVPHSSF9UX616IUN33M68J43E,"#15-34 The enclave, Russian territory lying between Poland and Lithuania, now has nuclear-capable Iskanders and anti-ship Bastion equipment.",98,107,Iskanders,2,1,3
382GHPVPHSSF9UX616IUN33M68J43E,"#15-34 The enclave, Russian territory lying between Poland and Lithuania, now has nuclear-capable Iskanders and anti-ship Bastion equipment.",112,121,anti-ship,2,1,3
382GHPVPHSSF9UX616IUN33M68J43E,"#15-34 The enclave, Russian territory lying between Poland and Lithuania, now has nuclear-capable Iskanders and anti-ship Bastion equipment.",112,129,anti-ship Bastion,1,0,1
382GHPVPHSSF9UX616IUN33M68J43E,"#15-34 The enclave, Russian territory lying between Poland and Lithuania, now has nuclear-capable Iskanders and anti-ship Bastion equipment.",112,139,anti-ship Bastion equipment,1,0,1
382GHPVPHSSF9UX616IUN33M68J43E,"#15-34 The enclave, Russian territory lying between Poland and Lithuania, now has nuclear-capable Iskanders and anti-ship Bastion equipment.",122,139,Bastion equipment,1,0,1
382GHPVPHSSF9UX616IUN33M68J43E,"#15-34 The enclave, Russian territory lying between Poland and Lithuania, now has nuclear-capable Iskanders and anti-ship Bastion equipment.",130,139,equipment,2,0,2
382GHPVPHSSF9UX616IUN33M68J43E,#15-35 NATO considered these deployments a response to its own.,29,40,deployments,6,4,10
382GHPVPHSSF9UX616IUN33M68J43E,#15-36 The US troops are set to rotate around the Balkans every nine months.,14,20,troops,0,1,1
382GHPVPHSSF9UX616IUN33M68J43E,#15-36 The US troops are set to rotate around the Balkans every nine months.,32,38,rotate,1,0,1
382GHPVPHSSF9UX616IUN33M68J43E,"#15-37 Other planned host nations are Estonia, Latvia, Lithuania, Romania, Bulgaria, and Hungary.",21,25,host,0,1,1
382GHPVPHSSF9UX616IUN33M68J43E,#15-38 The rotation is due to a treaty with Russia preventing permanent deployment to any particular territory.,11,19,rotation,3,0,3
382GHPVPHSSF9UX616IUN33M68J43E,#15-38 The rotation is due to a treaty with Russia preventing permanent deployment to any particular territory.,32,38,treaty,5,4,9
382GHPVPHSSF9UX616IUN33M68J43E,#15-38 The rotation is due to a treaty with Russia preventing permanent deployment to any particular territory.,62,71,permanent,3,0,3
382GHPVPHSSF9UX616IUN33M68J43E,#15-38 The rotation is due to a treaty with Russia preventing permanent deployment to any particular territory.,72,82,deployment,3,3,6
382GHPVPHSSF9UX616IUN33M68J43E,#15-38 The rotation is due to a treaty with Russia preventing permanent deployment to any particular territory.,90,100,particular,3,0,3
382GHPVPHSSF9UX616IUN33M68J43E,#15-38 The rotation is due to a treaty with Russia preventing permanent deployment to any particular territory.,101,110,territory,4,1,5
382GHPVPHSSF9UX616IUN33M68J43E,"#15-39 Russia-US relations face a potential thaw, as President-Elect Donald Trump moves towards office on January 20.",34,43,potential,3,4,7
382GHPVPHSSF9UX616IUN33M68J43E,"#15-39 Russia-US relations face a potential thaw, as President-Elect Donald Trump moves towards office on January 20.",34,48,potential thaw,1,2,3
382GHPVPHSSF9UX616IUN33M68J43E,"#15-39 Russia-US relations face a potential thaw, as President-Elect Donald Trump moves towards office on January 20.",44,48,thaw,7,5,12
307FVKVSYRGXADYT3ILK0KF2BA547J,"#24-13 According to the resort's manager Mr. Naseem, the bigger pieces of debris and other waste were taken away and disposed of in the usual way.",7,16,According,1,0,1
307FVKVSYRGXADYT3ILK0KF2BA547J,"#24-13 According to the resort's manager Mr. Naseem, the bigger pieces of debris and other waste were taken away and disposed of in the usual way.",7,19,According to,1,0,1
307FVKVSYRGXADYT3ILK0KF2BA547J,"#24-13 According to the resort's manager Mr. Naseem, the bigger pieces of debris and other waste were taken away and disposed of in the usual way.",24,31,resorts,1,0,1
307FVKVSYRGXADYT3ILK0KF2BA547J,"#24-13 According to the resort's manager Mr. Naseem, the bigger pieces of debris and other waste were taken away and disposed of in the usual way.",64,70,pieces,0,1,1
307FVKVSYRGXADYT3ILK0KF2BA547J,"#24-13 According to the resort's manager Mr. Naseem, the bigger pieces of debris and other waste were taken away and disposed of in the usual way.",74,80,debris,10,10,20
307FVKVSYRGXADYT3ILK0KF2BA547J,"#24-13 According to the resort's manager Mr. Naseem, the bigger pieces of debris and other waste were taken away and disposed of in the usual way.",117,125,disposed,7,7,14
307FVKVSYRGXADYT3ILK0KF2BA547J,"#24-14 He added other forms of debris and trash with no value, such as buoys and suspected military waste, wash up on the islands all the time, especially during monsoon season.",31,37,debris,3,2,5
307FVKVSYRGXADYT3ILK0KF2BA547J,"#24-14 He added other forms of debris and trash with no value, such as buoys and suspected military waste, wash up on the islands all the time, especially during monsoon season.",42,47,trash,1,2,3
307FVKVSYRGXADYT3ILK0KF2BA547J,"#24-14 He added other forms of debris and trash with no value, such as buoys and suspected military waste, wash up on the islands all the time, especially during monsoon season.",71,76,buoys,10,6,16
307FVKVSYRGXADYT3ILK0KF2BA547J,"#24-14 He added other forms of debris and trash with no value, such as buoys and suspected military waste, wash up on the islands all the time, especially during monsoon season.",81,90,suspected,3,1,4
307FVKVSYRGXADYT3ILK0KF2BA547J,"#24-14 He added other forms of debris and trash with no value, such as buoys and suspected military waste, wash up on the islands all the time, especially during monsoon season.",81,99,suspected military,1,0,1
307FVKVSYRGXADYT3ILK0KF2BA547J,"#24-14 He added other forms of debris and trash with no value, such as buoys and suspected military waste, wash up on the islands all the time, especially during monsoon season.",81,105,suspected military waste,1,3,4
307FVKVSYRGXADYT3ILK0KF2BA547J,"#24-14 He added other forms of debris and trash with no value, such as buoys and suspected military waste, wash up on the islands all the time, especially during monsoon season.",107,114,wash up,0,1,1
307FVKVSYRGXADYT3ILK0KF2BA547J,"#24-14 He added other forms of debris and trash with no value, such as buoys and suspected military waste, wash up on the islands all the time, especially during monsoon season.",144,154,especially,1,2,3
307FVKVSYRGXADYT3ILK0KF2BA547J,"#24-14 He added other forms of debris and trash with no value, such as buoys and suspected military waste, wash up on the islands all the time, especially during monsoon season.",162,169,monsoon,9,3,12
307FVKVSYRGXADYT3ILK0KF2BA547J,"#24-14 He added other forms of debris and trash with no value, such as buoys and suspected military waste, wash up on the islands all the time, especially during monsoon season.",162,176,monsoon season,2,1,3
307FVKVSYRGXADYT3ILK0KF2BA547J,"#24-15 Local residents and resort workers regularly collect trash which is sent to the garbage island Thilafushi where it's sorted, exported for recycling, or burned.",13,22,residents,1,0,1
307FVKVSYRGXADYT3ILK0KF2BA547J,"#24-15 Local residents and resort workers regularly collect trash which is sent to the garbage island Thilafushi where it's sorted, exported for recycling, or burned.",27,33,resort,1,0,1
307FVKVSYRGXADYT3ILK0KF2BA547J,"#24-15 Local residents and resort workers regularly collect trash which is sent to the garbage island Thilafushi where it's sorted, exported for recycling, or burned.",42,51,regularly,1,0,1
307FVKVSYRGXADYT3ILK0KF2BA547J,"#24-15 Local residents and resort workers regularly collect trash which is sent to the garbage island Thilafushi where it's sorted, exported for recycling, or burned.",60,65,trash,1,0,1
307FVKVSYRGXADYT3ILK0KF2BA547J,"#24-15 Local residents and resort workers regularly collect trash which is sent to the garbage island Thilafushi where it's sorted, exported for recycling, or burned.",87,94,garbage,1,5,6
307FVKVSYRGXADYT3ILK0KF2BA547J,"#24-15 Local residents and resort workers regularly collect trash which is sent to the garbage island Thilafushi where it's sorted, exported for recycling, or burned.",87,101,garbage island,0,1,1
307FVKVSYRGXADYT3ILK0KF2BA547J,"#24-15 Local residents and resort workers regularly collect trash which is sent to the garbage island Thilafushi where it's sorted, exported for recycling, or burned.",102,112,Thilafushi,3,0,3
307FVKVSYRGXADYT3ILK0KF2BA547J,"#24-15 Local residents and resort workers regularly collect trash which is sent to the garbage island Thilafushi where it's sorted, exported for recycling, or burned.",124,130,sorted,2,4,6
307FVKVSYRGXADYT3ILK0KF2BA547J,"#24-15 Local residents and resort workers regularly collect trash which is sent to the garbage island Thilafushi where it's sorted, exported for recycling, or burned.",132,140,exported,3,2,5
307FVKVSYRGXADYT3ILK0KF2BA547J,"#24-15 Local residents and resort workers regularly collect trash which is sent to the garbage island Thilafushi where it's sorted, exported for recycling, or burned.",132,154,exported for recycling,1,0,1
307FVKVSYRGXADYT3ILK0KF2BA547J,"#24-15 Local residents and resort workers regularly collect trash which is sent to the garbage island Thilafushi where it's sorted, exported for recycling, or burned.",145,154,recycling,4,4,8
307FVKVSYRGXADYT3ILK0KF2BA547J,"#24-16 Reports say at the time the debris was collected, no one suspected it could be from MH370.",35,41,debris,1,1,2
307FVKVSYRGXADYT3ILK0KF2BA547J,"#24-16 Reports say at the time the debris was collected, no one suspected it could be from MH370.",64,73,suspected,2,1,3
307FVKVSYRGXADYT3ILK0KF2BA547J,"#24-17 ""Although some of it was taken to Thilafushi, there is still a five or a seven inch piece on the resort.",41,51,Thilafushi,2,0,2
307FVKVSYRGXADYT3ILK0KF2BA547J,"#24-17 ""Although some of it was taken to Thilafushi, there is still a five or a seven inch piece on the resort.",86,90,inch,0,1,1
307FVKVSYRGXADYT3ILK0KF2BA547J,"#24-17 ""Although some of it was taken to Thilafushi, there is still a five or a seven inch piece on the resort.",104,110,resort,2,1,3
3EKZL9T8Y8NXY6HK96DEAVGKHQIHCB,"#29-1 'Birther King' announces 2016 campaign for U.S. president Via press release on Friday, Andy Martin, a perennial candidate for political office and self-proclaimed ""Birther King"", announced he is seeking the U.S. Republican Party's 2016 presidential nomination, his fourth bid for the White House.",7,19,Birther King,1,1,2
3EKZL9T8Y8NXY6HK96DEAVGKHQIHCB,"#29-1 'Birther King' announces 2016 campaign for U.S. president Via press release on Friday, Andy Martin, a perennial candidate for political office and self-proclaimed ""Birther King"", announced he is seeking the U.S. Republican Party's 2016 presidential nomination, his fourth bid for the White House.",7,14,Birther,2,1,3
3EKZL9T8Y8NXY6HK96DEAVGKHQIHCB,"#29-1 'Birther King' announces 2016 campaign for U.S. president Via press release on Friday, Andy Martin, a perennial candidate for political office and self-proclaimed ""Birther King"", announced he is seeking the U.S. Republican Party's 2016 presidential nomination, his fourth bid for the White House.",21,30,announces,1,0,1
3EKZL9T8Y8NXY6HK96DEAVGKHQIHCB,"#29-1 'Birther King' announces 2016 campaign for U.S. president Via press release on Friday, Andy Martin, a perennial candidate for political office and self-proclaimed ""Birther King"", announced he is seeking the U.S. Republican Party's 2016 presidential nomination, his fourth bid for the White House.",36,44,campaign,2,3,5
3EKZL9T8Y8NXY6HK96DEAVGKHQIHCB,"#29-1 'Birther King' announces 2016 campaign for U.S. president Via press release on Friday, Andy Martin, a perennial candidate for political office and self-proclaimed ""Birther King"", announced he is seeking the U.S. Republican Party's 2016 presidential nomination, his fourth bid for the White House.",106,117,a perennial,1,0,1
3EKZL9T8Y8NXY6HK96DEAVGKHQIHCB,"#29-1 'Birther King' announces 2016 campaign for U.S. president Via press release on Friday, Andy Martin, a perennial candidate for political office and self-proclaimed ""Birther King"", announced he is seeking the U.S. Republican Party's 2016 presidential nomination, his fourth bid for the White House.",108,117,perennial,9,7,16
3EKZL9T8Y8NXY6HK96DEAVGKHQIHCB,"#29-1 'Birther King' announces 2016 campaign for U.S. president Via press release on Friday, Andy Martin, a perennial candidate for political office and self-proclaimed ""Birther King"", announced he is seeking the U.S. Republican Party's 2016 presidential nomination, his fourth bid for the White House.",108,127,perennial candidate,3,3,6
3EKZL9T8Y8NXY6HK96DEAVGKHQIHCB,"#29-1 'Birther King' announces 2016 campaign for U.S. president Via press release on Friday, Andy Martin, a perennial candidate for political office and self-proclaimed ""Birther King"", announced he is seeking the U.S. Republican Party's 2016 presidential nomination, his fourth bid for the White House.",118,127,candidate,0,1,1
3EKZL9T8Y8NXY6HK96DEAVGKHQIHCB,"#29-1 'Birther King' announces 2016 campaign for U.S. president Via press release on Friday, Andy Martin, a perennial candidate for political office and self-proclaimed ""Birther King"", announced he is seeking the U.S. Republican Party's 2016 presidential nomination, his fourth bid for the White House.",153,168,self-proclaimed,5,7,12
3EKZL9T8Y8NXY6HK96DEAVGKHQIHCB,"#29-1 'Birther King' announces 2016 campaign for U.S. president Via press release on Friday, Andy Martin, a perennial candidate for political office and self-proclaimed ""Birther King"", announced he is seeking the U.S. Republican Party's 2016 presidential nomination, his fourth bid for the White House.",153,181,self-proclaimed Birther King,0,1,1
3EKZL9T8Y8NXY6HK96DEAVGKHQIHCB,"#29-1 'Birther King' announces 2016 campaign for U.S. president Via press release on Friday, Andy Martin, a perennial candidate for political office and self-proclaimed ""Birther King"", announced he is seeking the U.S. Republican Party's 2016 presidential nomination, his fourth bid for the White House.",201,208,seeking,0,2,2
3EKZL9T8Y8NXY6HK96DEAVGKHQIHCB,"#29-1 'Birther King' announces 2016 campaign for U.S. president Via press release on Friday, Andy Martin, a perennial candidate for political office and self-proclaimed ""Birther King"", announced he is seeking the U.S. Republican Party's 2016 presidential nomination, his fourth bid for the White House.",242,265,presidential nomination,1,1,2
3EKZL9T8Y8NXY6HK96DEAVGKHQIHCB,"#29-1 'Birther King' announces 2016 campaign for U.S. president Via press release on Friday, Andy Martin, a perennial candidate for political office and self-proclaimed ""Birther King"", announced he is seeking the U.S. Republican Party's 2016 presidential nomination, his fourth bid for the White House.",255,265,nomination,2,3,5
3EKZL9T8Y8NXY6HK96DEAVGKHQIHCB,"#29-1 'Birther King' announces 2016 campaign for U.S. president Via press release on Friday, Andy Martin, a perennial candidate for political office and self-proclaimed ""Birther King"", announced he is seeking the U.S. Republican Party's 2016 presidential nomination, his fourth bid for the White House.",271,281,fourth bid,1,0,1
3EKZL9T8Y8NXY6HK96DEAVGKHQIHCB,"#29-1 'Birther King' announces 2016 campaign for U.S. president Via press release on Friday, Andy Martin, a perennial candidate for political office and self-proclaimed ""Birther King"", announced he is seeking the U.S. Republican Party's 2016 presidential nomination, his fourth bid for the White House.",278,281,bid,0,4,4
3EKZL9T8Y8NXY6HK96DEAVGKHQIHCB,"#29-2 In his announcement and subsequent release, Martin expresses a desire to participate in Republican presidential debates and aligns himself with fellow Republican presidential candidate Donald Trump.",13,25,announcement,1,1,2
3EKZL9T8Y8NXY6HK96DEAVGKHQIHCB,"#29-2 In his announcement and subsequent release, Martin expresses a desire to participate in Republican presidential debates and aligns himself with fellow Republican presidential candidate Donald Trump.",30,40,subsequent,9,9,18
3EKZL9T8Y8NXY6HK96DEAVGKHQIHCB,"#29-2 In his announcement and subsequent release, Martin expresses a desire to participate in Republican presidential debates and aligns himself with fellow Republican presidential candidate Donald Trump.",30,48,subsequent release,1,2,3
3EKZL9T8Y8NXY6HK96DEAVGKHQIHCB,"#29-2 In his announcement and subsequent release, Martin expresses a desire to participate in Republican presidential debates and aligns himself with fellow Republican presidential candidate Donald Trump.",57,66,expresses,0,3,3
3EKZL9T8Y8NXY6HK96DEAVGKHQIHCB,"#29-2 In his announcement and subsequent release, Martin expresses a desire to participate in Republican presidential debates and aligns himself with fellow Republican presidential candidate Donald Trump.",79,90,participate,1,0,1
3EKZL9T8Y8NXY6HK96DEAVGKHQIHCB,"#29-2 In his announcement and subsequent release, Martin expresses a desire to participate in Republican presidential debates and aligns himself with fellow Republican presidential candidate Donald Trump.",105,117,presidential,1,0,1
3EKZL9T8Y8NXY6HK96DEAVGKHQIHCB,"#29-2 In his announcement and subsequent release, Martin expresses a desire to participate in Republican presidential debates and aligns himself with fellow Republican presidential candidate Donald Trump.",118,125,debates,1,3,4
3EKZL9T8Y8NXY6HK96DEAVGKHQIHCB,"#29-2 In his announcement and subsequent release, Martin expresses a desire to participate in Republican presidential debates and aligns himself with fellow Republican presidential candidate Donald Trump.",130,136,aligns,7,7,14
3EKZL9T8Y8NXY6HK96DEAVGKHQIHCB,"#29-2 In his announcement and subsequent release, Martin expresses a desire to participate in Republican presidential debates and aligns himself with fellow Republican presidential candidate Donald Trump.",150,156,fellow,0,1,1
3EKZL9T8Y8NXY6HK96DEAVGKHQIHCB,"#29-2 In his announcement and subsequent release, Martin expresses a desire to participate in Republican presidential debates and aligns himself with fellow Republican presidential candidate Donald Trump.",181,190,candidate,0,1,1
3EKZL9T8Y8NXY6HK96DEAVGKHQIHCB,"#29-3 Additionally, he outlines six reasons for running, including degrading the candidacy of former Florida governor Jeb Bush, who is also seeking the Republican nomination.",6,18,Additionally,0,1,1
3EKZL9T8Y8NXY6HK96DEAVGKHQIHCB,"#29-3 Additionally, he outlines six reasons for running, including degrading the candidacy of former Florida governor Jeb Bush, who is also seeking the Republican nomination.",23,31,outlines,0,1,1
3EKZL9T8Y8NXY6HK96DEAVGKHQIHCB,"#29-3 Additionally, he outlines six reasons for running, including degrading the candidacy of former Florida governor Jeb Bush, who is also seeking the Republican nomination.",67,76,degrading,8,9,17
3EKZL9T8Y8NXY6HK96DEAVGKHQIHCB,"#29-3 Additionally, he outlines six reasons for running, including degrading the candidacy of former Florida governor Jeb Bush, who is also seeking the Republican nomination.",67,90,degrading the candidacy,1,1,2
3EKZL9T8Y8NXY6HK96DEAVGKHQIHCB,"#29-3 Additionally, he outlines six reasons for running, including degrading the candidacy of former Florida governor Jeb Bush, who is also seeking the Republican nomination.",81,90,candidacy,4,7,11
3EKZL9T8Y8NXY6HK96DEAVGKHQIHCB,"#29-3 Additionally, he outlines six reasons for running, including degrading the candidacy of former Florida governor Jeb Bush, who is also seeking the Republican nomination.",152,162,Republican,0,1,1
3EKZL9T8Y8NXY6HK96DEAVGKHQIHCB,"#29-3 Additionally, he outlines six reasons for running, including degrading the candidacy of former Florida governor Jeb Bush, who is also seeking the Republican nomination.",163,173,nomination,4,0,4
3EKZL9T8Y8NXY6HK96DEAVGKHQIHCB,"#29-4 ""I have been a loyal Republican,"" says Martin in his announcement, ""loyal to the principles of our party but not necessarily loyal to some of its failed leaders.""",27,37,Republican,1,0,1
3EKZL9T8Y8NXY6HK96DEAVGKHQIHCB,"#29-4 ""I have been a loyal Republican,"" says Martin in his announcement, ""loyal to the principles of our party but not necessarily loyal to some of its failed leaders.""",59,71,announcement,2,1,3
3EKZL9T8Y8NXY6HK96DEAVGKHQIHCB,"#29-4 ""I have been a loyal Republican,"" says Martin in his announcement, ""loyal to the principles of our party but not necessarily loyal to some of its failed leaders.""",74,79,loyal,2,0,2
3EKZL9T8Y8NXY6HK96DEAVGKHQIHCB,"#29-4 ""I have been a loyal Republican,"" says Martin in his announcement, ""loyal to the principles of our party but not necessarily loyal to some of its failed leaders.""",87,97,principles,1,1,2
3EKZL9T8Y8NXY6HK96DEAVGKHQIHCB,"#29-4 ""I have been a loyal Republican,"" says Martin in his announcement, ""loyal to the principles of our party but not necessarily loyal to some of its failed leaders.""",119,130,necessarily,3,2,5
3EKZL9T8Y8NXY6HK96DEAVGKHQIHCB,"#29-4 ""I have been a loyal Republican,"" says Martin in his announcement, ""loyal to the principles of our party but not necessarily loyal to some of its failed leaders.""",131,136,loyal,0,1,1
3EKZL9T8Y8NXY6HK96DEAVGKHQIHCB,"#29-4 ""I have been a loyal Republican,"" says Martin in his announcement, ""loyal to the principles of our party but not necessarily loyal to some of its failed leaders.""",152,166,failed leaders,0,1,1
3GS542CVJVOJKFQMWK2EJ8CM6WO955,"#34-7 Yesterday, North Korea fired artillery rounds aimed at a loudspeaker in South Korea that broadcasts anti-Pyongyang propaganda into the North.",29,44,fired artillery,1,0,1
3GS542CVJVOJKFQMWK2EJ8CM6WO955,"#34-7 Yesterday, North Korea fired artillery rounds aimed at a loudspeaker in South Korea that broadcasts anti-Pyongyang propaganda into the North.",35,44,artillery,6,7,13
3GS542CVJVOJKFQMWK2EJ8CM6WO955,"#34-7 Yesterday, North Korea fired artillery rounds aimed at a loudspeaker in South Korea that broadcasts anti-Pyongyang propaganda into the North.",35,51,artillery rounds,1,1,2
3GS542CVJVOJKFQMWK2EJ8CM6WO955,"#34-7 Yesterday, North Korea fired artillery rounds aimed at a loudspeaker in South Korea that broadcasts anti-Pyongyang propaganda into the North.",45,51,rounds,0,1,1
3GS542CVJVOJKFQMWK2EJ8CM6WO955,"#34-7 Yesterday, North Korea fired artillery rounds aimed at a loudspeaker in South Korea that broadcasts anti-Pyongyang propaganda into the North.",45,57,rounds aimed,0,1,1
3GS542CVJVOJKFQMWK2EJ8CM6WO955,"#34-7 Yesterday, North Korea fired artillery rounds aimed at a loudspeaker in South Korea that broadcasts anti-Pyongyang propaganda into the North.",52,57,aimed,0,1,1
3GS542CVJVOJKFQMWK2EJ8CM6WO955,"#34-7 Yesterday, North Korea fired artillery rounds aimed at a loudspeaker in South Korea that broadcasts anti-Pyongyang propaganda into the North.",63,74,loudspeaker,4,4,8
3GS542CVJVOJKFQMWK2EJ8CM6WO955,"#34-7 Yesterday, North Korea fired artillery rounds aimed at a loudspeaker in South Korea that broadcasts anti-Pyongyang propaganda into the North.",95,105,broadcasts,0,4,4
3GS542CVJVOJKFQMWK2EJ8CM6WO955,"#34-7 Yesterday, North Korea fired artillery rounds aimed at a loudspeaker in South Korea that broadcasts anti-Pyongyang propaganda into the North.",106,120,anti-Pyongyang,3,0,3
3GS542CVJVOJKFQMWK2EJ8CM6WO955,"#34-7 Yesterday, North Korea fired artillery rounds aimed at a loudspeaker in South Korea that broadcasts anti-Pyongyang propaganda into the North.",106,131,anti-Pyongyang propaganda,2,2,4
3GS542CVJVOJKFQMWK2EJ8CM6WO955,"#34-7 Yesterday, North Korea fired artillery rounds aimed at a loudspeaker in South Korea that broadcasts anti-Pyongyang propaganda into the North.",121,131,propaganda,9,6,15
3GS542CVJVOJKFQMWK2EJ8CM6WO955,"#34-8 ""Commanders of the Korean People's Army were hastily dispatched to the front-line troops to command military operations to destroy psychological warfare tools if the enemy does not stop the propaganda broadcast within 48 hours and prepare against the enemy's possible counteractions,"" added KCNA.",7,17,Commanders,1,0,1
3GS542CVJVOJKFQMWK2EJ8CM6WO955,"#34-8 ""Commanders of the Korean People's Army were hastily dispatched to the front-line troops to command military operations to destroy psychological warfare tools if the enemy does not stop the propaganda broadcast within 48 hours and prepare against the enemy's possible counteractions,"" added KCNA.",51,58,hastily,4,5,9
3GS542CVJVOJKFQMWK2EJ8CM6WO955,"#34-8 ""Commanders of the Korean People's Army were hastily dispatched to the front-line troops to command military operations to destroy psychological warfare tools if the enemy does not stop the propaganda broadcast within 48 hours and prepare against the enemy's possible counteractions,"" added KCNA.",51,69,hastily dispatched,2,3,5
3GS542CVJVOJKFQMWK2EJ8CM6WO955,"#34-8 ""Commanders of the Korean People's Army were hastily dispatched to the front-line troops to command military operations to destroy psychological warfare tools if the enemy does not stop the propaganda broadcast within 48 hours and prepare against the enemy's possible counteractions,"" added KCNA.",59,69,dispatched,4,1,5
3GS542CVJVOJKFQMWK2EJ8CM6WO955,"#34-8 ""Commanders of the Korean People's Army were hastily dispatched to the front-line troops to command military operations to destroy psychological warfare tools if the enemy does not stop the propaganda broadcast within 48 hours and prepare against the enemy's possible counteractions,"" added KCNA.",77,87,front-line,1,0,1
3GS542CVJVOJKFQMWK2EJ8CM6WO955,"#34-8 ""Commanders of the Korean People's Army were hastily dispatched to the front-line troops to command military operations to destroy psychological warfare tools if the enemy does not stop the propaganda broadcast within 48 hours and prepare against the enemy's possible counteractions,"" added KCNA.",129,136,destroy,1,0,1
3GS542CVJVOJKFQMWK2EJ8CM6WO955,"#34-8 ""Commanders of the Korean People's Army were hastily dispatched to the front-line troops to command military operations to destroy psychological warfare tools if the enemy does not stop the propaganda broadcast within 48 hours and prepare against the enemy's possible counteractions,"" added KCNA.",137,150,psychological,6,2,8
3GS542CVJVOJKFQMWK2EJ8CM6WO955,"#34-8 ""Commanders of the Korean People's Army were hastily dispatched to the front-line troops to command military operations to destroy psychological warfare tools if the enemy does not stop the propaganda broadcast within 48 hours and prepare against the enemy's possible counteractions,"" added KCNA.",137,158,psychological warfare,3,2,5
3GS542CVJVOJKFQMWK2EJ8CM6WO955,"#34-8 ""Commanders of the Korean People's Army were hastily dispatched to the front-line troops to command military operations to destroy psychological warfare tools if the enemy does not stop the propaganda broadcast within 48 hours and prepare against the enemy's possible counteractions,"" added KCNA.",137,164,psychological warfare tools,0,2,2
3GS542CVJVOJKFQMWK2EJ8CM6WO955,"#34-8 ""Commanders of the Korean People's Army were hastily dispatched to the front-line troops to command military operations to destroy psychological warfare tools if the enemy does not stop the propaganda broadcast within 48 hours and prepare against the enemy's possible counteractions,"" added KCNA.",151,158,warfare,0,2,2
3GS542CVJVOJKFQMWK2EJ8CM6WO955,"#34-8 ""Commanders of the Korean People's Army were hastily dispatched to the front-line troops to command military operations to destroy psychological warfare tools if the enemy does not stop the propaganda broadcast within 48 hours and prepare against the enemy's possible counteractions,"" added KCNA.",172,177,enemy,1,0,1
3GS542CVJVOJKFQMWK2EJ8CM6WO955,"#34-8 ""Commanders of the Korean People's Army were hastily dispatched to the front-line troops to command military operations to destroy psychological warfare tools if the enemy does not stop the propaganda broadcast within 48 hours and prepare against the enemy's possible counteractions,"" added KCNA.",196,206,propaganda,4,0,4
3GS542CVJVOJKFQMWK2EJ8CM6WO955,"#34-8 ""Commanders of the Korean People's Army were hastily dispatched to the front-line troops to command military operations to destroy psychological warfare tools if the enemy does not stop the propaganda broadcast within 48 hours and prepare against the enemy's possible counteractions,"" added KCNA.",196,216,propaganda broadcast,0,1,1
3GS542CVJVOJKFQMWK2EJ8CM6WO955,"#34-8 ""Commanders of the Korean People's Army were hastily dispatched to the front-line troops to command military operations to destroy psychological warfare tools if the enemy does not stop the propaganda broadcast within 48 hours and prepare against the enemy's possible counteractions,"" added KCNA.",274,288,counteractions,10,10,20
3GS542CVJVOJKFQMWK2EJ8CM6WO955,"#34-9 No injuries or deaths were reported in the attacks from either side, but South Korea evacuated about 80 people in the town of Yeoncheon after at least one shell landed near the area.",9,17,injuries,1,0,1
3GS542CVJVOJKFQMWK2EJ8CM6WO955,"#34-9 No injuries or deaths were reported in the attacks from either side, but South Korea evacuated about 80 people in the town of Yeoncheon after at least one shell landed near the area.",49,56,attacks,0,1,1
3GS542CVJVOJKFQMWK2EJ8CM6WO955,"#34-9 No injuries or deaths were reported in the attacks from either side, but South Korea evacuated about 80 people in the town of Yeoncheon after at least one shell landed near the area.",91,100,evacuated,5,8,13
3GS542CVJVOJKFQMWK2EJ8CM6WO955,"#34-9 No injuries or deaths were reported in the attacks from either side, but South Korea evacuated about 80 people in the town of Yeoncheon after at least one shell landed near the area.",132,141,Yeoncheon,2,2,4
3GS542CVJVOJKFQMWK2EJ8CM6WO955,"#34-9 No injuries or deaths were reported in the attacks from either side, but South Korea evacuated about 80 people in the town of Yeoncheon after at least one shell landed near the area.",161,166,shell,2,3,5
3GS542CVJVOJKFQMWK2EJ8CM6WO955,"#34-9 No injuries or deaths were reported in the attacks from either side, but South Korea evacuated about 80 people in the town of Yeoncheon after at least one shell landed near the area.",167,173,landed,0,1,1
3GS542CVJVOJKFQMWK2EJ8CM6WO955,#34-10 The South retaliated by firing dozens of rounds of artillery into the north.,7,27,The South retaliated,0,1,1
3GS542CVJVOJKFQMWK2EJ8CM6WO955,#34-10 The South retaliated by firing dozens of rounds of artillery into the north.,17,27,retaliated,7,8,15
3GS542CVJVOJKFQMWK2EJ8CM6WO955,#34-10 The South retaliated by firing dozens of rounds of artillery into the north.,48,67,rounds of artillery,1,0,1
3GS542CVJVOJKFQMWK2EJ8CM6WO955,#34-10 The South retaliated by firing dozens of rounds of artillery into the north.,58,67,artillery,3,1,4
3GS542CVJVOJKFQMWK2EJ8CM6WO955,#34-11 South Korea had recently started to broadcast propaganda from loudspeakers after an 11-year lull.,43,52,broadcast,1,0,1
3GS542CVJVOJKFQMWK2EJ8CM6WO955,#34-11 South Korea had recently started to broadcast propaganda from loudspeakers after an 11-year lull.,53,63,propaganda,3,2,5
3GS542CVJVOJKFQMWK2EJ8CM6WO955,#34-11 South Korea had recently started to broadcast propaganda from loudspeakers after an 11-year lull.,69,81,loudspeakers,2,3,5
3GS542CVJVOJKFQMWK2EJ8CM6WO955,#34-11 South Korea had recently started to broadcast propaganda from loudspeakers after an 11-year lull.,99,103,lull,1,2,3
3UZUVSO3P7WYNI29WUZMSOOJJOUEMA,"#35-37 Mr Justice Green also ruled the pair, in principal, ""have a perfectly proper right to seek access to the personal data for the purpose of using it subsequently in their defence in criminal proceedings"", calling the case one about ""fundamental rights"".",29,34,ruled,0,2,2
3UZUVSO3P7WYNI29WUZMSOOJJOUEMA,"#35-37 Mr Justice Green also ruled the pair, in principal, ""have a perfectly proper right to seek access to the personal data for the purpose of using it subsequently in their defence in criminal proceedings"", calling the case one about ""fundamental rights"".",29,43,ruled the pair,0,1,1
3UZUVSO3P7WYNI29WUZMSOOJJOUEMA,"#35-37 Mr Justice Green also ruled the pair, in principal, ""have a perfectly proper right to seek access to the personal data for the purpose of using it subsequently in their defence in criminal proceedings"", calling the case one about ""fundamental rights"".",45,57,in principal,1,0,1
3UZUVSO3P7WYNI29WUZMSOOJJOUEMA,"#35-37 Mr Justice Green also ruled the pair, in principal, ""have a perfectly proper right to seek access to the personal data for the purpose of using it subsequently in their defence in criminal proceedings"", calling the case one about ""fundamental rights"".",48,57,principal,4,0,4
3UZUVSO3P7WYNI29WUZMSOOJJOUEMA,"#35-37 Mr Justice Green also ruled the pair, in principal, ""have a perfectly proper right to seek access to the personal data for the purpose of using it subsequently in their defence in criminal proceedings"", calling the case one about ""fundamental rights"".",67,76,perfectly,0,2,2
3UZUVSO3P7WYNI29WUZMSOOJJOUEMA,"#35-37 Mr Justice Green also ruled the pair, in principal, ""have a perfectly proper right to seek access to the personal data for the purpose of using it subsequently in their defence in criminal proceedings"", calling the case one about ""fundamental rights"".",67,89,perfectly proper right,1,0,1
3UZUVSO3P7WYNI29WUZMSOOJJOUEMA,"#35-37 Mr Justice Green also ruled the pair, in principal, ""have a perfectly proper right to seek access to the personal data for the purpose of using it subsequently in their defence in criminal proceedings"", calling the case one about ""fundamental rights"".",77,83,proper,1,0,1
3UZUVSO3P7WYNI29WUZMSOOJJOUEMA,"#35-37 Mr Justice Green also ruled the pair, in principal, ""have a perfectly proper right to seek access to the personal data for the purpose of using it subsequently in their defence in criminal proceedings"", calling the case one about ""fundamental rights"".",93,104,seek access,0,1,1
3UZUVSO3P7WYNI29WUZMSOOJJOUEMA,"#35-37 Mr Justice Green also ruled the pair, in principal, ""have a perfectly proper right to seek access to the personal data for the purpose of using it subsequently in their defence in criminal proceedings"", calling the case one about ""fundamental rights"".",98,104,access,0,1,1
3UZUVSO3P7WYNI29WUZMSOOJJOUEMA,"#35-37 Mr Justice Green also ruled the pair, in principal, ""have a perfectly proper right to seek access to the personal data for the purpose of using it subsequently in their defence in criminal proceedings"", calling the case one about ""fundamental rights"".",134,141,purpose,0,2,2
3UZUVSO3P7WYNI29WUZMSOOJJOUEMA,"#35-37 Mr Justice Green also ruled the pair, in principal, ""have a perfectly proper right to seek access to the personal data for the purpose of using it subsequently in their defence in criminal proceedings"", calling the case one about ""fundamental rights"".",154,166,subsequently,10,9,19
3UZUVSO3P7WYNI29WUZMSOOJJOUEMA,"#35-37 Mr Justice Green also ruled the pair, in principal, ""have a perfectly proper right to seek access to the personal data for the purpose of using it subsequently in their defence in criminal proceedings"", calling the case one about ""fundamental rights"".",176,183,defence,4,1,5
3UZUVSO3P7WYNI29WUZMSOOJJOUEMA,"#35-37 Mr Justice Green also ruled the pair, in principal, ""have a perfectly proper right to seek access to the personal data for the purpose of using it subsequently in their defence in criminal proceedings"", calling the case one about ""fundamental rights"".",187,195,criminal,1,0,1
3UZUVSO3P7WYNI29WUZMSOOJJOUEMA,"#35-37 Mr Justice Green also ruled the pair, in principal, ""have a perfectly proper right to seek access to the personal data for the purpose of using it subsequently in their defence in criminal proceedings"", calling the case one about ""fundamental rights"".",187,207,criminal proceedings,5,1,6
3UZUVSO3P7WYNI29WUZMSOOJJOUEMA,"#35-37 Mr Justice Green also ruled the pair, in principal, ""have a perfectly proper right to seek access to the personal data for the purpose of using it subsequently in their defence in criminal proceedings"", calling the case one about ""fundamental rights"".",196,207,proceedings,3,6,9
3UZUVSO3P7WYNI29WUZMSOOJJOUEMA,"#35-37 Mr Justice Green also ruled the pair, in principal, ""have a perfectly proper right to seek access to the personal data for the purpose of using it subsequently in their defence in criminal proceedings"", calling the case one about ""fundamental rights"".",238,249,fundamental,5,3,8
3UZUVSO3P7WYNI29WUZMSOOJJOUEMA,"#35-37 Mr Justice Green also ruled the pair, in principal, ""have a perfectly proper right to seek access to the personal data for the purpose of using it subsequently in their defence in criminal proceedings"", calling the case one about ""fundamental rights"".",238,256,fundamental rights,4,2,6
3UZUVSO3P7WYNI29WUZMSOOJJOUEMA,"#35-38 Rosa Curling, who represented both men in the London court, has said they would not appeal.",12,19,Curling,0,1,1
3UZUVSO3P7WYNI29WUZMSOOJJOUEMA,"#35-38 Rosa Curling, who represented both men in the London court, has said they would not appeal.",25,36,represented,4,1,5
3UZUVSO3P7WYNI29WUZMSOOJJOUEMA,"#35-38 Rosa Curling, who represented both men in the London court, has said they would not appeal.",91,97,appeal,3,4,7
3UZUVSO3P7WYNI29WUZMSOOJJOUEMA,"#35-39 She said Lin and Phyo are ""disappointed"" but ""are reassured that at least a British judge has now looked at the information held by the Metropolitan Police, applying anxious scrutiny, and determined that it would not assist them in their ongoing proceedings in Thailand.""",24,28,Phyo,0,1,1
3UZUVSO3P7WYNI29WUZMSOOJJOUEMA,"#35-39 She said Lin and Phyo are ""disappointed"" but ""are reassured that at least a British judge has now looked at the information held by the Metropolitan Police, applying anxious scrutiny, and determined that it would not assist them in their ongoing proceedings in Thailand.""",34,46,disappointed,4,2,6
3UZUVSO3P7WYNI29WUZMSOOJJOUEMA,"#35-39 She said Lin and Phyo are ""disappointed"" but ""are reassured that at least a British judge has now looked at the information held by the Metropolitan Police, applying anxious scrutiny, and determined that it would not assist them in their ongoing proceedings in Thailand.""",57,66,reassured,1,10,11
3UZUVSO3P7WYNI29WUZMSOOJJOUEMA,"#35-39 She said Lin and Phyo are ""disappointed"" but ""are reassured that at least a British judge has now looked at the information held by the Metropolitan Police, applying anxious scrutiny, and determined that it would not assist them in their ongoing proceedings in Thailand.""",119,130,information,1,1,2
3UZUVSO3P7WYNI29WUZMSOOJJOUEMA,"#35-39 She said Lin and Phyo are ""disappointed"" but ""are reassured that at least a British judge has now looked at the information held by the Metropolitan Police, applying anxious scrutiny, and determined that it would not assist them in their ongoing proceedings in Thailand.""",143,155,Metropolitan,1,1,2
3UZUVSO3P7WYNI29WUZMSOOJJOUEMA,"#35-39 She said Lin and Phyo are ""disappointed"" but ""are reassured that at least a British judge has now looked at the information held by the Metropolitan Police, applying anxious scrutiny, and determined that it would not assist them in their ongoing proceedings in Thailand.""",164,189,applying anxious scrutiny,1,0,1
3UZUVSO3P7WYNI29WUZMSOOJJOUEMA,"#35-39 She said Lin and Phyo are ""disappointed"" but ""are reassured that at least a British judge has now looked at the information held by the Metropolitan Police, applying anxious scrutiny, and determined that it would not assist them in their ongoing proceedings in Thailand.""",173,180,anxious,2,2,4
3UZUVSO3P7WYNI29WUZMSOOJJOUEMA,"#35-39 She said Lin and Phyo are ""disappointed"" but ""are reassured that at least a British judge has now looked at the information held by the Metropolitan Police, applying anxious scrutiny, and determined that it would not assist them in their ongoing proceedings in Thailand.""",173,189,anxious scrutiny,3,1,4
3UZUVSO3P7WYNI29WUZMSOOJJOUEMA,"#35-39 She said Lin and Phyo are ""disappointed"" but ""are reassured that at least a British judge has now looked at the information held by the Metropolitan Police, applying anxious scrutiny, and determined that it would not assist them in their ongoing proceedings in Thailand.""",181,189,scrutiny,7,6,13
3UZUVSO3P7WYNI29WUZMSOOJJOUEMA,"#35-39 She said Lin and Phyo are ""disappointed"" but ""are reassured that at least a British judge has now looked at the information held by the Metropolitan Police, applying anxious scrutiny, and determined that it would not assist them in their ongoing proceedings in Thailand.""",195,205,determined,1,2,3
3UZUVSO3P7WYNI29WUZMSOOJJOUEMA,"#35-39 She said Lin and Phyo are ""disappointed"" but ""are reassured that at least a British judge has now looked at the information held by the Metropolitan Police, applying anxious scrutiny, and determined that it would not assist them in their ongoing proceedings in Thailand.""",245,252,ongoing,0,6,6
3UZUVSO3P7WYNI29WUZMSOOJJOUEMA,"#35-39 She said Lin and Phyo are ""disappointed"" but ""are reassured that at least a British judge has now looked at the information held by the Metropolitan Police, applying anxious scrutiny, and determined that it would not assist them in their ongoing proceedings in Thailand.""",253,264,proceedings,1,1,2
3UZUVSO3P7WYNI29WUZMSOOJJOUEMA,"#35-40 Wikinews has contacted the Metropolitan Police, usually responsible for policing London, for a statement and is awaiting a response.",20,29,contacted,1,1,2
3UZUVSO3P7WYNI29WUZMSOOJJOUEMA,"#35-40 Wikinews has contacted the Metropolitan Police, usually responsible for policing London, for a statement and is awaiting a response.",34,46,Metropolitan,1,0,1
3UZUVSO3P7WYNI29WUZMSOOJJOUEMA,"#35-40 Wikinews has contacted the Metropolitan Police, usually responsible for policing London, for a statement and is awaiting a response.",63,74,responsible,1,1,2
3UZUVSO3P7WYNI29WUZMSOOJJOUEMA,"#35-40 Wikinews has contacted the Metropolitan Police, usually responsible for policing London, for a statement and is awaiting a response.",79,87,policing,1,0,1
3UZUVSO3P7WYNI29WUZMSOOJJOUEMA,"#35-40 Wikinews has contacted the Metropolitan Police, usually responsible for policing London, for a statement and is awaiting a response.",102,111,statement,0,1,1
3UZUVSO3P7WYNI29WUZMSOOJJOUEMA,"#35-40 Wikinews has contacted the Metropolitan Police, usually responsible for policing London, for a statement and is awaiting a response.",119,127,awaiting,2,3,5
3UZUVSO3P7WYNI29WUZMSOOJJOUEMA,"#35-40 Wikinews has contacted the Metropolitan Police, usually responsible for policing London, for a statement and is awaiting a response.",130,138,response,0,1,1
38Z7YZ2SB331O22NK6WUUC6GLIYIQA,"#1-11 Next week, on January 24, the Supreme Court is due to deliver a decision in a case challenging the government's right to issue Article 50—which starts the Brexit negotiations—without the consultation of Parliament.",36,49,Supreme Court,1,0,1
38Z7YZ2SB331O22NK6WUUC6GLIYIQA,"#1-11 Next week, on January 24, the Supreme Court is due to deliver a decision in a case challenging the government's right to issue Article 50—which starts the Brexit negotiations—without the consultation of Parliament.",53,56,due,0,1,1
38Z7YZ2SB331O22NK6WUUC6GLIYIQA,"#1-11 Next week, on January 24, the Supreme Court is due to deliver a decision in a case challenging the government's right to issue Article 50—which starts the Brexit negotiations—without the consultation of Parliament.",60,67,deliver,0,3,3
38Z7YZ2SB331O22NK6WUUC6GLIYIQA,"#1-11 Next week, on January 24, the Supreme Court is due to deliver a decision in a case challenging the government's right to issue Article 50—which starts the Brexit negotiations—without the consultation of Parliament.",70,78,decision,4,0,4
38Z7YZ2SB331O22NK6WUUC6GLIYIQA,"#1-11 Next week, on January 24, the Supreme Court is due to deliver a decision in a case challenging the government's right to issue Article 50—which starts the Brexit negotiations—without the consultation of Parliament.",89,100,challenging,5,6,11
38Z7YZ2SB331O22NK6WUUC6GLIYIQA,"#1-11 Next week, on January 24, the Supreme Court is due to deliver a decision in a case challenging the government's right to issue Article 50—which starts the Brexit negotiations—without the consultation of Parliament.",127,132,issue,0,1,1
38Z7YZ2SB331O22NK6WUUC6GLIYIQA,"#1-11 Next week, on January 24, the Supreme Court is due to deliver a decision in a case challenging the government's right to issue Article 50—which starts the Brexit negotiations—without the consultation of Parliament.",127,140,issue Article,1,0,1
38Z7YZ2SB331O22NK6WUUC6GLIYIQA,"#1-11 Next week, on January 24, the Supreme Court is due to deliver a decision in a case challenging the government's right to issue Article 50—which starts the Brexit negotiations—without the consultation of Parliament.",133,140,Article,1,1,2
38Z7YZ2SB331O22NK6WUUC6GLIYIQA,"#1-11 Next week, on January 24, the Supreme Court is due to deliver a decision in a case challenging the government's right to issue Article 50—which starts the Brexit negotiations—without the consultation of Parliament.",161,167,Brexit,1,0,1
38Z7YZ2SB331O22NK6WUUC6GLIYIQA,"#1-11 Next week, on January 24, the Supreme Court is due to deliver a decision in a case challenging the government's right to issue Article 50—which starts the Brexit negotiations—without the consultation of Parliament.",161,188,Brexit negotiations—without,1,0,1
38Z7YZ2SB331O22NK6WUUC6GLIYIQA,"#1-11 Next week, on January 24, the Supreme Court is due to deliver a decision in a case challenging the government's right to issue Article 50—which starts the Brexit negotiations—without the consultation of Parliament.",193,205,consultation,10,5,15
38Z7YZ2SB331O22NK6WUUC6GLIYIQA,"#1-11 Next week, on January 24, the Supreme Court is due to deliver a decision in a case challenging the government's right to issue Article 50—which starts the Brexit negotiations—without the consultation of Parliament.",193,219,consultation of Parliament,1,0,1
38Z7YZ2SB331O22NK6WUUC6GLIYIQA,"#1-11 Next week, on January 24, the Supreme Court is due to deliver a decision in a case challenging the government's right to issue Article 50—which starts the Brexit negotiations—without the consultation of Parliament.",209,219,Parliament,4,0,4
38Z7YZ2SB331O22NK6WUUC6GLIYIQA,#10-1 Polish PM Beata Szydło welcomes US troops Polish Prime Minister Beata Szydło on Saturday headed a ceremony in the Western town of Żagań welcoming US troops.,6,28,Polish PM Beata Szydło,1,0,1
38Z7YZ2SB331O22NK6WUUC6GLIYIQA,#10-1 Polish PM Beata Szydło welcomes US troops Polish Prime Minister Beata Szydło on Saturday headed a ceremony in the Western town of Żagań welcoming US troops.,48,82,Polish Prime Minister Beata Szydło,1,0,1
38Z7YZ2SB331O22NK6WUUC6GLIYIQA,#10-1 Polish PM Beata Szydło welcomes US troops Polish Prime Minister Beata Szydło on Saturday headed a ceremony in the Western town of Żagań welcoming US troops.,95,101,headed,3,3,6
38Z7YZ2SB331O22NK6WUUC6GLIYIQA,#10-1 Polish PM Beata Szydło welcomes US troops Polish Prime Minister Beata Szydło on Saturday headed a ceremony in the Western town of Żagań welcoming US troops.,104,112,ceremony,4,3,7
38Z7YZ2SB331O22NK6WUUC6GLIYIQA,#10-1 Polish PM Beata Szydło welcomes US troops Polish Prime Minister Beata Szydło on Saturday headed a ceremony in the Western town of Żagań welcoming US troops.,136,141,Żagań,1,0,1
38Z7YZ2SB331O22NK6WUUC6GLIYIQA,#10-1 Polish PM Beata Szydło welcomes US troops Polish Prime Minister Beata Szydło on Saturday headed a ceremony in the Western town of Żagań welcoming US troops.,155,161,troops,0,2,2
38Z7YZ2SB331O22NK6WUUC6GLIYIQA,#10-2 The troops are in the region in response to Russian action in Ukraine and began arriving earlier this week.,28,34,region,1,0,1
38Z7YZ2SB331O22NK6WUUC6GLIYIQA,#10-2 The troops are in the region in response to Russian action in Ukraine and began arriving earlier this week.,38,46,response,3,2,5
38Z7YZ2SB331O22NK6WUUC6GLIYIQA,#10-2 The troops are in the region in response to Russian action in Ukraine and began arriving earlier this week.,86,94,arriving,1,0,1
38Z7YZ2SB331O22NK6WUUC6GLIYIQA,"#10-4 ""It is the duty of the Polish state, the government to provide security.",17,21,duty,1,1,2
38Z7YZ2SB331O22NK6WUUC6GLIYIQA,"#10-4 ""It is the duty of the Polish state, the government to provide security.",47,57,government,1,1,2
38Z7YZ2SB331O22NK6WUUC6GLIYIQA,"#10-4 ""It is the duty of the Polish state, the government to provide security.",61,68,provide,1,1,2
38Z7YZ2SB331O22NK6WUUC6GLIYIQA,"#10-4 ""It is the duty of the Polish state, the government to provide security.",61,77,provide security,0,1,1
38Z7YZ2SB331O22NK6WUUC6GLIYIQA,"#10-4 ""It is the duty of the Polish state, the government to provide security.",69,77,security,4,0,4
38Z7YZ2SB331O22NK6WUUC6GLIYIQA,"#10-5 Today we have made a big step in this direction"".",27,35,big step,1,0,1
38Z7YZ2SB331O22NK6WUUC6GLIYIQA,"#10-5 Today we have made a big step in this direction"".",44,53,direction,1,1,2
38Z7YZ2SB331O22NK6WUUC6GLIYIQA,"#10-6 Outgoing US President Barack Obama authorised the move in response to Russian intervention in Ukraine in 2014, in which Crimea was annexed.",6,14,Outgoing,1,5,6
38Z7YZ2SB331O22NK6WUUC6GLIYIQA,"#10-6 Outgoing US President Barack Obama authorised the move in response to Russian intervention in Ukraine in 2014, in which Crimea was annexed.",41,51,authorised,10,5,15
38Z7YZ2SB331O22NK6WUUC6GLIYIQA,"#10-6 Outgoing US President Barack Obama authorised the move in response to Russian intervention in Ukraine in 2014, in which Crimea was annexed.",84,96,intervention,10,7,17
38Z7YZ2SB331O22NK6WUUC6GLIYIQA,"#10-6 Outgoing US President Barack Obama authorised the move in response to Russian intervention in Ukraine in 2014, in which Crimea was annexed.",126,144,Crimea was annexed,1,0,1
38Z7YZ2SB331O22NK6WUUC6GLIYIQA,"#10-6 Outgoing US President Barack Obama authorised the move in response to Russian intervention in Ukraine in 2014, in which Crimea was annexed.",137,144,annexed,10,10,20
3U74KRR67MM6UJ56YQ3H4PDKROQTNE,"#37-9 The Social and Popular Assembly, formed during protests in recent months, allege violations of electoral law by many parties, and want an electoral commission crackdown.",6,37,The Social and Popular Assembly,1,0,1
3U74KRR67MM6UJ56YQ3H4PDKROQTNE,"#37-9 The Social and Popular Assembly, formed during protests in recent months, allege violations of electoral law by many parties, and want an electoral commission crackdown.",10,16,Social,1,0,1
3U74KRR67MM6UJ56YQ3H4PDKROQTNE,"#37-9 The Social and Popular Assembly, formed during protests in recent months, allege violations of electoral law by many parties, and want an electoral commission crackdown.",29,37,Assembly,5,1,6
3U74KRR67MM6UJ56YQ3H4PDKROQTNE,"#37-9 The Social and Popular Assembly, formed during protests in recent months, allege violations of electoral law by many parties, and want an electoral commission crackdown.",53,61,protests,1,2,3
3U74KRR67MM6UJ56YQ3H4PDKROQTNE,"#37-9 The Social and Popular Assembly, formed during protests in recent months, allege violations of electoral law by many parties, and want an electoral commission crackdown.",65,71,recent,1,0,1
3U74KRR67MM6UJ56YQ3H4PDKROQTNE,"#37-9 The Social and Popular Assembly, formed during protests in recent months, allege violations of electoral law by many parties, and want an electoral commission crackdown.",80,86,allege,7,3,10
3U74KRR67MM6UJ56YQ3H4PDKROQTNE,"#37-9 The Social and Popular Assembly, formed during protests in recent months, allege violations of electoral law by many parties, and want an electoral commission crackdown.",80,97,allege violations,3,1,4
3U74KRR67MM6UJ56YQ3H4PDKROQTNE,"#37-9 The Social and Popular Assembly, formed during protests in recent months, allege violations of electoral law by many parties, and want an electoral commission crackdown.",87,97,violations,6,5,11
3U74KRR67MM6UJ56YQ3H4PDKROQTNE,"#37-9 The Social and Popular Assembly, formed during protests in recent months, allege violations of electoral law by many parties, and want an electoral commission crackdown.",101,110,electoral,6,0,6
3U74KRR67MM6UJ56YQ3H4PDKROQTNE,"#37-9 The Social and Popular Assembly, formed during protests in recent months, allege violations of electoral law by many parties, and want an electoral commission crackdown.",101,114,electoral law,1,0,1
3U74KRR67MM6UJ56YQ3H4PDKROQTNE,"#37-9 The Social and Popular Assembly, formed during protests in recent months, allege violations of electoral law by many parties, and want an electoral commission crackdown.",144,153,electoral,5,0,5
3U74KRR67MM6UJ56YQ3H4PDKROQTNE,"#37-9 The Social and Popular Assembly, formed during protests in recent months, allege violations of electoral law by many parties, and want an electoral commission crackdown.",144,174,electoral commission crackdown,2,0,2
3U74KRR67MM6UJ56YQ3H4PDKROQTNE,"#37-9 The Social and Popular Assembly, formed during protests in recent months, allege violations of electoral law by many parties, and want an electoral commission crackdown.",154,164,commission,3,0,3
3U74KRR67MM6UJ56YQ3H4PDKROQTNE,"#37-9 The Social and Popular Assembly, formed during protests in recent months, allege violations of electoral law by many parties, and want an electoral commission crackdown.",154,174,commission crackdown,2,0,2
3U74KRR67MM6UJ56YQ3H4PDKROQTNE,"#37-9 The Social and Popular Assembly, formed during protests in recent months, allege violations of electoral law by many parties, and want an electoral commission crackdown.",165,174,crackdown,2,10,12
3U74KRR67MM6UJ56YQ3H4PDKROQTNE,"#37-10 One member organisation, the Committee for Campesino Unity, wants a delay until elections are reformed.",18,30,organisation,2,0,2
3U74KRR67MM6UJ56YQ3H4PDKROQTNE,"#37-10 One member organisation, the Committee for Campesino Unity, wants a delay until elections are reformed.",50,59,Campesino,3,2,5
3U74KRR67MM6UJ56YQ3H4PDKROQTNE,"#37-10 One member organisation, the Committee for Campesino Unity, wants a delay until elections are reformed.",75,80,delay,0,1,1
3U74KRR67MM6UJ56YQ3H4PDKROQTNE,"#37-10 One member organisation, the Committee for Campesino Unity, wants a delay until elections are reformed.",101,109,reformed,2,5,7
3U74KRR67MM6UJ56YQ3H4PDKROQTNE,#37-11 They also seek a new constitution.,28,40,constitution,6,0,6
3U74KRR67MM6UJ56YQ3H4PDKROQTNE,#37-12 Molina is accused of conspiring to corruptly divert customs funds.,17,24,accused,0,1,1
3U74KRR67MM6UJ56YQ3H4PDKROQTNE,#37-12 Molina is accused of conspiring to corruptly divert customs funds.,28,38,conspiring,10,6,16
3U74KRR67MM6UJ56YQ3H4PDKROQTNE,#37-12 Molina is accused of conspiring to corruptly divert customs funds.,28,58,conspiring to corruptly divert,1,0,1
3U74KRR67MM6UJ56YQ3H4PDKROQTNE,#37-12 Molina is accused of conspiring to corruptly divert customs funds.,42,51,corruptly,6,3,9
3U74KRR67MM6UJ56YQ3H4PDKROQTNE,#37-12 Molina is accused of conspiring to corruptly divert customs funds.,42,58,corruptly divert,2,2,4
3U74KRR67MM6UJ56YQ3H4PDKROQTNE,#37-12 Molina is accused of conspiring to corruptly divert customs funds.,52,58,divert,4,3,7
3U74KRR67MM6UJ56YQ3H4PDKROQTNE,#37-13 He denies any misconduct.,10,16,denies,1,1,2
3U74KRR67MM6UJ56YQ3H4PDKROQTNE,#37-13 He denies any misconduct.,21,31,misconduct,8,7,15
3U74KRR67MM6UJ56YQ3H4PDKROQTNE,"#38-1 Virginia reporter, cameraman killed on live TV, alleged shooter commits suicide Two members of a news crew for Roanoke, Virginia station WDBJ were shot and killed on live television this morning.",54,61,alleged,3,3,6
3U74KRR67MM6UJ56YQ3H4PDKROQTNE,"#38-1 Virginia reporter, cameraman killed on live TV, alleged shooter commits suicide Two members of a news crew for Roanoke, Virginia station WDBJ were shot and killed on live television this morning.",54,69,alleged shooter,0,1,1
3U74KRR67MM6UJ56YQ3H4PDKROQTNE,"#38-1 Virginia reporter, cameraman killed on live TV, alleged shooter commits suicide Two members of a news crew for Roanoke, Virginia station WDBJ were shot and killed on live television this morning.",70,77,commits,1,1,2
3U74KRR67MM6UJ56YQ3H4PDKROQTNE,"#38-1 Virginia reporter, cameraman killed on live TV, alleged shooter commits suicide Two members of a news crew for Roanoke, Virginia station WDBJ were shot and killed on live television this morning.",78,85,suicide,1,3,4
3U74KRR67MM6UJ56YQ3H4PDKROQTNE,"#38-1 Virginia reporter, cameraman killed on live TV, alleged shooter commits suicide Two members of a news crew for Roanoke, Virginia station WDBJ were shot and killed on live television this morning.",108,112,crew,1,0,1
3U74KRR67MM6UJ56YQ3H4PDKROQTNE,"#38-1 Virginia reporter, cameraman killed on live TV, alleged shooter commits suicide Two members of a news crew for Roanoke, Virginia station WDBJ were shot and killed on live television this morning.",117,124,Roanoke,1,0,1
3U74KRR67MM6UJ56YQ3H4PDKROQTNE,"#38-2 The suspect, a former reporter for the news station, later shot himself after a manhunt of several hours, authorities said.",10,17,suspect,0,1,1
3U74KRR67MM6UJ56YQ3H4PDKROQTNE,"#38-2 The suspect, a former reporter for the news station, later shot himself after a manhunt of several hours, authorities said.",86,93,manhunt,6,9,15
3U74KRR67MM6UJ56YQ3H4PDKROQTNE,"#38-2 The suspect, a former reporter for the news station, later shot himself after a manhunt of several hours, authorities said.",112,123,authorities,2,1,3
3U74KRR67MM6UJ56YQ3H4PDKROQTNE,"#38-3 Reporter Alison Parker, 24, and cameraman Adam Ward, 27, were conducting an interview at a local outdoor shopping mall when a gunman opened fire at approximately 6:45 AM local time (1045 UTC).",68,78,conducting,1,2,3
3U74KRR67MM6UJ56YQ3H4PDKROQTNE,"#38-3 Reporter Alison Parker, 24, and cameraman Adam Ward, 27, were conducting an interview at a local outdoor shopping mall when a gunman opened fire at approximately 6:45 AM local time (1045 UTC).",82,91,interview,1,0,1
3U74KRR67MM6UJ56YQ3H4PDKROQTNE,"#38-3 Reporter Alison Parker, 24, and cameraman Adam Ward, 27, were conducting an interview at a local outdoor shopping mall when a gunman opened fire at approximately 6:45 AM local time (1045 UTC).",132,138,gunman,1,1,2
3U74KRR67MM6UJ56YQ3H4PDKROQTNE,"#38-3 Reporter Alison Parker, 24, and cameraman Adam Ward, 27, were conducting an interview at a local outdoor shopping mall when a gunman opened fire at approximately 6:45 AM local time (1045 UTC).",154,167,approximately,6,4,10
3126F2F5F8448LZMOARE9SIEOT5EP6,#40-10 They feel they are under-represented in higher education and are suffering in a regional economic downturn.,26,43,under-represented,9,8,17
3126F2F5F8448LZMOARE9SIEOT5EP6,#40-10 They feel they are under-represented in higher education and are suffering in a regional economic downturn.,54,63,education,1,0,1
3126F2F5F8448LZMOARE9SIEOT5EP6,#40-10 They feel they are under-represented in higher education and are suffering in a regional economic downturn.,72,81,suffering,2,2,4
3126F2F5F8448LZMOARE9SIEOT5EP6,#40-10 They feel they are under-represented in higher education and are suffering in a regional economic downturn.,87,95,regional,1,0,1
3126F2F5F8448LZMOARE9SIEOT5EP6,#40-10 They feel they are under-represented in higher education and are suffering in a regional economic downturn.,87,113,regional economic downturn,4,1,5
3126F2F5F8448LZMOARE9SIEOT5EP6,#40-10 They feel they are under-represented in higher education and are suffering in a regional economic downturn.,96,104,economic,3,0,3
3126F2F5F8448LZMOARE9SIEOT5EP6,#40-10 They feel they are under-represented in higher education and are suffering in a regional economic downturn.,96,113,economic downturn,1,2,3
3126F2F5F8448LZMOARE9SIEOT5EP6,#40-10 They feel they are under-represented in higher education and are suffering in a regional economic downturn.,105,113,downturn,3,8,11
3126F2F5F8448LZMOARE9SIEOT5EP6,"#40-11 Amongst those calling for an end to the violence was Prime Minister Narendra Modi, who said ""each and every issue can be resolved through talks"" during a televised broadcast.",7,14,Amongst,3,2,5
3126F2F5F8448LZMOARE9SIEOT5EP6,"#40-11 Amongst those calling for an end to the violence was Prime Minister Narendra Modi, who said ""each and every issue can be resolved through talks"" during a televised broadcast.",47,55,violence,2,1,3
3126F2F5F8448LZMOARE9SIEOT5EP6,"#40-11 Amongst those calling for an end to the violence was Prime Minister Narendra Modi, who said ""each and every issue can be resolved through talks"" during a televised broadcast.",128,136,resolved,3,3,6
3126F2F5F8448LZMOARE9SIEOT5EP6,"#40-11 Amongst those calling for an end to the violence was Prime Minister Narendra Modi, who said ""each and every issue can be resolved through talks"" during a televised broadcast.",161,170,televised,1,1,2
3126F2F5F8448LZMOARE9SIEOT5EP6,"#40-11 Amongst those calling for an end to the violence was Prime Minister Narendra Modi, who said ""each and every issue can be resolved through talks"" during a televised broadcast.",161,180,televised broadcast,2,1,3
3126F2F5F8448LZMOARE9SIEOT5EP6,"#40-11 Amongst those calling for an end to the violence was Prime Minister Narendra Modi, who said ""each and every issue can be resolved through talks"" during a televised broadcast.",171,180,broadcast,1,3,4
3126F2F5F8448LZMOARE9SIEOT5EP6,#40-12 He was elected last year and was previously the Chief Minister of Gujarat for more than twelve years.,40,50,previously,4,1,5
3126F2F5F8448LZMOARE9SIEOT5EP6,#40-12 He was elected last year and was previously the Chief Minister of Gujarat for more than twelve years.,55,69,Chief Minister,1,0,1
3126F2F5F8448LZMOARE9SIEOT5EP6,#40-13 He was in power in Gujurat during sectarian violence in 2002 which resulted in about a thousand deaths.,41,50,sectarian,10,8,18
3126F2F5F8448LZMOARE9SIEOT5EP6,#40-13 He was in power in Gujurat during sectarian violence in 2002 which resulted in about a thousand deaths.,41,59,sectarian violence,1,3,4
3126F2F5F8448LZMOARE9SIEOT5EP6,#40-13 He was in power in Gujurat during sectarian violence in 2002 which resulted in about a thousand deaths.,51,59,violence,2,1,3
3126F2F5F8448LZMOARE9SIEOT5EP6,#40-13 He was in power in Gujurat during sectarian violence in 2002 which resulted in about a thousand deaths.,74,82,resulted,0,1,1
3126F2F5F8448LZMOARE9SIEOT5EP6,#40-13 He was in power in Gujurat during sectarian violence in 2002 which resulted in about a thousand deaths.,94,102,thousand,1,0,1
3126F2F5F8448LZMOARE9SIEOT5EP6,"#41-1 Four men go before Hungarian court after 71 found dead in lorry To write, edit, start or view other articles on Austria, see the Austria Portal Four foreign men have today gone before a court in Hungary on suspicion of people smuggling.",25,34,Hungarian,0,1,1
3126F2F5F8448LZMOARE9SIEOT5EP6,"#41-1 Four men go before Hungarian court after 71 found dead in lorry To write, edit, start or view other articles on Austria, see the Austria Portal Four foreign men have today gone before a court in Hungary on suspicion of people smuggling.",64,69,lorry,3,2,5
3126F2F5F8448LZMOARE9SIEOT5EP6,"#41-1 Four men go before Hungarian court after 71 found dead in lorry To write, edit, start or view other articles on Austria, see the Austria Portal Four foreign men have today gone before a court in Hungary on suspicion of people smuggling.",106,114,articles,0,1,1
3126F2F5F8448LZMOARE9SIEOT5EP6,"#41-1 Four men go before Hungarian court after 71 found dead in lorry To write, edit, start or view other articles on Austria, see the Austria Portal Four foreign men have today gone before a court in Hungary on suspicion of people smuggling.",118,125,Austria,0,1,1
3126F2F5F8448LZMOARE9SIEOT5EP6,"#41-1 Four men go before Hungarian court after 71 found dead in lorry To write, edit, start or view other articles on Austria, see the Austria Portal Four foreign men have today gone before a court in Hungary on suspicion of people smuggling.",143,149,Portal,0,2,2
3126F2F5F8448LZMOARE9SIEOT5EP6,"#41-1 Four men go before Hungarian court after 71 found dead in lorry To write, edit, start or view other articles on Austria, see the Austria Portal Four foreign men have today gone before a court in Hungary on suspicion of people smuggling.",155,162,foreign,4,1,5
3126F2F5F8448LZMOARE9SIEOT5EP6,"#41-1 Four men go before Hungarian court after 71 found dead in lorry To write, edit, start or view other articles on Austria, see the Austria Portal Four foreign men have today gone before a court in Hungary on suspicion of people smuggling.",212,221,suspicion,6,7,13
3126F2F5F8448LZMOARE9SIEOT5EP6,"#41-1 Four men go before Hungarian court after 71 found dead in lorry To write, edit, start or view other articles on Austria, see the Austria Portal Four foreign men have today gone before a court in Hungary on suspicion of people smuggling.",232,241,smuggling,10,10,20
3CESM1J3EI4QFF38UEMBPYYX0SK6W8,"#30-18 The part of the law which prohibits ""the unauthorized use of images of police officers that might jeopardize their or their family's safety"" is cited as the reason for the fine, however, police spokesperson Fernando Portillo said it was up to police officers involved and under the new law they could do this.",33,42,prohibits,9,10,19
3CESM1J3EI4QFF38UEMBPYYX0SK6W8,"#30-18 The part of the law which prohibits ""the unauthorized use of images of police officers that might jeopardize their or their family's safety"" is cited as the reason for the fine, however, police spokesperson Fernando Portillo said it was up to police officers involved and under the new law they could do this.",48,60,unauthorized,9,9,18
3CESM1J3EI4QFF38UEMBPYYX0SK6W8,"#30-18 The part of the law which prohibits ""the unauthorized use of images of police officers that might jeopardize their or their family's safety"" is cited as the reason for the fine, however, police spokesperson Fernando Portillo said it was up to police officers involved and under the new law they could do this.",105,115,jeopardize,10,10,20
3CESM1J3EI4QFF38UEMBPYYX0SK6W8,"#30-18 The part of the law which prohibits ""the unauthorized use of images of police officers that might jeopardize their or their family's safety"" is cited as the reason for the fine, however, police spokesperson Fernando Portillo said it was up to police officers involved and under the new law they could do this.",151,156,cited,1,3,4
3CESM1J3EI4QFF38UEMBPYYX0SK6W8,"#30-18 The part of the law which prohibits ""the unauthorized use of images of police officers that might jeopardize their or their family's safety"" is cited as the reason for the fine, however, police spokesperson Fernando Portillo said it was up to police officers involved and under the new law they could do this.",201,213,spokesperson,3,6,9
3CESM1J3EI4QFF38UEMBPYYX0SK6W8,"#30-18 The part of the law which prohibits ""the unauthorized use of images of police officers that might jeopardize their or their family's safety"" is cited as the reason for the fine, however, police spokesperson Fernando Portillo said it was up to police officers involved and under the new law they could do this.",223,231,Portillo,0,1,1
3CESM1J3EI4QFF38UEMBPYYX0SK6W8,"#30-18 The part of the law which prohibits ""the unauthorized use of images of police officers that might jeopardize their or their family's safety"" is cited as the reason for the fine, however, police spokesperson Fernando Portillo said it was up to police officers involved and under the new law they could do this.",266,274,involved,0,1,1
3CESM1J3EI4QFF38UEMBPYYX0SK6W8,"#30-19 ""We would have preferred a different solution but they have the legal right to impose the fine,” Portillo said, but the public posting of the photo impugned the officers' sense of honor.",22,31,preferred,3,4,7
3CESM1J3EI4QFF38UEMBPYYX0SK6W8,"#30-19 ""We would have preferred a different solution but they have the legal right to impose the fine,” Portillo said, but the public posting of the photo impugned the officers' sense of honor.",44,52,solution,2,1,3
3CESM1J3EI4QFF38UEMBPYYX0SK6W8,"#30-19 ""We would have preferred a different solution but they have the legal right to impose the fine,” Portillo said, but the public posting of the photo impugned the officers' sense of honor.",71,76,legal,0,1,1
3CESM1J3EI4QFF38UEMBPYYX0SK6W8,"#30-19 ""We would have preferred a different solution but they have the legal right to impose the fine,” Portillo said, but the public posting of the photo impugned the officers' sense of honor.",71,82,legal right,0,1,1
3CESM1J3EI4QFF38UEMBPYYX0SK6W8,"#30-19 ""We would have preferred a different solution but they have the legal right to impose the fine,” Portillo said, but the public posting of the photo impugned the officers' sense of honor.",86,92,impose,3,5,8
3CESM1J3EI4QFF38UEMBPYYX0SK6W8,"#30-19 ""We would have preferred a different solution but they have the legal right to impose the fine,” Portillo said, but the public posting of the photo impugned the officers' sense of honor.",86,101,impose the fine,1,0,1
3CESM1J3EI4QFF38UEMBPYYX0SK6W8,"#30-19 ""We would have preferred a different solution but they have the legal right to impose the fine,” Portillo said, but the public posting of the photo impugned the officers' sense of honor.",104,112,Portillo,1,0,1
3CESM1J3EI4QFF38UEMBPYYX0SK6W8,"#30-19 ""We would have preferred a different solution but they have the legal right to impose the fine,” Portillo said, but the public posting of the photo impugned the officers' sense of honor.",155,163,impugned,10,10,20
3CESM1J3EI4QFF38UEMBPYYX0SK6W8,"#30-19 ""We would have preferred a different solution but they have the legal right to impose the fine,” Portillo said, but the public posting of the photo impugned the officers' sense of honor.",178,192,sense of honor,0,1,1
3CESM1J3EI4QFF38UEMBPYYX0SK6W8,"#31-1 Explosion in central Bangkok: Thailand to hunt those responsible Thai authorities are searching for a man wearing a yellow T-shirt, recorded on video leaving a backpack shortly before a pipe-bomb exploded two days ago near Erawan Hindu Shrine, Bangkok.",6,15,Explosion,2,4,6
3CESM1J3EI4QFF38UEMBPYYX0SK6W8,"#31-1 Explosion in central Bangkok: Thailand to hunt those responsible Thai authorities are searching for a man wearing a yellow T-shirt, recorded on video leaving a backpack shortly before a pipe-bomb exploded two days ago near Erawan Hindu Shrine, Bangkok.",48,52,hunt,0,3,3
3CESM1J3EI4QFF38UEMBPYYX0SK6W8,"#31-1 Explosion in central Bangkok: Thailand to hunt those responsible Thai authorities are searching for a man wearing a yellow T-shirt, recorded on video leaving a backpack shortly before a pipe-bomb exploded two days ago near Erawan Hindu Shrine, Bangkok.",59,70,responsible,2,1,3
3CESM1J3EI4QFF38UEMBPYYX0SK6W8,"#31-1 Explosion in central Bangkok: Thailand to hunt those responsible Thai authorities are searching for a man wearing a yellow T-shirt, recorded on video leaving a backpack shortly before a pipe-bomb exploded two days ago near Erawan Hindu Shrine, Bangkok.",76,87,authorities,2,1,3
3CESM1J3EI4QFF38UEMBPYYX0SK6W8,"#31-1 Explosion in central Bangkok: Thailand to hunt those responsible Thai authorities are searching for a man wearing a yellow T-shirt, recorded on video leaving a backpack shortly before a pipe-bomb exploded two days ago near Erawan Hindu Shrine, Bangkok.",92,101,searching,1,0,1
3CESM1J3EI4QFF38UEMBPYYX0SK6W8,"#31-1 Explosion in central Bangkok: Thailand to hunt those responsible Thai authorities are searching for a man wearing a yellow T-shirt, recorded on video leaving a backpack shortly before a pipe-bomb exploded two days ago near Erawan Hindu Shrine, Bangkok.",166,174,backpack,2,4,6
3CESM1J3EI4QFF38UEMBPYYX0SK6W8,"#31-1 Explosion in central Bangkok: Thailand to hunt those responsible Thai authorities are searching for a man wearing a yellow T-shirt, recorded on video leaving a backpack shortly before a pipe-bomb exploded two days ago near Erawan Hindu Shrine, Bangkok.",192,201,pipe-bomb,2,3,5
3CESM1J3EI4QFF38UEMBPYYX0SK6W8,"#31-1 Explosion in central Bangkok: Thailand to hunt those responsible Thai authorities are searching for a man wearing a yellow T-shirt, recorded on video leaving a backpack shortly before a pipe-bomb exploded two days ago near Erawan Hindu Shrine, Bangkok.",202,210,exploded,4,4,8
3CESM1J3EI4QFF38UEMBPYYX0SK6W8,"#31-1 Explosion in central Bangkok: Thailand to hunt those responsible Thai authorities are searching for a man wearing a yellow T-shirt, recorded on video leaving a backpack shortly before a pipe-bomb exploded two days ago near Erawan Hindu Shrine, Bangkok.",229,235,Erawan,1,0,1
3CESM1J3EI4QFF38UEMBPYYX0SK6W8,"#31-1 Explosion in central Bangkok: Thailand to hunt those responsible Thai authorities are searching for a man wearing a yellow T-shirt, recorded on video leaving a backpack shortly before a pipe-bomb exploded two days ago near Erawan Hindu Shrine, Bangkok.",242,248,Shrine,0,1,1
3ACRLU860NF24RYC559DE8DP7PQEBL,#22-3 Abdul Kalam was taken to Bethany Hospital's intensive care unit and was declared dead about an hour and a half later.,31,38,Bethany,0,1,1
3ACRLU860NF24RYC559DE8DP7PQEBL,#22-3 Abdul Kalam was taken to Bethany Hospital's intensive care unit and was declared dead about an hour and a half later.,50,59,intensive,9,4,13
3ACRLU860NF24RYC559DE8DP7PQEBL,#22-3 Abdul Kalam was taken to Bethany Hospital's intensive care unit and was declared dead about an hour and a half later.,50,64,intensive care,0,1,1
3ACRLU860NF24RYC559DE8DP7PQEBL,#22-3 Abdul Kalam was taken to Bethany Hospital's intensive care unit and was declared dead about an hour and a half later.,50,69,intensive care unit,2,1,3
3ACRLU860NF24RYC559DE8DP7PQEBL,#22-3 Abdul Kalam was taken to Bethany Hospital's intensive care unit and was declared dead about an hour and a half later.,78,86,declared,4,4,8
3ACRLU860NF24RYC559DE8DP7PQEBL,"#22-5 According to doctors at Bethany Hospital, Kalam was dead by 7 p.m. but they waited for the arrival of Meghalaya chief minister V. Shanmuganathan, about an hour later, before announcing the death.",6,18,According to,0,1,1
3ACRLU860NF24RYC559DE8DP7PQEBL,"#22-5 According to doctors at Bethany Hospital, Kalam was dead by 7 p.m. but they waited for the arrival of Meghalaya chief minister V. Shanmuganathan, about an hour later, before announcing the death.",30,37,Bethany,0,1,1
3ACRLU860NF24RYC559DE8DP7PQEBL,"#22-5 According to doctors at Bethany Hospital, Kalam was dead by 7 p.m. but they waited for the arrival of Meghalaya chief minister V. Shanmuganathan, about an hour later, before announcing the death.",82,88,waited,0,1,1
3ACRLU860NF24RYC559DE8DP7PQEBL,"#22-5 According to doctors at Bethany Hospital, Kalam was dead by 7 p.m. but they waited for the arrival of Meghalaya chief minister V. Shanmuganathan, about an hour later, before announcing the death.",97,104,arrival,1,0,1
3ACRLU860NF24RYC559DE8DP7PQEBL,"#22-5 According to doctors at Bethany Hospital, Kalam was dead by 7 p.m. but they waited for the arrival of Meghalaya chief minister V. Shanmuganathan, about an hour later, before announcing the death.",108,117,Meghalaya,0,2,2
3ACRLU860NF24RYC559DE8DP7PQEBL,"#22-5 According to doctors at Bethany Hospital, Kalam was dead by 7 p.m. but they waited for the arrival of Meghalaya chief minister V. Shanmuganathan, about an hour later, before announcing the death.",108,150,Meghalaya chief minister V. Shanmuganathan,1,0,1
3ACRLU860NF24RYC559DE8DP7PQEBL,"#22-5 According to doctors at Bethany Hospital, Kalam was dead by 7 p.m. but they waited for the arrival of Meghalaya chief minister V. Shanmuganathan, about an hour later, before announcing the death.",124,132,minister,1,0,1
3ACRLU860NF24RYC559DE8DP7PQEBL,"#22-5 According to doctors at Bethany Hospital, Kalam was dead by 7 p.m. but they waited for the arrival of Meghalaya chief minister V. Shanmuganathan, about an hour later, before announcing the death.",136,150,Shanmuganathan,1,1,2
3ACRLU860NF24RYC559DE8DP7PQEBL,"#22-5 According to doctors at Bethany Hospital, Kalam was dead by 7 p.m. but they waited for the arrival of Meghalaya chief minister V. Shanmuganathan, about an hour later, before announcing the death.",180,190,announcing,2,3,5
3ACRLU860NF24RYC559DE8DP7PQEBL,"#22-6 LC Goyal, home secretary, said the Indian government will declare a seven day national mourning for Kalam.",16,30,home secretary,3,1,4
3ACRLU860NF24RYC559DE8DP7PQEBL,"#22-6 LC Goyal, home secretary, said the Indian government will declare a seven day national mourning for Kalam.",48,58,government,1,0,1
3ACRLU860NF24RYC559DE8DP7PQEBL,"#22-6 LC Goyal, home secretary, said the Indian government will declare a seven day national mourning for Kalam.",64,71,declare,0,4,4
3ACRLU860NF24RYC559DE8DP7PQEBL,"#22-6 LC Goyal, home secretary, said the Indian government will declare a seven day national mourning for Kalam.",84,101,national mourning,2,1,3
3ACRLU860NF24RYC559DE8DP7PQEBL,"#22-6 LC Goyal, home secretary, said the Indian government will declare a seven day national mourning for Kalam.",93,101,mourning,4,10,14
3ACRLU860NF24RYC559DE8DP7PQEBL,"#22-7 Home minister Rajnath Singh tweeted, ""He was an inspiration to an entire generation.""",20,33,Rajnath Singh,0,1,1
3ACRLU860NF24RYC559DE8DP7PQEBL,"#22-7 Home minister Rajnath Singh tweeted, ""He was an inspiration to an entire generation.""",34,41,tweeted,4,4,8
3ACRLU860NF24RYC559DE8DP7PQEBL,"#22-7 Home minister Rajnath Singh tweeted, ""He was an inspiration to an entire generation.""",54,65,inspiration,8,4,12
3ACRLU860NF24RYC559DE8DP7PQEBL,"#22-7 Home minister Rajnath Singh tweeted, ""He was an inspiration to an entire generation.""",72,89,entire generation,0,1,1
3ACRLU860NF24RYC559DE8DP7PQEBL,"#22-7 Home minister Rajnath Singh tweeted, ""He was an inspiration to an entire generation.""",79,89,generation,7,1,8
3ACRLU860NF24RYC559DE8DP7PQEBL,#22-8 Kalam's presidential term completed in July 2007.,14,26,presidential,0,2,2
3ACRLU860NF24RYC559DE8DP7PQEBL,#22-8 Kalam's presidential term completed in July 2007.,32,41,completed,0,1,1
3ACRLU860NF24RYC559DE8DP7PQEBL,"#23-1 U.S. presidential candidate Mark Everson challenges debate exclusion U.S. Republican Party presidential candidate Mark Everson, former commissioner of the Internal Revenue Service (IRS), filed a complaint on Monday with the Federal Election Commission (FEC) to challenge his exclusion from Thursday's first Fox News Republican Party presidential debate.",47,57,challenges,0,5,5
3ACRLU860NF24RYC559DE8DP7PQEBL,"#23-1 U.S. presidential candidate Mark Everson challenges debate exclusion U.S. Republican Party presidential candidate Mark Everson, former commissioner of the Internal Revenue Service (IRS), filed a complaint on Monday with the Federal Election Commission (FEC) to challenge his exclusion from Thursday's first Fox News Republican Party presidential debate.",58,64,debate,1,2,3
3ACRLU860NF24RYC559DE8DP7PQEBL,"#23-1 U.S. presidential candidate Mark Everson challenges debate exclusion U.S. Republican Party presidential candidate Mark Everson, former commissioner of the Internal Revenue Service (IRS), filed a complaint on Monday with the Federal Election Commission (FEC) to challenge his exclusion from Thursday's first Fox News Republican Party presidential debate.",58,74,debate exclusion,2,0,2
3ACRLU860NF24RYC559DE8DP7PQEBL,"#23-1 U.S. presidential candidate Mark Everson challenges debate exclusion U.S. Republican Party presidential candidate Mark Everson, former commissioner of the Internal Revenue Service (IRS), filed a complaint on Monday with the Federal Election Commission (FEC) to challenge his exclusion from Thursday's first Fox News Republican Party presidential debate.",65,74,exclusion,8,3,11
3ACRLU860NF24RYC559DE8DP7PQEBL,"#23-1 U.S. presidential candidate Mark Everson challenges debate exclusion U.S. Republican Party presidential candidate Mark Everson, former commissioner of the Internal Revenue Service (IRS), filed a complaint on Monday with the Federal Election Commission (FEC) to challenge his exclusion from Thursday's first Fox News Republican Party presidential debate.",97,119,presidential candidate,0,1,1
3ACRLU860NF24RYC559DE8DP7PQEBL,"#23-1 U.S. presidential candidate Mark Everson challenges debate exclusion U.S. Republican Party presidential candidate Mark Everson, former commissioner of the Internal Revenue Service (IRS), filed a complaint on Monday with the Federal Election Commission (FEC) to challenge his exclusion from Thursday's first Fox News Republican Party presidential debate.",110,119,candidate,1,0,1
3ACRLU860NF24RYC559DE8DP7PQEBL,"#23-1 U.S. presidential candidate Mark Everson challenges debate exclusion U.S. Republican Party presidential candidate Mark Everson, former commissioner of the Internal Revenue Service (IRS), filed a complaint on Monday with the Federal Election Commission (FEC) to challenge his exclusion from Thursday's first Fox News Republican Party presidential debate.",141,153,commissioner,7,2,9
3ACRLU860NF24RYC559DE8DP7PQEBL,"#23-1 U.S. presidential candidate Mark Everson challenges debate exclusion U.S. Republican Party presidential candidate Mark Everson, former commissioner of the Internal Revenue Service (IRS), filed a complaint on Monday with the Federal Election Commission (FEC) to challenge his exclusion from Thursday's first Fox News Republican Party presidential debate.",141,185,commissioner of the Internal Revenue Service,1,0,1
3ACRLU860NF24RYC559DE8DP7PQEBL,"#23-1 U.S. presidential candidate Mark Everson challenges debate exclusion U.S. Republican Party presidential candidate Mark Everson, former commissioner of the Internal Revenue Service (IRS), filed a complaint on Monday with the Federal Election Commission (FEC) to challenge his exclusion from Thursday's first Fox News Republican Party presidential debate.",161,185,Internal Revenue Service,1,0,1
3ACRLU860NF24RYC559DE8DP7PQEBL,"#23-1 U.S. presidential candidate Mark Everson challenges debate exclusion U.S. Republican Party presidential candidate Mark Everson, former commissioner of the Internal Revenue Service (IRS), filed a complaint on Monday with the Federal Election Commission (FEC) to challenge his exclusion from Thursday's first Fox News Republican Party presidential debate.",161,190,Internal Revenue Service (IRS,1,0,1
3ACRLU860NF24RYC559DE8DP7PQEBL,"#23-1 U.S. presidential candidate Mark Everson challenges debate exclusion U.S. Republican Party presidential candidate Mark Everson, former commissioner of the Internal Revenue Service (IRS), filed a complaint on Monday with the Federal Election Commission (FEC) to challenge his exclusion from Thursday's first Fox News Republican Party presidential debate.",170,177,Revenue,2,0,2
3ACRLU860NF24RYC559DE8DP7PQEBL,"#23-1 U.S. presidential candidate Mark Everson challenges debate exclusion U.S. Republican Party presidential candidate Mark Everson, former commissioner of the Internal Revenue Service (IRS), filed a complaint on Monday with the Federal Election Commission (FEC) to challenge his exclusion from Thursday's first Fox News Republican Party presidential debate.",193,198,filed,0,1,1
3ACRLU860NF24RYC559DE8DP7PQEBL,"#23-1 U.S. presidential candidate Mark Everson challenges debate exclusion U.S. Republican Party presidential candidate Mark Everson, former commissioner of the Internal Revenue Service (IRS), filed a complaint on Monday with the Federal Election Commission (FEC) to challenge his exclusion from Thursday's first Fox News Republican Party presidential debate.",201,210,complaint,2,1,3
3ACRLU860NF24RYC559DE8DP7PQEBL,"#23-1 U.S. presidential candidate Mark Everson challenges debate exclusion U.S. Republican Party presidential candidate Mark Everson, former commissioner of the Internal Revenue Service (IRS), filed a complaint on Monday with the Federal Election Commission (FEC) to challenge his exclusion from Thursday's first Fox News Republican Party presidential debate.",230,237,Federal,0,1,1
3ACRLU860NF24RYC559DE8DP7PQEBL,"#23-1 U.S. presidential candidate Mark Everson challenges debate exclusion U.S. Republican Party presidential candidate Mark Everson, former commissioner of the Internal Revenue Service (IRS), filed a complaint on Monday with the Federal Election Commission (FEC) to challenge his exclusion from Thursday's first Fox News Republican Party presidential debate.",230,257,Federal Election Commission,5,0,5
3ACRLU860NF24RYC559DE8DP7PQEBL,"#23-1 U.S. presidential candidate Mark Everson challenges debate exclusion U.S. Republican Party presidential candidate Mark Everson, former commissioner of the Internal Revenue Service (IRS), filed a complaint on Monday with the Federal Election Commission (FEC) to challenge his exclusion from Thursday's first Fox News Republican Party presidential debate.",238,246,Election,1,0,1
3ACRLU860NF24RYC559DE8DP7PQEBL,"#23-1 U.S. presidential candidate Mark Everson challenges debate exclusion U.S. Republican Party presidential candidate Mark Everson, former commissioner of the Internal Revenue Service (IRS), filed a complaint on Monday with the Federal Election Commission (FEC) to challenge his exclusion from Thursday's first Fox News Republican Party presidential debate.",238,257,Election Commission,1,0,1
3ACRLU860NF24RYC559DE8DP7PQEBL,"#23-1 U.S. presidential candidate Mark Everson challenges debate exclusion U.S. Republican Party presidential candidate Mark Everson, former commissioner of the Internal Revenue Service (IRS), filed a complaint on Monday with the Federal Election Commission (FEC) to challenge his exclusion from Thursday's first Fox News Republican Party presidential debate.",267,276,challenge,0,2,2
3ACRLU860NF24RYC559DE8DP7PQEBL,"#23-1 U.S. presidential candidate Mark Everson challenges debate exclusion U.S. Republican Party presidential candidate Mark Everson, former commissioner of the Internal Revenue Service (IRS), filed a complaint on Monday with the Federal Election Commission (FEC) to challenge his exclusion from Thursday's first Fox News Republican Party presidential debate.",267,290,challenge his exclusion,1,0,1
3ACRLU860NF24RYC559DE8DP7PQEBL,"#23-1 U.S. presidential candidate Mark Everson challenges debate exclusion U.S. Republican Party presidential candidate Mark Everson, former commissioner of the Internal Revenue Service (IRS), filed a complaint on Monday with the Federal Election Commission (FEC) to challenge his exclusion from Thursday's first Fox News Republican Party presidential debate.",281,290,exclusion,2,6,8
3ACRLU860NF24RYC559DE8DP7PQEBL,"#23-1 U.S. presidential candidate Mark Everson challenges debate exclusion U.S. Republican Party presidential candidate Mark Everson, former commissioner of the Internal Revenue Service (IRS), filed a complaint on Monday with the Federal Election Commission (FEC) to challenge his exclusion from Thursday's first Fox News Republican Party presidential debate.",322,332,Republican,1,0,1
3ACRLU860NF24RYC559DE8DP7PQEBL,"#23-1 U.S. presidential candidate Mark Everson challenges debate exclusion U.S. Republican Party presidential candidate Mark Everson, former commissioner of the Internal Revenue Service (IRS), filed a complaint on Monday with the Federal Election Commission (FEC) to challenge his exclusion from Thursday's first Fox News Republican Party presidential debate.",322,338,Republican Party,1,0,1
3ACRLU860NF24RYC559DE8DP7PQEBL,"#23-1 U.S. presidential candidate Mark Everson challenges debate exclusion U.S. Republican Party presidential candidate Mark Everson, former commissioner of the Internal Revenue Service (IRS), filed a complaint on Monday with the Federal Election Commission (FEC) to challenge his exclusion from Thursday's first Fox News Republican Party presidential debate.",339,351,presidential,2,0,2
3ACRLU860NF24RYC559DE8DP7PQEBL,"#23-1 U.S. presidential candidate Mark Everson challenges debate exclusion U.S. Republican Party presidential candidate Mark Everson, former commissioner of the Internal Revenue Service (IRS), filed a complaint on Monday with the Federal Election Commission (FEC) to challenge his exclusion from Thursday's first Fox News Republican Party presidential debate.",339,358,presidential debate,0,1,1
3ACRLU860NF24RYC559DE8DP7PQEBL,"#23-1 U.S. presidential candidate Mark Everson challenges debate exclusion U.S. Republican Party presidential candidate Mark Everson, former commissioner of the Internal Revenue Service (IRS), filed a complaint on Monday with the Federal Election Commission (FEC) to challenge his exclusion from Thursday's first Fox News Republican Party presidential debate.",352,358,debate,1,4,5
31ANT7FQN83CZL85UWQ6WPAAP9WH53,#23-6 Fox News claims Everson fails to meet the criteria it established for Thursday's two debates.,15,21,claims,1,1,2
31ANT7FQN83CZL85UWQ6WPAAP9WH53,#23-6 Fox News claims Everson fails to meet the criteria it established for Thursday's two debates.,22,29,Everson,0,1,1
31ANT7FQN83CZL85UWQ6WPAAP9WH53,#23-6 Fox News claims Everson fails to meet the criteria it established for Thursday's two debates.,39,56,meet the criteria,1,0,1
31ANT7FQN83CZL85UWQ6WPAAP9WH53,#23-6 Fox News claims Everson fails to meet the criteria it established for Thursday's two debates.,48,56,criteria,7,7,14
31ANT7FQN83CZL85UWQ6WPAAP9WH53,#23-6 Fox News claims Everson fails to meet the criteria it established for Thursday's two debates.,60,71,established,8,2,10
31ANT7FQN83CZL85UWQ6WPAAP9WH53,#23-6 Fox News claims Everson fails to meet the criteria it established for Thursday's two debates.,91,98,debates,1,3,4
31ANT7FQN83CZL85UWQ6WPAAP9WH53,"#23-7 Only seventeen candidates meet the criteria, which require a candidate ""consistently"" be included in ""recognized"" opinion polls.",11,31,seventeen candidates,1,0,1
31ANT7FQN83CZL85UWQ6WPAAP9WH53,"#23-7 Only seventeen candidates meet the criteria, which require a candidate ""consistently"" be included in ""recognized"" opinion polls.",21,31,candidates,1,1,2
31ANT7FQN83CZL85UWQ6WPAAP9WH53,"#23-7 Only seventeen candidates meet the criteria, which require a candidate ""consistently"" be included in ""recognized"" opinion polls.",41,49,criteria,3,0,3
31ANT7FQN83CZL85UWQ6WPAAP9WH53,"#23-7 Only seventeen candidates meet the criteria, which require a candidate ""consistently"" be included in ""recognized"" opinion polls.",78,90,consistently,8,9,17
31ANT7FQN83CZL85UWQ6WPAAP9WH53,"#23-7 Only seventeen candidates meet the criteria, which require a candidate ""consistently"" be included in ""recognized"" opinion polls.",107,131,recognized opinion polls,1,0,1
31ANT7FQN83CZL85UWQ6WPAAP9WH53,"#23-7 Only seventeen candidates meet the criteria, which require a candidate ""consistently"" be included in ""recognized"" opinion polls.",108,118,recognized,3,5,8
31ANT7FQN83CZL85UWQ6WPAAP9WH53,"#23-7 Only seventeen candidates meet the criteria, which require a candidate ""consistently"" be included in ""recognized"" opinion polls.",120,127,opinion,2,0,2
31ANT7FQN83CZL85UWQ6WPAAP9WH53,"#23-7 Only seventeen candidates meet the criteria, which require a candidate ""consistently"" be included in ""recognized"" opinion polls.",120,133,opinion polls,0,1,1
31ANT7FQN83CZL85UWQ6WPAAP9WH53,"#23-7 Only seventeen candidates meet the criteria, which require a candidate ""consistently"" be included in ""recognized"" opinion polls.",128,133,polls,0,2,2
31ANT7FQN83CZL85UWQ6WPAAP9WH53,#23-8 The prime-time event features the top ten candidates by average polling percentage.,10,20,prime-time,1,5,6
31ANT7FQN83CZL85UWQ6WPAAP9WH53,#23-8 The prime-time event features the top ten candidates by average polling percentage.,10,26,prime-time event,1,1,2
31ANT7FQN83CZL85UWQ6WPAAP9WH53,#23-8 The prime-time event features the top ten candidates by average polling percentage.,27,35,features,1,1,2
31ANT7FQN83CZL85UWQ6WPAAP9WH53,#23-8 The prime-time event features the top ten candidates by average polling percentage.,62,69,average,1,0,1
31ANT7FQN83CZL85UWQ6WPAAP9WH53,#23-8 The prime-time event features the top ten candidates by average polling percentage.,62,77,average polling,0,1,1
31ANT7FQN83CZL85UWQ6WPAAP9WH53,#23-8 The prime-time event features the top ten candidates by average polling percentage.,62,88,average polling percentage,2,0,2
31ANT7FQN83CZL85UWQ6WPAAP9WH53,#23-8 The prime-time event features the top ten candidates by average polling percentage.,70,77,polling,1,1,2
31ANT7FQN83CZL85UWQ6WPAAP9WH53,#23-8 The prime-time event features the top ten candidates by average polling percentage.,78,88,percentage,2,1,3
31ANT7FQN83CZL85UWQ6WPAAP9WH53,#23-9 The other seven participate in a separate debate just before the prime time event.,22,33,participate,3,1,4
31ANT7FQN83CZL85UWQ6WPAAP9WH53,#23-9 The other seven participate in a separate debate just before the prime time event.,39,47,separate,1,0,1
31ANT7FQN83CZL85UWQ6WPAAP9WH53,#23-9 The other seven participate in a separate debate just before the prime time event.,48,54,debate,1,0,1
31ANT7FQN83CZL85UWQ6WPAAP9WH53,#23-9 The other seven participate in a separate debate just before the prime time event.,71,87,prime time event,0,1,1
31ANT7FQN83CZL85UWQ6WPAAP9WH53,"#23-10 In his complaint, Everson urges the FEC to compel Fox News to include him in the second tier debate as the eighth participant.",14,23,complaint,3,1,4
31ANT7FQN83CZL85UWQ6WPAAP9WH53,"#23-10 In his complaint, Everson urges the FEC to compel Fox News to include him in the second tier debate as the eighth participant.",25,32,Everson,0,1,1
31ANT7FQN83CZL85UWQ6WPAAP9WH53,"#23-10 In his complaint, Everson urges the FEC to compel Fox News to include him in the second tier debate as the eighth participant.",33,38,urges,2,1,3
31ANT7FQN83CZL85UWQ6WPAAP9WH53,"#23-10 In his complaint, Everson urges the FEC to compel Fox News to include him in the second tier debate as the eighth participant.",50,56,compel,3,3,6
31ANT7FQN83CZL85UWQ6WPAAP9WH53,"#23-10 In his complaint, Everson urges the FEC to compel Fox News to include him in the second tier debate as the eighth participant.",57,65,Fox News,1,0,1
31ANT7FQN83CZL85UWQ6WPAAP9WH53,"#23-10 In his complaint, Everson urges the FEC to compel Fox News to include him in the second tier debate as the eighth participant.",88,99,second tier,1,0,1
31ANT7FQN83CZL85UWQ6WPAAP9WH53,"#23-10 In his complaint, Everson urges the FEC to compel Fox News to include him in the second tier debate as the eighth participant.",88,106,second tier debate,2,1,3
31ANT7FQN83CZL85UWQ6WPAAP9WH53,"#23-10 In his complaint, Everson urges the FEC to compel Fox News to include him in the second tier debate as the eighth participant.",95,99,tier,3,1,4
31ANT7FQN83CZL85UWQ6WPAAP9WH53,"#23-10 In his complaint, Everson urges the FEC to compel Fox News to include him in the second tier debate as the eighth participant.",114,132,eighth participant,1,0,1
31ANT7FQN83CZL85UWQ6WPAAP9WH53,"#23-10 In his complaint, Everson urges the FEC to compel Fox News to include him in the second tier debate as the eighth participant.",121,132,participant,4,0,4
31ANT7FQN83CZL85UWQ6WPAAP9WH53,"#23-11 Everson argues Fox News, in violation of Title 11, ""structure[d] the debates to promote or advance one candidate over another"" through a July 27 change to its criteria that replaced a pre-existing one percent polling threshold with a threshold admitting those ""consistently"" included in ""recognized"" polls.",15,21,argues,1,1,2
31ANT7FQN83CZL85UWQ6WPAAP9WH53,"#23-11 Everson argues Fox News, in violation of Title 11, ""structure[d] the debates to promote or advance one candidate over another"" through a July 27 change to its criteria that replaced a pre-existing one percent polling threshold with a threshold admitting those ""consistently"" included in ""recognized"" polls.",35,44,violation,3,1,4
31ANT7FQN83CZL85UWQ6WPAAP9WH53,"#23-11 Everson argues Fox News, in violation of Title 11, ""structure[d] the debates to promote or advance one candidate over another"" through a July 27 change to its criteria that replaced a pre-existing one percent polling threshold with a threshold admitting those ""consistently"" included in ""recognized"" polls.",59,83,structure[d] the debates,1,0,1
31ANT7FQN83CZL85UWQ6WPAAP9WH53,"#23-11 Everson argues Fox News, in violation of Title 11, ""structure[d] the debates to promote or advance one candidate over another"" through a July 27 change to its criteria that replaced a pre-existing one percent polling threshold with a threshold admitting those ""consistently"" included in ""recognized"" polls.",76,83,debates,0,1,1
31ANT7FQN83CZL85UWQ6WPAAP9WH53,"#23-11 Everson argues Fox News, in violation of Title 11, ""structure[d] the debates to promote or advance one candidate over another"" through a July 27 change to its criteria that replaced a pre-existing one percent polling threshold with a threshold admitting those ""consistently"" included in ""recognized"" polls.",110,119,candidate,2,0,2
31ANT7FQN83CZL85UWQ6WPAAP9WH53,"#23-11 Everson argues Fox News, in violation of Title 11, ""structure[d] the debates to promote or advance one candidate over another"" through a July 27 change to its criteria that replaced a pre-existing one percent polling threshold with a threshold admitting those ""consistently"" included in ""recognized"" polls.",166,174,criteria,2,0,2
31ANT7FQN83CZL85UWQ6WPAAP9WH53,"#23-11 Everson argues Fox News, in violation of Title 11, ""structure[d] the debates to promote or advance one candidate over another"" through a July 27 change to its criteria that replaced a pre-existing one percent polling threshold with a threshold admitting those ""consistently"" included in ""recognized"" polls.",166,188,criteria that replaced,0,1,1
31ANT7FQN83CZL85UWQ6WPAAP9WH53,"#23-11 Everson argues Fox News, in violation of Title 11, ""structure[d] the debates to promote or advance one candidate over another"" through a July 27 change to its criteria that replaced a pre-existing one percent polling threshold with a threshold admitting those ""consistently"" included in ""recognized"" polls.",191,203,pre-existing,7,2,9
31ANT7FQN83CZL85UWQ6WPAAP9WH53,"#23-11 Everson argues Fox News, in violation of Title 11, ""structure[d] the debates to promote or advance one candidate over another"" through a July 27 change to its criteria that replaced a pre-existing one percent polling threshold with a threshold admitting those ""consistently"" included in ""recognized"" polls.",208,223,percent polling,0,1,1
31ANT7FQN83CZL85UWQ6WPAAP9WH53,"#23-11 Everson argues Fox News, in violation of Title 11, ""structure[d] the debates to promote or advance one candidate over another"" through a July 27 change to its criteria that replaced a pre-existing one percent polling threshold with a threshold admitting those ""consistently"" included in ""recognized"" polls.",216,223,polling,1,0,1
31ANT7FQN83CZL85UWQ6WPAAP9WH53,"#23-11 Everson argues Fox News, in violation of Title 11, ""structure[d] the debates to promote or advance one candidate over another"" through a July 27 change to its criteria that replaced a pre-existing one percent polling threshold with a threshold admitting those ""consistently"" included in ""recognized"" polls.",216,233,polling threshold,1,1,2
31ANT7FQN83CZL85UWQ6WPAAP9WH53,"#23-11 Everson argues Fox News, in violation of Title 11, ""structure[d] the debates to promote or advance one candidate over another"" through a July 27 change to its criteria that replaced a pre-existing one percent polling threshold with a threshold admitting those ""consistently"" included in ""recognized"" polls.",224,233,threshold,7,4,11
31ANT7FQN83CZL85UWQ6WPAAP9WH53,"#23-11 Everson argues Fox News, in violation of Title 11, ""structure[d] the debates to promote or advance one candidate over another"" through a July 27 change to its criteria that replaced a pre-existing one percent polling threshold with a threshold admitting those ""consistently"" included in ""recognized"" polls.",241,260,threshold admitting,1,0,1
31ANT7FQN83CZL85UWQ6WPAAP9WH53,"#23-11 Everson argues Fox News, in violation of Title 11, ""structure[d] the debates to promote or advance one candidate over another"" through a July 27 change to its criteria that replaced a pre-existing one percent polling threshold with a threshold admitting those ""consistently"" included in ""recognized"" polls.",268,280,consistently,3,3,6
31ANT7FQN83CZL85UWQ6WPAAP9WH53,"#23-11 Everson argues Fox News, in violation of Title 11, ""structure[d] the debates to promote or advance one candidate over another"" through a July 27 change to its criteria that replaced a pre-existing one percent polling threshold with a threshold admitting those ""consistently"" included in ""recognized"" polls.",294,310,recognized polls,1,0,1
31ANT7FQN83CZL85UWQ6WPAAP9WH53,"#23-11 Everson argues Fox News, in violation of Title 11, ""structure[d] the debates to promote or advance one candidate over another"" through a July 27 change to its criteria that replaced a pre-existing one percent polling threshold with a threshold admitting those ""consistently"" included in ""recognized"" polls.",295,305,recognized,4,2,6
3ZQA3IO31BSN3KT9XMJKD8UUPF51OT,"#1-1 Theresa May's Brexit speech rules out single market membership UK Prime Minister Theresa May yesterday announced the government's plans for how to proceed with the United Kingdom's exit, or ""Brexit"" (British exit), from the European Union.",19,25,Brexit,4,3,7
3ZQA3IO31BSN3KT9XMJKD8UUPF51OT,"#1-1 Theresa May's Brexit speech rules out single market membership UK Prime Minister Theresa May yesterday announced the government's plans for how to proceed with the United Kingdom's exit, or ""Brexit"" (British exit), from the European Union.",33,42,rules out,0,4,4
3ZQA3IO31BSN3KT9XMJKD8UUPF51OT,"#1-1 Theresa May's Brexit speech rules out single market membership UK Prime Minister Theresa May yesterday announced the government's plans for how to proceed with the United Kingdom's exit, or ""Brexit"" (British exit), from the European Union.",43,56,single market,1,0,1
3ZQA3IO31BSN3KT9XMJKD8UUPF51OT,"#1-1 Theresa May's Brexit speech rules out single market membership UK Prime Minister Theresa May yesterday announced the government's plans for how to proceed with the United Kingdom's exit, or ""Brexit"" (British exit), from the European Union.",43,67,single market membership,0,3,3
3ZQA3IO31BSN3KT9XMJKD8UUPF51OT,"#1-1 Theresa May's Brexit speech rules out single market membership UK Prime Minister Theresa May yesterday announced the government's plans for how to proceed with the United Kingdom's exit, or ""Brexit"" (British exit), from the European Union.",50,56,market,1,0,1
3ZQA3IO31BSN3KT9XMJKD8UUPF51OT,"#1-1 Theresa May's Brexit speech rules out single market membership UK Prime Minister Theresa May yesterday announced the government's plans for how to proceed with the United Kingdom's exit, or ""Brexit"" (British exit), from the European Union.",57,67,membership,1,0,1
3ZQA3IO31BSN3KT9XMJKD8UUPF51OT,"#1-1 Theresa May's Brexit speech rules out single market membership UK Prime Minister Theresa May yesterday announced the government's plans for how to proceed with the United Kingdom's exit, or ""Brexit"" (British exit), from the European Union.",108,117,announced,2,2,4
3ZQA3IO31BSN3KT9XMJKD8UUPF51OT,"#1-1 Theresa May's Brexit speech rules out single market membership UK Prime Minister Theresa May yesterday announced the government's plans for how to proceed with the United Kingdom's exit, or ""Brexit"" (British exit), from the European Union.",122,133,governments,1,0,1
3ZQA3IO31BSN3KT9XMJKD8UUPF51OT,"#1-1 Theresa May's Brexit speech rules out single market membership UK Prime Minister Theresa May yesterday announced the government's plans for how to proceed with the United Kingdom's exit, or ""Brexit"" (British exit), from the European Union.",152,159,proceed,2,3,5
3ZQA3IO31BSN3KT9XMJKD8UUPF51OT,"#1-1 Theresa May's Brexit speech rules out single market membership UK Prime Minister Theresa May yesterday announced the government's plans for how to proceed with the United Kingdom's exit, or ""Brexit"" (British exit), from the European Union.",196,202,Brexit,2,0,2
3ZQA3IO31BSN3KT9XMJKD8UUPF51OT,#1-2 May stated the government would not seek to be a member of the European single market and would instead seek a new trade relationship.,9,15,stated,0,1,1
3ZQA3IO31BSN3KT9XMJKD8UUPF51OT,#1-2 May stated the government would not seek to be a member of the European single market and would instead seek a new trade relationship.,20,30,government,1,0,1
3ZQA3IO31BSN3KT9XMJKD8UUPF51OT,#1-2 May stated the government would not seek to be a member of the European single market and would instead seek a new trade relationship.,41,45,seek,0,1,1
3ZQA3IO31BSN3KT9XMJKD8UUPF51OT,#1-2 May stated the government would not seek to be a member of the European single market and would instead seek a new trade relationship.,77,90,single market,0,2,2
3ZQA3IO31BSN3KT9XMJKD8UUPF51OT,#1-2 May stated the government would not seek to be a member of the European single market and would instead seek a new trade relationship.,101,108,instead,0,3,3
3ZQA3IO31BSN3KT9XMJKD8UUPF51OT,#1-2 May stated the government would not seek to be a member of the European single market and would instead seek a new trade relationship.,109,113,seek,2,1,3
3ZQA3IO31BSN3KT9XMJKD8UUPF51OT,#1-2 May stated the government would not seek to be a member of the European single market and would instead seek a new trade relationship.,120,125,trade,0,1,1
3ZQA3IO31BSN3KT9XMJKD8UUPF51OT,#1-2 May stated the government would not seek to be a member of the European single market and would instead seek a new trade relationship.,120,138,trade relationship,0,2,2
3ZQA3IO31BSN3KT9XMJKD8UUPF51OT,#1-2 May stated the government would not seek to be a member of the European single market and would instead seek a new trade relationship.,126,138,relationship,2,0,2
3ZQA3IO31BSN3KT9XMJKD8UUPF51OT,#1-3 May said the UK government would seek access to the single market without retaining formal membership in it.,21,31,government,1,0,1
3ZQA3IO31BSN3KT9XMJKD8UUPF51OT,#1-3 May said the UK government would seek access to the single market without retaining formal membership in it.,38,42,seek,0,1,1
3ZQA3IO31BSN3KT9XMJKD8UUPF51OT,#1-3 May said the UK government would seek access to the single market without retaining formal membership in it.,38,49,seek access,0,1,1
3ZQA3IO31BSN3KT9XMJKD8UUPF51OT,#1-3 May said the UK government would seek access to the single market without retaining formal membership in it.,43,49,access,4,0,4
3ZQA3IO31BSN3KT9XMJKD8UUPF51OT,#1-3 May said the UK government would seek access to the single market without retaining formal membership in it.,57,70,single market,0,1,1
3ZQA3IO31BSN3KT9XMJKD8UUPF51OT,#1-3 May said the UK government would seek access to the single market without retaining formal membership in it.,79,88,retaining,10,9,19
3ZQA3IO31BSN3KT9XMJKD8UUPF51OT,#1-3 May said the UK government would seek access to the single market without retaining formal membership in it.,89,95,formal,0,1,1
3ZQA3IO31BSN3KT9XMJKD8UUPF51OT,#1-3 May said the UK government would seek access to the single market without retaining formal membership in it.,96,106,membership,1,0,1
3ZQA3IO31BSN3KT9XMJKD8UUPF51OT,"#1-4 May's speech stressed the need for friendliness between Britain and the EU but also ruled out any deal that did not allow the British government to control immigration, or which would require Britain to continue being bound by decisions of the European Court of Justice.",18,26,stressed,2,6,8
3ZQA3IO31BSN3KT9XMJKD8UUPF51OT,"#1-4 May's speech stressed the need for friendliness between Britain and the EU but also ruled out any deal that did not allow the British government to control immigration, or which would require Britain to continue being bound by decisions of the European Court of Justice.",31,52,need for friendliness,0,1,1
3ZQA3IO31BSN3KT9XMJKD8UUPF51OT,"#1-4 May's speech stressed the need for friendliness between Britain and the EU but also ruled out any deal that did not allow the British government to control immigration, or which would require Britain to continue being bound by decisions of the European Court of Justice.",40,52,friendliness,5,2,7
3ZQA3IO31BSN3KT9XMJKD8UUPF51OT,"#1-4 May's speech stressed the need for friendliness between Britain and the EU but also ruled out any deal that did not allow the British government to control immigration, or which would require Britain to continue being bound by decisions of the European Court of Justice.",77,79,EU,1,0,1
3ZQA3IO31BSN3KT9XMJKD8UUPF51OT,"#1-4 May's speech stressed the need for friendliness between Britain and the EU but also ruled out any deal that did not allow the British government to control immigration, or which would require Britain to continue being bound by decisions of the European Court of Justice.",153,172,control immigration,1,1,2
3ZQA3IO31BSN3KT9XMJKD8UUPF51OT,"#1-4 May's speech stressed the need for friendliness between Britain and the EU but also ruled out any deal that did not allow the British government to control immigration, or which would require Britain to continue being bound by decisions of the European Court of Justice.",161,172,immigration,10,6,16
3ZQA3IO31BSN3KT9XMJKD8UUPF51OT,"#1-4 May's speech stressed the need for friendliness between Britain and the EU but also ruled out any deal that did not allow the British government to control immigration, or which would require Britain to continue being bound by decisions of the European Court of Justice.",189,196,require,1,0,1
3ZQA3IO31BSN3KT9XMJKD8UUPF51OT,"#1-4 May's speech stressed the need for friendliness between Britain and the EU but also ruled out any deal that did not allow the British government to control immigration, or which would require Britain to continue being bound by decisions of the European Court of Justice.",223,228,bound,3,6,9
3ZQA3IO31BSN3KT9XMJKD8UUPF51OT,"#1-4 May's speech stressed the need for friendliness between Britain and the EU but also ruled out any deal that did not allow the British government to control immigration, or which would require Britain to continue being bound by decisions of the European Court of Justice.",223,241,bound by decisions,0,2,2
3ZQA3IO31BSN3KT9XMJKD8UUPF51OT,"#1-4 May's speech stressed the need for friendliness between Britain and the EU but also ruled out any deal that did not allow the British government to control immigration, or which would require Britain to continue being bound by decisions of the European Court of Justice.",232,241,decisions,3,1,4
3ZQA3IO31BSN3KT9XMJKD8UUPF51OT,"#1-4 May's speech stressed the need for friendliness between Britain and the EU but also ruled out any deal that did not allow the British government to control immigration, or which would require Britain to continue being bound by decisions of the European Court of Justice.",249,257,European,1,0,1
3ZQA3IO31BSN3KT9XMJKD8UUPF51OT,"#1-4 May's speech stressed the need for friendliness between Britain and the EU but also ruled out any deal that did not allow the British government to control immigration, or which would require Britain to continue being bound by decisions of the European Court of Justice.",249,274,European Court of Justice,1,0,1
3ZQA3IO31BSN3KT9XMJKD8UUPF51OT,"#1-4 May's speech stressed the need for friendliness between Britain and the EU but also ruled out any deal that did not allow the British government to control immigration, or which would require Britain to continue being bound by decisions of the European Court of Justice.",258,263,Court,1,0,1
3ZQA3IO31BSN3KT9XMJKD8UUPF51OT,"#1-4 May's speech stressed the need for friendliness between Britain and the EU but also ruled out any deal that did not allow the British government to control immigration, or which would require Britain to continue being bound by decisions of the European Court of Justice.",267,274,Justice,2,0,2
3WRKFXQBOB8AX4T9BGDO7Y9IKRFIYD,"#29-15 In addition to preventing Bush from gaining the Republican nomination, Martin intends to focus his campaign on protecting the prestige of the New Hampshire Primary and Iowa Caucus, defending the economic legacy of Founding Father Alexander Hamilton, combating political correctness, emphasizing U.S. relations with Greece, and fighting political corruption.",22,32,preventing,1,2,3
3WRKFXQBOB8AX4T9BGDO7Y9IKRFIYD,"#29-15 In addition to preventing Bush from gaining the Republican nomination, Martin intends to focus his campaign on protecting the prestige of the New Hampshire Primary and Iowa Caucus, defending the economic legacy of Founding Father Alexander Hamilton, combating political correctness, emphasizing U.S. relations with Greece, and fighting political corruption.",43,50,gaining,0,1,1
3WRKFXQBOB8AX4T9BGDO7Y9IKRFIYD,"#29-15 In addition to preventing Bush from gaining the Republican nomination, Martin intends to focus his campaign on protecting the prestige of the New Hampshire Primary and Iowa Caucus, defending the economic legacy of Founding Father Alexander Hamilton, combating political correctness, emphasizing U.S. relations with Greece, and fighting political corruption.",55,76,Republican nomination,3,0,3
3WRKFXQBOB8AX4T9BGDO7Y9IKRFIYD,"#29-15 In addition to preventing Bush from gaining the Republican nomination, Martin intends to focus his campaign on protecting the prestige of the New Hampshire Primary and Iowa Caucus, defending the economic legacy of Founding Father Alexander Hamilton, combating political correctness, emphasizing U.S. relations with Greece, and fighting political corruption.",66,76,nomination,10,3,13
3WRKFXQBOB8AX4T9BGDO7Y9IKRFIYD,"#29-15 In addition to preventing Bush from gaining the Republican nomination, Martin intends to focus his campaign on protecting the prestige of the New Hampshire Primary and Iowa Caucus, defending the economic legacy of Founding Father Alexander Hamilton, combating political correctness, emphasizing U.S. relations with Greece, and fighting political corruption.",85,92,intends,0,3,3
3WRKFXQBOB8AX4T9BGDO7Y9IKRFIYD,"#29-15 In addition to preventing Bush from gaining the Republican nomination, Martin intends to focus his campaign on protecting the prestige of the New Hampshire Primary and Iowa Caucus, defending the economic legacy of Founding Father Alexander Hamilton, combating political correctness, emphasizing U.S. relations with Greece, and fighting political corruption.",96,101,focus,2,1,3
3WRKFXQBOB8AX4T9BGDO7Y9IKRFIYD,"#29-15 In addition to preventing Bush from gaining the Republican nomination, Martin intends to focus his campaign on protecting the prestige of the New Hampshire Primary and Iowa Caucus, defending the economic legacy of Founding Father Alexander Hamilton, combating political correctness, emphasizing U.S. relations with Greece, and fighting political corruption.",106,114,campaign,4,4,8
3WRKFXQBOB8AX4T9BGDO7Y9IKRFIYD,"#29-15 In addition to preventing Bush from gaining the Republican nomination, Martin intends to focus his campaign on protecting the prestige of the New Hampshire Primary and Iowa Caucus, defending the economic legacy of Founding Father Alexander Hamilton, combating political correctness, emphasizing U.S. relations with Greece, and fighting political corruption.",118,128,protecting,1,0,1
3WRKFXQBOB8AX4T9BGDO7Y9IKRFIYD,"#29-15 In addition to preventing Bush from gaining the Republican nomination, Martin intends to focus his campaign on protecting the prestige of the New Hampshire Primary and Iowa Caucus, defending the economic legacy of Founding Father Alexander Hamilton, combating political correctness, emphasizing U.S. relations with Greece, and fighting political corruption.",133,141,prestige,9,7,16
3WRKFXQBOB8AX4T9BGDO7Y9IKRFIYD,"#29-15 In addition to preventing Bush from gaining the Republican nomination, Martin intends to focus his campaign on protecting the prestige of the New Hampshire Primary and Iowa Caucus, defending the economic legacy of Founding Father Alexander Hamilton, combating political correctness, emphasizing U.S. relations with Greece, and fighting political corruption.",153,162,Hampshire,0,1,1
3WRKFXQBOB8AX4T9BGDO7Y9IKRFIYD,"#29-15 In addition to preventing Bush from gaining the Republican nomination, Martin intends to focus his campaign on protecting the prestige of the New Hampshire Primary and Iowa Caucus, defending the economic legacy of Founding Father Alexander Hamilton, combating political correctness, emphasizing U.S. relations with Greece, and fighting political corruption.",163,170,Primary,2,0,2
3WRKFXQBOB8AX4T9BGDO7Y9IKRFIYD,"#29-15 In addition to preventing Bush from gaining the Republican nomination, Martin intends to focus his campaign on protecting the prestige of the New Hampshire Primary and Iowa Caucus, defending the economic legacy of Founding Father Alexander Hamilton, combating political correctness, emphasizing U.S. relations with Greece, and fighting political corruption.",180,186,Caucus,4,2,6
3WRKFXQBOB8AX4T9BGDO7Y9IKRFIYD,"#29-15 In addition to preventing Bush from gaining the Republican nomination, Martin intends to focus his campaign on protecting the prestige of the New Hampshire Primary and Iowa Caucus, defending the economic legacy of Founding Father Alexander Hamilton, combating political correctness, emphasizing U.S. relations with Greece, and fighting political corruption.",188,217,defending the economic legacy,1,0,1
3WRKFXQBOB8AX4T9BGDO7Y9IKRFIYD,"#29-15 In addition to preventing Bush from gaining the Republican nomination, Martin intends to focus his campaign on protecting the prestige of the New Hampshire Primary and Iowa Caucus, defending the economic legacy of Founding Father Alexander Hamilton, combating political correctness, emphasizing U.S. relations with Greece, and fighting political corruption.",202,217,economic legacy,2,1,3
3WRKFXQBOB8AX4T9BGDO7Y9IKRFIYD,"#29-15 In addition to preventing Bush from gaining the Republican nomination, Martin intends to focus his campaign on protecting the prestige of the New Hampshire Primary and Iowa Caucus, defending the economic legacy of Founding Father Alexander Hamilton, combating political correctness, emphasizing U.S. relations with Greece, and fighting political corruption.",211,217,legacy,3,5,8
3WRKFXQBOB8AX4T9BGDO7Y9IKRFIYD,"#29-15 In addition to preventing Bush from gaining the Republican nomination, Martin intends to focus his campaign on protecting the prestige of the New Hampshire Primary and Iowa Caucus, defending the economic legacy of Founding Father Alexander Hamilton, combating political correctness, emphasizing U.S. relations with Greece, and fighting political corruption.",237,255,Alexander Hamilton,0,1,1
3WRKFXQBOB8AX4T9BGDO7Y9IKRFIYD,"#29-15 In addition to preventing Bush from gaining the Republican nomination, Martin intends to focus his campaign on protecting the prestige of the New Hampshire Primary and Iowa Caucus, defending the economic legacy of Founding Father Alexander Hamilton, combating political correctness, emphasizing U.S. relations with Greece, and fighting political corruption.",257,266,combating,2,6,8
3WRKFXQBOB8AX4T9BGDO7Y9IKRFIYD,"#29-15 In addition to preventing Bush from gaining the Republican nomination, Martin intends to focus his campaign on protecting the prestige of the New Hampshire Primary and Iowa Caucus, defending the economic legacy of Founding Father Alexander Hamilton, combating political correctness, emphasizing U.S. relations with Greece, and fighting political corruption.",257,288,combating political correctness,1,1,2
3WRKFXQBOB8AX4T9BGDO7Y9IKRFIYD,"#29-15 In addition to preventing Bush from gaining the Republican nomination, Martin intends to focus his campaign on protecting the prestige of the New Hampshire Primary and Iowa Caucus, defending the economic legacy of Founding Father Alexander Hamilton, combating political correctness, emphasizing U.S. relations with Greece, and fighting political corruption.",267,288,political correctness,1,0,1
3WRKFXQBOB8AX4T9BGDO7Y9IKRFIYD,"#29-15 In addition to preventing Bush from gaining the Republican nomination, Martin intends to focus his campaign on protecting the prestige of the New Hampshire Primary and Iowa Caucus, defending the economic legacy of Founding Father Alexander Hamilton, combating political correctness, emphasizing U.S. relations with Greece, and fighting political corruption.",277,288,correctness,1,0,1
3WRKFXQBOB8AX4T9BGDO7Y9IKRFIYD,"#29-15 In addition to preventing Bush from gaining the Republican nomination, Martin intends to focus his campaign on protecting the prestige of the New Hampshire Primary and Iowa Caucus, defending the economic legacy of Founding Father Alexander Hamilton, combating political correctness, emphasizing U.S. relations with Greece, and fighting political corruption.",290,301,emphasizing,7,5,12
3WRKFXQBOB8AX4T9BGDO7Y9IKRFIYD,"#29-15 In addition to preventing Bush from gaining the Republican nomination, Martin intends to focus his campaign on protecting the prestige of the New Hampshire Primary and Iowa Caucus, defending the economic legacy of Founding Father Alexander Hamilton, combating political correctness, emphasizing U.S. relations with Greece, and fighting political corruption.",307,316,relations,1,0,1
3WRKFXQBOB8AX4T9BGDO7Y9IKRFIYD,"#29-15 In addition to preventing Bush from gaining the Republican nomination, Martin intends to focus his campaign on protecting the prestige of the New Hampshire Primary and Iowa Caucus, defending the economic legacy of Founding Father Alexander Hamilton, combating political correctness, emphasizing U.S. relations with Greece, and fighting political corruption.",343,352,political,1,0,1
3WRKFXQBOB8AX4T9BGDO7Y9IKRFIYD,"#29-15 In addition to preventing Bush from gaining the Republican nomination, Martin intends to focus his campaign on protecting the prestige of the New Hampshire Primary and Iowa Caucus, defending the economic legacy of Founding Father Alexander Hamilton, combating political correctness, emphasizing U.S. relations with Greece, and fighting political corruption.",343,363,political corruption,0,2,2
3WRKFXQBOB8AX4T9BGDO7Y9IKRFIYD,"#29-15 In addition to preventing Bush from gaining the Republican nomination, Martin intends to focus his campaign on protecting the prestige of the New Hampshire Primary and Iowa Caucus, defending the economic legacy of Founding Father Alexander Hamilton, combating political correctness, emphasizing U.S. relations with Greece, and fighting political corruption.",353,363,corruption,4,4,8
3WRKFXQBOB8AX4T9BGDO7Y9IKRFIYD,#29-16 Martin filed paperwork with the Federal Election Commission last month to run for president in 2016 officially.,14,29,filed paperwork,0,1,1
3WRKFXQBOB8AX4T9BGDO7Y9IKRFIYD,#29-16 Martin filed paperwork with the Federal Election Commission last month to run for president in 2016 officially.,20,29,paperwork,0,4,4
3WRKFXQBOB8AX4T9BGDO7Y9IKRFIYD,#29-16 Martin filed paperwork with the Federal Election Commission last month to run for president in 2016 officially.,39,46,Federal,1,0,1
3WRKFXQBOB8AX4T9BGDO7Y9IKRFIYD,#29-16 Martin filed paperwork with the Federal Election Commission last month to run for president in 2016 officially.,81,88,run for,1,0,1
3WRKFXQBOB8AX4T9BGDO7Y9IKRFIYD,#29-16 Martin filed paperwork with the Federal Election Commission last month to run for president in 2016 officially.,107,117,officially,0,1,1
3WRKFXQBOB8AX4T9BGDO7Y9IKRFIYD,#29-17 He joins 139 other Republican Party presidential candidates who have done likewise.,43,55,presidential,1,2,3
3WRKFXQBOB8AX4T9BGDO7Y9IKRFIYD,#29-17 He joins 139 other Republican Party presidential candidates who have done likewise.,43,66,presidential candidates,1,0,1
3WRKFXQBOB8AX4T9BGDO7Y9IKRFIYD,#29-17 He joins 139 other Republican Party presidential candidates who have done likewise.,81,89,likewise,2,4,6
3WRKFXQBOB8AX4T9BGDO7Y9IKRFIYD,"#3-1 Rape-accused Russian political artist Pyotr Pavlensky to seek asylum in France On Monday, controversial Russian political artist Pyotr Pavlensky, currently in Paris, informed media that he and his family are to seek political asylum in France.",5,17,Rape-accused,2,2,4
3WRKFXQBOB8AX4T9BGDO7Y9IKRFIYD,"#3-1 Rape-accused Russian political artist Pyotr Pavlensky to seek asylum in France On Monday, controversial Russian political artist Pyotr Pavlensky, currently in Paris, informed media that he and his family are to seek political asylum in France.",43,58,Pyotr Pavlensky,1,1,2
3WRKFXQBOB8AX4T9BGDO7Y9IKRFIYD,"#3-1 Rape-accused Russian political artist Pyotr Pavlensky to seek asylum in France On Monday, controversial Russian political artist Pyotr Pavlensky, currently in Paris, informed media that he and his family are to seek political asylum in France.",62,73,seek asylum,0,1,1
3WRKFXQBOB8AX4T9BGDO7Y9IKRFIYD,"#3-1 Rape-accused Russian political artist Pyotr Pavlensky to seek asylum in France On Monday, controversial Russian political artist Pyotr Pavlensky, currently in Paris, informed media that he and his family are to seek political asylum in France.",67,73,asylum,5,5,10
3WRKFXQBOB8AX4T9BGDO7Y9IKRFIYD,"#3-1 Rape-accused Russian political artist Pyotr Pavlensky to seek asylum in France On Monday, controversial Russian political artist Pyotr Pavlensky, currently in Paris, informed media that he and his family are to seek political asylum in France.",95,108,controversial,10,8,18
3WRKFXQBOB8AX4T9BGDO7Y9IKRFIYD,"#3-1 Rape-accused Russian political artist Pyotr Pavlensky to seek asylum in France On Monday, controversial Russian political artist Pyotr Pavlensky, currently in Paris, informed media that he and his family are to seek political asylum in France.",117,126,political,1,0,1
3WRKFXQBOB8AX4T9BGDO7Y9IKRFIYD,"#3-1 Rape-accused Russian political artist Pyotr Pavlensky to seek asylum in France On Monday, controversial Russian political artist Pyotr Pavlensky, currently in Paris, informed media that he and his family are to seek political asylum in France.",221,237,political asylum,0,2,2
3WRKFXQBOB8AX4T9BGDO7Y9IKRFIYD,"#3-1 Rape-accused Russian political artist Pyotr Pavlensky to seek asylum in France On Monday, controversial Russian political artist Pyotr Pavlensky, currently in Paris, informed media that he and his family are to seek political asylum in France.",231,237,asylum,6,2,8
3WRKFXQBOB8AX4T9BGDO7Y9IKRFIYD,#3-2 Pavlensky said he and his partner Oksana Shalygina were falsely accused under Section 132 of the Criminal law for rape.,39,55,Oksana Shalygina,0,1,1
3WRKFXQBOB8AX4T9BGDO7Y9IKRFIYD,#3-2 Pavlensky said he and his partner Oksana Shalygina were falsely accused under Section 132 of the Criminal law for rape.,46,55,Shalygina,1,0,1
3WRKFXQBOB8AX4T9BGDO7Y9IKRFIYD,#3-2 Pavlensky said he and his partner Oksana Shalygina were falsely accused under Section 132 of the Criminal law for rape.,61,68,falsely,1,1,2
3WRKFXQBOB8AX4T9BGDO7Y9IKRFIYD,#3-2 Pavlensky said he and his partner Oksana Shalygina were falsely accused under Section 132 of the Criminal law for rape.,61,76,falsely accused,1,1,2
3WRKFXQBOB8AX4T9BGDO7Y9IKRFIYD,#3-2 Pavlensky said he and his partner Oksana Shalygina were falsely accused under Section 132 of the Criminal law for rape.,69,76,accused,1,3,4
3WRKFXQBOB8AX4T9BGDO7Y9IKRFIYD,#3-2 Pavlensky said he and his partner Oksana Shalygina were falsely accused under Section 132 of the Criminal law for rape.,102,110,Criminal,1,0,1
3WRKFXQBOB8AX4T9BGDO7Y9IKRFIYD,#3-2 Pavlensky said he and his partner Oksana Shalygina were falsely accused under Section 132 of the Criminal law for rape.,102,114,Criminal law,0,1,1
3WRKFXQBOB8AX4T9BGDO7Y9IKRFIYD,#3-2 Pavlensky said he and his partner Oksana Shalygina were falsely accused under Section 132 of the Criminal law for rape.,119,123,rape,1,0,1
3VQTAXTYN3MJTNVYV5OIIQZSTDKBUZ,"#15-16 Russian Presidential spokesperson Dmitry Peskov echoed Putin, saying the troops are ""a threat.",15,27,Presidential,1,0,1
3VQTAXTYN3MJTNVYV5OIIQZSTDKBUZ,"#15-16 Russian Presidential spokesperson Dmitry Peskov echoed Putin, saying the troops are ""a threat.",15,40,Presidential spokesperson,1,0,1
3VQTAXTYN3MJTNVYV5OIIQZSTDKBUZ,"#15-16 Russian Presidential spokesperson Dmitry Peskov echoed Putin, saying the troops are ""a threat.",28,40,spokesperson,6,7,13
3VQTAXTYN3MJTNVYV5OIIQZSTDKBUZ,"#15-16 Russian Presidential spokesperson Dmitry Peskov echoed Putin, saying the troops are ""a threat.",41,47,Dmitry,0,1,1
3VQTAXTYN3MJTNVYV5OIIQZSTDKBUZ,"#15-16 Russian Presidential spokesperson Dmitry Peskov echoed Putin, saying the troops are ""a threat.",41,54,Dmitry Peskov,1,1,2
3VQTAXTYN3MJTNVYV5OIIQZSTDKBUZ,"#15-16 Russian Presidential spokesperson Dmitry Peskov echoed Putin, saying the troops are ""a threat.",55,61,echoed,4,6,10
3VQTAXTYN3MJTNVYV5OIIQZSTDKBUZ,"#15-16 Russian Presidential spokesperson Dmitry Peskov echoed Putin, saying the troops are ""a threat.",55,67,echoed Putin,0,1,1
3VQTAXTYN3MJTNVYV5OIIQZSTDKBUZ,"#15-16 Russian Presidential spokesperson Dmitry Peskov echoed Putin, saying the troops are ""a threat.",80,86,troops,0,3,3
3VQTAXTYN3MJTNVYV5OIIQZSTDKBUZ,"#15-16 Russian Presidential spokesperson Dmitry Peskov echoed Putin, saying the troops are ""a threat.",94,100,threat,2,1,3
3VQTAXTYN3MJTNVYV5OIIQZSTDKBUZ,"#15-17 These actions threaten our interests, our security.",21,29,threaten,4,8,12
3VQTAXTYN3MJTNVYV5OIIQZSTDKBUZ,"#15-17 These actions threaten our interests, our security.",21,43,threaten our interests,1,0,1
3VQTAXTYN3MJTNVYV5OIIQZSTDKBUZ,#15-18 Especially as it concerns a third party building up its military presence near our borders.,7,17,Especially,3,0,3
3VQTAXTYN3MJTNVYV5OIIQZSTDKBUZ,#15-18 Especially as it concerns a third party building up its military presence near our borders.,24,32,concerns,1,3,4
3VQTAXTYN3MJTNVYV5OIIQZSTDKBUZ,#15-18 Especially as it concerns a third party building up its military presence near our borders.,35,46,third party,1,0,1
3VQTAXTYN3MJTNVYV5OIIQZSTDKBUZ,#15-18 Especially as it concerns a third party building up its military presence near our borders.,63,71,military,1,0,1
3VQTAXTYN3MJTNVYV5OIIQZSTDKBUZ,#15-18 Especially as it concerns a third party building up its military presence near our borders.,63,80,military presence,2,0,2
3VQTAXTYN3MJTNVYV5OIIQZSTDKBUZ,#15-18 Especially as it concerns a third party building up its military presence near our borders.,72,80,presence,3,1,4
3VQTAXTYN3MJTNVYV5OIIQZSTDKBUZ,#15-18 Especially as it concerns a third party building up its military presence near our borders.,90,97,borders,0,1,1
3VQTAXTYN3MJTNVYV5OIIQZSTDKBUZ,"#15-19 It's [the US], not even a European state.""",33,47,European state,1,0,1
3VQTAXTYN3MJTNVYV5OIIQZSTDKBUZ,#15-20 Ties between Russia and the US are strained.,7,11,Ties,0,2,2
3VQTAXTYN3MJTNVYV5OIIQZSTDKBUZ,#15-20 Ties between Russia and the US are strained.,42,50,strained,4,10,14
3VQTAXTYN3MJTNVYV5OIIQZSTDKBUZ,"#15-21 Last month the US expelled 35 Russian diplomats accused of espionage, and sanctioned Russian intelligence agencies.",25,33,expelled,2,6,8
3VQTAXTYN3MJTNVYV5OIIQZSTDKBUZ,"#15-21 Last month the US expelled 35 Russian diplomats accused of espionage, and sanctioned Russian intelligence agencies.",45,54,diplomats,4,4,8
3VQTAXTYN3MJTNVYV5OIIQZSTDKBUZ,"#15-21 Last month the US expelled 35 Russian diplomats accused of espionage, and sanctioned Russian intelligence agencies.",45,62,diplomats accused,2,0,2
3VQTAXTYN3MJTNVYV5OIIQZSTDKBUZ,"#15-21 Last month the US expelled 35 Russian diplomats accused of espionage, and sanctioned Russian intelligence agencies.",55,62,accused,2,1,3
3VQTAXTYN3MJTNVYV5OIIQZSTDKBUZ,"#15-21 Last month the US expelled 35 Russian diplomats accused of espionage, and sanctioned Russian intelligence agencies.",66,75,espionage,10,10,20
3VQTAXTYN3MJTNVYV5OIIQZSTDKBUZ,"#15-21 Last month the US expelled 35 Russian diplomats accused of espionage, and sanctioned Russian intelligence agencies.",81,91,sanctioned,9,5,14
3VQTAXTYN3MJTNVYV5OIIQZSTDKBUZ,"#15-21 Last month the US expelled 35 Russian diplomats accused of espionage, and sanctioned Russian intelligence agencies.",100,112,intelligence,4,0,4
3VQTAXTYN3MJTNVYV5OIIQZSTDKBUZ,"#15-21 Last month the US expelled 35 Russian diplomats accused of espionage, and sanctioned Russian intelligence agencies.",100,121,intelligence agencies,1,1,2
3VQTAXTYN3MJTNVYV5OIIQZSTDKBUZ,#15-22 This was in response to a CIA report issued two weeks earlier that concluded the Russian government hacked servers belonging to the U.S. Republican and Democratic parties.,19,27,response,0,1,1
3VQTAXTYN3MJTNVYV5OIIQZSTDKBUZ,#15-22 This was in response to a CIA report issued two weeks earlier that concluded the Russian government hacked servers belonging to the U.S. Republican and Democratic parties.,107,113,hacked,5,6,11
3VQTAXTYN3MJTNVYV5OIIQZSTDKBUZ,#15-22 This was in response to a CIA report issued two weeks earlier that concluded the Russian government hacked servers belonging to the U.S. Republican and Democratic parties.,107,121,hacked servers,0,1,1
3VQTAXTYN3MJTNVYV5OIIQZSTDKBUZ,#15-22 This was in response to a CIA report issued two weeks earlier that concluded the Russian government hacked servers belonging to the U.S. Republican and Democratic parties.,114,121,servers,1,0,1
3VQTAXTYN3MJTNVYV5OIIQZSTDKBUZ,#15-22 This was in response to a CIA report issued two weeks earlier that concluded the Russian government hacked servers belonging to the U.S. Republican and Democratic parties.,144,154,Republican,1,1,2
3VQTAXTYN3MJTNVYV5OIIQZSTDKBUZ,#15-22 This was in response to a CIA report issued two weeks earlier that concluded the Russian government hacked servers belonging to the U.S. Republican and Democratic parties.,159,177,Democratic parties,0,1,1
3VQTAXTYN3MJTNVYV5OIIQZSTDKBUZ,#15-23 The CIA report said this was to turn the 2016 presidential election toward president-elect Donald Trump.,53,65,presidential,0,1,1
3VQTAXTYN3MJTNVYV5OIIQZSTDKBUZ,#15-23 The CIA report said this was to turn the 2016 presidential election toward president-elect Donald Trump.,82,97,president-elect,2,0,2
3VQTAXTYN3MJTNVYV5OIIQZSTDKBUZ,#15-23 The CIA report said this was to turn the 2016 presidential election toward president-elect Donald Trump.,82,104,president-elect Donald,0,1,1
3VQTAXTYN3MJTNVYV5OIIQZSTDKBUZ,"#15-24 Since Szydło took office in 2015, Poland has also suffered a decline in relations with Russia.",13,19,Szydło,1,2,3
3VQTAXTYN3MJTNVYV5OIIQZSTDKBUZ,"#15-24 Since Szydło took office in 2015, Poland has also suffered a decline in relations with Russia.",41,47,Poland,0,1,1
3VQTAXTYN3MJTNVYV5OIIQZSTDKBUZ,"#15-24 Since Szydło took office in 2015, Poland has also suffered a decline in relations with Russia.",57,65,suffered,5,3,8
3VQTAXTYN3MJTNVYV5OIIQZSTDKBUZ,"#15-24 Since Szydło took office in 2015, Poland has also suffered a decline in relations with Russia.",57,75,suffered a decline,0,1,1
3VQTAXTYN3MJTNVYV5OIIQZSTDKBUZ,"#15-24 Since Szydło took office in 2015, Poland has also suffered a decline in relations with Russia.",68,75,decline,4,4,8
36AZSFEYZ41J62KY0VYNEC1B7KTBVO,"#17-9 [...] Of course, the opinion’s showy profundities are often profoundly incoherent.""",27,36,opinion’s,1,0,1
36AZSFEYZ41J62KY0VYNEC1B7KTBVO,"#17-9 [...] Of course, the opinion’s showy profundities are often profoundly incoherent.""",37,42,showy,0,2,2
36AZSFEYZ41J62KY0VYNEC1B7KTBVO,"#17-9 [...] Of course, the opinion’s showy profundities are often profoundly incoherent.""",37,55,showy profundities,1,0,1
36AZSFEYZ41J62KY0VYNEC1B7KTBVO,"#17-9 [...] Of course, the opinion’s showy profundities are often profoundly incoherent.""",43,55,profundities,10,10,20
36AZSFEYZ41J62KY0VYNEC1B7KTBVO,"#17-9 [...] Of course, the opinion’s showy profundities are often profoundly incoherent.""",66,76,profoundly,1,3,4
36AZSFEYZ41J62KY0VYNEC1B7KTBVO,"#17-9 [...] Of course, the opinion’s showy profundities are often profoundly incoherent.""",66,87,profoundly incoherent,10,3,13
36AZSFEYZ41J62KY0VYNEC1B7KTBVO,"#17-9 [...] Of course, the opinion’s showy profundities are often profoundly incoherent.""",77,87,incoherent,5,8,13
36AZSFEYZ41J62KY0VYNEC1B7KTBVO,"#17-10 When the decision was made, police allowed people outside the court to wave the rainbow flag on the court plaza.",16,24,decision,1,0,1
36AZSFEYZ41J62KY0VYNEC1B7KTBVO,"#17-10 When the decision was made, police allowed people outside the court to wave the rainbow flag on the court plaza.",78,82,wave,0,1,1
36AZSFEYZ41J62KY0VYNEC1B7KTBVO,"#17-10 When the decision was made, police allowed people outside the court to wave the rainbow flag on the court plaza.",87,99,rainbow flag,0,1,1
36AZSFEYZ41J62KY0VYNEC1B7KTBVO,"#17-10 When the decision was made, police allowed people outside the court to wave the rainbow flag on the court plaza.",107,112,court,0,1,1
36AZSFEYZ41J62KY0VYNEC1B7KTBVO,"#17-10 When the decision was made, police allowed people outside the court to wave the rainbow flag on the court plaza.",107,118,court plaza,1,0,1
36AZSFEYZ41J62KY0VYNEC1B7KTBVO,"#17-10 When the decision was made, police allowed people outside the court to wave the rainbow flag on the court plaza.",113,118,plaza,1,0,1
36AZSFEYZ41J62KY0VYNEC1B7KTBVO,"#17-11 Demonstrators outside the court chanted ""Love has won"".",7,20,Demonstrators,10,4,14
36AZSFEYZ41J62KY0VYNEC1B7KTBVO,"#17-11 Demonstrators outside the court chanted ""Love has won"".",33,38,court,0,1,1
36AZSFEYZ41J62KY0VYNEC1B7KTBVO,"#17-11 Demonstrators outside the court chanted ""Love has won"".",39,46,chanted,1,5,6
36AZSFEYZ41J62KY0VYNEC1B7KTBVO,#17-12 This decision made the United States the 21st country to legalise same-sex marriage.,64,72,legalise,10,4,14
36AZSFEYZ41J62KY0VYNEC1B7KTBVO,#17-12 This decision made the United States the 21st country to legalise same-sex marriage.,64,81,legalise same-sex,1,0,1
36AZSFEYZ41J62KY0VYNEC1B7KTBVO,#17-12 This decision made the United States the 21st country to legalise same-sex marriage.,73,90,same-sex marriage,2,0,2
36AZSFEYZ41J62KY0VYNEC1B7KTBVO,#17-12 This decision made the United States the 21st country to legalise same-sex marriage.,82,90,marriage,1,0,1
36AZSFEYZ41J62KY0VYNEC1B7KTBVO,"#17-13 President Barack Obama responded to the decision: ""Today we can say, in no uncertain terms, that we have made our union a little more perfect.""",30,39,responded,1,2,3
36AZSFEYZ41J62KY0VYNEC1B7KTBVO,"#17-13 President Barack Obama responded to the decision: ""Today we can say, in no uncertain terms, that we have made our union a little more perfect.""",47,55,decision,1,0,1
36AZSFEYZ41J62KY0VYNEC1B7KTBVO,"#17-13 President Barack Obama responded to the decision: ""Today we can say, in no uncertain terms, that we have made our union a little more perfect.""",82,91,uncertain,3,2,5
36AZSFEYZ41J62KY0VYNEC1B7KTBVO,"#17-13 President Barack Obama responded to the decision: ""Today we can say, in no uncertain terms, that we have made our union a little more perfect.""",82,97,uncertain terms,0,1,1
36AZSFEYZ41J62KY0VYNEC1B7KTBVO,"#17-13 President Barack Obama responded to the decision: ""Today we can say, in no uncertain terms, that we have made our union a little more perfect.""",121,126,union,1,0,1
36AZSFEYZ41J62KY0VYNEC1B7KTBVO,"#17-14 After this decision, Facebook introduced a new tool to add rainbow coloring to one's profile picture to celebrate this victory.",37,47,introduced,0,1,1
36AZSFEYZ41J62KY0VYNEC1B7KTBVO,"#17-14 After this decision, Facebook introduced a new tool to add rainbow coloring to one's profile picture to celebrate this victory.",92,99,profile,1,1,2
36AZSFEYZ41J62KY0VYNEC1B7KTBVO,"#17-14 After this decision, Facebook introduced a new tool to add rainbow coloring to one's profile picture to celebrate this victory.",92,107,profile picture,1,0,1
36AZSFEYZ41J62KY0VYNEC1B7KTBVO,"#17-14 After this decision, Facebook introduced a new tool to add rainbow coloring to one's profile picture to celebrate this victory.",126,133,victory,2,0,2
36AZSFEYZ41J62KY0VYNEC1B7KTBVO,"#17-15 Mark Zuckerberg posted on Facebook ""I'm so happy for all of my friends and everyone in our community who can finally celebrate their love and be recognized as equal couples under the law"".",12,22,Zuckerberg,1,0,1
36AZSFEYZ41J62KY0VYNEC1B7KTBVO,"#17-15 Mark Zuckerberg posted on Facebook ""I'm so happy for all of my friends and everyone in our community who can finally celebrate their love and be recognized as equal couples under the law"".",98,107,community,4,1,5
36AZSFEYZ41J62KY0VYNEC1B7KTBVO,"#17-15 Mark Zuckerberg posted on Facebook ""I'm so happy for all of my friends and everyone in our community who can finally celebrate their love and be recognized as equal couples under the law"".",152,162,recognized,10,2,12
36AZSFEYZ41J62KY0VYNEC1B7KTBVO,"#17-15 Mark Zuckerberg posted on Facebook ""I'm so happy for all of my friends and everyone in our community who can finally celebrate their love and be recognized as equal couples under the law"".",166,179,equal couples,1,0,1
32CAVSKPCEQIGPD6T8VTCEMJ71T1U6,"#23-2 Everson argues his exclusion violates Title 11 of the U.S. Code of Federal Regulations in that debate hosts must not ""structure the debates to promote or advance one candidate over another"", and must ""use pre-established objective criteria to determine which candidates may participate in a debate.""",14,20,argues,2,3,5
32CAVSKPCEQIGPD6T8VTCEMJ71T1U6,"#23-2 Everson argues his exclusion violates Title 11 of the U.S. Code of Federal Regulations in that debate hosts must not ""structure the debates to promote or advance one candidate over another"", and must ""use pre-established objective criteria to determine which candidates may participate in a debate.""",21,34,his exclusion,1,0,1
32CAVSKPCEQIGPD6T8VTCEMJ71T1U6,"#23-2 Everson argues his exclusion violates Title 11 of the U.S. Code of Federal Regulations in that debate hosts must not ""structure the debates to promote or advance one candidate over another"", and must ""use pre-established objective criteria to determine which candidates may participate in a debate.""",25,34,exclusion,8,6,14
32CAVSKPCEQIGPD6T8VTCEMJ71T1U6,"#23-2 Everson argues his exclusion violates Title 11 of the U.S. Code of Federal Regulations in that debate hosts must not ""structure the debates to promote or advance one candidate over another"", and must ""use pre-established objective criteria to determine which candidates may participate in a debate.""",25,43,exclusion violates,1,1,2
32CAVSKPCEQIGPD6T8VTCEMJ71T1U6,"#23-2 Everson argues his exclusion violates Title 11 of the U.S. Code of Federal Regulations in that debate hosts must not ""structure the debates to promote or advance one candidate over another"", and must ""use pre-established objective criteria to determine which candidates may participate in a debate.""",35,43,violates,3,2,5
32CAVSKPCEQIGPD6T8VTCEMJ71T1U6,"#23-2 Everson argues his exclusion violates Title 11 of the U.S. Code of Federal Regulations in that debate hosts must not ""structure the debates to promote or advance one candidate over another"", and must ""use pre-established objective criteria to determine which candidates may participate in a debate.""",60,92,U.S. Code of Federal Regulations,1,0,1
32CAVSKPCEQIGPD6T8VTCEMJ71T1U6,"#23-2 Everson argues his exclusion violates Title 11 of the U.S. Code of Federal Regulations in that debate hosts must not ""structure the debates to promote or advance one candidate over another"", and must ""use pre-established objective criteria to determine which candidates may participate in a debate.""",73,80,Federal,0,1,1
32CAVSKPCEQIGPD6T8VTCEMJ71T1U6,"#23-2 Everson argues his exclusion violates Title 11 of the U.S. Code of Federal Regulations in that debate hosts must not ""structure the debates to promote or advance one candidate over another"", and must ""use pre-established objective criteria to determine which candidates may participate in a debate.""",73,92,Federal Regulations,0,1,1
32CAVSKPCEQIGPD6T8VTCEMJ71T1U6,"#23-2 Everson argues his exclusion violates Title 11 of the U.S. Code of Federal Regulations in that debate hosts must not ""structure the debates to promote or advance one candidate over another"", and must ""use pre-established objective criteria to determine which candidates may participate in a debate.""",81,92,Regulations,1,1,2
32CAVSKPCEQIGPD6T8VTCEMJ71T1U6,"#23-2 Everson argues his exclusion violates Title 11 of the U.S. Code of Federal Regulations in that debate hosts must not ""structure the debates to promote or advance one candidate over another"", and must ""use pre-established objective criteria to determine which candidates may participate in a debate.""",101,107,debate,1,2,3
32CAVSKPCEQIGPD6T8VTCEMJ71T1U6,"#23-2 Everson argues his exclusion violates Title 11 of the U.S. Code of Federal Regulations in that debate hosts must not ""structure the debates to promote or advance one candidate over another"", and must ""use pre-established objective criteria to determine which candidates may participate in a debate.""",124,133,structure,0,2,2
32CAVSKPCEQIGPD6T8VTCEMJ71T1U6,"#23-2 Everson argues his exclusion violates Title 11 of the U.S. Code of Federal Regulations in that debate hosts must not ""structure the debates to promote or advance one candidate over another"", and must ""use pre-established objective criteria to determine which candidates may participate in a debate.""",138,145,debates,1,0,1
32CAVSKPCEQIGPD6T8VTCEMJ71T1U6,"#23-2 Everson argues his exclusion violates Title 11 of the U.S. Code of Federal Regulations in that debate hosts must not ""structure the debates to promote or advance one candidate over another"", and must ""use pre-established objective criteria to determine which candidates may participate in a debate.""",149,156,promote,1,0,1
32CAVSKPCEQIGPD6T8VTCEMJ71T1U6,"#23-2 Everson argues his exclusion violates Title 11 of the U.S. Code of Federal Regulations in that debate hosts must not ""structure the debates to promote or advance one candidate over another"", and must ""use pre-established objective criteria to determine which candidates may participate in a debate.""",160,167,advance,0,1,1
32CAVSKPCEQIGPD6T8VTCEMJ71T1U6,"#23-2 Everson argues his exclusion violates Title 11 of the U.S. Code of Federal Regulations in that debate hosts must not ""structure the debates to promote or advance one candidate over another"", and must ""use pre-established objective criteria to determine which candidates may participate in a debate.""",160,194,advance one candidate over another,1,0,1
32CAVSKPCEQIGPD6T8VTCEMJ71T1U6,"#23-2 Everson argues his exclusion violates Title 11 of the U.S. Code of Federal Regulations in that debate hosts must not ""structure the debates to promote or advance one candidate over another"", and must ""use pre-established objective criteria to determine which candidates may participate in a debate.""",172,181,candidate,2,0,2
32CAVSKPCEQIGPD6T8VTCEMJ71T1U6,"#23-2 Everson argues his exclusion violates Title 11 of the U.S. Code of Federal Regulations in that debate hosts must not ""structure the debates to promote or advance one candidate over another"", and must ""use pre-established objective criteria to determine which candidates may participate in a debate.""",211,226,pre-established,3,3,6
32CAVSKPCEQIGPD6T8VTCEMJ71T1U6,"#23-2 Everson argues his exclusion violates Title 11 of the U.S. Code of Federal Regulations in that debate hosts must not ""structure the debates to promote or advance one candidate over another"", and must ""use pre-established objective criteria to determine which candidates may participate in a debate.""",211,245,pre-established objective criteria,3,0,3
32CAVSKPCEQIGPD6T8VTCEMJ71T1U6,"#23-2 Everson argues his exclusion violates Title 11 of the U.S. Code of Federal Regulations in that debate hosts must not ""structure the debates to promote or advance one candidate over another"", and must ""use pre-established objective criteria to determine which candidates may participate in a debate.""",227,236,objective,1,2,3
32CAVSKPCEQIGPD6T8VTCEMJ71T1U6,"#23-2 Everson argues his exclusion violates Title 11 of the U.S. Code of Federal Regulations in that debate hosts must not ""structure the debates to promote or advance one candidate over another"", and must ""use pre-established objective criteria to determine which candidates may participate in a debate.""",227,245,objective criteria,1,2,3
32CAVSKPCEQIGPD6T8VTCEMJ71T1U6,"#23-2 Everson argues his exclusion violates Title 11 of the U.S. Code of Federal Regulations in that debate hosts must not ""structure the debates to promote or advance one candidate over another"", and must ""use pre-established objective criteria to determine which candidates may participate in a debate.""",237,245,criteria,4,4,8
32CAVSKPCEQIGPD6T8VTCEMJ71T1U6,"#23-2 Everson argues his exclusion violates Title 11 of the U.S. Code of Federal Regulations in that debate hosts must not ""structure the debates to promote or advance one candidate over another"", and must ""use pre-established objective criteria to determine which candidates may participate in a debate.""",249,258,determine,1,1,2
32CAVSKPCEQIGPD6T8VTCEMJ71T1U6,"#23-2 Everson argues his exclusion violates Title 11 of the U.S. Code of Federal Regulations in that debate hosts must not ""structure the debates to promote or advance one candidate over another"", and must ""use pre-established objective criteria to determine which candidates may participate in a debate.""",265,275,candidates,1,0,1
32CAVSKPCEQIGPD6T8VTCEMJ71T1U6,"#23-2 Everson argues his exclusion violates Title 11 of the U.S. Code of Federal Regulations in that debate hosts must not ""structure the debates to promote or advance one candidate over another"", and must ""use pre-established objective criteria to determine which candidates may participate in a debate.""",280,291,participate,1,1,2
32CAVSKPCEQIGPD6T8VTCEMJ71T1U6,"#23-2 Everson argues his exclusion violates Title 11 of the U.S. Code of Federal Regulations in that debate hosts must not ""structure the debates to promote or advance one candidate over another"", and must ""use pre-established objective criteria to determine which candidates may participate in a debate.""",297,303,debate,0,1,1
32CAVSKPCEQIGPD6T8VTCEMJ71T1U6,"#23-3 Everson served as Commissioner of the IRS from 2003 to 2007, during the George W. Bush administration.",24,36,Commissioner,2,1,3
32CAVSKPCEQIGPD6T8VTCEMJ71T1U6,"#23-3 Everson served as Commissioner of the IRS from 2003 to 2007, during the George W. Bush administration.",44,47,IRS,1,0,1
32CAVSKPCEQIGPD6T8VTCEMJ71T1U6,"#23-3 Everson served as Commissioner of the IRS from 2003 to 2007, during the George W. Bush administration.",93,107,administration,4,1,5
32CAVSKPCEQIGPD6T8VTCEMJ71T1U6,"#23-4 After his departure, he briefly served as CEO of the American Red Cross, worked in the cabinet of Indiana governor Mitch Daniels, and worked for the tax consulting firm alliantgroup.",16,25,departure,2,3,5
32CAVSKPCEQIGPD6T8VTCEMJ71T1U6,"#23-4 After his departure, he briefly served as CEO of the American Red Cross, worked in the cabinet of Indiana governor Mitch Daniels, and worked for the tax consulting firm alliantgroup.",93,100,cabinet,2,0,2
32CAVSKPCEQIGPD6T8VTCEMJ71T1U6,"#23-4 After his departure, he briefly served as CEO of the American Red Cross, worked in the cabinet of Indiana governor Mitch Daniels, and worked for the tax consulting firm alliantgroup.",112,120,governor,1,0,1
32CAVSKPCEQIGPD6T8VTCEMJ71T1U6,"#23-4 After his departure, he briefly served as CEO of the American Red Cross, worked in the cabinet of Indiana governor Mitch Daniels, and worked for the tax consulting firm alliantgroup.",121,134,Mitch Daniels,0,1,1
32CAVSKPCEQIGPD6T8VTCEMJ71T1U6,"#23-4 After his departure, he briefly served as CEO of the American Red Cross, worked in the cabinet of Indiana governor Mitch Daniels, and worked for the tax consulting firm alliantgroup.",155,169,tax consulting,1,1,2
32CAVSKPCEQIGPD6T8VTCEMJ71T1U6,"#23-4 After his departure, he briefly served as CEO of the American Red Cross, worked in the cabinet of Indiana governor Mitch Daniels, and worked for the tax consulting firm alliantgroup.",159,169,consulting,3,1,4
32CAVSKPCEQIGPD6T8VTCEMJ71T1U6,"#23-4 After his departure, he briefly served as CEO of the American Red Cross, worked in the cabinet of Indiana governor Mitch Daniels, and worked for the tax consulting firm alliantgroup.",170,174,firm,0,1,1
32CAVSKPCEQIGPD6T8VTCEMJ71T1U6,"#23-4 After his departure, he briefly served as CEO of the American Red Cross, worked in the cabinet of Indiana governor Mitch Daniels, and worked for the tax consulting firm alliantgroup.",175,187,alliantgroup,6,5,11
32CAVSKPCEQIGPD6T8VTCEMJ71T1U6,"#23-5 He announced his candidacy this past March with a sixteen-page open letter in which he outlined the six pillars of his campaign: amnesty for illegal immigrants, reinstatement of the military draft, a promise to serve only a single presidential term, and calls for tax reform, deficit reduction, and corporate responsibility.",9,18,announced,2,1,3
32CAVSKPCEQIGPD6T8VTCEMJ71T1U6,"#23-5 He announced his candidacy this past March with a sixteen-page open letter in which he outlined the six pillars of his campaign: amnesty for illegal immigrants, reinstatement of the military draft, a promise to serve only a single presidential term, and calls for tax reform, deficit reduction, and corporate responsibility.",23,32,candidacy,6,5,11
32CAVSKPCEQIGPD6T8VTCEMJ71T1U6,"#23-5 He announced his candidacy this past March with a sixteen-page open letter in which he outlined the six pillars of his campaign: amnesty for illegal immigrants, reinstatement of the military draft, a promise to serve only a single presidential term, and calls for tax reform, deficit reduction, and corporate responsibility.",93,101,outlined,0,3,3
32CAVSKPCEQIGPD6T8VTCEMJ71T1U6,"#23-5 He announced his candidacy this past March with a sixteen-page open letter in which he outlined the six pillars of his campaign: amnesty for illegal immigrants, reinstatement of the military draft, a promise to serve only a single presidential term, and calls for tax reform, deficit reduction, and corporate responsibility.",110,117,pillars,2,2,4
32CAVSKPCEQIGPD6T8VTCEMJ71T1U6,"#23-5 He announced his candidacy this past March with a sixteen-page open letter in which he outlined the six pillars of his campaign: amnesty for illegal immigrants, reinstatement of the military draft, a promise to serve only a single presidential term, and calls for tax reform, deficit reduction, and corporate responsibility.",125,133,campaign,1,0,1
32CAVSKPCEQIGPD6T8VTCEMJ71T1U6,"#23-5 He announced his candidacy this past March with a sixteen-page open letter in which he outlined the six pillars of his campaign: amnesty for illegal immigrants, reinstatement of the military draft, a promise to serve only a single presidential term, and calls for tax reform, deficit reduction, and corporate responsibility.",135,142,amnesty,10,3,13
32CAVSKPCEQIGPD6T8VTCEMJ71T1U6,"#23-5 He announced his candidacy this past March with a sixteen-page open letter in which he outlined the six pillars of his campaign: amnesty for illegal immigrants, reinstatement of the military draft, a promise to serve only a single presidential term, and calls for tax reform, deficit reduction, and corporate responsibility.",135,165,amnesty for illegal immigrants,2,1,3
32CAVSKPCEQIGPD6T8VTCEMJ71T1U6,"#23-5 He announced his candidacy this past March with a sixteen-page open letter in which he outlined the six pillars of his campaign: amnesty for illegal immigrants, reinstatement of the military draft, a promise to serve only a single presidential term, and calls for tax reform, deficit reduction, and corporate responsibility.",147,165,illegal immigrants,0,1,1
32CAVSKPCEQIGPD6T8VTCEMJ71T1U6,"#23-5 He announced his candidacy this past March with a sixteen-page open letter in which he outlined the six pillars of his campaign: amnesty for illegal immigrants, reinstatement of the military draft, a promise to serve only a single presidential term, and calls for tax reform, deficit reduction, and corporate responsibility.",155,165,immigrants,2,4,6
32CAVSKPCEQIGPD6T8VTCEMJ71T1U6,"#23-5 He announced his candidacy this past March with a sixteen-page open letter in which he outlined the six pillars of his campaign: amnesty for illegal immigrants, reinstatement of the military draft, a promise to serve only a single presidential term, and calls for tax reform, deficit reduction, and corporate responsibility.",167,180,reinstatement,7,10,17
32CAVSKPCEQIGPD6T8VTCEMJ71T1U6,"#23-5 He announced his candidacy this past March with a sixteen-page open letter in which he outlined the six pillars of his campaign: amnesty for illegal immigrants, reinstatement of the military draft, a promise to serve only a single presidential term, and calls for tax reform, deficit reduction, and corporate responsibility.",167,202,reinstatement of the military draft,1,1,2
32CAVSKPCEQIGPD6T8VTCEMJ71T1U6,"#23-5 He announced his candidacy this past March with a sixteen-page open letter in which he outlined the six pillars of his campaign: amnesty for illegal immigrants, reinstatement of the military draft, a promise to serve only a single presidential term, and calls for tax reform, deficit reduction, and corporate responsibility.",197,202,draft,0,3,3
32CAVSKPCEQIGPD6T8VTCEMJ71T1U6,"#23-5 He announced his candidacy this past March with a sixteen-page open letter in which he outlined the six pillars of his campaign: amnesty for illegal immigrants, reinstatement of the military draft, a promise to serve only a single presidential term, and calls for tax reform, deficit reduction, and corporate responsibility.",237,249,presidential,0,1,1
32CAVSKPCEQIGPD6T8VTCEMJ71T1U6,"#23-5 He announced his candidacy this past March with a sixteen-page open letter in which he outlined the six pillars of his campaign: amnesty for illegal immigrants, reinstatement of the military draft, a promise to serve only a single presidential term, and calls for tax reform, deficit reduction, and corporate responsibility.",270,280,tax reform,0,1,1
32CAVSKPCEQIGPD6T8VTCEMJ71T1U6,"#23-5 He announced his candidacy this past March with a sixteen-page open letter in which he outlined the six pillars of his campaign: amnesty for illegal immigrants, reinstatement of the military draft, a promise to serve only a single presidential term, and calls for tax reform, deficit reduction, and corporate responsibility.",274,280,reform,0,1,1
32CAVSKPCEQIGPD6T8VTCEMJ71T1U6,"#23-5 He announced his candidacy this past March with a sixteen-page open letter in which he outlined the six pillars of his campaign: amnesty for illegal immigrants, reinstatement of the military draft, a promise to serve only a single presidential term, and calls for tax reform, deficit reduction, and corporate responsibility.",282,289,deficit,6,4,10
32CAVSKPCEQIGPD6T8VTCEMJ71T1U6,"#23-5 He announced his candidacy this past March with a sixteen-page open letter in which he outlined the six pillars of his campaign: amnesty for illegal immigrants, reinstatement of the military draft, a promise to serve only a single presidential term, and calls for tax reform, deficit reduction, and corporate responsibility.",282,299,deficit reduction,2,1,3
32CAVSKPCEQIGPD6T8VTCEMJ71T1U6,"#23-5 He announced his candidacy this past March with a sixteen-page open letter in which he outlined the six pillars of his campaign: amnesty for illegal immigrants, reinstatement of the military draft, a promise to serve only a single presidential term, and calls for tax reform, deficit reduction, and corporate responsibility.",305,314,corporate,1,1,2
32CAVSKPCEQIGPD6T8VTCEMJ71T1U6,"#23-5 He announced his candidacy this past March with a sixteen-page open letter in which he outlined the six pillars of his campaign: amnesty for illegal immigrants, reinstatement of the military draft, a promise to serve only a single presidential term, and calls for tax reform, deficit reduction, and corporate responsibility.",315,329,responsibility,0,1,1
32W3UF2EZOM3MUTPUZTVG67GCLW4CC,"#31-2 The shrine is a popular attraction in Thailand's capital, where at least 20 people, including at least eight foreigners, are reported dead with upwards of 100 injured.",10,16,shrine,6,9,15
32W3UF2EZOM3MUTPUZTVG67GCLW4CC,"#31-2 The shrine is a popular attraction in Thailand's capital, where at least 20 people, including at least eight foreigners, are reported dead with upwards of 100 injured.",22,40,popular attraction,1,1,2
32W3UF2EZOM3MUTPUZTVG67GCLW4CC,"#31-2 The shrine is a popular attraction in Thailand's capital, where at least 20 people, including at least eight foreigners, are reported dead with upwards of 100 injured.",30,40,attraction,3,2,5
32W3UF2EZOM3MUTPUZTVG67GCLW4CC,"#31-2 The shrine is a popular attraction in Thailand's capital, where at least 20 people, including at least eight foreigners, are reported dead with upwards of 100 injured.",44,61,Thailands capital,0,1,1
32W3UF2EZOM3MUTPUZTVG67GCLW4CC,"#31-2 The shrine is a popular attraction in Thailand's capital, where at least 20 people, including at least eight foreigners, are reported dead with upwards of 100 injured.",90,99,including,0,2,2
32W3UF2EZOM3MUTPUZTVG67GCLW4CC,"#31-2 The shrine is a popular attraction in Thailand's capital, where at least 20 people, including at least eight foreigners, are reported dead with upwards of 100 injured.",115,125,foreigners,4,2,6
32W3UF2EZOM3MUTPUZTVG67GCLW4CC,"#31-2 The shrine is a popular attraction in Thailand's capital, where at least 20 people, including at least eight foreigners, are reported dead with upwards of 100 injured.",131,139,reported,0,2,2
32W3UF2EZOM3MUTPUZTVG67GCLW4CC,"#31-2 The shrine is a popular attraction in Thailand's capital, where at least 20 people, including at least eight foreigners, are reported dead with upwards of 100 injured.",150,157,upwards,0,2,2
32W3UF2EZOM3MUTPUZTVG67GCLW4CC,"#31-2 The shrine is a popular attraction in Thailand's capital, where at least 20 people, including at least eight foreigners, are reported dead with upwards of 100 injured.",165,172,injured,0,1,1
32W3UF2EZOM3MUTPUZTVG67GCLW4CC,"#31-3 The blast occurred at approximately 7pm on Monday local time (1200 UTC), when central Bangkok was flooded with pedestrian activity.",10,15,blast,0,2,2
32W3UF2EZOM3MUTPUZTVG67GCLW4CC,"#31-3 The blast occurred at approximately 7pm on Monday local time (1200 UTC), when central Bangkok was flooded with pedestrian activity.",10,24,blast occurred,1,0,1
32W3UF2EZOM3MUTPUZTVG67GCLW4CC,"#31-3 The blast occurred at approximately 7pm on Monday local time (1200 UTC), when central Bangkok was flooded with pedestrian activity.",16,24,occurred,1,1,2
32W3UF2EZOM3MUTPUZTVG67GCLW4CC,"#31-3 The blast occurred at approximately 7pm on Monday local time (1200 UTC), when central Bangkok was flooded with pedestrian activity.",28,41,approximately,8,3,11
32W3UF2EZOM3MUTPUZTVG67GCLW4CC,"#31-3 The blast occurred at approximately 7pm on Monday local time (1200 UTC), when central Bangkok was flooded with pedestrian activity.",92,99,Bangkok,0,1,1
32W3UF2EZOM3MUTPUZTVG67GCLW4CC,"#31-3 The blast occurred at approximately 7pm on Monday local time (1200 UTC), when central Bangkok was flooded with pedestrian activity.",104,111,flooded,2,5,7
32W3UF2EZOM3MUTPUZTVG67GCLW4CC,"#31-3 The blast occurred at approximately 7pm on Monday local time (1200 UTC), when central Bangkok was flooded with pedestrian activity.",117,127,pedestrian,8,9,17
32W3UF2EZOM3MUTPUZTVG67GCLW4CC,"#31-3 The blast occurred at approximately 7pm on Monday local time (1200 UTC), when central Bangkok was flooded with pedestrian activity.",117,136,pedestrian activity,1,1,2
32W3UF2EZOM3MUTPUZTVG67GCLW4CC,#31-4 Authorities say the suspect may have already left Thailand and was assisted by others.,6,17,Authorities,1,2,3
32W3UF2EZOM3MUTPUZTVG67GCLW4CC,#31-4 Authorities say the suspect may have already left Thailand and was assisted by others.,26,33,suspect,2,1,3
32W3UF2EZOM3MUTPUZTVG67GCLW4CC,#31-4 Authorities say the suspect may have already left Thailand and was assisted by others.,73,81,assisted,1,0,1
32W3UF2EZOM3MUTPUZTVG67GCLW4CC,"#31-5 Following months of political unrest, since the explosion the Thai baht hit a six year low.",26,42,political unrest,2,1,3
32W3UF2EZOM3MUTPUZTVG67GCLW4CC,"#31-5 Following months of political unrest, since the explosion the Thai baht hit a six year low.",36,42,unrest,1,7,8
32W3UF2EZOM3MUTPUZTVG67GCLW4CC,"#31-5 Following months of political unrest, since the explosion the Thai baht hit a six year low.",54,63,explosion,4,2,6
32W3UF2EZOM3MUTPUZTVG67GCLW4CC,"#31-5 Following months of political unrest, since the explosion the Thai baht hit a six year low.",68,77,Thai baht,1,1,2
32W3UF2EZOM3MUTPUZTVG67GCLW4CC,"#31-5 Following months of political unrest, since the explosion the Thai baht hit a six year low.",68,81,Thai baht hit,1,0,1
32W3UF2EZOM3MUTPUZTVG67GCLW4CC,"#31-5 Following months of political unrest, since the explosion the Thai baht hit a six year low.",73,77,baht,1,2,3
32W3UF2EZOM3MUTPUZTVG67GCLW4CC,"#31-6 According to Defence Minister Prawit Wonguwan speaking to Reuters, the bombing was a deliberate attack on the country's economy and tourism industry.",19,26,Defence,1,1,2
32W3UF2EZOM3MUTPUZTVG67GCLW4CC,"#31-6 According to Defence Minister Prawit Wonguwan speaking to Reuters, the bombing was a deliberate attack on the country's economy and tourism industry.",19,35,Defence Minister,1,0,1
32W3UF2EZOM3MUTPUZTVG67GCLW4CC,"#31-6 According to Defence Minister Prawit Wonguwan speaking to Reuters, the bombing was a deliberate attack on the country's economy and tourism industry.",36,51,Prawit Wonguwan,0,2,2
32W3UF2EZOM3MUTPUZTVG67GCLW4CC,"#31-6 According to Defence Minister Prawit Wonguwan speaking to Reuters, the bombing was a deliberate attack on the country's economy and tourism industry.",64,71,Reuters,0,2,2
32W3UF2EZOM3MUTPUZTVG67GCLW4CC,"#31-6 According to Defence Minister Prawit Wonguwan speaking to Reuters, the bombing was a deliberate attack on the country's economy and tourism industry.",89,101,a deliberate,1,0,1
32W3UF2EZOM3MUTPUZTVG67GCLW4CC,"#31-6 According to Defence Minister Prawit Wonguwan speaking to Reuters, the bombing was a deliberate attack on the country's economy and tourism industry.",91,101,deliberate,9,8,17
32W3UF2EZOM3MUTPUZTVG67GCLW4CC,"#31-6 According to Defence Minister Prawit Wonguwan speaking to Reuters, the bombing was a deliberate attack on the country's economy and tourism industry.",91,108,deliberate attack,1,0,1
32W3UF2EZOM3MUTPUZTVG67GCLW4CC,"#31-6 According to Defence Minister Prawit Wonguwan speaking to Reuters, the bombing was a deliberate attack on the country's economy and tourism industry.",126,133,economy,2,0,2
32W3UF2EZOM3MUTPUZTVG67GCLW4CC,"#31-6 According to Defence Minister Prawit Wonguwan speaking to Reuters, the bombing was a deliberate attack on the country's economy and tourism industry.",138,145,tourism,1,0,1
32W3UF2EZOM3MUTPUZTVG67GCLW4CC,"#31-6 According to Defence Minister Prawit Wonguwan speaking to Reuters, the bombing was a deliberate attack on the country's economy and tourism industry.",138,154,tourism industry,1,0,1
32W3UF2EZOM3MUTPUZTVG67GCLW4CC,#31-7 Military authorities said Muslim insurgents from the country's southern provinces are unlikely to be behind the attack.,15,26,authorities,1,0,1
32W3UF2EZOM3MUTPUZTVG67GCLW4CC,#31-7 Military authorities said Muslim insurgents from the country's southern provinces are unlikely to be behind the attack.,32,49,Muslim insurgents,2,0,2
32W3UF2EZOM3MUTPUZTVG67GCLW4CC,#31-7 Military authorities said Muslim insurgents from the country's southern provinces are unlikely to be behind the attack.,39,49,insurgents,10,5,15
32W3UF2EZOM3MUTPUZTVG67GCLW4CC,#31-7 Military authorities said Muslim insurgents from the country's southern provinces are unlikely to be behind the attack.,69,87,southern provinces,0,1,1
32W3UF2EZOM3MUTPUZTVG67GCLW4CC,#31-7 Military authorities said Muslim insurgents from the country's southern provinces are unlikely to be behind the attack.,78,87,provinces,2,1,3
32W3UF2EZOM3MUTPUZTVG67GCLW4CC,"#32-1 Wikinews interviews Mark Everson, U.S. Republican Party presidential candidate Former U.S. Commissioner of Internal Revenue Mark Everson took some time to talk with Wikinews about his campaign for the U.S. Republican Party's 2016 presidential nomination.",6,14,Wikinews,0,1,1
32W3UF2EZOM3MUTPUZTVG67GCLW4CC,"#32-1 Wikinews interviews Mark Everson, U.S. Republican Party presidential candidate Former U.S. Commissioner of Internal Revenue Mark Everson took some time to talk with Wikinews about his campaign for the U.S. Republican Party's 2016 presidential nomination.",6,25,Wikinews interviews,0,1,1
32W3UF2EZOM3MUTPUZTVG67GCLW4CC,"#32-1 Wikinews interviews Mark Everson, U.S. Republican Party presidential candidate Former U.S. Commissioner of Internal Revenue Mark Everson took some time to talk with Wikinews about his campaign for the U.S. Republican Party's 2016 presidential nomination.",45,61,Republican Party,1,0,1
32W3UF2EZOM3MUTPUZTVG67GCLW4CC,"#32-1 Wikinews interviews Mark Everson, U.S. Republican Party presidential candidate Former U.S. Commissioner of Internal Revenue Mark Everson took some time to talk with Wikinews about his campaign for the U.S. Republican Party's 2016 presidential nomination.",75,84,candidate,0,1,1
32W3UF2EZOM3MUTPUZTVG67GCLW4CC,"#32-1 Wikinews interviews Mark Everson, U.S. Republican Party presidential candidate Former U.S. Commissioner of Internal Revenue Mark Everson took some time to talk with Wikinews about his campaign for the U.S. Republican Party's 2016 presidential nomination.",92,129,U.S. Commissioner of Internal Revenue,1,0,1
32W3UF2EZOM3MUTPUZTVG67GCLW4CC,"#32-1 Wikinews interviews Mark Everson, U.S. Republican Party presidential candidate Former U.S. Commissioner of Internal Revenue Mark Everson took some time to talk with Wikinews about his campaign for the U.S. Republican Party's 2016 presidential nomination.",97,109,Commissioner,0,1,1
32W3UF2EZOM3MUTPUZTVG67GCLW4CC,"#32-1 Wikinews interviews Mark Everson, U.S. Republican Party presidential candidate Former U.S. Commissioner of Internal Revenue Mark Everson took some time to talk with Wikinews about his campaign for the U.S. Republican Party's 2016 presidential nomination.",97,129,Commissioner of Internal Revenue,1,0,1
32W3UF2EZOM3MUTPUZTVG67GCLW4CC,"#32-1 Wikinews interviews Mark Everson, U.S. Republican Party presidential candidate Former U.S. Commissioner of Internal Revenue Mark Everson took some time to talk with Wikinews about his campaign for the U.S. Republican Party's 2016 presidential nomination.",113,129,Internal Revenue,0,1,1
32W3UF2EZOM3MUTPUZTVG67GCLW4CC,"#32-1 Wikinews interviews Mark Everson, U.S. Republican Party presidential candidate Former U.S. Commissioner of Internal Revenue Mark Everson took some time to talk with Wikinews about his campaign for the U.S. Republican Party's 2016 presidential nomination.",122,129,Revenue,2,0,2
32W3UF2EZOM3MUTPUZTVG67GCLW4CC,"#32-1 Wikinews interviews Mark Everson, U.S. Republican Party presidential candidate Former U.S. Commissioner of Internal Revenue Mark Everson took some time to talk with Wikinews about his campaign for the U.S. Republican Party's 2016 presidential nomination.",171,179,Wikinews,1,0,1
32W3UF2EZOM3MUTPUZTVG67GCLW4CC,"#32-1 Wikinews interviews Mark Everson, U.S. Republican Party presidential candidate Former U.S. Commissioner of Internal Revenue Mark Everson took some time to talk with Wikinews about his campaign for the U.S. Republican Party's 2016 presidential nomination.",190,198,campaign,2,5,7
32W3UF2EZOM3MUTPUZTVG67GCLW4CC,"#32-1 Wikinews interviews Mark Everson, U.S. Republican Party presidential candidate Former U.S. Commissioner of Internal Revenue Mark Everson took some time to talk with Wikinews about his campaign for the U.S. Republican Party's 2016 presidential nomination.",212,222,Republican,1,0,1
32W3UF2EZOM3MUTPUZTVG67GCLW4CC,"#32-1 Wikinews interviews Mark Everson, U.S. Republican Party presidential candidate Former U.S. Commissioner of Internal Revenue Mark Everson took some time to talk with Wikinews about his campaign for the U.S. Republican Party's 2016 presidential nomination.",236,259,presidential nomination,0,1,1
32W3UF2EZOM3MUTPUZTVG67GCLW4CC,"#32-1 Wikinews interviews Mark Everson, U.S. Republican Party presidential candidate Former U.S. Commissioner of Internal Revenue Mark Everson took some time to talk with Wikinews about his campaign for the U.S. Republican Party's 2016 presidential nomination.",249,259,nomination,4,2,6
36FFXPMST9PY7VENZBM55VA1641HO8,"#9-22 The Amazonas prison riot on January 1–2 resulted in at least 56 killed inmates, of whom many were beheaded and dismembered.",10,18,Amazonas,0,1,1
36FFXPMST9PY7VENZBM55VA1641HO8,"#9-22 The Amazonas prison riot on January 1–2 resulted in at least 56 killed inmates, of whom many were beheaded and dismembered.",19,25,prison,0,1,1
36FFXPMST9PY7VENZBM55VA1641HO8,"#9-22 The Amazonas prison riot on January 1–2 resulted in at least 56 killed inmates, of whom many were beheaded and dismembered.",19,30,prison riot,0,2,2
36FFXPMST9PY7VENZBM55VA1641HO8,"#9-22 The Amazonas prison riot on January 1–2 resulted in at least 56 killed inmates, of whom many were beheaded and dismembered.",26,30,riot,2,3,5
36FFXPMST9PY7VENZBM55VA1641HO8,"#9-22 The Amazonas prison riot on January 1–2 resulted in at least 56 killed inmates, of whom many were beheaded and dismembered.",77,84,inmates,2,4,6
36FFXPMST9PY7VENZBM55VA1641HO8,"#9-22 The Amazonas prison riot on January 1–2 resulted in at least 56 killed inmates, of whom many were beheaded and dismembered.",89,93,whom,1,0,1
36FFXPMST9PY7VENZBM55VA1641HO8,"#9-22 The Amazonas prison riot on January 1–2 resulted in at least 56 killed inmates, of whom many were beheaded and dismembered.",104,112,beheaded,9,10,19
36FFXPMST9PY7VENZBM55VA1641HO8,"#9-22 The Amazonas prison riot on January 1–2 resulted in at least 56 killed inmates, of whom many were beheaded and dismembered.",104,128,beheaded and dismembered,1,0,1
36FFXPMST9PY7VENZBM55VA1641HO8,"#9-22 The Amazonas prison riot on January 1–2 resulted in at least 56 killed inmates, of whom many were beheaded and dismembered.",117,128,dismembered,10,10,20
36FFXPMST9PY7VENZBM55VA1641HO8,"#9-23 The Roraima riot on January 6 resulted in at least 33 killed, of whom many were disembowelled.",10,17,Roraima,0,2,2
36FFXPMST9PY7VENZBM55VA1641HO8,"#9-23 The Roraima riot on January 6 resulted in at least 33 killed, of whom many were disembowelled.",18,22,riot,1,0,1
36FFXPMST9PY7VENZBM55VA1641HO8,"#9-23 The Roraima riot on January 6 resulted in at least 33 killed, of whom many were disembowelled.",86,99,disembowelled,10,10,20
36FFXPMST9PY7VENZBM55VA1641HO8,"#9-24 In the wake of this year's riots, the Brazilian President Michel Temer announced to Reuters yesterday a plan, under joint cooperation of state and federal governments, to build nearly thirty prisons by 2018, including ""five maximum security prisons to house the most violent convicts,"" and to create intelligence units in effort to counter the influence of powerful inmates.",13,17,wake,1,0,1
36FFXPMST9PY7VENZBM55VA1641HO8,"#9-24 In the wake of this year's riots, the Brazilian President Michel Temer announced to Reuters yesterday a plan, under joint cooperation of state and federal governments, to build nearly thirty prisons by 2018, including ""five maximum security prisons to house the most violent convicts,"" and to create intelligence units in effort to counter the influence of powerful inmates.",33,38,riots,2,1,3
36FFXPMST9PY7VENZBM55VA1641HO8,"#9-24 In the wake of this year's riots, the Brazilian President Michel Temer announced to Reuters yesterday a plan, under joint cooperation of state and federal governments, to build nearly thirty prisons by 2018, including ""five maximum security prisons to house the most violent convicts,"" and to create intelligence units in effort to counter the influence of powerful inmates.",64,76,Michel Temer,0,1,1
36FFXPMST9PY7VENZBM55VA1641HO8,"#9-24 In the wake of this year's riots, the Brazilian President Michel Temer announced to Reuters yesterday a plan, under joint cooperation of state and federal governments, to build nearly thirty prisons by 2018, including ""five maximum security prisons to house the most violent convicts,"" and to create intelligence units in effort to counter the influence of powerful inmates.",90,97,Reuters,0,1,1
36FFXPMST9PY7VENZBM55VA1641HO8,"#9-24 In the wake of this year's riots, the Brazilian President Michel Temer announced to Reuters yesterday a plan, under joint cooperation of state and federal governments, to build nearly thirty prisons by 2018, including ""five maximum security prisons to house the most violent convicts,"" and to create intelligence units in effort to counter the influence of powerful inmates.",122,139,joint cooperation,0,1,1
36FFXPMST9PY7VENZBM55VA1641HO8,"#9-24 In the wake of this year's riots, the Brazilian President Michel Temer announced to Reuters yesterday a plan, under joint cooperation of state and federal governments, to build nearly thirty prisons by 2018, including ""five maximum security prisons to house the most violent convicts,"" and to create intelligence units in effort to counter the influence of powerful inmates.",128,139,cooperation,1,0,1
36FFXPMST9PY7VENZBM55VA1641HO8,"#9-24 In the wake of this year's riots, the Brazilian President Michel Temer announced to Reuters yesterday a plan, under joint cooperation of state and federal governments, to build nearly thirty prisons by 2018, including ""five maximum security prisons to house the most violent convicts,"" and to create intelligence units in effort to counter the influence of powerful inmates.",153,160,federal,2,1,3
36FFXPMST9PY7VENZBM55VA1641HO8,"#9-24 In the wake of this year's riots, the Brazilian President Michel Temer announced to Reuters yesterday a plan, under joint cooperation of state and federal governments, to build nearly thirty prisons by 2018, including ""five maximum security prisons to house the most violent convicts,"" and to create intelligence units in effort to counter the influence of powerful inmates.",230,246,maximum security,2,0,2
36FFXPMST9PY7VENZBM55VA1641HO8,"#9-24 In the wake of this year's riots, the Brazilian President Michel Temer announced to Reuters yesterday a plan, under joint cooperation of state and federal governments, to build nearly thirty prisons by 2018, including ""five maximum security prisons to house the most violent convicts,"" and to create intelligence units in effort to counter the influence of powerful inmates.",238,254,security prisons,0,1,1
36FFXPMST9PY7VENZBM55VA1641HO8,"#9-24 In the wake of this year's riots, the Brazilian President Michel Temer announced to Reuters yesterday a plan, under joint cooperation of state and federal governments, to build nearly thirty prisons by 2018, including ""five maximum security prisons to house the most violent convicts,"" and to create intelligence units in effort to counter the influence of powerful inmates.",258,263,house,0,1,1
36FFXPMST9PY7VENZBM55VA1641HO8,"#9-24 In the wake of this year's riots, the Brazilian President Michel Temer announced to Reuters yesterday a plan, under joint cooperation of state and federal governments, to build nearly thirty prisons by 2018, including ""five maximum security prisons to house the most violent convicts,"" and to create intelligence units in effort to counter the influence of powerful inmates.",273,280,violent,3,0,3
36FFXPMST9PY7VENZBM55VA1641HO8,"#9-24 In the wake of this year's riots, the Brazilian President Michel Temer announced to Reuters yesterday a plan, under joint cooperation of state and federal governments, to build nearly thirty prisons by 2018, including ""five maximum security prisons to house the most violent convicts,"" and to create intelligence units in effort to counter the influence of powerful inmates.",273,289,violent convicts,1,2,3
36FFXPMST9PY7VENZBM55VA1641HO8,"#9-24 In the wake of this year's riots, the Brazilian President Michel Temer announced to Reuters yesterday a plan, under joint cooperation of state and federal governments, to build nearly thirty prisons by 2018, including ""five maximum security prisons to house the most violent convicts,"" and to create intelligence units in effort to counter the influence of powerful inmates.",281,289,convicts,4,3,7
36FFXPMST9PY7VENZBM55VA1641HO8,"#9-24 In the wake of this year's riots, the Brazilian President Michel Temer announced to Reuters yesterday a plan, under joint cooperation of state and federal governments, to build nearly thirty prisons by 2018, including ""five maximum security prisons to house the most violent convicts,"" and to create intelligence units in effort to counter the influence of powerful inmates.",306,318,intelligence,3,0,3
36FFXPMST9PY7VENZBM55VA1641HO8,"#9-24 In the wake of this year's riots, the Brazilian President Michel Temer announced to Reuters yesterday a plan, under joint cooperation of state and federal governments, to build nearly thirty prisons by 2018, including ""five maximum security prisons to house the most violent convicts,"" and to create intelligence units in effort to counter the influence of powerful inmates.",338,345,counter,0,2,2
36FFXPMST9PY7VENZBM55VA1641HO8,"#9-24 In the wake of this year's riots, the Brazilian President Michel Temer announced to Reuters yesterday a plan, under joint cooperation of state and federal governments, to build nearly thirty prisons by 2018, including ""five maximum security prisons to house the most violent convicts,"" and to create intelligence units in effort to counter the influence of powerful inmates.",350,359,influence,3,1,4
36FFXPMST9PY7VENZBM55VA1641HO8,"#9-24 In the wake of this year's riots, the Brazilian President Michel Temer announced to Reuters yesterday a plan, under joint cooperation of state and federal governments, to build nearly thirty prisons by 2018, including ""five maximum security prisons to house the most violent convicts,"" and to create intelligence units in effort to counter the influence of powerful inmates.",363,379,powerful inmates,1,0,1
36FFXPMST9PY7VENZBM55VA1641HO8,"#9-24 In the wake of this year's riots, the Brazilian President Michel Temer announced to Reuters yesterday a plan, under joint cooperation of state and federal governments, to build nearly thirty prisons by 2018, including ""five maximum security prisons to house the most violent convicts,"" and to create intelligence units in effort to counter the influence of powerful inmates.",372,379,inmates,2,2,4
36FFXPMST9PY7VENZBM55VA1641HO8,#9-25 Temer announced more than one billion Brazilian reals (US$309 million) as the budget of the plan.,6,11,Temer,0,1,1
36FFXPMST9PY7VENZBM55VA1641HO8,#9-25 Temer announced more than one billion Brazilian reals (US$309 million) as the budget of the plan.,12,21,announced,0,1,1
36FFXPMST9PY7VENZBM55VA1641HO8,#9-25 Temer announced more than one billion Brazilian reals (US$309 million) as the budget of the plan.,44,53,Brazilian,0,1,1
36FFXPMST9PY7VENZBM55VA1641HO8,#9-25 Temer announced more than one billion Brazilian reals (US$309 million) as the budget of the plan.,44,59,Brazilian reals,1,0,1
36FFXPMST9PY7VENZBM55VA1641HO8,#9-25 Temer announced more than one billion Brazilian reals (US$309 million) as the budget of the plan.,84,90,budget,2,0,2
36FFXPMST9PY7VENZBM55VA1641HO8,"#9-26 However, human rights activists and experts were skeptical about building more prisons.",28,37,activists,4,0,4
36FFXPMST9PY7VENZBM55VA1641HO8,"#9-26 However, human rights activists and experts were skeptical about building more prisons.",55,64,skeptical,10,9,19
3LG268AV387PKYF112V3ENITPBTERY,#42-40 For this we basically put colonies on a diet of either food with medicine or without for a while.,16,41,we basically put colonies,1,0,1
3LG268AV387PKYF112V3ENITPBTERY,#42-40 For this we basically put colonies on a diet of either food with medicine or without for a while.,19,28,basically,1,5,6
3LG268AV387PKYF112V3ENITPBTERY,#42-40 For this we basically put colonies on a diet of either food with medicine or without for a while.,33,41,colonies,10,4,14
3LG268AV387PKYF112V3ENITPBTERY,#42-40 For this we basically put colonies on a diet of either food with medicine or without for a while.,47,51,diet,1,0,1
3LG268AV387PKYF112V3ENITPBTERY,#42-41 And afterwards either infected them or not.,11,21,afterwards,0,4,4
3LG268AV387PKYF112V3ENITPBTERY,#42-41 And afterwards either infected them or not.,29,37,infected,4,4,8
3LG268AV387PKYF112V3ENITPBTERY,#42-43 This gives us the data to do a so-called survival analysis.,25,29,data,1,0,1
3LG268AV387PKYF112V3ENITPBTERY,#42-43 This gives us the data to do a so-called survival analysis.,38,47,so-called,2,3,5
3LG268AV387PKYF112V3ENITPBTERY,#42-43 This gives us the data to do a so-called survival analysis.,38,65,so-called survival analysis,1,0,1
3LG268AV387PKYF112V3ENITPBTERY,#42-43 This gives us the data to do a so-called survival analysis.,48,56,survival,0,3,3
3LG268AV387PKYF112V3ENITPBTERY,#42-43 This gives us the data to do a so-called survival analysis.,48,65,survival analysis,2,3,5
3LG268AV387PKYF112V3ENITPBTERY,#42-43 This gives us the data to do a so-called survival analysis.,57,65,analysis,7,2,9
3LG268AV387PKYF112V3ENITPBTERY,#42-44 We measured the ROS-concentration in the bodies of ants after they ingested the food with the medicine using a spectrophotometer.,10,18,measured,0,2,2
3LG268AV387PKYF112V3ENITPBTERY,#42-44 We measured the ROS-concentration in the bodies of ants after they ingested the food with the medicine using a spectrophotometer.,23,40,ROS-concentration,7,3,10
3LG268AV387PKYF112V3ENITPBTERY,#42-44 We measured the ROS-concentration in the bodies of ants after they ingested the food with the medicine using a spectrophotometer.,74,82,ingested,5,9,14
3LG268AV387PKYF112V3ENITPBTERY,#42-44 We measured the ROS-concentration in the bodies of ants after they ingested the food with the medicine using a spectrophotometer.,110,135,using a spectrophotometer,1,0,1
3LG268AV387PKYF112V3ENITPBTERY,#42-44 We measured the ROS-concentration in the bodies of ants after they ingested the food with the medicine using a spectrophotometer.,118,135,spectrophotometer,10,8,18
3LG268AV387PKYF112V3ENITPBTERY,"#42-45 By adding certain chemicals, the ROS can be measured using the emission of light of a certain wave-length.",25,34,chemicals,2,0,2
3LG268AV387PKYF112V3ENITPBTERY,"#42-45 By adding certain chemicals, the ROS can be measured using the emission of light of a certain wave-length.",70,78,emission,7,5,12
3LG268AV387PKYF112V3ENITPBTERY,"#42-45 By adding certain chemicals, the ROS can be measured using the emission of light of a certain wave-length.",70,112,emission of light of a certain wave-length,1,0,1
3LG268AV387PKYF112V3ENITPBTERY,"#42-45 By adding certain chemicals, the ROS can be measured using the emission of light of a certain wave-length.",101,112,wave-length,2,3,5
3LG268AV387PKYF112V3ENITPBTERY,#42-46 The detrimental effect of ROS on spores was easy to measure.,11,22,detrimental,8,9,17
3LG268AV387PKYF112V3ENITPBTERY,#42-46 The detrimental effect of ROS on spores was easy to measure.,11,29,detrimental effect,0,2,2
3LG268AV387PKYF112V3ENITPBTERY,#42-46 The detrimental effect of ROS on spores was easy to measure.,33,36,ROS,2,0,2
3LG268AV387PKYF112V3ENITPBTERY,#42-46 The detrimental effect of ROS on spores was easy to measure.,40,46,spores,4,3,7
3LG268AV387PKYF112V3ENITPBTERY,"#42-47 We mixed different concentrations of ROS with the spores, plated them out on petridishes with an agar-solution where fungus can grow on.",26,40,concentrations,3,3,6
3LG268AV387PKYF112V3ENITPBTERY,"#42-47 We mixed different concentrations of ROS with the spores, plated them out on petridishes with an agar-solution where fungus can grow on.",44,47,ROS,1,0,1
3LG268AV387PKYF112V3ENITPBTERY,"#42-47 We mixed different concentrations of ROS with the spores, plated them out on petridishes with an agar-solution where fungus can grow on.",57,63,spores,2,1,3
3LG268AV387PKYF112V3ENITPBTERY,"#42-47 We mixed different concentrations of ROS with the spores, plated them out on petridishes with an agar-solution where fungus can grow on.",65,71,plated,0,3,3
3LG268AV387PKYF112V3ENITPBTERY,"#42-47 We mixed different concentrations of ROS with the spores, plated them out on petridishes with an agar-solution where fungus can grow on.",65,95,plated them out on petridishes,1,0,1
3LG268AV387PKYF112V3ENITPBTERY,"#42-47 We mixed different concentrations of ROS with the spores, plated them out on petridishes with an agar-solution where fungus can grow on.",84,95,petridishes,10,10,20
3LG268AV387PKYF112V3ENITPBTERY,"#42-47 We mixed different concentrations of ROS with the spores, plated them out on petridishes with an agar-solution where fungus can grow on.",104,117,agar-solution,8,4,12
3LG268AV387PKYF112V3ENITPBTERY,"#42-47 We mixed different concentrations of ROS with the spores, plated them out on petridishes with an agar-solution where fungus can grow on.",124,130,fungus,4,4,8
3CMIQF80GNRLVI7MI5N5X9GBCR36Q4,"#17-16 Later, companies like Google, Yahoo, Tumblr and Vine tweeted with hashtag ""#LoveWins"".",44,50,Tumblr,0,1,1
3CMIQF80GNRLVI7MI5N5X9GBCR36Q4,"#17-16 Later, companies like Google, Yahoo, Tumblr and Vine tweeted with hashtag ""#LoveWins"".",60,67,tweeted,8,2,10
3CMIQF80GNRLVI7MI5N5X9GBCR36Q4,"#17-16 Later, companies like Google, Yahoo, Tumblr and Vine tweeted with hashtag ""#LoveWins"".",73,80,hashtag,6,5,11
3CMIQF80GNRLVI7MI5N5X9GBCR36Q4,"#17-17 That night, the White House had the rainbow projected on the outside of the building to celebrate the decision.",51,60,projected,5,3,8
3CMIQF80GNRLVI7MI5N5X9GBCR36Q4,"#17-17 That night, the White House had the rainbow projected on the outside of the building to celebrate the decision.",109,117,decision,1,0,1
3CMIQF80GNRLVI7MI5N5X9GBCR36Q4,"#18-1 Palestinian prisoner Khader Adnan stops hunger strike, due to be released Khader Adnan, a senior member of the Palestinian Islamic Jihad (PIJ) movement, has stopped his hunger strike.",6,17,Palestinian,3,1,4
3CMIQF80GNRLVI7MI5N5X9GBCR36Q4,"#18-1 Palestinian prisoner Khader Adnan stops hunger strike, due to be released Khader Adnan, a senior member of the Palestinian Islamic Jihad (PIJ) movement, has stopped his hunger strike.",18,26,prisoner,1,0,1
3CMIQF80GNRLVI7MI5N5X9GBCR36Q4,"#18-1 Palestinian prisoner Khader Adnan stops hunger strike, due to be released Khader Adnan, a senior member of the Palestinian Islamic Jihad (PIJ) movement, has stopped his hunger strike.",27,39,Khader Adnan,0,1,1
3CMIQF80GNRLVI7MI5N5X9GBCR36Q4,"#18-1 Palestinian prisoner Khader Adnan stops hunger strike, due to be released Khader Adnan, a senior member of the Palestinian Islamic Jihad (PIJ) movement, has stopped his hunger strike.",46,59,hunger strike,2,2,4
3CMIQF80GNRLVI7MI5N5X9GBCR36Q4,"#18-1 Palestinian prisoner Khader Adnan stops hunger strike, due to be released Khader Adnan, a senior member of the Palestinian Islamic Jihad (PIJ) movement, has stopped his hunger strike.",71,79,released,3,1,4
3CMIQF80GNRLVI7MI5N5X9GBCR36Q4,"#18-1 Palestinian prisoner Khader Adnan stops hunger strike, due to be released Khader Adnan, a senior member of the Palestinian Islamic Jihad (PIJ) movement, has stopped his hunger strike.",117,128,Palestinian,2,0,2
3CMIQF80GNRLVI7MI5N5X9GBCR36Q4,"#18-1 Palestinian prisoner Khader Adnan stops hunger strike, due to be released Khader Adnan, a senior member of the Palestinian Islamic Jihad (PIJ) movement, has stopped his hunger strike.",117,142,Palestinian Islamic Jihad,2,0,2
3CMIQF80GNRLVI7MI5N5X9GBCR36Q4,"#18-1 Palestinian prisoner Khader Adnan stops hunger strike, due to be released Khader Adnan, a senior member of the Palestinian Islamic Jihad (PIJ) movement, has stopped his hunger strike.",129,136,Islamic,1,0,1
3CMIQF80GNRLVI7MI5N5X9GBCR36Q4,"#18-1 Palestinian prisoner Khader Adnan stops hunger strike, due to be released Khader Adnan, a senior member of the Palestinian Islamic Jihad (PIJ) movement, has stopped his hunger strike.",129,142,Islamic Jihad,0,1,1
3CMIQF80GNRLVI7MI5N5X9GBCR36Q4,"#18-1 Palestinian prisoner Khader Adnan stops hunger strike, due to be released Khader Adnan, a senior member of the Palestinian Islamic Jihad (PIJ) movement, has stopped his hunger strike.",137,142,Jihad,1,0,1
3CMIQF80GNRLVI7MI5N5X9GBCR36Q4,"#18-1 Palestinian prisoner Khader Adnan stops hunger strike, due to be released Khader Adnan, a senior member of the Palestinian Islamic Jihad (PIJ) movement, has stopped his hunger strike.",149,157,movement,1,0,1
3CMIQF80GNRLVI7MI5N5X9GBCR36Q4,"#18-2 According to media reports on Monday, Adnan ceased his strike after achieving an agreement with Israel entailing his release from administrative detention.",19,24,media,1,0,1
3CMIQF80GNRLVI7MI5N5X9GBCR36Q4,"#18-2 According to media reports on Monday, Adnan ceased his strike after achieving an agreement with Israel entailing his release from administrative detention.",44,49,Adnan,0,1,1
3CMIQF80GNRLVI7MI5N5X9GBCR36Q4,"#18-2 According to media reports on Monday, Adnan ceased his strike after achieving an agreement with Israel entailing his release from administrative detention.",50,56,ceased,5,6,11
3CMIQF80GNRLVI7MI5N5X9GBCR36Q4,"#18-2 According to media reports on Monday, Adnan ceased his strike after achieving an agreement with Israel entailing his release from administrative detention.",74,83,achieving,4,3,7
3CMIQF80GNRLVI7MI5N5X9GBCR36Q4,"#18-2 According to media reports on Monday, Adnan ceased his strike after achieving an agreement with Israel entailing his release from administrative detention.",87,96,agreement,1,0,1
3CMIQF80GNRLVI7MI5N5X9GBCR36Q4,"#18-2 According to media reports on Monday, Adnan ceased his strike after achieving an agreement with Israel entailing his release from administrative detention.",109,118,entailing,6,9,15
3CMIQF80GNRLVI7MI5N5X9GBCR36Q4,"#18-2 According to media reports on Monday, Adnan ceased his strike after achieving an agreement with Israel entailing his release from administrative detention.",136,150,administrative,5,1,6
3CMIQF80GNRLVI7MI5N5X9GBCR36Q4,"#18-2 According to media reports on Monday, Adnan ceased his strike after achieving an agreement with Israel entailing his release from administrative detention.",136,160,administrative detention,4,1,5
3CMIQF80GNRLVI7MI5N5X9GBCR36Q4,"#18-2 According to media reports on Monday, Adnan ceased his strike after achieving an agreement with Israel entailing his release from administrative detention.",151,160,detention,6,4,10
3CMIQF80GNRLVI7MI5N5X9GBCR36Q4,"#18-3 Adnan's strike lasted over 50 days, and he was in mortal danger for the last couple of weeks.",21,27,lasted,0,1,1
3CMIQF80GNRLVI7MI5N5X9GBCR36Q4,"#18-3 Adnan's strike lasted over 50 days, and he was in mortal danger for the last couple of weeks.",56,62,mortal,4,4,8
3CMIQF80GNRLVI7MI5N5X9GBCR36Q4,"#18-3 Adnan's strike lasted over 50 days, and he was in mortal danger for the last couple of weeks.",56,69,mortal danger,1,1,2
3CMIQF80GNRLVI7MI5N5X9GBCR36Q4,"#18-4 Due to his severe deterioration, Israel was forced to hospitalize him, and placed him in Assaf Harofe hospital in Israel.",17,23,severe,2,0,2
3CMIQF80GNRLVI7MI5N5X9GBCR36Q4,"#18-4 Due to his severe deterioration, Israel was forced to hospitalize him, and placed him in Assaf Harofe hospital in Israel.",17,37,severe deterioration,1,1,2
3CMIQF80GNRLVI7MI5N5X9GBCR36Q4,"#18-4 Due to his severe deterioration, Israel was forced to hospitalize him, and placed him in Assaf Harofe hospital in Israel.",24,37,deterioration,10,9,19
3CMIQF80GNRLVI7MI5N5X9GBCR36Q4,"#18-4 Due to his severe deterioration, Israel was forced to hospitalize him, and placed him in Assaf Harofe hospital in Israel.",60,71,hospitalize,7,1,8
3CMIQF80GNRLVI7MI5N5X9GBCR36Q4,"#18-4 Due to his severe deterioration, Israel was forced to hospitalize him, and placed him in Assaf Harofe hospital in Israel.",95,107,Assaf Harofe,0,1,1
3CMIQF80GNRLVI7MI5N5X9GBCR36Q4,"#18-5 Jawd Boulos, Adnan's lawyer, said Adnan is due to be released on July 12.",6,17,Jawd Boulos,0,1,1
3CMIQF80GNRLVI7MI5N5X9GBCR36Q4,"#18-5 Jawd Boulos, Adnan's lawyer, said Adnan is due to be released on July 12.",59,67,released,1,0,1
3KA7IJSNW6661IN2EJPO8KCTLWSBP3,#1-5 In yesterday's speech May also ruled out continued membership of the customs union as this prevented Britain from negotiating trade deals with non-EU countries.,8,18,yesterdays,0,1,1
3KA7IJSNW6661IN2EJPO8KCTLWSBP3,#1-5 In yesterday's speech May also ruled out continued membership of the customs union as this prevented Britain from negotiating trade deals with non-EU countries.,36,41,ruled,0,1,1
3KA7IJSNW6661IN2EJPO8KCTLWSBP3,#1-5 In yesterday's speech May also ruled out continued membership of the customs union as this prevented Britain from negotiating trade deals with non-EU countries.,36,45,ruled out,0,4,4
3KA7IJSNW6661IN2EJPO8KCTLWSBP3,#1-5 In yesterday's speech May also ruled out continued membership of the customs union as this prevented Britain from negotiating trade deals with non-EU countries.,56,66,membership,1,1,2
3KA7IJSNW6661IN2EJPO8KCTLWSBP3,#1-5 In yesterday's speech May also ruled out continued membership of the customs union as this prevented Britain from negotiating trade deals with non-EU countries.,74,81,customs,1,0,1
3KA7IJSNW6661IN2EJPO8KCTLWSBP3,#1-5 In yesterday's speech May also ruled out continued membership of the customs union as this prevented Britain from negotiating trade deals with non-EU countries.,74,87,customs union,3,1,4
3KA7IJSNW6661IN2EJPO8KCTLWSBP3,#1-5 In yesterday's speech May also ruled out continued membership of the customs union as this prevented Britain from negotiating trade deals with non-EU countries.,82,87,union,1,0,1
3KA7IJSNW6661IN2EJPO8KCTLWSBP3,#1-5 In yesterday's speech May also ruled out continued membership of the customs union as this prevented Britain from negotiating trade deals with non-EU countries.,96,105,prevented,0,1,1
3KA7IJSNW6661IN2EJPO8KCTLWSBP3,#1-5 In yesterday's speech May also ruled out continued membership of the customs union as this prevented Britain from negotiating trade deals with non-EU countries.,119,130,negotiating,10,10,20
3KA7IJSNW6661IN2EJPO8KCTLWSBP3,#1-5 In yesterday's speech May also ruled out continued membership of the customs union as this prevented Britain from negotiating trade deals with non-EU countries.,119,142,negotiating trade deals,1,0,1
3KA7IJSNW6661IN2EJPO8KCTLWSBP3,#1-5 In yesterday's speech May also ruled out continued membership of the customs union as this prevented Britain from negotiating trade deals with non-EU countries.,137,142,deals,0,1,1
3KA7IJSNW6661IN2EJPO8KCTLWSBP3,#1-5 In yesterday's speech May also ruled out continued membership of the customs union as this prevented Britain from negotiating trade deals with non-EU countries.,148,164,non-EU countries,1,0,1
3KA7IJSNW6661IN2EJPO8KCTLWSBP3,"#1-6 Theresa May also said Britain's contributions to the EU budget would cease, although some contributions would be made to some pan-European schemes.",5,12,Theresa,0,1,1
3KA7IJSNW6661IN2EJPO8KCTLWSBP3,"#1-6 Theresa May also said Britain's contributions to the EU budget would cease, although some contributions would be made to some pan-European schemes.",37,50,contributions,4,6,10
3KA7IJSNW6661IN2EJPO8KCTLWSBP3,"#1-6 Theresa May also said Britain's contributions to the EU budget would cease, although some contributions would be made to some pan-European schemes.",58,67,EU budget,1,0,1
3KA7IJSNW6661IN2EJPO8KCTLWSBP3,"#1-6 Theresa May also said Britain's contributions to the EU budget would cease, although some contributions would be made to some pan-European schemes.",61,67,budget,1,0,1
3KA7IJSNW6661IN2EJPO8KCTLWSBP3,"#1-6 Theresa May also said Britain's contributions to the EU budget would cease, although some contributions would be made to some pan-European schemes.",74,79,cease,3,7,10
3KA7IJSNW6661IN2EJPO8KCTLWSBP3,"#1-6 Theresa May also said Britain's contributions to the EU budget would cease, although some contributions would be made to some pan-European schemes.",95,108,contributions,6,1,7
3KA7IJSNW6661IN2EJPO8KCTLWSBP3,"#1-6 Theresa May also said Britain's contributions to the EU budget would cease, although some contributions would be made to some pan-European schemes.",131,143,pan-European,3,1,4
3KA7IJSNW6661IN2EJPO8KCTLWSBP3,"#1-6 Theresa May also said Britain's contributions to the EU budget would cease, although some contributions would be made to some pan-European schemes.",131,151,pan-European schemes,3,2,5
3KA7IJSNW6661IN2EJPO8KCTLWSBP3,"#1-6 Theresa May also said Britain's contributions to the EU budget would cease, although some contributions would be made to some pan-European schemes.",144,151,schemes,4,3,7
3KA7IJSNW6661IN2EJPO8KCTLWSBP3,"#1-7 In her words, ""the days of Britain making vast contributions to the European Union every year will end"".",47,51,vast,1,2,3
3KA7IJSNW6661IN2EJPO8KCTLWSBP3,"#1-7 In her words, ""the days of Britain making vast contributions to the European Union every year will end"".",47,65,vast contributions,0,2,2
3KA7IJSNW6661IN2EJPO8KCTLWSBP3,"#1-7 In her words, ""the days of Britain making vast contributions to the European Union every year will end"".",52,65,contributions,3,0,3
3KA7IJSNW6661IN2EJPO8KCTLWSBP3,#1-8 The speech also covered the legal status of both UK citizens living abroad and EU citizens living in the UK.,33,45,legal status,1,2,3
3KA7IJSNW6661IN2EJPO8KCTLWSBP3,#1-8 The speech also covered the legal status of both UK citizens living abroad and EU citizens living in the UK.,73,79,abroad,1,2,3
3KA7IJSNW6661IN2EJPO8KCTLWSBP3,"#1-9 May said she wished to guarantee the status of both, but that she also sought ""reciprocity"" before doing so, and noted ""one or two"" other countries had not been willing to do so.",28,37,guarantee,4,6,10
3KA7IJSNW6661IN2EJPO8KCTLWSBP3,"#1-9 May said she wished to guarantee the status of both, but that she also sought ""reciprocity"" before doing so, and noted ""one or two"" other countries had not been willing to do so.",76,82,sought,1,1,2
3KA7IJSNW6661IN2EJPO8KCTLWSBP3,"#1-9 May said she wished to guarantee the status of both, but that she also sought ""reciprocity"" before doing so, and noted ""one or two"" other countries had not been willing to do so.",76,94,sought reciprocity,0,1,1
3KA7IJSNW6661IN2EJPO8KCTLWSBP3,"#1-9 May said she wished to guarantee the status of both, but that she also sought ""reciprocity"" before doing so, and noted ""one or two"" other countries had not been willing to do so.",84,95,reciprocity,10,8,18
3KA7IJSNW6661IN2EJPO8KCTLWSBP3,"#1-10 Following May's speech the Secretary of State for Exiting the European Union, David Davis, echoed the Prime Minister in a speech he gave to Parliament, adding ""the final deal agreed between the UK and the EU will be put to a vote in both Houses of Parliament before it takes effect"".",56,63,Exiting,3,3,6
3KA7IJSNW6661IN2EJPO8KCTLWSBP3,"#1-10 Following May's speech the Secretary of State for Exiting the European Union, David Davis, echoed the Prime Minister in a speech he gave to Parliament, adding ""the final deal agreed between the UK and the EU will be put to a vote in both Houses of Parliament before it takes effect"".",97,103,echoed,1,6,7
3KA7IJSNW6661IN2EJPO8KCTLWSBP3,"#1-10 Following May's speech the Secretary of State for Exiting the European Union, David Davis, echoed the Prime Minister in a speech he gave to Parliament, adding ""the final deal agreed between the UK and the EU will be put to a vote in both Houses of Parliament before it takes effect"".",146,156,Parliament,3,2,5
3KA7IJSNW6661IN2EJPO8KCTLWSBP3,"#1-10 Following May's speech the Secretary of State for Exiting the European Union, David Davis, echoed the Prime Minister in a speech he gave to Parliament, adding ""the final deal agreed between the UK and the EU will be put to a vote in both Houses of Parliament before it takes effect"".",244,264,Houses of Parliament,1,0,1
3KA7IJSNW6661IN2EJPO8KCTLWSBP3,"#1-10 Following May's speech the Secretary of State for Exiting the European Union, David Davis, echoed the Prime Minister in a speech he gave to Parliament, adding ""the final deal agreed between the UK and the EU will be put to a vote in both Houses of Parliament before it takes effect"".",254,264,Parliament,0,1,1
30F94FBDNRL4TAG9V0Y8DUDQAZCTBP,"#25-1 US economy adds 215,000 jobs in July; unemployment rate remains steady at 5.3% The Bureau of Labor Statistics reported that the US economy added 215,000 jobs in July.",9,16,economy,5,0,5
30F94FBDNRL4TAG9V0Y8DUDQAZCTBP,"#25-1 US economy adds 215,000 jobs in July; unemployment rate remains steady at 5.3% The Bureau of Labor Statistics reported that the US economy added 215,000 jobs in July.",44,56,unemployment,8,4,12
30F94FBDNRL4TAG9V0Y8DUDQAZCTBP,"#25-1 US economy adds 215,000 jobs in July; unemployment rate remains steady at 5.3% The Bureau of Labor Statistics reported that the US economy added 215,000 jobs in July.",44,61,unemployment rate,0,2,2
30F94FBDNRL4TAG9V0Y8DUDQAZCTBP,"#25-1 US economy adds 215,000 jobs in July; unemployment rate remains steady at 5.3% The Bureau of Labor Statistics reported that the US economy added 215,000 jobs in July.",62,69,remains,1,0,1
30F94FBDNRL4TAG9V0Y8DUDQAZCTBP,"#25-1 US economy adds 215,000 jobs in July; unemployment rate remains steady at 5.3% The Bureau of Labor Statistics reported that the US economy added 215,000 jobs in July.",62,76,remains steady,0,1,1
30F94FBDNRL4TAG9V0Y8DUDQAZCTBP,"#25-1 US economy adds 215,000 jobs in July; unemployment rate remains steady at 5.3% The Bureau of Labor Statistics reported that the US economy added 215,000 jobs in July.",70,76,steady,0,3,3
30F94FBDNRL4TAG9V0Y8DUDQAZCTBP,"#25-1 US economy adds 215,000 jobs in July; unemployment rate remains steady at 5.3% The Bureau of Labor Statistics reported that the US economy added 215,000 jobs in July.",89,95,Bureau,2,1,3
30F94FBDNRL4TAG9V0Y8DUDQAZCTBP,"#25-1 US economy adds 215,000 jobs in July; unemployment rate remains steady at 5.3% The Bureau of Labor Statistics reported that the US economy added 215,000 jobs in July.",89,115,Bureau of Labor Statistics,1,0,1
30F94FBDNRL4TAG9V0Y8DUDQAZCTBP,"#25-1 US economy adds 215,000 jobs in July; unemployment rate remains steady at 5.3% The Bureau of Labor Statistics reported that the US economy added 215,000 jobs in July.",105,115,Statistics,1,1,2
30F94FBDNRL4TAG9V0Y8DUDQAZCTBP,"#25-2 Job growth has averaged 242,000 per month for the past year.",10,16,growth,1,0,1
30F94FBDNRL4TAG9V0Y8DUDQAZCTBP,"#25-2 Job growth has averaged 242,000 per month for the past year.",21,29,averaged,3,2,5
30F94FBDNRL4TAG9V0Y8DUDQAZCTBP,"#25-3 Continuing a trend of steady employment growth, the United States economy added 215,000 jobs in July, the Bureau of Labor Statistics said on Friday.",6,16,Continuing,0,1,1
30F94FBDNRL4TAG9V0Y8DUDQAZCTBP,"#25-3 Continuing a trend of steady employment growth, the United States economy added 215,000 jobs in July, the Bureau of Labor Statistics said on Friday.",17,24,a trend,1,0,1
30F94FBDNRL4TAG9V0Y8DUDQAZCTBP,"#25-3 Continuing a trend of steady employment growth, the United States economy added 215,000 jobs in July, the Bureau of Labor Statistics said on Friday.",19,24,trend,2,4,6
30F94FBDNRL4TAG9V0Y8DUDQAZCTBP,"#25-3 Continuing a trend of steady employment growth, the United States economy added 215,000 jobs in July, the Bureau of Labor Statistics said on Friday.",28,34,steady,3,3,6
30F94FBDNRL4TAG9V0Y8DUDQAZCTBP,"#25-3 Continuing a trend of steady employment growth, the United States economy added 215,000 jobs in July, the Bureau of Labor Statistics said on Friday.",28,52,steady employment growth,0,1,1
30F94FBDNRL4TAG9V0Y8DUDQAZCTBP,"#25-3 Continuing a trend of steady employment growth, the United States economy added 215,000 jobs in July, the Bureau of Labor Statistics said on Friday.",35,45,employment,1,1,2
30F94FBDNRL4TAG9V0Y8DUDQAZCTBP,"#25-3 Continuing a trend of steady employment growth, the United States economy added 215,000 jobs in July, the Bureau of Labor Statistics said on Friday.",72,79,economy,1,1,2
30F94FBDNRL4TAG9V0Y8DUDQAZCTBP,"#25-3 Continuing a trend of steady employment growth, the United States economy added 215,000 jobs in July, the Bureau of Labor Statistics said on Friday.",128,138,Statistics,3,0,3
30F94FBDNRL4TAG9V0Y8DUDQAZCTBP,#25-4 The unemployment rate remained unchanged at 5.3%.,10,22,unemployment,0,1,1
30F94FBDNRL4TAG9V0Y8DUDQAZCTBP,#25-4 The unemployment rate remained unchanged at 5.3%.,28,36,remained,0,1,1
30F94FBDNRL4TAG9V0Y8DUDQAZCTBP,#25-4 The unemployment rate remained unchanged at 5.3%.,37,46,unchanged,0,1,1
30F94FBDNRL4TAG9V0Y8DUDQAZCTBP,"#25-5 ""Job growth is quite strong,"" stated Jim O'Sullivan, chief economist at High Frequency Economics, a data analysis firm in New York.",21,33,quite strong,1,0,1
30F94FBDNRL4TAG9V0Y8DUDQAZCTBP,"#25-5 ""Job growth is quite strong,"" stated Jim O'Sullivan, chief economist at High Frequency Economics, a data analysis firm in New York.",43,56,Jim OSullivan,0,1,1
30F94FBDNRL4TAG9V0Y8DUDQAZCTBP,"#25-5 ""Job growth is quite strong,"" stated Jim O'Sullivan, chief economist at High Frequency Economics, a data analysis firm in New York.",59,64,chief,2,0,2
30F94FBDNRL4TAG9V0Y8DUDQAZCTBP,"#25-5 ""Job growth is quite strong,"" stated Jim O'Sullivan, chief economist at High Frequency Economics, a data analysis firm in New York.",65,74,economist,7,3,10
30F94FBDNRL4TAG9V0Y8DUDQAZCTBP,"#25-5 ""Job growth is quite strong,"" stated Jim O'Sullivan, chief economist at High Frequency Economics, a data analysis firm in New York.",93,102,Economics,0,1,1
30F94FBDNRL4TAG9V0Y8DUDQAZCTBP,"#25-5 ""Job growth is quite strong,"" stated Jim O'Sullivan, chief economist at High Frequency Economics, a data analysis firm in New York.",106,110,data,1,0,1
30F94FBDNRL4TAG9V0Y8DUDQAZCTBP,"#25-5 ""Job growth is quite strong,"" stated Jim O'Sullivan, chief economist at High Frequency Economics, a data analysis firm in New York.",106,119,data analysis,1,1,2
30F94FBDNRL4TAG9V0Y8DUDQAZCTBP,"#25-5 ""Job growth is quite strong,"" stated Jim O'Sullivan, chief economist at High Frequency Economics, a data analysis firm in New York.",106,124,data analysis firm,2,1,3
30F94FBDNRL4TAG9V0Y8DUDQAZCTBP,"#25-5 ""Job growth is quite strong,"" stated Jim O'Sullivan, chief economist at High Frequency Economics, a data analysis firm in New York.",111,119,analysis,5,2,7
30F94FBDNRL4TAG9V0Y8DUDQAZCTBP,"#25-5 ""Job growth is quite strong,"" stated Jim O'Sullivan, chief economist at High Frequency Economics, a data analysis firm in New York.",120,124,firm,1,0,1
30F94FBDNRL4TAG9V0Y8DUDQAZCTBP,"#25-6 ""This pace of employment growth is clearly strong enough to keep the unemployment rate trending down.""",12,16,pace,1,1,2
30F94FBDNRL4TAG9V0Y8DUDQAZCTBP,"#25-6 ""This pace of employment growth is clearly strong enough to keep the unemployment rate trending down.""",20,37,employment growth,1,0,1
30F94FBDNRL4TAG9V0Y8DUDQAZCTBP,"#25-6 ""This pace of employment growth is clearly strong enough to keep the unemployment rate trending down.""",93,101,trending,1,5,6
30F94FBDNRL4TAG9V0Y8DUDQAZCTBP,"#25-6 ""This pace of employment growth is clearly strong enough to keep the unemployment rate trending down.""",93,106,trending down,1,1,2
30F94FBDNRL4TAG9V0Y8DUDQAZCTBP,"#25-7 Average hourly earnings rose 0.2%, marking a rebound after growth stalled in June.",21,29,earnings,2,1,3
30F94FBDNRL4TAG9V0Y8DUDQAZCTBP,"#25-7 Average hourly earnings rose 0.2%, marking a rebound after growth stalled in June.",30,34,rose,0,1,1
30F94FBDNRL4TAG9V0Y8DUDQAZCTBP,"#25-7 Average hourly earnings rose 0.2%, marking a rebound after growth stalled in June.",51,58,rebound,9,7,16
30F94FBDNRL4TAG9V0Y8DUDQAZCTBP,"#25-7 Average hourly earnings rose 0.2%, marking a rebound after growth stalled in June.",72,79,stalled,3,7,10
30F94FBDNRL4TAG9V0Y8DUDQAZCTBP,"#25-8 Wages have grown by 2.1% over the past year, below the Federal Reserve's target of 3.5% annual wage growth, and not much more than the underlying rate of inflation.",6,11,Wages,1,1,2
30F94FBDNRL4TAG9V0Y8DUDQAZCTBP,"#25-8 Wages have grown by 2.1% over the past year, below the Federal Reserve's target of 3.5% annual wage growth, and not much more than the underlying rate of inflation.",61,68,Federal,0,1,1
30F94FBDNRL4TAG9V0Y8DUDQAZCTBP,"#25-8 Wages have grown by 2.1% over the past year, below the Federal Reserve's target of 3.5% annual wage growth, and not much more than the underlying rate of inflation.",61,76,Federal Reserve,1,0,1
30F94FBDNRL4TAG9V0Y8DUDQAZCTBP,"#25-8 Wages have grown by 2.1% over the past year, below the Federal Reserve's target of 3.5% annual wage growth, and not much more than the underlying rate of inflation.",94,100,annual,2,1,3
30F94FBDNRL4TAG9V0Y8DUDQAZCTBP,"#25-8 Wages have grown by 2.1% over the past year, below the Federal Reserve's target of 3.5% annual wage growth, and not much more than the underlying rate of inflation.",94,112,annual wage growth,2,0,2
30F94FBDNRL4TAG9V0Y8DUDQAZCTBP,"#25-8 Wages have grown by 2.1% over the past year, below the Federal Reserve's target of 3.5% annual wage growth, and not much more than the underlying rate of inflation.",101,105,wage,0,1,1
30F94FBDNRL4TAG9V0Y8DUDQAZCTBP,"#25-8 Wages have grown by 2.1% over the past year, below the Federal Reserve's target of 3.5% annual wage growth, and not much more than the underlying rate of inflation.",141,151,underlying,9,7,16
30F94FBDNRL4TAG9V0Y8DUDQAZCTBP,"#25-8 Wages have grown by 2.1% over the past year, below the Federal Reserve's target of 3.5% annual wage growth, and not much more than the underlying rate of inflation.",141,156,underlying rate,0,1,1
30F94FBDNRL4TAG9V0Y8DUDQAZCTBP,"#25-8 Wages have grown by 2.1% over the past year, below the Federal Reserve's target of 3.5% annual wage growth, and not much more than the underlying rate of inflation.",141,169,underlying rate of inflation,1,0,1
30F94FBDNRL4TAG9V0Y8DUDQAZCTBP,"#25-8 Wages have grown by 2.1% over the past year, below the Federal Reserve's target of 3.5% annual wage growth, and not much more than the underlying rate of inflation.",160,169,inflation,8,7,15
3S1WOPCJFGU8MAWOTXMUCWW2FUZJEB,"#41-26 Found near the German border, the migrants were from Afghanistan, Syria, and Bangladesh.",29,35,border,1,0,1
3S1WOPCJFGU8MAWOTXMUCWW2FUZJEB,"#41-26 Found near the German border, the migrants were from Afghanistan, Syria, and Bangladesh.",41,49,migrants,7,9,16
3S1WOPCJFGU8MAWOTXMUCWW2FUZJEB,"#41-26 Found near the German border, the migrants were from Afghanistan, Syria, and Bangladesh.",60,94,"Afghanistan, Syria, and Bangladesh",1,0,1
3S1WOPCJFGU8MAWOTXMUCWW2FUZJEB,"#41-26 Found near the German border, the migrants were from Afghanistan, Syria, and Bangladesh.",73,78,Syria,0,1,1
3S1WOPCJFGU8MAWOTXMUCWW2FUZJEB,"#42-1 Biologist Nick Bos tells Wikinews about 'self-medicating' ants Nick Bos, of the University of Helsinki, studies ""the amazing adaptations social insects have evolved in order to fight the extreme parasite pressure they experience"".",6,15,Biologist,5,1,6
3S1WOPCJFGU8MAWOTXMUCWW2FUZJEB,"#42-1 Biologist Nick Bos tells Wikinews about 'self-medicating' ants Nick Bos, of the University of Helsinki, studies ""the amazing adaptations social insects have evolved in order to fight the extreme parasite pressure they experience"".",6,24,Biologist Nick Bos,0,1,1
3S1WOPCJFGU8MAWOTXMUCWW2FUZJEB,"#42-1 Biologist Nick Bos tells Wikinews about 'self-medicating' ants Nick Bos, of the University of Helsinki, studies ""the amazing adaptations social insects have evolved in order to fight the extreme parasite pressure they experience"".",31,39,Wikinews,1,0,1
3S1WOPCJFGU8MAWOTXMUCWW2FUZJEB,"#42-1 Biologist Nick Bos tells Wikinews about 'self-medicating' ants Nick Bos, of the University of Helsinki, studies ""the amazing adaptations social insects have evolved in order to fight the extreme parasite pressure they experience"".",47,62,self-medicating,7,1,8
3S1WOPCJFGU8MAWOTXMUCWW2FUZJEB,"#42-1 Biologist Nick Bos tells Wikinews about 'self-medicating' ants Nick Bos, of the University of Helsinki, studies ""the amazing adaptations social insects have evolved in order to fight the extreme parasite pressure they experience"".",64,68,ants,0,1,1
3S1WOPCJFGU8MAWOTXMUCWW2FUZJEB,"#42-1 Biologist Nick Bos tells Wikinews about 'self-medicating' ants Nick Bos, of the University of Helsinki, studies ""the amazing adaptations social insects have evolved in order to fight the extreme parasite pressure they experience"".",86,108,University of Helsinki,1,0,1
3S1WOPCJFGU8MAWOTXMUCWW2FUZJEB,"#42-1 Biologist Nick Bos tells Wikinews about 'self-medicating' ants Nick Bos, of the University of Helsinki, studies ""the amazing adaptations social insects have evolved in order to fight the extreme parasite pressure they experience"".",100,108,Helsinki,0,1,1
3S1WOPCJFGU8MAWOTXMUCWW2FUZJEB,"#42-1 Biologist Nick Bos tells Wikinews about 'self-medicating' ants Nick Bos, of the University of Helsinki, studies ""the amazing adaptations social insects have evolved in order to fight the extreme parasite pressure they experience"".",123,142,amazing adaptations,1,1,2
3S1WOPCJFGU8MAWOTXMUCWW2FUZJEB,"#42-1 Biologist Nick Bos tells Wikinews about 'self-medicating' ants Nick Bos, of the University of Helsinki, studies ""the amazing adaptations social insects have evolved in order to fight the extreme parasite pressure they experience"".",131,142,adaptations,9,9,18
3S1WOPCJFGU8MAWOTXMUCWW2FUZJEB,"#42-1 Biologist Nick Bos tells Wikinews about 'self-medicating' ants Nick Bos, of the University of Helsinki, studies ""the amazing adaptations social insects have evolved in order to fight the extreme parasite pressure they experience"".",143,157,social insects,1,2,3
3S1WOPCJFGU8MAWOTXMUCWW2FUZJEB,"#42-1 Biologist Nick Bos tells Wikinews about 'self-medicating' ants Nick Bos, of the University of Helsinki, studies ""the amazing adaptations social insects have evolved in order to fight the extreme parasite pressure they experience"".",163,170,evolved,2,3,5
3S1WOPCJFGU8MAWOTXMUCWW2FUZJEB,"#42-1 Biologist Nick Bos tells Wikinews about 'self-medicating' ants Nick Bos, of the University of Helsinki, studies ""the amazing adaptations social insects have evolved in order to fight the extreme parasite pressure they experience"".",193,200,extreme,1,0,1
3S1WOPCJFGU8MAWOTXMUCWW2FUZJEB,"#42-1 Biologist Nick Bos tells Wikinews about 'self-medicating' ants Nick Bos, of the University of Helsinki, studies ""the amazing adaptations social insects have evolved in order to fight the extreme parasite pressure they experience"".",193,218,extreme parasite pressure,0,1,1
3S1WOPCJFGU8MAWOTXMUCWW2FUZJEB,"#42-1 Biologist Nick Bos tells Wikinews about 'self-medicating' ants Nick Bos, of the University of Helsinki, studies ""the amazing adaptations social insects have evolved in order to fight the extreme parasite pressure they experience"".",201,209,parasite,9,5,14
3S1WOPCJFGU8MAWOTXMUCWW2FUZJEB,"#42-1 Biologist Nick Bos tells Wikinews about 'self-medicating' ants Nick Bos, of the University of Helsinki, studies ""the amazing adaptations social insects have evolved in order to fight the extreme parasite pressure they experience"".",201,218,parasite pressure,1,2,3
3S1WOPCJFGU8MAWOTXMUCWW2FUZJEB,"#42-1 Biologist Nick Bos tells Wikinews about 'self-medicating' ants Nick Bos, of the University of Helsinki, studies ""the amazing adaptations social insects have evolved in order to fight the extreme parasite pressure they experience"".",224,234,experience,0,1,1
3S1WOPCJFGU8MAWOTXMUCWW2FUZJEB,#42-2 In a recently-accepted Evolution paper Bos and colleagues describe ants appearing to self-medicate.,11,28,recently-accepted,1,1,2
3S1WOPCJFGU8MAWOTXMUCWW2FUZJEB,#42-2 In a recently-accepted Evolution paper Bos and colleagues describe ants appearing to self-medicate.,29,38,Evolution,4,2,6
3S1WOPCJFGU8MAWOTXMUCWW2FUZJEB,#42-2 In a recently-accepted Evolution paper Bos and colleagues describe ants appearing to self-medicate.,53,63,colleagues,4,3,7
3S1WOPCJFGU8MAWOTXMUCWW2FUZJEB,#42-2 In a recently-accepted Evolution paper Bos and colleagues describe ants appearing to self-medicate.,73,77,ants,0,1,1
3S1WOPCJFGU8MAWOTXMUCWW2FUZJEB,#42-2 In a recently-accepted Evolution paper Bos and colleagues describe ants appearing to self-medicate.,78,87,appearing,1,0,1
3S1WOPCJFGU8MAWOTXMUCWW2FUZJEB,#42-2 In a recently-accepted Evolution paper Bos and colleagues describe ants appearing to self-medicate.,91,104,self-medicate,3,3,6
3S1WOPCJFGU8MAWOTXMUCWW2FUZJEB,"#42-3 I have no doubt that as time goes on, there will be more and more cases documented.",78,88,documented,3,4,7
3S1WOPCJFGU8MAWOTXMUCWW2FUZJEB,"#42-4 The team used Formica fusca, an ant species that can form thousand-strong colonies.",20,27,Formica,1,0,1
3S1WOPCJFGU8MAWOTXMUCWW2FUZJEB,"#42-4 The team used Formica fusca, an ant species that can form thousand-strong colonies.",20,33,Formica fusca,2,1,3
3S1WOPCJFGU8MAWOTXMUCWW2FUZJEB,"#42-4 The team used Formica fusca, an ant species that can form thousand-strong colonies.",28,33,fusca,1,1,2
3S1WOPCJFGU8MAWOTXMUCWW2FUZJEB,"#42-4 The team used Formica fusca, an ant species that can form thousand-strong colonies.",38,41,ant,0,1,1
3S1WOPCJFGU8MAWOTXMUCWW2FUZJEB,"#42-4 The team used Formica fusca, an ant species that can form thousand-strong colonies.",42,49,species,1,0,1
3S1WOPCJFGU8MAWOTXMUCWW2FUZJEB,"#42-4 The team used Formica fusca, an ant species that can form thousand-strong colonies.",64,79,thousand-strong,1,3,4
3S1WOPCJFGU8MAWOTXMUCWW2FUZJEB,"#42-4 The team used Formica fusca, an ant species that can form thousand-strong colonies.",80,88,colonies,4,1,5
3S1WOPCJFGU8MAWOTXMUCWW2FUZJEB,"#42-5 This common black ant eats other insects, and also aphid honeydew.",57,62,aphid,6,2,8
3S1WOPCJFGU8MAWOTXMUCWW2FUZJEB,"#42-5 This common black ant eats other insects, and also aphid honeydew.",57,71,aphid honeydew,2,3,5
3S1WOPCJFGU8MAWOTXMUCWW2FUZJEB,"#42-5 This common black ant eats other insects, and also aphid honeydew.",63,71,honeydew,0,2,2
3S1WOPCJFGU8MAWOTXMUCWW2FUZJEB,#42-6 It often nests in tree stumps or under rocks and foraging workers can sometimes be spotted climbing trees.,15,20,nests,0,2,2
3S1WOPCJFGU8MAWOTXMUCWW2FUZJEB,#42-6 It often nests in tree stumps or under rocks and foraging workers can sometimes be spotted climbing trees.,24,35,tree stumps,1,1,2
3S1WOPCJFGU8MAWOTXMUCWW2FUZJEB,#42-6 It often nests in tree stumps or under rocks and foraging workers can sometimes be spotted climbing trees.,29,35,stumps,2,4,6
3S1WOPCJFGU8MAWOTXMUCWW2FUZJEB,#42-6 It often nests in tree stumps or under rocks and foraging workers can sometimes be spotted climbing trees.,55,63,foraging,6,6,12
3S1WOPCJFGU8MAWOTXMUCWW2FUZJEB,#42-6 It often nests in tree stumps or under rocks and foraging workers can sometimes be spotted climbing trees.,55,71,foraging workers,1,2,3
3S1WOPCJFGU8MAWOTXMUCWW2FUZJEB,#42-6 It often nests in tree stumps or under rocks and foraging workers can sometimes be spotted climbing trees.,89,96,spotted,0,6,6
3S1WOPCJFGU8MAWOTXMUCWW2FUZJEB,"#42-7 Some ants were infected with Beauveria bassiana, a fungus.",11,15,ants,0,1,1
3S1WOPCJFGU8MAWOTXMUCWW2FUZJEB,"#42-7 Some ants were infected with Beauveria bassiana, a fungus.",35,53,Beauveria bassiana,4,1,5
3S1WOPCJFGU8MAWOTXMUCWW2FUZJEB,"#42-7 Some ants were infected with Beauveria bassiana, a fungus.",45,53,bassiana,0,1,1
3S1WOPCJFGU8MAWOTXMUCWW2FUZJEB,"#42-7 Some ants were infected with Beauveria bassiana, a fungus.",55,63,a fungus,1,0,1
3S1WOPCJFGU8MAWOTXMUCWW2FUZJEB,"#42-7 Some ants were infected with Beauveria bassiana, a fungus.",57,63,fungus,6,1,7
3RWO3EJELHA5OK5ACMWZ28ZKZK11PA,"#15-1 Putin calls US troops in Poland 'a threat' Reports yesterday indicated Russian President Vladimir Putin views the arrival of US troops in Poland as ""a threat"".",21,27,troops,0,2,2
3RWO3EJELHA5OK5ACMWZ28ZKZK11PA,"#15-1 Putin calls US troops in Poland 'a threat' Reports yesterday indicated Russian President Vladimir Putin views the arrival of US troops in Poland as ""a threat"".",41,47,threat,2,2,4
3RWO3EJELHA5OK5ACMWZ28ZKZK11PA,"#15-1 Putin calls US troops in Poland 'a threat' Reports yesterday indicated Russian President Vladimir Putin views the arrival of US troops in Poland as ""a threat"".",57,66,yesterday,0,1,1
3RWO3EJELHA5OK5ACMWZ28ZKZK11PA,"#15-1 Putin calls US troops in Poland 'a threat' Reports yesterday indicated Russian President Vladimir Putin views the arrival of US troops in Poland as ""a threat"".",67,76,indicated,4,4,8
3RWO3EJELHA5OK5ACMWZ28ZKZK11PA,"#15-1 Putin calls US troops in Poland 'a threat' Reports yesterday indicated Russian President Vladimir Putin views the arrival of US troops in Poland as ""a threat"".",155,163,a threat,1,1,2
3RWO3EJELHA5OK5ACMWZ28ZKZK11PA,"#15-1 Putin calls US troops in Poland 'a threat' Reports yesterday indicated Russian President Vladimir Putin views the arrival of US troops in Poland as ""a threat"".",157,163,threat,1,3,4
3RWO3EJELHA5OK5ACMWZ28ZKZK11PA,"#15-2 US troops and tanks in Poland in 2015, as part of an earlier deployment under Operation Atlantic Resolve.",67,77,deployment,10,10,20
3RWO3EJELHA5OK5ACMWZ28ZKZK11PA,"#15-2 US troops and tanks in Poland in 2015, as part of an earlier deployment under Operation Atlantic Resolve.",84,93,Operation,1,0,1
3RWO3EJELHA5OK5ACMWZ28ZKZK11PA,"#15-2 US troops and tanks in Poland in 2015, as part of an earlier deployment under Operation Atlantic Resolve.",84,110,Operation Atlantic Resolve,1,2,3
3RWO3EJELHA5OK5ACMWZ28ZKZK11PA,"#15-2 US troops and tanks in Poland in 2015, as part of an earlier deployment under Operation Atlantic Resolve.",103,110,Resolve,3,1,4
3RWO3EJELHA5OK5ACMWZ28ZKZK11PA,"#15-3 Earlier this week around a quarter of 4,000 troops earmarked for Poland crossed into Poland from Germany.",33,40,quarter,2,2,4
3RWO3EJELHA5OK5ACMWZ28ZKZK11PA,"#15-3 Earlier this week around a quarter of 4,000 troops earmarked for Poland crossed into Poland from Germany.",50,56,troops,1,0,1
3RWO3EJELHA5OK5ACMWZ28ZKZK11PA,"#15-3 Earlier this week around a quarter of 4,000 troops earmarked for Poland crossed into Poland from Germany.",57,66,earmarked,8,10,18
3RWO3EJELHA5OK5ACMWZ28ZKZK11PA,"#15-4 Also included were trucks, tanks, and Humvees.",44,51,Humvees,8,3,11
3RWO3EJELHA5OK5ACMWZ28ZKZK11PA,"#15-5 Many are set to be based in Żagań, where Polish Prime Minister Beata Szydło and Defence Minister Antoni Macierewicz are scheduled to ceremonially welcome them tomorrow.",25,30,based,1,0,1
3RWO3EJELHA5OK5ACMWZ28ZKZK11PA,"#15-5 Many are set to be based in Żagań, where Polish Prime Minister Beata Szydło and Defence Minister Antoni Macierewicz are scheduled to ceremonially welcome them tomorrow.",34,39,Żagań,2,0,2
3RWO3EJELHA5OK5ACMWZ28ZKZK11PA,"#15-5 Many are set to be based in Żagań, where Polish Prime Minister Beata Szydło and Defence Minister Antoni Macierewicz are scheduled to ceremonially welcome them tomorrow.",47,68,Polish Prime Minister,1,0,1
3RWO3EJELHA5OK5ACMWZ28ZKZK11PA,"#15-5 Many are set to be based in Żagań, where Polish Prime Minister Beata Szydło and Defence Minister Antoni Macierewicz are scheduled to ceremonially welcome them tomorrow.",54,68,Prime Minister,1,0,1
3RWO3EJELHA5OK5ACMWZ28ZKZK11PA,"#15-5 Many are set to be based in Żagań, where Polish Prime Minister Beata Szydło and Defence Minister Antoni Macierewicz are scheduled to ceremonially welcome them tomorrow.",86,102,Defence Minister,1,0,1
3RWO3EJELHA5OK5ACMWZ28ZKZK11PA,"#15-5 Many are set to be based in Żagań, where Polish Prime Minister Beata Szydło and Defence Minister Antoni Macierewicz are scheduled to ceremonially welcome them tomorrow.",110,121,Macierewicz,1,0,1
3RWO3EJELHA5OK5ACMWZ28ZKZK11PA,"#15-5 Many are set to be based in Żagań, where Polish Prime Minister Beata Szydło and Defence Minister Antoni Macierewicz are scheduled to ceremonially welcome them tomorrow.",126,135,scheduled,4,3,7
3RWO3EJELHA5OK5ACMWZ28ZKZK11PA,"#15-5 Many are set to be based in Żagań, where Polish Prime Minister Beata Szydło and Defence Minister Antoni Macierewicz are scheduled to ceremonially welcome them tomorrow.",139,151,ceremonially,10,9,19
3RWO3EJELHA5OK5ACMWZ28ZKZK11PA,"#15-5 Many are set to be based in Żagań, where Polish Prime Minister Beata Szydło and Defence Minister Antoni Macierewicz are scheduled to ceremonially welcome them tomorrow.",165,173,tomorrow,0,1,1
3RWO3EJELHA5OK5ACMWZ28ZKZK11PA,"#15-6 Part of Operation Atlantic Resolve, the deployment is set to include Abrams tanks, Bradley Fighting Vehicles, and Paladin artillery.",46,56,deployment,3,4,7
3RWO3EJELHA5OK5ACMWZ28ZKZK11PA,"#15-6 Part of Operation Atlantic Resolve, the deployment is set to include Abrams tanks, Bradley Fighting Vehicles, and Paladin artillery.",75,87,Abrams tanks,0,1,1
3RWO3EJELHA5OK5ACMWZ28ZKZK11PA,"#15-6 Part of Operation Atlantic Resolve, the deployment is set to include Abrams tanks, Bradley Fighting Vehicles, and Paladin artillery.",89,114,Bradley Fighting Vehicles,1,1,2
3RWO3EJELHA5OK5ACMWZ28ZKZK11PA,"#15-6 Part of Operation Atlantic Resolve, the deployment is set to include Abrams tanks, Bradley Fighting Vehicles, and Paladin artillery.",106,114,Vehicles,1,0,1
3RWO3EJELHA5OK5ACMWZ28ZKZK11PA,"#15-6 Part of Operation Atlantic Resolve, the deployment is set to include Abrams tanks, Bradley Fighting Vehicles, and Paladin artillery.",120,127,Paladin,1,0,1
3RWO3EJELHA5OK5ACMWZ28ZKZK11PA,"#15-6 Part of Operation Atlantic Resolve, the deployment is set to include Abrams tanks, Bradley Fighting Vehicles, and Paladin artillery.",120,137,Paladin artillery,2,2,4
3RWO3EJELHA5OK5ACMWZ28ZKZK11PA,"#15-6 Part of Operation Atlantic Resolve, the deployment is set to include Abrams tanks, Bradley Fighting Vehicles, and Paladin artillery.",128,137,artillery,9,7,16
3RWO3EJELHA5OK5ACMWZ28ZKZK11PA,#15-7 It is the largest deployment of US troops to Europe since the Cold War ended.,24,34,deployment,4,2,6
3RWO3EJELHA5OK5ACMWZ28ZKZK11PA,#15-7 It is the largest deployment of US troops to Europe since the Cold War ended.,68,76,Cold War,1,2,3
3F6045TU7DP2L2SYZAFVVOHOSS799W,"#9-6 The Ministry of Justice and state-run news outlet Agência Brasil said the latest riot started at around 5:00 p.m., local time, on Saturday.",21,28,Justice,0,1,1
3F6045TU7DP2L2SYZAFVVOHOSS799W,"#9-6 The Ministry of Justice and state-run news outlet Agência Brasil said the latest riot started at around 5:00 p.m., local time, on Saturday.",33,42,state-run,3,3,6
3F6045TU7DP2L2SYZAFVVOHOSS799W,"#9-6 The Ministry of Justice and state-run news outlet Agência Brasil said the latest riot started at around 5:00 p.m., local time, on Saturday.",43,54,news outlet,1,0,1
3F6045TU7DP2L2SYZAFVVOHOSS799W,"#9-6 The Ministry of Justice and state-run news outlet Agência Brasil said the latest riot started at around 5:00 p.m., local time, on Saturday.",48,54,outlet,2,1,3
3F6045TU7DP2L2SYZAFVVOHOSS799W,"#9-6 The Ministry of Justice and state-run news outlet Agência Brasil said the latest riot started at around 5:00 p.m., local time, on Saturday.",55,62,Agência,1,0,1
3F6045TU7DP2L2SYZAFVVOHOSS799W,"#9-6 The Ministry of Justice and state-run news outlet Agência Brasil said the latest riot started at around 5:00 p.m., local time, on Saturday.",55,69,Agência Brasil,1,0,1
3F6045TU7DP2L2SYZAFVVOHOSS799W,"#9-6 The Ministry of Justice and state-run news outlet Agência Brasil said the latest riot started at around 5:00 p.m., local time, on Saturday.",86,90,riot,3,8,11
3F6045TU7DP2L2SYZAFVVOHOSS799W,#9-7 It continued until the security forces quelled the riot on Sunday at around 7:15 a.m..,8,17,continued,0,1,1
3F6045TU7DP2L2SYZAFVVOHOSS799W,#9-7 It continued until the security forces quelled the riot on Sunday at around 7:15 a.m..,28,36,security,1,0,1
3F6045TU7DP2L2SYZAFVVOHOSS799W,#9-7 It continued until the security forces quelled the riot on Sunday at around 7:15 a.m..,28,43,security forces,1,0,1
3F6045TU7DP2L2SYZAFVVOHOSS799W,#9-7 It continued until the security forces quelled the riot on Sunday at around 7:15 a.m..,28,51,security forces quelled,1,0,1
3F6045TU7DP2L2SYZAFVVOHOSS799W,#9-7 It continued until the security forces quelled the riot on Sunday at around 7:15 a.m..,44,51,quelled,10,10,20
3F6045TU7DP2L2SYZAFVVOHOSS799W,#9-7 It continued until the security forces quelled the riot on Sunday at around 7:15 a.m..,56,60,riot,0,2,2
3F6045TU7DP2L2SYZAFVVOHOSS799W,#9-8 Agence France Presse (AFP) and Rio de Janeiro newspaper O Globo report that the gang members of the Primeiro Comando da Capital (PCC) and Comando Vermelho were the latest riot's participants.,19,25,Presse,1,0,1
3F6045TU7DP2L2SYZAFVVOHOSS799W,#9-8 Agence France Presse (AFP) and Rio de Janeiro newspaper O Globo report that the gang members of the Primeiro Comando da Capital (PCC) and Comando Vermelho were the latest riot's participants.,43,50,Janeiro,2,0,2
3F6045TU7DP2L2SYZAFVVOHOSS799W,#9-8 Agence France Presse (AFP) and Rio de Janeiro newspaper O Globo report that the gang members of the Primeiro Comando da Capital (PCC) and Comando Vermelho were the latest riot's participants.,85,89,gang,0,2,2
3F6045TU7DP2L2SYZAFVVOHOSS799W,#9-8 Agence France Presse (AFP) and Rio de Janeiro newspaper O Globo report that the gang members of the Primeiro Comando da Capital (PCC) and Comando Vermelho were the latest riot's participants.,85,97,gang members,1,0,1
3F6045TU7DP2L2SYZAFVVOHOSS799W,#9-8 Agence France Presse (AFP) and Rio de Janeiro newspaper O Globo report that the gang members of the Primeiro Comando da Capital (PCC) and Comando Vermelho were the latest riot's participants.,105,113,Primeiro,2,1,3
3F6045TU7DP2L2SYZAFVVOHOSS799W,#9-8 Agence France Presse (AFP) and Rio de Janeiro newspaper O Globo report that the gang members of the Primeiro Comando da Capital (PCC) and Comando Vermelho were the latest riot's participants.,105,132,Primeiro Comando da Capital,1,0,1
3F6045TU7DP2L2SYZAFVVOHOSS799W,#9-8 Agence France Presse (AFP) and Rio de Janeiro newspaper O Globo report that the gang members of the Primeiro Comando da Capital (PCC) and Comando Vermelho were the latest riot's participants.,143,159,Comando Vermelho,2,0,2
3F6045TU7DP2L2SYZAFVVOHOSS799W,#9-8 Agence France Presse (AFP) and Rio de Janeiro newspaper O Globo report that the gang members of the Primeiro Comando da Capital (PCC) and Comando Vermelho were the latest riot's participants.,151,159,Vermelho,1,0,1
3F6045TU7DP2L2SYZAFVVOHOSS799W,#9-8 Agence France Presse (AFP) and Rio de Janeiro newspaper O Globo report that the gang members of the Primeiro Comando da Capital (PCC) and Comando Vermelho were the latest riot's participants.,176,181,riots,0,1,1
3F6045TU7DP2L2SYZAFVVOHOSS799W,#9-8 Agence France Presse (AFP) and Rio de Janeiro newspaper O Globo report that the gang members of the Primeiro Comando da Capital (PCC) and Comando Vermelho were the latest riot's participants.,183,195,participants,3,1,4
3F6045TU7DP2L2SYZAFVVOHOSS799W,#9-9 CNN reports that its participants were PCC and Sindicato do Crime do RN.,26,38,participants,2,1,3
3F6045TU7DP2L2SYZAFVVOHOSS799W,#9-9 CNN reports that its participants were PCC and Sindicato do Crime do RN.,52,70,Sindicato do Crime,1,0,1
3F6045TU7DP2L2SYZAFVVOHOSS799W,#9-10 The gangs had been housed in separate parts of the prison.,16,31,had been housed,0,1,1
3F6045TU7DP2L2SYZAFVVOHOSS799W,#9-10 The gangs had been housed in separate parts of the prison.,25,31,housed,1,3,4
3F6045TU7DP2L2SYZAFVVOHOSS799W,#9-10 The gangs had been housed in separate parts of the prison.,35,43,separate,1,2,3
3F6045TU7DP2L2SYZAFVVOHOSS799W,#9-10 The gangs had been housed in separate parts of the prison.,57,63,prison,1,1,2
3F6045TU7DP2L2SYZAFVVOHOSS799W,#9-11 Six of the ringleaders have been captured and sent to other facilities.,17,28,ringleaders,10,10,20
3F6045TU7DP2L2SYZAFVVOHOSS799W,#9-11 Six of the ringleaders have been captured and sent to other facilities.,39,47,captured,2,5,7
3F6045TU7DP2L2SYZAFVVOHOSS799W,#9-11 Six of the ringleaders have been captured and sent to other facilities.,66,76,facilities,4,5,9
3F6045TU7DP2L2SYZAFVVOHOSS799W,"#9-12 Like other riots this year, overcrowding may have contributed to the latest riot.",17,22,riots,0,1,1
3F6045TU7DP2L2SYZAFVVOHOSS799W,"#9-12 Like other riots this year, overcrowding may have contributed to the latest riot.",34,46,overcrowding,10,9,19
3F6045TU7DP2L2SYZAFVVOHOSS799W,"#9-12 Like other riots this year, overcrowding may have contributed to the latest riot.",56,67,contributed,3,4,7
3F6045TU7DP2L2SYZAFVVOHOSS799W,"#9-12 Like other riots this year, overcrowding may have contributed to the latest riot.",82,86,riot,0,1,1
3F6045TU7DP2L2SYZAFVVOHOSS799W,"#9-13 According to Brazil's justice department, the Alcaçuz prison houses more than 1,000 inmates on a capacity of 620.",36,46,department,1,0,1
3F6045TU7DP2L2SYZAFVVOHOSS799W,"#9-13 According to Brazil's justice department, the Alcaçuz prison houses more than 1,000 inmates on a capacity of 620.",52,59,Alcaçuz,1,1,2
3F6045TU7DP2L2SYZAFVVOHOSS799W,"#9-13 According to Brazil's justice department, the Alcaçuz prison houses more than 1,000 inmates on a capacity of 620.",90,97,inmates,3,6,9
3F6045TU7DP2L2SYZAFVVOHOSS799W,"#9-13 According to Brazil's justice department, the Alcaçuz prison houses more than 1,000 inmates on a capacity of 620.",103,111,capacity,3,1,4
3T2HW4QDUV84J0Z1BUPMXEIWYDAC9G,"#8-4 Robben has won five Bundesliga titles, and four DFB-Pokal titles.",25,35,Bundesliga,3,1,4
3T2HW4QDUV84J0Z1BUPMXEIWYDAC9G,"#8-4 Robben has won five Bundesliga titles, and four DFB-Pokal titles.",25,42,Bundesliga titles,1,1,2
3T2HW4QDUV84J0Z1BUPMXEIWYDAC9G,"#8-4 Robben has won five Bundesliga titles, and four DFB-Pokal titles.",36,42,titles,2,0,2
3T2HW4QDUV84J0Z1BUPMXEIWYDAC9G,"#8-4 Robben has won five Bundesliga titles, and four DFB-Pokal titles.",53,62,DFB-Pokal,0,1,1
3T2HW4QDUV84J0Z1BUPMXEIWYDAC9G,"#8-4 Robben has won five Bundesliga titles, and four DFB-Pokal titles.",53,69,DFB-Pokal titles,1,1,2
3T2HW4QDUV84J0Z1BUPMXEIWYDAC9G,"#8-4 Robben has won five Bundesliga titles, and four DFB-Pokal titles.",63,69,titles,1,2,3
3T2HW4QDUV84J0Z1BUPMXEIWYDAC9G,"#8-5 In 2013, Robben scored the winning goal in the UEFA Champions League final at Wembley Stadium against Bayern's arch rivals Borussia Dortmund.",21,27,scored,1,1,2
3T2HW4QDUV84J0Z1BUPMXEIWYDAC9G,"#8-5 In 2013, Robben scored the winning goal in the UEFA Champions League final at Wembley Stadium against Bayern's arch rivals Borussia Dortmund.",32,39,winning,0,1,1
3T2HW4QDUV84J0Z1BUPMXEIWYDAC9G,"#8-5 In 2013, Robben scored the winning goal in the UEFA Champions League final at Wembley Stadium against Bayern's arch rivals Borussia Dortmund.",32,44,winning goal,0,2,2
3T2HW4QDUV84J0Z1BUPMXEIWYDAC9G,"#8-5 In 2013, Robben scored the winning goal in the UEFA Champions League final at Wembley Stadium against Bayern's arch rivals Borussia Dortmund.",40,44,goal,1,0,1
3T2HW4QDUV84J0Z1BUPMXEIWYDAC9G,"#8-5 In 2013, Robben scored the winning goal in the UEFA Champions League final at Wembley Stadium against Bayern's arch rivals Borussia Dortmund.",52,73,UEFA Champions League,1,0,1
3T2HW4QDUV84J0Z1BUPMXEIWYDAC9G,"#8-5 In 2013, Robben scored the winning goal in the UEFA Champions League final at Wembley Stadium against Bayern's arch rivals Borussia Dortmund.",57,73,Champions League,1,0,1
3T2HW4QDUV84J0Z1BUPMXEIWYDAC9G,"#8-5 In 2013, Robben scored the winning goal in the UEFA Champions League final at Wembley Stadium against Bayern's arch rivals Borussia Dortmund.",67,73,League,4,1,5
3T2HW4QDUV84J0Z1BUPMXEIWYDAC9G,"#8-5 In 2013, Robben scored the winning goal in the UEFA Champions League final at Wembley Stadium against Bayern's arch rivals Borussia Dortmund.",83,98,Wembley Stadium,1,0,1
3T2HW4QDUV84J0Z1BUPMXEIWYDAC9G,"#8-5 In 2013, Robben scored the winning goal in the UEFA Champions League final at Wembley Stadium against Bayern's arch rivals Borussia Dortmund.",107,114,Bayerns,1,0,1
3T2HW4QDUV84J0Z1BUPMXEIWYDAC9G,"#8-5 In 2013, Robben scored the winning goal in the UEFA Champions League final at Wembley Stadium against Bayern's arch rivals Borussia Dortmund.",116,120,arch,2,0,2
3T2HW4QDUV84J0Z1BUPMXEIWYDAC9G,"#8-5 In 2013, Robben scored the winning goal in the UEFA Champions League final at Wembley Stadium against Bayern's arch rivals Borussia Dortmund.",116,127,arch rivals,5,6,11
3T2HW4QDUV84J0Z1BUPMXEIWYDAC9G,"#8-5 In 2013, Robben scored the winning goal in the UEFA Champions League final at Wembley Stadium against Bayern's arch rivals Borussia Dortmund.",121,127,rivals,1,2,3
3T2HW4QDUV84J0Z1BUPMXEIWYDAC9G,"#8-5 In 2013, Robben scored the winning goal in the UEFA Champions League final at Wembley Stadium against Bayern's arch rivals Borussia Dortmund.",128,145,Borussia Dortmund,1,0,1
3T2HW4QDUV84J0Z1BUPMXEIWYDAC9G,"#8-6 After signing the contract, Robben said, ""I'm very happy that I'll be playing a further year for FC Bayern.",11,18,signing,1,1,2
3T2HW4QDUV84J0Z1BUPMXEIWYDAC9G,"#8-6 After signing the contract, Robben said, ""I'm very happy that I'll be playing a further year for FC Bayern.",23,31,contract,1,3,4
3T2HW4QDUV84J0Z1BUPMXEIWYDAC9G,"#8-6 After signing the contract, Robben said, ""I'm very happy that I'll be playing a further year for FC Bayern.",75,82,playing,0,1,1
3T2HW4QDUV84J0Z1BUPMXEIWYDAC9G,"#8-6 After signing the contract, Robben said, ""I'm very happy that I'll be playing a further year for FC Bayern.",85,97,further year,0,1,1
3T2HW4QDUV84J0Z1BUPMXEIWYDAC9G,#8-7 The club is one of the best in the world and Munich has become a second home for me and my family.,9,13,club,0,1,1
3T2HW4QDUV84J0Z1BUPMXEIWYDAC9G,#8-7 The club is one of the best in the world and Munich has become a second home for me and my family.,50,56,Munich,1,0,1
3T2HW4QDUV84J0Z1BUPMXEIWYDAC9G,#8-7 The club is one of the best in the world and Munich has become a second home for me and my family.,70,81,second home,0,1,1
3T2HW4QDUV84J0Z1BUPMXEIWYDAC9G,"#8-8 I want to continue playing at the highest level and win as many trophies as possible.""",15,23,continue,1,1,2
3T2HW4QDUV84J0Z1BUPMXEIWYDAC9G,"#8-8 I want to continue playing at the highest level and win as many trophies as possible.""",39,52,highest level,0,1,1
3T2HW4QDUV84J0Z1BUPMXEIWYDAC9G,"#8-8 I want to continue playing at the highest level and win as many trophies as possible.""",69,77,trophies,9,6,15
3T2HW4QDUV84J0Z1BUPMXEIWYDAC9G,"#8-9 On Sunday, Bayern announced signings of 21-year-old Niklas Süle and 26-year-old Sebastian Rudy from TSG 1899 Hoffenheim who are to join the Bayern squad in July.",23,32,announced,2,3,5
3T2HW4QDUV84J0Z1BUPMXEIWYDAC9G,"#8-9 On Sunday, Bayern announced signings of 21-year-old Niklas Süle and 26-year-old Sebastian Rudy from TSG 1899 Hoffenheim who are to join the Bayern squad in July.",23,41,announced signings,0,1,1
3T2HW4QDUV84J0Z1BUPMXEIWYDAC9G,"#8-9 On Sunday, Bayern announced signings of 21-year-old Niklas Süle and 26-year-old Sebastian Rudy from TSG 1899 Hoffenheim who are to join the Bayern squad in July.",33,41,signings,2,4,6
3T2HW4QDUV84J0Z1BUPMXEIWYDAC9G,"#8-9 On Sunday, Bayern announced signings of 21-year-old Niklas Süle and 26-year-old Sebastian Rudy from TSG 1899 Hoffenheim who are to join the Bayern squad in July.",57,68,Niklas Süle,1,0,1
3T2HW4QDUV84J0Z1BUPMXEIWYDAC9G,"#8-9 On Sunday, Bayern announced signings of 21-year-old Niklas Süle and 26-year-old Sebastian Rudy from TSG 1899 Hoffenheim who are to join the Bayern squad in July.",114,124,Hoffenheim,2,0,2
3T2HW4QDUV84J0Z1BUPMXEIWYDAC9G,"#8-9 On Sunday, Bayern announced signings of 21-year-old Niklas Süle and 26-year-old Sebastian Rudy from TSG 1899 Hoffenheim who are to join the Bayern squad in July.",152,157,squad,3,4,7
3T2HW4QDUV84J0Z1BUPMXEIWYDAC9G,"#8-9 On Sunday, Bayern announced signings of 21-year-old Niklas Süle and 26-year-old Sebastian Rudy from TSG 1899 Hoffenheim who are to join the Bayern squad in July.",152,160,squad in,1,0,1
3T2HW4QDUV84J0Z1BUPMXEIWYDAC9G,#8-10 The German internationals have penned a five-year and a three-year contract respectively.,17,31,internationals,6,1,7
3T2HW4QDUV84J0Z1BUPMXEIWYDAC9G,#8-10 The German internationals have penned a five-year and a three-year contract respectively.,37,43,penned,6,10,16
3T2HW4QDUV84J0Z1BUPMXEIWYDAC9G,#8-10 The German internationals have penned a five-year and a three-year contract respectively.,82,94,respectively,10,5,15
3D1TUISJWI1TGV941FGZ4D35O34IUF,#21-16 This is the Bianchi family's second driver death.,19,26,Bianchi,1,0,1
3D1TUISJWI1TGV941FGZ4D35O34IUF,#21-16 This is the Bianchi family's second driver death.,19,54,Bianchi familys second driver death,1,0,1
3D1TUISJWI1TGV941FGZ4D35O34IUF,#21-16 This is the Bianchi family's second driver death.,43,55,driver death,1,0,1
3D1TUISJWI1TGV941FGZ4D35O34IUF,"#21-17 Lucien Bianchi, the 1968 24 Hours of Le Mans winner and Jules's great uncle, was killed in 1969 during testing at Circuit de la Sarthe, where the 24 Hours of Le Mans race is held.",44,51,Le Mans,1,0,1
3D1TUISJWI1TGV941FGZ4D35O34IUF,"#21-17 Lucien Bianchi, the 1968 24 Hours of Le Mans winner and Jules's great uncle, was killed in 1969 during testing at Circuit de la Sarthe, where the 24 Hours of Le Mans race is held.",71,82,great uncle,2,0,2
3D1TUISJWI1TGV941FGZ4D35O34IUF,"#21-17 Lucien Bianchi, the 1968 24 Hours of Le Mans winner and Jules's great uncle, was killed in 1969 during testing at Circuit de la Sarthe, where the 24 Hours of Le Mans race is held.",110,128,testing at Circuit,1,0,1
3D1TUISJWI1TGV941FGZ4D35O34IUF,"#21-17 Lucien Bianchi, the 1968 24 Hours of Le Mans winner and Jules's great uncle, was killed in 1969 during testing at Circuit de la Sarthe, where the 24 Hours of Le Mans race is held.",121,128,Circuit,2,0,2
3D1TUISJWI1TGV941FGZ4D35O34IUF,"#21-17 Lucien Bianchi, the 1968 24 Hours of Le Mans winner and Jules's great uncle, was killed in 1969 during testing at Circuit de la Sarthe, where the 24 Hours of Le Mans race is held.",121,141,Circuit de la Sarthe,4,0,4
3D1TUISJWI1TGV941FGZ4D35O34IUF,"#21-17 Lucien Bianchi, the 1968 24 Hours of Le Mans winner and Jules's great uncle, was killed in 1969 during testing at Circuit de la Sarthe, where the 24 Hours of Le Mans race is held.",135,141,Sarthe,2,0,2
3D1TUISJWI1TGV941FGZ4D35O34IUF,"#21-17 Lucien Bianchi, the 1968 24 Hours of Le Mans winner and Jules's great uncle, was killed in 1969 during testing at Circuit de la Sarthe, where the 24 Hours of Le Mans race is held.",165,172,Le Mans,1,0,1
3D1TUISJWI1TGV941FGZ4D35O34IUF,"#21-17 Lucien Bianchi, the 1968 24 Hours of Le Mans winner and Jules's great uncle, was killed in 1969 during testing at Circuit de la Sarthe, where the 24 Hours of Le Mans race is held.",165,177,Le Mans race,1,0,1
3D1TUISJWI1TGV941FGZ4D35O34IUF,"#21-17 Lucien Bianchi, the 1968 24 Hours of Le Mans winner and Jules's great uncle, was killed in 1969 during testing at Circuit de la Sarthe, where the 24 Hours of Le Mans race is held.",181,185,held,0,2,2
3D1TUISJWI1TGV941FGZ4D35O34IUF,"#21-18 Upon the news of his death, many drivers sent their condolences through social media.",59,70,condolences,10,10,20
3D1TUISJWI1TGV941FGZ4D35O34IUF,"#21-18 Upon the news of his death, many drivers sent their condolences through social media.",79,91,social media,2,1,3
3D1TUISJWI1TGV941FGZ4D35O34IUF,"#21-19 Bianchi's Marussia team mate Max Chilton tweeted, ""No words can describe what his family and the sport have lost.",17,25,Marussia,1,1,2
3D1TUISJWI1TGV941FGZ4D35O34IUF,"#21-19 Bianchi's Marussia team mate Max Chilton tweeted, ""No words can describe what his family and the sport have lost.",26,35,team mate,1,0,1
3D1TUISJWI1TGV941FGZ4D35O34IUF,"#21-19 Bianchi's Marussia team mate Max Chilton tweeted, ""No words can describe what his family and the sport have lost.",31,35,mate,0,1,1
3D1TUISJWI1TGV941FGZ4D35O34IUF,"#21-19 Bianchi's Marussia team mate Max Chilton tweeted, ""No words can describe what his family and the sport have lost.",48,55,tweeted,5,3,8
3D1TUISJWI1TGV941FGZ4D35O34IUF,"#21-19 Bianchi's Marussia team mate Max Chilton tweeted, ""No words can describe what his family and the sport have lost.",71,79,describe,0,1,1
3D1TUISJWI1TGV941FGZ4D35O34IUF,"#21-20 All I can say [is] it was a pleasure knowing and racing you.""",35,43,pleasure,2,1,3
3D1TUISJWI1TGV941FGZ4D35O34IUF,"#21-20 All I can say [is] it was a pleasure knowing and racing you.""",35,51,pleasure knowing,0,1,1
3D1TUISJWI1TGV941FGZ4D35O34IUF,"#21-20 All I can say [is] it was a pleasure knowing and racing you.""",44,66,knowing and racing you,1,0,1
3D1TUISJWI1TGV941FGZ4D35O34IUF,"#22-1 Former Indian president APJ Abdul Kalam dies at age 83 Portrait of former Indian president Dr. APJ Abdul Kalam, also known as the Missile Man of India; 2008.",61,69,Portrait,5,4,9
3D1TUISJWI1TGV941FGZ4D35O34IUF,"#22-1 Former Indian president APJ Abdul Kalam dies at age 83 Portrait of former Indian president Dr. APJ Abdul Kalam, also known as the Missile Man of India; 2008.",87,96,president,1,0,1
3D1TUISJWI1TGV941FGZ4D35O34IUF,"#22-1 Former Indian president APJ Abdul Kalam dies at age 83 Portrait of former Indian president Dr. APJ Abdul Kalam, also known as the Missile Man of India; 2008.",136,143,Missile,0,1,1
3D1TUISJWI1TGV941FGZ4D35O34IUF,"#22-1 Former Indian president APJ Abdul Kalam dies at age 83 Portrait of former Indian president Dr. APJ Abdul Kalam, also known as the Missile Man of India; 2008.",136,147,Missile Man,3,0,3
3D1TUISJWI1TGV941FGZ4D35O34IUF,"#22-1 Former Indian president APJ Abdul Kalam dies at age 83 Portrait of former Indian president Dr. APJ Abdul Kalam, also known as the Missile Man of India; 2008.",136,156,Missile Man of India,1,0,1
3D1TUISJWI1TGV941FGZ4D35O34IUF,"#22-2 Yesterday, former Indian president APJ Abdul Kalam died at the age of 83 after collapsing at about 6:30 p.m. local time (0000 today UTC) while delivering a speech about Livable Planet Earth at the Indian Institute of Management Shillong, in Meghalaya, India.",17,23,former,0,1,1
3D1TUISJWI1TGV941FGZ4D35O34IUF,"#22-2 Yesterday, former Indian president APJ Abdul Kalam died at the age of 83 after collapsing at about 6:30 p.m. local time (0000 today UTC) while delivering a speech about Livable Planet Earth at the Indian Institute of Management Shillong, in Meghalaya, India.",85,95,collapsing,10,10,20
3D1TUISJWI1TGV941FGZ4D35O34IUF,"#22-2 Yesterday, former Indian president APJ Abdul Kalam died at the age of 83 after collapsing at about 6:30 p.m. local time (0000 today UTC) while delivering a speech about Livable Planet Earth at the Indian Institute of Management Shillong, in Meghalaya, India.",85,98,collapsing at,1,0,1
3D1TUISJWI1TGV941FGZ4D35O34IUF,"#22-2 Yesterday, former Indian president APJ Abdul Kalam died at the age of 83 after collapsing at about 6:30 p.m. local time (0000 today UTC) while delivering a speech about Livable Planet Earth at the Indian Institute of Management Shillong, in Meghalaya, India.",149,159,delivering,6,5,11
3D1TUISJWI1TGV941FGZ4D35O34IUF,"#22-2 Yesterday, former Indian president APJ Abdul Kalam died at the age of 83 after collapsing at about 6:30 p.m. local time (0000 today UTC) while delivering a speech about Livable Planet Earth at the Indian Institute of Management Shillong, in Meghalaya, India.",149,168,delivering a speech,0,1,1
3D1TUISJWI1TGV941FGZ4D35O34IUF,"#22-2 Yesterday, former Indian president APJ Abdul Kalam died at the age of 83 after collapsing at about 6:30 p.m. local time (0000 today UTC) while delivering a speech about Livable Planet Earth at the Indian Institute of Management Shillong, in Meghalaya, India.",162,168,speech,0,1,1
3D1TUISJWI1TGV941FGZ4D35O34IUF,"#22-2 Yesterday, former Indian president APJ Abdul Kalam died at the age of 83 after collapsing at about 6:30 p.m. local time (0000 today UTC) while delivering a speech about Livable Planet Earth at the Indian Institute of Management Shillong, in Meghalaya, India.",175,182,Livable,2,0,2
3D1TUISJWI1TGV941FGZ4D35O34IUF,"#22-2 Yesterday, former Indian president APJ Abdul Kalam died at the age of 83 after collapsing at about 6:30 p.m. local time (0000 today UTC) while delivering a speech about Livable Planet Earth at the Indian Institute of Management Shillong, in Meghalaya, India.",175,195,Livable Planet Earth,1,0,1
3D1TUISJWI1TGV941FGZ4D35O34IUF,"#22-2 Yesterday, former Indian president APJ Abdul Kalam died at the age of 83 after collapsing at about 6:30 p.m. local time (0000 today UTC) while delivering a speech about Livable Planet Earth at the Indian Institute of Management Shillong, in Meghalaya, India.",203,242,Indian Institute of Management Shillong,2,0,2
3D1TUISJWI1TGV941FGZ4D35O34IUF,"#22-2 Yesterday, former Indian president APJ Abdul Kalam died at the age of 83 after collapsing at about 6:30 p.m. local time (0000 today UTC) while delivering a speech about Livable Planet Earth at the Indian Institute of Management Shillong, in Meghalaya, India.",210,219,Institute,1,0,1
3D1TUISJWI1TGV941FGZ4D35O34IUF,"#22-2 Yesterday, former Indian president APJ Abdul Kalam died at the age of 83 after collapsing at about 6:30 p.m. local time (0000 today UTC) while delivering a speech about Livable Planet Earth at the Indian Institute of Management Shillong, in Meghalaya, India.",210,233,Institute of Management,1,0,1
3D1TUISJWI1TGV941FGZ4D35O34IUF,"#22-2 Yesterday, former Indian president APJ Abdul Kalam died at the age of 83 after collapsing at about 6:30 p.m. local time (0000 today UTC) while delivering a speech about Livable Planet Earth at the Indian Institute of Management Shillong, in Meghalaya, India.",210,242,Institute of Management Shillong,1,0,1
3D1TUISJWI1TGV941FGZ4D35O34IUF,"#22-2 Yesterday, former Indian president APJ Abdul Kalam died at the age of 83 after collapsing at about 6:30 p.m. local time (0000 today UTC) while delivering a speech about Livable Planet Earth at the Indian Institute of Management Shillong, in Meghalaya, India.",223,263,"Management Shillong, in Meghalaya, India",1,0,1
3D1TUISJWI1TGV941FGZ4D35O34IUF,"#22-2 Yesterday, former Indian president APJ Abdul Kalam died at the age of 83 after collapsing at about 6:30 p.m. local time (0000 today UTC) while delivering a speech about Livable Planet Earth at the Indian Institute of Management Shillong, in Meghalaya, India.",247,256,Meghalaya,1,0,1
3WPCIUYH1A9X87ET9WPE8K1QDKOTDW,"#3-18 Earlier in 2013, he wrapped himself, half naked, in a cocoon of barbed wire.",26,33,wrapped,3,9,12
3WPCIUYH1A9X87ET9WPE8K1QDKOTDW,"#3-18 Earlier in 2013, he wrapped himself, half naked, in a cocoon of barbed wire.",26,41,wrapped himself,0,1,1
3WPCIUYH1A9X87ET9WPE8K1QDKOTDW,"#3-18 Earlier in 2013, he wrapped himself, half naked, in a cocoon of barbed wire.",43,53,half naked,1,0,1
3WPCIUYH1A9X87ET9WPE8K1QDKOTDW,"#3-18 Earlier in 2013, he wrapped himself, half naked, in a cocoon of barbed wire.",60,66,cocoon,10,6,16
3WPCIUYH1A9X87ET9WPE8K1QDKOTDW,"#3-18 Earlier in 2013, he wrapped himself, half naked, in a cocoon of barbed wire.",70,76,barbed,2,8,10
3WPCIUYH1A9X87ET9WPE8K1QDKOTDW,"#3-18 Earlier in 2013, he wrapped himself, half naked, in a cocoon of barbed wire.",70,81,barbed wire,5,1,6
3WPCIUYH1A9X87ET9WPE8K1QDKOTDW,"#3-19 The following year, he chopped off a part of his right ear lobe with a chef's knife sitting nude on a roof labelling the art as ""Segregation"".",10,19,following,1,0,1
3WPCIUYH1A9X87ET9WPE8K1QDKOTDW,"#3-19 The following year, he chopped off a part of his right ear lobe with a chef's knife sitting nude on a roof labelling the art as ""Segregation"".",29,36,chopped,2,2,4
3WPCIUYH1A9X87ET9WPE8K1QDKOTDW,"#3-19 The following year, he chopped off a part of his right ear lobe with a chef's knife sitting nude on a roof labelling the art as ""Segregation"".",29,40,chopped off,0,4,4
3WPCIUYH1A9X87ET9WPE8K1QDKOTDW,"#3-19 The following year, he chopped off a part of his right ear lobe with a chef's knife sitting nude on a roof labelling the art as ""Segregation"".",61,69,ear lobe,1,0,1
3WPCIUYH1A9X87ET9WPE8K1QDKOTDW,"#3-19 The following year, he chopped off a part of his right ear lobe with a chef's knife sitting nude on a roof labelling the art as ""Segregation"".",65,69,lobe,0,2,2
3WPCIUYH1A9X87ET9WPE8K1QDKOTDW,"#3-19 The following year, he chopped off a part of his right ear lobe with a chef's knife sitting nude on a roof labelling the art as ""Segregation"".",98,102,nude,2,2,4
3WPCIUYH1A9X87ET9WPE8K1QDKOTDW,"#3-19 The following year, he chopped off a part of his right ear lobe with a chef's knife sitting nude on a roof labelling the art as ""Segregation"".",113,122,labelling,3,2,5
3WPCIUYH1A9X87ET9WPE8K1QDKOTDW,"#3-19 The following year, he chopped off a part of his right ear lobe with a chef's knife sitting nude on a roof labelling the art as ""Segregation"".",135,146,Segregation,10,9,19
3WPCIUYH1A9X87ET9WPE8K1QDKOTDW,"#3-20 About returning to Russia, Pavlensky told BBC, ""I have no desire to return like a lamb to the slaughter, especially a slaughter that is desired, by the state.""",12,21,returning,1,0,1
3WPCIUYH1A9X87ET9WPE8K1QDKOTDW,"#3-20 About returning to Russia, Pavlensky told BBC, ""I have no desire to return like a lamb to the slaughter, especially a slaughter that is desired, by the state.""",33,42,Pavlensky,1,2,3
3WPCIUYH1A9X87ET9WPE8K1QDKOTDW,"#3-20 About returning to Russia, Pavlensky told BBC, ""I have no desire to return like a lamb to the slaughter, especially a slaughter that is desired, by the state.""",88,109,lamb to the slaughter,1,0,1
3WPCIUYH1A9X87ET9WPE8K1QDKOTDW,"#3-20 About returning to Russia, Pavlensky told BBC, ""I have no desire to return like a lamb to the slaughter, especially a slaughter that is desired, by the state.""",100,109,slaughter,10,9,19
3WPCIUYH1A9X87ET9WPE8K1QDKOTDW,"#3-20 About returning to Russia, Pavlensky told BBC, ""I have no desire to return like a lamb to the slaughter, especially a slaughter that is desired, by the state.""",111,121,especially,1,1,2
3WPCIUYH1A9X87ET9WPE8K1QDKOTDW,"#3-20 About returning to Russia, Pavlensky told BBC, ""I have no desire to return like a lamb to the slaughter, especially a slaughter that is desired, by the state.""",124,133,slaughter,4,3,7
3WPCIUYH1A9X87ET9WPE8K1QDKOTDW,"#3-20 About returning to Russia, Pavlensky told BBC, ""I have no desire to return like a lamb to the slaughter, especially a slaughter that is desired, by the state.""",142,149,desired,0,1,1
3WPCIUYH1A9X87ET9WPE8K1QDKOTDW,#3-21 Pavlensky and Oksana are liable to be sentenced to a ten-year jail term if found guilty.,20,26,Oksana,0,1,1
3WPCIUYH1A9X87ET9WPE8K1QDKOTDW,#3-21 Pavlensky and Oksana are liable to be sentenced to a ten-year jail term if found guilty.,31,37,liable,7,4,11
3WPCIUYH1A9X87ET9WPE8K1QDKOTDW,#3-21 Pavlensky and Oksana are liable to be sentenced to a ten-year jail term if found guilty.,44,53,sentenced,2,3,5
3WPCIUYH1A9X87ET9WPE8K1QDKOTDW,#3-21 Pavlensky and Oksana are liable to be sentenced to a ten-year jail term if found guilty.,87,93,guilty,5,3,8
3WPCIUYH1A9X87ET9WPE8K1QDKOTDW,"#30-1 Woman fined in Spain under new 'Gag Law' The posted photo of a police vehicle parked in handicapped bay in Petrer, Spain; license number removed.",12,17,fined,0,1,1
3WPCIUYH1A9X87ET9WPE8K1QDKOTDW,"#30-1 Woman fined in Spain under new 'Gag Law' The posted photo of a police vehicle parked in handicapped bay in Petrer, Spain; license number removed.",38,45,Gag Law,1,2,3
3WPCIUYH1A9X87ET9WPE8K1QDKOTDW,"#30-1 Woman fined in Spain under new 'Gag Law' The posted photo of a police vehicle parked in handicapped bay in Petrer, Spain; license number removed.",76,83,vehicle,0,1,1
3WPCIUYH1A9X87ET9WPE8K1QDKOTDW,"#30-1 Woman fined in Spain under new 'Gag Law' The posted photo of a police vehicle parked in handicapped bay in Petrer, Spain; license number removed.",94,105,handicapped,8,3,11
3WPCIUYH1A9X87ET9WPE8K1QDKOTDW,"#30-1 Woman fined in Spain under new 'Gag Law' The posted photo of a police vehicle parked in handicapped bay in Petrer, Spain; license number removed.",94,109,handicapped bay,0,2,2
3WPCIUYH1A9X87ET9WPE8K1QDKOTDW,"#30-1 Woman fined in Spain under new 'Gag Law' The posted photo of a police vehicle parked in handicapped bay in Petrer, Spain; license number removed.",113,119,Petrer,0,1,1
3WPCIUYH1A9X87ET9WPE8K1QDKOTDW,"#30-1 Woman fined in Spain under new 'Gag Law' The posted photo of a police vehicle parked in handicapped bay in Petrer, Spain; license number removed.",128,135,license,4,1,5
3WPCIUYH1A9X87ET9WPE8K1QDKOTDW,#30-2 A woman in Spain has been fined €800 after posting a photograph to her Facebook account of a police vehicle parked in space reserved for disabled/handicapped drivers.,32,37,fined,0,1,1
3WPCIUYH1A9X87ET9WPE8K1QDKOTDW,#30-2 A woman in Spain has been fined €800 after posting a photograph to her Facebook account of a police vehicle parked in space reserved for disabled/handicapped drivers.,49,56,posting,0,1,1
3WPCIUYH1A9X87ET9WPE8K1QDKOTDW,#30-2 A woman in Spain has been fined €800 after posting a photograph to her Facebook account of a police vehicle parked in space reserved for disabled/handicapped drivers.,59,69,photograph,1,0,1
3WPCIUYH1A9X87ET9WPE8K1QDKOTDW,#30-2 A woman in Spain has been fined €800 after posting a photograph to her Facebook account of a police vehicle parked in space reserved for disabled/handicapped drivers.,106,113,vehicle,1,1,2
3WPCIUYH1A9X87ET9WPE8K1QDKOTDW,#30-2 A woman in Spain has been fined €800 after posting a photograph to her Facebook account of a police vehicle parked in space reserved for disabled/handicapped drivers.,130,138,reserved,3,1,4
3WPCIUYH1A9X87ET9WPE8K1QDKOTDW,#30-2 A woman in Spain has been fined €800 after posting a photograph to her Facebook account of a police vehicle parked in space reserved for disabled/handicapped drivers.,143,163,disabled/handicapped,4,0,4
3DIIW4IV8PWUZXFPM9PHR95BPQG4IE,"#38-12 ""Eventually after many incidents of his anger coming to the fore, we dismissed him.",8,18,Eventually,4,4,8
3DIIW4IV8PWUZXFPM9PHR95BPQG4IE,"#38-12 ""Eventually after many incidents of his anger coming to the fore, we dismissed him.",30,39,incidents,8,3,11
3DIIW4IV8PWUZXFPM9PHR95BPQG4IE,"#38-12 ""Eventually after many incidents of his anger coming to the fore, we dismissed him.",47,52,anger,0,1,1
3DIIW4IV8PWUZXFPM9PHR95BPQG4IE,"#38-12 ""Eventually after many incidents of his anger coming to the fore, we dismissed him.",67,71,fore,5,5,10
3DIIW4IV8PWUZXFPM9PHR95BPQG4IE,"#38-12 ""Eventually after many incidents of his anger coming to the fore, we dismissed him.",76,85,dismissed,5,6,11
3DIIW4IV8PWUZXFPM9PHR95BPQG4IE,"#38-14 A video of the shooting, which appeared to have been captured from the point of view of the shooter, was posted on Bryce Williams' Twitter and Facebook pages several hours afterwards.",38,46,appeared,1,1,2
3DIIW4IV8PWUZXFPM9PHR95BPQG4IE,"#38-14 A video of the shooting, which appeared to have been captured from the point of view of the shooter, was posted on Bryce Williams' Twitter and Facebook pages several hours afterwards.",60,68,captured,4,3,7
3DIIW4IV8PWUZXFPM9PHR95BPQG4IE,"#38-14 A video of the shooting, which appeared to have been captured from the point of view of the shooter, was posted on Bryce Williams' Twitter and Facebook pages several hours afterwards.",138,164,Twitter and Facebook pages,1,0,1
3DIIW4IV8PWUZXFPM9PHR95BPQG4IE,"#38-14 A video of the shooting, which appeared to have been captured from the point of view of the shooter, was posted on Bryce Williams' Twitter and Facebook pages several hours afterwards.",179,189,afterwards,3,3,6
3DIIW4IV8PWUZXFPM9PHR95BPQG4IE,"#39-1 Austrian police find dozens dead inside lorry To write, edit, start or view other articles on Austria, see the Austria Portal Flag of Austria.svg The turning for Parndorf off the A4, from file.",27,33,dozens,0,1,1
3DIIW4IV8PWUZXFPM9PHR95BPQG4IE,"#39-1 Austrian police find dozens dead inside lorry To write, edit, start or view other articles on Austria, see the Austria Portal Flag of Austria.svg The turning for Parndorf off the A4, from file.",46,51,lorry,3,2,5
3DIIW4IV8PWUZXFPM9PHR95BPQG4IE,"#39-1 Austrian police find dozens dead inside lorry To write, edit, start or view other articles on Austria, see the Austria Portal Flag of Austria.svg The turning for Parndorf off the A4, from file.",46,55,lorry  To,1,0,1
3DIIW4IV8PWUZXFPM9PHR95BPQG4IE,"#39-1 Austrian police find dozens dead inside lorry To write, edit, start or view other articles on Austria, see the Austria Portal Flag of Austria.svg The turning for Parndorf off the A4, from file.",88,96,articles,0,1,1
3DIIW4IV8PWUZXFPM9PHR95BPQG4IE,"#39-1 Austrian police find dozens dead inside lorry To write, edit, start or view other articles on Austria, see the Austria Portal Flag of Austria.svg The turning for Parndorf off the A4, from file.",125,131,Portal,0,1,1
3DIIW4IV8PWUZXFPM9PHR95BPQG4IE,"#39-1 Austrian police find dozens dead inside lorry To write, edit, start or view other articles on Austria, see the Austria Portal Flag of Austria.svg The turning for Parndorf off the A4, from file.",125,137,Portal  Flag,2,0,2
3DIIW4IV8PWUZXFPM9PHR95BPQG4IE,"#39-1 Austrian police find dozens dead inside lorry To write, edit, start or view other articles on Austria, see the Austria Portal Flag of Austria.svg The turning for Parndorf off the A4, from file.",140,151,Austria.svg,1,0,1
3DIIW4IV8PWUZXFPM9PHR95BPQG4IE,"#39-1 Austrian police find dozens dead inside lorry To write, edit, start or view other articles on Austria, see the Austria Portal Flag of Austria.svg The turning for Parndorf off the A4, from file.",168,176,Parndorf,2,1,3
3DIIW4IV8PWUZXFPM9PHR95BPQG4IE,#39-2 The lorry was found on the road nearby.,10,15,lorry,6,1,7
3DIIW4IV8PWUZXFPM9PHR95BPQG4IE,#39-3 Austrian police today found an estimated 20–50 decomposing corpses in an apparently abandoned lorry.,37,46,estimated,3,5,8
3DIIW4IV8PWUZXFPM9PHR95BPQG4IE,#39-3 Austrian police today found an estimated 20–50 decomposing corpses in an apparently abandoned lorry.,53,64,decomposing,5,5,10
3DIIW4IV8PWUZXFPM9PHR95BPQG4IE,#39-3 Austrian police today found an estimated 20–50 decomposing corpses in an apparently abandoned lorry.,53,72,decomposing corpses,6,3,9
3DIIW4IV8PWUZXFPM9PHR95BPQG4IE,#39-3 Austrian police today found an estimated 20–50 decomposing corpses in an apparently abandoned lorry.,65,72,corpses,2,4,6
3DIIW4IV8PWUZXFPM9PHR95BPQG4IE,#39-3 Austrian police today found an estimated 20–50 decomposing corpses in an apparently abandoned lorry.,79,89,apparently,5,3,8
3DIIW4IV8PWUZXFPM9PHR95BPQG4IE,#39-3 Austrian police today found an estimated 20–50 decomposing corpses in an apparently abandoned lorry.,79,99,apparently abandoned,2,3,5
3DIIW4IV8PWUZXFPM9PHR95BPQG4IE,#39-3 Austrian police today found an estimated 20–50 decomposing corpses in an apparently abandoned lorry.,79,105,apparently abandoned lorry,1,0,1
3DIIW4IV8PWUZXFPM9PHR95BPQG4IE,#39-3 Austrian police today found an estimated 20–50 decomposing corpses in an apparently abandoned lorry.,90,99,abandoned,6,5,11
3DIIW4IV8PWUZXFPM9PHR95BPQG4IE,#39-3 Austrian police today found an estimated 20–50 decomposing corpses in an apparently abandoned lorry.,100,105,lorry,4,1,5
3DIIW4IV8PWUZXFPM9PHR95BPQG4IE,"#39-4 Roadworkers who spotted the vehicle, which had been there since yesterday at least, alerted police.",6,17,Roadworkers,3,2,5
3DIIW4IV8PWUZXFPM9PHR95BPQG4IE,"#39-4 Roadworkers who spotted the vehicle, which had been there since yesterday at least, alerted police.",22,29,spotted,0,3,3
3DIIW4IV8PWUZXFPM9PHR95BPQG4IE,"#39-4 Roadworkers who spotted the vehicle, which had been there since yesterday at least, alerted police.",34,41,vehicle,1,0,1
3DIIW4IV8PWUZXFPM9PHR95BPQG4IE,"#39-4 Roadworkers who spotted the vehicle, which had been there since yesterday at least, alerted police.",70,79,yesterday,1,0,1
3DIIW4IV8PWUZXFPM9PHR95BPQG4IE,"#39-4 Roadworkers who spotted the vehicle, which had been there since yesterday at least, alerted police.",90,97,alerted,0,3,3
3DIIW4IV8PWUZXFPM9PHR95BPQG4IE,#39-5 Responding officers found it full of corpses.,6,16,Responding,4,1,5
3DIIW4IV8PWUZXFPM9PHR95BPQG4IE,#39-5 Responding officers found it full of corpses.,43,50,corpses,2,3,5
30F94FBDNRL4TAG9V0Y8DUDQAZDBT8,#11-13 The researchers say this shows the amygdala is likely to control hunting and biting behavior across many or all jawed vertebrates.,11,22,researchers,2,1,3
30F94FBDNRL4TAG9V0Y8DUDQAZDBT8,#11-13 The researchers say this shows the amygdala is likely to control hunting and biting behavior across many or all jawed vertebrates.,42,50,amygdala,10,8,18
30F94FBDNRL4TAG9V0Y8DUDQAZDBT8,#11-13 The researchers say this shows the amygdala is likely to control hunting and biting behavior across many or all jawed vertebrates.,72,79,hunting,0,1,1
30F94FBDNRL4TAG9V0Y8DUDQAZDBT8,#11-13 The researchers say this shows the amygdala is likely to control hunting and biting behavior across many or all jawed vertebrates.,84,90,biting,1,1,2
30F94FBDNRL4TAG9V0Y8DUDQAZDBT8,#11-13 The researchers say this shows the amygdala is likely to control hunting and biting behavior across many or all jawed vertebrates.,84,99,biting behavior,1,0,1
30F94FBDNRL4TAG9V0Y8DUDQAZDBT8,#11-13 The researchers say this shows the amygdala is likely to control hunting and biting behavior across many or all jawed vertebrates.,119,124,jawed,0,3,3
30F94FBDNRL4TAG9V0Y8DUDQAZDBT8,#11-13 The researchers say this shows the amygdala is likely to control hunting and biting behavior across many or all jawed vertebrates.,119,136,jawed vertebrates,3,2,5
30F94FBDNRL4TAG9V0Y8DUDQAZDBT8,#11-13 The researchers say this shows the amygdala is likely to control hunting and biting behavior across many or all jawed vertebrates.,125,136,vertebrates,10,4,14
30F94FBDNRL4TAG9V0Y8DUDQAZDBT8,#11-14 The experiments were funded by national research organizations in the United States and China and the government of Brazil.,11,22,experiments,5,0,5
30F94FBDNRL4TAG9V0Y8DUDQAZDBT8,#11-14 The experiments were funded by national research organizations in the United States and China and the government of Brazil.,28,34,funded,0,2,2
30F94FBDNRL4TAG9V0Y8DUDQAZDBT8,#11-14 The experiments were funded by national research organizations in the United States and China and the government of Brazil.,56,69,organizations,5,1,6
30F94FBDNRL4TAG9V0Y8DUDQAZDBT8,"#11-15 The findings inspired comparisons by the research team and the press to zombies from The Walking Dead, especially since the behavior was more pronounced when the animals were hungry.",20,28,inspired,3,1,4
30F94FBDNRL4TAG9V0Y8DUDQAZDBT8,"#11-15 The findings inspired comparisons by the research team and the press to zombies from The Walking Dead, especially since the behavior was more pronounced when the animals were hungry.",20,40,inspired comparisons,1,1,2
30F94FBDNRL4TAG9V0Y8DUDQAZDBT8,"#11-15 The findings inspired comparisons by the research team and the press to zombies from The Walking Dead, especially since the behavior was more pronounced when the animals were hungry.",29,40,comparisons,0,1,1
30F94FBDNRL4TAG9V0Y8DUDQAZDBT8,"#11-15 The findings inspired comparisons by the research team and the press to zombies from The Walking Dead, especially since the behavior was more pronounced when the animals were hungry.",48,56,research,1,0,1
30F94FBDNRL4TAG9V0Y8DUDQAZDBT8,"#11-15 The findings inspired comparisons by the research team and the press to zombies from The Walking Dead, especially since the behavior was more pronounced when the animals were hungry.",79,86,zombies,4,5,9
30F94FBDNRL4TAG9V0Y8DUDQAZDBT8,"#11-15 The findings inspired comparisons by the research team and the press to zombies from The Walking Dead, especially since the behavior was more pronounced when the animals were hungry.",96,108,Walking Dead,0,1,1
30F94FBDNRL4TAG9V0Y8DUDQAZDBT8,"#11-15 The findings inspired comparisons by the research team and the press to zombies from The Walking Dead, especially since the behavior was more pronounced when the animals were hungry.",110,120,especially,1,0,1
30F94FBDNRL4TAG9V0Y8DUDQAZDBT8,"#11-15 The findings inspired comparisons by the research team and the press to zombies from The Walking Dead, especially since the behavior was more pronounced when the animals were hungry.",131,139,behavior,2,0,2
30F94FBDNRL4TAG9V0Y8DUDQAZDBT8,"#11-15 The findings inspired comparisons by the research team and the press to zombies from The Walking Dead, especially since the behavior was more pronounced when the animals were hungry.",149,159,pronounced,7,4,11
30F94FBDNRL4TAG9V0Y8DUDQAZDBT8,#11-16 Researchers noted the subjects did not attack any of the other mice.,29,37,subjects,0,1,1
30F94FBDNRL4TAG9V0Y8DUDQAZDBT8,#11-16 Researchers noted the subjects did not attack any of the other mice.,70,74,mice,1,1,2
30F94FBDNRL4TAG9V0Y8DUDQAZDBT8,#11-17 The scientists say this shows they were stimulating predatory behavior specifically and not making the animals generally more angry or aggressive.,47,58,stimulating,6,5,11
30F94FBDNRL4TAG9V0Y8DUDQAZDBT8,#11-17 The scientists say this shows they were stimulating predatory behavior specifically and not making the animals generally more angry or aggressive.,47,68,stimulating predatory,3,0,3
30F94FBDNRL4TAG9V0Y8DUDQAZDBT8,#11-17 The scientists say this shows they were stimulating predatory behavior specifically and not making the animals generally more angry or aggressive.,47,77,stimulating predatory behavior,0,1,1
30F94FBDNRL4TAG9V0Y8DUDQAZDBT8,#11-17 The scientists say this shows they were stimulating predatory behavior specifically and not making the animals generally more angry or aggressive.,59,68,predatory,8,4,12
30F94FBDNRL4TAG9V0Y8DUDQAZDBT8,#11-17 The scientists say this shows they were stimulating predatory behavior specifically and not making the animals generally more angry or aggressive.,59,77,predatory behavior,0,2,2
30F94FBDNRL4TAG9V0Y8DUDQAZDBT8,#11-17 The scientists say this shows they were stimulating predatory behavior specifically and not making the animals generally more angry or aggressive.,78,90,specifically,5,0,5
30F94FBDNRL4TAG9V0Y8DUDQAZDBT8,#11-17 The scientists say this shows they were stimulating predatory behavior specifically and not making the animals generally more angry or aggressive.,142,152,aggressive,4,4,8
30F94FBDNRL4TAG9V0Y8DUDQAZDBT8,"#11-18 However, the study did not state whether the laser resembled the light of a full moon.",52,57,laser,1,0,1
30F94FBDNRL4TAG9V0Y8DUDQAZDBT8,"#11-18 However, the study did not state whether the laser resembled the light of a full moon.",58,67,resembled,5,6,11
30F94FBDNRL4TAG9V0Y8DUDQAZDBT8,"#12-1 Man charged over motorway bridge collapse in Kent, England Reports yesterday indicated a 63-year-old man has been charged in connection with the collapse of a pedestrian bridge onto the M20 motorway in Kent, England last year.",23,31,motorway,1,1,2
30F94FBDNRL4TAG9V0Y8DUDQAZDBT8,"#12-1 Man charged over motorway bridge collapse in Kent, England Reports yesterday indicated a 63-year-old man has been charged in connection with the collapse of a pedestrian bridge onto the M20 motorway in Kent, England last year.",23,38,motorway bridge,0,1,1
30F94FBDNRL4TAG9V0Y8DUDQAZDBT8,"#12-1 Man charged over motorway bridge collapse in Kent, England Reports yesterday indicated a 63-year-old man has been charged in connection with the collapse of a pedestrian bridge onto the M20 motorway in Kent, England last year.",39,47,collapse,2,2,4
30F94FBDNRL4TAG9V0Y8DUDQAZDBT8,"#12-1 Man charged over motorway bridge collapse in Kent, England Reports yesterday indicated a 63-year-old man has been charged in connection with the collapse of a pedestrian bridge onto the M20 motorway in Kent, England last year.",83,92,indicated,1,3,4
30F94FBDNRL4TAG9V0Y8DUDQAZDBT8,"#12-1 Man charged over motorway bridge collapse in Kent, England Reports yesterday indicated a 63-year-old man has been charged in connection with the collapse of a pedestrian bridge onto the M20 motorway in Kent, England last year.",120,127,charged,0,1,1
30F94FBDNRL4TAG9V0Y8DUDQAZDBT8,"#12-1 Man charged over motorway bridge collapse in Kent, England Reports yesterday indicated a 63-year-old man has been charged in connection with the collapse of a pedestrian bridge onto the M20 motorway in Kent, England last year.",151,159,collapse,4,0,4
30F94FBDNRL4TAG9V0Y8DUDQAZDBT8,"#12-1 Man charged over motorway bridge collapse in Kent, England Reports yesterday indicated a 63-year-old man has been charged in connection with the collapse of a pedestrian bridge onto the M20 motorway in Kent, England last year.",165,175,pedestrian,9,5,14
30F94FBDNRL4TAG9V0Y8DUDQAZDBT8,"#12-1 Man charged over motorway bridge collapse in Kent, England Reports yesterday indicated a 63-year-old man has been charged in connection with the collapse of a pedestrian bridge onto the M20 motorway in Kent, England last year.",165,182,pedestrian bridge,0,2,2
30F94FBDNRL4TAG9V0Y8DUDQAZDBT8,"#12-1 Man charged over motorway bridge collapse in Kent, England Reports yesterday indicated a 63-year-old man has been charged in connection with the collapse of a pedestrian bridge onto the M20 motorway in Kent, England last year.",196,204,motorway,0,1,1
3UOMW19E6D7LIDXP84C5LYDUCHRC5P,"#42-48 A day after, we counted how many spores were still alive.",23,30,counted,0,1,1
3UOMW19E6D7LIDXP84C5LYDUCHRC5P,"#42-48 A day after, we counted how many spores were still alive.",40,46,spores,7,10,17
3UOMW19E6D7LIDXP84C5LYDUCHRC5P,#42-49 Wikinews: How reliable do you consider your results to be?,21,29,reliable,2,8,10
3UOMW19E6D7LIDXP84C5LYDUCHRC5P,#42-50 NB: The results we got are very reliable.,39,47,reliable,4,3,7
3UOMW19E6D7LIDXP84C5LYDUCHRC5P,"#42-51 We had a lot of colonies containing a lot of ants, and wherever possible we conducted the experiment blind.",23,31,colonies,6,6,12
3UOMW19E6D7LIDXP84C5LYDUCHRC5P,"#42-51 We had a lot of colonies containing a lot of ants, and wherever possible we conducted the experiment blind.",32,42,containing,1,0,1
3UOMW19E6D7LIDXP84C5LYDUCHRC5P,"#42-51 We had a lot of colonies containing a lot of ants, and wherever possible we conducted the experiment blind.",83,92,conducted,4,5,9
3UOMW19E6D7LIDXP84C5LYDUCHRC5P,"#42-51 We had a lot of colonies containing a lot of ants, and wherever possible we conducted the experiment blind.",83,113,conducted the experiment blind,1,0,1
3UOMW19E6D7LIDXP84C5LYDUCHRC5P,"#42-51 We had a lot of colonies containing a lot of ants, and wherever possible we conducted the experiment blind.",97,107,experiment,2,1,3
3UOMW19E6D7LIDXP84C5LYDUCHRC5P,"#42-51 We had a lot of colonies containing a lot of ants, and wherever possible we conducted the experiment blind.",97,113,experiment blind,0,1,1
3UOMW19E6D7LIDXP84C5LYDUCHRC5P,"#42-51 We had a lot of colonies containing a lot of ants, and wherever possible we conducted the experiment blind.",108,113,blind,1,2,3
3UOMW19E6D7LIDXP84C5LYDUCHRC5P,"#42-52 This means the experimenter doesn't know which ants belong to which treatment, so it's impossible to influence the results with 'observer bias'.",22,34,experimenter,4,4,8
3UOMW19E6D7LIDXP84C5LYDUCHRC5P,"#42-52 This means the experimenter doesn't know which ants belong to which treatment, so it's impossible to influence the results with 'observer bias'.",75,84,treatment,1,0,1
3UOMW19E6D7LIDXP84C5LYDUCHRC5P,"#42-52 This means the experimenter doesn't know which ants belong to which treatment, so it's impossible to influence the results with 'observer bias'.",94,104,impossible,1,0,1
3UOMW19E6D7LIDXP84C5LYDUCHRC5P,"#42-52 This means the experimenter doesn't know which ants belong to which treatment, so it's impossible to influence the results with 'observer bias'.",108,117,influence,3,5,8
3UOMW19E6D7LIDXP84C5LYDUCHRC5P,"#42-52 This means the experimenter doesn't know which ants belong to which treatment, so it's impossible to influence the results with 'observer bias'.",136,149,observer bias,7,7,14
3UOMW19E6D7LIDXP84C5LYDUCHRC5P,"#42-52 This means the experimenter doesn't know which ants belong to which treatment, so it's impossible to influence the results with 'observer bias'.",145,149,bias,4,4,8
3UOMW19E6D7LIDXP84C5LYDUCHRC5P,"#42-53 However, of course this is proof in just one species.",34,39,proof,0,2,2
3UOMW19E6D7LIDXP84C5LYDUCHRC5P,"#42-53 However, of course this is proof in just one species.",52,59,species,2,3,5
3UOMW19E6D7LIDXP84C5LYDUCHRC5P,"#42-54 It is hard to extrapolate to other ants, as different species lead very different lives.",21,32,extrapolate,10,10,20
3UOMW19E6D7LIDXP84C5LYDUCHRC5P,"#42-54 It is hard to extrapolate to other ants, as different species lead very different lives.",42,46,ants,0,1,1
3UOMW19E6D7LIDXP84C5LYDUCHRC5P,"#42-54 It is hard to extrapolate to other ants, as different species lead very different lives.",69,73,lead,0,1,1
3UOMW19E6D7LIDXP84C5LYDUCHRC5P,#42-55 Cquote1.svg At the moment it seems that sick ants mostly take care of the problem themselves Cquote2.svg Wikinews: Where did the ants and fungus you used come from?,145,151,fungus,3,4,7
37G6BXQPLQMP8X01ON639X8OTPREQX,"#41-19 Slovak chicken meat company Hyza, a previous owner, previously told Wikinews the lorry has changed hands several times in roughly the last year.",7,13,Slovak,2,2,4
37G6BXQPLQMP8X01ON639X8OTPREQX,"#41-19 Slovak chicken meat company Hyza, a previous owner, previously told Wikinews the lorry has changed hands several times in roughly the last year.",35,39,Hyza,1,1,2
37G6BXQPLQMP8X01ON639X8OTPREQX,"#41-19 Slovak chicken meat company Hyza, a previous owner, previously told Wikinews the lorry has changed hands several times in roughly the last year.",59,69,previously,2,2,4
37G6BXQPLQMP8X01ON639X8OTPREQX,"#41-19 Slovak chicken meat company Hyza, a previous owner, previously told Wikinews the lorry has changed hands several times in roughly the last year.",75,83,Wikinews,2,0,2
37G6BXQPLQMP8X01ON639X8OTPREQX,"#41-19 Slovak chicken meat company Hyza, a previous owner, previously told Wikinews the lorry has changed hands several times in roughly the last year.",84,93,the lorry,0,1,1
37G6BXQPLQMP8X01ON639X8OTPREQX,"#41-19 Slovak chicken meat company Hyza, a previous owner, previously told Wikinews the lorry has changed hands several times in roughly the last year.",88,93,lorry,5,3,8
37G6BXQPLQMP8X01ON639X8OTPREQX,"#41-19 Slovak chicken meat company Hyza, a previous owner, previously told Wikinews the lorry has changed hands several times in roughly the last year.",98,105,changed,0,1,1
37G6BXQPLQMP8X01ON639X8OTPREQX,"#41-19 Slovak chicken meat company Hyza, a previous owner, previously told Wikinews the lorry has changed hands several times in roughly the last year.",98,111,changed hands,1,0,1
37G6BXQPLQMP8X01ON639X8OTPREQX,"#41-19 Slovak chicken meat company Hyza, a previous owner, previously told Wikinews the lorry has changed hands several times in roughly the last year.",129,136,roughly,2,4,6
37G6BXQPLQMP8X01ON639X8OTPREQX,#41-20 After they sold it they say it was exported to Hungary; it now bears Hungarian plates but still features Hyza branding including pictures of meat.,42,50,exported,9,1,10
37G6BXQPLQMP8X01ON639X8OTPREQX,#41-20 After they sold it they say it was exported to Hungary; it now bears Hungarian plates but still features Hyza branding including pictures of meat.,70,75,bears,0,2,2
37G6BXQPLQMP8X01ON639X8OTPREQX,#41-20 After they sold it they say it was exported to Hungary; it now bears Hungarian plates but still features Hyza branding including pictures of meat.,76,85,Hungarian,1,0,1
37G6BXQPLQMP8X01ON639X8OTPREQX,#41-20 After they sold it they say it was exported to Hungary; it now bears Hungarian plates but still features Hyza branding including pictures of meat.,103,111,features,2,3,5
37G6BXQPLQMP8X01ON639X8OTPREQX,#41-20 After they sold it they say it was exported to Hungary; it now bears Hungarian plates but still features Hyza branding including pictures of meat.,117,125,branding,3,4,7
37G6BXQPLQMP8X01ON639X8OTPREQX,#41-20 After they sold it they say it was exported to Hungary; it now bears Hungarian plates but still features Hyza branding including pictures of meat.,126,135,including,1,1,2
37G6BXQPLQMP8X01ON639X8OTPREQX,#41-21 On the day of the discovery Hyza quickly removed a graphic from their homepage featuring cartoon chicken stowaways in a car being inspected at a customs post.,25,34,discovery,2,0,2
37G6BXQPLQMP8X01ON639X8OTPREQX,#41-21 On the day of the discovery Hyza quickly removed a graphic from their homepage featuring cartoon chicken stowaways in a car being inspected at a customs post.,48,55,removed,0,1,1
37G6BXQPLQMP8X01ON639X8OTPREQX,#41-21 On the day of the discovery Hyza quickly removed a graphic from their homepage featuring cartoon chicken stowaways in a car being inspected at a customs post.,58,65,graphic,5,2,7
37G6BXQPLQMP8X01ON639X8OTPREQX,#41-21 On the day of the discovery Hyza quickly removed a graphic from their homepage featuring cartoon chicken stowaways in a car being inspected at a customs post.,58,85,graphic from their homepage,1,0,1
37G6BXQPLQMP8X01ON639X8OTPREQX,#41-21 On the day of the discovery Hyza quickly removed a graphic from their homepage featuring cartoon chicken stowaways in a car being inspected at a customs post.,77,85,homepage,0,2,2
37G6BXQPLQMP8X01ON639X8OTPREQX,#41-21 On the day of the discovery Hyza quickly removed a graphic from their homepage featuring cartoon chicken stowaways in a car being inspected at a customs post.,86,95,featuring,2,0,2
37G6BXQPLQMP8X01ON639X8OTPREQX,#41-21 On the day of the discovery Hyza quickly removed a graphic from their homepage featuring cartoon chicken stowaways in a car being inspected at a customs post.,104,121,chicken stowaways,0,1,1
37G6BXQPLQMP8X01ON639X8OTPREQX,#41-21 On the day of the discovery Hyza quickly removed a graphic from their homepage featuring cartoon chicken stowaways in a car being inspected at a customs post.,112,121,stowaways,9,9,18
37G6BXQPLQMP8X01ON639X8OTPREQX,#41-21 On the day of the discovery Hyza quickly removed a graphic from their homepage featuring cartoon chicken stowaways in a car being inspected at a customs post.,137,146,inspected,3,2,5
37G6BXQPLQMP8X01ON639X8OTPREQX,#41-21 On the day of the discovery Hyza quickly removed a graphic from their homepage featuring cartoon chicken stowaways in a car being inspected at a customs post.,152,159,customs,2,2,4
37G6BXQPLQMP8X01ON639X8OTPREQX,"#41-22 The stowaways also appeared with a line through them alongside the word ""imigranti"".",11,20,stowaways,6,3,9
37G6BXQPLQMP8X01ON639X8OTPREQX,"#41-22 The stowaways also appeared with a line through them alongside the word ""imigranti"".",26,34,appeared,1,1,2
37G6BXQPLQMP8X01ON639X8OTPREQX,"#41-22 The stowaways also appeared with a line through them alongside the word ""imigranti"".",60,69,alongside,1,2,3
37G6BXQPLQMP8X01ON639X8OTPREQX,"#41-22 The stowaways also appeared with a line through them alongside the word ""imigranti"".",80,89,imigranti,8,4,12
37G6BXQPLQMP8X01ON639X8OTPREQX,"#41-23 Police today found 26 migrants in a lorry near Braunau am Inn, Austria.",29,37,migrants,3,4,7
37G6BXQPLQMP8X01ON639X8OTPREQX,"#41-23 Police today found 26 migrants in a lorry near Braunau am Inn, Austria.",43,48,lorry,1,1,2
37G6BXQPLQMP8X01ON639X8OTPREQX,"#41-23 Police today found 26 migrants in a lorry near Braunau am Inn, Austria.",54,61,Braunau,1,1,2
37G6BXQPLQMP8X01ON639X8OTPREQX,"#41-24 The driver, from Romania, refused to stop for police and was arrested following a chase.",33,40,refused,0,2,2
37G6BXQPLQMP8X01ON639X8OTPREQX,"#41-24 The driver, from Romania, refused to stop for police and was arrested following a chase.",68,76,arrested,0,1,1
37G6BXQPLQMP8X01ON639X8OTPREQX,"#41-24 The driver, from Romania, refused to stop for police and was arrested following a chase.",89,94,chase,0,1,1
37G6BXQPLQMP8X01ON639X8OTPREQX,"#41-25 Police said three children were hospitalised for ""severe dehydration"".",39,51,hospitalised,8,2,10
37G6BXQPLQMP8X01ON639X8OTPREQX,"#41-25 Police said three children were hospitalised for ""severe dehydration"".",57,63,severe,2,0,2
37G6BXQPLQMP8X01ON639X8OTPREQX,"#41-25 Police said three children were hospitalised for ""severe dehydration"".",57,75,severe dehydration,2,1,3
37G6BXQPLQMP8X01ON639X8OTPREQX,"#41-25 Police said three children were hospitalised for ""severe dehydration"".",64,75,dehydration,10,9,19
3TFJJUELSHQTJGE2QLA7NRAIS70C2O,"#32-2 Everson served as Commissioner of Internal Revenue, the administrative head of the Internal Revenue Service (IRS) from 2003 to 2007, during the George W. Bush administration.",14,20,served,1,2,3
3TFJJUELSHQTJGE2QLA7NRAIS70C2O,"#32-2 Everson served as Commissioner of Internal Revenue, the administrative head of the Internal Revenue Service (IRS) from 2003 to 2007, during the George W. Bush administration.",24,36,Commissioner,4,2,6
3TFJJUELSHQTJGE2QLA7NRAIS70C2O,"#32-2 Everson served as Commissioner of Internal Revenue, the administrative head of the Internal Revenue Service (IRS) from 2003 to 2007, during the George W. Bush administration.",24,56,Commissioner of Internal Revenue,1,0,1
3TFJJUELSHQTJGE2QLA7NRAIS70C2O,"#32-2 Everson served as Commissioner of Internal Revenue, the administrative head of the Internal Revenue Service (IRS) from 2003 to 2007, during the George W. Bush administration.",40,48,Internal,1,0,1
3TFJJUELSHQTJGE2QLA7NRAIS70C2O,"#32-2 Everson served as Commissioner of Internal Revenue, the administrative head of the Internal Revenue Service (IRS) from 2003 to 2007, during the George W. Bush administration.",40,56,Internal Revenue,2,2,4
3TFJJUELSHQTJGE2QLA7NRAIS70C2O,"#32-2 Everson served as Commissioner of Internal Revenue, the administrative head of the Internal Revenue Service (IRS) from 2003 to 2007, during the George W. Bush administration.",49,56,Revenue,3,2,5
3TFJJUELSHQTJGE2QLA7NRAIS70C2O,"#32-2 Everson served as Commissioner of Internal Revenue, the administrative head of the Internal Revenue Service (IRS) from 2003 to 2007, during the George W. Bush administration.",62,76,administrative,8,2,10
3TFJJUELSHQTJGE2QLA7NRAIS70C2O,"#32-2 Everson served as Commissioner of Internal Revenue, the administrative head of the Internal Revenue Service (IRS) from 2003 to 2007, during the George W. Bush administration.",89,113,Internal Revenue Service,1,0,1
3TFJJUELSHQTJGE2QLA7NRAIS70C2O,"#32-2 Everson served as Commissioner of Internal Revenue, the administrative head of the Internal Revenue Service (IRS) from 2003 to 2007, during the George W. Bush administration.",89,118,Internal Revenue Service (IRS,0,1,1
3TFJJUELSHQTJGE2QLA7NRAIS70C2O,"#32-2 Everson served as Commissioner of Internal Revenue, the administrative head of the Internal Revenue Service (IRS) from 2003 to 2007, during the George W. Bush administration.",165,179,administration,3,2,5
3TFJJUELSHQTJGE2QLA7NRAIS70C2O,"#32-3 After his departure, he briefly served as CEO of the American Red Cross, worked in the cabinet of Indiana governor Mitch Daniels, and worked for the tax consulting firm alliantgroup.",16,25,departure,7,7,14
3TFJJUELSHQTJGE2QLA7NRAIS70C2O,"#32-3 After his departure, he briefly served as CEO of the American Red Cross, worked in the cabinet of Indiana governor Mitch Daniels, and worked for the tax consulting firm alliantgroup.",30,37,briefly,1,3,4
3TFJJUELSHQTJGE2QLA7NRAIS70C2O,"#32-3 After his departure, he briefly served as CEO of the American Red Cross, worked in the cabinet of Indiana governor Mitch Daniels, and worked for the tax consulting firm alliantgroup.",93,100,cabinet,5,3,8
3TFJJUELSHQTJGE2QLA7NRAIS70C2O,"#32-3 After his departure, he briefly served as CEO of the American Red Cross, worked in the cabinet of Indiana governor Mitch Daniels, and worked for the tax consulting firm alliantgroup.",104,120,Indiana governor,1,0,1
3TFJJUELSHQTJGE2QLA7NRAIS70C2O,"#32-3 After his departure, he briefly served as CEO of the American Red Cross, worked in the cabinet of Indiana governor Mitch Daniels, and worked for the tax consulting firm alliantgroup.",121,134,Mitch Daniels,0,1,1
3TFJJUELSHQTJGE2QLA7NRAIS70C2O,"#32-3 After his departure, he briefly served as CEO of the American Red Cross, worked in the cabinet of Indiana governor Mitch Daniels, and worked for the tax consulting firm alliantgroup.",155,174,tax consulting firm,1,1,2
3TFJJUELSHQTJGE2QLA7NRAIS70C2O,"#32-3 After his departure, he briefly served as CEO of the American Red Cross, worked in the cabinet of Indiana governor Mitch Daniels, and worked for the tax consulting firm alliantgroup.",155,187,tax consulting firm alliantgroup,1,0,1
3TFJJUELSHQTJGE2QLA7NRAIS70C2O,"#32-3 After his departure, he briefly served as CEO of the American Red Cross, worked in the cabinet of Indiana governor Mitch Daniels, and worked for the tax consulting firm alliantgroup.",159,169,consulting,6,2,8
3TFJJUELSHQTJGE2QLA7NRAIS70C2O,"#32-3 After his departure, he briefly served as CEO of the American Red Cross, worked in the cabinet of Indiana governor Mitch Daniels, and worked for the tax consulting firm alliantgroup.",175,187,alliantgroup,6,2,8
3TFJJUELSHQTJGE2QLA7NRAIS70C2O,"#32-4 He announced his candidacy this past March with a sixteen-page open letter in which he outlined the six pillars of his campaign: amnesty for illegal immigrants, reinstatement of the military draft, a promise to serve only a single presidential term, and calls for tax reform, deficit reduction, and corporate responsibility.",9,18,announced,2,1,3
3TFJJUELSHQTJGE2QLA7NRAIS70C2O,"#32-4 He announced his candidacy this past March with a sixteen-page open letter in which he outlined the six pillars of his campaign: amnesty for illegal immigrants, reinstatement of the military draft, a promise to serve only a single presidential term, and calls for tax reform, deficit reduction, and corporate responsibility.",23,32,candidacy,7,7,14
3TFJJUELSHQTJGE2QLA7NRAIS70C2O,"#32-4 He announced his candidacy this past March with a sixteen-page open letter in which he outlined the six pillars of his campaign: amnesty for illegal immigrants, reinstatement of the military draft, a promise to serve only a single presidential term, and calls for tax reform, deficit reduction, and corporate responsibility.",93,101,outlined,0,5,5
3TFJJUELSHQTJGE2QLA7NRAIS70C2O,"#32-4 He announced his candidacy this past March with a sixteen-page open letter in which he outlined the six pillars of his campaign: amnesty for illegal immigrants, reinstatement of the military draft, a promise to serve only a single presidential term, and calls for tax reform, deficit reduction, and corporate responsibility.",110,117,pillars,5,2,7
3TFJJUELSHQTJGE2QLA7NRAIS70C2O,"#32-4 He announced his candidacy this past March with a sixteen-page open letter in which he outlined the six pillars of his campaign: amnesty for illegal immigrants, reinstatement of the military draft, a promise to serve only a single presidential term, and calls for tax reform, deficit reduction, and corporate responsibility.",125,133,campaign,2,1,3
3TFJJUELSHQTJGE2QLA7NRAIS70C2O,"#32-4 He announced his candidacy this past March with a sixteen-page open letter in which he outlined the six pillars of his campaign: amnesty for illegal immigrants, reinstatement of the military draft, a promise to serve only a single presidential term, and calls for tax reform, deficit reduction, and corporate responsibility.",135,142,amnesty,10,3,13
3TFJJUELSHQTJGE2QLA7NRAIS70C2O,"#32-4 He announced his candidacy this past March with a sixteen-page open letter in which he outlined the six pillars of his campaign: amnesty for illegal immigrants, reinstatement of the military draft, a promise to serve only a single presidential term, and calls for tax reform, deficit reduction, and corporate responsibility.",147,154,illegal,1,0,1
3TFJJUELSHQTJGE2QLA7NRAIS70C2O,"#32-4 He announced his candidacy this past March with a sixteen-page open letter in which he outlined the six pillars of his campaign: amnesty for illegal immigrants, reinstatement of the military draft, a promise to serve only a single presidential term, and calls for tax reform, deficit reduction, and corporate responsibility.",147,165,illegal immigrants,0,2,2
3TFJJUELSHQTJGE2QLA7NRAIS70C2O,"#32-4 He announced his candidacy this past March with a sixteen-page open letter in which he outlined the six pillars of his campaign: amnesty for illegal immigrants, reinstatement of the military draft, a promise to serve only a single presidential term, and calls for tax reform, deficit reduction, and corporate responsibility.",155,165,immigrants,6,5,11
3TFJJUELSHQTJGE2QLA7NRAIS70C2O,"#32-4 He announced his candidacy this past March with a sixteen-page open letter in which he outlined the six pillars of his campaign: amnesty for illegal immigrants, reinstatement of the military draft, a promise to serve only a single presidential term, and calls for tax reform, deficit reduction, and corporate responsibility.",167,180,reinstatement,10,10,20
3TFJJUELSHQTJGE2QLA7NRAIS70C2O,"#32-4 He announced his candidacy this past March with a sixteen-page open letter in which he outlined the six pillars of his campaign: amnesty for illegal immigrants, reinstatement of the military draft, a promise to serve only a single presidential term, and calls for tax reform, deficit reduction, and corporate responsibility.",167,202,reinstatement of the military draft,0,1,1
3TFJJUELSHQTJGE2QLA7NRAIS70C2O,"#32-4 He announced his candidacy this past March with a sixteen-page open letter in which he outlined the six pillars of his campaign: amnesty for illegal immigrants, reinstatement of the military draft, a promise to serve only a single presidential term, and calls for tax reform, deficit reduction, and corporate responsibility.",197,202,draft,1,4,5
3TFJJUELSHQTJGE2QLA7NRAIS70C2O,"#32-4 He announced his candidacy this past March with a sixteen-page open letter in which he outlined the six pillars of his campaign: amnesty for illegal immigrants, reinstatement of the military draft, a promise to serve only a single presidential term, and calls for tax reform, deficit reduction, and corporate responsibility.",237,254,presidential term,0,1,1
3TFJJUELSHQTJGE2QLA7NRAIS70C2O,"#32-4 He announced his candidacy this past March with a sixteen-page open letter in which he outlined the six pillars of his campaign: amnesty for illegal immigrants, reinstatement of the military draft, a promise to serve only a single presidential term, and calls for tax reform, deficit reduction, and corporate responsibility.",270,280,tax reform,0,1,1
3TFJJUELSHQTJGE2QLA7NRAIS70C2O,"#32-4 He announced his candidacy this past March with a sixteen-page open letter in which he outlined the six pillars of his campaign: amnesty for illegal immigrants, reinstatement of the military draft, a promise to serve only a single presidential term, and calls for tax reform, deficit reduction, and corporate responsibility.",282,289,deficit,5,2,7
3TFJJUELSHQTJGE2QLA7NRAIS70C2O,"#32-4 He announced his candidacy this past March with a sixteen-page open letter in which he outlined the six pillars of his campaign: amnesty for illegal immigrants, reinstatement of the military draft, a promise to serve only a single presidential term, and calls for tax reform, deficit reduction, and corporate responsibility.",282,299,deficit reduction,0,4,4
3TFJJUELSHQTJGE2QLA7NRAIS70C2O,"#32-4 He announced his candidacy this past March with a sixteen-page open letter in which he outlined the six pillars of his campaign: amnesty for illegal immigrants, reinstatement of the military draft, a promise to serve only a single presidential term, and calls for tax reform, deficit reduction, and corporate responsibility.",305,329,corporate responsibility,0,3,3
3TFJJUELSHQTJGE2QLA7NRAIS70C2O,"#32-4 He announced his candidacy this past March with a sixteen-page open letter in which he outlined the six pillars of his campaign: amnesty for illegal immigrants, reinstatement of the military draft, a promise to serve only a single presidential term, and calls for tax reform, deficit reduction, and corporate responsibility.",315,329,responsibility,0,1,1
3TFJJUELSHQTJGE2QLA7NRAIS70C2O,#32-5 He was excluded from the August 6 Fox News Republican presidential debate and has been excluded from most presidential polls.,13,21,excluded,3,2,5
3TFJJUELSHQTJGE2QLA7NRAIS70C2O,#32-5 He was excluded from the August 6 Fox News Republican presidential debate and has been excluded from most presidential polls.,60,72,presidential,1,1,2
3TFJJUELSHQTJGE2QLA7NRAIS70C2O,#32-5 He was excluded from the August 6 Fox News Republican presidential debate and has been excluded from most presidential polls.,73,79,debate,0,2,2
3TFJJUELSHQTJGE2QLA7NRAIS70C2O,#32-5 He was excluded from the August 6 Fox News Republican presidential debate and has been excluded from most presidential polls.,93,101,excluded,3,1,4
3TFJJUELSHQTJGE2QLA7NRAIS70C2O,#32-5 He was excluded from the August 6 Fox News Republican presidential debate and has been excluded from most presidential polls.,125,130,polls,0,1,1
32TMVRKDGNZ1AR3CDNDQEKBXMUB486,#27-6 He was appointed to the position in June of 2014.,13,22,appointed,10,5,15
32TMVRKDGNZ1AR3CDNDQEKBXMUB486,#27-6 He was appointed to the position in June of 2014.,30,38,position,1,1,2
32TMVRKDGNZ1AR3CDNDQEKBXMUB486,#27-7 Choe was involved with trade talks between the two Koreas in the mid-2000s.,6,10,Choe,0,1,1
32TMVRKDGNZ1AR3CDNDQEKBXMUB486,#27-7 Choe was involved with trade talks between the two Koreas in the mid-2000s.,15,23,involved,3,3,6
32TMVRKDGNZ1AR3CDNDQEKBXMUB486,#27-7 Choe was involved with trade talks between the two Koreas in the mid-2000s.,29,40,trade talks,2,1,3
32TMVRKDGNZ1AR3CDNDQEKBXMUB486,#27-7 Choe was involved with trade talks between the two Koreas in the mid-2000s.,35,40,talks,1,0,1
32TMVRKDGNZ1AR3CDNDQEKBXMUB486,#27-7 Choe was involved with trade talks between the two Koreas in the mid-2000s.,57,63,Koreas,0,1,1
32TMVRKDGNZ1AR3CDNDQEKBXMUB486,"#27-8 In 2004, he attended the opening of the Kaesong Industrial Region, a joint venture of the two nations.",18,26,attended,1,2,3
32TMVRKDGNZ1AR3CDNDQEKBXMUB486,"#27-8 In 2004, he attended the opening of the Kaesong Industrial Region, a joint venture of the two nations.",46,53,Kaesong,1,1,2
32TMVRKDGNZ1AR3CDNDQEKBXMUB486,"#27-8 In 2004, he attended the opening of the Kaesong Industrial Region, a joint venture of the two nations.",46,71,Kaesong Industrial Region,1,0,1
32TMVRKDGNZ1AR3CDNDQEKBXMUB486,"#27-8 In 2004, he attended the opening of the Kaesong Industrial Region, a joint venture of the two nations.",54,64,Industrial,2,1,3
32TMVRKDGNZ1AR3CDNDQEKBXMUB486,"#27-8 In 2004, he attended the opening of the Kaesong Industrial Region, a joint venture of the two nations.",75,80,joint,1,0,1
32TMVRKDGNZ1AR3CDNDQEKBXMUB486,"#27-8 In 2004, he attended the opening of the Kaesong Industrial Region, a joint venture of the two nations.",75,88,joint venture,5,5,10
32TMVRKDGNZ1AR3CDNDQEKBXMUB486,"#27-8 In 2004, he attended the opening of the Kaesong Industrial Region, a joint venture of the two nations.",81,88,venture,6,3,9
32TMVRKDGNZ1AR3CDNDQEKBXMUB486,#27-9 South Korea's Ministry of Unification told both Reuters and BBC it was monitoring the situation but Choe has not been seen publicly since December.,6,18,South Koreas,0,1,1
32TMVRKDGNZ1AR3CDNDQEKBXMUB486,#27-9 South Korea's Ministry of Unification told both Reuters and BBC it was monitoring the situation but Choe has not been seen publicly since December.,20,43,Ministry of Unification,1,0,1
32TMVRKDGNZ1AR3CDNDQEKBXMUB486,#27-9 South Korea's Ministry of Unification told both Reuters and BBC it was monitoring the situation but Choe has not been seen publicly since December.,32,43,Unification,2,4,6
32TMVRKDGNZ1AR3CDNDQEKBXMUB486,#27-9 South Korea's Ministry of Unification told both Reuters and BBC it was monitoring the situation but Choe has not been seen publicly since December.,54,61,Reuters,1,3,4
32TMVRKDGNZ1AR3CDNDQEKBXMUB486,#27-9 South Korea's Ministry of Unification told both Reuters and BBC it was monitoring the situation but Choe has not been seen publicly since December.,77,87,monitoring,7,5,12
32TMVRKDGNZ1AR3CDNDQEKBXMUB486,#27-9 South Korea's Ministry of Unification told both Reuters and BBC it was monitoring the situation but Choe has not been seen publicly since December.,129,137,publicly,3,1,4
32TMVRKDGNZ1AR3CDNDQEKBXMUB486,"#27-10 Back in April, South Korea's National Intelligence Service said executions had been ordered for fifteen officials including a ""forestry official"".",22,34,South Koreas,0,1,1
32TMVRKDGNZ1AR3CDNDQEKBXMUB486,"#27-10 Back in April, South Korea's National Intelligence Service said executions had been ordered for fifteen officials including a ""forestry official"".",71,81,executions,5,9,14
32TMVRKDGNZ1AR3CDNDQEKBXMUB486,"#27-10 Back in April, South Korea's National Intelligence Service said executions had been ordered for fifteen officials including a ""forestry official"".",111,120,officials,0,1,1
32TMVRKDGNZ1AR3CDNDQEKBXMUB486,"#27-10 Back in April, South Korea's National Intelligence Service said executions had been ordered for fifteen officials including a ""forestry official"".",121,130,including,0,1,1
32TMVRKDGNZ1AR3CDNDQEKBXMUB486,"#27-10 Back in April, South Korea's National Intelligence Service said executions had been ordered for fifteen officials including a ""forestry official"".",134,151,forestry official,1,1,2
32TMVRKDGNZ1AR3CDNDQEKBXMUB486,"#27-10 Back in April, South Korea's National Intelligence Service said executions had been ordered for fifteen officials including a ""forestry official"".",134,142,forestry,7,3,10
32TMVRKDGNZ1AR3CDNDQEKBXMUB486,"#27-11 Choe Yong-gon was not mentioned by name, nor is it known now if the report was referring to Choe.",7,20,Choe Yong-gon,0,1,1
32TMVRKDGNZ1AR3CDNDQEKBXMUB486,"#27-11 Choe Yong-gon was not mentioned by name, nor is it known now if the report was referring to Choe.",29,38,mentioned,2,2,4
32TMVRKDGNZ1AR3CDNDQEKBXMUB486,"#27-11 Choe Yong-gon was not mentioned by name, nor is it known now if the report was referring to Choe.",86,95,referring,2,3,5
32TMVRKDGNZ1AR3CDNDQEKBXMUB486,#27-12 Yonhap has attributed roughly 70 executions of officials to Kim Jong-un's rule which began after the death of his father Kim Jong-il in December 2011.,7,13,Yonhap,1,1,2
32TMVRKDGNZ1AR3CDNDQEKBXMUB486,#27-12 Yonhap has attributed roughly 70 executions of officials to Kim Jong-un's rule which began after the death of his father Kim Jong-il in December 2011.,18,28,attributed,8,7,15
32TMVRKDGNZ1AR3CDNDQEKBXMUB486,#27-12 Yonhap has attributed roughly 70 executions of officials to Kim Jong-un's rule which began after the death of his father Kim Jong-il in December 2011.,18,36,attributed roughly,1,0,1
32TMVRKDGNZ1AR3CDNDQEKBXMUB486,#27-12 Yonhap has attributed roughly 70 executions of officials to Kim Jong-un's rule which began after the death of his father Kim Jong-il in December 2011.,29,36,roughly,0,4,4
32TMVRKDGNZ1AR3CDNDQEKBXMUB486,#27-12 Yonhap has attributed roughly 70 executions of officials to Kim Jong-un's rule which began after the death of his father Kim Jong-il in December 2011.,40,50,executions,7,0,7
3DW3BNF1GHJ044MRXJEDNABAZE88VM,#10-14 The US troops are set to rotate around the region every nine months.,14,20,troops,1,0,1
3DW3BNF1GHJ044MRXJEDNABAZE88VM,#10-14 The US troops are set to rotate around the region every nine months.,21,31,are set to,0,1,1
3DW3BNF1GHJ044MRXJEDNABAZE88VM,#10-14 The US troops are set to rotate around the region every nine months.,32,38,rotate,3,3,6
3DW3BNF1GHJ044MRXJEDNABAZE88VM,#10-14 The US troops are set to rotate around the region every nine months.,32,45,rotate around,1,0,1
3DW3BNF1GHJ044MRXJEDNABAZE88VM,#10-14 The US troops are set to rotate around the region every nine months.,50,56,region,3,0,3
3DW3BNF1GHJ044MRXJEDNABAZE88VM,"#10-15 Other planned host nations are Estonia, Latvia, Lithuania, Romania, Bulgaria, and Hungary.",13,20,planned,0,1,1
3DW3BNF1GHJ044MRXJEDNABAZE88VM,"#10-15 Other planned host nations are Estonia, Latvia, Lithuania, Romania, Bulgaria, and Hungary.",21,25,host,2,4,6
3DW3BNF1GHJ044MRXJEDNABAZE88VM,"#10-15 Other planned host nations are Estonia, Latvia, Lithuania, Romania, Bulgaria, and Hungary.",26,33,nations,1,0,1
3DW3BNF1GHJ044MRXJEDNABAZE88VM,"#10-15 Other planned host nations are Estonia, Latvia, Lithuania, Romania, Bulgaria, and Hungary.",38,45,Estonia,1,1,2
3DW3BNF1GHJ044MRXJEDNABAZE88VM,"#10-15 Other planned host nations are Estonia, Latvia, Lithuania, Romania, Bulgaria, and Hungary.",38,83,"Estonia, Latvia, Lithuania, Romania, Bulgaria",1,0,1
3DW3BNF1GHJ044MRXJEDNABAZE88VM,"#10-15 Other planned host nations are Estonia, Latvia, Lithuania, Romania, Bulgaria, and Hungary.",47,53,Latvia,1,1,2
3DW3BNF1GHJ044MRXJEDNABAZE88VM,"#10-15 Other planned host nations are Estonia, Latvia, Lithuania, Romania, Bulgaria, and Hungary.",55,64,Lithuania,1,1,2
3DW3BNF1GHJ044MRXJEDNABAZE88VM,"#10-15 Other planned host nations are Estonia, Latvia, Lithuania, Romania, Bulgaria, and Hungary.",66,73,Romania,0,1,1
3DW3BNF1GHJ044MRXJEDNABAZE88VM,"#10-15 Other planned host nations are Estonia, Latvia, Lithuania, Romania, Bulgaria, and Hungary.",75,83,Bulgaria,0,1,1
3DW3BNF1GHJ044MRXJEDNABAZE88VM,"#10-15 Other planned host nations are Estonia, Latvia, Lithuania, Romania, Bulgaria, and Hungary.",89,96,Hungary,1,0,1
3DW3BNF1GHJ044MRXJEDNABAZE88VM,#10-16 The rotation is due to a treaty with Russia preventing permanent deployment to any particular territory.,11,19,rotation,1,0,1
3DW3BNF1GHJ044MRXJEDNABAZE88VM,#10-16 The rotation is due to a treaty with Russia preventing permanent deployment to any particular territory.,32,38,treaty,6,6,12
3DW3BNF1GHJ044MRXJEDNABAZE88VM,#10-16 The rotation is due to a treaty with Russia preventing permanent deployment to any particular territory.,51,61,preventing,3,2,5
3DW3BNF1GHJ044MRXJEDNABAZE88VM,#10-16 The rotation is due to a treaty with Russia preventing permanent deployment to any particular territory.,51,82,preventing permanent deployment,1,0,1
3DW3BNF1GHJ044MRXJEDNABAZE88VM,#10-16 The rotation is due to a treaty with Russia preventing permanent deployment to any particular territory.,62,71,permanent,1,0,1
3DW3BNF1GHJ044MRXJEDNABAZE88VM,#10-16 The rotation is due to a treaty with Russia preventing permanent deployment to any particular territory.,62,82,permanent deployment,2,0,2
3DW3BNF1GHJ044MRXJEDNABAZE88VM,#10-16 The rotation is due to a treaty with Russia preventing permanent deployment to any particular territory.,72,82,deployment,8,10,18
3DW3BNF1GHJ044MRXJEDNABAZE88VM,#10-16 The rotation is due to a treaty with Russia preventing permanent deployment to any particular territory.,90,110,particular territory,3,0,3
3DW3BNF1GHJ044MRXJEDNABAZE88VM,#10-16 The rotation is due to a treaty with Russia preventing permanent deployment to any particular territory.,101,110,territory,6,5,11
3DW3BNF1GHJ044MRXJEDNABAZE88VM,"#10-17 Russian Deputy Foreign Minister Alexei Mechkov said the incoming troops and vehicles were a ""factor destabilising European security"".",15,21,Deputy,0,1,1
3DW3BNF1GHJ044MRXJEDNABAZE88VM,"#10-17 Russian Deputy Foreign Minister Alexei Mechkov said the incoming troops and vehicles were a ""factor destabilising European security"".",22,29,Foreign,1,0,1
3DW3BNF1GHJ044MRXJEDNABAZE88VM,"#10-17 Russian Deputy Foreign Minister Alexei Mechkov said the incoming troops and vehicles were a ""factor destabilising European security"".",39,53,Alexei Mechkov,1,1,2
3DW3BNF1GHJ044MRXJEDNABAZE88VM,"#10-17 Russian Deputy Foreign Minister Alexei Mechkov said the incoming troops and vehicles were a ""factor destabilising European security"".",63,71,incoming,1,1,2
3DW3BNF1GHJ044MRXJEDNABAZE88VM,"#10-17 Russian Deputy Foreign Minister Alexei Mechkov said the incoming troops and vehicles were a ""factor destabilising European security"".",83,91,vehicles,1,0,1
3DW3BNF1GHJ044MRXJEDNABAZE88VM,"#10-17 Russian Deputy Foreign Minister Alexei Mechkov said the incoming troops and vehicles were a ""factor destabilising European security"".",100,106,factor,1,0,1
3DW3BNF1GHJ044MRXJEDNABAZE88VM,"#10-17 Russian Deputy Foreign Minister Alexei Mechkov said the incoming troops and vehicles were a ""factor destabilising European security"".",100,138,factor destabilising European security,1,0,1
3DW3BNF1GHJ044MRXJEDNABAZE88VM,"#10-17 Russian Deputy Foreign Minister Alexei Mechkov said the incoming troops and vehicles were a ""factor destabilising European security"".",107,120,destabilising,10,9,19
3DW3BNF1GHJ044MRXJEDNABAZE88VM,"#10-18 The presence of US assets ""threatens our interests and our security,"" according to Russian President Vladimir Putin.",11,19,presence,0,1,1
3DW3BNF1GHJ044MRXJEDNABAZE88VM,"#10-18 The presence of US assets ""threatens our interests and our security,"" according to Russian President Vladimir Putin.",23,32,US assets,0,1,1
3DW3BNF1GHJ044MRXJEDNABAZE88VM,"#10-18 The presence of US assets ""threatens our interests and our security,"" according to Russian President Vladimir Putin.",26,32,assets,1,1,2
3DW3BNF1GHJ044MRXJEDNABAZE88VM,"#10-18 The presence of US assets ""threatens our interests and our security,"" according to Russian President Vladimir Putin.",34,43,threatens,1,5,6
3DW3BNF1GHJ044MRXJEDNABAZE88VM,"#10-18 The presence of US assets ""threatens our interests and our security,"" according to Russian President Vladimir Putin.",34,74,threatens our interests and our security,1,0,1
3DW3BNF1GHJ044MRXJEDNABAZE88VM,"#10-18 The presence of US assets ""threatens our interests and our security,"" according to Russian President Vladimir Putin.",66,74,security,1,0,1
3DW3BNF1GHJ044MRXJEDNABAZE88VM,"#10-18 The presence of US assets ""threatens our interests and our security,"" according to Russian President Vladimir Putin.",108,122,Vladimir Putin,1,0,1
3DW3BNF1GHJ044MRXJEDNABAZE88VM,"#10-18 The presence of US assets ""threatens our interests and our security,"" according to Russian President Vladimir Putin.",117,122,Putin,0,1,1
3DW3BNF1GHJ044MRXJEDNABAZE88VM,"#10-19 Putin's administration described the deployment as ""a threat"".",15,29,administration,5,1,6
3DW3BNF1GHJ044MRXJEDNABAZE88VM,"#10-19 Putin's administration described the deployment as ""a threat"".",30,39,described,0,1,1
3DW3BNF1GHJ044MRXJEDNABAZE88VM,"#10-19 Putin's administration described the deployment as ""a threat"".",44,54,deployment,2,1,3
3DW3BNF1GHJ044MRXJEDNABAZE88VM,"#10-19 Putin's administration described the deployment as ""a threat"".",61,67,threat,0,2,2
3DW3BNF1GHJ044MRXJEDNABAZE88VM,#10-20 Polish relations with Russia are strained.,14,23,relations,1,0,1
3DW3BNF1GHJ044MRXJEDNABAZE88VM,#10-20 Polish relations with Russia are strained.,40,48,strained,2,9,11
3DW3BNF1GHJ044MRXJEDNABAZE88VM,"#10-21 Since the annexation of Crimea, Russia has recently been increasing its military presence in Kalingrad.",17,27,annexation,10,10,20
3DW3BNF1GHJ044MRXJEDNABAZE88VM,"#10-21 Since the annexation of Crimea, Russia has recently been increasing its military presence in Kalingrad.",31,37,Crimea,2,1,3
3DW3BNF1GHJ044MRXJEDNABAZE88VM,"#10-21 Since the annexation of Crimea, Russia has recently been increasing its military presence in Kalingrad.",64,74,increasing,1,0,1
3DW3BNF1GHJ044MRXJEDNABAZE88VM,"#10-21 Since the annexation of Crimea, Russia has recently been increasing its military presence in Kalingrad.",88,96,presence,2,0,2
3DW3BNF1GHJ044MRXJEDNABAZE88VM,"#10-21 Since the annexation of Crimea, Russia has recently been increasing its military presence in Kalingrad.",100,109,Kalingrad,1,1,2
3DW3BNF1GHJ044MRXJEDNABAZE88VM,"#10-22 The enclave, Russian territory lying between Poland and Lithuania, now has nuclear-capable Iskander missiles and anti-ship Bastion equipment.",11,18,enclave,4,3,7
3DW3BNF1GHJ044MRXJEDNABAZE88VM,"#10-22 The enclave, Russian territory lying between Poland and Lithuania, now has nuclear-capable Iskander missiles and anti-ship Bastion equipment.",28,37,territory,1,1,2
3DW3BNF1GHJ044MRXJEDNABAZE88VM,"#10-22 The enclave, Russian territory lying between Poland and Lithuania, now has nuclear-capable Iskander missiles and anti-ship Bastion equipment.",63,72,Lithuania,0,1,1
3DW3BNF1GHJ044MRXJEDNABAZE88VM,"#10-22 The enclave, Russian territory lying between Poland and Lithuania, now has nuclear-capable Iskander missiles and anti-ship Bastion equipment.",82,97,nuclear-capable,3,1,4
3DW3BNF1GHJ044MRXJEDNABAZE88VM,"#10-22 The enclave, Russian territory lying between Poland and Lithuania, now has nuclear-capable Iskander missiles and anti-ship Bastion equipment.",98,106,Iskander,2,0,2
3DW3BNF1GHJ044MRXJEDNABAZE88VM,"#10-22 The enclave, Russian territory lying between Poland and Lithuania, now has nuclear-capable Iskander missiles and anti-ship Bastion equipment.",107,115,missiles,1,0,1
3DW3BNF1GHJ044MRXJEDNABAZE88VM,"#10-22 The enclave, Russian territory lying between Poland and Lithuania, now has nuclear-capable Iskander missiles and anti-ship Bastion equipment.",120,129,anti-ship,0,1,1
3DW3BNF1GHJ044MRXJEDNABAZE88VM,"#10-22 The enclave, Russian territory lying between Poland and Lithuania, now has nuclear-capable Iskander missiles and anti-ship Bastion equipment.",130,137,Bastion,1,1,2
3DW3BNF1GHJ044MRXJEDNABAZE88VM,"#10-22 The enclave, Russian territory lying between Poland and Lithuania, now has nuclear-capable Iskander missiles and anti-ship Bastion equipment.",130,147,Bastion equipment,1,0,1
3DW3BNF1GHJ044MRXJEDNABAZE88VM,"#10-22 The enclave, Russian territory lying between Poland and Lithuania, now has nuclear-capable Iskander missiles and anti-ship Bastion equipment.",138,147,equipment,0,1,1
3PKJ68EHDNXK6KNQJYU0XZTF7ARJHR,#6-8 Not everyone has considered Manning's actions to be wrong.,22,32,considered,1,0,1
3PKJ68EHDNXK6KNQJYU0XZTF7ARJHR,#6-8 Not everyone has considered Manning's actions to be wrong.,33,41,Mannings,0,2,2
3PKJ68EHDNXK6KNQJYU0XZTF7ARJHR,#6-8 Not everyone has considered Manning's actions to be wrong.,33,49,Mannings actions,0,1,1
3PKJ68EHDNXK6KNQJYU0XZTF7ARJHR,"#6-9 ""Chelsea Manning exposed serious abuses,"" says Margaret Huang, executive director of the U.S. branch of Amnesty International, ""and as a result her own human rights have been violated.""",6,13,Chelsea,0,1,1
3PKJ68EHDNXK6KNQJYU0XZTF7ARJHR,"#6-9 ""Chelsea Manning exposed serious abuses,"" says Margaret Huang, executive director of the U.S. branch of Amnesty International, ""and as a result her own human rights have been violated.""",22,29,exposed,5,2,7
3PKJ68EHDNXK6KNQJYU0XZTF7ARJHR,"#6-9 ""Chelsea Manning exposed serious abuses,"" says Margaret Huang, executive director of the U.S. branch of Amnesty International, ""and as a result her own human rights have been violated.""",30,37,serious,1,0,1
3PKJ68EHDNXK6KNQJYU0XZTF7ARJHR,"#6-9 ""Chelsea Manning exposed serious abuses,"" says Margaret Huang, executive director of the U.S. branch of Amnesty International, ""and as a result her own human rights have been violated.""",30,44,serious abuses,0,1,1
3PKJ68EHDNXK6KNQJYU0XZTF7ARJHR,"#6-9 ""Chelsea Manning exposed serious abuses,"" says Margaret Huang, executive director of the U.S. branch of Amnesty International, ""and as a result her own human rights have been violated.""",38,44,abuses,1,5,6
3PKJ68EHDNXK6KNQJYU0XZTF7ARJHR,"#6-9 ""Chelsea Manning exposed serious abuses,"" says Margaret Huang, executive director of the U.S. branch of Amnesty International, ""and as a result her own human rights have been violated.""",68,77,executive,1,0,1
3PKJ68EHDNXK6KNQJYU0XZTF7ARJHR,"#6-9 ""Chelsea Manning exposed serious abuses,"" says Margaret Huang, executive director of the U.S. branch of Amnesty International, ""and as a result her own human rights have been violated.""",109,116,Amnesty,5,1,6
3PKJ68EHDNXK6KNQJYU0XZTF7ARJHR,"#6-9 ""Chelsea Manning exposed serious abuses,"" says Margaret Huang, executive director of the U.S. branch of Amnesty International, ""and as a result her own human rights have been violated.""",109,130,Amnesty International,1,0,1
3PKJ68EHDNXK6KNQJYU0XZTF7ARJHR,"#6-9 ""Chelsea Manning exposed serious abuses,"" says Margaret Huang, executive director of the U.S. branch of Amnesty International, ""and as a result her own human rights have been violated.""",117,130,International,2,0,2
3PKJ68EHDNXK6KNQJYU0XZTF7ARJHR,"#6-9 ""Chelsea Manning exposed serious abuses,"" says Margaret Huang, executive director of the U.S. branch of Amnesty International, ""and as a result her own human rights have been violated.""",180,188,violated,8,6,14
3PKJ68EHDNXK6KNQJYU0XZTF7ARJHR,"#6-10 Huang went on to call Obama's order for Manning's release ""long overdue.""",6,11,Huang,0,1,1
3PKJ68EHDNXK6KNQJYU0XZTF7ARJHR,"#6-10 Huang went on to call Obama's order for Manning's release ""long overdue.""",65,77,long overdue,2,3,5
3PKJ68EHDNXK6KNQJYU0XZTF7ARJHR,"#6-10 Huang went on to call Obama's order for Manning's release ""long overdue.""",70,77,overdue,3,4,7
3PKJ68EHDNXK6KNQJYU0XZTF7ARJHR,"#6-11 Despite being a trans woman, Manning was housed in a men's prison, the U.S. Disciplinary Barracks at Fort Leavenworth, Kansas.She spent a long period in solitary confinement and attempted suicide twice in 2016.",6,13,Despite,1,1,2
3PKJ68EHDNXK6KNQJYU0XZTF7ARJHR,"#6-11 Despite being a trans woman, Manning was housed in a men's prison, the U.S. Disciplinary Barracks at Fort Leavenworth, Kansas.She spent a long period in solitary confinement and attempted suicide twice in 2016.",22,27,trans,1,0,1
3PKJ68EHDNXK6KNQJYU0XZTF7ARJHR,"#6-11 Despite being a trans woman, Manning was housed in a men's prison, the U.S. Disciplinary Barracks at Fort Leavenworth, Kansas.She spent a long period in solitary confinement and attempted suicide twice in 2016.",22,33,trans woman,3,3,6
3PKJ68EHDNXK6KNQJYU0XZTF7ARJHR,"#6-11 Despite being a trans woman, Manning was housed in a men's prison, the U.S. Disciplinary Barracks at Fort Leavenworth, Kansas.She spent a long period in solitary confinement and attempted suicide twice in 2016.",47,53,housed,2,1,3
3PKJ68EHDNXK6KNQJYU0XZTF7ARJHR,"#6-11 Despite being a trans woman, Manning was housed in a men's prison, the U.S. Disciplinary Barracks at Fort Leavenworth, Kansas.She spent a long period in solitary confinement and attempted suicide twice in 2016.",82,94,Disciplinary,3,0,3
3PKJ68EHDNXK6KNQJYU0XZTF7ARJHR,"#6-11 Despite being a trans woman, Manning was housed in a men's prison, the U.S. Disciplinary Barracks at Fort Leavenworth, Kansas.She spent a long period in solitary confinement and attempted suicide twice in 2016.",82,103,Disciplinary Barracks,0,1,1
3PKJ68EHDNXK6KNQJYU0XZTF7ARJHR,"#6-11 Despite being a trans woman, Manning was housed in a men's prison, the U.S. Disciplinary Barracks at Fort Leavenworth, Kansas.She spent a long period in solitary confinement and attempted suicide twice in 2016.",82,131,"Disciplinary Barracks at Fort Leavenworth, Kansas",1,0,1
3PKJ68EHDNXK6KNQJYU0XZTF7ARJHR,"#6-11 Despite being a trans woman, Manning was housed in a men's prison, the U.S. Disciplinary Barracks at Fort Leavenworth, Kansas.She spent a long period in solitary confinement and attempted suicide twice in 2016.",95,103,Barracks,1,1,2
3PKJ68EHDNXK6KNQJYU0XZTF7ARJHR,"#6-11 Despite being a trans woman, Manning was housed in a men's prison, the U.S. Disciplinary Barracks at Fort Leavenworth, Kansas.She spent a long period in solitary confinement and attempted suicide twice in 2016.",112,123,Leavenworth,1,0,1
3PKJ68EHDNXK6KNQJYU0XZTF7ARJHR,"#6-11 Despite being a trans woman, Manning was housed in a men's prison, the U.S. Disciplinary Barracks at Fort Leavenworth, Kansas.She spent a long period in solitary confinement and attempted suicide twice in 2016.",159,167,solitary,4,2,6
3PKJ68EHDNXK6KNQJYU0XZTF7ARJHR,"#6-11 Despite being a trans woman, Manning was housed in a men's prison, the U.S. Disciplinary Barracks at Fort Leavenworth, Kansas.She spent a long period in solitary confinement and attempted suicide twice in 2016.",159,179,solitary confinement,6,3,9
3PKJ68EHDNXK6KNQJYU0XZTF7ARJHR,"#6-11 Despite being a trans woman, Manning was housed in a men's prison, the U.S. Disciplinary Barracks at Fort Leavenworth, Kansas.She spent a long period in solitary confinement and attempted suicide twice in 2016.",168,179,confinement,3,8,11
3PKJ68EHDNXK6KNQJYU0XZTF7ARJHR,"#6-11 Despite being a trans woman, Manning was housed in a men's prison, the U.S. Disciplinary Barracks at Fort Leavenworth, Kansas.She spent a long period in solitary confinement and attempted suicide twice in 2016.",184,193,attempted,2,0,2
3PKJ68EHDNXK6KNQJYU0XZTF7ARJHR,"#6-11 Despite being a trans woman, Manning was housed in a men's prison, the U.S. Disciplinary Barracks at Fort Leavenworth, Kansas.She spent a long period in solitary confinement and attempted suicide twice in 2016.",184,201,attempted suicide,1,0,1
3PKJ68EHDNXK6KNQJYU0XZTF7ARJHR,"#6-11 Despite being a trans woman, Manning was housed in a men's prison, the U.S. Disciplinary Barracks at Fort Leavenworth, Kansas.She spent a long period in solitary confinement and attempted suicide twice in 2016.",194,201,suicide,2,2,4
3PKJ68EHDNXK6KNQJYU0XZTF7ARJHR,#6-12 Obama's staff told the press WikiLeaks founder Julian Assange's promise to agree to U.S. extradition if Manning was granted clemency had nothing to do with the decision.,35,44,WikiLeaks,1,0,1
3PKJ68EHDNXK6KNQJYU0XZTF7ARJHR,#6-12 Obama's staff told the press WikiLeaks founder Julian Assange's promise to agree to U.S. extradition if Manning was granted clemency had nothing to do with the decision.,53,68,Julian Assanges,0,1,1
3PKJ68EHDNXK6KNQJYU0XZTF7ARJHR,#6-12 Obama's staff told the press WikiLeaks founder Julian Assange's promise to agree to U.S. extradition if Manning was granted clemency had nothing to do with the decision.,90,106,U.S. extradition,0,1,1
3PKJ68EHDNXK6KNQJYU0XZTF7ARJHR,#6-12 Obama's staff told the press WikiLeaks founder Julian Assange's promise to agree to U.S. extradition if Manning was granted clemency had nothing to do with the decision.,95,106,extradition,7,4,11
3PKJ68EHDNXK6KNQJYU0XZTF7ARJHR,#6-12 Obama's staff told the press WikiLeaks founder Julian Assange's promise to agree to U.S. extradition if Manning was granted clemency had nothing to do with the decision.,122,129,granted,0,1,1
3PKJ68EHDNXK6KNQJYU0XZTF7ARJHR,#6-12 Obama's staff told the press WikiLeaks founder Julian Assange's promise to agree to U.S. extradition if Manning was granted clemency had nothing to do with the decision.,122,138,granted clemency,2,0,2
3PKJ68EHDNXK6KNQJYU0XZTF7ARJHR,#6-12 Obama's staff told the press WikiLeaks founder Julian Assange's promise to agree to U.S. extradition if Manning was granted clemency had nothing to do with the decision.,130,138,clemency,9,9,18
3PKJ68EHDNXK6KNQJYU0XZTF7ARJHR,"#6-13 Assange is currently living in the Ecuadorian embassy in London, where he is claiming asylum.",6,13,Assange,1,2,3
3PKJ68EHDNXK6KNQJYU0XZTF7ARJHR,"#6-13 Assange is currently living in the Ecuadorian embassy in London, where he is claiming asylum.",41,51,Ecuadorian,1,1,2
3PKJ68EHDNXK6KNQJYU0XZTF7ARJHR,"#6-13 Assange is currently living in the Ecuadorian embassy in London, where he is claiming asylum.",52,59,embassy,3,0,3
3PKJ68EHDNXK6KNQJYU0XZTF7ARJHR,"#6-13 Assange is currently living in the Ecuadorian embassy in London, where he is claiming asylum.",83,91,claiming,0,1,1
3PKJ68EHDNXK6KNQJYU0XZTF7ARJHR,"#6-13 Assange is currently living in the Ecuadorian embassy in London, where he is claiming asylum.",83,98,claiming asylum,2,2,4
3PKJ68EHDNXK6KNQJYU0XZTF7ARJHR,"#6-13 Assange is currently living in the Ecuadorian embassy in London, where he is claiming asylum.",92,98,asylum,7,8,15
3H1C3QRA01KLEWQIJ558PSJ7PAQECS,#24-25 Nobody had thought twice about it then.,26,31,twice,0,1,1
3H1C3QRA01KLEWQIJ558PSJ7PAQECS,"#24-26 When he heard about the discovery in Vabbinfaru resort we immediately called the Police,"" said Mohamed Ibrahim, a councilman for Fehendhoo Island, to Haveeru Daily.",15,20,heard,0,1,1
3H1C3QRA01KLEWQIJ558PSJ7PAQECS,"#24-26 When he heard about the discovery in Vabbinfaru resort we immediately called the Police,"" said Mohamed Ibrahim, a councilman for Fehendhoo Island, to Haveeru Daily.",31,40,discovery,7,3,10
3H1C3QRA01KLEWQIJ558PSJ7PAQECS,"#24-26 When he heard about the discovery in Vabbinfaru resort we immediately called the Police,"" said Mohamed Ibrahim, a councilman for Fehendhoo Island, to Haveeru Daily.",44,54,Vabbinfaru,1,3,4
3H1C3QRA01KLEWQIJ558PSJ7PAQECS,"#24-26 When he heard about the discovery in Vabbinfaru resort we immediately called the Police,"" said Mohamed Ibrahim, a councilman for Fehendhoo Island, to Haveeru Daily.",44,61,Vabbinfaru resort,1,0,1
3H1C3QRA01KLEWQIJ558PSJ7PAQECS,"#24-26 When he heard about the discovery in Vabbinfaru resort we immediately called the Police,"" said Mohamed Ibrahim, a councilman for Fehendhoo Island, to Haveeru Daily.",55,61,resort,1,0,1
3H1C3QRA01KLEWQIJ558PSJ7PAQECS,"#24-26 When he heard about the discovery in Vabbinfaru resort we immediately called the Police,"" said Mohamed Ibrahim, a councilman for Fehendhoo Island, to Haveeru Daily.",65,76,immediately,3,0,3
3H1C3QRA01KLEWQIJ558PSJ7PAQECS,"#24-26 When he heard about the discovery in Vabbinfaru resort we immediately called the Police,"" said Mohamed Ibrahim, a councilman for Fehendhoo Island, to Haveeru Daily.",65,83,immediately called,0,1,1
3H1C3QRA01KLEWQIJ558PSJ7PAQECS,"#24-26 When he heard about the discovery in Vabbinfaru resort we immediately called the Police,"" said Mohamed Ibrahim, a councilman for Fehendhoo Island, to Haveeru Daily.",102,117,Mohamed Ibrahim,0,1,1
3H1C3QRA01KLEWQIJ558PSJ7PAQECS,"#24-26 When he heard about the discovery in Vabbinfaru resort we immediately called the Police,"" said Mohamed Ibrahim, a councilman for Fehendhoo Island, to Haveeru Daily.",121,131,councilman,9,6,15
3H1C3QRA01KLEWQIJ558PSJ7PAQECS,"#24-26 When he heard about the discovery in Vabbinfaru resort we immediately called the Police,"" said Mohamed Ibrahim, a councilman for Fehendhoo Island, to Haveeru Daily.",136,145,Fehendhoo,1,1,2
3H1C3QRA01KLEWQIJ558PSJ7PAQECS,"#24-26 When he heard about the discovery in Vabbinfaru resort we immediately called the Police,"" said Mohamed Ibrahim, a councilman for Fehendhoo Island, to Haveeru Daily.",136,152,Fehendhoo Island,2,0,2
3H1C3QRA01KLEWQIJ558PSJ7PAQECS,"#24-26 When he heard about the discovery in Vabbinfaru resort we immediately called the Police,"" said Mohamed Ibrahim, a councilman for Fehendhoo Island, to Haveeru Daily.",157,164,Haveeru,1,2,3
3H1C3QRA01KLEWQIJ558PSJ7PAQECS,"#24-27 MH370, while flying from Kuala Lumpur, Malaysia to Beijing, China, vanished without a trace on March 8, 2014.",32,44,Kuala Lumpur,1,1,2
3H1C3QRA01KLEWQIJ558PSJ7PAQECS,"#24-27 MH370, while flying from Kuala Lumpur, Malaysia to Beijing, China, vanished without a trace on March 8, 2014.",74,82,vanished,6,10,16
3H1C3QRA01KLEWQIJ558PSJ7PAQECS,"#24-27 MH370, while flying from Kuala Lumpur, Malaysia to Beijing, China, vanished without a trace on March 8, 2014.",83,98,without a trace,1,0,1
3H1C3QRA01KLEWQIJ558PSJ7PAQECS,"#24-27 MH370, while flying from Kuala Lumpur, Malaysia to Beijing, China, vanished without a trace on March 8, 2014.",93,98,trace,3,4,7
3H1C3QRA01KLEWQIJ558PSJ7PAQECS,#24-28 All 239 passengers and crew are believed to be dead.,15,25,passengers,3,1,4
3H1C3QRA01KLEWQIJ558PSJ7PAQECS,#24-28 All 239 passengers and crew are believed to be dead.,30,34,crew,1,3,4
3H1C3QRA01KLEWQIJ558PSJ7PAQECS,#24-28 All 239 passengers and crew are believed to be dead.,39,47,believed,1,0,1
3H1C3QRA01KLEWQIJ558PSJ7PAQECS,"#24-29 On the day the plane went missing, residents on the small Maldive island of Kudahuvadhoo claimed to have seen a very ""low flying jumbo jet"" crash into the Indian Ocean.",42,51,residents,2,2,4
3H1C3QRA01KLEWQIJ558PSJ7PAQECS,"#24-29 On the day the plane went missing, residents on the small Maldive island of Kudahuvadhoo claimed to have seen a very ""low flying jumbo jet"" crash into the Indian Ocean.",65,72,Maldive,0,1,1
3H1C3QRA01KLEWQIJ558PSJ7PAQECS,"#24-29 On the day the plane went missing, residents on the small Maldive island of Kudahuvadhoo claimed to have seen a very ""low flying jumbo jet"" crash into the Indian Ocean.",83,95,Kudahuvadhoo,3,2,5
3H1C3QRA01KLEWQIJ558PSJ7PAQECS,"#24-29 On the day the plane went missing, residents on the small Maldive island of Kudahuvadhoo claimed to have seen a very ""low flying jumbo jet"" crash into the Indian Ocean.",96,103,claimed,0,3,3
3H1C3QRA01KLEWQIJ558PSJ7PAQECS,"#24-29 On the day the plane went missing, residents on the small Maldive island of Kudahuvadhoo claimed to have seen a very ""low flying jumbo jet"" crash into the Indian Ocean.",125,145,low flying jumbo jet,1,1,2
3H1C3QRA01KLEWQIJ558PSJ7PAQECS,"#24-29 On the day the plane went missing, residents on the small Maldive island of Kudahuvadhoo claimed to have seen a very ""low flying jumbo jet"" crash into the Indian Ocean.",136,145,jumbo jet,1,0,1
3H1C3QRA01KLEWQIJ558PSJ7PAQECS,"#24-29 On the day the plane went missing, residents on the small Maldive island of Kudahuvadhoo claimed to have seen a very ""low flying jumbo jet"" crash into the Indian Ocean.",147,152,crash,0,1,1
3H1C3QRA01KLEWQIJ558PSJ7PAQECS,#24-30 Some also noted the colors appeared to resemble that of a Malaysia Airlines plane.,34,42,appeared,2,1,3
3H1C3QRA01KLEWQIJ558PSJ7PAQECS,#24-30 Some also noted the colors appeared to resemble that of a Malaysia Airlines plane.,46,54,resemble,10,9,19
3H1C3QRA01KLEWQIJ558PSJ7PAQECS,#24-30 Some also noted the colors appeared to resemble that of a Malaysia Airlines plane.,65,73,Malaysia,0,1,1
3H1C3QRA01KLEWQIJ558PSJ7PAQECS,#24-30 Some also noted the colors appeared to resemble that of a Malaysia Airlines plane.,65,82,Malaysia Airlines,1,0,1
3H1C3QRA01KLEWQIJ558PSJ7PAQECS,"#24-32 We've seen seaplanes, but I'm sure that this was not one of those.",18,27,seaplanes,8,7,15
38RHULDV9YG68ZY9WFV0M1O29JFIWE,"#26-14 IKEA spokesperson Anna Pilkrona-Godden told BBC News, ""Our thoughts are with those affected,"" and said the store is closed for the time being.",7,11,IKEA,0,1,1
38RHULDV9YG68ZY9WFV0M1O29JFIWE,"#26-14 IKEA spokesperson Anna Pilkrona-Godden told BBC News, ""Our thoughts are with those affected,"" and said the store is closed for the time being.",12,24,spokesperson,7,5,12
38RHULDV9YG68ZY9WFV0M1O29JFIWE,"#26-14 IKEA spokesperson Anna Pilkrona-Godden told BBC News, ""Our thoughts are with those affected,"" and said the store is closed for the time being.",30,45,Pilkrona-Godden,0,1,1
38RHULDV9YG68ZY9WFV0M1O29JFIWE,"#26-14 IKEA spokesperson Anna Pilkrona-Godden told BBC News, ""Our thoughts are with those affected,"" and said the store is closed for the time being.",90,98,affected,3,2,5
38RHULDV9YG68ZY9WFV0M1O29JFIWE,"#26-14 IKEA spokesperson Anna Pilkrona-Godden told BBC News, ""Our thoughts are with those affected,"" and said the store is closed for the time being.",138,148,time being,1,1,2
38RHULDV9YG68ZY9WFV0M1O29JFIWE,"#26-15 Västerås is in central Sweden, approximately 115 km (70 miles) west from the capital Stockholm.",7,15,Västerås,2,1,3
38RHULDV9YG68ZY9WFV0M1O29JFIWE,"#26-15 Västerås is in central Sweden, approximately 115 km (70 miles) west from the capital Stockholm.",38,51,approximately,8,3,11
38RHULDV9YG68ZY9WFV0M1O29JFIWE,"#26-15 Västerås is in central Sweden, approximately 115 km (70 miles) west from the capital Stockholm.",84,91,capital,1,0,1
38RHULDV9YG68ZY9WFV0M1O29JFIWE,"#26-15 Västerås is in central Sweden, approximately 115 km (70 miles) west from the capital Stockholm.",92,101,Stockholm,0,2,2
38RHULDV9YG68ZY9WFV0M1O29JFIWE,#26-16 The population is roughly 110 thousand.,11,21,population,2,2,4
38RHULDV9YG68ZY9WFV0M1O29JFIWE,#26-16 The population is roughly 110 thousand.,25,32,roughly,2,2,4
38RHULDV9YG68ZY9WFV0M1O29JFIWE,#27-1 Report: Vice-premier of North Korea executed A report published Wednesday by the Yonhap News Agency claims vice premier Choe Yong-gon of North Korea was executed in May.,14,26,Vice-premier,4,2,6
38RHULDV9YG68ZY9WFV0M1O29JFIWE,#27-1 Report: Vice-premier of North Korea executed A report published Wednesday by the Yonhap News Agency claims vice premier Choe Yong-gon of North Korea was executed in May.,42,50,executed,3,3,6
38RHULDV9YG68ZY9WFV0M1O29JFIWE,#27-1 Report: Vice-premier of North Korea executed A report published Wednesday by the Yonhap News Agency claims vice premier Choe Yong-gon of North Korea was executed in May.,60,69,published,2,0,2
38RHULDV9YG68ZY9WFV0M1O29JFIWE,#27-1 Report: Vice-premier of North Korea executed A report published Wednesday by the Yonhap News Agency claims vice premier Choe Yong-gon of North Korea was executed in May.,87,93,Yonhap,1,1,2
38RHULDV9YG68ZY9WFV0M1O29JFIWE,#27-1 Report: Vice-premier of North Korea executed A report published Wednesday by the Yonhap News Agency claims vice premier Choe Yong-gon of North Korea was executed in May.,87,105,Yonhap News Agency,1,0,1
38RHULDV9YG68ZY9WFV0M1O29JFIWE,#27-1 Report: Vice-premier of North Korea executed A report published Wednesday by the Yonhap News Agency claims vice premier Choe Yong-gon of North Korea was executed in May.,106,112,claims,0,1,1
38RHULDV9YG68ZY9WFV0M1O29JFIWE,#27-1 Report: Vice-premier of North Korea executed A report published Wednesday by the Yonhap News Agency claims vice premier Choe Yong-gon of North Korea was executed in May.,113,125,vice premier,2,0,2
38RHULDV9YG68ZY9WFV0M1O29JFIWE,#27-1 Report: Vice-premier of North Korea executed A report published Wednesday by the Yonhap News Agency claims vice premier Choe Yong-gon of North Korea was executed in May.,118,125,premier,3,0,3
38RHULDV9YG68ZY9WFV0M1O29JFIWE,#27-1 Report: Vice-premier of North Korea executed A report published Wednesday by the Yonhap News Agency claims vice premier Choe Yong-gon of North Korea was executed in May.,126,139,Choe Yong-gon,0,1,1
38RHULDV9YG68ZY9WFV0M1O29JFIWE,#27-1 Report: Vice-premier of North Korea executed A report published Wednesday by the Yonhap News Agency claims vice premier Choe Yong-gon of North Korea was executed in May.,131,139,Yong-gon,1,0,1
38RHULDV9YG68ZY9WFV0M1O29JFIWE,#27-1 Report: Vice-premier of North Korea executed A report published Wednesday by the Yonhap News Agency claims vice premier Choe Yong-gon of North Korea was executed in May.,159,167,executed,6,5,11
38RHULDV9YG68ZY9WFV0M1O29JFIWE,"#27-2 The report, which cites an unnamed source, has not been confirmed by Wikinews or other agencies.",24,29,cites,2,3,5
38RHULDV9YG68ZY9WFV0M1O29JFIWE,"#27-2 The report, which cites an unnamed source, has not been confirmed by Wikinews or other agencies.",33,40,unnamed,4,3,7
38RHULDV9YG68ZY9WFV0M1O29JFIWE,"#27-2 The report, which cites an unnamed source, has not been confirmed by Wikinews or other agencies.",33,47,unnamed source,1,2,3
38RHULDV9YG68ZY9WFV0M1O29JFIWE,"#27-2 The report, which cites an unnamed source, has not been confirmed by Wikinews or other agencies.",41,47,source,0,1,1
38RHULDV9YG68ZY9WFV0M1O29JFIWE,"#27-2 The report, which cites an unnamed source, has not been confirmed by Wikinews or other agencies.",62,71,confirmed,3,3,6
38RHULDV9YG68ZY9WFV0M1O29JFIWE,"#27-2 The report, which cites an unnamed source, has not been confirmed by Wikinews or other agencies.",75,83,Wikinews,2,0,2
38RHULDV9YG68ZY9WFV0M1O29JFIWE,#27-3 The government of North Korea rarely makes statements about its internal affairs.,36,42,rarely,0,1,1
38RHULDV9YG68ZY9WFV0M1O29JFIWE,#27-3 The government of North Korea rarely makes statements about its internal affairs.,49,59,statements,2,3,5
38RHULDV9YG68ZY9WFV0M1O29JFIWE,#27-3 The government of North Korea rarely makes statements about its internal affairs.,70,78,internal,3,0,3
38RHULDV9YG68ZY9WFV0M1O29JFIWE,#27-3 The government of North Korea rarely makes statements about its internal affairs.,70,86,internal affairs,1,5,6
38RHULDV9YG68ZY9WFV0M1O29JFIWE,#27-3 The government of North Korea rarely makes statements about its internal affairs.,79,86,affairs,1,2,3
38RHULDV9YG68ZY9WFV0M1O29JFIWE,"#27-4 According to the report, the 63-year-old Choe had disagreed with Supreme Leader Kim Jong-un's forestry policies.",47,51,Choe,1,0,1
38RHULDV9YG68ZY9WFV0M1O29JFIWE,"#27-4 According to the report, the 63-year-old Choe had disagreed with Supreme Leader Kim Jong-un's forestry policies.",56,65,disagreed,1,5,6
38RHULDV9YG68ZY9WFV0M1O29JFIWE,"#27-4 According to the report, the 63-year-old Choe had disagreed with Supreme Leader Kim Jong-un's forestry policies.",71,85,Supreme Leader,1,0,1
38RHULDV9YG68ZY9WFV0M1O29JFIWE,"#27-4 According to the report, the 63-year-old Choe had disagreed with Supreme Leader Kim Jong-un's forestry policies.",86,98,Kim Jong-uns,0,1,1
38RHULDV9YG68ZY9WFV0M1O29JFIWE,"#27-4 According to the report, the 63-year-old Choe had disagreed with Supreme Leader Kim Jong-un's forestry policies.",100,108,forestry,6,3,9
38RHULDV9YG68ZY9WFV0M1O29JFIWE,"#27-4 According to the report, the 63-year-old Choe had disagreed with Supreme Leader Kim Jong-un's forestry policies.",100,117,forestry policies,4,2,6
38RHULDV9YG68ZY9WFV0M1O29JFIWE,"#27-4 According to the report, the 63-year-old Choe had disagreed with Supreme Leader Kim Jong-un's forestry policies.",109,117,policies,1,0,1
38RHULDV9YG68ZY9WFV0M1O29JFIWE,"#27-5 Choe, one of seven vice premiers, was in charge of construction and building material industries.",6,10,Choe,1,1,2
38RHULDV9YG68ZY9WFV0M1O29JFIWE,"#27-5 Choe, one of seven vice premiers, was in charge of construction and building material industries.",25,38,vice premiers,4,0,4
38RHULDV9YG68ZY9WFV0M1O29JFIWE,"#27-5 Choe, one of seven vice premiers, was in charge of construction and building material industries.",30,38,premiers,4,1,5
38RHULDV9YG68ZY9WFV0M1O29JFIWE,"#27-5 Choe, one of seven vice premiers, was in charge of construction and building material industries.",47,53,charge,0,1,1
38RHULDV9YG68ZY9WFV0M1O29JFIWE,"#27-5 Choe, one of seven vice premiers, was in charge of construction and building material industries.",57,69,construction,1,0,1
38RHULDV9YG68ZY9WFV0M1O29JFIWE,"#27-5 Choe, one of seven vice premiers, was in charge of construction and building material industries.",74,82,building,0,1,1
38RHULDV9YG68ZY9WFV0M1O29JFIWE,"#27-5 Choe, one of seven vice premiers, was in charge of construction and building material industries.",83,91,material,1,0,1
38RHULDV9YG68ZY9WFV0M1O29JFIWE,"#27-5 Choe, one of seven vice premiers, was in charge of construction and building material industries.",83,102,material industries,1,0,1
38RHULDV9YG68ZY9WFV0M1O29JFIWE,"#27-5 Choe, one of seven vice premiers, was in charge of construction and building material industries.",92,102,industries,0,1,1
34KYK9TV2R93EA3U60TI3PH48GZBSJ,"#11-8 ""We'd turn the laser on and they'd jump on an object, hold it with their paws and intensively bite it as if they were trying to capture and kill it,"" says lead investigator and Yale Associated Professor of Psychiatry Ivan de Araujo.",21,26,laser,2,2,4
34KYK9TV2R93EA3U60TI3PH48GZBSJ,"#11-8 ""We'd turn the laser on and they'd jump on an object, hold it with their paws and intensively bite it as if they were trying to capture and kill it,"" says lead investigator and Yale Associated Professor of Psychiatry Ivan de Araujo.",52,58,object,2,1,3
34KYK9TV2R93EA3U60TI3PH48GZBSJ,"#11-8 ""We'd turn the laser on and they'd jump on an object, hold it with their paws and intensively bite it as if they were trying to capture and kill it,"" says lead investigator and Yale Associated Professor of Psychiatry Ivan de Araujo.",79,83,paws,2,6,8
34KYK9TV2R93EA3U60TI3PH48GZBSJ,"#11-8 ""We'd turn the laser on and they'd jump on an object, hold it with their paws and intensively bite it as if they were trying to capture and kill it,"" says lead investigator and Yale Associated Professor of Psychiatry Ivan de Araujo.",88,99,intensively,10,6,16
34KYK9TV2R93EA3U60TI3PH48GZBSJ,"#11-8 ""We'd turn the laser on and they'd jump on an object, hold it with their paws and intensively bite it as if they were trying to capture and kill it,"" says lead investigator and Yale Associated Professor of Psychiatry Ivan de Araujo.",88,104,intensively bite,0,1,1
34KYK9TV2R93EA3U60TI3PH48GZBSJ,"#11-8 ""We'd turn the laser on and they'd jump on an object, hold it with their paws and intensively bite it as if they were trying to capture and kill it,"" says lead investigator and Yale Associated Professor of Psychiatry Ivan de Araujo.",100,104,bite,0,1,1
34KYK9TV2R93EA3U60TI3PH48GZBSJ,"#11-8 ""We'd turn the laser on and they'd jump on an object, hold it with their paws and intensively bite it as if they were trying to capture and kill it,"" says lead investigator and Yale Associated Professor of Psychiatry Ivan de Araujo.",134,141,capture,0,3,3
34KYK9TV2R93EA3U60TI3PH48GZBSJ,"#11-8 ""We'd turn the laser on and they'd jump on an object, hold it with their paws and intensively bite it as if they were trying to capture and kill it,"" says lead investigator and Yale Associated Professor of Psychiatry Ivan de Araujo.",166,178,investigator,3,2,5
34KYK9TV2R93EA3U60TI3PH48GZBSJ,"#11-8 ""We'd turn the laser on and they'd jump on an object, hold it with their paws and intensively bite it as if they were trying to capture and kill it,"" says lead investigator and Yale Associated Professor of Psychiatry Ivan de Araujo.",188,198,Associated,1,0,1
34KYK9TV2R93EA3U60TI3PH48GZBSJ,"#11-8 ""We'd turn the laser on and they'd jump on an object, hold it with their paws and intensively bite it as if they were trying to capture and kill it,"" says lead investigator and Yale Associated Professor of Psychiatry Ivan de Araujo.",188,208,Associated Professor,0,1,1
34KYK9TV2R93EA3U60TI3PH48GZBSJ,"#11-8 ""We'd turn the laser on and they'd jump on an object, hold it with their paws and intensively bite it as if they were trying to capture and kill it,"" says lead investigator and Yale Associated Professor of Psychiatry Ivan de Araujo.",212,222,Psychiatry,4,2,6
34KYK9TV2R93EA3U60TI3PH48GZBSJ,"#11-8 ""We'd turn the laser on and they'd jump on an object, hold it with their paws and intensively bite it as if they were trying to capture and kill it,"" says lead investigator and Yale Associated Professor of Psychiatry Ivan de Araujo.",231,237,Araujo,1,0,1
34KYK9TV2R93EA3U60TI3PH48GZBSJ,#11-9 The mice behaved normally at all other times.,10,14,mice,0,1,1
34KYK9TV2R93EA3U60TI3PH48GZBSJ,#11-9 The mice behaved normally at all other times.,15,22,behaved,1,2,3
34KYK9TV2R93EA3U60TI3PH48GZBSJ,"#11-10 The work was inspired by Araujo's desire to study natural feeding behavior, as opposed to animals passively munching on food pellets.",20,28,inspired,2,3,5
34KYK9TV2R93EA3U60TI3PH48GZBSJ,"#11-10 The work was inspired by Araujo's desire to study natural feeding behavior, as opposed to animals passively munching on food pellets.",57,81,natural feeding behavior,1,1,2
34KYK9TV2R93EA3U60TI3PH48GZBSJ,"#11-10 The work was inspired by Araujo's desire to study natural feeding behavior, as opposed to animals passively munching on food pellets.",65,72,feeding,0,1,1
34KYK9TV2R93EA3U60TI3PH48GZBSJ,"#11-10 The work was inspired by Araujo's desire to study natural feeding behavior, as opposed to animals passively munching on food pellets.",73,81,behavior,1,0,1
34KYK9TV2R93EA3U60TI3PH48GZBSJ,"#11-10 The work was inspired by Araujo's desire to study natural feeding behavior, as opposed to animals passively munching on food pellets.",86,93,opposed,2,0,2
34KYK9TV2R93EA3U60TI3PH48GZBSJ,"#11-10 The work was inspired by Araujo's desire to study natural feeding behavior, as opposed to animals passively munching on food pellets.",105,114,passively,5,4,9
34KYK9TV2R93EA3U60TI3PH48GZBSJ,"#11-10 The work was inspired by Araujo's desire to study natural feeding behavior, as opposed to animals passively munching on food pellets.",105,123,passively munching,0,1,1
34KYK9TV2R93EA3U60TI3PH48GZBSJ,"#11-10 The work was inspired by Araujo's desire to study natural feeding behavior, as opposed to animals passively munching on food pellets.",115,123,munching,4,9,13
34KYK9TV2R93EA3U60TI3PH48GZBSJ,"#11-10 The work was inspired by Araujo's desire to study natural feeding behavior, as opposed to animals passively munching on food pellets.",127,139,food pellets,0,2,2
34KYK9TV2R93EA3U60TI3PH48GZBSJ,"#11-10 The work was inspired by Araujo's desire to study natural feeding behavior, as opposed to animals passively munching on food pellets.",132,139,pellets,1,4,5
34KYK9TV2R93EA3U60TI3PH48GZBSJ,"#11-11 The study covered many parts of the brain already known to be associated with feeding, and the results suggested some areas are associated with both hunting and feeding and others only with just one behavior.",69,79,associated,4,2,6
34KYK9TV2R93EA3U60TI3PH48GZBSJ,"#11-11 The study covered many parts of the brain already known to be associated with feeding, and the results suggested some areas are associated with both hunting and feeding and others only with just one behavior.",69,92,associated with feeding,0,1,1
34KYK9TV2R93EA3U60TI3PH48GZBSJ,"#11-11 The study covered many parts of the brain already known to be associated with feeding, and the results suggested some areas are associated with both hunting and feeding and others only with just one behavior.",85,92,feeding,0,1,1
34KYK9TV2R93EA3U60TI3PH48GZBSJ,"#11-11 The study covered many parts of the brain already known to be associated with feeding, and the results suggested some areas are associated with both hunting and feeding and others only with just one behavior.",110,119,suggested,0,2,2
34KYK9TV2R93EA3U60TI3PH48GZBSJ,"#11-11 The study covered many parts of the brain already known to be associated with feeding, and the results suggested some areas are associated with both hunting and feeding and others only with just one behavior.",135,145,associated,3,0,3
34KYK9TV2R93EA3U60TI3PH48GZBSJ,"#11-11 The study covered many parts of the brain already known to be associated with feeding, and the results suggested some areas are associated with both hunting and feeding and others only with just one behavior.",156,163,hunting,0,1,1
34KYK9TV2R93EA3U60TI3PH48GZBSJ,"#11-11 The study covered many parts of the brain already known to be associated with feeding, and the results suggested some areas are associated with both hunting and feeding and others only with just one behavior.",168,175,feeding,0,1,1
34KYK9TV2R93EA3U60TI3PH48GZBSJ,"#11-11 The study covered many parts of the brain already known to be associated with feeding, and the results suggested some areas are associated with both hunting and feeding and others only with just one behavior.",206,214,behavior,1,0,1
34KYK9TV2R93EA3U60TI3PH48GZBSJ,#11-12 Stimulation of the periaqueductal gray (PAG) portion of the brain controlled stalking and stimulation of the reticular formation controlled biting.,7,18,Stimulation,5,7,12
34KYK9TV2R93EA3U60TI3PH48GZBSJ,#11-12 Stimulation of the periaqueductal gray (PAG) portion of the brain controlled stalking and stimulation of the reticular formation controlled biting.,26,40,periaqueductal,8,3,11
34KYK9TV2R93EA3U60TI3PH48GZBSJ,#11-12 Stimulation of the periaqueductal gray (PAG) portion of the brain controlled stalking and stimulation of the reticular formation controlled biting.,26,45,periaqueductal gray,3,2,5
34KYK9TV2R93EA3U60TI3PH48GZBSJ,#11-12 Stimulation of the periaqueductal gray (PAG) portion of the brain controlled stalking and stimulation of the reticular formation controlled biting.,26,50,periaqueductal gray (PAG,1,0,1
34KYK9TV2R93EA3U60TI3PH48GZBSJ,#11-12 Stimulation of the periaqueductal gray (PAG) portion of the brain controlled stalking and stimulation of the reticular formation controlled biting.,73,83,controlled,1,0,1
34KYK9TV2R93EA3U60TI3PH48GZBSJ,#11-12 Stimulation of the periaqueductal gray (PAG) portion of the brain controlled stalking and stimulation of the reticular formation controlled biting.,73,92,controlled stalking,1,0,1
34KYK9TV2R93EA3U60TI3PH48GZBSJ,#11-12 Stimulation of the periaqueductal gray (PAG) portion of the brain controlled stalking and stimulation of the reticular formation controlled biting.,84,92,stalking,4,5,9
34KYK9TV2R93EA3U60TI3PH48GZBSJ,#11-12 Stimulation of the periaqueductal gray (PAG) portion of the brain controlled stalking and stimulation of the reticular formation controlled biting.,84,108,stalking and stimulation,0,2,2
34KYK9TV2R93EA3U60TI3PH48GZBSJ,#11-12 Stimulation of the periaqueductal gray (PAG) portion of the brain controlled stalking and stimulation of the reticular formation controlled biting.,97,108,stimulation,4,1,5
34KYK9TV2R93EA3U60TI3PH48GZBSJ,#11-12 Stimulation of the periaqueductal gray (PAG) portion of the brain controlled stalking and stimulation of the reticular formation controlled biting.,116,125,reticular,8,6,14
34KYK9TV2R93EA3U60TI3PH48GZBSJ,#11-12 Stimulation of the periaqueductal gray (PAG) portion of the brain controlled stalking and stimulation of the reticular formation controlled biting.,116,135,reticular formation,2,3,5
34KYK9TV2R93EA3U60TI3PH48GZBSJ,#11-12 Stimulation of the periaqueductal gray (PAG) portion of the brain controlled stalking and stimulation of the reticular formation controlled biting.,116,146,reticular formation controlled,1,0,1
34KYK9TV2R93EA3U60TI3PH48GZBSJ,#11-12 Stimulation of the periaqueductal gray (PAG) portion of the brain controlled stalking and stimulation of the reticular formation controlled biting.,116,153,reticular formation controlled biting,1,0,1
34KYK9TV2R93EA3U60TI3PH48GZBSJ,#11-12 Stimulation of the periaqueductal gray (PAG) portion of the brain controlled stalking and stimulation of the reticular formation controlled biting.,126,135,formation,2,0,2
34KYK9TV2R93EA3U60TI3PH48GZBSJ,#11-12 Stimulation of the periaqueductal gray (PAG) portion of the brain controlled stalking and stimulation of the reticular formation controlled biting.,136,146,controlled,1,0,1
34KYK9TV2R93EA3U60TI3PH48GZBSJ,#11-12 Stimulation of the periaqueductal gray (PAG) portion of the brain controlled stalking and stimulation of the reticular formation controlled biting.,147,153,biting,0,1,1
3M7OI89LVYPH1HX3DNMAD4RU8C2C65,#6-3 Artist's rendition of Manning as she views herself.,14,23,rendition,7,10,17
3M7OI89LVYPH1HX3DNMAD4RU8C2C65,#6-3 Artist's rendition of Manning as she views herself.,27,34,Manning,0,2,2
3M7OI89LVYPH1HX3DNMAD4RU8C2C65,"#6-4 The information Manning released to the public through WikiLeaks and The Guardian in 2010 included diplomatic accounts, videos, military incident logs, and battle plans, including footage of an American Apache helicopter firing on suspected Iraqi insurgents, reports of prisoners held in Guantanamo Bay without trial, and records of detainees abused by the Iraqi military.",9,20,information,1,1,2
3M7OI89LVYPH1HX3DNMAD4RU8C2C65,"#6-4 The information Manning released to the public through WikiLeaks and The Guardian in 2010 included diplomatic accounts, videos, military incident logs, and battle plans, including footage of an American Apache helicopter firing on suspected Iraqi insurgents, reports of prisoners held in Guantanamo Bay without trial, and records of detainees abused by the Iraqi military.",21,28,Manning,1,0,1
3M7OI89LVYPH1HX3DNMAD4RU8C2C65,"#6-4 The information Manning released to the public through WikiLeaks and The Guardian in 2010 included diplomatic accounts, videos, military incident logs, and battle plans, including footage of an American Apache helicopter firing on suspected Iraqi insurgents, reports of prisoners held in Guantanamo Bay without trial, and records of detainees abused by the Iraqi military.",29,37,released,1,1,2
3M7OI89LVYPH1HX3DNMAD4RU8C2C65,"#6-4 The information Manning released to the public through WikiLeaks and The Guardian in 2010 included diplomatic accounts, videos, military incident logs, and battle plans, including footage of an American Apache helicopter firing on suspected Iraqi insurgents, reports of prisoners held in Guantanamo Bay without trial, and records of detainees abused by the Iraqi military.",60,69,WikiLeaks,2,2,4
3M7OI89LVYPH1HX3DNMAD4RU8C2C65,"#6-4 The information Manning released to the public through WikiLeaks and The Guardian in 2010 included diplomatic accounts, videos, military incident logs, and battle plans, including footage of an American Apache helicopter firing on suspected Iraqi insurgents, reports of prisoners held in Guantanamo Bay without trial, and records of detainees abused by the Iraqi military.",104,114,diplomatic,8,3,11
3M7OI89LVYPH1HX3DNMAD4RU8C2C65,"#6-4 The information Manning released to the public through WikiLeaks and The Guardian in 2010 included diplomatic accounts, videos, military incident logs, and battle plans, including footage of an American Apache helicopter firing on suspected Iraqi insurgents, reports of prisoners held in Guantanamo Bay without trial, and records of detainees abused by the Iraqi military.",104,123,diplomatic accounts,0,2,2
3M7OI89LVYPH1HX3DNMAD4RU8C2C65,"#6-4 The information Manning released to the public through WikiLeaks and The Guardian in 2010 included diplomatic accounts, videos, military incident logs, and battle plans, including footage of an American Apache helicopter firing on suspected Iraqi insurgents, reports of prisoners held in Guantanamo Bay without trial, and records of detainees abused by the Iraqi military.",133,141,military,1,0,1
3M7OI89LVYPH1HX3DNMAD4RU8C2C65,"#6-4 The information Manning released to the public through WikiLeaks and The Guardian in 2010 included diplomatic accounts, videos, military incident logs, and battle plans, including footage of an American Apache helicopter firing on suspected Iraqi insurgents, reports of prisoners held in Guantanamo Bay without trial, and records of detainees abused by the Iraqi military.",133,155,military incident logs,1,0,1
3M7OI89LVYPH1HX3DNMAD4RU8C2C65,"#6-4 The information Manning released to the public through WikiLeaks and The Guardian in 2010 included diplomatic accounts, videos, military incident logs, and battle plans, including footage of an American Apache helicopter firing on suspected Iraqi insurgents, reports of prisoners held in Guantanamo Bay without trial, and records of detainees abused by the Iraqi military.",142,155,incident logs,0,2,2
3M7OI89LVYPH1HX3DNMAD4RU8C2C65,"#6-4 The information Manning released to the public through WikiLeaks and The Guardian in 2010 included diplomatic accounts, videos, military incident logs, and battle plans, including footage of an American Apache helicopter firing on suspected Iraqi insurgents, reports of prisoners held in Guantanamo Bay without trial, and records of detainees abused by the Iraqi military.",151,155,logs,1,1,2
3M7OI89LVYPH1HX3DNMAD4RU8C2C65,"#6-4 The information Manning released to the public through WikiLeaks and The Guardian in 2010 included diplomatic accounts, videos, military incident logs, and battle plans, including footage of an American Apache helicopter firing on suspected Iraqi insurgents, reports of prisoners held in Guantanamo Bay without trial, and records of detainees abused by the Iraqi military.",185,192,footage,2,5,7
3M7OI89LVYPH1HX3DNMAD4RU8C2C65,"#6-4 The information Manning released to the public through WikiLeaks and The Guardian in 2010 included diplomatic accounts, videos, military incident logs, and battle plans, including footage of an American Apache helicopter firing on suspected Iraqi insurgents, reports of prisoners held in Guantanamo Bay without trial, and records of detainees abused by the Iraqi military.",208,214,Apache,1,0,1
3M7OI89LVYPH1HX3DNMAD4RU8C2C65,"#6-4 The information Manning released to the public through WikiLeaks and The Guardian in 2010 included diplomatic accounts, videos, military incident logs, and battle plans, including footage of an American Apache helicopter firing on suspected Iraqi insurgents, reports of prisoners held in Guantanamo Bay without trial, and records of detainees abused by the Iraqi military.",208,225,Apache helicopter,1,0,1
3M7OI89LVYPH1HX3DNMAD4RU8C2C65,"#6-4 The information Manning released to the public through WikiLeaks and The Guardian in 2010 included diplomatic accounts, videos, military incident logs, and battle plans, including footage of an American Apache helicopter firing on suspected Iraqi insurgents, reports of prisoners held in Guantanamo Bay without trial, and records of detainees abused by the Iraqi military.",236,245,suspected,2,4,6
3M7OI89LVYPH1HX3DNMAD4RU8C2C65,"#6-4 The information Manning released to the public through WikiLeaks and The Guardian in 2010 included diplomatic accounts, videos, military incident logs, and battle plans, including footage of an American Apache helicopter firing on suspected Iraqi insurgents, reports of prisoners held in Guantanamo Bay without trial, and records of detainees abused by the Iraqi military.",246,251,Iraqi,0,1,1
3M7OI89LVYPH1HX3DNMAD4RU8C2C65,"#6-4 The information Manning released to the public through WikiLeaks and The Guardian in 2010 included diplomatic accounts, videos, military incident logs, and battle plans, including footage of an American Apache helicopter firing on suspected Iraqi insurgents, reports of prisoners held in Guantanamo Bay without trial, and records of detainees abused by the Iraqi military.",252,262,insurgents,7,7,14
3M7OI89LVYPH1HX3DNMAD4RU8C2C65,"#6-4 The information Manning released to the public through WikiLeaks and The Guardian in 2010 included diplomatic accounts, videos, military incident logs, and battle plans, including footage of an American Apache helicopter firing on suspected Iraqi insurgents, reports of prisoners held in Guantanamo Bay without trial, and records of detainees abused by the Iraqi military.",293,303,Guantanamo,1,1,2
3M7OI89LVYPH1HX3DNMAD4RU8C2C65,"#6-4 The information Manning released to the public through WikiLeaks and The Guardian in 2010 included diplomatic accounts, videos, military incident logs, and battle plans, including footage of an American Apache helicopter firing on suspected Iraqi insurgents, reports of prisoners held in Guantanamo Bay without trial, and records of detainees abused by the Iraqi military.",293,307,Guantanamo Bay,1,0,1
3M7OI89LVYPH1HX3DNMAD4RU8C2C65,"#6-4 The information Manning released to the public through WikiLeaks and The Guardian in 2010 included diplomatic accounts, videos, military incident logs, and battle plans, including footage of an American Apache helicopter firing on suspected Iraqi insurgents, reports of prisoners held in Guantanamo Bay without trial, and records of detainees abused by the Iraqi military.",316,321,trial,0,1,1
3M7OI89LVYPH1HX3DNMAD4RU8C2C65,"#6-4 The information Manning released to the public through WikiLeaks and The Guardian in 2010 included diplomatic accounts, videos, military incident logs, and battle plans, including footage of an American Apache helicopter firing on suspected Iraqi insurgents, reports of prisoners held in Guantanamo Bay without trial, and records of detainees abused by the Iraqi military.",338,347,detainees,10,8,18
3M7OI89LVYPH1HX3DNMAD4RU8C2C65,"#6-4 The information Manning released to the public through WikiLeaks and The Guardian in 2010 included diplomatic accounts, videos, military incident logs, and battle plans, including footage of an American Apache helicopter firing on suspected Iraqi insurgents, reports of prisoners held in Guantanamo Bay without trial, and records of detainees abused by the Iraqi military.",338,354,detainees abused,0,1,1
3M7OI89LVYPH1HX3DNMAD4RU8C2C65,"#6-4 The information Manning released to the public through WikiLeaks and The Guardian in 2010 included diplomatic accounts, videos, military incident logs, and battle plans, including footage of an American Apache helicopter firing on suspected Iraqi insurgents, reports of prisoners held in Guantanamo Bay without trial, and records of detainees abused by the Iraqi military.",348,354,abused,2,4,6
3M7OI89LVYPH1HX3DNMAD4RU8C2C65,"#6-5 Many in Congress have denounced Manning as a traitor, stating the breach endangered U.S. national security.",27,36,denounced,3,5,8
3M7OI89LVYPH1HX3DNMAD4RU8C2C65,"#6-5 Many in Congress have denounced Manning as a traitor, stating the breach endangered U.S. national security.",37,44,Manning,1,0,1
3M7OI89LVYPH1HX3DNMAD4RU8C2C65,"#6-5 Many in Congress have denounced Manning as a traitor, stating the breach endangered U.S. national security.",50,57,traitor,2,4,6
3M7OI89LVYPH1HX3DNMAD4RU8C2C65,"#6-5 Many in Congress have denounced Manning as a traitor, stating the breach endangered U.S. national security.",71,77,breach,2,1,3
3M7OI89LVYPH1HX3DNMAD4RU8C2C65,"#6-5 Many in Congress have denounced Manning as a traitor, stating the breach endangered U.S. national security.",78,88,endangered,4,5,9
3M7OI89LVYPH1HX3DNMAD4RU8C2C65,"#6-6 Manning was convicted in 2013 of 22 charges, including espionage, but acquitted of aiding the enemy.",17,26,convicted,2,1,3
3M7OI89LVYPH1HX3DNMAD4RU8C2C65,"#6-6 Manning was convicted in 2013 of 22 charges, including espionage, but acquitted of aiding the enemy.",60,69,espionage,5,9,14
3M7OI89LVYPH1HX3DNMAD4RU8C2C65,"#6-6 Manning was convicted in 2013 of 22 charges, including espionage, but acquitted of aiding the enemy.",75,84,acquitted,4,7,11
3M7OI89LVYPH1HX3DNMAD4RU8C2C65,"#6-6 Manning was convicted in 2013 of 22 charges, including espionage, but acquitted of aiding the enemy.",88,94,aiding,0,1,1
3M7OI89LVYPH1HX3DNMAD4RU8C2C65,"#6-7 Republican senator John McCain, who ran for president against Obama in 2008, said ""It is a sad, yet perhaps fitting commentary on President Obama's failed national security policies that he would commute the sentence of an individual that endangered the lives of American troops, diplomats, and intelligence sources by leaking hundreds of thousands of sensitive government documents to WikiLeaks, a virulently anti-American organization that was a tool of Russia's recent interference in our elections.""",113,120,fitting,0,1,1
3M7OI89LVYPH1HX3DNMAD4RU8C2C65,"#6-7 Republican senator John McCain, who ran for president against Obama in 2008, said ""It is a sad, yet perhaps fitting commentary on President Obama's failed national security policies that he would commute the sentence of an individual that endangered the lives of American troops, diplomats, and intelligence sources by leaking hundreds of thousands of sensitive government documents to WikiLeaks, a virulently anti-American organization that was a tool of Russia's recent interference in our elections.""",121,131,commentary,3,0,3
3M7OI89LVYPH1HX3DNMAD4RU8C2C65,"#6-7 Republican senator John McCain, who ran for president against Obama in 2008, said ""It is a sad, yet perhaps fitting commentary on President Obama's failed national security policies that he would commute the sentence of an individual that endangered the lives of American troops, diplomats, and intelligence sources by leaking hundreds of thousands of sensitive government documents to WikiLeaks, a virulently anti-American organization that was a tool of Russia's recent interference in our elections.""",201,208,commute,1,4,5
3M7OI89LVYPH1HX3DNMAD4RU8C2C65,"#6-7 Republican senator John McCain, who ran for president against Obama in 2008, said ""It is a sad, yet perhaps fitting commentary on President Obama's failed national security policies that he would commute the sentence of an individual that endangered the lives of American troops, diplomats, and intelligence sources by leaking hundreds of thousands of sensitive government documents to WikiLeaks, a virulently anti-American organization that was a tool of Russia's recent interference in our elections.""",244,254,endangered,3,5,8
3M7OI89LVYPH1HX3DNMAD4RU8C2C65,"#6-7 Republican senator John McCain, who ran for president against Obama in 2008, said ""It is a sad, yet perhaps fitting commentary on President Obama's failed national security policies that he would commute the sentence of an individual that endangered the lives of American troops, diplomats, and intelligence sources by leaking hundreds of thousands of sensitive government documents to WikiLeaks, a virulently anti-American organization that was a tool of Russia's recent interference in our elections.""",285,294,diplomats,1,0,1
3M7OI89LVYPH1HX3DNMAD4RU8C2C65,"#6-7 Republican senator John McCain, who ran for president against Obama in 2008, said ""It is a sad, yet perhaps fitting commentary on President Obama's failed national security policies that he would commute the sentence of an individual that endangered the lives of American troops, diplomats, and intelligence sources by leaking hundreds of thousands of sensitive government documents to WikiLeaks, a virulently anti-American organization that was a tool of Russia's recent interference in our elections.""",300,312,intelligence,1,0,1
3M7OI89LVYPH1HX3DNMAD4RU8C2C65,"#6-7 Republican senator John McCain, who ran for president against Obama in 2008, said ""It is a sad, yet perhaps fitting commentary on President Obama's failed national security policies that he would commute the sentence of an individual that endangered the lives of American troops, diplomats, and intelligence sources by leaking hundreds of thousands of sensitive government documents to WikiLeaks, a virulently anti-American organization that was a tool of Russia's recent interference in our elections.""",324,331,leaking,0,2,2
3M7OI89LVYPH1HX3DNMAD4RU8C2C65,"#6-7 Republican senator John McCain, who ran for president against Obama in 2008, said ""It is a sad, yet perhaps fitting commentary on President Obama's failed national security policies that he would commute the sentence of an individual that endangered the lives of American troops, diplomats, and intelligence sources by leaking hundreds of thousands of sensitive government documents to WikiLeaks, a virulently anti-American organization that was a tool of Russia's recent interference in our elections.""",357,366,sensitive,2,0,2
3M7OI89LVYPH1HX3DNMAD4RU8C2C65,"#6-7 Republican senator John McCain, who ran for president against Obama in 2008, said ""It is a sad, yet perhaps fitting commentary on President Obama's failed national security policies that he would commute the sentence of an individual that endangered the lives of American troops, diplomats, and intelligence sources by leaking hundreds of thousands of sensitive government documents to WikiLeaks, a virulently anti-American organization that was a tool of Russia's recent interference in our elections.""",367,377,government,1,0,1
3M7OI89LVYPH1HX3DNMAD4RU8C2C65,"#6-7 Republican senator John McCain, who ran for president against Obama in 2008, said ""It is a sad, yet perhaps fitting commentary on President Obama's failed national security policies that he would commute the sentence of an individual that endangered the lives of American troops, diplomats, and intelligence sources by leaking hundreds of thousands of sensitive government documents to WikiLeaks, a virulently anti-American organization that was a tool of Russia's recent interference in our elections.""",391,400,WikiLeaks,1,1,2
3M7OI89LVYPH1HX3DNMAD4RU8C2C65,"#6-7 Republican senator John McCain, who ran for president against Obama in 2008, said ""It is a sad, yet perhaps fitting commentary on President Obama's failed national security policies that he would commute the sentence of an individual that endangered the lives of American troops, diplomats, and intelligence sources by leaking hundreds of thousands of sensitive government documents to WikiLeaks, a virulently anti-American organization that was a tool of Russia's recent interference in our elections.""",404,414,virulently,5,9,14
3M7OI89LVYPH1HX3DNMAD4RU8C2C65,"#6-7 Republican senator John McCain, who ran for president against Obama in 2008, said ""It is a sad, yet perhaps fitting commentary on President Obama's failed national security policies that he would commute the sentence of an individual that endangered the lives of American troops, diplomats, and intelligence sources by leaking hundreds of thousands of sensitive government documents to WikiLeaks, a virulently anti-American organization that was a tool of Russia's recent interference in our elections.""",477,489,interference,8,4,12
3M7OI89LVYPH1HX3DNMAD4RU8C2C65,"#6-7 Republican senator John McCain, who ran for president against Obama in 2008, said ""It is a sad, yet perhaps fitting commentary on President Obama's failed national security policies that he would commute the sentence of an individual that endangered the lives of American troops, diplomats, and intelligence sources by leaking hundreds of thousands of sensitive government documents to WikiLeaks, a virulently anti-American organization that was a tool of Russia's recent interference in our elections.""",497,506,elections,1,0,1
3RIHDBQ1NEZA7STBMV7SDRLWB4MHMT,"#5-1 Bomb kills at least 50 in Gao, Mali A vehicle packed with explosives was detonated this morning in Gao, Mali.",5,9,Bomb,1,0,1
3RIHDBQ1NEZA7STBMV7SDRLWB4MHMT,"#5-1 Bomb kills at least 50 in Gao, Mali A vehicle packed with explosives was detonated this morning in Gao, Mali.",43,50,vehicle,1,0,1
3RIHDBQ1NEZA7STBMV7SDRLWB4MHMT,"#5-1 Bomb kills at least 50 in Gao, Mali A vehicle packed with explosives was detonated this morning in Gao, Mali.",51,57,packed,0,2,2
3RIHDBQ1NEZA7STBMV7SDRLWB4MHMT,"#5-1 Bomb kills at least 50 in Gao, Mali A vehicle packed with explosives was detonated this morning in Gao, Mali.",63,73,explosives,9,2,11
3RIHDBQ1NEZA7STBMV7SDRLWB4MHMT,"#5-1 Bomb kills at least 50 in Gao, Mali A vehicle packed with explosives was detonated this morning in Gao, Mali.",78,87,detonated,10,10,20
3RIHDBQ1NEZA7STBMV7SDRLWB4MHMT,"#5-3 The bombing targeted a camp housing government soldiers and rebels, some of whom were in a meeting at the time.",17,25,targeted,3,4,7
3RIHDBQ1NEZA7STBMV7SDRLWB4MHMT,"#5-3 The bombing targeted a camp housing government soldiers and rebels, some of whom were in a meeting at the time.",33,40,housing,0,1,1
3RIHDBQ1NEZA7STBMV7SDRLWB4MHMT,"#5-3 The bombing targeted a camp housing government soldiers and rebels, some of whom were in a meeting at the time.",41,51,government,1,0,1
3RIHDBQ1NEZA7STBMV7SDRLWB4MHMT,"#5-3 The bombing targeted a camp housing government soldiers and rebels, some of whom were in a meeting at the time.",65,71,rebels,0,4,4
3RIHDBQ1NEZA7STBMV7SDRLWB4MHMT,"#5-3 The bombing targeted a camp housing government soldiers and rebels, some of whom were in a meeting at the time.",81,85,whom,0,1,1
3RIHDBQ1NEZA7STBMV7SDRLWB4MHMT,"#5-4 Northern Mali was seized by Islamic militants in 2012, with France leading a military intervention the following year.",23,29,seized,7,6,13
3RIHDBQ1NEZA7STBMV7SDRLWB4MHMT,"#5-4 Northern Mali was seized by Islamic militants in 2012, with France leading a military intervention the following year.",33,40,Islamic,0,1,1
3RIHDBQ1NEZA7STBMV7SDRLWB4MHMT,"#5-4 Northern Mali was seized by Islamic militants in 2012, with France leading a military intervention the following year.",33,50,Islamic militants,2,1,3
3RIHDBQ1NEZA7STBMV7SDRLWB4MHMT,"#5-4 Northern Mali was seized by Islamic militants in 2012, with France leading a military intervention the following year.",41,50,militants,4,1,5
3RIHDBQ1NEZA7STBMV7SDRLWB4MHMT,"#5-4 Northern Mali was seized by Islamic militants in 2012, with France leading a military intervention the following year.",72,79,leading,0,1,1
3RIHDBQ1NEZA7STBMV7SDRLWB4MHMT,"#5-4 Northern Mali was seized by Islamic militants in 2012, with France leading a military intervention the following year.",82,103,military intervention,1,1,2
3RIHDBQ1NEZA7STBMV7SDRLWB4MHMT,"#5-4 Northern Mali was seized by Islamic militants in 2012, with France leading a military intervention the following year.",91,103,intervention,9,5,14
3RIHDBQ1NEZA7STBMV7SDRLWB4MHMT,#5-5 The camp was formed as part of a disputed ceasefire.,38,46,disputed,4,1,5
3RIHDBQ1NEZA7STBMV7SDRLWB4MHMT,#5-5 The camp was formed as part of a disputed ceasefire.,38,56,disputed ceasefire,4,2,6
3RIHDBQ1NEZA7STBMV7SDRLWB4MHMT,#5-5 The camp was formed as part of a disputed ceasefire.,47,56,ceasefire,7,7,14
3RIHDBQ1NEZA7STBMV7SDRLWB4MHMT,"#5-6 Occasional attacks continue, and the latest is the worst in years.",5,15,Occasional,2,1,3
3RIHDBQ1NEZA7STBMV7SDRLWB4MHMT,"#5-6 Occasional attacks continue, and the latest is the worst in years.",56,61,worst,0,2,2
3RIHDBQ1NEZA7STBMV7SDRLWB4MHMT,"#5-7 French Interior Minister Bruno Le Roux called the attack ""highly symbolic"".",30,43,Bruno Le Roux,0,1,1
3RIHDBQ1NEZA7STBMV7SDRLWB4MHMT,"#5-7 French Interior Minister Bruno Le Roux called the attack ""highly symbolic"".",63,78,highly symbolic,2,1,3
3RIHDBQ1NEZA7STBMV7SDRLWB4MHMT,"#5-7 French Interior Minister Bruno Le Roux called the attack ""highly symbolic"".",70,78,symbolic,9,5,14
3RIHDBQ1NEZA7STBMV7SDRLWB4MHMT,#5-8 French President François Hollande visited the scene last week.,22,30,François,0,1,1
3RIHDBQ1NEZA7STBMV7SDRLWB4MHMT,#5-8 French President François Hollande visited the scene last week.,31,39,Hollande,0,1,1
3RIHDBQ1NEZA7STBMV7SDRLWB4MHMT,"#5-9 Victims included people tasked with providing patrols, part of a United Nations-backed move to quell the violence.",5,12,Victims,1,1,2
3RIHDBQ1NEZA7STBMV7SDRLWB4MHMT,"#5-9 Victims included people tasked with providing patrols, part of a United Nations-backed move to quell the violence.",29,35,tasked,0,1,1
3RIHDBQ1NEZA7STBMV7SDRLWB4MHMT,"#5-9 Victims included people tasked with providing patrols, part of a United Nations-backed move to quell the violence.",41,50,providing,2,0,2
3RIHDBQ1NEZA7STBMV7SDRLWB4MHMT,"#5-9 Victims included people tasked with providing patrols, part of a United Nations-backed move to quell the violence.",41,58,providing patrols,1,0,1
3RIHDBQ1NEZA7STBMV7SDRLWB4MHMT,"#5-9 Victims included people tasked with providing patrols, part of a United Nations-backed move to quell the violence.",51,58,patrols,4,3,7
3RIHDBQ1NEZA7STBMV7SDRLWB4MHMT,"#5-9 Victims included people tasked with providing patrols, part of a United Nations-backed move to quell the violence.",97,105,to quell,0,1,1
3RIHDBQ1NEZA7STBMV7SDRLWB4MHMT,"#5-9 Victims included people tasked with providing patrols, part of a United Nations-backed move to quell the violence.",100,105,quell,6,8,14
3RIHDBQ1NEZA7STBMV7SDRLWB4MHMT,"#5-9 Victims included people tasked with providing patrols, part of a United Nations-backed move to quell the violence.",100,118,quell the violence,0,1,1
3RIHDBQ1NEZA7STBMV7SDRLWB4MHMT,"#5-9 Victims included people tasked with providing patrols, part of a United Nations-backed move to quell the violence.",110,118,violence,2,1,3
3RIHDBQ1NEZA7STBMV7SDRLWB4MHMT,#5-10 Malian President Ibrahim Boubacar Keita took to Twitter today to declare three days of mourning.,31,45,Boubacar Keita,0,1,1
3RIHDBQ1NEZA7STBMV7SDRLWB4MHMT,#5-10 Malian President Ibrahim Boubacar Keita took to Twitter today to declare three days of mourning.,71,78,declare,1,1,2
3RIHDBQ1NEZA7STBMV7SDRLWB4MHMT,#5-10 Malian President Ibrahim Boubacar Keita took to Twitter today to declare three days of mourning.,93,101,mourning,8,8,16
3OLZC0DJ8JGTTAY465Q40Z5O2ADIV4,"#25-9 While sluggish wage growth remains a pocket of weakness in the economic recovery, steady payroll gains averaging 242,000 per month over the past twelve months have led observers to consider a Federal Reserve interest rate hike as increasingly likely, according to The New York Times.",12,20,sluggish,10,10,20
3OLZC0DJ8JGTTAY465Q40Z5O2ADIV4,"#25-9 While sluggish wage growth remains a pocket of weakness in the economic recovery, steady payroll gains averaging 242,000 per month over the past twelve months have led observers to consider a Federal Reserve interest rate hike as increasingly likely, according to The New York Times.",12,32,sluggish wage growth,1,1,2
3OLZC0DJ8JGTTAY465Q40Z5O2ADIV4,"#25-9 While sluggish wage growth remains a pocket of weakness in the economic recovery, steady payroll gains averaging 242,000 per month over the past twelve months have led observers to consider a Federal Reserve interest rate hike as increasingly likely, according to The New York Times.",21,25,wage,0,1,1
3OLZC0DJ8JGTTAY465Q40Z5O2ADIV4,"#25-9 While sluggish wage growth remains a pocket of weakness in the economic recovery, steady payroll gains averaging 242,000 per month over the past twelve months have led observers to consider a Federal Reserve interest rate hike as increasingly likely, according to The New York Times.",43,61,pocket of weakness,2,1,3
3OLZC0DJ8JGTTAY465Q40Z5O2ADIV4,"#25-9 While sluggish wage growth remains a pocket of weakness in the economic recovery, steady payroll gains averaging 242,000 per month over the past twelve months have led observers to consider a Federal Reserve interest rate hike as increasingly likely, according to The New York Times.",53,61,weakness,1,1,2
3OLZC0DJ8JGTTAY465Q40Z5O2ADIV4,"#25-9 While sluggish wage growth remains a pocket of weakness in the economic recovery, steady payroll gains averaging 242,000 per month over the past twelve months have led observers to consider a Federal Reserve interest rate hike as increasingly likely, according to The New York Times.",69,77,economic,2,0,2
3OLZC0DJ8JGTTAY465Q40Z5O2ADIV4,"#25-9 While sluggish wage growth remains a pocket of weakness in the economic recovery, steady payroll gains averaging 242,000 per month over the past twelve months have led observers to consider a Federal Reserve interest rate hike as increasingly likely, according to The New York Times.",69,86,economic recovery,2,1,3
3OLZC0DJ8JGTTAY465Q40Z5O2ADIV4,"#25-9 While sluggish wage growth remains a pocket of weakness in the economic recovery, steady payroll gains averaging 242,000 per month over the past twelve months have led observers to consider a Federal Reserve interest rate hike as increasingly likely, according to The New York Times.",88,94,steady,1,1,2
3OLZC0DJ8JGTTAY465Q40Z5O2ADIV4,"#25-9 While sluggish wage growth remains a pocket of weakness in the economic recovery, steady payroll gains averaging 242,000 per month over the past twelve months have led observers to consider a Federal Reserve interest rate hike as increasingly likely, according to The New York Times.",88,102,steady payroll,0,1,1
3OLZC0DJ8JGTTAY465Q40Z5O2ADIV4,"#25-9 While sluggish wage growth remains a pocket of weakness in the economic recovery, steady payroll gains averaging 242,000 per month over the past twelve months have led observers to consider a Federal Reserve interest rate hike as increasingly likely, according to The New York Times.",95,102,payroll,2,9,11
3OLZC0DJ8JGTTAY465Q40Z5O2ADIV4,"#25-9 While sluggish wage growth remains a pocket of weakness in the economic recovery, steady payroll gains averaging 242,000 per month over the past twelve months have led observers to consider a Federal Reserve interest rate hike as increasingly likely, according to The New York Times.",95,108,payroll gains,1,0,1
3OLZC0DJ8JGTTAY465Q40Z5O2ADIV4,"#25-9 While sluggish wage growth remains a pocket of weakness in the economic recovery, steady payroll gains averaging 242,000 per month over the past twelve months have led observers to consider a Federal Reserve interest rate hike as increasingly likely, according to The New York Times.",109,118,averaging,4,0,4
3OLZC0DJ8JGTTAY465Q40Z5O2ADIV4,"#25-9 While sluggish wage growth remains a pocket of weakness in the economic recovery, steady payroll gains averaging 242,000 per month over the past twelve months have led observers to consider a Federal Reserve interest rate hike as increasingly likely, according to The New York Times.",170,173,led,0,1,1
3OLZC0DJ8JGTTAY465Q40Z5O2ADIV4,"#25-9 While sluggish wage growth remains a pocket of weakness in the economic recovery, steady payroll gains averaging 242,000 per month over the past twelve months have led observers to consider a Federal Reserve interest rate hike as increasingly likely, according to The New York Times.",174,183,observers,3,3,6
3OLZC0DJ8JGTTAY465Q40Z5O2ADIV4,"#25-9 While sluggish wage growth remains a pocket of weakness in the economic recovery, steady payroll gains averaging 242,000 per month over the past twelve months have led observers to consider a Federal Reserve interest rate hike as increasingly likely, according to The New York Times.",198,205,Federal,1,1,2
3OLZC0DJ8JGTTAY465Q40Z5O2ADIV4,"#25-9 While sluggish wage growth remains a pocket of weakness in the economic recovery, steady payroll gains averaging 242,000 per month over the past twelve months have led observers to consider a Federal Reserve interest rate hike as increasingly likely, according to The New York Times.",198,213,Federal Reserve,2,0,2
3OLZC0DJ8JGTTAY465Q40Z5O2ADIV4,"#25-9 While sluggish wage growth remains a pocket of weakness in the economic recovery, steady payroll gains averaging 242,000 per month over the past twelve months have led observers to consider a Federal Reserve interest rate hike as increasingly likely, according to The New York Times.",206,213,Reserve,1,0,1
3OLZC0DJ8JGTTAY465Q40Z5O2ADIV4,"#25-9 While sluggish wage growth remains a pocket of weakness in the economic recovery, steady payroll gains averaging 242,000 per month over the past twelve months have led observers to consider a Federal Reserve interest rate hike as increasingly likely, according to The New York Times.",228,232,hike,0,5,5
3OLZC0DJ8JGTTAY465Q40Z5O2ADIV4,"#25-9 While sluggish wage growth remains a pocket of weakness in the economic recovery, steady payroll gains averaging 242,000 per month over the past twelve months have led observers to consider a Federal Reserve interest rate hike as increasingly likely, according to The New York Times.",236,248,increasingly,2,1,3
3OLZC0DJ8JGTTAY465Q40Z5O2ADIV4,"#25-9 While sluggish wage growth remains a pocket of weakness in the economic recovery, steady payroll gains averaging 242,000 per month over the past twelve months have led observers to consider a Federal Reserve interest rate hike as increasingly likely, according to The New York Times.",257,269,according to,1,0,1
3OLZC0DJ8JGTTAY465Q40Z5O2ADIV4,"#25-10 ""We view this report as easily clearing the hurdle needed to keep the Fed on track for a September rate hike,"" said Rob Martin, an economist at Barclays in New York.",38,57,clearing the hurdle,1,0,1
3OLZC0DJ8JGTTAY465Q40Z5O2ADIV4,"#25-10 ""We view this report as easily clearing the hurdle needed to keep the Fed on track for a September rate hike,"" said Rob Martin, an economist at Barclays in New York.",51,57,hurdle,8,10,18
3OLZC0DJ8JGTTAY465Q40Z5O2ADIV4,"#25-10 ""We view this report as easily clearing the hurdle needed to keep the Fed on track for a September rate hike,"" said Rob Martin, an economist at Barclays in New York.",77,80,Fed,2,1,3
3OLZC0DJ8JGTTAY465Q40Z5O2ADIV4,"#25-10 ""We view this report as easily clearing the hurdle needed to keep the Fed on track for a September rate hike,"" said Rob Martin, an economist at Barclays in New York.",106,115,rate hike,2,0,2
3OLZC0DJ8JGTTAY465Q40Z5O2ADIV4,"#25-10 ""We view this report as easily clearing the hurdle needed to keep the Fed on track for a September rate hike,"" said Rob Martin, an economist at Barclays in New York.",111,115,hike,0,1,1
3OLZC0DJ8JGTTAY465Q40Z5O2ADIV4,"#25-10 ""We view this report as easily clearing the hurdle needed to keep the Fed on track for a September rate hike,"" said Rob Martin, an economist at Barclays in New York.",138,147,economist,9,1,10
3OLZC0DJ8JGTTAY465Q40Z5O2ADIV4,"#25-11 ""The bar for not moving now is much higher.""",12,15,bar,0,1,1
3OLZC0DJ8JGTTAY465Q40Z5O2ADIV4,"#25-12 Although the Federal Reserve has not explicitly stated that they plan to raise interest rates in the near future, the US central bank has stated that it would raise rates when it has seen ""some further improvement"" in the jobs market.",20,35,Federal Reserve,1,1,2
3OLZC0DJ8JGTTAY465Q40Z5O2ADIV4,"#25-12 Although the Federal Reserve has not explicitly stated that they plan to raise interest rates in the near future, the US central bank has stated that it would raise rates when it has seen ""some further improvement"" in the jobs market.",44,54,explicitly,8,10,18
3OLZC0DJ8JGTTAY465Q40Z5O2ADIV4,"#25-12 Although the Federal Reserve has not explicitly stated that they plan to raise interest rates in the near future, the US central bank has stated that it would raise rates when it has seen ""some further improvement"" in the jobs market.",44,61,explicitly stated,0,1,1
3OLZC0DJ8JGTTAY465Q40Z5O2ADIV4,"#25-12 Although the Federal Reserve has not explicitly stated that they plan to raise interest rates in the near future, the US central bank has stated that it would raise rates when it has seen ""some further improvement"" in the jobs market.",86,100,interest rates,1,0,1
3OLZC0DJ8JGTTAY465Q40Z5O2ADIV4,"#25-12 Although the Federal Reserve has not explicitly stated that they plan to raise interest rates in the near future, the US central bank has stated that it would raise rates when it has seen ""some further improvement"" in the jobs market.",145,151,stated,0,2,2
3OLZC0DJ8JGTTAY465Q40Z5O2ADIV4,"#25-12 Although the Federal Reserve has not explicitly stated that they plan to raise interest rates in the near future, the US central bank has stated that it would raise rates when it has seen ""some further improvement"" in the jobs market.",201,220,further improvement,0,1,1
3OLZC0DJ8JGTTAY465Q40Z5O2ADIV4,"#25-12 Although the Federal Reserve has not explicitly stated that they plan to raise interest rates in the near future, the US central bank has stated that it would raise rates when it has seen ""some further improvement"" in the jobs market.",209,220,improvement,3,2,5
3OLZC0DJ8JGTTAY465Q40Z5O2ADIV4,"#25-12 Although the Federal Reserve has not explicitly stated that they plan to raise interest rates in the near future, the US central bank has stated that it would raise rates when it has seen ""some further improvement"" in the jobs market.",229,240,jobs market,1,0,1
30OITAWPBQ4V08AHXM3N85FCB5FH9U,"#24-19 The management has decided to hand it over to the Police"", said an unnamed official to SunOnline, who said authorities don't know if any of the debris taken away has been destroyed.",11,21,management,5,4,9
30OITAWPBQ4V08AHXM3N85FCB5FH9U,"#24-19 The management has decided to hand it over to the Police"", said an unnamed official to SunOnline, who said authorities don't know if any of the debris taken away has been destroyed.",37,49,hand it over,0,1,1
30OITAWPBQ4V08AHXM3N85FCB5FH9U,"#24-19 The management has decided to hand it over to the Police"", said an unnamed official to SunOnline, who said authorities don't know if any of the debris taken away has been destroyed.",74,81,unnamed,2,1,3
30OITAWPBQ4V08AHXM3N85FCB5FH9U,"#24-19 The management has decided to hand it over to the Police"", said an unnamed official to SunOnline, who said authorities don't know if any of the debris taken away has been destroyed.",114,125,authorities,5,3,8
30OITAWPBQ4V08AHXM3N85FCB5FH9U,"#24-19 The management has decided to hand it over to the Police"", said an unnamed official to SunOnline, who said authorities don't know if any of the debris taken away has been destroyed.",151,157,debris,8,8,16
30OITAWPBQ4V08AHXM3N85FCB5FH9U,"#24-19 The management has decided to hand it over to the Police"", said an unnamed official to SunOnline, who said authorities don't know if any of the debris taken away has been destroyed.",178,187,destroyed,1,1,2
30OITAWPBQ4V08AHXM3N85FCB5FH9U,#24-20 The Serious and Organized Crime Unit of the Maldives Police Service and experts from the Maldives Civil Aviation Authority are heading the investigation.,7,43,The Serious and Organized Crime Unit,1,0,1
30OITAWPBQ4V08AHXM3N85FCB5FH9U,#24-20 The Serious and Organized Crime Unit of the Maldives Police Service and experts from the Maldives Civil Aviation Authority are heading the investigation.,11,43,Serious and Organized Crime Unit,1,0,1
30OITAWPBQ4V08AHXM3N85FCB5FH9U,#24-20 The Serious and Organized Crime Unit of the Maldives Police Service and experts from the Maldives Civil Aviation Authority are heading the investigation.,23,32,Organized,0,2,2
30OITAWPBQ4V08AHXM3N85FCB5FH9U,#24-20 The Serious and Organized Crime Unit of the Maldives Police Service and experts from the Maldives Civil Aviation Authority are heading the investigation.,51,59,Maldives,0,1,1
30OITAWPBQ4V08AHXM3N85FCB5FH9U,#24-20 The Serious and Organized Crime Unit of the Maldives Police Service and experts from the Maldives Civil Aviation Authority are heading the investigation.,79,86,experts,0,3,3
30OITAWPBQ4V08AHXM3N85FCB5FH9U,#24-20 The Serious and Organized Crime Unit of the Maldives Police Service and experts from the Maldives Civil Aviation Authority are heading the investigation.,96,129,Maldives Civil Aviation Authority,1,0,1
30OITAWPBQ4V08AHXM3N85FCB5FH9U,#24-20 The Serious and Organized Crime Unit of the Maldives Police Service and experts from the Maldives Civil Aviation Authority are heading the investigation.,105,110,Civil,3,0,3
30OITAWPBQ4V08AHXM3N85FCB5FH9U,#24-20 The Serious and Organized Crime Unit of the Maldives Police Service and experts from the Maldives Civil Aviation Authority are heading the investigation.,105,129,Civil Aviation Authority,1,0,1
30OITAWPBQ4V08AHXM3N85FCB5FH9U,#24-20 The Serious and Organized Crime Unit of the Maldives Police Service and experts from the Maldives Civil Aviation Authority are heading the investigation.,111,119,Aviation,3,4,7
30OITAWPBQ4V08AHXM3N85FCB5FH9U,#24-20 The Serious and Organized Crime Unit of the Maldives Police Service and experts from the Maldives Civil Aviation Authority are heading the investigation.,120,129,Authority,1,0,1
30OITAWPBQ4V08AHXM3N85FCB5FH9U,#24-20 The Serious and Organized Crime Unit of the Maldives Police Service and experts from the Maldives Civil Aviation Authority are heading the investigation.,134,141,heading,0,1,1
30OITAWPBQ4V08AHXM3N85FCB5FH9U,#24-20 The Serious and Organized Crime Unit of the Maldives Police Service and experts from the Maldives Civil Aviation Authority are heading the investigation.,146,159,investigation,8,4,12
30OITAWPBQ4V08AHXM3N85FCB5FH9U,"#24-21 Yesterday, reports stated several more pieces of debris, one piece measuring some eight feet by two feet (about 2.4 by 0.6 m), were found on Baa Atoll, Fehendhoo and Fulhahdhoo and washed ashore sometime in the past few days.",7,16,Yesterday,1,0,1
30OITAWPBQ4V08AHXM3N85FCB5FH9U,"#24-21 Yesterday, reports stated several more pieces of debris, one piece measuring some eight feet by two feet (about 2.4 by 0.6 m), were found on Baa Atoll, Fehendhoo and Fulhahdhoo and washed ashore sometime in the past few days.",56,62,debris,5,3,8
30OITAWPBQ4V08AHXM3N85FCB5FH9U,"#24-21 Yesterday, reports stated several more pieces of debris, one piece measuring some eight feet by two feet (about 2.4 by 0.6 m), were found on Baa Atoll, Fehendhoo and Fulhahdhoo and washed ashore sometime in the past few days.",74,83,measuring,3,4,7
30OITAWPBQ4V08AHXM3N85FCB5FH9U,"#24-21 Yesterday, reports stated several more pieces of debris, one piece measuring some eight feet by two feet (about 2.4 by 0.6 m), were found on Baa Atoll, Fehendhoo and Fulhahdhoo and washed ashore sometime in the past few days.",148,157,Baa Atoll,0,1,1
30OITAWPBQ4V08AHXM3N85FCB5FH9U,"#24-21 Yesterday, reports stated several more pieces of debris, one piece measuring some eight feet by two feet (about 2.4 by 0.6 m), were found on Baa Atoll, Fehendhoo and Fulhahdhoo and washed ashore sometime in the past few days.",159,168,Fehendhoo,2,1,3
30OITAWPBQ4V08AHXM3N85FCB5FH9U,"#24-21 Yesterday, reports stated several more pieces of debris, one piece measuring some eight feet by two feet (about 2.4 by 0.6 m), were found on Baa Atoll, Fehendhoo and Fulhahdhoo and washed ashore sometime in the past few days.",173,183,Fulhahdhoo,1,1,2
30OITAWPBQ4V08AHXM3N85FCB5FH9U,"#24-21 Yesterday, reports stated several more pieces of debris, one piece measuring some eight feet by two feet (about 2.4 by 0.6 m), were found on Baa Atoll, Fehendhoo and Fulhahdhoo and washed ashore sometime in the past few days.",195,201,ashore,4,7,11
30OITAWPBQ4V08AHXM3N85FCB5FH9U,"#24-22 One piece appears to have a serial number on the side, possibly reading '021411270507.'",11,16,piece,0,1,1
30OITAWPBQ4V08AHXM3N85FCB5FH9U,"#24-22 One piece appears to have a serial number on the side, possibly reading '021411270507.'",17,24,appears,1,0,1
30OITAWPBQ4V08AHXM3N85FCB5FH9U,"#24-22 One piece appears to have a serial number on the side, possibly reading '021411270507.'",35,41,serial,3,0,3
30OITAWPBQ4V08AHXM3N85FCB5FH9U,"#24-22 One piece appears to have a serial number on the side, possibly reading '021411270507.'",35,48,serial number,1,0,1
30OITAWPBQ4V08AHXM3N85FCB5FH9U,#24-23 Initially residents who found the debris took it home.,7,16,Initially,6,3,9
30OITAWPBQ4V08AHXM3N85FCB5FH9U,#24-23 Initially residents who found the debris took it home.,17,26,residents,3,2,5
30OITAWPBQ4V08AHXM3N85FCB5FH9U,#24-23 Initially residents who found the debris took it home.,41,47,debris,1,3,4
30OITAWPBQ4V08AHXM3N85FCB5FH9U,"#24-24 ""A resident had found the debris and taken it home.",10,18,resident,1,3,4
30OITAWPBQ4V08AHXM3N85FCB5FH9U,"#24-24 ""A resident had found the debris and taken it home.",33,39,debris,3,3,6
33KMQD9OFJFUT0GC5GJR3WZC2CV776,#6-14 He faces rape accusations from two Swedish women.,15,19,rape,1,0,1
33KMQD9OFJFUT0GC5GJR3WZC2CV776,#6-14 He faces rape accusations from two Swedish women.,15,31,rape accusations,0,1,1
33KMQD9OFJFUT0GC5GJR3WZC2CV776,#6-14 He faces rape accusations from two Swedish women.,20,31,accusations,10,10,20
33KMQD9OFJFUT0GC5GJR3WZC2CV776,#6-14 He faces rape accusations from two Swedish women.,41,48,Swedish,0,1,1
33KMQD9OFJFUT0GC5GJR3WZC2CV776,"#6-15 The Obama administration has seen what The New York Times calls an ""unprecedented crackdown on leaks of government secrets.""",16,30,administration,2,2,4
33KMQD9OFJFUT0GC5GJR3WZC2CV776,"#6-15 The Obama administration has seen what The New York Times calls an ""unprecedented crackdown on leaks of government secrets.""",74,87,unprecedented,10,9,19
33KMQD9OFJFUT0GC5GJR3WZC2CV776,"#6-15 The Obama administration has seen what The New York Times calls an ""unprecedented crackdown on leaks of government secrets.""",74,97,unprecedented crackdown,2,4,6
33KMQD9OFJFUT0GC5GJR3WZC2CV776,"#6-15 The Obama administration has seen what The New York Times calls an ""unprecedented crackdown on leaks of government secrets.""",88,97,crackdown,2,7,9
33KMQD9OFJFUT0GC5GJR3WZC2CV776,"#6-15 The Obama administration has seen what The New York Times calls an ""unprecedented crackdown on leaks of government secrets.""",101,106,leaks,1,2,3
33KMQD9OFJFUT0GC5GJR3WZC2CV776,"#6-15 The Obama administration has seen what The New York Times calls an ""unprecedented crackdown on leaks of government secrets.""",101,128,leaks of government secrets,1,0,1
33KMQD9OFJFUT0GC5GJR3WZC2CV776,"#6-15 The Obama administration has seen what The New York Times calls an ""unprecedented crackdown on leaks of government secrets.""",110,120,government,0,1,1
33KMQD9OFJFUT0GC5GJR3WZC2CV776,"#6-16 Manning is among more than 1,500 individuals whom President Obama has granted clemency during his tenure.",6,13,Manning,1,2,3
33KMQD9OFJFUT0GC5GJR3WZC2CV776,"#6-16 Manning is among more than 1,500 individuals whom President Obama has granted clemency during his tenure.",39,50,individuals,0,1,1
33KMQD9OFJFUT0GC5GJR3WZC2CV776,"#6-16 Manning is among more than 1,500 individuals whom President Obama has granted clemency during his tenure.",76,83,granted,0,1,1
33KMQD9OFJFUT0GC5GJR3WZC2CV776,"#6-16 Manning is among more than 1,500 individuals whom President Obama has granted clemency during his tenure.",84,92,clemency,10,9,19
33KMQD9OFJFUT0GC5GJR3WZC2CV776,"#6-16 Manning is among more than 1,500 individuals whom President Obama has granted clemency during his tenure.",104,110,tenure,4,7,11
33KMQD9OFJFUT0GC5GJR3WZC2CV776,#6-17 White House Press Secretary Josh Ernest was asked if NSA whistleblower Edward Snowden would also be pardoned.,34,45,Josh Ernest,0,1,1
33KMQD9OFJFUT0GC5GJR3WZC2CV776,#6-17 White House Press Secretary Josh Ernest was asked if NSA whistleblower Edward Snowden would also be pardoned.,63,76,whistleblower,8,9,17
33KMQD9OFJFUT0GC5GJR3WZC2CV776,#6-17 White House Press Secretary Josh Ernest was asked if NSA whistleblower Edward Snowden would also be pardoned.,77,83,Edward,0,1,1
33KMQD9OFJFUT0GC5GJR3WZC2CV776,#6-17 White House Press Secretary Josh Ernest was asked if NSA whistleblower Edward Snowden would also be pardoned.,84,91,Snowden,0,1,1
33KMQD9OFJFUT0GC5GJR3WZC2CV776,#6-17 White House Press Secretary Josh Ernest was asked if NSA whistleblower Edward Snowden would also be pardoned.,106,114,pardoned,5,10,15
33KMQD9OFJFUT0GC5GJR3WZC2CV776,"#6-18 Ernest said no, saying the information Snowden released was more dangerous to the U.S. public and pointed out that while Manning had gone through a formal trial and acknowledged wrongdoing, ""Mr. Snowden fled into the arms of an adversary and has sought refuge in a country that most recently made a concerted effort to undermine confidence in our democracy.""",71,80,dangerous,2,0,2
33KMQD9OFJFUT0GC5GJR3WZC2CV776,"#6-18 Ernest said no, saying the information Snowden released was more dangerous to the U.S. public and pointed out that while Manning had gone through a formal trial and acknowledged wrongdoing, ""Mr. Snowden fled into the arms of an adversary and has sought refuge in a country that most recently made a concerted effort to undermine confidence in our democracy.""",154,166,formal trial,0,1,1
33KMQD9OFJFUT0GC5GJR3WZC2CV776,"#6-18 Ernest said no, saying the information Snowden released was more dangerous to the U.S. public and pointed out that while Manning had gone through a formal trial and acknowledged wrongdoing, ""Mr. Snowden fled into the arms of an adversary and has sought refuge in a country that most recently made a concerted effort to undermine confidence in our democracy.""",171,183,acknowledged,2,0,2
33KMQD9OFJFUT0GC5GJR3WZC2CV776,"#6-18 Ernest said no, saying the information Snowden released was more dangerous to the U.S. public and pointed out that while Manning had gone through a formal trial and acknowledged wrongdoing, ""Mr. Snowden fled into the arms of an adversary and has sought refuge in a country that most recently made a concerted effort to undermine confidence in our democracy.""",171,194,acknowledged wrongdoing,2,2,4
33KMQD9OFJFUT0GC5GJR3WZC2CV776,"#6-18 Ernest said no, saying the information Snowden released was more dangerous to the U.S. public and pointed out that while Manning had gone through a formal trial and acknowledged wrongdoing, ""Mr. Snowden fled into the arms of an adversary and has sought refuge in a country that most recently made a concerted effort to undermine confidence in our democracy.""",184,194,wrongdoing,2,4,6
33KMQD9OFJFUT0GC5GJR3WZC2CV776,"#6-18 Ernest said no, saying the information Snowden released was more dangerous to the U.S. public and pointed out that while Manning had gone through a formal trial and acknowledged wrongdoing, ""Mr. Snowden fled into the arms of an adversary and has sought refuge in a country that most recently made a concerted effort to undermine confidence in our democracy.""",234,243,adversary,7,8,15
33KMQD9OFJFUT0GC5GJR3WZC2CV776,"#6-18 Ernest said no, saying the information Snowden released was more dangerous to the U.S. public and pointed out that while Manning had gone through a formal trial and acknowledged wrongdoing, ""Mr. Snowden fled into the arms of an adversary and has sought refuge in a country that most recently made a concerted effort to undermine confidence in our democracy.""",252,258,sought,3,2,5
33KMQD9OFJFUT0GC5GJR3WZC2CV776,"#6-18 Ernest said no, saying the information Snowden released was more dangerous to the U.S. public and pointed out that while Manning had gone through a formal trial and acknowledged wrongdoing, ""Mr. Snowden fled into the arms of an adversary and has sought refuge in a country that most recently made a concerted effort to undermine confidence in our democracy.""",252,265,sought refuge,0,2,2
33KMQD9OFJFUT0GC5GJR3WZC2CV776,"#6-18 Ernest said no, saying the information Snowden released was more dangerous to the U.S. public and pointed out that while Manning had gone through a formal trial and acknowledged wrongdoing, ""Mr. Snowden fled into the arms of an adversary and has sought refuge in a country that most recently made a concerted effort to undermine confidence in our democracy.""",259,265,refuge,2,3,5
33KMQD9OFJFUT0GC5GJR3WZC2CV776,"#6-18 Ernest said no, saying the information Snowden released was more dangerous to the U.S. public and pointed out that while Manning had gone through a formal trial and acknowledged wrongdoing, ""Mr. Snowden fled into the arms of an adversary and has sought refuge in a country that most recently made a concerted effort to undermine confidence in our democracy.""",305,314,concerted,6,4,10
33KMQD9OFJFUT0GC5GJR3WZC2CV776,"#6-18 Ernest said no, saying the information Snowden released was more dangerous to the U.S. public and pointed out that while Manning had gone through a formal trial and acknowledged wrongdoing, ""Mr. Snowden fled into the arms of an adversary and has sought refuge in a country that most recently made a concerted effort to undermine confidence in our democracy.""",305,321,concerted effort,0,2,2
33KMQD9OFJFUT0GC5GJR3WZC2CV776,"#6-18 Ernest said no, saying the information Snowden released was more dangerous to the U.S. public and pointed out that while Manning had gone through a formal trial and acknowledged wrongdoing, ""Mr. Snowden fled into the arms of an adversary and has sought refuge in a country that most recently made a concerted effort to undermine confidence in our democracy.""",325,334,undermine,4,4,8
33KMQD9OFJFUT0GC5GJR3WZC2CV776,"#6-18 Ernest said no, saying the information Snowden released was more dangerous to the U.S. public and pointed out that while Manning had gone through a formal trial and acknowledged wrongdoing, ""Mr. Snowden fled into the arms of an adversary and has sought refuge in a country that most recently made a concerted effort to undermine confidence in our democracy.""",325,345,undermine confidence,1,0,1
33KMQD9OFJFUT0GC5GJR3WZC2CV776,"#6-18 Ernest said no, saying the information Snowden released was more dangerous to the U.S. public and pointed out that while Manning had gone through a formal trial and acknowledged wrongdoing, ""Mr. Snowden fled into the arms of an adversary and has sought refuge in a country that most recently made a concerted effort to undermine confidence in our democracy.""",353,362,democracy,3,1,4
33KMQD9OFJFUT0GC5GJR3WZC2CV776,"#6-19 This week, Obama also commuted the sentences of Oscar Lopez Rivera, a Puerto Rican nationalist linked to bombings in the 1970s and 1980s, James E. Cartwright, a former Marine general and White House Chief of Staff convicted of lying to the FBI, and over two hundred other individuals, mostly drug offenders.",28,36,commuted,4,5,9
33KMQD9OFJFUT0GC5GJR3WZC2CV776,"#6-19 This week, Obama also commuted the sentences of Oscar Lopez Rivera, a Puerto Rican nationalist linked to bombings in the 1970s and 1980s, James E. Cartwright, a former Marine general and White House Chief of Staff convicted of lying to the FBI, and over two hundred other individuals, mostly drug offenders.",89,100,nationalist,3,1,4
33KMQD9OFJFUT0GC5GJR3WZC2CV776,"#6-19 This week, Obama also commuted the sentences of Oscar Lopez Rivera, a Puerto Rican nationalist linked to bombings in the 1970s and 1980s, James E. Cartwright, a former Marine general and White House Chief of Staff convicted of lying to the FBI, and over two hundred other individuals, mostly drug offenders.",220,229,convicted,0,1,1
3VAOOVPI3ZTSN6UGD4LB56ZESG5LL2,"#4-8 Following Apollo 17, Cernan worked on the Apollo-Soyuz project before retiring from NASA and the Navy in 1976.",15,21,Apollo,1,0,1
3VAOOVPI3ZTSN6UGD4LB56ZESG5LL2,"#4-8 Following Apollo 17, Cernan worked on the Apollo-Soyuz project before retiring from NASA and the Navy in 1976.",26,32,Cernan,0,1,1
3VAOOVPI3ZTSN6UGD4LB56ZESG5LL2,"#4-8 Following Apollo 17, Cernan worked on the Apollo-Soyuz project before retiring from NASA and the Navy in 1976.",26,39,Cernan worked,0,1,1
3VAOOVPI3ZTSN6UGD4LB56ZESG5LL2,"#4-8 Following Apollo 17, Cernan worked on the Apollo-Soyuz project before retiring from NASA and the Navy in 1976.",47,59,Apollo-Soyuz,1,1,2
3VAOOVPI3ZTSN6UGD4LB56ZESG5LL2,"#4-8 Following Apollo 17, Cernan worked on the Apollo-Soyuz project before retiring from NASA and the Navy in 1976.",47,67,Apollo-Soyuz project,1,0,1
3VAOOVPI3ZTSN6UGD4LB56ZESG5LL2,"#4-8 Following Apollo 17, Cernan worked on the Apollo-Soyuz project before retiring from NASA and the Navy in 1976.",60,67,project,0,1,1
3VAOOVPI3ZTSN6UGD4LB56ZESG5LL2,"#4-8 Following Apollo 17, Cernan worked on the Apollo-Soyuz project before retiring from NASA and the Navy in 1976.",75,83,retiring,4,3,7
3VAOOVPI3ZTSN6UGD4LB56ZESG5LL2,"#4-8 Following Apollo 17, Cernan worked on the Apollo-Soyuz project before retiring from NASA and the Navy in 1976.",89,93,NASA,2,0,2
3VAOOVPI3ZTSN6UGD4LB56ZESG5LL2,"#4-9 In his later years he became an executive and consultant, wrote an autobiography, and advocated for returning to the Moon along with Neil Armstrong, the first human to walk on the Moon, who died in 2012.",37,46,executive,7,3,10
3VAOOVPI3ZTSN6UGD4LB56ZESG5LL2,"#4-9 In his later years he became an executive and consultant, wrote an autobiography, and advocated for returning to the Moon along with Neil Armstrong, the first human to walk on the Moon, who died in 2012.",37,61,executive and consultant,1,0,1
3VAOOVPI3ZTSN6UGD4LB56ZESG5LL2,"#4-9 In his later years he became an executive and consultant, wrote an autobiography, and advocated for returning to the Moon along with Neil Armstrong, the first human to walk on the Moon, who died in 2012.",51,61,consultant,7,5,12
3VAOOVPI3ZTSN6UGD4LB56ZESG5LL2,"#4-9 In his later years he became an executive and consultant, wrote an autobiography, and advocated for returning to the Moon along with Neil Armstrong, the first human to walk on the Moon, who died in 2012.",72,85,autobiography,10,2,12
3VAOOVPI3ZTSN6UGD4LB56ZESG5LL2,"#4-9 In his later years he became an executive and consultant, wrote an autobiography, and advocated for returning to the Moon along with Neil Armstrong, the first human to walk on the Moon, who died in 2012.",91,100,advocated,10,7,17
3VAOOVPI3ZTSN6UGD4LB56ZESG5LL2,"#4-9 In his later years he became an executive and consultant, wrote an autobiography, and advocated for returning to the Moon along with Neil Armstrong, the first human to walk on the Moon, who died in 2012.",105,114,returning,1,0,1
3VAOOVPI3ZTSN6UGD4LB56ZESG5LL2,"#4-9 In his later years he became an executive and consultant, wrote an autobiography, and advocated for returning to the Moon along with Neil Armstrong, the first human to walk on the Moon, who died in 2012.",138,152,Neil Armstrong,0,1,1
3VAOOVPI3ZTSN6UGD4LB56ZESG5LL2,"#4-10 ""Truly, America has lost a patriot and pioneer who helped shape our country's bold ambitions to do things that humankind had never before achieved,"" NASA Administrator Charles Bolden said in a statement.",33,40,patriot,4,6,10
3VAOOVPI3ZTSN6UGD4LB56ZESG5LL2,"#4-10 ""Truly, America has lost a patriot and pioneer who helped shape our country's bold ambitions to do things that humankind had never before achieved,"" NASA Administrator Charles Bolden said in a statement.",45,52,pioneer,4,6,10
3VAOOVPI3ZTSN6UGD4LB56ZESG5LL2,"#4-10 ""Truly, America has lost a patriot and pioneer who helped shape our country's bold ambitions to do things that humankind had never before achieved,"" NASA Administrator Charles Bolden said in a statement.",64,69,shape,0,1,1
3VAOOVPI3ZTSN6UGD4LB56ZESG5LL2,"#4-10 ""Truly, America has lost a patriot and pioneer who helped shape our country's bold ambitions to do things that humankind had never before achieved,"" NASA Administrator Charles Bolden said in a statement.",74,97,countrys bold ambitions,0,1,1
3VAOOVPI3ZTSN6UGD4LB56ZESG5LL2,"#4-10 ""Truly, America has lost a patriot and pioneer who helped shape our country's bold ambitions to do things that humankind had never before achieved,"" NASA Administrator Charles Bolden said in a statement.",84,88,bold,0,1,1
3VAOOVPI3ZTSN6UGD4LB56ZESG5LL2,"#4-10 ""Truly, America has lost a patriot and pioneer who helped shape our country's bold ambitions to do things that humankind had never before achieved,"" NASA Administrator Charles Bolden said in a statement.",84,98,bold ambitions,0,1,1
3VAOOVPI3ZTSN6UGD4LB56ZESG5LL2,"#4-10 ""Truly, America has lost a patriot and pioneer who helped shape our country's bold ambitions to do things that humankind had never before achieved,"" NASA Administrator Charles Bolden said in a statement.",89,98,ambitions,4,8,12
3VAOOVPI3ZTSN6UGD4LB56ZESG5LL2,"#4-10 ""Truly, America has lost a patriot and pioneer who helped shape our country's bold ambitions to do things that humankind had never before achieved,"" NASA Administrator Charles Bolden said in a statement.",89,126,ambitions to do things that humankind,0,1,1
3VAOOVPI3ZTSN6UGD4LB56ZESG5LL2,"#4-10 ""Truly, America has lost a patriot and pioneer who helped shape our country's bold ambitions to do things that humankind had never before achieved,"" NASA Administrator Charles Bolden said in a statement.",117,126,humankind,3,6,9
3VAOOVPI3ZTSN6UGD4LB56ZESG5LL2,"#4-10 ""Truly, America has lost a patriot and pioneer who helped shape our country's bold ambitions to do things that humankind had never before achieved,"" NASA Administrator Charles Bolden said in a statement.",144,152,achieved,2,3,5
3VAOOVPI3ZTSN6UGD4LB56ZESG5LL2,"#4-10 ""Truly, America has lost a patriot and pioneer who helped shape our country's bold ambitions to do things that humankind had never before achieved,"" NASA Administrator Charles Bolden said in a statement.",160,173,Administrator,2,0,2
3VAOOVPI3ZTSN6UGD4LB56ZESG5LL2,"#4-10 ""Truly, America has lost a patriot and pioneer who helped shape our country's bold ambitions to do things that humankind had never before achieved,"" NASA Administrator Charles Bolden said in a statement.",160,188,Administrator Charles Bolden,0,1,1
3VAOOVPI3ZTSN6UGD4LB56ZESG5LL2,"#4-10 ""Truly, America has lost a patriot and pioneer who helped shape our country's bold ambitions to do things that humankind had never before achieved,"" NASA Administrator Charles Bolden said in a statement.",174,188,Charles Bolden,0,1,1
3VAOOVPI3ZTSN6UGD4LB56ZESG5LL2,#40-1 Gujarat quota protests turn violent Parts of the Indian state of Gujarat have been under curfew since Tuesday.,6,19,Gujarat quota,0,1,1
3VAOOVPI3ZTSN6UGD4LB56ZESG5LL2,#40-1 Gujarat quota protests turn violent Parts of the Indian state of Gujarat have been under curfew since Tuesday.,6,28,Gujarat quota protests,2,0,2
3VAOOVPI3ZTSN6UGD4LB56ZESG5LL2,#40-1 Gujarat quota protests turn violent Parts of the Indian state of Gujarat have been under curfew since Tuesday.,14,19,quota,5,1,6
3VAOOVPI3ZTSN6UGD4LB56ZESG5LL2,#40-1 Gujarat quota protests turn violent Parts of the Indian state of Gujarat have been under curfew since Tuesday.,14,28,quota protests,1,0,1
3VAOOVPI3ZTSN6UGD4LB56ZESG5LL2,#40-1 Gujarat quota protests turn violent Parts of the Indian state of Gujarat have been under curfew since Tuesday.,20,28,protests,1,2,3
3VAOOVPI3ZTSN6UGD4LB56ZESG5LL2,#40-1 Gujarat quota protests turn violent Parts of the Indian state of Gujarat have been under curfew since Tuesday.,34,41,violent,2,0,2
3VAOOVPI3ZTSN6UGD4LB56ZESG5LL2,#40-1 Gujarat quota protests turn violent Parts of the Indian state of Gujarat have been under curfew since Tuesday.,71,78,Gujarat,1,0,1
3VAOOVPI3ZTSN6UGD4LB56ZESG5LL2,#40-1 Gujarat quota protests turn violent Parts of the Indian state of Gujarat have been under curfew since Tuesday.,95,101,curfew,6,9,15
3VAOOVPI3ZTSN6UGD4LB56ZESG5LL2,"#40-2 At least seven are reported dead, with over 100 buses and dozens of police stations burned, after protests over job quotas turned violent in several major cities including Ahmedabad, Surat, and Rajkot.",64,70,dozens,0,1,1
3VAOOVPI3ZTSN6UGD4LB56ZESG5LL2,"#40-2 At least seven are reported dead, with over 100 buses and dozens of police stations burned, after protests over job quotas turned violent in several major cities including Ahmedabad, Surat, and Rajkot.",104,112,protests,2,1,3
3VAOOVPI3ZTSN6UGD4LB56ZESG5LL2,"#40-2 At least seven are reported dead, with over 100 buses and dozens of police stations burned, after protests over job quotas turned violent in several major cities including Ahmedabad, Surat, and Rajkot.",118,128,job quotas,1,0,1
3VAOOVPI3ZTSN6UGD4LB56ZESG5LL2,"#40-2 At least seven are reported dead, with over 100 buses and dozens of police stations burned, after protests over job quotas turned violent in several major cities including Ahmedabad, Surat, and Rajkot.",122,128,quotas,3,2,5
3VAOOVPI3ZTSN6UGD4LB56ZESG5LL2,"#40-2 At least seven are reported dead, with over 100 buses and dozens of police stations burned, after protests over job quotas turned violent in several major cities including Ahmedabad, Surat, and Rajkot.",178,187,Ahmedabad,0,1,1
3OPLMF3EU5OIB6X1PH1QIY33XB5LN4,"#42-34 We then drilled a tunnel to a pot (the foraging arena), where the ants got the choice between the food with medicine and the food without.",15,22,drilled,1,7,8
3OPLMF3EU5OIB6X1PH1QIY33XB5LN4,"#42-34 We then drilled a tunnel to a pot (the foraging arena), where the ants got the choice between the food with medicine and the food without.",15,31,drilled a tunnel,1,0,1
3OPLMF3EU5OIB6X1PH1QIY33XB5LN4,"#42-34 We then drilled a tunnel to a pot (the foraging arena), where the ants got the choice between the food with medicine and the food without.",25,31,tunnel,2,4,6
3OPLMF3EU5OIB6X1PH1QIY33XB5LN4,"#42-34 We then drilled a tunnel to a pot (the foraging arena), where the ants got the choice between the food with medicine and the food without.",37,40,pot,1,0,1
3OPLMF3EU5OIB6X1PH1QIY33XB5LN4,"#42-34 We then drilled a tunnel to a pot (the foraging arena), where the ants got the choice between the food with medicine and the food without.",42,60,the foraging arena,1,0,1
3OPLMF3EU5OIB6X1PH1QIY33XB5LN4,"#42-34 We then drilled a tunnel to a pot (the foraging arena), where the ants got the choice between the food with medicine and the food without.",46,54,foraging,6,3,9
3OPLMF3EU5OIB6X1PH1QIY33XB5LN4,"#42-34 We then drilled a tunnel to a pot (the foraging arena), where the ants got the choice between the food with medicine and the food without.",46,60,foraging arena,1,1,2
3OPLMF3EU5OIB6X1PH1QIY33XB5LN4,"#42-34 We then drilled a tunnel to a pot (the foraging arena), where the ants got the choice between the food with medicine and the food without.",115,123,medicine,2,0,2
3OPLMF3EU5OIB6X1PH1QIY33XB5LN4,#42-35 We infected the ants by preparing a solution of the fungus Beauveria bassiana.,10,18,infected,2,4,6
3OPLMF3EU5OIB6X1PH1QIY33XB5LN4,#42-35 We infected the ants by preparing a solution of the fungus Beauveria bassiana.,31,40,preparing,0,1,1
3OPLMF3EU5OIB6X1PH1QIY33XB5LN4,#42-35 We infected the ants by preparing a solution of the fungus Beauveria bassiana.,43,51,solution,2,1,3
3OPLMF3EU5OIB6X1PH1QIY33XB5LN4,#42-35 We infected the ants by preparing a solution of the fungus Beauveria bassiana.,59,65,fungus,6,2,8
3OPLMF3EU5OIB6X1PH1QIY33XB5LN4,#42-35 We infected the ants by preparing a solution of the fungus Beauveria bassiana.,59,84,fungus Beauveria bassiana,2,0,2
3OPLMF3EU5OIB6X1PH1QIY33XB5LN4,#42-35 We infected the ants by preparing a solution of the fungus Beauveria bassiana.,66,75,Beauveria,3,0,3
3OPLMF3EU5OIB6X1PH1QIY33XB5LN4,#42-35 We infected the ants by preparing a solution of the fungus Beauveria bassiana.,66,84,Beauveria bassiana,5,2,7
3OPLMF3EU5OIB6X1PH1QIY33XB5LN4,#42-35 We infected the ants by preparing a solution of the fungus Beauveria bassiana.,76,84,bassiana,4,2,6
3OPLMF3EU5OIB6X1PH1QIY33XB5LN4,"#42-36 Afterwards, each ant was dipped in the solution for a couple of seconds, dried on a cloth and put in the nest.",7,17,Afterwards,1,0,1
3OPLMF3EU5OIB6X1PH1QIY33XB5LN4,"#42-36 Afterwards, each ant was dipped in the solution for a couple of seconds, dried on a cloth and put in the nest.",32,38,dipped,0,5,5
3OPLMF3EU5OIB6X1PH1QIY33XB5LN4,"#42-36 Afterwards, each ant was dipped in the solution for a couple of seconds, dried on a cloth and put in the nest.",46,54,solution,1,0,1
3OPLMF3EU5OIB6X1PH1QIY33XB5LN4,"#42-36 Afterwards, each ant was dipped in the solution for a couple of seconds, dried on a cloth and put in the nest.",80,85,dried,0,2,2
3OPLMF3EU5OIB6X1PH1QIY33XB5LN4,"#42-37 After exposing the ants to the fungus, we took pictures of each foraging arena three times per day, and counted how many ants were present on each food-source.",13,21,exposing,4,6,10
3OPLMF3EU5OIB6X1PH1QIY33XB5LN4,"#42-37 After exposing the ants to the fungus, we took pictures of each foraging arena three times per day, and counted how many ants were present on each food-source.",38,44,fungus,3,1,4
3OPLMF3EU5OIB6X1PH1QIY33XB5LN4,"#42-37 After exposing the ants to the fungus, we took pictures of each foraging arena three times per day, and counted how many ants were present on each food-source.",71,79,foraging,3,7,10
3OPLMF3EU5OIB6X1PH1QIY33XB5LN4,"#42-37 After exposing the ants to the fungus, we took pictures of each foraging arena three times per day, and counted how many ants were present on each food-source.",71,85,foraging arena,4,2,6
3OPLMF3EU5OIB6X1PH1QIY33XB5LN4,"#42-37 After exposing the ants to the fungus, we took pictures of each foraging arena three times per day, and counted how many ants were present on each food-source.",80,85,arena,0,2,2
3OPLMF3EU5OIB6X1PH1QIY33XB5LN4,"#42-37 After exposing the ants to the fungus, we took pictures of each foraging arena three times per day, and counted how many ants were present on each food-source.",111,118,counted,0,1,1
3OPLMF3EU5OIB6X1PH1QIY33XB5LN4,"#42-37 After exposing the ants to the fungus, we took pictures of each foraging arena three times per day, and counted how many ants were present on each food-source.",154,165,food-source,1,1,2
3OPLMF3EU5OIB6X1PH1QIY33XB5LN4,#42-38 This gave us the data that ants choose more medicine after they have been infected.,81,89,infected,1,1,2
3OPLMF3EU5OIB6X1PH1QIY33XB5LN4,"#42-39 The result that healthy ants die sooner when ingesting ROS [Reactive Oxygen Species, the group of chemicals that includes hydrogen peroxide] but infected ants die less was obtained in another way (as you have to 'force feed' the ROS, as healthy ants, when given the choice, ignore that food-source.)",40,46,sooner,0,2,2
3OPLMF3EU5OIB6X1PH1QIY33XB5LN4,"#42-39 The result that healthy ants die sooner when ingesting ROS [Reactive Oxygen Species, the group of chemicals that includes hydrogen peroxide] but infected ants die less was obtained in another way (as you have to 'force feed' the ROS, as healthy ants, when given the choice, ignore that food-source.)",52,61,ingesting,3,10,13
3OPLMF3EU5OIB6X1PH1QIY33XB5LN4,"#42-39 The result that healthy ants die sooner when ingesting ROS [Reactive Oxygen Species, the group of chemicals that includes hydrogen peroxide] but infected ants die less was obtained in another way (as you have to 'force feed' the ROS, as healthy ants, when given the choice, ignore that food-source.)",62,65,ROS,2,0,2
3OPLMF3EU5OIB6X1PH1QIY33XB5LN4,"#42-39 The result that healthy ants die sooner when ingesting ROS [Reactive Oxygen Species, the group of chemicals that includes hydrogen peroxide] but infected ants die less was obtained in another way (as you have to 'force feed' the ROS, as healthy ants, when given the choice, ignore that food-source.)",62,90,ROS [Reactive Oxygen Species,1,0,1
3OPLMF3EU5OIB6X1PH1QIY33XB5LN4,"#42-39 The result that healthy ants die sooner when ingesting ROS [Reactive Oxygen Species, the group of chemicals that includes hydrogen peroxide] but infected ants die less was obtained in another way (as you have to 'force feed' the ROS, as healthy ants, when given the choice, ignore that food-source.)",67,75,Reactive,1,0,1
3OPLMF3EU5OIB6X1PH1QIY33XB5LN4,"#42-39 The result that healthy ants die sooner when ingesting ROS [Reactive Oxygen Species, the group of chemicals that includes hydrogen peroxide] but infected ants die less was obtained in another way (as you have to 'force feed' the ROS, as healthy ants, when given the choice, ignore that food-source.)",67,90,Reactive Oxygen Species,2,0,2
3OPLMF3EU5OIB6X1PH1QIY33XB5LN4,"#42-39 The result that healthy ants die sooner when ingesting ROS [Reactive Oxygen Species, the group of chemicals that includes hydrogen peroxide] but infected ants die less was obtained in another way (as you have to 'force feed' the ROS, as healthy ants, when given the choice, ignore that food-source.)",76,82,Oxygen,1,0,1
3OPLMF3EU5OIB6X1PH1QIY33XB5LN4,"#42-39 The result that healthy ants die sooner when ingesting ROS [Reactive Oxygen Species, the group of chemicals that includes hydrogen peroxide] but infected ants die less was obtained in another way (as you have to 'force feed' the ROS, as healthy ants, when given the choice, ignore that food-source.)",83,90,Species,2,2,4
3OPLMF3EU5OIB6X1PH1QIY33XB5LN4,"#42-39 The result that healthy ants die sooner when ingesting ROS [Reactive Oxygen Species, the group of chemicals that includes hydrogen peroxide] but infected ants die less was obtained in another way (as you have to 'force feed' the ROS, as healthy ants, when given the choice, ignore that food-source.)",105,114,chemicals,1,0,1
3OPLMF3EU5OIB6X1PH1QIY33XB5LN4,"#42-39 The result that healthy ants die sooner when ingesting ROS [Reactive Oxygen Species, the group of chemicals that includes hydrogen peroxide] but infected ants die less was obtained in another way (as you have to 'force feed' the ROS, as healthy ants, when given the choice, ignore that food-source.)",129,137,hydrogen,4,0,4
3OPLMF3EU5OIB6X1PH1QIY33XB5LN4,"#42-39 The result that healthy ants die sooner when ingesting ROS [Reactive Oxygen Species, the group of chemicals that includes hydrogen peroxide] but infected ants die less was obtained in another way (as you have to 'force feed' the ROS, as healthy ants, when given the choice, ignore that food-source.)",129,146,hydrogen peroxide,2,0,2
3OPLMF3EU5OIB6X1PH1QIY33XB5LN4,"#42-39 The result that healthy ants die sooner when ingesting ROS [Reactive Oxygen Species, the group of chemicals that includes hydrogen peroxide] but infected ants die less was obtained in another way (as you have to 'force feed' the ROS, as healthy ants, when given the choice, ignore that food-source.)",138,146,peroxide,1,0,1
3OPLMF3EU5OIB6X1PH1QIY33XB5LN4,"#42-39 The result that healthy ants die sooner when ingesting ROS [Reactive Oxygen Species, the group of chemicals that includes hydrogen peroxide] but infected ants die less was obtained in another way (as you have to 'force feed' the ROS, as healthy ants, when given the choice, ignore that food-source.)",152,160,infected,1,0,1
3OPLMF3EU5OIB6X1PH1QIY33XB5LN4,"#42-39 The result that healthy ants die sooner when ingesting ROS [Reactive Oxygen Species, the group of chemicals that includes hydrogen peroxide] but infected ants die less was obtained in another way (as you have to 'force feed' the ROS, as healthy ants, when given the choice, ignore that food-source.)",179,187,obtained,3,3,6
3OPLMF3EU5OIB6X1PH1QIY33XB5LN4,"#42-39 The result that healthy ants die sooner when ingesting ROS [Reactive Oxygen Species, the group of chemicals that includes hydrogen peroxide] but infected ants die less was obtained in another way (as you have to 'force feed' the ROS, as healthy ants, when given the choice, ignore that food-source.)",220,230,force feed,0,2,2
3OPLMF3EU5OIB6X1PH1QIY33XB5LN4,"#42-39 The result that healthy ants die sooner when ingesting ROS [Reactive Oxygen Species, the group of chemicals that includes hydrogen peroxide] but infected ants die less was obtained in another way (as you have to 'force feed' the ROS, as healthy ants, when given the choice, ignore that food-source.)",281,287,ignore,2,1,3
36GJS3V78VR66OSFZSCICZHESAEJGS,"#42-80 If they would only do it in the lab, the behaviour wouldn't be very interesting.",48,57,behaviour,9,3,12
36GJS3V78VR66OSFZSCICZHESAEJGS,"#42-81 We have some guesses where they might get it from, but at the moment we don't know yet.",20,27,guesses,2,5,7
36GJS3V78VR66OSFZSCICZHESAEJGS,"#42-81 We have some guesses where they might get it from, but at the moment we don't know yet.",69,75,moment,1,1,2
36GJS3V78VR66OSFZSCICZHESAEJGS,"#42-82 That said, I plan to investigate this question (among others) further [in] the next couple of years.",28,39,investigate,8,6,14
36GJS3V78VR66OSFZSCICZHESAEJGS,"#42-82 That said, I plan to investigate this question (among others) further [in] the next couple of years.",91,97,couple,1,1,2
36GJS3V78VR66OSFZSCICZHESAEJGS,#42-83 Wikinews: For your PhD you researched ants' scent-based communications.,7,15,Wikinews,1,0,1
36GJS3V78VR66OSFZSCICZHESAEJGS,#42-83 Wikinews: For your PhD you researched ants' scent-based communications.,26,29,PhD,1,0,1
36GJS3V78VR66OSFZSCICZHESAEJGS,#42-83 Wikinews: For your PhD you researched ants' scent-based communications.,34,44,researched,2,0,2
36GJS3V78VR66OSFZSCICZHESAEJGS,#42-83 Wikinews: For your PhD you researched ants' scent-based communications.,45,76,ants scent-based communications,0,1,1
36GJS3V78VR66OSFZSCICZHESAEJGS,#42-83 Wikinews: For your PhD you researched ants' scent-based communications.,51,62,scent-based,2,5,7
36GJS3V78VR66OSFZSCICZHESAEJGS,#42-83 Wikinews: For your PhD you researched ants' scent-based communications.,51,77,scent-based communications,5,2,7
36GJS3V78VR66OSFZSCICZHESAEJGS,#42-83 Wikinews: For your PhD you researched ants' scent-based communications.,63,77,communications,4,1,5
36GJS3V78VR66OSFZSCICZHESAEJGS,#42-84 Could healthy ants perhaps tell other ants are infected and encourage this behaviour?,54,62,infected,1,5,6
36GJS3V78VR66OSFZSCICZHESAEJGS,#42-84 Could healthy ants perhaps tell other ants are infected and encourage this behaviour?,67,76,encourage,2,4,6
36GJS3V78VR66OSFZSCICZHESAEJGS,#42-86 There's conflicting evidence about whether sick ants actually smell different from healthy ones or not.,15,26,conflicting,6,8,14
36GJS3V78VR66OSFZSCICZHESAEJGS,#42-86 There's conflicting evidence about whether sick ants actually smell different from healthy ones or not.,15,35,conflicting evidence,3,0,3
36GJS3V78VR66OSFZSCICZHESAEJGS,#42-86 There's conflicting evidence about whether sick ants actually smell different from healthy ones or not.,27,35,evidence,0,3,3
36GJS3V78VR66OSFZSCICZHESAEJGS,#42-86 There's conflicting evidence about whether sick ants actually smell different from healthy ones or not.,60,68,actually,1,0,1
36GJS3V78VR66OSFZSCICZHESAEJGS,#42-86 There's conflicting evidence about whether sick ants actually smell different from healthy ones or not.,69,74,smell,0,1,1
36GJS3V78VR66OSFZSCICZHESAEJGS,"#42-88 Sick ants stop most interaction with nestmates and especially brood, and leave the nest to die in isolation.",27,38,interaction,5,3,8
36GJS3V78VR66OSFZSCICZHESAEJGS,"#42-88 Sick ants stop most interaction with nestmates and especially brood, and leave the nest to die in isolation.",44,53,nestmates,10,10,20
36GJS3V78VR66OSFZSCICZHESAEJGS,"#42-88 Sick ants stop most interaction with nestmates and especially brood, and leave the nest to die in isolation.",44,74,nestmates and especially brood,1,0,1
36GJS3V78VR66OSFZSCICZHESAEJGS,"#42-88 Sick ants stop most interaction with nestmates and especially brood, and leave the nest to die in isolation.",69,74,brood,2,7,9
36GJS3V78VR66OSFZSCICZHESAEJGS,"#42-88 Sick ants stop most interaction with nestmates and especially brood, and leave the nest to die in isolation.",90,94,nest,0,1,1
36GJS3V78VR66OSFZSCICZHESAEJGS,"#42-88 Sick ants stop most interaction with nestmates and especially brood, and leave the nest to die in isolation.",98,114,die in isolation,0,1,1
36GJS3V78VR66OSFZSCICZHESAEJGS,"#42-88 Sick ants stop most interaction with nestmates and especially brood, and leave the nest to die in isolation.",105,114,isolation,10,8,18
3ZTE0JGGCET7QN37DJ84U4DLTCWOC6,#42-56 How common are they in the wild?,11,17,common,1,0,1
3ZTE0JGGCET7QN37DJ84U4DLTCWOC6,"#42-57 NB: For ants, see above about the collection.",41,51,collection,3,4,7
3ZTE0JGGCET7QN37DJ84U4DLTCWOC6,"#42-58 This species of fungus does appear in Finland, but we chose to use a different strain from Denmark (with thanks to Prof. J. Eilenberg and the laboratory technician Louise Lee Munch Larsen from the University of Copenhagen).",12,19,species,6,7,13
3ZTE0JGGCET7QN37DJ84U4DLTCWOC6,"#42-58 This species of fungus does appear in Finland, but we chose to use a different strain from Denmark (with thanks to Prof. J. Eilenberg and the laboratory technician Louise Lee Munch Larsen from the University of Copenhagen).",12,29,species of fungus,1,0,1
3ZTE0JGGCET7QN37DJ84U4DLTCWOC6,"#42-58 This species of fungus does appear in Finland, but we chose to use a different strain from Denmark (with thanks to Prof. J. Eilenberg and the laboratory technician Louise Lee Munch Larsen from the University of Copenhagen).",23,29,fungus,7,2,9
3ZTE0JGGCET7QN37DJ84U4DLTCWOC6,"#42-58 This species of fungus does appear in Finland, but we chose to use a different strain from Denmark (with thanks to Prof. J. Eilenberg and the laboratory technician Louise Lee Munch Larsen from the University of Copenhagen).",35,41,appear,1,1,2
3ZTE0JGGCET7QN37DJ84U4DLTCWOC6,"#42-58 This species of fungus does appear in Finland, but we chose to use a different strain from Denmark (with thanks to Prof. J. Eilenberg and the laboratory technician Louise Lee Munch Larsen from the University of Copenhagen).",76,92,different strain,1,1,2
3ZTE0JGGCET7QN37DJ84U4DLTCWOC6,"#42-58 This species of fungus does appear in Finland, but we chose to use a different strain from Denmark (with thanks to Prof. J. Eilenberg and the laboratory technician Louise Lee Munch Larsen from the University of Copenhagen).",86,92,strain,7,7,14
3ZTE0JGGCET7QN37DJ84U4DLTCWOC6,"#42-58 This species of fungus does appear in Finland, but we chose to use a different strain from Denmark (with thanks to Prof. J. Eilenberg and the laboratory technician Louise Lee Munch Larsen from the University of Copenhagen).",149,159,laboratory,5,0,5
3ZTE0JGGCET7QN37DJ84U4DLTCWOC6,"#42-58 This species of fungus does appear in Finland, but we chose to use a different strain from Denmark (with thanks to Prof. J. Eilenberg and the laboratory technician Louise Lee Munch Larsen from the University of Copenhagen).",149,170,laboratory technician,1,0,1
3ZTE0JGGCET7QN37DJ84U4DLTCWOC6,"#42-58 This species of fungus does appear in Finland, but we chose to use a different strain from Denmark (with thanks to Prof. J. Eilenberg and the laboratory technician Louise Lee Munch Larsen from the University of Copenhagen).",160,170,technician,3,1,4
3ZTE0JGGCET7QN37DJ84U4DLTCWOC6,"#42-59 Animals can adapt to local strains ('local adaptation'), and just to make sure we thought it would be good to use a strain of fungus that the ants definitely did not evolve specific resistances against.",19,24,adapt,5,2,7
3ZTE0JGGCET7QN37DJ84U4DLTCWOC6,"#42-59 Animals can adapt to local strains ('local adaptation'), and just to make sure we thought it would be good to use a strain of fungus that the ants definitely did not evolve specific resistances against.",28,41,local strains,2,1,3
3ZTE0JGGCET7QN37DJ84U4DLTCWOC6,"#42-59 Animals can adapt to local strains ('local adaptation'), and just to make sure we thought it would be good to use a strain of fungus that the ants definitely did not evolve specific resistances against.",34,41,strains,3,4,7
3ZTE0JGGCET7QN37DJ84U4DLTCWOC6,"#42-59 Animals can adapt to local strains ('local adaptation'), and just to make sure we thought it would be good to use a strain of fungus that the ants definitely did not evolve specific resistances against.",44,60,local adaptation,2,0,2
3ZTE0JGGCET7QN37DJ84U4DLTCWOC6,"#42-59 Animals can adapt to local strains ('local adaptation'), and just to make sure we thought it would be good to use a strain of fungus that the ants definitely did not evolve specific resistances against.",50,60,adaptation,3,5,8
3ZTE0JGGCET7QN37DJ84U4DLTCWOC6,"#42-59 Animals can adapt to local strains ('local adaptation'), and just to make sure we thought it would be good to use a strain of fungus that the ants definitely did not evolve specific resistances against.",123,129,strain,2,2,4
3ZTE0JGGCET7QN37DJ84U4DLTCWOC6,"#42-59 Animals can adapt to local strains ('local adaptation'), and just to make sure we thought it would be good to use a strain of fungus that the ants definitely did not evolve specific resistances against.",123,139,strain of fungus,2,0,2
3ZTE0JGGCET7QN37DJ84U4DLTCWOC6,"#42-59 Animals can adapt to local strains ('local adaptation'), and just to make sure we thought it would be good to use a strain of fungus that the ants definitely did not evolve specific resistances against.",133,139,fungus,1,1,2
3ZTE0JGGCET7QN37DJ84U4DLTCWOC6,"#42-59 Animals can adapt to local strains ('local adaptation'), and just to make sure we thought it would be good to use a strain of fungus that the ants definitely did not evolve specific resistances against.",154,164,definitely,1,3,4
3ZTE0JGGCET7QN37DJ84U4DLTCWOC6,"#42-59 Animals can adapt to local strains ('local adaptation'), and just to make sure we thought it would be good to use a strain of fungus that the ants definitely did not evolve specific resistances against.",173,179,evolve,4,5,9
3ZTE0JGGCET7QN37DJ84U4DLTCWOC6,"#42-59 Animals can adapt to local strains ('local adaptation'), and just to make sure we thought it would be good to use a strain of fungus that the ants definitely did not evolve specific resistances against.",173,200,evolve specific resistances,1,0,1
3ZTE0JGGCET7QN37DJ84U4DLTCWOC6,"#42-59 Animals can adapt to local strains ('local adaptation'), and just to make sure we thought it would be good to use a strain of fungus that the ants definitely did not evolve specific resistances against.",180,188,specific,1,0,1
3ZTE0JGGCET7QN37DJ84U4DLTCWOC6,"#42-59 Animals can adapt to local strains ('local adaptation'), and just to make sure we thought it would be good to use a strain of fungus that the ants definitely did not evolve specific resistances against.",180,200,specific resistances,2,1,3
3ZTE0JGGCET7QN37DJ84U4DLTCWOC6,"#42-59 Animals can adapt to local strains ('local adaptation'), and just to make sure we thought it would be good to use a strain of fungus that the ants definitely did not evolve specific resistances against.",189,200,resistances,9,5,14
3ZTE0JGGCET7QN37DJ84U4DLTCWOC6,"#42-60 This means that the reaction of the ants (to self-medicate) is very likely to be a general response, and not just against their local fungal enemies.",27,35,reaction,0,1,1
3ZTE0JGGCET7QN37DJ84U4DLTCWOC6,"#42-60 This means that the reaction of the ants (to self-medicate) is very likely to be a general response, and not just against their local fungal enemies.",49,65,to self-medicate,1,0,1
3ZTE0JGGCET7QN37DJ84U4DLTCWOC6,"#42-60 This means that the reaction of the ants (to self-medicate) is very likely to be a general response, and not just against their local fungal enemies.",52,65,self-medicate,1,0,1
3ZTE0JGGCET7QN37DJ84U4DLTCWOC6,"#42-60 This means that the reaction of the ants (to self-medicate) is very likely to be a general response, and not just against their local fungal enemies.",90,106,general response,1,2,3
3ZTE0JGGCET7QN37DJ84U4DLTCWOC6,"#42-60 This means that the reaction of the ants (to self-medicate) is very likely to be a general response, and not just against their local fungal enemies.",98,106,response,1,0,1
3ZTE0JGGCET7QN37DJ84U4DLTCWOC6,"#42-60 This means that the reaction of the ants (to self-medicate) is very likely to be a general response, and not just against their local fungal enemies.",141,147,fungal,0,1,1
3ZTE0JGGCET7QN37DJ84U4DLTCWOC6,"#42-60 This means that the reaction of the ants (to self-medicate) is very likely to be a general response, and not just against their local fungal enemies.",141,155,fungal enemies,2,0,2
3ZTE0JGGCET7QN37DJ84U4DLTCWOC6,"#42-60 This means that the reaction of the ants (to self-medicate) is very likely to be a general response, and not just against their local fungal enemies.",148,155,enemies,2,1,3
3ZTE0JGGCET7QN37DJ84U4DLTCWOC6,#42-61 Wikinews: Are there any ethical considerations around exposing ants to toxins and parasites?,31,38,ethical,5,3,8
3ZTE0JGGCET7QN37DJ84U4DLTCWOC6,#42-61 Wikinews: Are there any ethical considerations around exposing ants to toxins and parasites?,31,53,ethical considerations,3,1,4
3ZTE0JGGCET7QN37DJ84U4DLTCWOC6,#42-61 Wikinews: Are there any ethical considerations around exposing ants to toxins and parasites?,39,53,considerations,2,1,3
3ZTE0JGGCET7QN37DJ84U4DLTCWOC6,#42-61 Wikinews: Are there any ethical considerations around exposing ants to toxins and parasites?,61,69,exposing,2,2,4
3ZTE0JGGCET7QN37DJ84U4DLTCWOC6,#42-61 Wikinews: Are there any ethical considerations around exposing ants to toxins and parasites?,78,84,toxins,7,6,13
3ZTE0JGGCET7QN37DJ84U4DLTCWOC6,#42-61 Wikinews: Are there any ethical considerations around exposing ants to toxins and parasites?,89,98,parasites,1,1,2
3TTPFEFXCTL8IP8JZF0BOVOAL47H6J,"#23-12 He alleges this was done to ensure the inclusion of the low-polling candidates former Hewlett-Packard CEO Carly Fiorina, former New York governor George Pataki, Senator Lindsey Graham, and former Virginia governor Jim Gilmore, because Fox News recognizes these candidates as ""major players.""",10,17,alleges,7,9,16
3TTPFEFXCTL8IP8JZF0BOVOAL47H6J,"#23-12 He alleges this was done to ensure the inclusion of the low-polling candidates former Hewlett-Packard CEO Carly Fiorina, former New York governor George Pataki, Senator Lindsey Graham, and former Virginia governor Jim Gilmore, because Fox News recognizes these candidates as ""major players.""",35,41,ensure,2,5,7
3TTPFEFXCTL8IP8JZF0BOVOAL47H6J,"#23-12 He alleges this was done to ensure the inclusion of the low-polling candidates former Hewlett-Packard CEO Carly Fiorina, former New York governor George Pataki, Senator Lindsey Graham, and former Virginia governor Jim Gilmore, because Fox News recognizes these candidates as ""major players.""",46,55,inclusion,6,3,9
3TTPFEFXCTL8IP8JZF0BOVOAL47H6J,"#23-12 He alleges this was done to ensure the inclusion of the low-polling candidates former Hewlett-Packard CEO Carly Fiorina, former New York governor George Pataki, Senator Lindsey Graham, and former Virginia governor Jim Gilmore, because Fox News recognizes these candidates as ""major players.""",46,85,inclusion of the low-polling candidates,1,0,1
3TTPFEFXCTL8IP8JZF0BOVOAL47H6J,"#23-12 He alleges this was done to ensure the inclusion of the low-polling candidates former Hewlett-Packard CEO Carly Fiorina, former New York governor George Pataki, Senator Lindsey Graham, and former Virginia governor Jim Gilmore, because Fox News recognizes these candidates as ""major players.""",63,74,low-polling,3,1,4
3TTPFEFXCTL8IP8JZF0BOVOAL47H6J,"#23-12 He alleges this was done to ensure the inclusion of the low-polling candidates former Hewlett-Packard CEO Carly Fiorina, former New York governor George Pataki, Senator Lindsey Graham, and former Virginia governor Jim Gilmore, because Fox News recognizes these candidates as ""major players.""",63,85,low-polling candidates,2,2,4
3TTPFEFXCTL8IP8JZF0BOVOAL47H6J,"#23-12 He alleges this was done to ensure the inclusion of the low-polling candidates former Hewlett-Packard CEO Carly Fiorina, former New York governor George Pataki, Senator Lindsey Graham, and former Virginia governor Jim Gilmore, because Fox News recognizes these candidates as ""major players.""",75,85,candidates,0,1,1
3TTPFEFXCTL8IP8JZF0BOVOAL47H6J,"#23-12 He alleges this was done to ensure the inclusion of the low-polling candidates former Hewlett-Packard CEO Carly Fiorina, former New York governor George Pataki, Senator Lindsey Graham, and former Virginia governor Jim Gilmore, because Fox News recognizes these candidates as ""major players.""",93,108,Hewlett-Packard,0,1,1
3TTPFEFXCTL8IP8JZF0BOVOAL47H6J,"#23-12 He alleges this was done to ensure the inclusion of the low-polling candidates former Hewlett-Packard CEO Carly Fiorina, former New York governor George Pataki, Senator Lindsey Graham, and former Virginia governor Jim Gilmore, because Fox News recognizes these candidates as ""major players.""",113,118,Carly,0,1,1
3TTPFEFXCTL8IP8JZF0BOVOAL47H6J,"#23-12 He alleges this was done to ensure the inclusion of the low-polling candidates former Hewlett-Packard CEO Carly Fiorina, former New York governor George Pataki, Senator Lindsey Graham, and former Virginia governor Jim Gilmore, because Fox News recognizes these candidates as ""major players.""",119,126,Fiorina,0,1,1
3TTPFEFXCTL8IP8JZF0BOVOAL47H6J,"#23-12 He alleges this was done to ensure the inclusion of the low-polling candidates former Hewlett-Packard CEO Carly Fiorina, former New York governor George Pataki, Senator Lindsey Graham, and former Virginia governor Jim Gilmore, because Fox News recognizes these candidates as ""major players.""",153,166,George Pataki,0,1,1
3TTPFEFXCTL8IP8JZF0BOVOAL47H6J,"#23-12 He alleges this was done to ensure the inclusion of the low-polling candidates former Hewlett-Packard CEO Carly Fiorina, former New York governor George Pataki, Senator Lindsey Graham, and former Virginia governor Jim Gilmore, because Fox News recognizes these candidates as ""major players.""",176,183,Lindsey,0,1,1
3TTPFEFXCTL8IP8JZF0BOVOAL47H6J,"#23-12 He alleges this was done to ensure the inclusion of the low-polling candidates former Hewlett-Packard CEO Carly Fiorina, former New York governor George Pataki, Senator Lindsey Graham, and former Virginia governor Jim Gilmore, because Fox News recognizes these candidates as ""major players.""",184,190,Graham,0,1,1
3TTPFEFXCTL8IP8JZF0BOVOAL47H6J,"#23-12 He alleges this was done to ensure the inclusion of the low-polling candidates former Hewlett-Packard CEO Carly Fiorina, former New York governor George Pataki, Senator Lindsey Graham, and former Virginia governor Jim Gilmore, because Fox News recognizes these candidates as ""major players.""",225,232,Gilmore,0,1,1
3TTPFEFXCTL8IP8JZF0BOVOAL47H6J,"#23-12 He alleges this was done to ensure the inclusion of the low-polling candidates former Hewlett-Packard CEO Carly Fiorina, former New York governor George Pataki, Senator Lindsey Graham, and former Virginia governor Jim Gilmore, because Fox News recognizes these candidates as ""major players.""",251,261,recognizes,4,4,8
3TTPFEFXCTL8IP8JZF0BOVOAL47H6J,"#23-12 He alleges this was done to ensure the inclusion of the low-polling candidates former Hewlett-Packard CEO Carly Fiorina, former New York governor George Pataki, Senator Lindsey Graham, and former Virginia governor Jim Gilmore, because Fox News recognizes these candidates as ""major players.""",283,296,major players,2,1,3
3TTPFEFXCTL8IP8JZF0BOVOAL47H6J,"#23-13 Furthermore, Everson argues the Fox News criteria are not ""objective,"" as Title 11 requires, because they fail to define the terms ""consistently"" and ""recognized"" when referring to polls.",7,18,Furthermore,0,3,3
3TTPFEFXCTL8IP8JZF0BOVOAL47H6J,"#23-13 Furthermore, Everson argues the Fox News criteria are not ""objective,"" as Title 11 requires, because they fail to define the terms ""consistently"" and ""recognized"" when referring to polls.",28,34,argues,2,2,4
3TTPFEFXCTL8IP8JZF0BOVOAL47H6J,"#23-13 Furthermore, Everson argues the Fox News criteria are not ""objective,"" as Title 11 requires, because they fail to define the terms ""consistently"" and ""recognized"" when referring to polls.",48,56,criteria,4,3,7
3TTPFEFXCTL8IP8JZF0BOVOAL47H6J,"#23-13 Furthermore, Everson argues the Fox News criteria are not ""objective,"" as Title 11 requires, because they fail to define the terms ""consistently"" and ""recognized"" when referring to polls.",66,75,objective,3,4,7
3TTPFEFXCTL8IP8JZF0BOVOAL47H6J,"#23-13 Furthermore, Everson argues the Fox News criteria are not ""objective,"" as Title 11 requires, because they fail to define the terms ""consistently"" and ""recognized"" when referring to polls.",121,127,define,0,1,1
3TTPFEFXCTL8IP8JZF0BOVOAL47H6J,"#23-13 Furthermore, Everson argues the Fox News criteria are not ""objective,"" as Title 11 requires, because they fail to define the terms ""consistently"" and ""recognized"" when referring to polls.",139,151,consistently,8,9,17
3TTPFEFXCTL8IP8JZF0BOVOAL47H6J,"#23-13 Furthermore, Everson argues the Fox News criteria are not ""objective,"" as Title 11 requires, because they fail to define the terms ""consistently"" and ""recognized"" when referring to polls.",158,168,recognized,2,5,7
3TTPFEFXCTL8IP8JZF0BOVOAL47H6J,"#23-13 Furthermore, Everson argues the Fox News criteria are not ""objective,"" as Title 11 requires, because they fail to define the terms ""consistently"" and ""recognized"" when referring to polls.",175,184,referring,0,2,2
3TTPFEFXCTL8IP8JZF0BOVOAL47H6J,#23-14 He asserts he was included in the Republican Party's online straw poll in May and is the only candidate still listed on that poll who has been excluded from Thursday's debate.,10,17,asserts,3,5,8
3TTPFEFXCTL8IP8JZF0BOVOAL47H6J,#23-14 He asserts he was included in the Republican Party's online straw poll in May and is the only candidate still listed on that poll who has been excluded from Thursday's debate.,41,51,Republican,1,0,1
3TTPFEFXCTL8IP8JZF0BOVOAL47H6J,#23-14 He asserts he was included in the Republican Party's online straw poll in May and is the only candidate still listed on that poll who has been excluded from Thursday's debate.,60,77,online straw poll,1,2,3
3TTPFEFXCTL8IP8JZF0BOVOAL47H6J,#23-14 He asserts he was included in the Republican Party's online straw poll in May and is the only candidate still listed on that poll who has been excluded from Thursday's debate.,67,72,straw,0,1,1
3TTPFEFXCTL8IP8JZF0BOVOAL47H6J,#23-14 He asserts he was included in the Republican Party's online straw poll in May and is the only candidate still listed on that poll who has been excluded from Thursday's debate.,67,77,straw poll,3,3,6
3TTPFEFXCTL8IP8JZF0BOVOAL47H6J,#23-14 He asserts he was included in the Republican Party's online straw poll in May and is the only candidate still listed on that poll who has been excluded from Thursday's debate.,150,158,excluded,4,2,6
3TTPFEFXCTL8IP8JZF0BOVOAL47H6J,#23-14 He asserts he was included in the Republican Party's online straw poll in May and is the only candidate still listed on that poll who has been excluded from Thursday's debate.,175,181,debate,1,2,3
3TTPFEFXCTL8IP8JZF0BOVOAL47H6J,"#23-15 Election law expert Richard Winger, publisher of Ballot Access News, says Everson is ""completely correct"" in his challenge.",20,26,expert,0,1,1
3TTPFEFXCTL8IP8JZF0BOVOAL47H6J,"#23-15 Election law expert Richard Winger, publisher of Ballot Access News, says Everson is ""completely correct"" in his challenge.",43,52,publisher,1,0,1
3TTPFEFXCTL8IP8JZF0BOVOAL47H6J,"#23-15 Election law expert Richard Winger, publisher of Ballot Access News, says Everson is ""completely correct"" in his challenge.",56,74,Ballot Access News,0,1,1
3TTPFEFXCTL8IP8JZF0BOVOAL47H6J,"#23-15 Election law expert Richard Winger, publisher of Ballot Access News, says Everson is ""completely correct"" in his challenge.",120,129,challenge,0,2,2
3TTPFEFXCTL8IP8JZF0BOVOAL47H6J,"#23-16 However, he believes Everson only has a chance of success if he actually files a lawsuit rather than simply complaining to the FEC.",47,64,chance of success,0,1,1
3TTPFEFXCTL8IP8JZF0BOVOAL47H6J,"#23-16 However, he believes Everson only has a chance of success if he actually files a lawsuit rather than simply complaining to the FEC.",71,79,actually,1,0,1
3TTPFEFXCTL8IP8JZF0BOVOAL47H6J,"#23-16 However, he believes Everson only has a chance of success if he actually files a lawsuit rather than simply complaining to the FEC.",88,95,lawsuit,2,10,12
3TTPFEFXCTL8IP8JZF0BOVOAL47H6J,"#23-16 However, he believes Everson only has a chance of success if he actually files a lawsuit rather than simply complaining to the FEC.",115,126,complaining,1,3,4
3TTPFEFXCTL8IP8JZF0BOVOAL47H6J,"#23-16 However, he believes Everson only has a chance of success if he actually files a lawsuit rather than simply complaining to the FEC.",134,137,FEC,0,1,1
37VE3DA4YUIEO1PEV6HJZBA2Z5IHB4,"#28-15 ""We're here today on a very sad day,"" said Tim Cannon, deputy chief of the HCSO.",62,68,deputy,5,2,7
37VE3DA4YUIEO1PEV6HJZBA2Z5IHB4,"#28-15 ""We're here today on a very sad day,"" said Tim Cannon, deputy chief of the HCSO.",62,74,deputy chief,2,0,2
37VE3DA4YUIEO1PEV6HJZBA2Z5IHB4,"#28-15 ""We're here today on a very sad day,"" said Tim Cannon, deputy chief of the HCSO.",62,86,deputy chief of the HCSO,1,0,1
37VE3DA4YUIEO1PEV6HJZBA2Z5IHB4,"#28-16 ""We're here with our brothers in arms standing behind us because we're all hurting.",28,44,brothers in arms,2,0,2
37VE3DA4YUIEO1PEV6HJZBA2Z5IHB4,"#28-16 ""We're here with our brothers in arms standing behind us because we're all hurting.",40,44,arms,1,1,2
37VE3DA4YUIEO1PEV6HJZBA2Z5IHB4,"#28-16 ""We're here with our brothers in arms standing behind us because we're all hurting.",82,89,hurting,3,6,9
37VE3DA4YUIEO1PEV6HJZBA2Z5IHB4,#28-17 It's a difficult day for us at the sheriff's office.,14,23,difficult,3,0,3
37VE3DA4YUIEO1PEV6HJZBA2Z5IHB4,#28-17 It's a difficult day for us at the sheriff's office.,42,49,sheriff,2,0,2
37VE3DA4YUIEO1PEV6HJZBA2Z5IHB4,#28-17 It's a difficult day for us at the sheriff's office.,42,50,sheriffs,2,0,2
37VE3DA4YUIEO1PEV6HJZBA2Z5IHB4,"#28-18 Once again, a tragedy has struck…our city.",19,28,a tragedy,1,0,1
37VE3DA4YUIEO1PEV6HJZBA2Z5IHB4,"#28-18 Once again, a tragedy has struck…our city.",21,28,tragedy,8,6,14
37VE3DA4YUIEO1PEV6HJZBA2Z5IHB4,"#28-19 Our hearts go out to those…affected by this tragedy.""",28,42,those…affected,1,0,1
37VE3DA4YUIEO1PEV6HJZBA2Z5IHB4,"#28-19 Our hearts go out to those…affected by this tragedy.""",51,58,tragedy,1,0,1
37VE3DA4YUIEO1PEV6HJZBA2Z5IHB4,"#28-20 Tuesday, Conley was allowed to speak to reporters at an administrative segregation unit of the Harris County Jail.",47,56,reporters,2,0,2
37VE3DA4YUIEO1PEV6HJZBA2Z5IHB4,"#28-20 Tuesday, Conley was allowed to speak to reporters at an administrative segregation unit of the Harris County Jail.",63,77,administrative,6,2,8
37VE3DA4YUIEO1PEV6HJZBA2Z5IHB4,"#28-20 Tuesday, Conley was allowed to speak to reporters at an administrative segregation unit of the Harris County Jail.",63,89,administrative segregation,4,2,6
37VE3DA4YUIEO1PEV6HJZBA2Z5IHB4,"#28-20 Tuesday, Conley was allowed to speak to reporters at an administrative segregation unit of the Harris County Jail.",63,94,administrative segregation unit,1,0,1
37VE3DA4YUIEO1PEV6HJZBA2Z5IHB4,"#28-20 Tuesday, Conley was allowed to speak to reporters at an administrative segregation unit of the Harris County Jail.",78,89,segregation,10,7,17
37VE3DA4YUIEO1PEV6HJZBA2Z5IHB4,"#28-21 Conley said he had been living in the house and although he had promised to move out, he did not have elsewhere to go.",71,79,promised,1,1,2
37VE3DA4YUIEO1PEV6HJZBA2Z5IHB4,"#28-21 Conley said he had been living in the house and although he had promised to move out, he did not have elsewhere to go.",109,118,elsewhere,2,2,4
37VE3DA4YUIEO1PEV6HJZBA2Z5IHB4,#28-22 He was angered when he returned to find the door locks changed.,14,21,angered,1,4,5
37VE3DA4YUIEO1PEV6HJZBA2Z5IHB4,#28-23 Conley also felt all the victims disrespected and mistreated him.,32,39,victims,3,2,5
37VE3DA4YUIEO1PEV6HJZBA2Z5IHB4,#28-23 Conley also felt all the victims disrespected and mistreated him.,32,52,victims disrespected,0,1,1
37VE3DA4YUIEO1PEV6HJZBA2Z5IHB4,#28-23 Conley also felt all the victims disrespected and mistreated him.,40,52,disrespected,10,6,16
37VE3DA4YUIEO1PEV6HJZBA2Z5IHB4,#28-23 Conley also felt all the victims disrespected and mistreated him.,57,67,mistreated,10,9,19
3O0M2G5VC631OWMMIFJ4EG6860T940,"#33-4 Tom Williams, auxiliary bishop of Liverpool, conducted the Roman Catholic mass in St Mary's Roman Catholic Church in Liverpool's Woolton area.",20,29,auxiliary,10,8,18
3O0M2G5VC631OWMMIFJ4EG6860T940,"#33-4 Tom Williams, auxiliary bishop of Liverpool, conducted the Roman Catholic mass in St Mary's Roman Catholic Church in Liverpool's Woolton area.",20,36,auxiliary bishop,3,2,5
3O0M2G5VC631OWMMIFJ4EG6860T940,"#33-4 Tom Williams, auxiliary bishop of Liverpool, conducted the Roman Catholic mass in St Mary's Roman Catholic Church in Liverpool's Woolton area.",30,36,bishop,4,0,4
3O0M2G5VC631OWMMIFJ4EG6860T940,"#33-4 Tom Williams, auxiliary bishop of Liverpool, conducted the Roman Catholic mass in St Mary's Roman Catholic Church in Liverpool's Woolton area.",51,60,conducted,5,1,6
3O0M2G5VC631OWMMIFJ4EG6860T940,"#33-4 Tom Williams, auxiliary bishop of Liverpool, conducted the Roman Catholic mass in St Mary's Roman Catholic Church in Liverpool's Woolton area.",65,84,Roman Catholic mass,2,0,2
3O0M2G5VC631OWMMIFJ4EG6860T940,"#33-4 Tom Williams, auxiliary bishop of Liverpool, conducted the Roman Catholic mass in St Mary's Roman Catholic Church in Liverpool's Woolton area.",80,84,mass,1,1,2
3O0M2G5VC631OWMMIFJ4EG6860T940,"#33-4 Tom Williams, auxiliary bishop of Liverpool, conducted the Roman Catholic mass in St Mary's Roman Catholic Church in Liverpool's Woolton area.",88,118,St Marys Roman Catholic Church,1,0,1
3O0M2G5VC631OWMMIFJ4EG6860T940,"#33-4 Tom Williams, auxiliary bishop of Liverpool, conducted the Roman Catholic mass in St Mary's Roman Catholic Church in Liverpool's Woolton area.",104,112,Catholic,0,1,1
3O0M2G5VC631OWMMIFJ4EG6860T940,"#33-4 Tom Williams, auxiliary bishop of Liverpool, conducted the Roman Catholic mass in St Mary's Roman Catholic Church in Liverpool's Woolton area.",123,141,Liverpools Woolton,1,0,1
3O0M2G5VC631OWMMIFJ4EG6860T940,"#33-4 Tom Williams, auxiliary bishop of Liverpool, conducted the Roman Catholic mass in St Mary's Roman Catholic Church in Liverpool's Woolton area.",135,142,Woolton,0,2,2
3O0M2G5VC631OWMMIFJ4EG6860T940,"#33-5 This is the same church that Black got married in 1969 to Bobby Willis, who died in 1999 after 30 years of marriage.",23,29,church,1,0,1
3O0M2G5VC631OWMMIFJ4EG6860T940,"#33-5 This is the same church that Black got married in 1969 to Bobby Willis, who died in 1999 after 30 years of marriage.",64,76,Bobby Willis,0,1,1
3O0M2G5VC631OWMMIFJ4EG6860T940,"#33-5 This is the same church that Black got married in 1969 to Bobby Willis, who died in 1999 after 30 years of marriage.",113,121,marriage,1,0,1
3O0M2G5VC631OWMMIFJ4EG6860T940,#33-6 Eulogies were delivered by Cliff Richard and Paul O'Grady together with poems read by two of Black's sons.,6,14,Eulogies,8,7,15
3O0M2G5VC631OWMMIFJ4EG6860T940,#33-6 Eulogies were delivered by Cliff Richard and Paul O'Grady together with poems read by two of Black's sons.,20,29,delivered,1,2,3
3O0M2G5VC631OWMMIFJ4EG6860T940,#33-6 Eulogies were delivered by Cliff Richard and Paul O'Grady together with poems read by two of Black's sons.,33,46,Cliff Richard,0,1,1
3O0M2G5VC631OWMMIFJ4EG6860T940,#33-6 Eulogies were delivered by Cliff Richard and Paul O'Grady together with poems read by two of Black's sons.,56,62,OGrady,0,1,1
3O0M2G5VC631OWMMIFJ4EG6860T940,#33-6 Eulogies were delivered by Cliff Richard and Paul O'Grady together with poems read by two of Black's sons.,78,83,poems,1,0,1
3O0M2G5VC631OWMMIFJ4EG6860T940,"#33-7 Further tributes were paid by Tom Jones, who flew in specially for the funeral.",14,22,tributes,9,8,17
3O0M2G5VC631OWMMIFJ4EG6860T940,"#33-7 Further tributes were paid by Tom Jones, who flew in specially for the funeral.",51,55,flew,0,3,3
3O0M2G5VC631OWMMIFJ4EG6860T940,"#33-7 Further tributes were paid by Tom Jones, who flew in specially for the funeral.",59,68,specially,3,0,3
3O0M2G5VC631OWMMIFJ4EG6860T940,"#33-7 Further tributes were paid by Tom Jones, who flew in specially for the funeral.",77,84,funeral,3,4,7
3O0M2G5VC631OWMMIFJ4EG6860T940,"#33-8 After the service, Black was to be interred in a private ceremony, next to the graves of her parents at the Allerton cemetery.",41,49,interred,9,7,16
3O0M2G5VC631OWMMIFJ4EG6860T940,"#33-8 After the service, Black was to be interred in a private ceremony, next to the graves of her parents at the Allerton cemetery.",63,71,ceremony,5,0,5
3O0M2G5VC631OWMMIFJ4EG6860T940,"#33-8 After the service, Black was to be interred in a private ceremony, next to the graves of her parents at the Allerton cemetery.",85,91,graves,1,2,3
3O0M2G5VC631OWMMIFJ4EG6860T940,"#33-8 After the service, Black was to be interred in a private ceremony, next to the graves of her parents at the Allerton cemetery.",114,122,Allerton,0,2,2
3O0M2G5VC631OWMMIFJ4EG6860T940,"#33-8 After the service, Black was to be interred in a private ceremony, next to the graves of her parents at the Allerton cemetery.",123,131,cemetery,7,2,9
3O0M2G5VC631OWMMIFJ4EG6860T940,"#33-9 She died early this month, aged 72, after she fell at her home in Spain and suffered a stroke.",82,90,suffered,1,2,3
3O0M2G5VC631OWMMIFJ4EG6860T940,"#33-9 She died early this month, aged 72, after she fell at her home in Spain and suffered a stroke.",93,99,stroke,4,2,6
3O0M2G5VC631OWMMIFJ4EG6860T940,"#34-1 North Korea puts military in 'quasi-state of war' According to Yonhap news agency, quoting North Korea's main news agency Korean Central News Agency (KCNA), the country's military has been placed on high alert and has been told to prepare a ""quasi-state of war"".",23,31,military,1,1,2
3O0M2G5VC631OWMMIFJ4EG6860T940,"#34-1 North Korea puts military in 'quasi-state of war' According to Yonhap news agency, quoting North Korea's main news agency Korean Central News Agency (KCNA), the country's military has been placed on high alert and has been told to prepare a ""quasi-state of war"".",36,54,quasi-state of war,3,1,4
3O0M2G5VC631OWMMIFJ4EG6860T940,"#34-1 North Korea puts military in 'quasi-state of war' According to Yonhap news agency, quoting North Korea's main news agency Korean Central News Agency (KCNA), the country's military has been placed on high alert and has been told to prepare a ""quasi-state of war"".",36,47,quasi-state,4,3,7
3O0M2G5VC631OWMMIFJ4EG6860T940,"#34-1 North Korea puts military in 'quasi-state of war' According to Yonhap news agency, quoting North Korea's main news agency Korean Central News Agency (KCNA), the country's military has been placed on high alert and has been told to prepare a ""quasi-state of war"".",56,65,According,1,0,1
3O0M2G5VC631OWMMIFJ4EG6860T940,"#34-1 North Korea puts military in 'quasi-state of war' According to Yonhap news agency, quoting North Korea's main news agency Korean Central News Agency (KCNA), the country's military has been placed on high alert and has been told to prepare a ""quasi-state of war"".",69,75,Yonhap,0,2,2
3O0M2G5VC631OWMMIFJ4EG6860T940,"#34-1 North Korea puts military in 'quasi-state of war' According to Yonhap news agency, quoting North Korea's main news agency Korean Central News Agency (KCNA), the country's military has been placed on high alert and has been told to prepare a ""quasi-state of war"".",89,96,quoting,3,2,5
3O0M2G5VC631OWMMIFJ4EG6860T940,"#34-1 North Korea puts military in 'quasi-state of war' According to Yonhap news agency, quoting North Korea's main news agency Korean Central News Agency (KCNA), the country's military has been placed on high alert and has been told to prepare a ""quasi-state of war"".",121,127,agency,1,0,1
3O0M2G5VC631OWMMIFJ4EG6860T940,"#34-1 North Korea puts military in 'quasi-state of war' According to Yonhap news agency, quoting North Korea's main news agency Korean Central News Agency (KCNA), the country's military has been placed on high alert and has been told to prepare a ""quasi-state of war"".",177,185,military,0,1,1
3O0M2G5VC631OWMMIFJ4EG6860T940,"#34-1 North Korea puts military in 'quasi-state of war' According to Yonhap news agency, quoting North Korea's main news agency Korean Central News Agency (KCNA), the country's military has been placed on high alert and has been told to prepare a ""quasi-state of war"".",205,215,high alert,0,1,1
3O0M2G5VC631OWMMIFJ4EG6860T940,"#34-1 North Korea puts military in 'quasi-state of war' According to Yonhap news agency, quoting North Korea's main news agency Korean Central News Agency (KCNA), the country's military has been placed on high alert and has been told to prepare a ""quasi-state of war"".",210,215,alert,1,0,1
3O0M2G5VC631OWMMIFJ4EG6860T940,"#34-1 North Korea puts military in 'quasi-state of war' According to Yonhap news agency, quoting North Korea's main news agency Korean Central News Agency (KCNA), the country's military has been placed on high alert and has been told to prepare a ""quasi-state of war"".",237,244,prepare,2,0,2
3O0M2G5VC631OWMMIFJ4EG6860T940,"#34-1 North Korea puts military in 'quasi-state of war' According to Yonhap news agency, quoting North Korea's main news agency Korean Central News Agency (KCNA), the country's military has been placed on high alert and has been told to prepare a ""quasi-state of war"".",248,259,quasi-state,1,1,2
3O0M2G5VC631OWMMIFJ4EG6860T940,"#34-1 North Korea puts military in 'quasi-state of war' According to Yonhap news agency, quoting North Korea's main news agency Korean Central News Agency (KCNA), the country's military has been placed on high alert and has been told to prepare a ""quasi-state of war"".",248,266,quasi-state of war,2,2,4
3FVBZG9CLJFD4EM4XQKUFUEJ81LH0I,"#13-6 Although the 51-48 vote was mostly along party lines, some Republicans have expressed uncertainty about repealing Obamacare before a replacement system is worked out.",41,58,along party lines,0,1,1
3FVBZG9CLJFD4EM4XQKUFUEJ81LH0I,"#13-6 Although the 51-48 vote was mostly along party lines, some Republicans have expressed uncertainty about repealing Obamacare before a replacement system is worked out.",47,58,party lines,0,1,1
3FVBZG9CLJFD4EM4XQKUFUEJ81LH0I,"#13-6 Although the 51-48 vote was mostly along party lines, some Republicans have expressed uncertainty about repealing Obamacare before a replacement system is worked out.",65,76,Republicans,4,0,4
3FVBZG9CLJFD4EM4XQKUFUEJ81LH0I,"#13-6 Although the 51-48 vote was mostly along party lines, some Republicans have expressed uncertainty about repealing Obamacare before a replacement system is worked out.",82,91,expressed,1,3,4
3FVBZG9CLJFD4EM4XQKUFUEJ81LH0I,"#13-6 Although the 51-48 vote was mostly along party lines, some Republicans have expressed uncertainty about repealing Obamacare before a replacement system is worked out.",92,103,uncertainty,7,5,12
3FVBZG9CLJFD4EM4XQKUFUEJ81LH0I,"#13-6 Although the 51-48 vote was mostly along party lines, some Republicans have expressed uncertainty about repealing Obamacare before a replacement system is worked out.",110,119,repealing,8,10,18
3FVBZG9CLJFD4EM4XQKUFUEJ81LH0I,"#13-6 Although the 51-48 vote was mostly along party lines, some Republicans have expressed uncertainty about repealing Obamacare before a replacement system is worked out.",110,129,repealing Obamacare,1,0,1
3FVBZG9CLJFD4EM4XQKUFUEJ81LH0I,"#13-6 Although the 51-48 vote was mostly along party lines, some Republicans have expressed uncertainty about repealing Obamacare before a replacement system is worked out.",120,129,Obamacare,2,1,3
3FVBZG9CLJFD4EM4XQKUFUEJ81LH0I,"#13-6 Although the 51-48 vote was mostly along party lines, some Republicans have expressed uncertainty about repealing Obamacare before a replacement system is worked out.",139,150,replacement,2,3,5
3FVBZG9CLJFD4EM4XQKUFUEJ81LH0I,"#13-6 Although the 51-48 vote was mostly along party lines, some Republicans have expressed uncertainty about repealing Obamacare before a replacement system is worked out.",139,157,replacement system,1,0,1
3FVBZG9CLJFD4EM4XQKUFUEJ81LH0I,"#13-7 Although president-elect Donald Trump has called for a ""repeal and replace"" plan, saying that a new health care system would be enacted ""almost simultaneously,"" many in government and the press have expressed doubts about whether this would actually happen.",15,30,president-elect,1,1,2
3FVBZG9CLJFD4EM4XQKUFUEJ81LH0I,"#13-7 Although president-elect Donald Trump has called for a ""repeal and replace"" plan, saying that a new health care system would be enacted ""almost simultaneously,"" many in government and the press have expressed doubts about whether this would actually happen.",31,43,Donald Trump,0,1,1
3FVBZG9CLJFD4EM4XQKUFUEJ81LH0I,"#13-7 Although president-elect Donald Trump has called for a ""repeal and replace"" plan, saying that a new health care system would be enacted ""almost simultaneously,"" many in government and the press have expressed doubts about whether this would actually happen.",62,80,repeal and replace,2,0,2
3FVBZG9CLJFD4EM4XQKUFUEJ81LH0I,"#13-7 Although president-elect Donald Trump has called for a ""repeal and replace"" plan, saying that a new health care system would be enacted ""almost simultaneously,"" many in government and the press have expressed doubts about whether this would actually happen.",62,68,repeal,0,3,3
3FVBZG9CLJFD4EM4XQKUFUEJ81LH0I,"#13-7 Although president-elect Donald Trump has called for a ""repeal and replace"" plan, saying that a new health care system would be enacted ""almost simultaneously,"" many in government and the press have expressed doubts about whether this would actually happen.",134,141,enacted,8,7,15
3FVBZG9CLJFD4EM4XQKUFUEJ81LH0I,"#13-7 Although president-elect Donald Trump has called for a ""repeal and replace"" plan, saying that a new health care system would be enacted ""almost simultaneously,"" many in government and the press have expressed doubts about whether this would actually happen.",150,164,simultaneously,10,8,18
3FVBZG9CLJFD4EM4XQKUFUEJ81LH0I,"#13-7 Although president-elect Donald Trump has called for a ""repeal and replace"" plan, saying that a new health care system would be enacted ""almost simultaneously,"" many in government and the press have expressed doubts about whether this would actually happen.",175,185,government,1,0,1
3FVBZG9CLJFD4EM4XQKUFUEJ81LH0I,"#13-7 Although president-elect Donald Trump has called for a ""repeal and replace"" plan, saying that a new health care system would be enacted ""almost simultaneously,"" many in government and the press have expressed doubts about whether this would actually happen.",205,214,expressed,1,1,2
3FVBZG9CLJFD4EM4XQKUFUEJ81LH0I,"#13-7 Although president-elect Donald Trump has called for a ""repeal and replace"" plan, saying that a new health care system would be enacted ""almost simultaneously,"" many in government and the press have expressed doubts about whether this would actually happen.",215,221,doubts,2,0,2
3FVBZG9CLJFD4EM4XQKUFUEJ81LH0I,"#13-8 Senator Susan Collins of Maine said she would like to at least see a well-constructed plan before voting and Senator Johnny Isakson of Georgia said repealing Obamacare without replacing it was ""unacceptable.""",75,91,well-constructed,3,1,4
3FVBZG9CLJFD4EM4XQKUFUEJ81LH0I,"#13-8 Senator Susan Collins of Maine said she would like to at least see a well-constructed plan before voting and Senator Johnny Isakson of Georgia said repealing Obamacare without replacing it was ""unacceptable.""",75,96,well-constructed plan,0,1,1
3FVBZG9CLJFD4EM4XQKUFUEJ81LH0I,"#13-8 Senator Susan Collins of Maine said she would like to at least see a well-constructed plan before voting and Senator Johnny Isakson of Georgia said repealing Obamacare without replacing it was ""unacceptable.""",104,110,voting,1,0,1
3FVBZG9CLJFD4EM4XQKUFUEJ81LH0I,"#13-8 Senator Susan Collins of Maine said she would like to at least see a well-constructed plan before voting and Senator Johnny Isakson of Georgia said repealing Obamacare without replacing it was ""unacceptable.""",115,122,Senator,1,0,1
3FVBZG9CLJFD4EM4XQKUFUEJ81LH0I,"#13-8 Senator Susan Collins of Maine said she would like to at least see a well-constructed plan before voting and Senator Johnny Isakson of Georgia said repealing Obamacare without replacing it was ""unacceptable.""",123,137,Johnny Isakson,0,1,1
3FVBZG9CLJFD4EM4XQKUFUEJ81LH0I,"#13-8 Senator Susan Collins of Maine said she would like to at least see a well-constructed plan before voting and Senator Johnny Isakson of Georgia said repealing Obamacare without replacing it was ""unacceptable.""",154,163,repealing,4,2,6
3FVBZG9CLJFD4EM4XQKUFUEJ81LH0I,"#13-8 Senator Susan Collins of Maine said she would like to at least see a well-constructed plan before voting and Senator Johnny Isakson of Georgia said repealing Obamacare without replacing it was ""unacceptable.""",164,173,Obamacare,0,1,1
3FVBZG9CLJFD4EM4XQKUFUEJ81LH0I,"#13-8 Senator Susan Collins of Maine said she would like to at least see a well-constructed plan before voting and Senator Johnny Isakson of Georgia said repealing Obamacare without replacing it was ""unacceptable.""",200,212,unacceptable,5,3,8
3FVBZG9CLJFD4EM4XQKUFUEJ81LH0I,#13-9 These concerns were shared by members of the House of Representatives.,12,20,concerns,5,3,8
3FVBZG9CLJFD4EM4XQKUFUEJ81LH0I,#13-9 These concerns were shared by members of the House of Representatives.,51,75,House of Representatives,2,0,2
3FVBZG9CLJFD4EM4XQKUFUEJ81LH0I,#13-9 These concerns were shared by members of the House of Representatives.,60,75,Representatives,2,0,2
3FVBZG9CLJFD4EM4XQKUFUEJ81LH0I,"#13-10 ""We need to be voting for a replacement plan at the same time that we vote for repeal,"" added Representative Mark Meadows of North Carolina.",35,46,replacement,0,2,2
3FVBZG9CLJFD4EM4XQKUFUEJ81LH0I,"#13-10 ""We need to be voting for a replacement plan at the same time that we vote for repeal,"" added Representative Mark Meadows of North Carolina.",86,92,repeal,3,1,4
3FVBZG9CLJFD4EM4XQKUFUEJ81LH0I,"#13-10 ""We need to be voting for a replacement plan at the same time that we vote for repeal,"" added Representative Mark Meadows of North Carolina.",101,115,Representative,3,1,4
3FVBZG9CLJFD4EM4XQKUFUEJ81LH0I,"#13-10 ""We need to be voting for a replacement plan at the same time that we vote for repeal,"" added Representative Mark Meadows of North Carolina.",116,128,Mark Meadows,0,1,1
3ZZAYRN1I6SOC45IZ53UJEDPHYVTOT,#39-24 Neighbouring Hungary is constructing a border fence across its entire frontier with Serbia.,7,19,Neighbouring,9,3,12
3ZZAYRN1I6SOC45IZ53UJEDPHYVTOT,#39-24 Neighbouring Hungary is constructing a border fence across its entire frontier with Serbia.,20,43,Hungary is constructing,0,1,1
3ZZAYRN1I6SOC45IZ53UJEDPHYVTOT,#39-24 Neighbouring Hungary is constructing a border fence across its entire frontier with Serbia.,31,43,constructing,5,2,7
3ZZAYRN1I6SOC45IZ53UJEDPHYVTOT,#39-24 Neighbouring Hungary is constructing a border fence across its entire frontier with Serbia.,31,58,constructing a border fence,1,0,1
3ZZAYRN1I6SOC45IZ53UJEDPHYVTOT,#39-24 Neighbouring Hungary is constructing a border fence across its entire frontier with Serbia.,46,58,border fence,0,3,3
3ZZAYRN1I6SOC45IZ53UJEDPHYVTOT,#39-24 Neighbouring Hungary is constructing a border fence across its entire frontier with Serbia.,53,58,fence,0,3,3
3ZZAYRN1I6SOC45IZ53UJEDPHYVTOT,#39-24 Neighbouring Hungary is constructing a border fence across its entire frontier with Serbia.,77,85,frontier,9,4,13
3ZZAYRN1I6SOC45IZ53UJEDPHYVTOT,"#39-25 Yesterday alone saw a record 3,241 attempts to enter Hungary illegally, according to authorities there.",42,50,attempts,1,0,1
3ZZAYRN1I6SOC45IZ53UJEDPHYVTOT,"#39-25 Yesterday alone saw a record 3,241 attempts to enter Hungary illegally, according to authorities there.",68,77,illegally,6,2,8
3ZZAYRN1I6SOC45IZ53UJEDPHYVTOT,"#39-25 Yesterday alone saw a record 3,241 attempts to enter Hungary illegally, according to authorities there.",79,103,according to authorities,1,0,1
3ZZAYRN1I6SOC45IZ53UJEDPHYVTOT,"#39-25 Yesterday alone saw a record 3,241 attempts to enter Hungary illegally, according to authorities there.",92,103,authorities,6,2,8
3ZZAYRN1I6SOC45IZ53UJEDPHYVTOT,#39-26 Conflict in Syria and other parts of the world has led refugees to Europe.,7,15,Conflict,3,3,6
3ZZAYRN1I6SOC45IZ53UJEDPHYVTOT,#39-26 Conflict in Syria and other parts of the world has led refugees to Europe.,62,70,refugees,9,6,15
3ZZAYRN1I6SOC45IZ53UJEDPHYVTOT,"#39-27 Once inside, they can move freely inside the Schengen Area, which covers most of the EU.",34,40,freely,0,1,1
3ZZAYRN1I6SOC45IZ53UJEDPHYVTOT,"#39-27 Once inside, they can move freely inside the Schengen Area, which covers most of the EU.",52,60,Schengen,1,1,2
3ZZAYRN1I6SOC45IZ53UJEDPHYVTOT,"#39-27 Once inside, they can move freely inside the Schengen Area, which covers most of the EU.",52,65,Schengen Area,0,1,1
3ZZAYRN1I6SOC45IZ53UJEDPHYVTOT,#39-28 Austrian police earlier this week arrested three motorists suspected of people smuggling.,41,49,arrested,2,0,2
3ZZAYRN1I6SOC45IZ53UJEDPHYVTOT,#39-28 Austrian police earlier this week arrested three motorists suspected of people smuggling.,56,65,motorists,2,2,4
3ZZAYRN1I6SOC45IZ53UJEDPHYVTOT,#39-28 Austrian police earlier this week arrested three motorists suspected of people smuggling.,56,95,motorists suspected of people smuggling,1,0,1
3ZZAYRN1I6SOC45IZ53UJEDPHYVTOT,#39-28 Austrian police earlier this week arrested three motorists suspected of people smuggling.,66,75,suspected,3,2,5
3ZZAYRN1I6SOC45IZ53UJEDPHYVTOT,#39-28 Austrian police earlier this week arrested three motorists suspected of people smuggling.,79,95,people smuggling,1,1,2
3ZZAYRN1I6SOC45IZ53UJEDPHYVTOT,#39-28 Austrian police earlier this week arrested three motorists suspected of people smuggling.,86,95,smuggling,10,9,19
3ZZAYRN1I6SOC45IZ53UJEDPHYVTOT,"#39-29 One driver is accused of moving 34 people, ten of them children, into Austria from Serbia.",21,28,accused,5,4,9
3ZZAYRN1I6SOC45IZ53UJEDPHYVTOT,#39-30 The group were left by the roadside near Bruck an der Leitha and reported struggling to breathe in the van.,34,42,roadside,1,1,2
3ZZAYRN1I6SOC45IZ53UJEDPHYVTOT,#39-30 The group were left by the roadside near Bruck an der Leitha and reported struggling to breathe in the van.,48,53,Bruck,0,1,1
3ZZAYRN1I6SOC45IZ53UJEDPHYVTOT,#39-30 The group were left by the roadside near Bruck an der Leitha and reported struggling to breathe in the van.,48,67,Bruck an der Leitha,1,0,1
3ZZAYRN1I6SOC45IZ53UJEDPHYVTOT,#39-30 The group were left by the roadside near Bruck an der Leitha and reported struggling to breathe in the van.,61,67,Leitha,0,1,1
3ZZAYRN1I6SOC45IZ53UJEDPHYVTOT,#39-30 The group were left by the roadside near Bruck an der Leitha and reported struggling to breathe in the van.,81,91,struggling,4,7,11
3ZZAYRN1I6SOC45IZ53UJEDPHYVTOT,#39-30 The group were left by the roadside near Bruck an der Leitha and reported struggling to breathe in the van.,81,102,struggling to breathe,1,1,2
3ZZAYRN1I6SOC45IZ53UJEDPHYVTOT,#39-30 The group were left by the roadside near Bruck an der Leitha and reported struggling to breathe in the van.,95,102,breathe,2,1,3
3ZZAYRN1I6SOC45IZ53UJEDPHYVTOT,"#4-1 Former NASA astronaut Eugene Cernan dies aged 82 Eugene Cernan, former NASA astronaut and the most recent human to walk on the Moon, died on Monday aged 82, according to a NASA statement.",17,26,astronaut,4,2,6
3ZZAYRN1I6SOC45IZ53UJEDPHYVTOT,"#4-1 Former NASA astronaut Eugene Cernan dies aged 82 Eugene Cernan, former NASA astronaut and the most recent human to walk on the Moon, died on Monday aged 82, according to a NASA statement.",17,33,astronaut Eugene,1,0,1
3ZZAYRN1I6SOC45IZ53UJEDPHYVTOT,"#4-1 Former NASA astronaut Eugene Cernan dies aged 82 Eugene Cernan, former NASA astronaut and the most recent human to walk on the Moon, died on Monday aged 82, according to a NASA statement.",61,67,Cernan,0,1,1
3ZZAYRN1I6SOC45IZ53UJEDPHYVTOT,"#4-1 Former NASA astronaut Eugene Cernan dies aged 82 Eugene Cernan, former NASA astronaut and the most recent human to walk on the Moon, died on Monday aged 82, according to a NASA statement.",76,90,NASA astronaut,1,1,2
3ZZAYRN1I6SOC45IZ53UJEDPHYVTOT,"#4-1 Former NASA astronaut Eugene Cernan dies aged 82 Eugene Cernan, former NASA astronaut and the most recent human to walk on the Moon, died on Monday aged 82, according to a NASA statement.",81,90,astronaut,7,2,9
3ZZAYRN1I6SOC45IZ53UJEDPHYVTOT,"#4-1 Former NASA astronaut Eugene Cernan dies aged 82 Eugene Cernan, former NASA astronaut and the most recent human to walk on the Moon, died on Monday aged 82, according to a NASA statement.",162,171,according,1,0,1
3ZZAYRN1I6SOC45IZ53UJEDPHYVTOT,"#4-1 Former NASA astronaut Eugene Cernan dies aged 82 Eugene Cernan, former NASA astronaut and the most recent human to walk on the Moon, died on Monday aged 82, according to a NASA statement.",177,181,NASA,1,0,1
3ZZAYRN1I6SOC45IZ53UJEDPHYVTOT,"#4-1 Former NASA astronaut Eugene Cernan dies aged 82 Eugene Cernan, former NASA astronaut and the most recent human to walk on the Moon, died on Monday aged 82, according to a NASA statement.",182,191,statement,1,0,1
3R4QIDVOJPD0BUAWFWB3FGJAAM3EEL,"#29-10 Although he described Trump's previous foray into politics as a ""charade"" during a 2011 interview with Wikinews, Martin now sees himself as Trump's ""tag team"" partner in attacking the Bush candidacy.",37,45,previous,1,0,1
3R4QIDVOJPD0BUAWFWB3FGJAAM3EEL,"#29-10 Although he described Trump's previous foray into politics as a ""charade"" during a 2011 interview with Wikinews, Martin now sees himself as Trump's ""tag team"" partner in attacking the Bush candidacy.",37,51,previous foray,0,1,1
3R4QIDVOJPD0BUAWFWB3FGJAAM3EEL,"#29-10 Although he described Trump's previous foray into politics as a ""charade"" during a 2011 interview with Wikinews, Martin now sees himself as Trump's ""tag team"" partner in attacking the Bush candidacy.",46,51,foray,10,7,17
3R4QIDVOJPD0BUAWFWB3FGJAAM3EEL,"#29-10 Although he described Trump's previous foray into politics as a ""charade"" during a 2011 interview with Wikinews, Martin now sees himself as Trump's ""tag team"" partner in attacking the Bush candidacy.",72,79,charade,10,8,18
3R4QIDVOJPD0BUAWFWB3FGJAAM3EEL,"#29-10 Although he described Trump's previous foray into politics as a ""charade"" during a 2011 interview with Wikinews, Martin now sees himself as Trump's ""tag team"" partner in attacking the Bush candidacy.",110,118,Wikinews,1,0,1
3R4QIDVOJPD0BUAWFWB3FGJAAM3EEL,"#29-10 Although he described Trump's previous foray into politics as a ""charade"" during a 2011 interview with Wikinews, Martin now sees himself as Trump's ""tag team"" partner in attacking the Bush candidacy.",156,164,tag team,5,2,7
3R4QIDVOJPD0BUAWFWB3FGJAAM3EEL,"#29-10 Although he described Trump's previous foray into politics as a ""charade"" during a 2011 interview with Wikinews, Martin now sees himself as Trump's ""tag team"" partner in attacking the Bush candidacy.",177,186,attacking,1,0,1
3R4QIDVOJPD0BUAWFWB3FGJAAM3EEL,"#29-10 Although he described Trump's previous foray into politics as a ""charade"" during a 2011 interview with Wikinews, Martin now sees himself as Trump's ""tag team"" partner in attacking the Bush candidacy.",196,205,candidacy,10,5,15
3R4QIDVOJPD0BUAWFWB3FGJAAM3EEL,"#29-11 ""Trump has the raw media power to weaken Bush,"" says Martin, ""I have the negative information and hardball media tactics to make Bush a toxic candidate for the Republican base.""",22,25,raw,1,1,2
3R4QIDVOJPD0BUAWFWB3FGJAAM3EEL,"#29-11 ""Trump has the raw media power to weaken Bush,"" says Martin, ""I have the negative information and hardball media tactics to make Bush a toxic candidate for the Republican base.""",22,31,raw media,1,0,1
3R4QIDVOJPD0BUAWFWB3FGJAAM3EEL,"#29-11 ""Trump has the raw media power to weaken Bush,"" says Martin, ""I have the negative information and hardball media tactics to make Bush a toxic candidate for the Republican base.""",22,37,raw media power,2,2,4
3R4QIDVOJPD0BUAWFWB3FGJAAM3EEL,"#29-11 ""Trump has the raw media power to weaken Bush,"" says Martin, ""I have the negative information and hardball media tactics to make Bush a toxic candidate for the Republican base.""",41,47,weaken,1,1,2
3R4QIDVOJPD0BUAWFWB3FGJAAM3EEL,"#29-11 ""Trump has the raw media power to weaken Bush,"" says Martin, ""I have the negative information and hardball media tactics to make Bush a toxic candidate for the Republican base.""",80,88,negative,1,0,1
3R4QIDVOJPD0BUAWFWB3FGJAAM3EEL,"#29-11 ""Trump has the raw media power to weaken Bush,"" says Martin, ""I have the negative information and hardball media tactics to make Bush a toxic candidate for the Republican base.""",80,100,negative information,0,1,1
3R4QIDVOJPD0BUAWFWB3FGJAAM3EEL,"#29-11 ""Trump has the raw media power to weaken Bush,"" says Martin, ""I have the negative information and hardball media tactics to make Bush a toxic candidate for the Republican base.""",105,113,hardball,6,5,11
3R4QIDVOJPD0BUAWFWB3FGJAAM3EEL,"#29-11 ""Trump has the raw media power to weaken Bush,"" says Martin, ""I have the negative information and hardball media tactics to make Bush a toxic candidate for the Republican base.""",105,127,hardball media tactics,1,3,4
3R4QIDVOJPD0BUAWFWB3FGJAAM3EEL,"#29-11 ""Trump has the raw media power to weaken Bush,"" says Martin, ""I have the negative information and hardball media tactics to make Bush a toxic candidate for the Republican base.""",120,127,tactics,6,4,10
3R4QIDVOJPD0BUAWFWB3FGJAAM3EEL,"#29-11 ""Trump has the raw media power to weaken Bush,"" says Martin, ""I have the negative information and hardball media tactics to make Bush a toxic candidate for the Republican base.""",143,148,toxic,4,2,6
3R4QIDVOJPD0BUAWFWB3FGJAAM3EEL,"#29-11 ""Trump has the raw media power to weaken Bush,"" says Martin, ""I have the negative information and hardball media tactics to make Bush a toxic candidate for the Republican base.""",143,158,toxic candidate,2,0,2
3R4QIDVOJPD0BUAWFWB3FGJAAM3EEL,"#29-11 ""Trump has the raw media power to weaken Bush,"" says Martin, ""I have the negative information and hardball media tactics to make Bush a toxic candidate for the Republican base.""",149,158,candidate,3,0,3
3R4QIDVOJPD0BUAWFWB3FGJAAM3EEL,"#29-12 Martin adamantly opposes Bush because of the foreign policy of the candidate's brother, former President George W. Bush.",14,23,adamantly,10,10,20
3R4QIDVOJPD0BUAWFWB3FGJAAM3EEL,"#29-12 Martin adamantly opposes Bush because of the foreign policy of the candidate's brother, former President George W. Bush.",14,31,adamantly opposes,1,1,2
3R4QIDVOJPD0BUAWFWB3FGJAAM3EEL,"#29-12 Martin adamantly opposes Bush because of the foreign policy of the candidate's brother, former President George W. Bush.",24,31,opposes,3,1,4
3R4QIDVOJPD0BUAWFWB3FGJAAM3EEL,"#29-13 He also criticizes Bush for his alleged economic benefit from the collapse of Lehman Brothers, labeling Bush as a ""front man for a handful of corrupt plutocrats that have raped [the nation's] economy.""",15,25,criticizes,4,1,5
3R4QIDVOJPD0BUAWFWB3FGJAAM3EEL,"#29-13 He also criticizes Bush for his alleged economic benefit from the collapse of Lehman Brothers, labeling Bush as a ""front man for a handful of corrupt plutocrats that have raped [the nation's] economy.""",39,46,alleged,3,6,9
3R4QIDVOJPD0BUAWFWB3FGJAAM3EEL,"#29-13 He also criticizes Bush for his alleged economic benefit from the collapse of Lehman Brothers, labeling Bush as a ""front man for a handful of corrupt plutocrats that have raped [the nation's] economy.""",47,55,economic,1,0,1
3R4QIDVOJPD0BUAWFWB3FGJAAM3EEL,"#29-13 He also criticizes Bush for his alleged economic benefit from the collapse of Lehman Brothers, labeling Bush as a ""front man for a handful of corrupt plutocrats that have raped [the nation's] economy.""",73,81,collapse,1,2,3
3R4QIDVOJPD0BUAWFWB3FGJAAM3EEL,"#29-13 He also criticizes Bush for his alleged economic benefit from the collapse of Lehman Brothers, labeling Bush as a ""front man for a handful of corrupt plutocrats that have raped [the nation's] economy.""",85,91,Lehman,0,1,1
3R4QIDVOJPD0BUAWFWB3FGJAAM3EEL,"#29-13 He also criticizes Bush for his alleged economic benefit from the collapse of Lehman Brothers, labeling Bush as a ""front man for a handful of corrupt plutocrats that have raped [the nation's] economy.""",102,110,labeling,0,1,1
3R4QIDVOJPD0BUAWFWB3FGJAAM3EEL,"#29-13 He also criticizes Bush for his alleged economic benefit from the collapse of Lehman Brothers, labeling Bush as a ""front man for a handful of corrupt plutocrats that have raped [the nation's] economy.""",138,145,handful,0,1,1
3R4QIDVOJPD0BUAWFWB3FGJAAM3EEL,"#29-13 He also criticizes Bush for his alleged economic benefit from the collapse of Lehman Brothers, labeling Bush as a ""front man for a handful of corrupt plutocrats that have raped [the nation's] economy.""",149,156,corrupt,2,0,2
3R4QIDVOJPD0BUAWFWB3FGJAAM3EEL,"#29-13 He also criticizes Bush for his alleged economic benefit from the collapse of Lehman Brothers, labeling Bush as a ""front man for a handful of corrupt plutocrats that have raped [the nation's] economy.""",149,167,corrupt plutocrats,3,2,5
3R4QIDVOJPD0BUAWFWB3FGJAAM3EEL,"#29-13 He also criticizes Bush for his alleged economic benefit from the collapse of Lehman Brothers, labeling Bush as a ""front man for a handful of corrupt plutocrats that have raped [the nation's] economy.""",157,167,plutocrats,10,8,18
3R4QIDVOJPD0BUAWFWB3FGJAAM3EEL,"#29-14 Martin has previously criticized the Bush family during his 2000 campaign, when he ran television ads accusing then-presidential candidate George W. Bush of abusing cocaine and alcohol.",18,28,previously,1,0,1
3R4QIDVOJPD0BUAWFWB3FGJAAM3EEL,"#29-14 Martin has previously criticized the Bush family during his 2000 campaign, when he ran television ads accusing then-presidential candidate George W. Bush of abusing cocaine and alcohol.",29,39,criticized,1,3,4
3R4QIDVOJPD0BUAWFWB3FGJAAM3EEL,"#29-14 Martin has previously criticized the Bush family during his 2000 campaign, when he ran television ads accusing then-presidential candidate George W. Bush of abusing cocaine and alcohol.",109,117,accusing,2,0,2
3R4QIDVOJPD0BUAWFWB3FGJAAM3EEL,"#29-14 Martin has previously criticized the Bush family during his 2000 campaign, when he ran television ads accusing then-presidential candidate George W. Bush of abusing cocaine and alcohol.",118,135,then-presidential,2,0,2
3R4QIDVOJPD0BUAWFWB3FGJAAM3EEL,"#29-14 Martin has previously criticized the Bush family during his 2000 campaign, when he ran television ads accusing then-presidential candidate George W. Bush of abusing cocaine and alcohol.",118,145,then-presidential candidate,1,0,1
3R4QIDVOJPD0BUAWFWB3FGJAAM3EEL,"#29-14 Martin has previously criticized the Bush family during his 2000 campaign, when he ran television ads accusing then-presidential candidate George W. Bush of abusing cocaine and alcohol.",164,171,abusing,1,3,4
3R4QIDVOJPD0BUAWFWB3FGJAAM3EEL,"#29-14 Martin has previously criticized the Bush family during his 2000 campaign, when he ran television ads accusing then-presidential candidate George W. Bush of abusing cocaine and alcohol.",172,179,cocaine,0,1,1
3ODOP6T3ASLQOC1NX64P4TYU0UJ423,"#15-8 The presence of US assets ""threatens our interests and our security,"" according to Putin.",10,18,presence,3,2,5
3ODOP6T3ASLQOC1NX64P4TYU0UJ423,"#15-8 The presence of US assets ""threatens our interests and our security,"" according to Putin.",10,31,presence of US assets,1,0,1
3ODOP6T3ASLQOC1NX64P4TYU0UJ423,"#15-8 The presence of US assets ""threatens our interests and our security,"" according to Putin.",22,31,US assets,1,0,1
3ODOP6T3ASLQOC1NX64P4TYU0UJ423,"#15-8 The presence of US assets ""threatens our interests and our security,"" according to Putin.",25,31,assets,1,3,4
3ODOP6T3ASLQOC1NX64P4TYU0UJ423,"#15-8 The presence of US assets ""threatens our interests and our security,"" according to Putin.",33,42,threatens,3,8,11
3ODOP6T3ASLQOC1NX64P4TYU0UJ423,"#15-8 The presence of US assets ""threatens our interests and our security,"" according to Putin.",33,73,threatens our interests and our security,1,1,2
3ODOP6T3ASLQOC1NX64P4TYU0UJ423,"#15-8 The presence of US assets ""threatens our interests and our security,"" according to Putin.",65,73,security,1,1,2
3ODOP6T3ASLQOC1NX64P4TYU0UJ423,"#15-9 ""It's a third country that is building up its military presence on our borders in Europe,"" he told the BBC.",52,69,military presence,0,1,1
3ODOP6T3ASLQOC1NX64P4TYU0UJ423,"#15-9 ""It's a third country that is building up its military presence on our borders in Europe,"" he told the BBC.",61,69,presence,2,1,3
3ODOP6T3ASLQOC1NX64P4TYU0UJ423,"#15-9 ""It's a third country that is building up its military presence on our borders in Europe,"" he told the BBC.",109,112,BBC,1,0,1
3ODOP6T3ASLQOC1NX64P4TYU0UJ423,"#15-11 Outgoing US President Barack Obama authorised the move in response to Russian intervention in Ukraine in 2014, in which Crimea was annexed.",7,15,Outgoing,1,3,4
3ODOP6T3ASLQOC1NX64P4TYU0UJ423,"#15-11 Outgoing US President Barack Obama authorised the move in response to Russian intervention in Ukraine in 2014, in which Crimea was annexed.",29,41,Barack Obama,0,1,1
3ODOP6T3ASLQOC1NX64P4TYU0UJ423,"#15-11 Outgoing US President Barack Obama authorised the move in response to Russian intervention in Ukraine in 2014, in which Crimea was annexed.",42,52,authorised,5,7,12
3ODOP6T3ASLQOC1NX64P4TYU0UJ423,"#15-11 Outgoing US President Barack Obama authorised the move in response to Russian intervention in Ukraine in 2014, in which Crimea was annexed.",65,73,response,0,1,1
3ODOP6T3ASLQOC1NX64P4TYU0UJ423,"#15-11 Outgoing US President Barack Obama authorised the move in response to Russian intervention in Ukraine in 2014, in which Crimea was annexed.",77,97,Russian intervention,1,0,1
3ODOP6T3ASLQOC1NX64P4TYU0UJ423,"#15-11 Outgoing US President Barack Obama authorised the move in response to Russian intervention in Ukraine in 2014, in which Crimea was annexed.",85,97,intervention,6,7,13
3ODOP6T3ASLQOC1NX64P4TYU0UJ423,"#15-11 Outgoing US President Barack Obama authorised the move in response to Russian intervention in Ukraine in 2014, in which Crimea was annexed.",101,108,Ukraine,1,1,2
3ODOP6T3ASLQOC1NX64P4TYU0UJ423,"#15-11 Outgoing US President Barack Obama authorised the move in response to Russian intervention in Ukraine in 2014, in which Crimea was annexed.",127,133,Crimea,0,2,2
3ODOP6T3ASLQOC1NX64P4TYU0UJ423,"#15-11 Outgoing US President Barack Obama authorised the move in response to Russian intervention in Ukraine in 2014, in which Crimea was annexed.",127,145,Crimea was annexed,1,0,1
3ODOP6T3ASLQOC1NX64P4TYU0UJ423,"#15-11 Outgoing US President Barack Obama authorised the move in response to Russian intervention in Ukraine in 2014, in which Crimea was annexed.",138,145,annexed,8,8,16
3ODOP6T3ASLQOC1NX64P4TYU0UJ423,#15-12 It was agreed at a NATO summit in Warsaw last year.,26,37,NATO summit,1,1,2
3ODOP6T3ASLQOC1NX64P4TYU0UJ423,#15-12 It was agreed at a NATO summit in Warsaw last year.,31,37,summit,1,3,4
3ODOP6T3ASLQOC1NX64P4TYU0UJ423,"#15-13 Tomasz Szatkowski, Polish Undersecretary of State for Defence, noted ""large exercises"" by Russia near the Polish border as another reason the troops were needed.",7,13,Tomasz,0,1,1
3ODOP6T3ASLQOC1NX64P4TYU0UJ423,"#15-13 Tomasz Szatkowski, Polish Undersecretary of State for Defence, noted ""large exercises"" by Russia near the Polish border as another reason the troops were needed.",7,24,Tomasz Szatkowski,1,1,2
3ODOP6T3ASLQOC1NX64P4TYU0UJ423,"#15-13 Tomasz Szatkowski, Polish Undersecretary of State for Defence, noted ""large exercises"" by Russia near the Polish border as another reason the troops were needed.",26,47,Polish Undersecretary,1,0,1
3ODOP6T3ASLQOC1NX64P4TYU0UJ423,"#15-13 Tomasz Szatkowski, Polish Undersecretary of State for Defence, noted ""large exercises"" by Russia near the Polish border as another reason the troops were needed.",33,47,Undersecretary,4,2,6
3ODOP6T3ASLQOC1NX64P4TYU0UJ423,"#15-13 Tomasz Szatkowski, Polish Undersecretary of State for Defence, noted ""large exercises"" by Russia near the Polish border as another reason the troops were needed.",33,56,Undersecretary of State,0,1,1
3ODOP6T3ASLQOC1NX64P4TYU0UJ423,"#15-13 Tomasz Szatkowski, Polish Undersecretary of State for Defence, noted ""large exercises"" by Russia near the Polish border as another reason the troops were needed.",33,68,Undersecretary of State for Defence,0,1,1
3ODOP6T3ASLQOC1NX64P4TYU0UJ423,"#15-13 Tomasz Szatkowski, Polish Undersecretary of State for Defence, noted ""large exercises"" by Russia near the Polish border as another reason the troops were needed.",77,92,large exercises,0,2,2
3ODOP6T3ASLQOC1NX64P4TYU0UJ423,"#15-13 Tomasz Szatkowski, Polish Undersecretary of State for Defence, noted ""large exercises"" by Russia near the Polish border as another reason the troops were needed.",83,92,exercises,1,2,3
3ODOP6T3ASLQOC1NX64P4TYU0UJ423,"#15-13 Tomasz Szatkowski, Polish Undersecretary of State for Defence, noted ""large exercises"" by Russia near the Polish border as another reason the troops were needed.",149,155,troops,0,2,2
3ODOP6T3ASLQOC1NX64P4TYU0UJ423,"#15-14 Szatkowski also mentioned Russian action in Ukraine, which he called ""aggressive actions in our vicinity"".",7,17,Szatkowski,0,1,1
3ODOP6T3ASLQOC1NX64P4TYU0UJ423,"#15-14 Szatkowski also mentioned Russian action in Ukraine, which he called ""aggressive actions in our vicinity"".",23,32,mentioned,2,1,3
3ODOP6T3ASLQOC1NX64P4TYU0UJ423,"#15-14 Szatkowski also mentioned Russian action in Ukraine, which he called ""aggressive actions in our vicinity"".",77,87,aggressive,5,5,10
3ODOP6T3ASLQOC1NX64P4TYU0UJ423,"#15-14 Szatkowski also mentioned Russian action in Ukraine, which he called ""aggressive actions in our vicinity"".",77,95,aggressive actions,1,0,1
3ODOP6T3ASLQOC1NX64P4TYU0UJ423,"#15-14 Szatkowski also mentioned Russian action in Ukraine, which he called ""aggressive actions in our vicinity"".",77,111,aggressive actions in our vicinity,1,1,2
3ODOP6T3ASLQOC1NX64P4TYU0UJ423,"#15-14 Szatkowski also mentioned Russian action in Ukraine, which he called ""aggressive actions in our vicinity"".",103,111,vicinity,6,10,16
3ODOP6T3ASLQOC1NX64P4TYU0UJ423,"#15-15 Russian Deputy Foreign Minister Alexei Mechkov, however, said the incoming troops and vehicles were a ""factor destabilising European security"".",15,21,Deputy,0,1,1
3ODOP6T3ASLQOC1NX64P4TYU0UJ423,"#15-15 Russian Deputy Foreign Minister Alexei Mechkov, however, said the incoming troops and vehicles were a ""factor destabilising European security"".",39,53,Alexei Mechkov,0,1,1
3ODOP6T3ASLQOC1NX64P4TYU0UJ423,"#15-15 Russian Deputy Foreign Minister Alexei Mechkov, however, said the incoming troops and vehicles were a ""factor destabilising European security"".",46,53,Mechkov,1,1,2
3ODOP6T3ASLQOC1NX64P4TYU0UJ423,"#15-15 Russian Deputy Foreign Minister Alexei Mechkov, however, said the incoming troops and vehicles were a ""factor destabilising European security"".",73,81,incoming,1,1,2
3ODOP6T3ASLQOC1NX64P4TYU0UJ423,"#15-15 Russian Deputy Foreign Minister Alexei Mechkov, however, said the incoming troops and vehicles were a ""factor destabilising European security"".",93,101,vehicles,1,1,2
3ODOP6T3ASLQOC1NX64P4TYU0UJ423,"#15-15 Russian Deputy Foreign Minister Alexei Mechkov, however, said the incoming troops and vehicles were a ""factor destabilising European security"".",110,148,factor destabilising European security,0,1,1
3ODOP6T3ASLQOC1NX64P4TYU0UJ423,"#15-15 Russian Deputy Foreign Minister Alexei Mechkov, however, said the incoming troops and vehicles were a ""factor destabilising European security"".",117,130,destabilising,10,8,18
3ODOP6T3ASLQOC1NX64P4TYU0UJ423,"#15-15 Russian Deputy Foreign Minister Alexei Mechkov, however, said the incoming troops and vehicles were a ""factor destabilising European security"".",117,148,destabilising European security,1,0,1
3O0M2G5VC631OWMMIFJ4EG6860T49V,"#28-9 His most recent stint behind bars came last month, when he was arrested for allegedly slamming his girlfriend's head into a refrigerator in the same home involved on Saturday.",15,27,recent stint,0,1,1
3O0M2G5VC631OWMMIFJ4EG6860T49V,"#28-9 His most recent stint behind bars came last month, when he was arrested for allegedly slamming his girlfriend's head into a refrigerator in the same home involved on Saturday.",22,27,stint,9,9,18
3O0M2G5VC631OWMMIFJ4EG6860T49V,"#28-9 His most recent stint behind bars came last month, when he was arrested for allegedly slamming his girlfriend's head into a refrigerator in the same home involved on Saturday.",69,77,arrested,3,2,5
3O0M2G5VC631OWMMIFJ4EG6860T49V,"#28-9 His most recent stint behind bars came last month, when he was arrested for allegedly slamming his girlfriend's head into a refrigerator in the same home involved on Saturday.",82,91,allegedly,10,7,17
3O0M2G5VC631OWMMIFJ4EG6860T49V,"#28-9 His most recent stint behind bars came last month, when he was arrested for allegedly slamming his girlfriend's head into a refrigerator in the same home involved on Saturday.",82,100,allegedly slamming,1,2,3
3O0M2G5VC631OWMMIFJ4EG6860T49V,"#28-9 His most recent stint behind bars came last month, when he was arrested for allegedly slamming his girlfriend's head into a refrigerator in the same home involved on Saturday.",92,100,slamming,3,8,11
3O0M2G5VC631OWMMIFJ4EG6860T49V,"#28-9 His most recent stint behind bars came last month, when he was arrested for allegedly slamming his girlfriend's head into a refrigerator in the same home involved on Saturday.",130,142,refrigerator,4,2,6
3O0M2G5VC631OWMMIFJ4EG6860T49V,"#28-9 His most recent stint behind bars came last month, when he was arrested for allegedly slamming his girlfriend's head into a refrigerator in the same home involved on Saturday.",160,168,involved,0,1,1
3O0M2G5VC631OWMMIFJ4EG6860T49V,"#28-10 At the time of the murders, Conley was wanted on an assault charge against a family member.",26,33,murders,0,1,1
3O0M2G5VC631OWMMIFJ4EG6860T49V,"#28-10 At the time of the murders, Conley was wanted on an assault charge against a family member.",59,66,assault,5,9,14
3O0M2G5VC631OWMMIFJ4EG6860T49V,"#28-10 At the time of the murders, Conley was wanted on an assault charge against a family member.",59,73,assault charge,1,2,3
3O0M2G5VC631OWMMIFJ4EG6860T49V,#28-11 All eight victims died at the scene.,17,24,victims,2,3,5
3O0M2G5VC631OWMMIFJ4EG6860T49V,#28-11 All eight victims died at the scene.,37,42,scene,0,1,1
3O0M2G5VC631OWMMIFJ4EG6860T49V,"#28-12 On Sunday, authorities released the names and ages of the victims: Valerie Jackson, 40, and Dwayne Jackson, her husband, 50; Nathaniel Jackson, 13; Honesty Jackson, 11; Dwayne Jackson, Jr., 10; Caleb Jackson, 9; Trinity Jackson, 7; and Jonah Jackson, 6.",18,29,authorities,5,4,9
3O0M2G5VC631OWMMIFJ4EG6860T49V,"#28-12 On Sunday, authorities released the names and ages of the victims: Valerie Jackson, 40, and Dwayne Jackson, her husband, 50; Nathaniel Jackson, 13; Honesty Jackson, 11; Dwayne Jackson, Jr., 10; Caleb Jackson, 9; Trinity Jackson, 7; and Jonah Jackson, 6.",30,38,released,1,2,3
3O0M2G5VC631OWMMIFJ4EG6860T49V,"#28-12 On Sunday, authorities released the names and ages of the victims: Valerie Jackson, 40, and Dwayne Jackson, her husband, 50; Nathaniel Jackson, 13; Honesty Jackson, 11; Dwayne Jackson, Jr., 10; Caleb Jackson, 9; Trinity Jackson, 7; and Jonah Jackson, 6.",99,105,Dwayne,1,0,1
3O0M2G5VC631OWMMIFJ4EG6860T49V,"#28-12 On Sunday, authorities released the names and ages of the victims: Valerie Jackson, 40, and Dwayne Jackson, her husband, 50; Nathaniel Jackson, 13; Honesty Jackson, 11; Dwayne Jackson, Jr., 10; Caleb Jackson, 9; Trinity Jackson, 7; and Jonah Jackson, 6.",155,162,Honesty,1,0,1
3O0M2G5VC631OWMMIFJ4EG6860T49V,#28-13 Conley was the father of Nathaniel (Nate) Jackson.,32,41,Nathaniel,1,0,1
3O0M2G5VC631OWMMIFJ4EG6860T49V,#28-14 Conley told investigators he used to live with Valerie Jackson and broke into the home after she had changed the locks.,19,32,investigators,7,5,12
3O0M2G5VC631OWMMIFJ4EG6860T49V,#28-14 Conley told investigators he used to live with Valerie Jackson and broke into the home after she had changed the locks.,54,61,Valerie,1,0,1
3O0M2G5VC631OWMMIFJ4EG6860T49V,#28-14 Conley told investigators he used to live with Valerie Jackson and broke into the home after she had changed the locks.,74,79,broke,0,1,1
37J05LC5AXK3U4IOX2BA6EEHFIYJDI,"#39-16 ""We are truly sorry about [the] tragedy"" they told us in a statement.",39,46,tragedy,10,8,18
37J05LC5AXK3U4IOX2BA6EEHFIYJDI,"#39-16 ""We are truly sorry about [the] tragedy"" they told us in a statement.",64,75,a statement,0,1,1
37J05LC5AXK3U4IOX2BA6EEHFIYJDI,"#39-16 ""We are truly sorry about [the] tragedy"" they told us in a statement.",66,75,statement,0,4,4
37J05LC5AXK3U4IOX2BA6EEHFIYJDI,#39-17 They said they have checked GPS trackers on their fleet and all their vehicles remain in Slovakia.,27,34,checked,0,2,2
37J05LC5AXK3U4IOX2BA6EEHFIYJDI,#39-17 They said they have checked GPS trackers on their fleet and all their vehicles remain in Slovakia.,35,47,GPS trackers,0,1,1
37J05LC5AXK3U4IOX2BA6EEHFIYJDI,#39-17 They said they have checked GPS trackers on their fleet and all their vehicles remain in Slovakia.,39,47,trackers,1,2,3
37J05LC5AXK3U4IOX2BA6EEHFIYJDI,#39-17 They said they have checked GPS trackers on their fleet and all their vehicles remain in Slovakia.,57,62,fleet,1,3,4
37J05LC5AXK3U4IOX2BA6EEHFIYJDI,#39-17 They said they have checked GPS trackers on their fleet and all their vehicles remain in Slovakia.,77,85,vehicles,1,0,1
37J05LC5AXK3U4IOX2BA6EEHFIYJDI,#39-17 They said they have checked GPS trackers on their fleet and all their vehicles remain in Slovakia.,96,104,Slovakia,2,1,3
37J05LC5AXK3U4IOX2BA6EEHFIYJDI,#39-18 The statement says the lorry in question was one of 21 Hyza vehicles sold on last year.,11,20,statement,1,0,1
37J05LC5AXK3U4IOX2BA6EEHFIYJDI,#39-18 The statement says the lorry in question was one of 21 Hyza vehicles sold on last year.,30,35,lorry,7,3,10
37J05LC5AXK3U4IOX2BA6EEHFIYJDI,#39-18 The statement says the lorry in question was one of 21 Hyza vehicles sold on last year.,62,66,Hyza,1,1,2
37J05LC5AXK3U4IOX2BA6EEHFIYJDI,#39-18 The statement says the lorry in question was one of 21 Hyza vehicles sold on last year.,62,75,Hyza vehicles,1,0,1
37J05LC5AXK3U4IOX2BA6EEHFIYJDI,"#39-19 It was then sold again and exported to Hungary, where it is now registered.",34,42,exported,5,2,7
37J05LC5AXK3U4IOX2BA6EEHFIYJDI,"#39-19 It was then sold again and exported to Hungary, where it is now registered.",71,81,registered,4,3,7
37J05LC5AXK3U4IOX2BA6EEHFIYJDI,#39-20 Hyza told us the new owners have not changed the branding on the vehicle.,52,64,the branding,0,1,1
37J05LC5AXK3U4IOX2BA6EEHFIYJDI,#39-20 Hyza told us the new owners have not changed the branding on the vehicle.,56,64,branding,1,4,5
37J05LC5AXK3U4IOX2BA6EEHFIYJDI,"#39-21 According to the Bild newspaper, Agrofert -- the parent company of Hyza -- said in a statement the new owners were required to do so.",24,28,Bild,1,1,2
37J05LC5AXK3U4IOX2BA6EEHFIYJDI,"#39-21 According to the Bild newspaper, Agrofert -- the parent company of Hyza -- said in a statement the new owners were required to do so.",24,38,Bild newspaper,1,0,1
37J05LC5AXK3U4IOX2BA6EEHFIYJDI,"#39-21 According to the Bild newspaper, Agrofert -- the parent company of Hyza -- said in a statement the new owners were required to do so.",40,48,Agrofert,3,0,3
37J05LC5AXK3U4IOX2BA6EEHFIYJDI,"#39-21 According to the Bild newspaper, Agrofert -- the parent company of Hyza -- said in a statement the new owners were required to do so.",56,62,parent,0,1,1
37J05LC5AXK3U4IOX2BA6EEHFIYJDI,"#39-21 According to the Bild newspaper, Agrofert -- the parent company of Hyza -- said in a statement the new owners were required to do so.",92,101,statement,1,0,1
37J05LC5AXK3U4IOX2BA6EEHFIYJDI,"#39-21 According to the Bild newspaper, Agrofert -- the parent company of Hyza -- said in a statement the new owners were required to do so.",110,116,owners,0,1,1
37J05LC5AXK3U4IOX2BA6EEHFIYJDI,"#39-21 According to the Bild newspaper, Agrofert -- the parent company of Hyza -- said in a statement the new owners were required to do so.",122,130,required,0,2,2
37J05LC5AXK3U4IOX2BA6EEHFIYJDI,"#39-22 Hyza says they will ""actively cooperate with Slovak police"", and ""express [their] sincere condolences to the bereaved families.""",37,46,cooperate,3,1,4
37J05LC5AXK3U4IOX2BA6EEHFIYJDI,"#39-22 Hyza says they will ""actively cooperate with Slovak police"", and ""express [their] sincere condolences to the bereaved families.""",52,58,Slovak,0,1,1
37J05LC5AXK3U4IOX2BA6EEHFIYJDI,"#39-22 Hyza says they will ""actively cooperate with Slovak police"", and ""express [their] sincere condolences to the bereaved families.""",73,80,express,0,2,2
37J05LC5AXK3U4IOX2BA6EEHFIYJDI,"#39-22 Hyza says they will ""actively cooperate with Slovak police"", and ""express [their] sincere condolences to the bereaved families.""",89,96,sincere,1,0,1
37J05LC5AXK3U4IOX2BA6EEHFIYJDI,"#39-22 Hyza says they will ""actively cooperate with Slovak police"", and ""express [their] sincere condolences to the bereaved families.""",97,108,condolences,10,8,18
37J05LC5AXK3U4IOX2BA6EEHFIYJDI,"#39-22 Hyza says they will ""actively cooperate with Slovak police"", and ""express [their] sincere condolences to the bereaved families.""",97,124,condolences to the bereaved,1,0,1
37J05LC5AXK3U4IOX2BA6EEHFIYJDI,"#39-22 Hyza says they will ""actively cooperate with Slovak police"", and ""express [their] sincere condolences to the bereaved families.""",116,124,bereaved,10,10,20
37J05LC5AXK3U4IOX2BA6EEHFIYJDI,"#39-23 Interior Minister Johanna Mikl-Leitner called it ""a dark day"" and called for European Union-wide measures to protect immigrant refugees and tackle human traffickers.",7,15,Interior,0,1,1
37J05LC5AXK3U4IOX2BA6EEHFIYJDI,"#39-23 Interior Minister Johanna Mikl-Leitner called it ""a dark day"" and called for European Union-wide measures to protect immigrant refugees and tackle human traffickers.",7,24,Interior Minister,1,1,2
37J05LC5AXK3U4IOX2BA6EEHFIYJDI,"#39-23 Interior Minister Johanna Mikl-Leitner called it ""a dark day"" and called for European Union-wide measures to protect immigrant refugees and tackle human traffickers.",25,32,Johanna,0,1,1
37J05LC5AXK3U4IOX2BA6EEHFIYJDI,"#39-23 Interior Minister Johanna Mikl-Leitner called it ""a dark day"" and called for European Union-wide measures to protect immigrant refugees and tackle human traffickers.",33,45,Mikl-Leitner,0,1,1
37J05LC5AXK3U4IOX2BA6EEHFIYJDI,"#39-23 Interior Minister Johanna Mikl-Leitner called it ""a dark day"" and called for European Union-wide measures to protect immigrant refugees and tackle human traffickers.",93,103,Union-wide,1,0,1
37J05LC5AXK3U4IOX2BA6EEHFIYJDI,"#39-23 Interior Minister Johanna Mikl-Leitner called it ""a dark day"" and called for European Union-wide measures to protect immigrant refugees and tackle human traffickers.",104,112,measures,0,1,1
37J05LC5AXK3U4IOX2BA6EEHFIYJDI,"#39-23 Interior Minister Johanna Mikl-Leitner called it ""a dark day"" and called for European Union-wide measures to protect immigrant refugees and tackle human traffickers.",124,133,immigrant,4,5,9
37J05LC5AXK3U4IOX2BA6EEHFIYJDI,"#39-23 Interior Minister Johanna Mikl-Leitner called it ""a dark day"" and called for European Union-wide measures to protect immigrant refugees and tackle human traffickers.",124,142,immigrant refugees,1,2,3
37J05LC5AXK3U4IOX2BA6EEHFIYJDI,"#39-23 Interior Minister Johanna Mikl-Leitner called it ""a dark day"" and called for European Union-wide measures to protect immigrant refugees and tackle human traffickers.",134,142,refugees,5,3,8
37J05LC5AXK3U4IOX2BA6EEHFIYJDI,"#39-23 Interior Minister Johanna Mikl-Leitner called it ""a dark day"" and called for European Union-wide measures to protect immigrant refugees and tackle human traffickers.",147,153,tackle,2,6,8
37J05LC5AXK3U4IOX2BA6EEHFIYJDI,"#39-23 Interior Minister Johanna Mikl-Leitner called it ""a dark day"" and called for European Union-wide measures to protect immigrant refugees and tackle human traffickers.",154,171,human traffickers,2,0,2
37J05LC5AXK3U4IOX2BA6EEHFIYJDI,"#39-23 Interior Minister Johanna Mikl-Leitner called it ""a dark day"" and called for European Union-wide measures to protect immigrant refugees and tackle human traffickers.",160,171,traffickers,7,8,15
344M16OZKIG450N98VEM53DJOE4ENA,"#36-1 IndyCar driver Justin Wilson dies aged 37 Yesterday, 37-year old IndyCar Series driver Justin Wilson died of injuries sustained on Sunday during the ABC Supply 500 at Pocono Raceway.",48,57,Yesterday,1,0,1
344M16OZKIG450N98VEM53DJOE4ENA,"#36-1 IndyCar driver Justin Wilson dies aged 37 Yesterday, 37-year old IndyCar Series driver Justin Wilson died of injuries sustained on Sunday during the ABC Supply 500 at Pocono Raceway.",71,78,IndyCar,1,1,2
344M16OZKIG450N98VEM53DJOE4ENA,"#36-1 IndyCar driver Justin Wilson dies aged 37 Yesterday, 37-year old IndyCar Series driver Justin Wilson died of injuries sustained on Sunday during the ABC Supply 500 at Pocono Raceway.",115,123,injuries,4,0,4
344M16OZKIG450N98VEM53DJOE4ENA,"#36-1 IndyCar driver Justin Wilson dies aged 37 Yesterday, 37-year old IndyCar Series driver Justin Wilson died of injuries sustained on Sunday during the ABC Supply 500 at Pocono Raceway.",124,133,sustained,10,8,18
344M16OZKIG450N98VEM53DJOE4ENA,"#36-1 IndyCar driver Justin Wilson dies aged 37 Yesterday, 37-year old IndyCar Series driver Justin Wilson died of injuries sustained on Sunday during the ABC Supply 500 at Pocono Raceway.",173,179,Pocono,1,0,1
344M16OZKIG450N98VEM53DJOE4ENA,"#36-2 With about twenty laps remaining in the race, Sage Karam, who had been leading the event, crashed into the turn 1 wall.",17,28,twenty laps,0,1,1
344M16OZKIG450N98VEM53DJOE4ENA,"#36-2 With about twenty laps remaining in the race, Sage Karam, who had been leading the event, crashed into the turn 1 wall.",24,28,laps,0,3,3
344M16OZKIG450N98VEM53DJOE4ENA,"#36-2 With about twenty laps remaining in the race, Sage Karam, who had been leading the event, crashed into the turn 1 wall.",29,38,remaining,1,0,1
344M16OZKIG450N98VEM53DJOE4ENA,"#36-2 With about twenty laps remaining in the race, Sage Karam, who had been leading the event, crashed into the turn 1 wall.",77,84,leading,0,1,1
344M16OZKIG450N98VEM53DJOE4ENA,"#36-2 With about twenty laps remaining in the race, Sage Karam, who had been leading the event, crashed into the turn 1 wall.",96,103,crashed,0,3,3
344M16OZKIG450N98VEM53DJOE4ENA,"#36-3 As Wilson approached the site of the crash, reportedly the nose cone from Karam's car that had been airborne struck Wilson in the helmet; Wilson's car steered to the left and collided with the inside SAFER barrier.",16,26,approached,5,3,8
344M16OZKIG450N98VEM53DJOE4ENA,"#36-3 As Wilson approached the site of the crash, reportedly the nose cone from Karam's car that had been airborne struck Wilson in the helmet; Wilson's car steered to the left and collided with the inside SAFER barrier.",31,35,site,0,1,1
344M16OZKIG450N98VEM53DJOE4ENA,"#36-3 As Wilson approached the site of the crash, reportedly the nose cone from Karam's car that had been airborne struck Wilson in the helmet; Wilson's car steered to the left and collided with the inside SAFER barrier.",43,48,crash,0,1,1
344M16OZKIG450N98VEM53DJOE4ENA,"#36-3 As Wilson approached the site of the crash, reportedly the nose cone from Karam's car that had been airborne struck Wilson in the helmet; Wilson's car steered to the left and collided with the inside SAFER barrier.",50,60,reportedly,2,2,4
344M16OZKIG450N98VEM53DJOE4ENA,"#36-3 As Wilson approached the site of the crash, reportedly the nose cone from Karam's car that had been airborne struck Wilson in the helmet; Wilson's car steered to the left and collided with the inside SAFER barrier.",65,74,nose cone,0,1,1
344M16OZKIG450N98VEM53DJOE4ENA,"#36-3 As Wilson approached the site of the crash, reportedly the nose cone from Karam's car that had been airborne struck Wilson in the helmet; Wilson's car steered to the left and collided with the inside SAFER barrier.",70,74,cone,0,1,1
344M16OZKIG450N98VEM53DJOE4ENA,"#36-3 As Wilson approached the site of the crash, reportedly the nose cone from Karam's car that had been airborne struck Wilson in the helmet; Wilson's car steered to the left and collided with the inside SAFER barrier.",106,114,airborne,6,7,13
344M16OZKIG450N98VEM53DJOE4ENA,"#36-3 As Wilson approached the site of the crash, reportedly the nose cone from Karam's car that had been airborne struck Wilson in the helmet; Wilson's car steered to the left and collided with the inside SAFER barrier.",115,121,struck,0,1,1
344M16OZKIG450N98VEM53DJOE4ENA,"#36-3 As Wilson approached the site of the crash, reportedly the nose cone from Karam's car that had been airborne struck Wilson in the helmet; Wilson's car steered to the left and collided with the inside SAFER barrier.",136,142,helmet,1,0,1
344M16OZKIG450N98VEM53DJOE4ENA,"#36-3 As Wilson approached the site of the crash, reportedly the nose cone from Karam's car that had been airborne struck Wilson in the helmet; Wilson's car steered to the left and collided with the inside SAFER barrier.",157,164,steered,4,9,13
344M16OZKIG450N98VEM53DJOE4ENA,"#36-3 As Wilson approached the site of the crash, reportedly the nose cone from Karam's car that had been airborne struck Wilson in the helmet; Wilson's car steered to the left and collided with the inside SAFER barrier.",181,189,collided,8,5,13
344M16OZKIG450N98VEM53DJOE4ENA,"#36-3 As Wilson approached the site of the crash, reportedly the nose cone from Karam's car that had been airborne struck Wilson in the helmet; Wilson's car steered to the left and collided with the inside SAFER barrier.",212,219,barrier,3,4,7
344M16OZKIG450N98VEM53DJOE4ENA,#36-4 The event was placed under the caution flag as safety workers extracted Wilson from his car.,37,44,caution,3,0,3
344M16OZKIG450N98VEM53DJOE4ENA,#36-4 The event was placed under the caution flag as safety workers extracted Wilson from his car.,37,49,caution flag,1,2,3
344M16OZKIG450N98VEM53DJOE4ENA,#36-4 The event was placed under the caution flag as safety workers extracted Wilson from his car.,68,77,extracted,10,7,17
344M16OZKIG450N98VEM53DJOE4ENA,"#36-5 Wilson was airlifted to Lehigh Valley Hospital in Allentown, Pennsylvania.",17,26,airlifted,7,8,15
344M16OZKIG450N98VEM53DJOE4ENA,"#36-6 At 9 P.M. EST, INDYCAR released a statement, announcing that Wilson had suffered a severe head injury, was in critical condition and had fallen into a coma.",29,49,released a statement,1,0,1
344M16OZKIG450N98VEM53DJOE4ENA,"#36-6 At 9 P.M. EST, INDYCAR released a statement, announcing that Wilson had suffered a severe head injury, was in critical condition and had fallen into a coma.",40,49,statement,0,1,1
344M16OZKIG450N98VEM53DJOE4ENA,"#36-6 At 9 P.M. EST, INDYCAR released a statement, announcing that Wilson had suffered a severe head injury, was in critical condition and had fallen into a coma.",40,61,"statement, announcing",1,0,1
344M16OZKIG450N98VEM53DJOE4ENA,"#36-6 At 9 P.M. EST, INDYCAR released a statement, announcing that Wilson had suffered a severe head injury, was in critical condition and had fallen into a coma.",51,61,announcing,2,1,3
344M16OZKIG450N98VEM53DJOE4ENA,"#36-6 At 9 P.M. EST, INDYCAR released a statement, announcing that Wilson had suffered a severe head injury, was in critical condition and had fallen into a coma.",78,86,suffered,3,1,4
344M16OZKIG450N98VEM53DJOE4ENA,"#36-6 At 9 P.M. EST, INDYCAR released a statement, announcing that Wilson had suffered a severe head injury, was in critical condition and had fallen into a coma.",89,95,severe,5,0,5
344M16OZKIG450N98VEM53DJOE4ENA,"#36-6 At 9 P.M. EST, INDYCAR released a statement, announcing that Wilson had suffered a severe head injury, was in critical condition and had fallen into a coma.",116,124,critical,4,0,4
344M16OZKIG450N98VEM53DJOE4ENA,"#36-6 At 9 P.M. EST, INDYCAR released a statement, announcing that Wilson had suffered a severe head injury, was in critical condition and had fallen into a coma.",116,134,critical condition,2,0,2
344M16OZKIG450N98VEM53DJOE4ENA,"#36-6 At 9 P.M. EST, INDYCAR released a statement, announcing that Wilson had suffered a severe head injury, was in critical condition and had fallen into a coma.",125,134,condition,1,0,1
344M16OZKIG450N98VEM53DJOE4ENA,"#36-6 At 9 P.M. EST, INDYCAR released a statement, announcing that Wilson had suffered a severe head injury, was in critical condition and had fallen into a coma.",139,154,had fallen into,0,1,1
344M16OZKIG450N98VEM53DJOE4ENA,"#36-6 At 9 P.M. EST, INDYCAR released a statement, announcing that Wilson had suffered a severe head injury, was in critical condition and had fallen into a coma.",157,161,coma,3,5,8
374UMBUHN5QN3F8F90U3OEJ8SKCTCW,"#26-7 Initially, all three were considered victims, but the status of one has been changed to suspect.",6,15,Initially,7,2,9
374UMBUHN5QN3F8F90U3OEJ8SKCTCW,"#26-7 Initially, all three were considered victims, but the status of one has been changed to suspect.",32,42,considered,3,3,6
374UMBUHN5QN3F8F90U3OEJ8SKCTCW,"#26-7 Initially, all three were considered victims, but the status of one has been changed to suspect.",43,50,victims,4,2,6
374UMBUHN5QN3F8F90U3OEJ8SKCTCW,"#26-7 Initially, all three were considered victims, but the status of one has been changed to suspect.",60,66,status,4,1,5
374UMBUHN5QN3F8F90U3OEJ8SKCTCW,"#26-7 Initially, all three were considered victims, but the status of one has been changed to suspect.",83,90,changed,0,2,2
374UMBUHN5QN3F8F90U3OEJ8SKCTCW,"#26-7 Initially, all three were considered victims, but the status of one has been changed to suspect.",94,101,suspect,3,3,6
374UMBUHN5QN3F8F90U3OEJ8SKCTCW,"#26-8 The other two, a man and a woman, subsequently died from their wounds.",40,52,subsequently,10,9,19
374UMBUHN5QN3F8F90U3OEJ8SKCTCW,"#26-8 The other two, a man and a woman, subsequently died from their wounds.",69,75,wounds,2,1,3
374UMBUHN5QN3F8F90U3OEJ8SKCTCW,#26-9 Police have said CCTV is helping in the investigation.,23,27,CCTV,1,0,1
374UMBUHN5QN3F8F90U3OEJ8SKCTCW,#26-9 Police have said CCTV is helping in the investigation.,46,59,investigation,6,5,11
374UMBUHN5QN3F8F90U3OEJ8SKCTCW,#26-10 Local newspaper Vestmanlands Läns Tidning (VLT) has reportedly posted footage of one of the suspects being tackled by police.,7,53,Local newspaper Vestmanlands Läns Tidning (VLT,1,0,1
374UMBUHN5QN3F8F90U3OEJ8SKCTCW,#26-10 Local newspaper Vestmanlands Läns Tidning (VLT) has reportedly posted footage of one of the suspects being tackled by police.,13,22,newspaper,1,0,1
374UMBUHN5QN3F8F90U3OEJ8SKCTCW,#26-10 Local newspaper Vestmanlands Läns Tidning (VLT) has reportedly posted footage of one of the suspects being tackled by police.,23,48,Vestmanlands Läns Tidning,1,1,2
374UMBUHN5QN3F8F90U3OEJ8SKCTCW,#26-10 Local newspaper Vestmanlands Läns Tidning (VLT) has reportedly posted footage of one of the suspects being tackled by police.,59,69,reportedly,1,3,4
374UMBUHN5QN3F8F90U3OEJ8SKCTCW,#26-10 Local newspaper Vestmanlands Läns Tidning (VLT) has reportedly posted footage of one of the suspects being tackled by police.,77,84,footage,4,4,8
374UMBUHN5QN3F8F90U3OEJ8SKCTCW,#26-10 Local newspaper Vestmanlands Läns Tidning (VLT) has reportedly posted footage of one of the suspects being tackled by police.,99,107,suspects,2,1,3
374UMBUHN5QN3F8F90U3OEJ8SKCTCW,#26-10 Local newspaper Vestmanlands Läns Tidning (VLT) has reportedly posted footage of one of the suspects being tackled by police.,114,121,tackled,8,9,17
374UMBUHN5QN3F8F90U3OEJ8SKCTCW,"#26-11 VLT has further claimed to have identified the two victims as a mother and son, aged 55 and 28 respectively.",23,30,claimed,1,0,1
374UMBUHN5QN3F8F90U3OEJ8SKCTCW,"#26-11 VLT has further claimed to have identified the two victims as a mother and son, aged 55 and 28 respectively.",39,49,identified,3,0,3
374UMBUHN5QN3F8F90U3OEJ8SKCTCW,"#26-11 VLT has further claimed to have identified the two victims as a mother and son, aged 55 and 28 respectively.",102,114,respectively,10,2,12
374UMBUHN5QN3F8F90U3OEJ8SKCTCW,"#26-12 According to the paper, the victims were not local residents, but did have a connection with Västerås, where they were vacationing at the time of the attack, which a police spokesperson has called ""an act of madness""((sv)).",35,42,victims,0,1,1
374UMBUHN5QN3F8F90U3OEJ8SKCTCW,"#26-12 According to the paper, the victims were not local residents, but did have a connection with Västerås, where they were vacationing at the time of the attack, which a police spokesperson has called ""an act of madness""((sv)).",58,67,residents,1,1,2
374UMBUHN5QN3F8F90U3OEJ8SKCTCW,"#26-12 According to the paper, the victims were not local residents, but did have a connection with Västerås, where they were vacationing at the time of the attack, which a police spokesperson has called ""an act of madness""((sv)).",84,94,connection,1,0,1
374UMBUHN5QN3F8F90U3OEJ8SKCTCW,"#26-12 According to the paper, the victims were not local residents, but did have a connection with Västerås, where they were vacationing at the time of the attack, which a police spokesperson has called ""an act of madness""((sv)).",100,108,Västerås,1,1,2
374UMBUHN5QN3F8F90U3OEJ8SKCTCW,"#26-12 According to the paper, the victims were not local residents, but did have a connection with Västerås, where they were vacationing at the time of the attack, which a police spokesperson has called ""an act of madness""((sv)).",126,137,vacationing,9,8,17
374UMBUHN5QN3F8F90U3OEJ8SKCTCW,"#26-12 According to the paper, the victims were not local residents, but did have a connection with Västerås, where they were vacationing at the time of the attack, which a police spokesperson has called ""an act of madness""((sv)).",180,192,spokesperson,6,5,11
374UMBUHN5QN3F8F90U3OEJ8SKCTCW,"#26-12 According to the paper, the victims were not local residents, but did have a connection with Västerås, where they were vacationing at the time of the attack, which a police spokesperson has called ""an act of madness""((sv)).",205,222,an act of madness,1,0,1
374UMBUHN5QN3F8F90U3OEJ8SKCTCW,"#26-12 According to the paper, the victims were not local residents, but did have a connection with Västerås, where they were vacationing at the time of the attack, which a police spokesperson has called ""an act of madness""((sv)).",208,222,act of madness,0,1,1
374UMBUHN5QN3F8F90U3OEJ8SKCTCW,"#26-12 According to the paper, the victims were not local residents, but did have a connection with Västerås, where they were vacationing at the time of the attack, which a police spokesperson has called ""an act of madness""((sv)).",215,222,madness,2,0,2
374UMBUHN5QN3F8F90U3OEJ8SKCTCW,"#26-13 ""This is the worst working day of my life""((sv)), said Mattias Johansson, the store manager of IKEA in Västerås, to Sveriges Television.",20,25,worst,1,2,3
374UMBUHN5QN3F8F90U3OEJ8SKCTCW,"#26-13 ""This is the worst working day of my life""((sv)), said Mattias Johansson, the store manager of IKEA in Västerås, to Sveriges Television.",62,69,Mattias,1,0,1
374UMBUHN5QN3F8F90U3OEJ8SKCTCW,"#26-13 ""This is the worst working day of my life""((sv)), said Mattias Johansson, the store manager of IKEA in Västerås, to Sveriges Television.",62,79,Mattias Johansson,0,1,1
374UMBUHN5QN3F8F90U3OEJ8SKCTCW,"#26-13 ""This is the worst working day of my life""((sv)), said Mattias Johansson, the store manager of IKEA in Västerås, to Sveriges Television.",110,118,Västerås,1,0,1
374UMBUHN5QN3F8F90U3OEJ8SKCTCW,"#26-13 ""This is the worst working day of my life""((sv)), said Mattias Johansson, the store manager of IKEA in Västerås, to Sveriges Television.",123,131,Sveriges,1,1,2
301KG0KX9CMK0OPICDO8YI7Y5Z5H22,"#15-25 Within a week of the Law and Justice Party coming to power in Poland, it removed web pages featuring the results of an investigation into the Smolensk air disaster in Russia in 2010.",28,49,Law and Justice Party,1,0,1
301KG0KX9CMK0OPICDO8YI7Y5Z5H22,"#15-25 Within a week of the Law and Justice Party coming to power in Poland, it removed web pages featuring the results of an investigation into the Smolensk air disaster in Russia in 2010.",80,87,removed,0,1,1
301KG0KX9CMK0OPICDO8YI7Y5Z5H22,"#15-25 Within a week of the Law and Justice Party coming to power in Poland, it removed web pages featuring the results of an investigation into the Smolensk air disaster in Russia in 2010.",88,91,web,0,1,1
301KG0KX9CMK0OPICDO8YI7Y5Z5H22,"#15-25 Within a week of the Law and Justice Party coming to power in Poland, it removed web pages featuring the results of an investigation into the Smolensk air disaster in Russia in 2010.",98,107,featuring,3,5,8
301KG0KX9CMK0OPICDO8YI7Y5Z5H22,"#15-25 Within a week of the Law and Justice Party coming to power in Poland, it removed web pages featuring the results of an investigation into the Smolensk air disaster in Russia in 2010.",126,139,investigation,5,6,11
301KG0KX9CMK0OPICDO8YI7Y5Z5H22,"#15-25 Within a week of the Law and Justice Party coming to power in Poland, it removed web pages featuring the results of an investigation into the Smolensk air disaster in Russia in 2010.",149,157,Smolensk,2,1,3
301KG0KX9CMK0OPICDO8YI7Y5Z5H22,"#15-25 Within a week of the Law and Justice Party coming to power in Poland, it removed web pages featuring the results of an investigation into the Smolensk air disaster in Russia in 2010.",149,170,Smolensk air disaster,3,0,3
301KG0KX9CMK0OPICDO8YI7Y5Z5H22,"#15-25 Within a week of the Law and Justice Party coming to power in Poland, it removed web pages featuring the results of an investigation into the Smolensk air disaster in Russia in 2010.",158,161,air,1,0,1
301KG0KX9CMK0OPICDO8YI7Y5Z5H22,"#15-25 Within a week of the Law and Justice Party coming to power in Poland, it removed web pages featuring the results of an investigation into the Smolensk air disaster in Russia in 2010.",162,170,disaster,2,8,10
301KG0KX9CMK0OPICDO8YI7Y5Z5H22,"#15-26 The cause of the crash, which killed dignitaries including Polish President Lech Kaczynski, is disputed.",44,55,dignitaries,10,10,20
301KG0KX9CMK0OPICDO8YI7Y5Z5H22,"#15-26 The cause of the crash, which killed dignitaries including Polish President Lech Kaczynski, is disputed.",88,97,Kaczynski,1,1,2
301KG0KX9CMK0OPICDO8YI7Y5Z5H22,"#15-26 The cause of the crash, which killed dignitaries including Polish President Lech Kaczynski, is disputed.",102,110,disputed,5,8,13
301KG0KX9CMK0OPICDO8YI7Y5Z5H22,#15-27 A Polish probe concluded the Polish pilots put safety second in their determination to get their passengers through dense fog.,16,21,probe,3,1,4
301KG0KX9CMK0OPICDO8YI7Y5Z5H22,#15-27 A Polish probe concluded the Polish pilots put safety second in their determination to get their passengers through dense fog.,22,31,concluded,2,1,3
301KG0KX9CMK0OPICDO8YI7Y5Z5H22,#15-27 A Polish probe concluded the Polish pilots put safety second in their determination to get their passengers through dense fog.,43,49,pilots,2,0,2
301KG0KX9CMK0OPICDO8YI7Y5Z5H22,#15-27 A Polish probe concluded the Polish pilots put safety second in their determination to get their passengers through dense fog.,77,90,determination,8,7,15
301KG0KX9CMK0OPICDO8YI7Y5Z5H22,#15-27 A Polish probe concluded the Polish pilots put safety second in their determination to get their passengers through dense fog.,123,128,dense,3,2,5
301KG0KX9CMK0OPICDO8YI7Y5Z5H22,#15-27 A Polish probe concluded the Polish pilots put safety second in their determination to get their passengers through dense fog.,123,132,dense fog,0,2,2
301KG0KX9CMK0OPICDO8YI7Y5Z5H22,#15-27 A Polish probe concluded the Polish pilots put safety second in their determination to get their passengers through dense fog.,129,132,fog,0,1,1
301KG0KX9CMK0OPICDO8YI7Y5Z5H22,#15-28 It also placed blame on Russian controllers for failing to divert the aircraft.,22,27,blame,0,4,4
301KG0KX9CMK0OPICDO8YI7Y5Z5H22,#15-28 It also placed blame on Russian controllers for failing to divert the aircraft.,31,50,Russian controllers,1,1,2
301KG0KX9CMK0OPICDO8YI7Y5Z5H22,#15-28 It also placed blame on Russian controllers for failing to divert the aircraft.,55,62,failing,0,2,2
301KG0KX9CMK0OPICDO8YI7Y5Z5H22,#15-28 It also placed blame on Russian controllers for failing to divert the aircraft.,55,72,failing to divert,0,1,1
301KG0KX9CMK0OPICDO8YI7Y5Z5H22,#15-28 It also placed blame on Russian controllers for failing to divert the aircraft.,66,72,divert,2,5,7
301KG0KX9CMK0OPICDO8YI7Y5Z5H22,#15-29 Russian investigators blamed the pilots alone.,15,28,investigators,2,0,2
301KG0KX9CMK0OPICDO8YI7Y5Z5H22,#15-29 Russian investigators blamed the pilots alone.,29,35,blamed,0,2,2
301KG0KX9CMK0OPICDO8YI7Y5Z5H22,#15-29 Russian investigators blamed the pilots alone.,40,46,pilots,1,0,1
301KG0KX9CMK0OPICDO8YI7Y5Z5H22,"#15-30 The flight was carrying high-profile political figures to attend a ceremony commemorating the 70th anniversary of the Katyn massacre, when thousands of Polish prisoners of war and civilians were killed by the Soviets.",31,43,high-profile,2,3,5
301KG0KX9CMK0OPICDO8YI7Y5Z5H22,"#15-30 The flight was carrying high-profile political figures to attend a ceremony commemorating the 70th anniversary of the Katyn massacre, when thousands of Polish prisoners of war and civilians were killed by the Soviets.",31,61,high-profile political figures,1,1,2
301KG0KX9CMK0OPICDO8YI7Y5Z5H22,"#15-30 The flight was carrying high-profile political figures to attend a ceremony commemorating the 70th anniversary of the Katyn massacre, when thousands of Polish prisoners of war and civilians were killed by the Soviets.",44,53,political,0,1,1
301KG0KX9CMK0OPICDO8YI7Y5Z5H22,"#15-30 The flight was carrying high-profile political figures to attend a ceremony commemorating the 70th anniversary of the Katyn massacre, when thousands of Polish prisoners of war and civilians were killed by the Soviets.",74,82,ceremony,1,1,2
301KG0KX9CMK0OPICDO8YI7Y5Z5H22,"#15-30 The flight was carrying high-profile political figures to attend a ceremony commemorating the 70th anniversary of the Katyn massacre, when thousands of Polish prisoners of war and civilians were killed by the Soviets.",83,96,commemorating,10,9,19
301KG0KX9CMK0OPICDO8YI7Y5Z5H22,"#15-30 The flight was carrying high-profile political figures to attend a ceremony commemorating the 70th anniversary of the Katyn massacre, when thousands of Polish prisoners of war and civilians were killed by the Soviets.",106,117,anniversary,1,0,1
301KG0KX9CMK0OPICDO8YI7Y5Z5H22,"#15-30 The flight was carrying high-profile political figures to attend a ceremony commemorating the 70th anniversary of the Katyn massacre, when thousands of Polish prisoners of war and civilians were killed by the Soviets.",125,130,Katyn,0,1,1
301KG0KX9CMK0OPICDO8YI7Y5Z5H22,"#15-30 The flight was carrying high-profile political figures to attend a ceremony commemorating the 70th anniversary of the Katyn massacre, when thousands of Polish prisoners of war and civilians were killed by the Soviets.",131,139,massacre,8,5,13
301KG0KX9CMK0OPICDO8YI7Y5Z5H22,"#15-30 The flight was carrying high-profile political figures to attend a ceremony commemorating the 70th anniversary of the Katyn massacre, when thousands of Polish prisoners of war and civilians were killed by the Soviets.",187,196,civilians,2,0,2
301KG0KX9CMK0OPICDO8YI7Y5Z5H22,"#15-30 The flight was carrying high-profile political figures to attend a ceremony commemorating the 70th anniversary of the Katyn massacre, when thousands of Polish prisoners of war and civilians were killed by the Soviets.",216,223,Soviets,1,0,1
