HIT_ID,Sentence,Start_Offset,End_Offset,Complex_Phrase,Native_Annotators,Non_Native_Annotators,Total_Annotators
3XU9MCX6VODXPI3L8I02CM94TFB2R7,"Normally , the land will be passed down to future generations in a way that recognizes the community 's traditional connection to that country .",28,34,passed,0,2,2
3XU9MCX6VODXPI3L8I02CM94TFB2R7,"Normally , the land will be passed down to future generations in a way that recognizes the community 's traditional connection to that country .",43,49,future,1,0,1
3XU9MCX6VODXPI3L8I02CM94TFB2R7,"Normally , the land will be passed down to future generations in a way that recognizes the community 's traditional connection to that country .",43,61,future generations,1,2,3
3XU9MCX6VODXPI3L8I02CM94TFB2R7,"Normally , the land will be passed down to future generations in a way that recognizes the community 's traditional connection to that country .",50,61,generations,4,3,7
3XU9MCX6VODXPI3L8I02CM94TFB2R7,"Normally , the land will be passed down to future generations in a way that recognizes the community 's traditional connection to that country .",76,86,recognizes,3,4,7
3XU9MCX6VODXPI3L8I02CM94TFB2R7,"Normally , the land will be passed down to future generations in a way that recognizes the community 's traditional connection to that country .",91,100,community,1,0,1
3XU9MCX6VODXPI3L8I02CM94TFB2R7,"Normally , the land will be passed down to future generations in a way that recognizes the community 's traditional connection to that country .",91,125,community s traditional connection,1,0,1
3XU9MCX6VODXPI3L8I02CM94TFB2R7,"Normally , the land will be passed down to future generations in a way that recognizes the community 's traditional connection to that country .",104,115,traditional,1,4,5
3XU9MCX6VODXPI3L8I02CM94TFB2R7,"Normally , the land will be passed down to future generations in a way that recognizes the community 's traditional connection to that country .",104,142,traditional connection to that country,1,0,1
3XU9MCX6VODXPI3L8I02CM94TFB2R7,"Normally , the land will be passed down to future generations in a way that recognizes the community 's traditional connection to that country .",135,142,country,0,1,1
3XU9MCX6VODXPI3L8I02CM94TFB2R7,"The passing of Aboriginal land rights legislaton in Australia was preceded by a number of important Aboriginal protests , including the 1946 Aboriginal Stockmen 's Strike , the 1963 Yolngu Bark Petition , and the 1966 Wave Hill Walk-Off , as well as the Aboriginal Lands Trust Act 1966 ( SA ) , which established the South Australian Aboriginal Lands Trust .",15,25,Aboriginal,8,5,13
3XU9MCX6VODXPI3L8I02CM94TFB2R7,"The passing of Aboriginal land rights legislaton in Australia was preceded by a number of important Aboriginal protests , including the 1946 Aboriginal Stockmen 's Strike , the 1963 Yolngu Bark Petition , and the 1966 Wave Hill Walk-Off , as well as the Aboriginal Lands Trust Act 1966 ( SA ) , which established the South Australian Aboriginal Lands Trust .",15,48,Aboriginal land rights legislaton,1,1,2
3XU9MCX6VODXPI3L8I02CM94TFB2R7,"The passing of Aboriginal land rights legislaton in Australia was preceded by a number of important Aboriginal protests , including the 1946 Aboriginal Stockmen 's Strike , the 1963 Yolngu Bark Petition , and the 1966 Wave Hill Walk-Off , as well as the Aboriginal Lands Trust Act 1966 ( SA ) , which established the South Australian Aboriginal Lands Trust .",26,48,land rights legislaton,1,0,1
3XU9MCX6VODXPI3L8I02CM94TFB2R7,"The passing of Aboriginal land rights legislaton in Australia was preceded by a number of important Aboriginal protests , including the 1946 Aboriginal Stockmen 's Strike , the 1963 Yolngu Bark Petition , and the 1966 Wave Hill Walk-Off , as well as the Aboriginal Lands Trust Act 1966 ( SA ) , which established the South Australian Aboriginal Lands Trust .",38,48,legislaton,10,5,15
3XU9MCX6VODXPI3L8I02CM94TFB2R7,"The passing of Aboriginal land rights legislaton in Australia was preceded by a number of important Aboriginal protests , including the 1946 Aboriginal Stockmen 's Strike , the 1963 Yolngu Bark Petition , and the 1966 Wave Hill Walk-Off , as well as the Aboriginal Lands Trust Act 1966 ( SA ) , which established the South Australian Aboriginal Lands Trust .",66,74,preceded,8,8,16
3XU9MCX6VODXPI3L8I02CM94TFB2R7,"The passing of Aboriginal land rights legislaton in Australia was preceded by a number of important Aboriginal protests , including the 1946 Aboriginal Stockmen 's Strike , the 1963 Yolngu Bark Petition , and the 1966 Wave Hill Walk-Off , as well as the Aboriginal Lands Trust Act 1966 ( SA ) , which established the South Australian Aboriginal Lands Trust .",100,110,Aboriginal,2,1,3
3XU9MCX6VODXPI3L8I02CM94TFB2R7,"The passing of Aboriginal land rights legislaton in Australia was preceded by a number of important Aboriginal protests , including the 1946 Aboriginal Stockmen 's Strike , the 1963 Yolngu Bark Petition , and the 1966 Wave Hill Walk-Off , as well as the Aboriginal Lands Trust Act 1966 ( SA ) , which established the South Australian Aboriginal Lands Trust .",100,119,Aboriginal protests,1,1,2
3XU9MCX6VODXPI3L8I02CM94TFB2R7,"The passing of Aboriginal land rights legislaton in Australia was preceded by a number of important Aboriginal protests , including the 1946 Aboriginal Stockmen 's Strike , the 1963 Yolngu Bark Petition , and the 1966 Wave Hill Walk-Off , as well as the Aboriginal Lands Trust Act 1966 ( SA ) , which established the South Australian Aboriginal Lands Trust .",141,169,Aboriginal Stockmen s Strike,1,0,1
3XU9MCX6VODXPI3L8I02CM94TFB2R7,"The passing of Aboriginal land rights legislaton in Australia was preceded by a number of important Aboriginal protests , including the 1946 Aboriginal Stockmen 's Strike , the 1963 Yolngu Bark Petition , and the 1966 Wave Hill Walk-Off , as well as the Aboriginal Lands Trust Act 1966 ( SA ) , which established the South Australian Aboriginal Lands Trust .",152,160,Stockmen,1,1,2
3XU9MCX6VODXPI3L8I02CM94TFB2R7,"The passing of Aboriginal land rights legislaton in Australia was preceded by a number of important Aboriginal protests , including the 1946 Aboriginal Stockmen 's Strike , the 1963 Yolngu Bark Petition , and the 1966 Wave Hill Walk-Off , as well as the Aboriginal Lands Trust Act 1966 ( SA ) , which established the South Australian Aboriginal Lands Trust .",152,169,Stockmen s Strike,0,1,1
3XU9MCX6VODXPI3L8I02CM94TFB2R7,"The passing of Aboriginal land rights legislaton in Australia was preceded by a number of important Aboriginal protests , including the 1946 Aboriginal Stockmen 's Strike , the 1963 Yolngu Bark Petition , and the 1966 Wave Hill Walk-Off , as well as the Aboriginal Lands Trust Act 1966 ( SA ) , which established the South Australian Aboriginal Lands Trust .",164,170,Strike,0,1,1
3XU9MCX6VODXPI3L8I02CM94TFB2R7,"The passing of Aboriginal land rights legislaton in Australia was preceded by a number of important Aboriginal protests , including the 1946 Aboriginal Stockmen 's Strike , the 1963 Yolngu Bark Petition , and the 1966 Wave Hill Walk-Off , as well as the Aboriginal Lands Trust Act 1966 ( SA ) , which established the South Australian Aboriginal Lands Trust .",182,188,Yolngu,1,0,1
3XU9MCX6VODXPI3L8I02CM94TFB2R7,"The passing of Aboriginal land rights legislaton in Australia was preceded by a number of important Aboriginal protests , including the 1946 Aboriginal Stockmen 's Strike , the 1963 Yolngu Bark Petition , and the 1966 Wave Hill Walk-Off , as well as the Aboriginal Lands Trust Act 1966 ( SA ) , which established the South Australian Aboriginal Lands Trust .",182,202,Yolngu Bark Petition,1,0,1
3XU9MCX6VODXPI3L8I02CM94TFB2R7,"The passing of Aboriginal land rights legislaton in Australia was preceded by a number of important Aboriginal protests , including the 1946 Aboriginal Stockmen 's Strike , the 1963 Yolngu Bark Petition , and the 1966 Wave Hill Walk-Off , as well as the Aboriginal Lands Trust Act 1966 ( SA ) , which established the South Australian Aboriginal Lands Trust .",194,202,Petition,2,1,3
3XU9MCX6VODXPI3L8I02CM94TFB2R7,"The passing of Aboriginal land rights legislaton in Australia was preceded by a number of important Aboriginal protests , including the 1946 Aboriginal Stockmen 's Strike , the 1963 Yolngu Bark Petition , and the 1966 Wave Hill Walk-Off , as well as the Aboriginal Lands Trust Act 1966 ( SA ) , which established the South Australian Aboriginal Lands Trust .",218,237,Wave Hill Walk-Off ,1,0,1
3XU9MCX6VODXPI3L8I02CM94TFB2R7,"The passing of Aboriginal land rights legislaton in Australia was preceded by a number of important Aboriginal protests , including the 1946 Aboriginal Stockmen 's Strike , the 1963 Yolngu Bark Petition , and the 1966 Wave Hill Walk-Off , as well as the Aboriginal Lands Trust Act 1966 ( SA ) , which established the South Australian Aboriginal Lands Trust .",228,236,Walk-Off,0,3,3
3XU9MCX6VODXPI3L8I02CM94TFB2R7,"The passing of Aboriginal land rights legislaton in Australia was preceded by a number of important Aboriginal protests , including the 1946 Aboriginal Stockmen 's Strike , the 1963 Yolngu Bark Petition , and the 1966 Wave Hill Walk-Off , as well as the Aboriginal Lands Trust Act 1966 ( SA ) , which established the South Australian Aboriginal Lands Trust .",254,280,Aboriginal Lands Trust Act,1,0,1
3XU9MCX6VODXPI3L8I02CM94TFB2R7,"The passing of Aboriginal land rights legislaton in Australia was preceded by a number of important Aboriginal protests , including the 1946 Aboriginal Stockmen 's Strike , the 1963 Yolngu Bark Petition , and the 1966 Wave Hill Walk-Off , as well as the Aboriginal Lands Trust Act 1966 ( SA ) , which established the South Australian Aboriginal Lands Trust .",271,276,Trust,0,1,1
3XU9MCX6VODXPI3L8I02CM94TFB2R7,"The passing of Aboriginal land rights legislaton in Australia was preceded by a number of important Aboriginal protests , including the 1946 Aboriginal Stockmen 's Strike , the 1963 Yolngu Bark Petition , and the 1966 Wave Hill Walk-Off , as well as the Aboriginal Lands Trust Act 1966 ( SA ) , which established the South Australian Aboriginal Lands Trust .",301,312,established,5,3,8
3XU9MCX6VODXPI3L8I02CM94TFB2R7,"However , it was not until the 1970s , when indigenous Australians ( both Australian Aborigines and Torres Strait Islanders ) became more politically active , that there emerged powerful movement for the recognition of Aboriginal land rights .",44,54,indigenous,9,8,17
3XU9MCX6VODXPI3L8I02CM94TFB2R7,"However , it was not until the 1970s , when indigenous Australians ( both Australian Aborigines and Torres Strait Islanders ) became more politically active , that there emerged powerful movement for the recognition of Aboriginal land rights .",44,66,indigenous Australians,3,0,3
3XU9MCX6VODXPI3L8I02CM94TFB2R7,"However , it was not until the 1970s , when indigenous Australians ( both Australian Aborigines and Torres Strait Islanders ) became more politically active , that there emerged powerful movement for the recognition of Aboriginal land rights .",74,95,Australian Aborigines,1,0,1
3XU9MCX6VODXPI3L8I02CM94TFB2R7,"However , it was not until the 1970s , when indigenous Australians ( both Australian Aborigines and Torres Strait Islanders ) became more politically active , that there emerged powerful movement for the recognition of Aboriginal land rights .",74,123,Australian Aborigines and Torres Strait Islanders,1,0,1
3XU9MCX6VODXPI3L8I02CM94TFB2R7,"However , it was not until the 1970s , when indigenous Australians ( both Australian Aborigines and Torres Strait Islanders ) became more politically active , that there emerged powerful movement for the recognition of Aboriginal land rights .",100,113,Torres Strait,1,0,1
3XU9MCX6VODXPI3L8I02CM94TFB2R7,"However , it was not until the 1970s , when indigenous Australians ( both Australian Aborigines and Torres Strait Islanders ) became more politically active , that there emerged powerful movement for the recognition of Aboriginal land rights .",107,113,Strait,1,1,2
3XU9MCX6VODXPI3L8I02CM94TFB2R7,"However , it was not until the 1970s , when indigenous Australians ( both Australian Aborigines and Torres Strait Islanders ) became more politically active , that there emerged powerful movement for the recognition of Aboriginal land rights .",114,123,Islanders,0,1,1
3XU9MCX6VODXPI3L8I02CM94TFB2R7,"However , it was not until the 1970s , when indigenous Australians ( both Australian Aborigines and Torres Strait Islanders ) became more politically active , that there emerged powerful movement for the recognition of Aboriginal land rights .",138,149,politically,1,0,1
3XU9MCX6VODXPI3L8I02CM94TFB2R7,"However , it was not until the 1970s , when indigenous Australians ( both Australian Aborigines and Torres Strait Islanders ) became more politically active , that there emerged powerful movement for the recognition of Aboriginal land rights .",170,177,emerged,6,4,10
3XU9MCX6VODXPI3L8I02CM94TFB2R7,"However , it was not until the 1970s , when indigenous Australians ( both Australian Aborigines and Torres Strait Islanders ) became more politically active , that there emerged powerful movement for the recognition of Aboriginal land rights .",187,195,movement,0,1,1
3XU9MCX6VODXPI3L8I02CM94TFB2R7,"However , it was not until the 1970s , when indigenous Australians ( both Australian Aborigines and Torres Strait Islanders ) became more politically active , that there emerged powerful movement for the recognition of Aboriginal land rights .",204,215,recognition,4,3,7
3XU9MCX6VODXPI3L8I02CM94TFB2R7,"However , it was not until the 1970s , when indigenous Australians ( both Australian Aborigines and Torres Strait Islanders ) became more politically active , that there emerged powerful movement for the recognition of Aboriginal land rights .",219,229,Aboriginal,1,1,2
3XU9MCX6VODXPI3L8I02CM94TFB2R7,"However , it was not until the 1970s , when indigenous Australians ( both Australian Aborigines and Torres Strait Islanders ) became more politically active , that there emerged powerful movement for the recognition of Aboriginal land rights .",219,241,Aboriginal land rights,0,1,1
3Y7LTZE0YTNFBLYE1J4L486VLNEUZB,Her novel The Good Earth was the best-selling fiction book in the U.S. in 1931 and 1932 and won the Pulitzer Prize in 1932 .,4,9,novel,1,1,2
3Y7LTZE0YTNFBLYE1J4L486VLNEUZB,Her novel The Good Earth was the best-selling fiction book in the U.S. in 1931 and 1932 and won the Pulitzer Prize in 1932 .,33,45,best-selling,2,3,5
3Y7LTZE0YTNFBLYE1J4L486VLNEUZB,Her novel The Good Earth was the best-selling fiction book in the U.S. in 1931 and 1932 and won the Pulitzer Prize in 1932 .,46,53,fiction,6,5,11
3Y7LTZE0YTNFBLYE1J4L486VLNEUZB,Her novel The Good Earth was the best-selling fiction book in the U.S. in 1931 and 1932 and won the Pulitzer Prize in 1932 .,100,108,Pulitzer,0,1,1
3Y7LTZE0YTNFBLYE1J4L486VLNEUZB,Her novel The Good Earth was the best-selling fiction book in the U.S. in 1931 and 1932 and won the Pulitzer Prize in 1932 .,100,114,Pulitzer Prize,1,0,1
3Y7LTZE0YTNFBLYE1J4L486VLNEUZB,"In 1921 , Buck 's mother died of a tropical disease , sprue , and shortly afterward her father moved in .",35,43,tropical,8,6,14
3Y7LTZE0YTNFBLYE1J4L486VLNEUZB,"In 1921 , Buck 's mother died of a tropical disease , sprue , and shortly afterward her father moved in .",35,51,tropical disease,1,1,2
3Y7LTZE0YTNFBLYE1J4L486VLNEUZB,"In 1921 , Buck 's mother died of a tropical disease , sprue , and shortly afterward her father moved in .",44,51,disease,2,1,3
3Y7LTZE0YTNFBLYE1J4L486VLNEUZB,"In 1921 , Buck 's mother died of a tropical disease , sprue , and shortly afterward her father moved in .",54,59,sprue,7,4,11
3Y7LTZE0YTNFBLYE1J4L486VLNEUZB,"In 1921 , Buck 's mother died of a tropical disease , sprue , and shortly afterward her father moved in .",74,83,afterward,1,3,4
3Y7LTZE0YTNFBLYE1J4L486VLNEUZB,"From 1920 to 1933 , the Bucks made their home in Nanjing , on the campus of the University of Nanking , where both had teaching positions .",66,72,campus,4,1,5
3Y7LTZE0YTNFBLYE1J4L486VLNEUZB,"From 1920 to 1933 , the Bucks made their home in Nanjing , on the campus of the University of Nanking , where both had teaching positions .",128,137,positions,2,0,2
3Y7LTZE0YTNFBLYE1J4L486VLNEUZB,"In 1964 , to support children who were not eligible for adoption , Buck established the Pearl S. Buck Foundation ( now called Pearl S. Buck International ) to `` address poverty and discrimination faced by children in Asian countries . ''",43,51,eligible,6,1,7
3Y7LTZE0YTNFBLYE1J4L486VLNEUZB,"In 1964 , to support children who were not eligible for adoption , Buck established the Pearl S. Buck Foundation ( now called Pearl S. Buck International ) to `` address poverty and discrimination faced by children in Asian countries . ''",56,64,adoption,4,6,10
3Y7LTZE0YTNFBLYE1J4L486VLNEUZB,"In 1964 , to support children who were not eligible for adoption , Buck established the Pearl S. Buck Foundation ( now called Pearl S. Buck International ) to `` address poverty and discrimination faced by children in Asian countries . ''",72,83,established,4,1,5
3Y7LTZE0YTNFBLYE1J4L486VLNEUZB,"In 1964 , to support children who were not eligible for adoption , Buck established the Pearl S. Buck Foundation ( now called Pearl S. Buck International ) to `` address poverty and discrimination faced by children in Asian countries . ''",102,112,Foundation,2,0,2
3Y7LTZE0YTNFBLYE1J4L486VLNEUZB,"In 1964 , to support children who were not eligible for adoption , Buck established the Pearl S. Buck Foundation ( now called Pearl S. Buck International ) to `` address poverty and discrimination faced by children in Asian countries . ''",162,169,address,0,2,2
3Y7LTZE0YTNFBLYE1J4L486VLNEUZB,"In 1964 , to support children who were not eligible for adoption , Buck established the Pearl S. Buck Foundation ( now called Pearl S. Buck International ) to `` address poverty and discrimination faced by children in Asian countries . ''",170,177,poverty,7,2,9
3Y7LTZE0YTNFBLYE1J4L486VLNEUZB,"In 1964 , to support children who were not eligible for adoption , Buck established the Pearl S. Buck Foundation ( now called Pearl S. Buck International ) to `` address poverty and discrimination faced by children in Asian countries . ''",182,196,discrimination,10,9,19
3Y7LTZE0YTNFBLYE1J4L486VLNEUZB,"She wrote on a diverse variety of topics including women 's rights , Asian cultures , immigration , adoption , missionary work , and war .",15,22,diverse,5,5,10
3Y7LTZE0YTNFBLYE1J4L486VLNEUZB,"She wrote on a diverse variety of topics including women 's rights , Asian cultures , immigration , adoption , missionary work , and war .",15,30,diverse variety,1,0,1
3Y7LTZE0YTNFBLYE1J4L486VLNEUZB,"She wrote on a diverse variety of topics including women 's rights , Asian cultures , immigration , adoption , missionary work , and war .",23,30,variety,0,1,1
3Y7LTZE0YTNFBLYE1J4L486VLNEUZB,"She wrote on a diverse variety of topics including women 's rights , Asian cultures , immigration , adoption , missionary work , and war .",75,83,cultures,1,0,1
3Y7LTZE0YTNFBLYE1J4L486VLNEUZB,"She wrote on a diverse variety of topics including women 's rights , Asian cultures , immigration , adoption , missionary work , and war .",86,97,immigration,6,7,13
3Y7LTZE0YTNFBLYE1J4L486VLNEUZB,"She wrote on a diverse variety of topics including women 's rights , Asian cultures , immigration , adoption , missionary work , and war .",100,108,adoption,3,1,4
3Y7LTZE0YTNFBLYE1J4L486VLNEUZB,"She wrote on a diverse variety of topics including women 's rights , Asian cultures , immigration , adoption , missionary work , and war .",111,121,missionary,8,3,11
3Y7LTZE0YTNFBLYE1J4L486VLNEUZB,"She wrote on a diverse variety of topics including women 's rights , Asian cultures , immigration , adoption , missionary work , and war .",111,126,missionary work,4,2,6
3VJ4PFXFJ38EADQ6PROMNFFMC27AUQ,"Another Baroque piece that stands is the Chapel of Nuestra Señora del Rosario , which is a recognizable feature of the architecture of Quito .",8,15,Baroque,7,5,12
3VJ4PFXFJ38EADQ6PROMNFFMC27AUQ,"Another Baroque piece that stands is the Chapel of Nuestra Señora del Rosario , which is a recognizable feature of the architecture of Quito .",8,21,Baroque piece,1,0,1
3VJ4PFXFJ38EADQ6PROMNFFMC27AUQ,"Another Baroque piece that stands is the Chapel of Nuestra Señora del Rosario , which is a recognizable feature of the architecture of Quito .",22,33,that stands,0,1,1
3VJ4PFXFJ38EADQ6PROMNFFMC27AUQ,"Another Baroque piece that stands is the Chapel of Nuestra Señora del Rosario , which is a recognizable feature of the architecture of Quito .",41,47,Chapel,0,2,2
3VJ4PFXFJ38EADQ6PROMNFFMC27AUQ,"Another Baroque piece that stands is the Chapel of Nuestra Señora del Rosario , which is a recognizable feature of the architecture of Quito .",41,77,Chapel of Nuestra Señora del Rosario,1,0,1
3VJ4PFXFJ38EADQ6PROMNFFMC27AUQ,"Another Baroque piece that stands is the Chapel of Nuestra Señora del Rosario , which is a recognizable feature of the architecture of Quito .",51,77,Nuestra Señora del Rosario,2,0,2
3VJ4PFXFJ38EADQ6PROMNFFMC27AUQ,"Another Baroque piece that stands is the Chapel of Nuestra Señora del Rosario , which is a recognizable feature of the architecture of Quito .",91,103,recognizable,8,6,14
3VJ4PFXFJ38EADQ6PROMNFFMC27AUQ,"Another Baroque piece that stands is the Chapel of Nuestra Señora del Rosario , which is a recognizable feature of the architecture of Quito .",91,111,recognizable feature,2,0,2
3VJ4PFXFJ38EADQ6PROMNFFMC27AUQ,"Another Baroque piece that stands is the Chapel of Nuestra Señora del Rosario , which is a recognizable feature of the architecture of Quito .",104,111,feature,1,1,2
3VJ4PFXFJ38EADQ6PROMNFFMC27AUQ,"Another Baroque piece that stands is the Chapel of Nuestra Señora del Rosario , which is a recognizable feature of the architecture of Quito .",119,131,architecture,8,3,11
3VJ4PFXFJ38EADQ6PROMNFFMC27AUQ,"Another Baroque piece that stands is the Chapel of Nuestra Señora del Rosario , which is a recognizable feature of the architecture of Quito .",135,140,Quito,2,0,2
3VJ4PFXFJ38EADQ6PROMNFFMC27AUQ,"El Panecillo is a hill located in the middle west of the city at an altitude of about 3,016 metres ( 9,895 ft ) above sea level .",3,12,Panecillo,1,1,2
3VJ4PFXFJ38EADQ6PROMNFFMC27AUQ,"El Panecillo is a hill located in the middle west of the city at an altitude of about 3,016 metres ( 9,895 ft ) above sea level .",18,22,hill,0,1,1
3VJ4PFXFJ38EADQ6PROMNFFMC27AUQ,"El Panecillo is a hill located in the middle west of the city at an altitude of about 3,016 metres ( 9,895 ft ) above sea level .",68,76,altitude,9,3,12
3VJ4PFXFJ38EADQ6PROMNFFMC27AUQ,"El Panecillo is a hill located in the middle west of the city at an altitude of about 3,016 metres ( 9,895 ft ) above sea level .",118,127,sea level,1,0,1
3VJ4PFXFJ38EADQ6PROMNFFMC27AUQ,"Axis is the nerve of the public space known as Independence Square or Plaza Grande ( colonial name ) , around which were built in addition the Archbishop 's Palace , the Municipal Palace , the Hotel Plaza Grande and the Metropolitan Cathedral .",0,4,Axis,1,2,3
3VJ4PFXFJ38EADQ6PROMNFFMC27AUQ,"Axis is the nerve of the public space known as Independence Square or Plaza Grande ( colonial name ) , around which were built in addition the Archbishop 's Palace , the Municipal Palace , the Hotel Plaza Grande and the Metropolitan Cathedral .",12,17,nerve,3,3,6
3VJ4PFXFJ38EADQ6PROMNFFMC27AUQ,"Axis is the nerve of the public space known as Independence Square or Plaza Grande ( colonial name ) , around which were built in addition the Archbishop 's Palace , the Municipal Palace , the Hotel Plaza Grande and the Metropolitan Cathedral .",47,59,Independence,1,2,3
3VJ4PFXFJ38EADQ6PROMNFFMC27AUQ,"Axis is the nerve of the public space known as Independence Square or Plaza Grande ( colonial name ) , around which were built in addition the Archbishop 's Palace , the Municipal Palace , the Hotel Plaza Grande and the Metropolitan Cathedral .",85,93,colonial,2,3,5
3VJ4PFXFJ38EADQ6PROMNFFMC27AUQ,"Axis is the nerve of the public space known as Independence Square or Plaza Grande ( colonial name ) , around which were built in addition the Archbishop 's Palace , the Municipal Palace , the Hotel Plaza Grande and the Metropolitan Cathedral .",121,126,built,0,1,1
3VJ4PFXFJ38EADQ6PROMNFFMC27AUQ,"Axis is the nerve of the public space known as Independence Square or Plaza Grande ( colonial name ) , around which were built in addition the Archbishop 's Palace , the Municipal Palace , the Hotel Plaza Grande and the Metropolitan Cathedral .",130,138,addition,1,0,1
3VJ4PFXFJ38EADQ6PROMNFFMC27AUQ,"Axis is the nerve of the public space known as Independence Square or Plaza Grande ( colonial name ) , around which were built in addition the Archbishop 's Palace , the Municipal Palace , the Hotel Plaza Grande and the Metropolitan Cathedral .",143,153,Archbishop,6,0,6
3VJ4PFXFJ38EADQ6PROMNFFMC27AUQ,"Axis is the nerve of the public space known as Independence Square or Plaza Grande ( colonial name ) , around which were built in addition the Archbishop 's Palace , the Municipal Palace , the Hotel Plaza Grande and the Metropolitan Cathedral .",170,179,Municipal,5,0,5
3VJ4PFXFJ38EADQ6PROMNFFMC27AUQ,"Axis is the nerve of the public space known as Independence Square or Plaza Grande ( colonial name ) , around which were built in addition the Archbishop 's Palace , the Municipal Palace , the Hotel Plaza Grande and the Metropolitan Cathedral .",220,232,Metropolitan,2,0,2
3VJ4PFXFJ38EADQ6PROMNFFMC27AUQ,"Axis is the nerve of the public space known as Independence Square or Plaza Grande ( colonial name ) , around which were built in addition the Archbishop 's Palace , the Municipal Palace , the Hotel Plaza Grande and the Metropolitan Cathedral .",220,242,Metropolitan Cathedral,3,0,3
3VJ4PFXFJ38EADQ6PROMNFFMC27AUQ,"Axis is the nerve of the public space known as Independence Square or Plaza Grande ( colonial name ) , around which were built in addition the Archbishop 's Palace , the Municipal Palace , the Hotel Plaza Grande and the Metropolitan Cathedral .",233,242,Cathedral,0,1,1
3VJ4PFXFJ38EADQ6PROMNFFMC27AUQ,A monument to the Virgin Mary is located on top of El Panecillo and is visible from most of the city of Quito .,2,10,monument,6,4,10
3VJ4PFXFJ38EADQ6PROMNFFMC27AUQ,A monument to the Virgin Mary is located on top of El Panecillo and is visible from most of the city of Quito .,18,29,Virgin Mary,1,0,1
3VJ4PFXFJ38EADQ6PROMNFFMC27AUQ,A monument to the Virgin Mary is located on top of El Panecillo and is visible from most of the city of Quito .,54,63,Panecillo,1,0,1
3VJ4PFXFJ38EADQ6PROMNFFMC27AUQ,A monument to the Virgin Mary is located on top of El Panecillo and is visible from most of the city of Quito .,71,78,visible,2,1,3
3VJ4PFXFJ38EADQ6PROMNFFMC27AUQ,A monument to the Virgin Mary is located on top of El Panecillo and is visible from most of the city of Quito .,104,109,Quito,0,1,1
3VJ4PFXFJ38EADQ6PROMNFFMC27AUQ,"To this end , areas were organized to locate objects within their cultural contexts , to make them accessible to the world , which used several rooms and spaces within the palace .",0,11,To this end,1,0,1
3VJ4PFXFJ38EADQ6PROMNFFMC27AUQ,"To this end , areas were organized to locate objects within their cultural contexts , to make them accessible to the world , which used several rooms and spaces within the palace .",25,34,organized,5,1,6
3VJ4PFXFJ38EADQ6PROMNFFMC27AUQ,"To this end , areas were organized to locate objects within their cultural contexts , to make them accessible to the world , which used several rooms and spaces within the palace .",66,74,cultural,2,0,2
3VJ4PFXFJ38EADQ6PROMNFFMC27AUQ,"To this end , areas were organized to locate objects within their cultural contexts , to make them accessible to the world , which used several rooms and spaces within the palace .",66,83,cultural contexts,3,3,6
3VJ4PFXFJ38EADQ6PROMNFFMC27AUQ,"To this end , areas were organized to locate objects within their cultural contexts , to make them accessible to the world , which used several rooms and spaces within the palace .",75,83,contexts,2,4,6
3VJ4PFXFJ38EADQ6PROMNFFMC27AUQ,"To this end , areas were organized to locate objects within their cultural contexts , to make them accessible to the world , which used several rooms and spaces within the palace .",99,109,accessible,9,5,14
3HYV4299H0XJ2T052TP3N6NO0QD8E3,"Beethoven 's Symphony No. 7 , Bruckner 's Symphony No. 6 and Mendelssohn 's Symphony No. 4 comprise a nearly complete list of symphonies in this key in the Romantic era .",0,9,Beethoven,0,1,1
3HYV4299H0XJ2T052TP3N6NO0QD8E3,"Beethoven 's Symphony No. 7 , Bruckner 's Symphony No. 6 and Mendelssohn 's Symphony No. 4 comprise a nearly complete list of symphonies in this key in the Romantic era .",13,21,Symphony,8,5,13
3HYV4299H0XJ2T052TP3N6NO0QD8E3,"Beethoven 's Symphony No. 7 , Bruckner 's Symphony No. 6 and Mendelssohn 's Symphony No. 4 comprise a nearly complete list of symphonies in this key in the Romantic era .",42,50,Symphony,0,2,2
3HYV4299H0XJ2T052TP3N6NO0QD8E3,"Beethoven 's Symphony No. 7 , Bruckner 's Symphony No. 6 and Mendelssohn 's Symphony No. 4 comprise a nearly complete list of symphonies in this key in the Romantic era .",76,84,Symphony,1,0,1
3HYV4299H0XJ2T052TP3N6NO0QD8E3,"Beethoven 's Symphony No. 7 , Bruckner 's Symphony No. 6 and Mendelssohn 's Symphony No. 4 comprise a nearly complete list of symphonies in this key in the Romantic era .",91,99,comprise,8,4,12
3HYV4299H0XJ2T052TP3N6NO0QD8E3,"Beethoven 's Symphony No. 7 , Bruckner 's Symphony No. 6 and Mendelssohn 's Symphony No. 4 comprise a nearly complete list of symphonies in this key in the Romantic era .",102,108,nearly,0,2,2
3HYV4299H0XJ2T052TP3N6NO0QD8E3,"Beethoven 's Symphony No. 7 , Bruckner 's Symphony No. 6 and Mendelssohn 's Symphony No. 4 comprise a nearly complete list of symphonies in this key in the Romantic era .",126,136,symphonies,6,2,8
3HYV4299H0XJ2T052TP3N6NO0QD8E3,"Beethoven 's Symphony No. 7 , Bruckner 's Symphony No. 6 and Mendelssohn 's Symphony No. 4 comprise a nearly complete list of symphonies in this key in the Romantic era .",145,148,key,2,0,2
3HYV4299H0XJ2T052TP3N6NO0QD8E3,"Beethoven 's Symphony No. 7 , Bruckner 's Symphony No. 6 and Mendelssohn 's Symphony No. 4 comprise a nearly complete list of symphonies in this key in the Romantic era .",156,164,Romantic,2,0,2
3HYV4299H0XJ2T052TP3N6NO0QD8E3,"Beethoven 's Symphony No. 7 , Bruckner 's Symphony No. 6 and Mendelssohn 's Symphony No. 4 comprise a nearly complete list of symphonies in this key in the Romantic era .",156,168,Romantic era,2,1,3
3HYV4299H0XJ2T052TP3N6NO0QD8E3,"Mozart 's Clarinet Concerto and Clarinet Quintet are both in A major , and generally Mozart was more likely to use clarinets in A major than in any other key besides E-flat major .",0,6,Mozart,1,0,1
3HYV4299H0XJ2T052TP3N6NO0QD8E3,"Mozart 's Clarinet Concerto and Clarinet Quintet are both in A major , and generally Mozart was more likely to use clarinets in A major than in any other key besides E-flat major .",10,18,Clarinet,1,2,3
3HYV4299H0XJ2T052TP3N6NO0QD8E3,"Mozart 's Clarinet Concerto and Clarinet Quintet are both in A major , and generally Mozart was more likely to use clarinets in A major than in any other key besides E-flat major .",10,48,Clarinet Concerto and Clarinet Quintet,1,0,1
3HYV4299H0XJ2T052TP3N6NO0QD8E3,"Mozart 's Clarinet Concerto and Clarinet Quintet are both in A major , and generally Mozart was more likely to use clarinets in A major than in any other key besides E-flat major .",19,27,Concerto,4,0,4
3HYV4299H0XJ2T052TP3N6NO0QD8E3,"Mozart 's Clarinet Concerto and Clarinet Quintet are both in A major , and generally Mozart was more likely to use clarinets in A major than in any other key besides E-flat major .",41,48,Quintet,4,1,5
3HYV4299H0XJ2T052TP3N6NO0QD8E3,"Mozart 's Clarinet Concerto and Clarinet Quintet are both in A major , and generally Mozart was more likely to use clarinets in A major than in any other key besides E-flat major .",63,68,major,1,0,1
3HYV4299H0XJ2T052TP3N6NO0QD8E3,"Mozart 's Clarinet Concerto and Clarinet Quintet are both in A major , and generally Mozart was more likely to use clarinets in A major than in any other key besides E-flat major .",85,91,Mozart,1,0,1
3HYV4299H0XJ2T052TP3N6NO0QD8E3,"Mozart 's Clarinet Concerto and Clarinet Quintet are both in A major , and generally Mozart was more likely to use clarinets in A major than in any other key besides E-flat major .",85,100,Mozart was more,0,1,1
3HYV4299H0XJ2T052TP3N6NO0QD8E3,"Mozart 's Clarinet Concerto and Clarinet Quintet are both in A major , and generally Mozart was more likely to use clarinets in A major than in any other key besides E-flat major .",115,124,clarinets,5,4,9
3HYV4299H0XJ2T052TP3N6NO0QD8E3,"Mozart 's Clarinet Concerto and Clarinet Quintet are both in A major , and generally Mozart was more likely to use clarinets in A major than in any other key besides E-flat major .",166,178,E-flat major,1,1,2
3HYV4299H0XJ2T052TP3N6NO0QD8E3,"Johannes Brahms , César Franck , and Gabriel Fauré wrote violin sonatas in A major .",9,15,Brahms,1,0,1
3HYV4299H0XJ2T052TP3N6NO0QD8E3,"Johannes Brahms , César Franck , and Gabriel Fauré wrote violin sonatas in A major .",45,50,Fauré,1,0,1
3HYV4299H0XJ2T052TP3N6NO0QD8E3,"Johannes Brahms , César Franck , and Gabriel Fauré wrote violin sonatas in A major .",57,63,violin,1,0,1
3HYV4299H0XJ2T052TP3N6NO0QD8E3,"Johannes Brahms , César Franck , and Gabriel Fauré wrote violin sonatas in A major .",57,71,violin sonatas,1,1,2
3HYV4299H0XJ2T052TP3N6NO0QD8E3,"Johannes Brahms , César Franck , and Gabriel Fauré wrote violin sonatas in A major .",64,71,sonatas,10,7,17
3HYV4299H0XJ2T052TP3N6NO0QD8E3,"Johannes Brahms , César Franck , and Gabriel Fauré wrote violin sonatas in A major .",75,82,A major,0,1,1
3HYV4299H0XJ2T052TP3N6NO0QD8E3,"In connection to Beethoven 's Kreutzer Sonata , Peter Cropper said that A major `` is the fullest sounding key for the violin . ''",3,13,connection,1,0,1
3HYV4299H0XJ2T052TP3N6NO0QD8E3,"In connection to Beethoven 's Kreutzer Sonata , Peter Cropper said that A major `` is the fullest sounding key for the violin . ''",30,38,Kreutzer,1,0,1
3HYV4299H0XJ2T052TP3N6NO0QD8E3,"In connection to Beethoven 's Kreutzer Sonata , Peter Cropper said that A major `` is the fullest sounding key for the violin . ''",54,61,Cropper,0,1,1
3HYV4299H0XJ2T052TP3N6NO0QD8E3,"In connection to Beethoven 's Kreutzer Sonata , Peter Cropper said that A major `` is the fullest sounding key for the violin . ''",74,79,major,0,1,1
3HYV4299H0XJ2T052TP3N6NO0QD8E3,"In connection to Beethoven 's Kreutzer Sonata , Peter Cropper said that A major `` is the fullest sounding key for the violin . ''",90,97,fullest,0,1,1
3HYV4299H0XJ2T052TP3N6NO0QD8E3,"In connection to Beethoven 's Kreutzer Sonata , Peter Cropper said that A major `` is the fullest sounding key for the violin . ''",98,106,sounding,0,1,1
3HYV4299H0XJ2T052TP3N6NO0QD8E3,"In connection to Beethoven 's Kreutzer Sonata , Peter Cropper said that A major `` is the fullest sounding key for the violin . ''",98,110,sounding key,1,1,2
3HYV4299H0XJ2T052TP3N6NO0QD8E3,"In connection to Beethoven 's Kreutzer Sonata , Peter Cropper said that A major `` is the fullest sounding key for the violin . ''",119,125,violin,1,0,1
3HYV4299H0XJ2T052TP3N6NO0QD8E3,"According to Christian Friedrich Daniel Schubart , A major is a key suitable for `` declarations of innocent love , ... hope of seeing one 's beloved again when parting ; youthful cheerfulness and trust in God . ''",23,32,Friedrich,1,0,1
3HYV4299H0XJ2T052TP3N6NO0QD8E3,"According to Christian Friedrich Daniel Schubart , A major is a key suitable for `` declarations of innocent love , ... hope of seeing one 's beloved again when parting ; youthful cheerfulness and trust in God . ''",40,48,Schubart,1,0,1
3HYV4299H0XJ2T052TP3N6NO0QD8E3,"According to Christian Friedrich Daniel Schubart , A major is a key suitable for `` declarations of innocent love , ... hope of seeing one 's beloved again when parting ; youthful cheerfulness and trust in God . ''",53,58,major,1,0,1
3HYV4299H0XJ2T052TP3N6NO0QD8E3,"According to Christian Friedrich Daniel Schubart , A major is a key suitable for `` declarations of innocent love , ... hope of seeing one 's beloved again when parting ; youthful cheerfulness and trust in God . ''",68,76,suitable,5,1,6
3HYV4299H0XJ2T052TP3N6NO0QD8E3,"According to Christian Friedrich Daniel Schubart , A major is a key suitable for `` declarations of innocent love , ... hope of seeing one 's beloved again when parting ; youthful cheerfulness and trust in God . ''",84,96,declarations,8,2,10
3HYV4299H0XJ2T052TP3N6NO0QD8E3,"According to Christian Friedrich Daniel Schubart , A major is a key suitable for `` declarations of innocent love , ... hope of seeing one 's beloved again when parting ; youthful cheerfulness and trust in God . ''",84,113,declarations of innocent love,1,0,1
3HYV4299H0XJ2T052TP3N6NO0QD8E3,"According to Christian Friedrich Daniel Schubart , A major is a key suitable for `` declarations of innocent love , ... hope of seeing one 's beloved again when parting ; youthful cheerfulness and trust in God . ''",100,108,innocent,4,2,6
3HYV4299H0XJ2T052TP3N6NO0QD8E3,"According to Christian Friedrich Daniel Schubart , A major is a key suitable for `` declarations of innocent love , ... hope of seeing one 's beloved again when parting ; youthful cheerfulness and trust in God . ''",142,149,beloved,3,1,4
3HYV4299H0XJ2T052TP3N6NO0QD8E3,"According to Christian Friedrich Daniel Schubart , A major is a key suitable for `` declarations of innocent love , ... hope of seeing one 's beloved again when parting ; youthful cheerfulness and trust in God . ''",171,179,youthful,1,2,3
3HYV4299H0XJ2T052TP3N6NO0QD8E3,"According to Christian Friedrich Daniel Schubart , A major is a key suitable for `` declarations of innocent love , ... hope of seeing one 's beloved again when parting ; youthful cheerfulness and trust in God . ''",171,192,youthful cheerfulness,1,1,2
3HYV4299H0XJ2T052TP3N6NO0QD8E3,"According to Christian Friedrich Daniel Schubart , A major is a key suitable for `` declarations of innocent love , ... hope of seeing one 's beloved again when parting ; youthful cheerfulness and trust in God . ''",180,192,cheerfulness,3,6,9
3HYV4299H0XJ2T052TP3N6NO0QD8E3,"According to Christian Friedrich Daniel Schubart , A major is a key suitable for `` declarations of innocent love , ... hope of seeing one 's beloved again when parting ; youthful cheerfulness and trust in God . ''",197,209,trust in God,1,0,1
3INZSNUD80REOS5FBQKXHK0EKKUD94,"Al - ` Ain is often called the ` Garden City of The Gulf ' given the many oases , parks , tree-lined avenues and decorative roundabouts within the city .",7,10,Ain,2,0,2
3INZSNUD80REOS5FBQKXHK0EKKUD94,"Al - ` Ain is often called the ` Garden City of The Gulf ' given the many oases , parks , tree-lined avenues and decorative roundabouts within the city .",74,79,oases,6,7,13
3INZSNUD80REOS5FBQKXHK0EKKUD94,"Al - ` Ain is often called the ` Garden City of The Gulf ' given the many oases , parks , tree-lined avenues and decorative roundabouts within the city .",90,100,tree-lined,0,2,2
3INZSNUD80REOS5FBQKXHK0EKKUD94,"Al - ` Ain is often called the ` Garden City of The Gulf ' given the many oases , parks , tree-lined avenues and decorative roundabouts within the city .",90,108,tree-lined avenues,1,1,2
3INZSNUD80REOS5FBQKXHK0EKKUD94,"Al - ` Ain is often called the ` Garden City of The Gulf ' given the many oases , parks , tree-lined avenues and decorative roundabouts within the city .",101,108,avenues,3,4,7
3INZSNUD80REOS5FBQKXHK0EKKUD94,"Al - ` Ain is often called the ` Garden City of The Gulf ' given the many oases , parks , tree-lined avenues and decorative roundabouts within the city .",113,123,decorative,3,0,3
3INZSNUD80REOS5FBQKXHK0EKKUD94,"Al - ` Ain is often called the ` Garden City of The Gulf ' given the many oases , parks , tree-lined avenues and decorative roundabouts within the city .",113,135,decorative roundabouts,2,0,2
3INZSNUD80REOS5FBQKXHK0EKKUD94,"Al - ` Ain is often called the ` Garden City of The Gulf ' given the many oases , parks , tree-lined avenues and decorative roundabouts within the city .",124,135,roundabouts,10,10,20
3INZSNUD80REOS5FBQKXHK0EKKUD94,The dry desert air makes it a welcome retreat from the coastal humidity of the larger cities .,4,7,dry,0,1,1
3INZSNUD80REOS5FBQKXHK0EKKUD94,The dry desert air makes it a welcome retreat from the coastal humidity of the larger cities .,8,14,desert,2,0,2
3INZSNUD80REOS5FBQKXHK0EKKUD94,The dry desert air makes it a welcome retreat from the coastal humidity of the larger cities .,38,45,retreat,4,7,11
3INZSNUD80REOS5FBQKXHK0EKKUD94,The dry desert air makes it a welcome retreat from the coastal humidity of the larger cities .,55,62,coastal,1,1,2
3INZSNUD80REOS5FBQKXHK0EKKUD94,The dry desert air makes it a welcome retreat from the coastal humidity of the larger cities .,55,71,coastal humidity,2,1,3
3INZSNUD80REOS5FBQKXHK0EKKUD94,The dry desert air makes it a welcome retreat from the coastal humidity of the larger cities .,63,71,humidity,8,5,13
3INZSNUD80REOS5FBQKXHK0EKKUD94,"Other attractions include the Al Ain Oasis in the city center , other oases dotted around the area - all cool retreats in the middle of the summer heat - Al Ain Zoo , an amusement park named `` Hili Fun City '' , many well-maintained parks popular with families in the summer evenings , and a heritage village .",6,17,attractions,3,1,4
3INZSNUD80REOS5FBQKXHK0EKKUD94,"Other attractions include the Al Ain Oasis in the city center , other oases dotted around the area - all cool retreats in the middle of the summer heat - Al Ain Zoo , an amusement park named `` Hili Fun City '' , many well-maintained parks popular with families in the summer evenings , and a heritage village .",37,42,Oasis,0,1,1
3INZSNUD80REOS5FBQKXHK0EKKUD94,"Other attractions include the Al Ain Oasis in the city center , other oases dotted around the area - all cool retreats in the middle of the summer heat - Al Ain Zoo , an amusement park named `` Hili Fun City '' , many well-maintained parks popular with families in the summer evenings , and a heritage village .",70,75,oases,1,2,3
3INZSNUD80REOS5FBQKXHK0EKKUD94,"Other attractions include the Al Ain Oasis in the city center , other oases dotted around the area - all cool retreats in the middle of the summer heat - Al Ain Zoo , an amusement park named `` Hili Fun City '' , many well-maintained parks popular with families in the summer evenings , and a heritage village .",70,82,oases dotted,0,1,1
3INZSNUD80REOS5FBQKXHK0EKKUD94,"Other attractions include the Al Ain Oasis in the city center , other oases dotted around the area - all cool retreats in the middle of the summer heat - Al Ain Zoo , an amusement park named `` Hili Fun City '' , many well-maintained parks popular with families in the summer evenings , and a heritage village .",76,82,dotted,1,3,4
3INZSNUD80REOS5FBQKXHK0EKKUD94,"Other attractions include the Al Ain Oasis in the city center , other oases dotted around the area - all cool retreats in the middle of the summer heat - Al Ain Zoo , an amusement park named `` Hili Fun City '' , many well-maintained parks popular with families in the summer evenings , and a heritage village .",110,118,retreats,2,2,4
3INZSNUD80REOS5FBQKXHK0EKKUD94,"Other attractions include the Al Ain Oasis in the city center , other oases dotted around the area - all cool retreats in the middle of the summer heat - Al Ain Zoo , an amusement park named `` Hili Fun City '' , many well-maintained parks popular with families in the summer evenings , and a heritage village .",170,179,amusement,4,4,8
3INZSNUD80REOS5FBQKXHK0EKKUD94,"Other attractions include the Al Ain Oasis in the city center , other oases dotted around the area - all cool retreats in the middle of the summer heat - Al Ain Zoo , an amusement park named `` Hili Fun City '' , many well-maintained parks popular with families in the summer evenings , and a heritage village .",170,184,amusement park,1,1,2
3INZSNUD80REOS5FBQKXHK0EKKUD94,"Other attractions include the Al Ain Oasis in the city center , other oases dotted around the area - all cool retreats in the middle of the summer heat - Al Ain Zoo , an amusement park named `` Hili Fun City '' , many well-maintained parks popular with families in the summer evenings , and a heritage village .",218,233,well-maintained,5,1,6
3INZSNUD80REOS5FBQKXHK0EKKUD94,"Other attractions include the Al Ain Oasis in the city center , other oases dotted around the area - all cool retreats in the middle of the summer heat - Al Ain Zoo , an amusement park named `` Hili Fun City '' , many well-maintained parks popular with families in the summer evenings , and a heritage village .",293,301,heritage,9,8,17
3INZSNUD80REOS5FBQKXHK0EKKUD94,"Other attractions include the Al Ain Oasis in the city center , other oases dotted around the area - all cool retreats in the middle of the summer heat - Al Ain Zoo , an amusement park named `` Hili Fun City '' , many well-maintained parks popular with families in the summer evenings , and a heritage village .",293,309,heritage village,1,1,2
3INZSNUD80REOS5FBQKXHK0EKKUD94,"Al Ain ( Arabic : العين , al-ʿayn , literally The Spring ) , also known as the Garden City due to its greenery , is the second largest city in the Emirate of Abu Dhabi and the fourth largest city in the United Arab Emirates .",36,45,literally,1,1,2
3INZSNUD80REOS5FBQKXHK0EKKUD94,"Al Ain ( Arabic : العين , al-ʿayn , literally The Spring ) , also known as the Garden City due to its greenery , is the second largest city in the Emirate of Abu Dhabi and the fourth largest city in the United Arab Emirates .",102,110,greenery,8,8,16
3INZSNUD80REOS5FBQKXHK0EKKUD94,"Al Ain ( Arabic : العين , al-ʿayn , literally The Spring ) , also known as the Garden City due to its greenery , is the second largest city in the Emirate of Abu Dhabi and the fourth largest city in the United Arab Emirates .",147,154,Emirate,1,0,1
3INZSNUD80REOS5FBQKXHK0EKKUD94,"Al Ain ( Arabic : العين , al-ʿayn , literally The Spring ) , also known as the Garden City due to its greenery , is the second largest city in the Emirate of Abu Dhabi and the fourth largest city in the United Arab Emirates .",158,167,Abu Dhabi,1,0,1
3INZSNUD80REOS5FBQKXHK0EKKUD94,"Al Ain ( Arabic : العين , al-ʿayn , literally The Spring ) , also known as the Garden City due to its greenery , is the second largest city in the Emirate of Abu Dhabi and the fourth largest city in the United Arab Emirates .",203,223,United Arab Emirates,1,0,1
3INZSNUD80REOS5FBQKXHK0EKKUD94,"Al Ain ( Arabic : العين , al-ʿayn , literally The Spring ) , also known as the Garden City due to its greenery , is the second largest city in the Emirate of Abu Dhabi and the fourth largest city in the United Arab Emirates .",215,223,Emirates,2,1,3
3PKJ68EHDNXK6KNQJYU0XZTF8HZHJC,"In the time of William Shakespeare , women 's roles were generally played by men or boys .",46,51,roles,1,2,3
3PKJ68EHDNXK6KNQJYU0XZTF8HZHJC,"The stage role of Peter Pan , for example , is traditionally played by a woman , as are most principal boys in British pantomime .",4,9,stage,0,3,3
3PKJ68EHDNXK6KNQJYU0XZTF8HZHJC,"The stage role of Peter Pan , for example , is traditionally played by a woman , as are most principal boys in British pantomime .",47,60,traditionally,3,6,9
3PKJ68EHDNXK6KNQJYU0XZTF8HZHJC,"The stage role of Peter Pan , for example , is traditionally played by a woman , as are most principal boys in British pantomime .",93,102,principal,7,2,9
3PKJ68EHDNXK6KNQJYU0XZTF8HZHJC,"The stage role of Peter Pan , for example , is traditionally played by a woman , as are most principal boys in British pantomime .",93,107,principal boys,0,1,1
3PKJ68EHDNXK6KNQJYU0XZTF8HZHJC,"The stage role of Peter Pan , for example , is traditionally played by a woman , as are most principal boys in British pantomime .",119,128,pantomime,10,10,20
3PKJ68EHDNXK6KNQJYU0XZTF8HZHJC,"Opera has several `` breeches roles '' traditionally sung by women , usually mezzo-sopranos .",0,5,Opera,1,2,3
3PKJ68EHDNXK6KNQJYU0XZTF8HZHJC,"Opera has several `` breeches roles '' traditionally sung by women , usually mezzo-sopranos .",21,29,breeches,3,7,10
3PKJ68EHDNXK6KNQJYU0XZTF8HZHJC,"Opera has several `` breeches roles '' traditionally sung by women , usually mezzo-sopranos .",21,35,breeches roles,5,5,10
3PKJ68EHDNXK6KNQJYU0XZTF8HZHJC,"Opera has several `` breeches roles '' traditionally sung by women , usually mezzo-sopranos .",39,52,traditionally,2,0,2
3PKJ68EHDNXK6KNQJYU0XZTF8HZHJC,"Opera has several `` breeches roles '' traditionally sung by women , usually mezzo-sopranos .",53,57,sung,0,1,1
3PKJ68EHDNXK6KNQJYU0XZTF8HZHJC,"Opera has several `` breeches roles '' traditionally sung by women , usually mezzo-sopranos .",77,91,mezzo-sopranos,10,8,18
3PKJ68EHDNXK6KNQJYU0XZTF8HZHJC,"Examples are Hansel in Hänsel und Gretel , Cherubino in The Marriage of Figaro and Octavian in Der Rosenkavalier .",23,29,Hänsel,2,0,2
3PKJ68EHDNXK6KNQJYU0XZTF8HZHJC,"Examples are Hansel in Hänsel und Gretel , Cherubino in The Marriage of Figaro and Octavian in Der Rosenkavalier .",34,40,Gretel,1,0,1
3PKJ68EHDNXK6KNQJYU0XZTF8HZHJC,"Examples are Hansel in Hänsel und Gretel , Cherubino in The Marriage of Figaro and Octavian in Der Rosenkavalier .",43,52,Cherubino,3,1,4
3PKJ68EHDNXK6KNQJYU0XZTF8HZHJC,"Examples are Hansel in Hänsel und Gretel , Cherubino in The Marriage of Figaro and Octavian in Der Rosenkavalier .",72,78,Figaro,1,0,1
3PKJ68EHDNXK6KNQJYU0XZTF8HZHJC,"Examples are Hansel in Hänsel und Gretel , Cherubino in The Marriage of Figaro and Octavian in Der Rosenkavalier .",83,91,Octavian,1,1,2
3PKJ68EHDNXK6KNQJYU0XZTF8HZHJC,"Examples are Hansel in Hänsel und Gretel , Cherubino in The Marriage of Figaro and Octavian in Der Rosenkavalier .",95,112,Der Rosenkavalier,2,0,2
3PKJ68EHDNXK6KNQJYU0XZTF8HZHJC,"Examples are Hansel in Hänsel und Gretel , Cherubino in The Marriage of Figaro and Octavian in Der Rosenkavalier .",99,112,Rosenkavalier,1,1,2
3PKJ68EHDNXK6KNQJYU0XZTF8HZHJC,"In the former film Linda Hunt played the pivotal role of Billy Kwan , for which she received the Academy Award for Best Supporting Actress .",7,13,former,1,0,1
3PKJ68EHDNXK6KNQJYU0XZTF8HZHJC,"In the former film Linda Hunt played the pivotal role of Billy Kwan , for which she received the Academy Award for Best Supporting Actress .",41,48,pivotal,8,8,16
3PKJ68EHDNXK6KNQJYU0XZTF8HZHJC,"In the former film Linda Hunt played the pivotal role of Billy Kwan , for which she received the Academy Award for Best Supporting Actress .",41,53,pivotal role,0,2,2
3PKJ68EHDNXK6KNQJYU0XZTF8HZHJC,"In the former film Linda Hunt played the pivotal role of Billy Kwan , for which she received the Academy Award for Best Supporting Actress .",97,110,Academy Award,0,1,1
3PKJ68EHDNXK6KNQJYU0XZTF8HZHJC,"In the former film Linda Hunt played the pivotal role of Billy Kwan , for which she received the Academy Award for Best Supporting Actress .",120,130,Supporting,1,2,3
3PKJ68EHDNXK6KNQJYU0XZTF8HZHJC,"In the former film Linda Hunt played the pivotal role of Billy Kwan , for which she received the Academy Award for Best Supporting Actress .",131,138,Actress,0,1,1
3PKJ68EHDNXK6KNQJYU0XZTF8HZHJC,Having an actor dress as the opposite sex for comic effect is also a long-standing tradition in comic theater and film .,29,37,opposite,1,0,1
3PKJ68EHDNXK6KNQJYU0XZTF8HZHJC,Having an actor dress as the opposite sex for comic effect is also a long-standing tradition in comic theater and film .,29,41,opposite sex,2,0,2
3PKJ68EHDNXK6KNQJYU0XZTF8HZHJC,Having an actor dress as the opposite sex for comic effect is also a long-standing tradition in comic theater and film .,69,82,long-standing,2,5,7
3PKJ68EHDNXK6KNQJYU0XZTF8HZHJC,Having an actor dress as the opposite sex for comic effect is also a long-standing tradition in comic theater and film .,69,92,long-standing tradition,1,0,1
3PKJ68EHDNXK6KNQJYU0XZTF8HZHJC,Having an actor dress as the opposite sex for comic effect is also a long-standing tradition in comic theater and film .,83,92,tradition,1,0,1
3PKJ68EHDNXK6KNQJYU0XZTF8HZHJC,Having an actor dress as the opposite sex for comic effect is also a long-standing tradition in comic theater and film .,96,101,comic,1,0,1
3PKJ68EHDNXK6KNQJYU0XZTF8HZHJC,Having an actor dress as the opposite sex for comic effect is also a long-standing tradition in comic theater and film .,96,109,comic theater,0,1,1
3PKJ68EHDNXK6KNQJYU0XZTF8HZHJC,Having an actor dress as the opposite sex for comic effect is also a long-standing tradition in comic theater and film .,102,109,theater,0,2,2
32L724R85LLGOQ18KTH5U7G6HTKPID,"The Russian military is divided into the following branches : the Russian Ground Forces , the Russian Navy , and the Russian Air Force .",12,20,military,0,1,1
32L724R85LLGOQ18KTH5U7G6HTKPID,"The Russian military is divided into the following branches : the Russian Ground Forces , the Russian Navy , and the Russian Air Force .",24,31,divided,1,0,1
32L724R85LLGOQ18KTH5U7G6HTKPID,"The Russian military is divided into the following branches : the Russian Ground Forces , the Russian Navy , and the Russian Air Force .",51,59,branches,3,2,5
32L724R85LLGOQ18KTH5U7G6HTKPID,"As of 2008 ( update ) , some 480,000 young men are brought into the Army via Conscription in Russia in two call-ups each year .",13,19,update,0,2,2
32L724R85LLGOQ18KTH5U7G6HTKPID,"As of 2008 ( update ) , some 480,000 young men are brought into the Army via Conscription in Russia in two call-ups each year .",51,58,brought,1,2,3
32L724R85LLGOQ18KTH5U7G6HTKPID,"As of 2008 ( update ) , some 480,000 young men are brought into the Army via Conscription in Russia in two call-ups each year .",73,76,via,3,0,3
32L724R85LLGOQ18KTH5U7G6HTKPID,"As of 2008 ( update ) , some 480,000 young men are brought into the Army via Conscription in Russia in two call-ups each year .",77,89,Conscription,10,10,20
32L724R85LLGOQ18KTH5U7G6HTKPID,"As of 2008 ( update ) , some 480,000 young men are brought into the Army via Conscription in Russia in two call-ups each year .",107,115,call-ups,6,8,14
32L724R85LLGOQ18KTH5U7G6HTKPID,"It has been founded in 1991 by the Austrian writer , artist and musician Paul Jaeg .",12,19,founded,1,1,2
32L724R85LLGOQ18KTH5U7G6HTKPID,"It has been founded in 1991 by the Austrian writer , artist and musician Paul Jaeg .",35,43,Austrian,1,0,1
32L724R85LLGOQ18KTH5U7G6HTKPID,"Some authors , such as Peter Paul Wiplinger , have already several books with Arovell , but others use the publishing house as a platform to publish their first book ( s ) .",34,43,Wiplinger,1,0,1
32L724R85LLGOQ18KTH5U7G6HTKPID,"Some authors , such as Peter Paul Wiplinger , have already several books with Arovell , but others use the publishing house as a platform to publish their first book ( s ) .",78,85,Arovell,4,0,4
32L724R85LLGOQ18KTH5U7G6HTKPID,"Some authors , such as Peter Paul Wiplinger , have already several books with Arovell , but others use the publishing house as a platform to publish their first book ( s ) .",107,117,publishing,1,1,2
32L724R85LLGOQ18KTH5U7G6HTKPID,"Some authors , such as Peter Paul Wiplinger , have already several books with Arovell , but others use the publishing house as a platform to publish their first book ( s ) .",107,123,publishing house,2,1,3
32L724R85LLGOQ18KTH5U7G6HTKPID,"Some authors , such as Peter Paul Wiplinger , have already several books with Arovell , but others use the publishing house as a platform to publish their first book ( s ) .",129,137,platform,3,6,9
32L724R85LLGOQ18KTH5U7G6HTKPID,The covers of all books edited by Arovell show a painting respectively a section from a painting by Paul Jaeg .,4,10,covers,0,2,2
32L724R85LLGOQ18KTH5U7G6HTKPID,The covers of all books edited by Arovell show a painting respectively a section from a painting by Paul Jaeg .,24,30,edited,1,2,3
32L724R85LLGOQ18KTH5U7G6HTKPID,The covers of all books edited by Arovell show a painting respectively a section from a painting by Paul Jaeg .,34,41,Arovell,1,0,1
32L724R85LLGOQ18KTH5U7G6HTKPID,The covers of all books edited by Arovell show a painting respectively a section from a painting by Paul Jaeg .,58,70,respectively,10,5,15
32L724R85LLGOQ18KTH5U7G6HTKPID,The covers of all books edited by Arovell show a painting respectively a section from a painting by Paul Jaeg .,73,80,section,0,1,1
32L724R85LLGOQ18KTH5U7G6HTKPID,The covers of all books edited by Arovell show a painting respectively a section from a painting by Paul Jaeg .,105,109,Jaeg,1,0,1
32L724R85LLGOQ18KTH5U7G6HTKPID,"In addition , Arovell publishes a magazine about literature , music and art , which contains information about new books and public events .",3,11,addition,0,1,1
32L724R85LLGOQ18KTH5U7G6HTKPID,"In addition , Arovell publishes a magazine about literature , music and art , which contains information about new books and public events .",22,31,publishes,3,0,3
32L724R85LLGOQ18KTH5U7G6HTKPID,"In addition , Arovell publishes a magazine about literature , music and art , which contains information about new books and public events .",34,42,magazine,1,2,3
32L724R85LLGOQ18KTH5U7G6HTKPID,"In addition , Arovell publishes a magazine about literature , music and art , which contains information about new books and public events .",49,59,literature,3,2,5
32L724R85LLGOQ18KTH5U7G6HTKPID,"In addition , Arovell publishes a magazine about literature , music and art , which contains information about new books and public events .",84,92,contains,0,2,2
32L724R85LLGOQ18KTH5U7G6HTKPID,"In addition , Arovell publishes a magazine about literature , music and art , which contains information about new books and public events .",84,104,contains information,0,1,1
32L724R85LLGOQ18KTH5U7G6HTKPID,"In addition , Arovell publishes a magazine about literature , music and art , which contains information about new books and public events .",93,104,information,0,2,2
32L724R85LLGOQ18KTH5U7G6HTKPID,"In addition , Arovell publishes a magazine about literature , music and art , which contains information about new books and public events .",125,138,public events,1,2,3
3XD2A6FGFNVKQHOX8GFMCJMELN4S9D,"In certain organometallic compounds such as ferrocene or dibenzenechromium , the pi orbitals of the organic moiety ligate the metal .",11,25,organometallic,10,9,19
3XD2A6FGFNVKQHOX8GFMCJMELN4S9D,"In certain organometallic compounds such as ferrocene or dibenzenechromium , the pi orbitals of the organic moiety ligate the metal .",11,35,organometallic compounds,2,3,5
3XD2A6FGFNVKQHOX8GFMCJMELN4S9D,"In certain organometallic compounds such as ferrocene or dibenzenechromium , the pi orbitals of the organic moiety ligate the metal .",26,35,compounds,1,0,1
3XD2A6FGFNVKQHOX8GFMCJMELN4S9D,"In certain organometallic compounds such as ferrocene or dibenzenechromium , the pi orbitals of the organic moiety ligate the metal .",44,53,ferrocene,9,5,14
3XD2A6FGFNVKQHOX8GFMCJMELN4S9D,"In certain organometallic compounds such as ferrocene or dibenzenechromium , the pi orbitals of the organic moiety ligate the metal .",57,74,dibenzenechromium,10,6,16
3XD2A6FGFNVKQHOX8GFMCJMELN4S9D,"In certain organometallic compounds such as ferrocene or dibenzenechromium , the pi orbitals of the organic moiety ligate the metal .",81,83,pi,1,1,2
3XD2A6FGFNVKQHOX8GFMCJMELN4S9D,"In certain organometallic compounds such as ferrocene or dibenzenechromium , the pi orbitals of the organic moiety ligate the metal .",81,92,pi orbitals,4,4,8
3XD2A6FGFNVKQHOX8GFMCJMELN4S9D,"In certain organometallic compounds such as ferrocene or dibenzenechromium , the pi orbitals of the organic moiety ligate the metal .",84,92,orbitals,6,1,7
3XD2A6FGFNVKQHOX8GFMCJMELN4S9D,"In certain organometallic compounds such as ferrocene or dibenzenechromium , the pi orbitals of the organic moiety ligate the metal .",100,114,organic moiety,2,0,2
3XD2A6FGFNVKQHOX8GFMCJMELN4S9D,"In certain organometallic compounds such as ferrocene or dibenzenechromium , the pi orbitals of the organic moiety ligate the metal .",100,121,organic moiety ligate,1,0,1
3XD2A6FGFNVKQHOX8GFMCJMELN4S9D,"In certain organometallic compounds such as ferrocene or dibenzenechromium , the pi orbitals of the organic moiety ligate the metal .",108,114,moiety,3,6,9
3XD2A6FGFNVKQHOX8GFMCJMELN4S9D,"In certain organometallic compounds such as ferrocene or dibenzenechromium , the pi orbitals of the organic moiety ligate the metal .",108,121,moiety ligate,2,2,4
3XD2A6FGFNVKQHOX8GFMCJMELN4S9D,"In certain organometallic compounds such as ferrocene or dibenzenechromium , the pi orbitals of the organic moiety ligate the metal .",115,121,ligate,3,6,9
3XD2A6FGFNVKQHOX8GFMCJMELN4S9D,"In contrast to these coordination compounds , methylcobalamin ( a form of Vitamin B12 ) , with a cobalt-methyl bond , is a true organometallic complex , one of the few known in biology .",21,33,coordination,1,3,4
3XD2A6FGFNVKQHOX8GFMCJMELN4S9D,"In contrast to these coordination compounds , methylcobalamin ( a form of Vitamin B12 ) , with a cobalt-methyl bond , is a true organometallic complex , one of the few known in biology .",21,43,coordination compounds,2,0,2
3XD2A6FGFNVKQHOX8GFMCJMELN4S9D,"In contrast to these coordination compounds , methylcobalamin ( a form of Vitamin B12 ) , with a cobalt-methyl bond , is a true organometallic complex , one of the few known in biology .",34,43,compounds,0,1,1
3XD2A6FGFNVKQHOX8GFMCJMELN4S9D,"In contrast to these coordination compounds , methylcobalamin ( a form of Vitamin B12 ) , with a cobalt-methyl bond , is a true organometallic complex , one of the few known in biology .",46,61,methylcobalamin,10,5,15
3XD2A6FGFNVKQHOX8GFMCJMELN4S9D,"In contrast to these coordination compounds , methylcobalamin ( a form of Vitamin B12 ) , with a cobalt-methyl bond , is a true organometallic complex , one of the few known in biology .",97,110,cobalt-methyl,4,1,5
3XD2A6FGFNVKQHOX8GFMCJMELN4S9D,"In contrast to these coordination compounds , methylcobalamin ( a form of Vitamin B12 ) , with a cobalt-methyl bond , is a true organometallic complex , one of the few known in biology .",97,115,cobalt-methyl bond,2,1,3
3XD2A6FGFNVKQHOX8GFMCJMELN4S9D,"In contrast to these coordination compounds , methylcobalamin ( a form of Vitamin B12 ) , with a cobalt-methyl bond , is a true organometallic complex , one of the few known in biology .",128,142,organometallic,3,3,6
3XD2A6FGFNVKQHOX8GFMCJMELN4S9D,"In contrast to these coordination compounds , methylcobalamin ( a form of Vitamin B12 ) , with a cobalt-methyl bond , is a true organometallic complex , one of the few known in biology .",143,150,complex,1,2,3
3XD2A6FGFNVKQHOX8GFMCJMELN4S9D,"In contrast to these coordination compounds , methylcobalamin ( a form of Vitamin B12 ) , with a cobalt-methyl bond , is a true organometallic complex , one of the few known in biology .",177,184,biology,1,0,1
3XD2A6FGFNVKQHOX8GFMCJMELN4S9D,The term `` metalorganics '' usually refers to metal-containing compounds lacking direct metal-carbon bonds but which contain organic ligands .,12,25,metalorganics,6,6,12
3XD2A6FGFNVKQHOX8GFMCJMELN4S9D,The term `` metalorganics '' usually refers to metal-containing compounds lacking direct metal-carbon bonds but which contain organic ligands .,12,26,metalorganics ,1,0,1
3XD2A6FGFNVKQHOX8GFMCJMELN4S9D,The term `` metalorganics '' usually refers to metal-containing compounds lacking direct metal-carbon bonds but which contain organic ligands .,47,63,metal-containing,0,1,1
3XD2A6FGFNVKQHOX8GFMCJMELN4S9D,The term `` metalorganics '' usually refers to metal-containing compounds lacking direct metal-carbon bonds but which contain organic ligands .,47,73,metal-containing compounds,0,1,1
3XD2A6FGFNVKQHOX8GFMCJMELN4S9D,The term `` metalorganics '' usually refers to metal-containing compounds lacking direct metal-carbon bonds but which contain organic ligands .,64,73,compounds,0,2,2
3XD2A6FGFNVKQHOX8GFMCJMELN4S9D,The term `` metalorganics '' usually refers to metal-containing compounds lacking direct metal-carbon bonds but which contain organic ligands .,74,81,lacking,0,3,3
3XD2A6FGFNVKQHOX8GFMCJMELN4S9D,The term `` metalorganics '' usually refers to metal-containing compounds lacking direct metal-carbon bonds but which contain organic ligands .,89,101,metal-carbon,0,1,1
3XD2A6FGFNVKQHOX8GFMCJMELN4S9D,The term `` metalorganics '' usually refers to metal-containing compounds lacking direct metal-carbon bonds but which contain organic ligands .,89,107,metal-carbon bonds,0,1,1
3XD2A6FGFNVKQHOX8GFMCJMELN4S9D,The term `` metalorganics '' usually refers to metal-containing compounds lacking direct metal-carbon bonds but which contain organic ligands .,126,141,organic ligands,1,0,1
3XD2A6FGFNVKQHOX8GFMCJMELN4S9D,The term `` metalorganics '' usually refers to metal-containing compounds lacking direct metal-carbon bonds but which contain organic ligands .,134,141,ligands,3,8,11
3XD2A6FGFNVKQHOX8GFMCJMELN4S9D,"The organic ligands often bind the metal through a heteroatom such as oxygen or nitrogen , in which case such compounds are considered coordination compounds .",12,19,ligands,4,4,8
3XD2A6FGFNVKQHOX8GFMCJMELN4S9D,"The organic ligands often bind the metal through a heteroatom such as oxygen or nitrogen , in which case such compounds are considered coordination compounds .",26,30,bind,0,1,1
3XD2A6FGFNVKQHOX8GFMCJMELN4S9D,"The organic ligands often bind the metal through a heteroatom such as oxygen or nitrogen , in which case such compounds are considered coordination compounds .",51,61,heteroatom,10,5,15
3XD2A6FGFNVKQHOX8GFMCJMELN4S9D,"The organic ligands often bind the metal through a heteroatom such as oxygen or nitrogen , in which case such compounds are considered coordination compounds .",70,76,oxygen,2,0,2
3XD2A6FGFNVKQHOX8GFMCJMELN4S9D,"The organic ligands often bind the metal through a heteroatom such as oxygen or nitrogen , in which case such compounds are considered coordination compounds .",80,88,nitrogen,1,0,1
3XD2A6FGFNVKQHOX8GFMCJMELN4S9D,"Organometallic compounds with bonds that have characters in between ionic and covalent are very important in industry , as they are both relatively stable in solutions and relatively ionic to undergo reactions .",0,14,Organometallic,2,1,3
3XD2A6FGFNVKQHOX8GFMCJMELN4S9D,"Organometallic compounds with bonds that have characters in between ionic and covalent are very important in industry , as they are both relatively stable in solutions and relatively ionic to undergo reactions .",30,35,bonds,1,1,2
3XD2A6FGFNVKQHOX8GFMCJMELN4S9D,"Organometallic compounds with bonds that have characters in between ionic and covalent are very important in industry , as they are both relatively stable in solutions and relatively ionic to undergo reactions .",68,73,ionic,2,3,5
3XD2A6FGFNVKQHOX8GFMCJMELN4S9D,"Organometallic compounds with bonds that have characters in between ionic and covalent are very important in industry , as they are both relatively stable in solutions and relatively ionic to undergo reactions .",78,86,covalent,4,5,9
3XD2A6FGFNVKQHOX8GFMCJMELN4S9D,"Organometallic compounds with bonds that have characters in between ionic and covalent are very important in industry , as they are both relatively stable in solutions and relatively ionic to undergo reactions .",137,147,relatively,1,0,1
3XD2A6FGFNVKQHOX8GFMCJMELN4S9D,"Organometallic compounds with bonds that have characters in between ionic and covalent are very important in industry , as they are both relatively stable in solutions and relatively ionic to undergo reactions .",183,188,ionic,2,0,2
3XD2A6FGFNVKQHOX8GFMCJMELN4S9D,"Organometallic compounds with bonds that have characters in between ionic and covalent are very important in industry , as they are both relatively stable in solutions and relatively ionic to undergo reactions .",192,199,undergo,0,2,2
3XD2A6FGFNVKQHOX8GFMCJMELN4S9D,"Organometallic compounds with bonds that have characters in between ionic and covalent are very important in industry , as they are both relatively stable in solutions and relatively ionic to undergo reactions .",200,209,reactions,1,0,1
3KLL7H3EGD2TXFNK0N8J0N49346HVX,"Within the region , Doncaster is being recognized an important European hub with developments such as a new international airport , Robin Hood Airport Doncaster Sheffield which opened in 2005 .",20,29,Doncaster,0,2,2
3KLL7H3EGD2TXFNK0N8J0N49346HVX,"Within the region , Doncaster is being recognized an important European hub with developments such as a new international airport , Robin Hood Airport Doncaster Sheffield which opened in 2005 .",39,49,recognized,5,5,10
3KLL7H3EGD2TXFNK0N8J0N49346HVX,"Within the region , Doncaster is being recognized an important European hub with developments such as a new international airport , Robin Hood Airport Doncaster Sheffield which opened in 2005 .",72,75,hub,5,5,10
3KLL7H3EGD2TXFNK0N8J0N49346HVX,"Within the region , Doncaster is being recognized an important European hub with developments such as a new international airport , Robin Hood Airport Doncaster Sheffield which opened in 2005 .",81,93,developments,1,2,3
3KLL7H3EGD2TXFNK0N8J0N49346HVX,"Within the region , Doncaster is being recognized an important European hub with developments such as a new international airport , Robin Hood Airport Doncaster Sheffield which opened in 2005 .",108,121,international,3,2,5
3KLL7H3EGD2TXFNK0N8J0N49346HVX,"Within the region , Doncaster is being recognized an important European hub with developments such as a new international airport , Robin Hood Airport Doncaster Sheffield which opened in 2005 .",161,170,Sheffield,0,1,1
3KLL7H3EGD2TXFNK0N8J0N49346HVX,"Schistosomiasis , caused by one genus of trematodes , is the second-most devastating of all human diseases caused by parasites , surpassed only by malaria .",0,15,Schistosomiasis,10,4,14
3KLL7H3EGD2TXFNK0N8J0N49346HVX,"Schistosomiasis , caused by one genus of trematodes , is the second-most devastating of all human diseases caused by parasites , surpassed only by malaria .",18,24,caused,0,1,1
3KLL7H3EGD2TXFNK0N8J0N49346HVX,"Schistosomiasis , caused by one genus of trematodes , is the second-most devastating of all human diseases caused by parasites , surpassed only by malaria .",32,37,genus,5,4,9
3KLL7H3EGD2TXFNK0N8J0N49346HVX,"Schistosomiasis , caused by one genus of trematodes , is the second-most devastating of all human diseases caused by parasites , surpassed only by malaria .",32,51,genus of trematodes,0,1,1
3KLL7H3EGD2TXFNK0N8J0N49346HVX,"Schistosomiasis , caused by one genus of trematodes , is the second-most devastating of all human diseases caused by parasites , surpassed only by malaria .",41,51,trematodes,10,5,15
3KLL7H3EGD2TXFNK0N8J0N49346HVX,"Schistosomiasis , caused by one genus of trematodes , is the second-most devastating of all human diseases caused by parasites , surpassed only by malaria .",73,84,devastating,8,8,16
3KLL7H3EGD2TXFNK0N8J0N49346HVX,"Schistosomiasis , caused by one genus of trematodes , is the second-most devastating of all human diseases caused by parasites , surpassed only by malaria .",98,106,diseases,1,0,1
3KLL7H3EGD2TXFNK0N8J0N49346HVX,"Schistosomiasis , caused by one genus of trematodes , is the second-most devastating of all human diseases caused by parasites , surpassed only by malaria .",117,126,parasites,10,7,17
3KLL7H3EGD2TXFNK0N8J0N49346HVX,"Schistosomiasis , caused by one genus of trematodes , is the second-most devastating of all human diseases caused by parasites , surpassed only by malaria .",129,138,surpassed,7,7,14
3KLL7H3EGD2TXFNK0N8J0N49346HVX,"Schistosomiasis , caused by one genus of trematodes , is the second-most devastating of all human diseases caused by parasites , surpassed only by malaria .",147,154,malaria,7,0,7
3KLL7H3EGD2TXFNK0N8J0N49346HVX,"Over half of all known flatworm species are parasitic , and some do enormous harm to humans and their livestock .",23,31,flatworm,3,3,6
3KLL7H3EGD2TXFNK0N8J0N49346HVX,"Over half of all known flatworm species are parasitic , and some do enormous harm to humans and their livestock .",23,39,flatworm species,2,0,2
3KLL7H3EGD2TXFNK0N8J0N49346HVX,"Over half of all known flatworm species are parasitic , and some do enormous harm to humans and their livestock .",32,39,species,1,2,3
3KLL7H3EGD2TXFNK0N8J0N49346HVX,"Over half of all known flatworm species are parasitic , and some do enormous harm to humans and their livestock .",44,53,parasitic,4,3,7
3KLL7H3EGD2TXFNK0N8J0N49346HVX,"Over half of all known flatworm species are parasitic , and some do enormous harm to humans and their livestock .",68,76,enormous,3,4,7
3KLL7H3EGD2TXFNK0N8J0N49346HVX,"Over half of all known flatworm species are parasitic , and some do enormous harm to humans and their livestock .",102,111,livestock,4,9,13
3KLL7H3EGD2TXFNK0N8J0N49346HVX,"In 1965 , she opened the Opportunity Center and Orphanage in South Korea , and later offices were opened in Thailand , the Philippines , and Vietnam .",25,36,Opportunity,1,0,1
3KLL7H3EGD2TXFNK0N8J0N49346HVX,"In 1965 , she opened the Opportunity Center and Orphanage in South Korea , and later offices were opened in Thailand , the Philippines , and Vietnam .",25,57,Opportunity Center and Orphanage,1,0,1
3KLL7H3EGD2TXFNK0N8J0N49346HVX,"In 1965 , she opened the Opportunity Center and Orphanage in South Korea , and later offices were opened in Thailand , the Philippines , and Vietnam .",48,57,Orphanage,3,1,4
3KLL7H3EGD2TXFNK0N8J0N49346HVX,"Pearl S. Buck died of lung cancer on March 6 , 1973 , in Danby , Vermont , and was interred in Green Hills Farm in Perkasie , Pennsylvania .",83,91,interred,8,7,15
3WJGKMRWVIAGMQCINAUOJA1MQ5XDCL,"Though initially planned as a five-episode role , the character became so popular that she stayed on for the whole third season and returned for a two-part appearance in season four , after which the remainder of her original story arc was played out as part of the first season of the Buffy spin-off series Angel .",7,16,initially,8,1,9
3WJGKMRWVIAGMQCINAUOJA1MQ5XDCL,"Though initially planned as a five-episode role , the character became so popular that she stayed on for the whole third season and returned for a two-part appearance in season four , after which the remainder of her original story arc was played out as part of the first season of the Buffy spin-off series Angel .",30,42,five-episode,1,2,3
3WJGKMRWVIAGMQCINAUOJA1MQ5XDCL,"Though initially planned as a five-episode role , the character became so popular that she stayed on for the whole third season and returned for a two-part appearance in season four , after which the remainder of her original story arc was played out as part of the first season of the Buffy spin-off series Angel .",30,47,five-episode role,1,0,1
3WJGKMRWVIAGMQCINAUOJA1MQ5XDCL,"Though initially planned as a five-episode role , the character became so popular that she stayed on for the whole third season and returned for a two-part appearance in season four , after which the remainder of her original story arc was played out as part of the first season of the Buffy spin-off series Angel .",43,47,role,0,2,2
3WJGKMRWVIAGMQCINAUOJA1MQ5XDCL,"Though initially planned as a five-episode role , the character became so popular that she stayed on for the whole third season and returned for a two-part appearance in season four , after which the remainder of her original story arc was played out as part of the first season of the Buffy spin-off series Angel .",54,63,character,1,1,2
3WJGKMRWVIAGMQCINAUOJA1MQ5XDCL,"Though initially planned as a five-episode role , the character became so popular that she stayed on for the whole third season and returned for a two-part appearance in season four , after which the remainder of her original story arc was played out as part of the first season of the Buffy spin-off series Angel .",74,81,popular,1,0,1
3WJGKMRWVIAGMQCINAUOJA1MQ5XDCL,"Though initially planned as a five-episode role , the character became so popular that she stayed on for the whole third season and returned for a two-part appearance in season four , after which the remainder of her original story arc was played out as part of the first season of the Buffy spin-off series Angel .",121,127,season,1,0,1
3WJGKMRWVIAGMQCINAUOJA1MQ5XDCL,"Though initially planned as a five-episode role , the character became so popular that she stayed on for the whole third season and returned for a two-part appearance in season four , after which the remainder of her original story arc was played out as part of the first season of the Buffy spin-off series Angel .",132,140,returned,0,1,1
3WJGKMRWVIAGMQCINAUOJA1MQ5XDCL,"Though initially planned as a five-episode role , the character became so popular that she stayed on for the whole third season and returned for a two-part appearance in season four , after which the remainder of her original story arc was played out as part of the first season of the Buffy spin-off series Angel .",156,166,appearance,2,3,5
3WJGKMRWVIAGMQCINAUOJA1MQ5XDCL,"Though initially planned as a five-episode role , the character became so popular that she stayed on for the whole third season and returned for a two-part appearance in season four , after which the remainder of her original story arc was played out as part of the first season of the Buffy spin-off series Angel .",200,209,remainder,6,4,10
3WJGKMRWVIAGMQCINAUOJA1MQ5XDCL,"Though initially planned as a five-episode role , the character became so popular that she stayed on for the whole third season and returned for a two-part appearance in season four , after which the remainder of her original story arc was played out as part of the first season of the Buffy spin-off series Angel .",217,225,original,1,0,1
3WJGKMRWVIAGMQCINAUOJA1MQ5XDCL,"Though initially planned as a five-episode role , the character became so popular that she stayed on for the whole third season and returned for a two-part appearance in season four , after which the remainder of her original story arc was played out as part of the first season of the Buffy spin-off series Angel .",226,235,story arc,1,1,2
3WJGKMRWVIAGMQCINAUOJA1MQ5XDCL,"Though initially planned as a five-episode role , the character became so popular that she stayed on for the whole third season and returned for a two-part appearance in season four , after which the remainder of her original story arc was played out as part of the first season of the Buffy spin-off series Angel .",232,235,arc,3,1,4
3WJGKMRWVIAGMQCINAUOJA1MQ5XDCL,"Though initially planned as a five-episode role , the character became so popular that she stayed on for the whole third season and returned for a two-part appearance in season four , after which the remainder of her original story arc was played out as part of the first season of the Buffy spin-off series Angel .",286,291,Buffy,0,1,1
3WJGKMRWVIAGMQCINAUOJA1MQ5XDCL,"Though initially planned as a five-episode role , the character became so popular that she stayed on for the whole third season and returned for a two-part appearance in season four , after which the remainder of her original story arc was played out as part of the first season of the Buffy spin-off series Angel .",292,300,spin-off,6,6,12
3WJGKMRWVIAGMQCINAUOJA1MQ5XDCL,"Though initially planned as a five-episode role , the character became so popular that she stayed on for the whole third season and returned for a two-part appearance in season four , after which the remainder of her original story arc was played out as part of the first season of the Buffy spin-off series Angel .",292,307,spin-off series,1,0,1
3WJGKMRWVIAGMQCINAUOJA1MQ5XDCL,"Subsequently , it was announced on October 31 that Dushku had lured Joss Whedon , of Buffy The Vampire Slayer , back to TV , as they agreed to create a show called Dollhouse .",0,12,Subsequently,8,5,13
3WJGKMRWVIAGMQCINAUOJA1MQ5XDCL,"Subsequently , it was announced on October 31 that Dushku had lured Joss Whedon , of Buffy The Vampire Slayer , back to TV , as they agreed to create a show called Dollhouse .",22,31,announced,3,0,3
3WJGKMRWVIAGMQCINAUOJA1MQ5XDCL,"Subsequently , it was announced on October 31 that Dushku had lured Joss Whedon , of Buffy The Vampire Slayer , back to TV , as they agreed to create a show called Dollhouse .",62,67,lured,9,6,15
3WJGKMRWVIAGMQCINAUOJA1MQ5XDCL,"Subsequently , it was announced on October 31 that Dushku had lured Joss Whedon , of Buffy The Vampire Slayer , back to TV , as they agreed to create a show called Dollhouse .",95,102,Vampire,0,1,1
3WJGKMRWVIAGMQCINAUOJA1MQ5XDCL,"Subsequently , it was announced on October 31 that Dushku had lured Joss Whedon , of Buffy The Vampire Slayer , back to TV , as they agreed to create a show called Dollhouse .",95,109,Vampire Slayer,1,0,1
3WJGKMRWVIAGMQCINAUOJA1MQ5XDCL,"Subsequently , it was announced on October 31 that Dushku had lured Joss Whedon , of Buffy The Vampire Slayer , back to TV , as they agreed to create a show called Dollhouse .",103,109,Slayer,0,2,2
3WJGKMRWVIAGMQCINAUOJA1MQ5XDCL,"She followed that up with Soul Survivors , reuniting her with Race The Sun co-star Casey Affleck .",26,30,Soul,1,1,2
3WJGKMRWVIAGMQCINAUOJA1MQ5XDCL,"She followed that up with Soul Survivors , reuniting her with Race The Sun co-star Casey Affleck .",26,40,Soul Survivors,1,1,2
3WJGKMRWVIAGMQCINAUOJA1MQ5XDCL,"She followed that up with Soul Survivors , reuniting her with Race The Sun co-star Casey Affleck .",31,40,Survivors,1,3,4
3WJGKMRWVIAGMQCINAUOJA1MQ5XDCL,"She followed that up with Soul Survivors , reuniting her with Race The Sun co-star Casey Affleck .",43,52,reuniting,9,7,16
3WJGKMRWVIAGMQCINAUOJA1MQ5XDCL,"She followed that up with Soul Survivors , reuniting her with Race The Sun co-star Casey Affleck .",75,82,co-star,1,1,2
3WJGKMRWVIAGMQCINAUOJA1MQ5XDCL,"La India covered the song on her album , Sobre el Fuego as her third single from the album .",9,16,covered,3,2,5
3WJGKMRWVIAGMQCINAUOJA1MQ5XDCL,"La India covered the song on her album , Sobre el Fuego as her third single from the album .",41,55,Sobre el Fuego,1,0,1
3WJGKMRWVIAGMQCINAUOJA1MQ5XDCL,"La India covered the song on her album , Sobre el Fuego as her third single from the album .",85,90,album,1,1,2
34D9ZRXCYRVYV0Y20MTM8EXYR5MASA,"By the end of the 18th century , Tsarskoye Selo became a popular place of summer residence among the nobility .",23,30,century,1,0,1
34D9ZRXCYRVYV0Y20MTM8EXYR5MASA,"By the end of the 18th century , Tsarskoye Selo became a popular place of summer residence among the nobility .",33,42,Tsarskoye,0,1,1
34D9ZRXCYRVYV0Y20MTM8EXYR5MASA,"By the end of the 18th century , Tsarskoye Selo became a popular place of summer residence among the nobility .",33,47,Tsarskoye Selo,0,1,1
34D9ZRXCYRVYV0Y20MTM8EXYR5MASA,"By the end of the 18th century , Tsarskoye Selo became a popular place of summer residence among the nobility .",57,64,popular,1,0,1
34D9ZRXCYRVYV0Y20MTM8EXYR5MASA,"By the end of the 18th century , Tsarskoye Selo became a popular place of summer residence among the nobility .",74,90,summer residence,2,1,3
34D9ZRXCYRVYV0Y20MTM8EXYR5MASA,"By the end of the 18th century , Tsarskoye Selo became a popular place of summer residence among the nobility .",81,90,residence,4,3,7
34D9ZRXCYRVYV0Y20MTM8EXYR5MASA,"By the end of the 18th century , Tsarskoye Selo became a popular place of summer residence among the nobility .",101,109,nobility,10,10,20
34D9ZRXCYRVYV0Y20MTM8EXYR5MASA,It is now part of the town of Pushkin and of the World Heritage Site Saint Petersburg and Related Groups of Monuments .,30,37,Pushkin,0,1,1
34D9ZRXCYRVYV0Y20MTM8EXYR5MASA,It is now part of the town of Pushkin and of the World Heritage Site Saint Petersburg and Related Groups of Monuments .,49,68,World Heritage Site,1,0,1
34D9ZRXCYRVYV0Y20MTM8EXYR5MASA,It is now part of the town of Pushkin and of the World Heritage Site Saint Petersburg and Related Groups of Monuments .,55,63,Heritage,0,6,6
34D9ZRXCYRVYV0Y20MTM8EXYR5MASA,It is now part of the town of Pushkin and of the World Heritage Site Saint Petersburg and Related Groups of Monuments .,98,117,Groups of Monuments,1,0,1
34D9ZRXCYRVYV0Y20MTM8EXYR5MASA,It is now part of the town of Pushkin and of the World Heritage Site Saint Petersburg and Related Groups of Monuments .,108,117,Monuments,3,4,7
34D9ZRXCYRVYV0Y20MTM8EXYR5MASA,Later Empress Catherine II of Russia and her architect Charles Cameron extended the palace building that is now known as the Cameron Gallery .,6,13,Empress,1,1,2
34D9ZRXCYRVYV0Y20MTM8EXYR5MASA,Later Empress Catherine II of Russia and her architect Charles Cameron extended the palace building that is now known as the Cameron Gallery .,45,54,architect,7,2,9
34D9ZRXCYRVYV0Y20MTM8EXYR5MASA,Later Empress Catherine II of Russia and her architect Charles Cameron extended the palace building that is now known as the Cameron Gallery .,71,79,extended,2,3,5
34D9ZRXCYRVYV0Y20MTM8EXYR5MASA,Later Empress Catherine II of Russia and her architect Charles Cameron extended the palace building that is now known as the Cameron Gallery .,125,140,Cameron Gallery,1,0,1
34D9ZRXCYRVYV0Y20MTM8EXYR5MASA,"On September 17 , 1941 , the Germans occupied the town of Pushkin , destroying and plundering many historical monuments , buildings and other cultural artifacts , including the famous Amber Room .",37,45,occupied,2,2,4
34D9ZRXCYRVYV0Y20MTM8EXYR5MASA,"On September 17 , 1941 , the Germans occupied the town of Pushkin , destroying and plundering many historical monuments , buildings and other cultural artifacts , including the famous Amber Room .",58,65,Pushkin,0,1,1
34D9ZRXCYRVYV0Y20MTM8EXYR5MASA,"On September 17 , 1941 , the Germans occupied the town of Pushkin , destroying and plundering many historical monuments , buildings and other cultural artifacts , including the famous Amber Room .",68,93,destroying and plundering,1,0,1
34D9ZRXCYRVYV0Y20MTM8EXYR5MASA,"On September 17 , 1941 , the Germans occupied the town of Pushkin , destroying and plundering many historical monuments , buildings and other cultural artifacts , including the famous Amber Room .",83,93,plundering,10,10,20
34D9ZRXCYRVYV0Y20MTM8EXYR5MASA,"On September 17 , 1941 , the Germans occupied the town of Pushkin , destroying and plundering many historical monuments , buildings and other cultural artifacts , including the famous Amber Room .",99,119,historical monuments,2,0,2
34D9ZRXCYRVYV0Y20MTM8EXYR5MASA,"On September 17 , 1941 , the Germans occupied the town of Pushkin , destroying and plundering many historical monuments , buildings and other cultural artifacts , including the famous Amber Room .",110,119,monuments,2,4,6
34D9ZRXCYRVYV0Y20MTM8EXYR5MASA,"On September 17 , 1941 , the Germans occupied the town of Pushkin , destroying and plundering many historical monuments , buildings and other cultural artifacts , including the famous Amber Room .",142,150,cultural,1,0,1
34D9ZRXCYRVYV0Y20MTM8EXYR5MASA,"On September 17 , 1941 , the Germans occupied the town of Pushkin , destroying and plundering many historical monuments , buildings and other cultural artifacts , including the famous Amber Room .",142,160,cultural artifacts,4,0,4
34D9ZRXCYRVYV0Y20MTM8EXYR5MASA,"On September 17 , 1941 , the Germans occupied the town of Pushkin , destroying and plundering many historical monuments , buildings and other cultural artifacts , including the famous Amber Room .",151,160,artifacts,3,8,11
34D9ZRXCYRVYV0Y20MTM8EXYR5MASA,"On September 17 , 1941 , the Germans occupied the town of Pushkin , destroying and plundering many historical monuments , buildings and other cultural artifacts , including the famous Amber Room .",184,194,Amber Room,0,1,1
34D9ZRXCYRVYV0Y20MTM8EXYR5MASA,"2 ( Two ; i \/ ˈtuː \/ ) is a number , numeral , and glyph .",39,46,numeral,0,1,1
34D9ZRXCYRVYV0Y20MTM8EXYR5MASA,"2 ( Two ; i \/ ˈtuː \/ ) is a number , numeral , and glyph .",53,58,glyph,10,10,20
34D9ZRXCYRVYV0Y20MTM8EXYR5MASA,Two also has the unique property such that and also for a not equal to zero The number of domino tilings of a 2 × 2 checkerboard is 2 .,17,23,unique,3,0,3
34D9ZRXCYRVYV0Y20MTM8EXYR5MASA,Two also has the unique property such that and also for a not equal to zero The number of domino tilings of a 2 × 2 checkerboard is 2 .,17,32,unique property,0,1,1
34D9ZRXCYRVYV0Y20MTM8EXYR5MASA,Two also has the unique property such that and also for a not equal to zero The number of domino tilings of a 2 × 2 checkerboard is 2 .,33,42,such that,1,0,1
34D9ZRXCYRVYV0Y20MTM8EXYR5MASA,Two also has the unique property such that and also for a not equal to zero The number of domino tilings of a 2 × 2 checkerboard is 2 .,90,96,domino,2,2,4
34D9ZRXCYRVYV0Y20MTM8EXYR5MASA,Two also has the unique property such that and also for a not equal to zero The number of domino tilings of a 2 × 2 checkerboard is 2 .,90,104,domino tilings,3,3,6
34D9ZRXCYRVYV0Y20MTM8EXYR5MASA,Two also has the unique property such that and also for a not equal to zero The number of domino tilings of a 2 × 2 checkerboard is 2 .,97,104,tilings,3,4,7
34D9ZRXCYRVYV0Y20MTM8EXYR5MASA,Two also has the unique property such that and also for a not equal to zero The number of domino tilings of a 2 × 2 checkerboard is 2 .,116,128,checkerboard,1,3,4
3W31J70BASXO0WISFRGBNNWCAEUKC5,"Mucha produced a flurry of paintings , posters , advertisements , and book illustrations , as well as designs for jewelry , carpets , wallpaper , and theater sets in what was termed initially the Mucha Style but became known as Art Nouveau ( French for ` new art ' ) .",0,5,Mucha,2,0,2
3W31J70BASXO0WISFRGBNNWCAEUKC5,"Mucha produced a flurry of paintings , posters , advertisements , and book illustrations , as well as designs for jewelry , carpets , wallpaper , and theater sets in what was termed initially the Mucha Style but became known as Art Nouveau ( French for ` new art ' ) .",17,23,flurry,6,9,15
3W31J70BASXO0WISFRGBNNWCAEUKC5,"Mucha produced a flurry of paintings , posters , advertisements , and book illustrations , as well as designs for jewelry , carpets , wallpaper , and theater sets in what was termed initially the Mucha Style but became known as Art Nouveau ( French for ` new art ' ) .",27,36,paintings,0,1,1
3W31J70BASXO0WISFRGBNNWCAEUKC5,"Mucha produced a flurry of paintings , posters , advertisements , and book illustrations , as well as designs for jewelry , carpets , wallpaper , and theater sets in what was termed initially the Mucha Style but became known as Art Nouveau ( French for ` new art ' ) .",39,46,posters,0,1,1
3W31J70BASXO0WISFRGBNNWCAEUKC5,"Mucha produced a flurry of paintings , posters , advertisements , and book illustrations , as well as designs for jewelry , carpets , wallpaper , and theater sets in what was termed initially the Mucha Style but became known as Art Nouveau ( French for ` new art ' ) .",49,63,advertisements,1,2,3
3W31J70BASXO0WISFRGBNNWCAEUKC5,"Mucha produced a flurry of paintings , posters , advertisements , and book illustrations , as well as designs for jewelry , carpets , wallpaper , and theater sets in what was termed initially the Mucha Style but became known as Art Nouveau ( French for ` new art ' ) .",70,88,book illustrations,0,1,1
3W31J70BASXO0WISFRGBNNWCAEUKC5,"Mucha produced a flurry of paintings , posters , advertisements , and book illustrations , as well as designs for jewelry , carpets , wallpaper , and theater sets in what was termed initially the Mucha Style but became known as Art Nouveau ( French for ` new art ' ) .",75,88,illustrations,2,8,10
3W31J70BASXO0WISFRGBNNWCAEUKC5,"Mucha produced a flurry of paintings , posters , advertisements , and book illustrations , as well as designs for jewelry , carpets , wallpaper , and theater sets in what was termed initially the Mucha Style but became known as Art Nouveau ( French for ` new art ' ) .",102,109,designs,2,0,2
3W31J70BASXO0WISFRGBNNWCAEUKC5,"Mucha produced a flurry of paintings , posters , advertisements , and book illustrations , as well as designs for jewelry , carpets , wallpaper , and theater sets in what was termed initially the Mucha Style but became known as Art Nouveau ( French for ` new art ' ) .",114,121,jewelry,0,1,1
3W31J70BASXO0WISFRGBNNWCAEUKC5,"Mucha produced a flurry of paintings , posters , advertisements , and book illustrations , as well as designs for jewelry , carpets , wallpaper , and theater sets in what was termed initially the Mucha Style but became known as Art Nouveau ( French for ` new art ' ) .",150,157,theater,2,1,3
3W31J70BASXO0WISFRGBNNWCAEUKC5,"Mucha produced a flurry of paintings , posters , advertisements , and book illustrations , as well as designs for jewelry , carpets , wallpaper , and theater sets in what was termed initially the Mucha Style but became known as Art Nouveau ( French for ` new art ' ) .",175,181,termed,1,4,5
3W31J70BASXO0WISFRGBNNWCAEUKC5,"Mucha produced a flurry of paintings , posters , advertisements , and book illustrations , as well as designs for jewelry , carpets , wallpaper , and theater sets in what was termed initially the Mucha Style but became known as Art Nouveau ( French for ` new art ' ) .",182,191,initially,4,1,5
3W31J70BASXO0WISFRGBNNWCAEUKC5,"Mucha produced a flurry of paintings , posters , advertisements , and book illustrations , as well as designs for jewelry , carpets , wallpaper , and theater sets in what was termed initially the Mucha Style but became known as Art Nouveau ( French for ` new art ' ) .",196,207,Mucha Style,3,0,3
3W31J70BASXO0WISFRGBNNWCAEUKC5,"Mucha produced a flurry of paintings , posters , advertisements , and book illustrations , as well as designs for jewelry , carpets , wallpaper , and theater sets in what was termed initially the Mucha Style but became known as Art Nouveau ( French for ` new art ' ) .",228,239,Art Nouveau,2,1,3
3W31J70BASXO0WISFRGBNNWCAEUKC5,"Mucha produced a flurry of paintings , posters , advertisements , and book illustrations , as well as designs for jewelry , carpets , wallpaper , and theater sets in what was termed initially the Mucha Style but became known as Art Nouveau ( French for ` new art ' ) .",232,239,Nouveau,2,0,2
3W31J70BASXO0WISFRGBNNWCAEUKC5,"Mucha 's works frequently featured beautiful young women in flowing , vaguely Neoclassical-looking robes , often surrounded by lush flowers which sometimes formed halos behind their heads .",0,5,Mucha,1,0,1
3W31J70BASXO0WISFRGBNNWCAEUKC5,"Mucha 's works frequently featured beautiful young women in flowing , vaguely Neoclassical-looking robes , often surrounded by lush flowers which sometimes formed halos behind their heads .",0,7,Mucha s,1,0,1
3W31J70BASXO0WISFRGBNNWCAEUKC5,"Mucha 's works frequently featured beautiful young women in flowing , vaguely Neoclassical-looking robes , often surrounded by lush flowers which sometimes formed halos behind their heads .",15,25,frequently,2,1,3
3W31J70BASXO0WISFRGBNNWCAEUKC5,"Mucha 's works frequently featured beautiful young women in flowing , vaguely Neoclassical-looking robes , often surrounded by lush flowers which sometimes formed halos behind their heads .",26,34,featured,1,1,2
3W31J70BASXO0WISFRGBNNWCAEUKC5,"Mucha 's works frequently featured beautiful young women in flowing , vaguely Neoclassical-looking robes , often surrounded by lush flowers which sometimes formed halos behind their heads .",60,67,flowing,0,4,4
3W31J70BASXO0WISFRGBNNWCAEUKC5,"Mucha 's works frequently featured beautiful young women in flowing , vaguely Neoclassical-looking robes , often surrounded by lush flowers which sometimes formed halos behind their heads .",70,77,vaguely,5,8,13
3W31J70BASXO0WISFRGBNNWCAEUKC5,"Mucha 's works frequently featured beautiful young women in flowing , vaguely Neoclassical-looking robes , often surrounded by lush flowers which sometimes formed halos behind their heads .",70,98,vaguely Neoclassical-looking,3,1,4
3W31J70BASXO0WISFRGBNNWCAEUKC5,"Mucha 's works frequently featured beautiful young women in flowing , vaguely Neoclassical-looking robes , often surrounded by lush flowers which sometimes formed halos behind their heads .",70,104,vaguely Neoclassical-looking robes,0,1,1
3W31J70BASXO0WISFRGBNNWCAEUKC5,"Mucha 's works frequently featured beautiful young women in flowing , vaguely Neoclassical-looking robes , often surrounded by lush flowers which sometimes formed halos behind their heads .",78,98,Neoclassical-looking,6,3,9
3W31J70BASXO0WISFRGBNNWCAEUKC5,"Mucha 's works frequently featured beautiful young women in flowing , vaguely Neoclassical-looking robes , often surrounded by lush flowers which sometimes formed halos behind their heads .",113,123,surrounded,1,1,2
3W31J70BASXO0WISFRGBNNWCAEUKC5,"Mucha 's works frequently featured beautiful young women in flowing , vaguely Neoclassical-looking robes , often surrounded by lush flowers which sometimes formed halos behind their heads .",127,131,lush,2,5,7
3W31J70BASXO0WISFRGBNNWCAEUKC5,"Mucha 's works frequently featured beautiful young women in flowing , vaguely Neoclassical-looking robes , often surrounded by lush flowers which sometimes formed halos behind their heads .",127,139,lush flowers,0,2,2
3W31J70BASXO0WISFRGBNNWCAEUKC5,"Mucha 's works frequently featured beautiful young women in flowing , vaguely Neoclassical-looking robes , often surrounded by lush flowers which sometimes formed halos behind their heads .",163,168,halos,4,6,10
3W31J70BASXO0WISFRGBNNWCAEUKC5,"The 1900 Universal Exhibition in Paris spread the `` Mucha style '' internationally , of which Mucha said `` I think ( the Exposition Universelle ) made some contribution toward bringing aesthetic values into arts and crafts . ''",9,18,Universal,0,1,1
3W31J70BASXO0WISFRGBNNWCAEUKC5,"The 1900 Universal Exhibition in Paris spread the `` Mucha style '' internationally , of which Mucha said `` I think ( the Exposition Universelle ) made some contribution toward bringing aesthetic values into arts and crafts . ''",19,29,Exhibition,2,2,4
3W31J70BASXO0WISFRGBNNWCAEUKC5,"The 1900 Universal Exhibition in Paris spread the `` Mucha style '' internationally , of which Mucha said `` I think ( the Exposition Universelle ) made some contribution toward bringing aesthetic values into arts and crafts . ''",39,45,spread,0,1,1
3W31J70BASXO0WISFRGBNNWCAEUKC5,"The 1900 Universal Exhibition in Paris spread the `` Mucha style '' internationally , of which Mucha said `` I think ( the Exposition Universelle ) made some contribution toward bringing aesthetic values into arts and crafts . ''",53,64,Mucha style,2,0,2
3W31J70BASXO0WISFRGBNNWCAEUKC5,"The 1900 Universal Exhibition in Paris spread the `` Mucha style '' internationally , of which Mucha said `` I think ( the Exposition Universelle ) made some contribution toward bringing aesthetic values into arts and crafts . ''",68,83,internationally,1,0,1
3W31J70BASXO0WISFRGBNNWCAEUKC5,"The 1900 Universal Exhibition in Paris spread the `` Mucha style '' internationally , of which Mucha said `` I think ( the Exposition Universelle ) made some contribution toward bringing aesthetic values into arts and crafts . ''",95,100,Mucha,1,0,1
3W31J70BASXO0WISFRGBNNWCAEUKC5,"The 1900 Universal Exhibition in Paris spread the `` Mucha style '' internationally , of which Mucha said `` I think ( the Exposition Universelle ) made some contribution toward bringing aesthetic values into arts and crafts . ''",123,133,Exposition,1,1,2
3W31J70BASXO0WISFRGBNNWCAEUKC5,"The 1900 Universal Exhibition in Paris spread the `` Mucha style '' internationally , of which Mucha said `` I think ( the Exposition Universelle ) made some contribution toward bringing aesthetic values into arts and crafts . ''",123,145,Exposition Universelle,2,2,4
3W31J70BASXO0WISFRGBNNWCAEUKC5,"The 1900 Universal Exhibition in Paris spread the `` Mucha style '' internationally , of which Mucha said `` I think ( the Exposition Universelle ) made some contribution toward bringing aesthetic values into arts and crafts . ''",134,145,Universelle,1,0,1
3W31J70BASXO0WISFRGBNNWCAEUKC5,"The 1900 Universal Exhibition in Paris spread the `` Mucha style '' internationally , of which Mucha said `` I think ( the Exposition Universelle ) made some contribution toward bringing aesthetic values into arts and crafts . ''",158,170,contribution,0,1,1
3W31J70BASXO0WISFRGBNNWCAEUKC5,"The 1900 Universal Exhibition in Paris spread the `` Mucha style '' internationally , of which Mucha said `` I think ( the Exposition Universelle ) made some contribution toward bringing aesthetic values into arts and crafts . ''",187,196,aesthetic,9,4,13
3W31J70BASXO0WISFRGBNNWCAEUKC5,"The 1900 Universal Exhibition in Paris spread the `` Mucha style '' internationally , of which Mucha said `` I think ( the Exposition Universelle ) made some contribution toward bringing aesthetic values into arts and crafts . ''",187,203,aesthetic values,3,2,5
3W31J70BASXO0WISFRGBNNWCAEUKC5,"The 1900 Universal Exhibition in Paris spread the `` Mucha style '' internationally , of which Mucha said `` I think ( the Exposition Universelle ) made some contribution toward bringing aesthetic values into arts and crafts . ''",218,224,crafts,0,1,1
3W31J70BASXO0WISFRGBNNWCAEUKC5,He decorated the Bosnia and Herzegovina Pavilion and collaborated with decorating the Austrian Pavilion .,3,12,decorated,0,2,2
3W31J70BASXO0WISFRGBNNWCAEUKC5,He decorated the Bosnia and Herzegovina Pavilion and collaborated with decorating the Austrian Pavilion .,17,39,Bosnia and Herzegovina,1,0,1
3W31J70BASXO0WISFRGBNNWCAEUKC5,He decorated the Bosnia and Herzegovina Pavilion and collaborated with decorating the Austrian Pavilion .,28,39,Herzegovina,0,1,1
3W31J70BASXO0WISFRGBNNWCAEUKC5,He decorated the Bosnia and Herzegovina Pavilion and collaborated with decorating the Austrian Pavilion .,40,48,Pavilion,3,1,4
3W31J70BASXO0WISFRGBNNWCAEUKC5,He decorated the Bosnia and Herzegovina Pavilion and collaborated with decorating the Austrian Pavilion .,53,65,collaborated,10,6,16
3EAWOID6MTYIMFHO2F1YUV5SHN4V09,The roof of the Mudéjar style church features paintings of martyrs of the Order of Saint Dominic .,4,8,roof,0,2,2
3EAWOID6MTYIMFHO2F1YUV5SHN4V09,The roof of the Mudéjar style church features paintings of martyrs of the Order of Saint Dominic .,16,23,Mudéjar,6,1,7
3EAWOID6MTYIMFHO2F1YUV5SHN4V09,The roof of the Mudéjar style church features paintings of martyrs of the Order of Saint Dominic .,16,29,Mudéjar style,0,1,1
3EAWOID6MTYIMFHO2F1YUV5SHN4V09,The roof of the Mudéjar style church features paintings of martyrs of the Order of Saint Dominic .,37,45,features,1,2,3
3EAWOID6MTYIMFHO2F1YUV5SHN4V09,The roof of the Mudéjar style church features paintings of martyrs of the Order of Saint Dominic .,59,66,martyrs,10,7,17
3EAWOID6MTYIMFHO2F1YUV5SHN4V09,The roof of the Mudéjar style church features paintings of martyrs of the Order of Saint Dominic .,74,96,Order of Saint Dominic,1,0,1
3EAWOID6MTYIMFHO2F1YUV5SHN4V09,"In addition to the administrative units in the third level of the Palace is the presidential residence , a luxurious colonial-style apartment in which they live the President and his family .",19,33,administrative,6,0,6
3EAWOID6MTYIMFHO2F1YUV5SHN4V09,"In addition to the administrative units in the third level of the Palace is the presidential residence , a luxurious colonial-style apartment in which they live the President and his family .",19,39,administrative units,1,1,2
3EAWOID6MTYIMFHO2F1YUV5SHN4V09,"In addition to the administrative units in the third level of the Palace is the presidential residence , a luxurious colonial-style apartment in which they live the President and his family .",80,92,presidential,1,0,1
3EAWOID6MTYIMFHO2F1YUV5SHN4V09,"In addition to the administrative units in the third level of the Palace is the presidential residence , a luxurious colonial-style apartment in which they live the President and his family .",80,102,presidential residence,2,0,2
3EAWOID6MTYIMFHO2F1YUV5SHN4V09,"In addition to the administrative units in the third level of the Palace is the presidential residence , a luxurious colonial-style apartment in which they live the President and his family .",93,102,residence,2,1,3
3EAWOID6MTYIMFHO2F1YUV5SHN4V09,"In addition to the administrative units in the third level of the Palace is the presidential residence , a luxurious colonial-style apartment in which they live the President and his family .",107,116,luxurious,4,5,9
3EAWOID6MTYIMFHO2F1YUV5SHN4V09,"In addition to the administrative units in the third level of the Palace is the presidential residence , a luxurious colonial-style apartment in which they live the President and his family .",107,131,luxurious colonial-style,3,1,4
3EAWOID6MTYIMFHO2F1YUV5SHN4V09,"In addition to the administrative units in the third level of the Palace is the presidential residence , a luxurious colonial-style apartment in which they live the President and his family .",117,131,colonial-style,5,7,12
3EAWOID6MTYIMFHO2F1YUV5SHN4V09,"In addition to the administrative units in the third level of the Palace is the presidential residence , a luxurious colonial-style apartment in which they live the President and his family .",117,141,colonial-style apartment,1,0,1
3EAWOID6MTYIMFHO2F1YUV5SHN4V09,"Rafael Correa , president since 2007 , considering that Carondelet Palace and its agencies are Ecuadoran heritages , convert the presidential compound into a museum accessible to all who wish to visit it .",0,13,Rafael Correa,1,0,1
3EAWOID6MTYIMFHO2F1YUV5SHN4V09,"Rafael Correa , president since 2007 , considering that Carondelet Palace and its agencies are Ecuadoran heritages , convert the presidential compound into a museum accessible to all who wish to visit it .",39,50,considering,1,0,1
3EAWOID6MTYIMFHO2F1YUV5SHN4V09,"Rafael Correa , president since 2007 , considering that Carondelet Palace and its agencies are Ecuadoran heritages , convert the presidential compound into a museum accessible to all who wish to visit it .",56,73,Carondelet Palace,1,0,1
3EAWOID6MTYIMFHO2F1YUV5SHN4V09,"Rafael Correa , president since 2007 , considering that Carondelet Palace and its agencies are Ecuadoran heritages , convert the presidential compound into a museum accessible to all who wish to visit it .",82,90,agencies,1,0,1
3EAWOID6MTYIMFHO2F1YUV5SHN4V09,"Rafael Correa , president since 2007 , considering that Carondelet Palace and its agencies are Ecuadoran heritages , convert the presidential compound into a museum accessible to all who wish to visit it .",95,104,Ecuadoran,3,0,3
3EAWOID6MTYIMFHO2F1YUV5SHN4V09,"Rafael Correa , president since 2007 , considering that Carondelet Palace and its agencies are Ecuadoran heritages , convert the presidential compound into a museum accessible to all who wish to visit it .",95,114,Ecuadoran heritages,1,0,1
3EAWOID6MTYIMFHO2F1YUV5SHN4V09,"Rafael Correa , president since 2007 , considering that Carondelet Palace and its agencies are Ecuadoran heritages , convert the presidential compound into a museum accessible to all who wish to visit it .",105,114,heritages,4,7,11
3EAWOID6MTYIMFHO2F1YUV5SHN4V09,"Rafael Correa , president since 2007 , considering that Carondelet Palace and its agencies are Ecuadoran heritages , convert the presidential compound into a museum accessible to all who wish to visit it .",117,124,convert,2,1,3
3EAWOID6MTYIMFHO2F1YUV5SHN4V09,"Rafael Correa , president since 2007 , considering that Carondelet Palace and its agencies are Ecuadoran heritages , convert the presidential compound into a museum accessible to all who wish to visit it .",129,141,presidential,1,0,1
3EAWOID6MTYIMFHO2F1YUV5SHN4V09,"Rafael Correa , president since 2007 , considering that Carondelet Palace and its agencies are Ecuadoran heritages , convert the presidential compound into a museum accessible to all who wish to visit it .",142,150,compound,3,3,6
3EAWOID6MTYIMFHO2F1YUV5SHN4V09,"Rafael Correa , president since 2007 , considering that Carondelet Palace and its agencies are Ecuadoran heritages , convert the presidential compound into a museum accessible to all who wish to visit it .",158,164,museum,2,0,2
3EAWOID6MTYIMFHO2F1YUV5SHN4V09,"Rafael Correa , president since 2007 , considering that Carondelet Palace and its agencies are Ecuadoran heritages , convert the presidential compound into a museum accessible to all who wish to visit it .",165,175,accessible,3,2,5
3EAWOID6MTYIMFHO2F1YUV5SHN4V09,"The roof of the nave is composed of a pair and knuckle frame , coated inside by pieces of tracery .",4,20,roof of the nave,1,0,1
3EAWOID6MTYIMFHO2F1YUV5SHN4V09,"The roof of the nave is composed of a pair and knuckle frame , coated inside by pieces of tracery .",16,20,nave,4,3,7
3EAWOID6MTYIMFHO2F1YUV5SHN4V09,"The roof of the nave is composed of a pair and knuckle frame , coated inside by pieces of tracery .",38,60,pair and knuckle frame,2,1,3
3EAWOID6MTYIMFHO2F1YUV5SHN4V09,"The roof of the nave is composed of a pair and knuckle frame , coated inside by pieces of tracery .",47,54,knuckle,4,3,7
3EAWOID6MTYIMFHO2F1YUV5SHN4V09,"The roof of the nave is composed of a pair and knuckle frame , coated inside by pieces of tracery .",47,60,knuckle frame,1,6,7
3EAWOID6MTYIMFHO2F1YUV5SHN4V09,"The roof of the nave is composed of a pair and knuckle frame , coated inside by pieces of tracery .",63,69,coated,0,2,2
3EAWOID6MTYIMFHO2F1YUV5SHN4V09,"The roof of the nave is composed of a pair and knuckle frame , coated inside by pieces of tracery .",80,97,pieces of tracery,2,1,3
3EAWOID6MTYIMFHO2F1YUV5SHN4V09,"The roof of the nave is composed of a pair and knuckle frame , coated inside by pieces of tracery .",90,97,tracery,10,9,19
3EAWOID6MTYIMFHO2F1YUV5SHN4V09,"Carondelet Palace Carondelet Palace ( Spanish : Palacio de Carondelet ) is the seat of government of the Republic of Ecuador , located in the historical center of Quito .",0,10,Carondelet,1,0,1
3EAWOID6MTYIMFHO2F1YUV5SHN4V09,"Carondelet Palace Carondelet Palace ( Spanish : Palacio de Carondelet ) is the seat of government of the Republic of Ecuador , located in the historical center of Quito .",48,55,Palacio,1,0,1
3EAWOID6MTYIMFHO2F1YUV5SHN4V09,"Carondelet Palace Carondelet Palace ( Spanish : Palacio de Carondelet ) is the seat of government of the Republic of Ecuador , located in the historical center of Quito .",87,97,government,2,0,2
3EAWOID6MTYIMFHO2F1YUV5SHN4V09,"Carondelet Palace Carondelet Palace ( Spanish : Palacio de Carondelet ) is the seat of government of the Republic of Ecuador , located in the historical center of Quito .",142,152,historical,0,1,1
3EAWOID6MTYIMFHO2F1YUV5SHN4V09,"Carondelet Palace Carondelet Palace ( Spanish : Palacio de Carondelet ) is the seat of government of the Republic of Ecuador , located in the historical center of Quito .",142,159,historical center,1,0,1
3UQ1LLR26A9BRN3CGDWLWSJ3ZBEALW,"Aemilianus ( Latin : Marcus Aemilius Aemilianus Augustus ; c. 207\/213 - 253 ) , also known as Aemilian , was Roman Emperor for three months in 253 .",0,10,Aemilianus,4,3,7
3UQ1LLR26A9BRN3CGDWLWSJ3ZBEALW,"Aemilianus ( Latin : Marcus Aemilius Aemilianus Augustus ; c. 207\/213 - 253 ) , also known as Aemilian , was Roman Emperor for three months in 253 .",21,56,Marcus Aemilius Aemilianus Augustus,2,0,2
3UQ1LLR26A9BRN3CGDWLWSJ3ZBEALW,"Aemilianus ( Latin : Marcus Aemilius Aemilianus Augustus ; c. 207\/213 - 253 ) , also known as Aemilian , was Roman Emperor for three months in 253 .",28,56,Aemilius Aemilianus Augustus,1,0,1
3UQ1LLR26A9BRN3CGDWLWSJ3ZBEALW,"Aemilianus ( Latin : Marcus Aemilius Aemilianus Augustus ; c. 207\/213 - 253 ) , also known as Aemilian , was Roman Emperor for three months in 253 .",95,103,Aemilian,1,0,1
3UQ1LLR26A9BRN3CGDWLWSJ3ZBEALW,"Aemilianus ( Latin : Marcus Aemilius Aemilianus Augustus ; c. 207\/213 - 253 ) , also known as Aemilian , was Roman Emperor for three months in 253 .",116,123,Emperor,1,1,2
3UQ1LLR26A9BRN3CGDWLWSJ3ZBEALW,"Commander of the Moesian troops , he obtained an important victory against the invading Goths and was , for this reason , acclaimed Emperor by his army .",0,9,Commander,1,1,2
3UQ1LLR26A9BRN3CGDWLWSJ3ZBEALW,"Commander of the Moesian troops , he obtained an important victory against the invading Goths and was , for this reason , acclaimed Emperor by his army .",17,24,Moesian,5,2,7
3UQ1LLR26A9BRN3CGDWLWSJ3ZBEALW,"Commander of the Moesian troops , he obtained an important victory against the invading Goths and was , for this reason , acclaimed Emperor by his army .",17,31,Moesian troops,1,0,1
3UQ1LLR26A9BRN3CGDWLWSJ3ZBEALW,"Commander of the Moesian troops , he obtained an important victory against the invading Goths and was , for this reason , acclaimed Emperor by his army .",25,31,troops,0,3,3
3UQ1LLR26A9BRN3CGDWLWSJ3ZBEALW,"Commander of the Moesian troops , he obtained an important victory against the invading Goths and was , for this reason , acclaimed Emperor by his army .",37,45,obtained,4,0,4
3UQ1LLR26A9BRN3CGDWLWSJ3ZBEALW,"Commander of the Moesian troops , he obtained an important victory against the invading Goths and was , for this reason , acclaimed Emperor by his army .",59,66,victory,1,3,4
3UQ1LLR26A9BRN3CGDWLWSJ3ZBEALW,"Commander of the Moesian troops , he obtained an important victory against the invading Goths and was , for this reason , acclaimed Emperor by his army .",79,87,invading,2,5,7
3UQ1LLR26A9BRN3CGDWLWSJ3ZBEALW,"Commander of the Moesian troops , he obtained an important victory against the invading Goths and was , for this reason , acclaimed Emperor by his army .",79,93,invading Goths,0,1,1
3UQ1LLR26A9BRN3CGDWLWSJ3ZBEALW,"Commander of the Moesian troops , he obtained an important victory against the invading Goths and was , for this reason , acclaimed Emperor by his army .",88,93,Goths,1,3,4
3UQ1LLR26A9BRN3CGDWLWSJ3ZBEALW,"Commander of the Moesian troops , he obtained an important victory against the invading Goths and was , for this reason , acclaimed Emperor by his army .",122,131,acclaimed,10,9,19
3UQ1LLR26A9BRN3CGDWLWSJ3ZBEALW,"He then moved quickly to Italy , where he defeated Emperor Trebonianus Gallus , only to be killed by his own men when another general , Valerian , proclaimed himself Emperor and moved against Aemilian with a larger army .",42,50,defeated,3,3,6
3UQ1LLR26A9BRN3CGDWLWSJ3ZBEALW,"He then moved quickly to Italy , where he defeated Emperor Trebonianus Gallus , only to be killed by his own men when another general , Valerian , proclaimed himself Emperor and moved against Aemilian with a larger army .",51,58,Emperor,1,0,1
3UQ1LLR26A9BRN3CGDWLWSJ3ZBEALW,"He then moved quickly to Italy , where he defeated Emperor Trebonianus Gallus , only to be killed by his own men when another general , Valerian , proclaimed himself Emperor and moved against Aemilian with a larger army .",51,77,Emperor Trebonianus Gallus,2,0,2
3UQ1LLR26A9BRN3CGDWLWSJ3ZBEALW,"He then moved quickly to Italy , where he defeated Emperor Trebonianus Gallus , only to be killed by his own men when another general , Valerian , proclaimed himself Emperor and moved against Aemilian with a larger army .",59,77,Trebonianus Gallus,2,1,3
3UQ1LLR26A9BRN3CGDWLWSJ3ZBEALW,"He then moved quickly to Italy , where he defeated Emperor Trebonianus Gallus , only to be killed by his own men when another general , Valerian , proclaimed himself Emperor and moved against Aemilian with a larger army .",136,144,Valerian,0,1,1
3UQ1LLR26A9BRN3CGDWLWSJ3ZBEALW,"He then moved quickly to Italy , where he defeated Emperor Trebonianus Gallus , only to be killed by his own men when another general , Valerian , proclaimed himself Emperor and moved against Aemilian with a larger army .",147,157,proclaimed,8,7,15
3UQ1LLR26A9BRN3CGDWLWSJ3ZBEALW,"He then moved quickly to Italy , where he defeated Emperor Trebonianus Gallus , only to be killed by his own men when another general , Valerian , proclaimed himself Emperor and moved against Aemilian with a larger army .",192,200,Aemilian,2,1,3
3UQ1LLR26A9BRN3CGDWLWSJ3ZBEALW,"He then moved quickly to Italy , where he defeated Emperor Trebonianus Gallus , only to be killed by his own men when another general , Valerian , proclaimed himself Emperor and moved against Aemilian with a larger army .",215,219,army,0,1,1
3UQ1LLR26A9BRN3CGDWLWSJ3ZBEALW,"Emperor Aemilian 's men , fearful of a civil war and Valerian 's larger force , mutinied .",0,16,Emperor Aemilian,1,0,1
3UQ1LLR26A9BRN3CGDWLWSJ3ZBEALW,"Emperor Aemilian 's men , fearful of a civil war and Valerian 's larger force , mutinied .",26,33,fearful,0,5,5
3UQ1LLR26A9BRN3CGDWLWSJ3ZBEALW,"Emperor Aemilian 's men , fearful of a civil war and Valerian 's larger force , mutinied .",39,48,civil war,1,1,2
3UQ1LLR26A9BRN3CGDWLWSJ3ZBEALW,"Emperor Aemilian 's men , fearful of a civil war and Valerian 's larger force , mutinied .",53,61,Valerian,1,0,1
3UQ1LLR26A9BRN3CGDWLWSJ3ZBEALW,"Emperor Aemilian 's men , fearful of a civil war and Valerian 's larger force , mutinied .",53,76,Valerian s larger force,1,0,1
3UQ1LLR26A9BRN3CGDWLWSJ3ZBEALW,"Emperor Aemilian 's men , fearful of a civil war and Valerian 's larger force , mutinied .",80,88,mutinied,9,10,19
3UQ1LLR26A9BRN3CGDWLWSJ3ZBEALW,"Aemilian was killed by them at Spoletium or the Sanguinarium bridge , between Oriculum and Narnia ( half way between Spoletium and Rome ) , and recognized Valerian as the new emperor .",0,8,Aemilian,3,0,3
3UQ1LLR26A9BRN3CGDWLWSJ3ZBEALW,"Aemilian was killed by them at Spoletium or the Sanguinarium bridge , between Oriculum and Narnia ( half way between Spoletium and Rome ) , and recognized Valerian as the new emperor .",31,40,Spoletium,2,0,2
3UQ1LLR26A9BRN3CGDWLWSJ3ZBEALW,"Aemilian was killed by them at Spoletium or the Sanguinarium bridge , between Oriculum and Narnia ( half way between Spoletium and Rome ) , and recognized Valerian as the new emperor .",48,60,Sanguinarium,1,0,1
3UQ1LLR26A9BRN3CGDWLWSJ3ZBEALW,"Aemilian was killed by them at Spoletium or the Sanguinarium bridge , between Oriculum and Narnia ( half way between Spoletium and Rome ) , and recognized Valerian as the new emperor .",48,67,Sanguinarium bridge,1,1,2
3UQ1LLR26A9BRN3CGDWLWSJ3ZBEALW,"Aemilian was killed by them at Spoletium or the Sanguinarium bridge , between Oriculum and Narnia ( half way between Spoletium and Rome ) , and recognized Valerian as the new emperor .",78,86,Oriculum,2,0,2
3UQ1LLR26A9BRN3CGDWLWSJ3ZBEALW,"Aemilian was killed by them at Spoletium or the Sanguinarium bridge , between Oriculum and Narnia ( half way between Spoletium and Rome ) , and recognized Valerian as the new emperor .",91,97,Narnia,1,0,1
3UQ1LLR26A9BRN3CGDWLWSJ3ZBEALW,"Aemilian was killed by them at Spoletium or the Sanguinarium bridge , between Oriculum and Narnia ( half way between Spoletium and Rome ) , and recognized Valerian as the new emperor .",100,108,half way,0,1,1
3UQ1LLR26A9BRN3CGDWLWSJ3ZBEALW,"Aemilian was killed by them at Spoletium or the Sanguinarium bridge , between Oriculum and Narnia ( half way between Spoletium and Rome ) , and recognized Valerian as the new emperor .",117,126,Spoletium,2,0,2
3UQ1LLR26A9BRN3CGDWLWSJ3ZBEALW,"Aemilian was killed by them at Spoletium or the Sanguinarium bridge , between Oriculum and Narnia ( half way between Spoletium and Rome ) , and recognized Valerian as the new emperor .",144,154,recognized,1,3,4
3UQ1LLR26A9BRN3CGDWLWSJ3ZBEALW,"Aemilian was killed by them at Spoletium or the Sanguinarium bridge , between Oriculum and Narnia ( half way between Spoletium and Rome ) , and recognized Valerian as the new emperor .",155,163,Valerian,2,1,3
3UQ1LLR26A9BRN3CGDWLWSJ3ZBEALW,"Aemilian was killed by them at Spoletium or the Sanguinarium bridge , between Oriculum and Narnia ( half way between Spoletium and Rome ) , and recognized Valerian as the new emperor .",175,182,emperor,1,0,1
3UYRNV2KIT0NWZDIVSSMDTHXEIE8NS,"Meatpuppets will be blocked indefinitely , too ... do n't edit on behalf of someone else , no matter how well you may know them .",0,11,Meatpuppets,10,10,20
3UYRNV2KIT0NWZDIVSSMDTHXEIE8NS,"Meatpuppets will be blocked indefinitely , too ... do n't edit on behalf of someone else , no matter how well you may know them .",28,40,indefinitely,8,6,14
3UYRNV2KIT0NWZDIVSSMDTHXEIE8NS,"Meatpuppets will be blocked indefinitely , too ... do n't edit on behalf of someone else , no matter how well you may know them .",58,62,edit,1,0,1
3UYRNV2KIT0NWZDIVSSMDTHXEIE8NS,"Meatpuppets will be blocked indefinitely , too ... do n't edit on behalf of someone else , no matter how well you may know them .",63,75,on behalf of,2,1,3
3UYRNV2KIT0NWZDIVSSMDTHXEIE8NS,"Meatpuppets will be blocked indefinitely , too ... do n't edit on behalf of someone else , no matter how well you may know them .",66,72,behalf,1,4,5
3UYRNV2KIT0NWZDIVSSMDTHXEIE8NS,Wikipedia policy on open proxies is clear : editing through them is blocked without exception once identified .,0,9,Wikipedia,1,0,1
3UYRNV2KIT0NWZDIVSSMDTHXEIE8NS,Wikipedia policy on open proxies is clear : editing through them is blocked without exception once identified .,0,16,Wikipedia policy,1,0,1
3UYRNV2KIT0NWZDIVSSMDTHXEIE8NS,Wikipedia policy on open proxies is clear : editing through them is blocked without exception once identified .,10,16,policy,0,1,1
3UYRNV2KIT0NWZDIVSSMDTHXEIE8NS,Wikipedia policy on open proxies is clear : editing through them is blocked without exception once identified .,20,32,open proxies,2,1,3
3UYRNV2KIT0NWZDIVSSMDTHXEIE8NS,Wikipedia policy on open proxies is clear : editing through them is blocked without exception once identified .,25,32,proxies,10,10,20
3UYRNV2KIT0NWZDIVSSMDTHXEIE8NS,Wikipedia policy on open proxies is clear : editing through them is blocked without exception once identified .,76,93,without exception,1,0,1
3UYRNV2KIT0NWZDIVSSMDTHXEIE8NS,Wikipedia policy on open proxies is clear : editing through them is blocked without exception once identified .,84,93,exception,5,5,10
3UYRNV2KIT0NWZDIVSSMDTHXEIE8NS,Wikipedia policy on open proxies is clear : editing through them is blocked without exception once identified .,99,109,identified,0,2,2
3UYRNV2KIT0NWZDIVSSMDTHXEIE8NS,"Accounts with usernames that do not conform to the username policy are often blocked indefinitely , regardless of their editing behavior .",14,23,usernames,4,1,5
3UYRNV2KIT0NWZDIVSSMDTHXEIE8NS,"Accounts with usernames that do not conform to the username policy are often blocked indefinitely , regardless of their editing behavior .",36,43,conform,2,2,4
3UYRNV2KIT0NWZDIVSSMDTHXEIE8NS,"Accounts with usernames that do not conform to the username policy are often blocked indefinitely , regardless of their editing behavior .",51,59,username,0,1,1
3UYRNV2KIT0NWZDIVSSMDTHXEIE8NS,"Accounts with usernames that do not conform to the username policy are often blocked indefinitely , regardless of their editing behavior .",77,97,blocked indefinitely,1,0,1
3UYRNV2KIT0NWZDIVSSMDTHXEIE8NS,"Accounts with usernames that do not conform to the username policy are often blocked indefinitely , regardless of their editing behavior .",85,97,indefinitely,3,1,4
3UYRNV2KIT0NWZDIVSSMDTHXEIE8NS,"Accounts with usernames that do not conform to the username policy are often blocked indefinitely , regardless of their editing behavior .",100,110,regardless,1,7,8
3UYRNV2KIT0NWZDIVSSMDTHXEIE8NS,"Accounts with usernames that do not conform to the username policy are often blocked indefinitely , regardless of their editing behavior .",100,113,regardless of,1,1,2
3UYRNV2KIT0NWZDIVSSMDTHXEIE8NS,"Accounts with usernames that do not conform to the username policy are often blocked indefinitely , regardless of their editing behavior .",120,127,editing,1,0,1
3UYRNV2KIT0NWZDIVSSMDTHXEIE8NS,"Accounts with usernames that do not conform to the username policy are often blocked indefinitely , regardless of their editing behavior .",128,136,behavior,1,2,3
3UYRNV2KIT0NWZDIVSSMDTHXEIE8NS,"Also , if the reviewing administrator concludes that the block was justified , you will not be unblocked unless the reviewing administrator is convinced that you understand what you are blocked for , and that you will not do it again .",14,23,reviewing,1,2,3
3UYRNV2KIT0NWZDIVSSMDTHXEIE8NS,"Also , if the reviewing administrator concludes that the block was justified , you will not be unblocked unless the reviewing administrator is convinced that you understand what you are blocked for , and that you will not do it again .",14,37,reviewing administrator,2,0,2
3UYRNV2KIT0NWZDIVSSMDTHXEIE8NS,"Also , if the reviewing administrator concludes that the block was justified , you will not be unblocked unless the reviewing administrator is convinced that you understand what you are blocked for , and that you will not do it again .",24,37,administrator,1,1,2
3UYRNV2KIT0NWZDIVSSMDTHXEIE8NS,"Also , if the reviewing administrator concludes that the block was justified , you will not be unblocked unless the reviewing administrator is convinced that you understand what you are blocked for , and that you will not do it again .",38,47,concludes,3,0,3
3UYRNV2KIT0NWZDIVSSMDTHXEIE8NS,"Also , if the reviewing administrator concludes that the block was justified , you will not be unblocked unless the reviewing administrator is convinced that you understand what you are blocked for , and that you will not do it again .",67,76,justified,2,1,3
3UYRNV2KIT0NWZDIVSSMDTHXEIE8NS,"Also , if the reviewing administrator concludes that the block was justified , you will not be unblocked unless the reviewing administrator is convinced that you understand what you are blocked for , and that you will not do it again .",95,104,unblocked,1,2,3
3UYRNV2KIT0NWZDIVSSMDTHXEIE8NS,"Also , if the reviewing administrator concludes that the block was justified , you will not be unblocked unless the reviewing administrator is convinced that you understand what you are blocked for , and that you will not do it again .",126,139,administrator,2,1,3
3UYRNV2KIT0NWZDIVSSMDTHXEIE8NS,"Also , if the reviewing administrator concludes that the block was justified , you will not be unblocked unless the reviewing administrator is convinced that you understand what you are blocked for , and that you will not do it again .",143,152,convinced,4,4,8
3UYRNV2KIT0NWZDIVSSMDTHXEIE8NS,Do n't forget to insert your own reason to replace `` Insert your reason to be unblocked here '' .,17,23,insert,1,2,3
3UYRNV2KIT0NWZDIVSSMDTHXEIE8NS,Do n't forget to insert your own reason to replace `` Insert your reason to be unblocked here '' .,43,50,replace,1,0,1
3UYRNV2KIT0NWZDIVSSMDTHXEIE8NS,Do n't forget to insert your own reason to replace `` Insert your reason to be unblocked here '' .,54,60,Insert,1,0,1
3UYRNV2KIT0NWZDIVSSMDTHXEIE8NS,Do n't forget to insert your own reason to replace `` Insert your reason to be unblocked here '' .,79,88,unblocked,2,1,3
3909MD9T2ZISH8ASA7V9XY4ANUQFER,"However , the body feathers of Epidexipteryx are unique in that some appear to arise from a `` membranous structure '' at the base of each feather .",31,44,Epidexipteryx,9,4,13
3909MD9T2ZISH8ASA7V9XY4ANUQFER,"However , the body feathers of Epidexipteryx are unique in that some appear to arise from a `` membranous structure '' at the base of each feather .",49,55,unique,3,5,8
3909MD9T2ZISH8ASA7V9XY4ANUQFER,"However , the body feathers of Epidexipteryx are unique in that some appear to arise from a `` membranous structure '' at the base of each feather .",79,84,arise,0,2,2
3909MD9T2ZISH8ASA7V9XY4ANUQFER,"However , the body feathers of Epidexipteryx are unique in that some appear to arise from a `` membranous structure '' at the base of each feather .",94,115, membranous structure,1,0,1
3909MD9T2ZISH8ASA7V9XY4ANUQFER,"However , the body feathers of Epidexipteryx are unique in that some appear to arise from a `` membranous structure '' at the base of each feather .",95,105,membranous,9,5,14
3909MD9T2ZISH8ASA7V9XY4ANUQFER,"However , the body feathers of Epidexipteryx are unique in that some appear to arise from a `` membranous structure '' at the base of each feather .",95,115,membranous structure,6,2,8
3909MD9T2ZISH8ASA7V9XY4ANUQFER,"However , the body feathers of Epidexipteryx are unique in that some appear to arise from a `` membranous structure '' at the base of each feather .",106,115,structure,0,2,2
3909MD9T2ZISH8ASA7V9XY4ANUQFER,"The skull of Epidexipteryx is also unique in a number of features , and bears an overall similarity to the skull of Sapeornis , oviraptorosaurs and , to a lesser extent , therizinosauroids .",13,26,Epidexipteryx,2,1,3
3909MD9T2ZISH8ASA7V9XY4ANUQFER,"The skull of Epidexipteryx is also unique in a number of features , and bears an overall similarity to the skull of Sapeornis , oviraptorosaurs and , to a lesser extent , therizinosauroids .",35,41,unique,3,1,4
3909MD9T2ZISH8ASA7V9XY4ANUQFER,"The skull of Epidexipteryx is also unique in a number of features , and bears an overall similarity to the skull of Sapeornis , oviraptorosaurs and , to a lesser extent , therizinosauroids .",57,65,features,1,1,2
3909MD9T2ZISH8ASA7V9XY4ANUQFER,"The skull of Epidexipteryx is also unique in a number of features , and bears an overall similarity to the skull of Sapeornis , oviraptorosaurs and , to a lesser extent , therizinosauroids .",72,77,bears,1,1,2
3909MD9T2ZISH8ASA7V9XY4ANUQFER,"The skull of Epidexipteryx is also unique in a number of features , and bears an overall similarity to the skull of Sapeornis , oviraptorosaurs and , to a lesser extent , therizinosauroids .",81,88,overall,0,1,1
3909MD9T2ZISH8ASA7V9XY4ANUQFER,"The skull of Epidexipteryx is also unique in a number of features , and bears an overall similarity to the skull of Sapeornis , oviraptorosaurs and , to a lesser extent , therizinosauroids .",81,99,overall similarity,1,0,1
3909MD9T2ZISH8ASA7V9XY4ANUQFER,"The skull of Epidexipteryx is also unique in a number of features , and bears an overall similarity to the skull of Sapeornis , oviraptorosaurs and , to a lesser extent , therizinosauroids .",89,99,similarity,2,3,5
3909MD9T2ZISH8ASA7V9XY4ANUQFER,"The skull of Epidexipteryx is also unique in a number of features , and bears an overall similarity to the skull of Sapeornis , oviraptorosaurs and , to a lesser extent , therizinosauroids .",107,112,skull,1,1,2
3909MD9T2ZISH8ASA7V9XY4ANUQFER,"The skull of Epidexipteryx is also unique in a number of features , and bears an overall similarity to the skull of Sapeornis , oviraptorosaurs and , to a lesser extent , therizinosauroids .",116,125,Sapeornis,7,3,10
3909MD9T2ZISH8ASA7V9XY4ANUQFER,"The skull of Epidexipteryx is also unique in a number of features , and bears an overall similarity to the skull of Sapeornis , oviraptorosaurs and , to a lesser extent , therizinosauroids .",128,143,oviraptorosaurs,10,4,14
3909MD9T2ZISH8ASA7V9XY4ANUQFER,"The skull of Epidexipteryx is also unique in a number of features , and bears an overall similarity to the skull of Sapeornis , oviraptorosaurs and , to a lesser extent , therizinosauroids .",155,161,lesser,0,1,1
3909MD9T2ZISH8ASA7V9XY4ANUQFER,"The skull of Epidexipteryx is also unique in a number of features , and bears an overall similarity to the skull of Sapeornis , oviraptorosaurs and , to a lesser extent , therizinosauroids .",155,168,lesser extent,0,1,1
3909MD9T2ZISH8ASA7V9XY4ANUQFER,"The skull of Epidexipteryx is also unique in a number of features , and bears an overall similarity to the skull of Sapeornis , oviraptorosaurs and , to a lesser extent , therizinosauroids .",162,168,extent,2,2,4
3909MD9T2ZISH8ASA7V9XY4ANUQFER,"The skull of Epidexipteryx is also unique in a number of features , and bears an overall similarity to the skull of Sapeornis , oviraptorosaurs and , to a lesser extent , therizinosauroids .",171,188,therizinosauroids,10,4,14
3909MD9T2ZISH8ASA7V9XY4ANUQFER,"Epidexipteryx appears to have lacked remiges ( wing feathers ) , and it likely could not fly .",0,13,Epidexipteryx,2,2,4
3909MD9T2ZISH8ASA7V9XY4ANUQFER,"Epidexipteryx appears to have lacked remiges ( wing feathers ) , and it likely could not fly .",30,36,lacked,1,1,2
3909MD9T2ZISH8ASA7V9XY4ANUQFER,"Epidexipteryx appears to have lacked remiges ( wing feathers ) , and it likely could not fly .",30,44,lacked remiges,0,1,1
3909MD9T2ZISH8ASA7V9XY4ANUQFER,"Epidexipteryx appears to have lacked remiges ( wing feathers ) , and it likely could not fly .",37,44,remiges,10,5,15
3909MD9T2ZISH8ASA7V9XY4ANUQFER,"The 1936 Winter Olympics , officially known as the IV Olympic Winter Games ( French : Les IVes Jeux olympiques d'hiver ) , were a winter multi-sport event which was celebrated in 1936 in the market town of Garmisch-Partenkirchen in Bavaria , Germany .",16,24,Olympics,1,0,1
3909MD9T2ZISH8ASA7V9XY4ANUQFER,"The 1936 Winter Olympics , officially known as the IV Olympic Winter Games ( French : Les IVes Jeux olympiques d'hiver ) , were a winter multi-sport event which was celebrated in 1936 in the market town of Garmisch-Partenkirchen in Bavaria , Germany .",51,53,IV,1,0,1
3909MD9T2ZISH8ASA7V9XY4ANUQFER,"The 1936 Winter Olympics , officially known as the IV Olympic Winter Games ( French : Les IVes Jeux olympiques d'hiver ) , were a winter multi-sport event which was celebrated in 1936 in the market town of Garmisch-Partenkirchen in Bavaria , Germany .",100,110,olympiques,2,0,2
3909MD9T2ZISH8ASA7V9XY4ANUQFER,"The 1936 Winter Olympics , officially known as the IV Olympic Winter Games ( French : Les IVes Jeux olympiques d'hiver ) , were a winter multi-sport event which was celebrated in 1936 in the market town of Garmisch-Partenkirchen in Bavaria , Germany .",111,117,dhiver,1,0,1
3909MD9T2ZISH8ASA7V9XY4ANUQFER,"The 1936 Winter Olympics , officially known as the IV Olympic Winter Games ( French : Les IVes Jeux olympiques d'hiver ) , were a winter multi-sport event which was celebrated in 1936 in the market town of Garmisch-Partenkirchen in Bavaria , Germany .",137,148,multi-sport,2,3,5
3909MD9T2ZISH8ASA7V9XY4ANUQFER,"The 1936 Winter Olympics , officially known as the IV Olympic Winter Games ( French : Les IVes Jeux olympiques d'hiver ) , were a winter multi-sport event which was celebrated in 1936 in the market town of Garmisch-Partenkirchen in Bavaria , Germany .",137,154,multi-sport event,1,1,2
3909MD9T2ZISH8ASA7V9XY4ANUQFER,"The 1936 Winter Olympics , officially known as the IV Olympic Winter Games ( French : Les IVes Jeux olympiques d'hiver ) , were a winter multi-sport event which was celebrated in 1936 in the market town of Garmisch-Partenkirchen in Bavaria , Germany .",165,175,celebrated,0,3,3
3909MD9T2ZISH8ASA7V9XY4ANUQFER,"The 1936 Winter Olympics , officially known as the IV Olympic Winter Games ( French : Les IVes Jeux olympiques d'hiver ) , were a winter multi-sport event which was celebrated in 1936 in the market town of Garmisch-Partenkirchen in Bavaria , Germany .",191,202,market town,1,0,1
3909MD9T2ZISH8ASA7V9XY4ANUQFER,"The 1936 Winter Olympics , officially known as the IV Olympic Winter Games ( French : Les IVes Jeux olympiques d'hiver ) , were a winter multi-sport event which was celebrated in 1936 in the market town of Garmisch-Partenkirchen in Bavaria , Germany .",206,228,Garmisch-Partenkirchen,2,0,2
3909MD9T2ZISH8ASA7V9XY4ANUQFER,"The 1936 Winter Olympics , officially known as the IV Olympic Winter Games ( French : Les IVes Jeux olympiques d'hiver ) , were a winter multi-sport event which was celebrated in 1936 in the market town of Garmisch-Partenkirchen in Bavaria , Germany .",206,239,Garmisch-Partenkirchen in Bavaria,1,0,1
3W0KKJIARRAMOTSFYF06L10TKN98KN,"He left Nicopolis Pompeii , to live in Bondaroy ( France ) , near the town of Pithiviers .",8,17,Nicopolis,1,1,2
3W0KKJIARRAMOTSFYF06L10TKN98KN,"He left Nicopolis Pompeii , to live in Bondaroy ( France ) , near the town of Pithiviers .",8,25,Nicopolis Pompeii,0,1,1
3W0KKJIARRAMOTSFYF06L10TKN98KN,"He left Nicopolis Pompeii , to live in Bondaroy ( France ) , near the town of Pithiviers .",18,25,Pompeii,1,1,2
3W0KKJIARRAMOTSFYF06L10TKN98KN,"He left Nicopolis Pompeii , to live in Bondaroy ( France ) , near the town of Pithiviers .",39,47,Bondaroy,1,1,2
3W0KKJIARRAMOTSFYF06L10TKN98KN,"He left Nicopolis Pompeii , to live in Bondaroy ( France ) , near the town of Pithiviers .",78,88,Pithiviers,2,2,4
3W0KKJIARRAMOTSFYF06L10TKN98KN,"Originally , the term gingerbread ( from Latin zingiber via Old French gingebras ) referred to preserved ginger .",0,10,Originally,0,1,1
3W0KKJIARRAMOTSFYF06L10TKN98KN,"Originally , the term gingerbread ( from Latin zingiber via Old French gingebras ) referred to preserved ginger .",22,33,gingerbread,3,8,11
3W0KKJIARRAMOTSFYF06L10TKN98KN,"Originally , the term gingerbread ( from Latin zingiber via Old French gingebras ) referred to preserved ginger .",47,55,zingiber,2,1,3
3W0KKJIARRAMOTSFYF06L10TKN98KN,"Originally , the term gingerbread ( from Latin zingiber via Old French gingebras ) referred to preserved ginger .",71,80,gingebras,1,0,1
3W0KKJIARRAMOTSFYF06L10TKN98KN,"Originally , the term gingerbread ( from Latin zingiber via Old French gingebras ) referred to preserved ginger .",83,91,referred,0,1,1
3W0KKJIARRAMOTSFYF06L10TKN98KN,"Originally , the term gingerbread ( from Latin zingiber via Old French gingebras ) referred to preserved ginger .",95,104,preserved,1,6,7
3W0KKJIARRAMOTSFYF06L10TKN98KN,"Originally , the term gingerbread ( from Latin zingiber via Old French gingebras ) referred to preserved ginger .",105,111,ginger,0,2,2
3W0KKJIARRAMOTSFYF06L10TKN98KN,Early references from the Vadstena Abbey show how the Swedish nuns were baking gingerbread to ease indigestion in 1444 .,6,16,references,1,3,4
3W0KKJIARRAMOTSFYF06L10TKN98KN,Early references from the Vadstena Abbey show how the Swedish nuns were baking gingerbread to ease indigestion in 1444 .,26,34,Vadstena,1,1,2
3W0KKJIARRAMOTSFYF06L10TKN98KN,Early references from the Vadstena Abbey show how the Swedish nuns were baking gingerbread to ease indigestion in 1444 .,26,40,Vadstena Abbey,0,2,2
3W0KKJIARRAMOTSFYF06L10TKN98KN,Early references from the Vadstena Abbey show how the Swedish nuns were baking gingerbread to ease indigestion in 1444 .,35,40,Abbey,1,0,1
3W0KKJIARRAMOTSFYF06L10TKN98KN,Early references from the Vadstena Abbey show how the Swedish nuns were baking gingerbread to ease indigestion in 1444 .,54,61,Swedish,0,2,2
3W0KKJIARRAMOTSFYF06L10TKN98KN,Early references from the Vadstena Abbey show how the Swedish nuns were baking gingerbread to ease indigestion in 1444 .,62,66,nuns,0,5,5
3W0KKJIARRAMOTSFYF06L10TKN98KN,Early references from the Vadstena Abbey show how the Swedish nuns were baking gingerbread to ease indigestion in 1444 .,72,78,baking,0,2,2
3W0KKJIARRAMOTSFYF06L10TKN98KN,Early references from the Vadstena Abbey show how the Swedish nuns were baking gingerbread to ease indigestion in 1444 .,94,98,ease,1,0,1
3W0KKJIARRAMOTSFYF06L10TKN98KN,Early references from the Vadstena Abbey show how the Swedish nuns were baking gingerbread to ease indigestion in 1444 .,94,110,ease indigestion,0,1,1
3W0KKJIARRAMOTSFYF06L10TKN98KN,Early references from the Vadstena Abbey show how the Swedish nuns were baking gingerbread to ease indigestion in 1444 .,99,110,indigestion,10,9,19
3W0KKJIARRAMOTSFYF06L10TKN98KN,"Under conditions of high humidity , the rate of evaporation of sweat from the skin decreases .",20,33,high humidity,0,1,1
3W0KKJIARRAMOTSFYF06L10TKN98KN,"Under conditions of high humidity , the rate of evaporation of sweat from the skin decreases .",25,33,humidity,5,5,10
3W0KKJIARRAMOTSFYF06L10TKN98KN,"Under conditions of high humidity , the rate of evaporation of sweat from the skin decreases .",40,44,rate,2,0,2
3W0KKJIARRAMOTSFYF06L10TKN98KN,"Under conditions of high humidity , the rate of evaporation of sweat from the skin decreases .",48,59,evaporation,7,6,13
3W0KKJIARRAMOTSFYF06L10TKN98KN,"Under conditions of high humidity , the rate of evaporation of sweat from the skin decreases .",63,68,sweat,0,1,1
3W0KKJIARRAMOTSFYF06L10TKN98KN,"Under conditions of high humidity , the rate of evaporation of sweat from the skin decreases .",83,92,decreases,1,2,3
3W0KKJIARRAMOTSFYF06L10TKN98KN,"The son of a photocopier technician , he trained as a butcher , but became involved in graffiti during the great Bristol aerosol boom of the late 1980s . ''",13,24,photocopier,6,6,12
3W0KKJIARRAMOTSFYF06L10TKN98KN,"The son of a photocopier technician , he trained as a butcher , but became involved in graffiti during the great Bristol aerosol boom of the late 1980s . ''",13,35,photocopier technician,3,0,3
3W0KKJIARRAMOTSFYF06L10TKN98KN,"The son of a photocopier technician , he trained as a butcher , but became involved in graffiti during the great Bristol aerosol boom of the late 1980s . ''",25,35,technician,2,1,3
3W0KKJIARRAMOTSFYF06L10TKN98KN,"The son of a photocopier technician , he trained as a butcher , but became involved in graffiti during the great Bristol aerosol boom of the late 1980s . ''",54,61,butcher,2,7,9
3W0KKJIARRAMOTSFYF06L10TKN98KN,"The son of a photocopier technician , he trained as a butcher , but became involved in graffiti during the great Bristol aerosol boom of the late 1980s . ''",75,83,involved,0,2,2
3W0KKJIARRAMOTSFYF06L10TKN98KN,"The son of a photocopier technician , he trained as a butcher , but became involved in graffiti during the great Bristol aerosol boom of the late 1980s . ''",87,95,graffiti,5,7,12
3W0KKJIARRAMOTSFYF06L10TKN98KN,"The son of a photocopier technician , he trained as a butcher , but became involved in graffiti during the great Bristol aerosol boom of the late 1980s . ''",113,133,Bristol aerosol boom,0,2,2
3W0KKJIARRAMOTSFYF06L10TKN98KN,"The son of a photocopier technician , he trained as a butcher , but became involved in graffiti during the great Bristol aerosol boom of the late 1980s . ''",121,128,aerosol,8,3,11
3W0KKJIARRAMOTSFYF06L10TKN98KN,"The son of a photocopier technician , he trained as a butcher , but became involved in graffiti during the great Bristol aerosol boom of the late 1980s . ''",121,133,aerosol boom,1,1,2
3W0KKJIARRAMOTSFYF06L10TKN98KN,"The son of a photocopier technician , he trained as a butcher , but became involved in graffiti during the great Bristol aerosol boom of the late 1980s . ''",129,133,boom,0,2,2
3W0KKJIARRAMOTSFYF06L10TKN98KN,"In January 2011 , he was nominated for the Academy Award for Best Documentary for the film .",25,34,nominated,5,6,11
3W0KKJIARRAMOTSFYF06L10TKN98KN,"In January 2011 , he was nominated for the Academy Award for Best Documentary for the film .",66,77,Documentary,3,0,3
3W0KKJIARRAMOTSFYF06L10TKN98KN,"Banksy 's first film , Exit Through the Gift Shop , billed as `` the world 's first street art disaster movie '' , made its debut at the 2010 Sundance Film Festival .",52,58,billed,0,2,2
3W0KKJIARRAMOTSFYF06L10TKN98KN,"Banksy 's first film , Exit Through the Gift Shop , billed as `` the world 's first street art disaster movie '' , made its debut at the 2010 Sundance Film Festival .",52,61,billed as,0,1,1
3W0KKJIARRAMOTSFYF06L10TKN98KN,"Banksy 's first film , Exit Through the Gift Shop , billed as `` the world 's first street art disaster movie '' , made its debut at the 2010 Sundance Film Festival .",95,103,disaster,5,3,8
3W0KKJIARRAMOTSFYF06L10TKN98KN,"Banksy 's first film , Exit Through the Gift Shop , billed as `` the world 's first street art disaster movie '' , made its debut at the 2010 Sundance Film Festival .",124,129,debut,4,2,6
3W0KKJIARRAMOTSFYF06L10TKN98KN,"Banksy 's first film , Exit Through the Gift Shop , billed as `` the world 's first street art disaster movie '' , made its debut at the 2010 Sundance Film Festival .",142,150,Sundance,1,0,1
3W0KKJIARRAMOTSFYF06L10TKN98KN,"Banksy 's first film , Exit Through the Gift Shop , billed as `` the world 's first street art disaster movie '' , made its debut at the 2010 Sundance Film Festival .",142,164,Sundance Film Festival,1,0,1
3D17ECOUOEWYHV0NEOZSP5WJVVH31N,"Occasionally readers who have never or rarely edited before , or not from that location , with no intention of registering an account , click on edit only to find that editing from their IP address is blocked , for something they did n't do .",0,12,Occasionally,3,5,8
3D17ECOUOEWYHV0NEOZSP5WJVVH31N,"Occasionally readers who have never or rarely edited before , or not from that location , with no intention of registering an account , click on edit only to find that editing from their IP address is blocked , for something they did n't do .",39,45,rarely,1,2,3
3D17ECOUOEWYHV0NEOZSP5WJVVH31N,"Occasionally readers who have never or rarely edited before , or not from that location , with no intention of registering an account , click on edit only to find that editing from their IP address is blocked , for something they did n't do .",46,52,edited,1,1,2
3D17ECOUOEWYHV0NEOZSP5WJVVH31N,"Occasionally readers who have never or rarely edited before , or not from that location , with no intention of registering an account , click on edit only to find that editing from their IP address is blocked , for something they did n't do .",98,107,intention,5,4,9
3D17ECOUOEWYHV0NEOZSP5WJVVH31N,"Occasionally readers who have never or rarely edited before , or not from that location , with no intention of registering an account , click on edit only to find that editing from their IP address is blocked , for something they did n't do .",98,122,intention of registering,1,0,1
3D17ECOUOEWYHV0NEOZSP5WJVVH31N,"Occasionally readers who have never or rarely edited before , or not from that location , with no intention of registering an account , click on edit only to find that editing from their IP address is blocked , for something they did n't do .",111,122,registering,3,1,4
3D17ECOUOEWYHV0NEOZSP5WJVVH31N,"Occasionally readers who have never or rarely edited before , or not from that location , with no intention of registering an account , click on edit only to find that editing from their IP address is blocked , for something they did n't do .",111,133,registering an account,1,0,1
3D17ECOUOEWYHV0NEOZSP5WJVVH31N,"Occasionally readers who have never or rarely edited before , or not from that location , with no intention of registering an account , click on edit only to find that editing from their IP address is blocked , for something they did n't do .",187,189,IP,1,0,1
3D17ECOUOEWYHV0NEOZSP5WJVVH31N,"Occasionally readers who have never or rarely edited before , or not from that location , with no intention of registering an account , click on edit only to find that editing from their IP address is blocked , for something they did n't do .",187,197,IP address,1,0,1
3D17ECOUOEWYHV0NEOZSP5WJVVH31N,"Occasionally readers who have never or rarely edited before , or not from that location , with no intention of registering an account , click on edit only to find that editing from their IP address is blocked , for something they did n't do .",187,208,IP address is blocked,2,0,2
3D17ECOUOEWYHV0NEOZSP5WJVVH31N,"Occasionally readers who have never or rarely edited before , or not from that location , with no intention of registering an account , click on edit only to find that editing from their IP address is blocked , for something they did n't do .",201,208,blocked,0,1,1
3D17ECOUOEWYHV0NEOZSP5WJVVH31N,"As a user requesting to be unblocked , it is your responsibility to explain why you believe your block violates Wikipedia 's blocking policy or should otherwise be reversed .",10,20,requesting,2,1,3
3D17ECOUOEWYHV0NEOZSP5WJVVH31N,"As a user requesting to be unblocked , it is your responsibility to explain why you believe your block violates Wikipedia 's blocking policy or should otherwise be reversed .",27,36,unblocked,4,3,7
3D17ECOUOEWYHV0NEOZSP5WJVVH31N,"As a user requesting to be unblocked , it is your responsibility to explain why you believe your block violates Wikipedia 's blocking policy or should otherwise be reversed .",50,64,responsibility,4,0,4
3D17ECOUOEWYHV0NEOZSP5WJVVH31N,"As a user requesting to be unblocked , it is your responsibility to explain why you believe your block violates Wikipedia 's blocking policy or should otherwise be reversed .",103,111,violates,3,5,8
3D17ECOUOEWYHV0NEOZSP5WJVVH31N,"As a user requesting to be unblocked , it is your responsibility to explain why you believe your block violates Wikipedia 's blocking policy or should otherwise be reversed .",112,121,Wikipedia,2,0,2
3D17ECOUOEWYHV0NEOZSP5WJVVH31N,"As a user requesting to be unblocked , it is your responsibility to explain why you believe your block violates Wikipedia 's blocking policy or should otherwise be reversed .",125,140,blocking policy,1,0,1
3D17ECOUOEWYHV0NEOZSP5WJVVH31N,"As a user requesting to be unblocked , it is your responsibility to explain why you believe your block violates Wikipedia 's blocking policy or should otherwise be reversed .",151,160,otherwise,0,2,2
3D17ECOUOEWYHV0NEOZSP5WJVVH31N,"As a user requesting to be unblocked , it is your responsibility to explain why you believe your block violates Wikipedia 's blocking policy or should otherwise be reversed .",164,172,reversed,2,2,4
3D17ECOUOEWYHV0NEOZSP5WJVVH31N,Users may be blocked from editing by Wikipedia administrators to prevent damage or disruption to Wikipedia .,37,46,Wikipedia,1,0,1
3D17ECOUOEWYHV0NEOZSP5WJVVH31N,Users may be blocked from editing by Wikipedia administrators to prevent damage or disruption to Wikipedia .,47,61,administrators,5,1,6
3D17ECOUOEWYHV0NEOZSP5WJVVH31N,Users may be blocked from editing by Wikipedia administrators to prevent damage or disruption to Wikipedia .,73,79,damage,0,1,1
3D17ECOUOEWYHV0NEOZSP5WJVVH31N,Users may be blocked from editing by Wikipedia administrators to prevent damage or disruption to Wikipedia .,83,93,disruption,7,10,17
3D17ECOUOEWYHV0NEOZSP5WJVVH31N,Users may be blocked from editing by Wikipedia administrators to prevent damage or disruption to Wikipedia .,97,106,Wikipedia,1,0,1
3D17ECOUOEWYHV0NEOZSP5WJVVH31N,Blocks are lifted if they are not ( or no longer ) necessary to prevent such damage or disruption .,11,17,lifted,2,3,5
3D17ECOUOEWYHV0NEOZSP5WJVVH31N,Blocks are lifted if they are not ( or no longer ) necessary to prevent such damage or disruption .,87,97,disruption,4,3,7
3D17ECOUOEWYHV0NEOZSP5WJVVH31N,"They are usually one or more from among the following : vandalism , sockpuppetry , edit warring , violating the three-revert rule , spamming , editing with a conflict of interest or having a prohibited username .",56,65,vandalism,10,8,18
3D17ECOUOEWYHV0NEOZSP5WJVVH31N,"They are usually one or more from among the following : vandalism , sockpuppetry , edit warring , violating the three-revert rule , spamming , editing with a conflict of interest or having a prohibited username .",68,80,sockpuppetry,10,10,20
3D17ECOUOEWYHV0NEOZSP5WJVVH31N,"They are usually one or more from among the following : vandalism , sockpuppetry , edit warring , violating the three-revert rule , spamming , editing with a conflict of interest or having a prohibited username .",83,95,edit warring,4,8,12
3D17ECOUOEWYHV0NEOZSP5WJVVH31N,"They are usually one or more from among the following : vandalism , sockpuppetry , edit warring , violating the three-revert rule , spamming , editing with a conflict of interest or having a prohibited username .",88,95,warring,1,0,1
3D17ECOUOEWYHV0NEOZSP5WJVVH31N,"They are usually one or more from among the following : vandalism , sockpuppetry , edit warring , violating the three-revert rule , spamming , editing with a conflict of interest or having a prohibited username .",98,107,violating,2,1,3
3D17ECOUOEWYHV0NEOZSP5WJVVH31N,"They are usually one or more from among the following : vandalism , sockpuppetry , edit warring , violating the three-revert rule , spamming , editing with a conflict of interest or having a prohibited username .",98,129,violating the three-revert rule,1,1,2
3D17ECOUOEWYHV0NEOZSP5WJVVH31N,"They are usually one or more from among the following : vandalism , sockpuppetry , edit warring , violating the three-revert rule , spamming , editing with a conflict of interest or having a prohibited username .",112,124,three-revert,2,3,5
3D17ECOUOEWYHV0NEOZSP5WJVVH31N,"They are usually one or more from among the following : vandalism , sockpuppetry , edit warring , violating the three-revert rule , spamming , editing with a conflict of interest or having a prohibited username .",112,129,three-revert rule,2,3,5
3D17ECOUOEWYHV0NEOZSP5WJVVH31N,"They are usually one or more from among the following : vandalism , sockpuppetry , edit warring , violating the three-revert rule , spamming , editing with a conflict of interest or having a prohibited username .",132,140,spamming,3,8,11
3D17ECOUOEWYHV0NEOZSP5WJVVH31N,"They are usually one or more from among the following : vandalism , sockpuppetry , edit warring , violating the three-revert rule , spamming , editing with a conflict of interest or having a prohibited username .",158,166,conflict,0,1,1
3D17ECOUOEWYHV0NEOZSP5WJVVH31N,"They are usually one or more from among the following : vandalism , sockpuppetry , edit warring , violating the three-revert rule , spamming , editing with a conflict of interest or having a prohibited username .",158,178,conflict of interest,2,1,3
3D17ECOUOEWYHV0NEOZSP5WJVVH31N,"They are usually one or more from among the following : vandalism , sockpuppetry , edit warring , violating the three-revert rule , spamming , editing with a conflict of interest or having a prohibited username .",191,201,prohibited,4,7,11
3D17ECOUOEWYHV0NEOZSP5WJVVH31N,"They are usually one or more from among the following : vandalism , sockpuppetry , edit warring , violating the three-revert rule , spamming , editing with a conflict of interest or having a prohibited username .",202,210,username,1,0,1
34XASH8KLQN2K9RZ58FXM0NNY24PMT,"After spending two years in the Royal Canadian Navy during World War II , Stewart returned to the NHL in 1945 and had his best season , leading the league with 37 goals - the last time a Leaf led the League in goals .",6,14,spending,3,3,6
34XASH8KLQN2K9RZ58FXM0NNY24PMT,"After spending two years in the Royal Canadian Navy during World War II , Stewart returned to the NHL in 1945 and had his best season , leading the league with 37 goals - the last time a Leaf led the League in goals .",32,37,Royal,0,1,1
34XASH8KLQN2K9RZ58FXM0NNY24PMT,"After spending two years in the Royal Canadian Navy during World War II , Stewart returned to the NHL in 1945 and had his best season , leading the league with 37 goals - the last time a Leaf led the League in goals .",32,51,Royal Canadian Navy,3,1,4
34XASH8KLQN2K9RZ58FXM0NNY24PMT,"After spending two years in the Royal Canadian Navy during World War II , Stewart returned to the NHL in 1945 and had his best season , leading the league with 37 goals - the last time a Leaf led the League in goals .",38,46,Canadian,1,0,1
34XASH8KLQN2K9RZ58FXM0NNY24PMT,"After spending two years in the Royal Canadian Navy during World War II , Stewart returned to the NHL in 1945 and had his best season , leading the league with 37 goals - the last time a Leaf led the League in goals .",59,71,World War II,2,0,2
34XASH8KLQN2K9RZ58FXM0NNY24PMT,"After spending two years in the Royal Canadian Navy during World War II , Stewart returned to the NHL in 1945 and had his best season , leading the league with 37 goals - the last time a Leaf led the League in goals .",82,90,returned,1,1,2
34XASH8KLQN2K9RZ58FXM0NNY24PMT,"After spending two years in the Royal Canadian Navy during World War II , Stewart returned to the NHL in 1945 and had his best season , leading the league with 37 goals - the last time a Leaf led the League in goals .",98,101,NHL,2,0,2
34XASH8KLQN2K9RZ58FXM0NNY24PMT,"After spending two years in the Royal Canadian Navy during World War II , Stewart returned to the NHL in 1945 and had his best season , leading the league with 37 goals - the last time a Leaf led the League in goals .",127,133,season,1,2,3
34XASH8KLQN2K9RZ58FXM0NNY24PMT,"After spending two years in the Royal Canadian Navy during World War II , Stewart returned to the NHL in 1945 and had his best season , leading the league with 37 goals - the last time a Leaf led the League in goals .",136,143,leading,1,2,3
34XASH8KLQN2K9RZ58FXM0NNY24PMT,"After spending two years in the Royal Canadian Navy during World War II , Stewart returned to the NHL in 1945 and had his best season , leading the league with 37 goals - the last time a Leaf led the League in goals .",136,154,leading the league,0,1,1
34XASH8KLQN2K9RZ58FXM0NNY24PMT,"After spending two years in the Royal Canadian Navy during World War II , Stewart returned to the NHL in 1945 and had his best season , leading the league with 37 goals - the last time a Leaf led the League in goals .",148,154,league,5,4,9
34XASH8KLQN2K9RZ58FXM0NNY24PMT,"After spending two years in the Royal Canadian Navy during World War II , Stewart returned to the NHL in 1945 and had his best season , leading the league with 37 goals - the last time a Leaf led the League in goals .",163,168,goals,1,0,1
34XASH8KLQN2K9RZ58FXM0NNY24PMT,"After spending two years in the Royal Canadian Navy during World War II , Stewart returned to the NHL in 1945 and had his best season , leading the league with 37 goals - the last time a Leaf led the League in goals .",185,191,a Leaf,0,1,1
34XASH8KLQN2K9RZ58FXM0NNY24PMT,"After spending two years in the Royal Canadian Navy during World War II , Stewart returned to the NHL in 1945 and had his best season , leading the league with 37 goals - the last time a Leaf led the League in goals .",187,191,Leaf,0,1,1
34XASH8KLQN2K9RZ58FXM0NNY24PMT,"After spending two years in the Royal Canadian Navy during World War II , Stewart returned to the NHL in 1945 and had his best season , leading the league with 37 goals - the last time a Leaf led the League in goals .",192,195,led,0,2,2
34XASH8KLQN2K9RZ58FXM0NNY24PMT,"After spending two years in the Royal Canadian Navy during World War II , Stewart returned to the NHL in 1945 and had his best season , leading the league with 37 goals - the last time a Leaf led the League in goals .",200,206,League,2,0,2
34XASH8KLQN2K9RZ58FXM0NNY24PMT,"The next season , Stewart won the 1942-43 Calder Memorial Trophy , beating out Maurice ` The Rocket ' Richard of the Montreal Canadiens .",9,15,season,1,0,1
34XASH8KLQN2K9RZ58FXM0NNY24PMT,"The next season , Stewart won the 1942-43 Calder Memorial Trophy , beating out Maurice ` The Rocket ' Richard of the Montreal Canadiens .",18,25,Stewart,0,1,1
34XASH8KLQN2K9RZ58FXM0NNY24PMT,"The next season , Stewart won the 1942-43 Calder Memorial Trophy , beating out Maurice ` The Rocket ' Richard of the Montreal Canadiens .",42,64,Calder Memorial Trophy,2,2,4
34XASH8KLQN2K9RZ58FXM0NNY24PMT,"The next season , Stewart won the 1942-43 Calder Memorial Trophy , beating out Maurice ` The Rocket ' Richard of the Montreal Canadiens .",49,57,Memorial,4,2,6
34XASH8KLQN2K9RZ58FXM0NNY24PMT,"The next season , Stewart won the 1942-43 Calder Memorial Trophy , beating out Maurice ` The Rocket ' Richard of the Montreal Canadiens .",49,64,Memorial Trophy,1,0,1
34XASH8KLQN2K9RZ58FXM0NNY24PMT,"The next season , Stewart won the 1942-43 Calder Memorial Trophy , beating out Maurice ` The Rocket ' Richard of the Montreal Canadiens .",58,64,Trophy,2,1,3
34XASH8KLQN2K9RZ58FXM0NNY24PMT,"The next season , Stewart won the 1942-43 Calder Memorial Trophy , beating out Maurice ` The Rocket ' Richard of the Montreal Canadiens .",67,74,beating,0,2,2
34XASH8KLQN2K9RZ58FXM0NNY24PMT,"The next season , Stewart won the 1942-43 Calder Memorial Trophy , beating out Maurice ` The Rocket ' Richard of the Montreal Canadiens .",67,78,beating out,2,1,3
34XASH8KLQN2K9RZ58FXM0NNY24PMT,"The next season , Stewart won the 1942-43 Calder Memorial Trophy , beating out Maurice ` The Rocket ' Richard of the Montreal Canadiens .",79,86,Maurice,1,2,3
34XASH8KLQN2K9RZ58FXM0NNY24PMT,"The next season , Stewart won the 1942-43 Calder Memorial Trophy , beating out Maurice ` The Rocket ' Richard of the Montreal Canadiens .",117,125,Montreal,0,1,1
34XASH8KLQN2K9RZ58FXM0NNY24PMT,"The next season , Stewart won the 1942-43 Calder Memorial Trophy , beating out Maurice ` The Rocket ' Richard of the Montreal Canadiens .",117,135,Montreal Canadiens,2,0,2
34XASH8KLQN2K9RZ58FXM0NNY24PMT,"The next season , Stewart won the 1942-43 Calder Memorial Trophy , beating out Maurice ` The Rocket ' Richard of the Montreal Canadiens .",126,135,Canadiens,1,1,2
34XASH8KLQN2K9RZ58FXM0NNY24PMT,"Stewart won his second Stanley Cup , again with the Maple Leafs , in 1946-47 .",0,7,Stewart,0,1,1
34XASH8KLQN2K9RZ58FXM0NNY24PMT,"Stewart won his second Stanley Cup , again with the Maple Leafs , in 1946-47 .",8,11,won,0,1,1
34XASH8KLQN2K9RZ58FXM0NNY24PMT,"Stewart won his second Stanley Cup , again with the Maple Leafs , in 1946-47 .",23,30,Stanley,0,1,1
34XASH8KLQN2K9RZ58FXM0NNY24PMT,"Stewart won his second Stanley Cup , again with the Maple Leafs , in 1946-47 .",23,34,Stanley Cup,2,1,3
34XASH8KLQN2K9RZ58FXM0NNY24PMT,"Stewart won his second Stanley Cup , again with the Maple Leafs , in 1946-47 .",52,57,Maple,1,1,2
34XASH8KLQN2K9RZ58FXM0NNY24PMT,"Stewart won his second Stanley Cup , again with the Maple Leafs , in 1946-47 .",52,63,Maple Leafs,1,1,2
34XASH8KLQN2K9RZ58FXM0NNY24PMT,"Born in Fort William , Ontario , Stewart was called from the minors in 1942 to play in one game of the Stanley Cup Finals , where he helped the Toronto Maple Leafs win the Stanley Cup .",0,4,Born,0,1,1
34XASH8KLQN2K9RZ58FXM0NNY24PMT,"Born in Fort William , Ontario , Stewart was called from the minors in 1942 to play in one game of the Stanley Cup Finals , where he helped the Toronto Maple Leafs win the Stanley Cup .",23,30,Ontario,1,0,1
34XASH8KLQN2K9RZ58FXM0NNY24PMT,"Born in Fort William , Ontario , Stewart was called from the minors in 1942 to play in one game of the Stanley Cup Finals , where he helped the Toronto Maple Leafs win the Stanley Cup .",57,67,the minors,1,0,1
34XASH8KLQN2K9RZ58FXM0NNY24PMT,"Born in Fort William , Ontario , Stewart was called from the minors in 1942 to play in one game of the Stanley Cup Finals , where he helped the Toronto Maple Leafs win the Stanley Cup .",61,67,minors,7,5,12
34XASH8KLQN2K9RZ58FXM0NNY24PMT,"Born in Fort William , Ontario , Stewart was called from the minors in 1942 to play in one game of the Stanley Cup Finals , where he helped the Toronto Maple Leafs win the Stanley Cup .",103,121,Stanley Cup Finals,1,0,1
34XASH8KLQN2K9RZ58FXM0NNY24PMT,"Born in Fort William , Ontario , Stewart was called from the minors in 1942 to play in one game of the Stanley Cup Finals , where he helped the Toronto Maple Leafs win the Stanley Cup .",133,139,helped,0,1,1
34XASH8KLQN2K9RZ58FXM0NNY24PMT,"Born in Fort William , Ontario , Stewart was called from the minors in 1942 to play in one game of the Stanley Cup Finals , where he helped the Toronto Maple Leafs win the Stanley Cup .",144,151,Toronto,1,0,1
34XASH8KLQN2K9RZ58FXM0NNY24PMT,"Born in Fort William , Ontario , Stewart was called from the minors in 1942 to play in one game of the Stanley Cup Finals , where he helped the Toronto Maple Leafs win the Stanley Cup .",152,163,Maple Leafs,1,0,1
34XASH8KLQN2K9RZ58FXM0NNY24PMT,"Born in Fort William , Ontario , Stewart was called from the minors in 1942 to play in one game of the Stanley Cup Finals , where he helped the Toronto Maple Leafs win the Stanley Cup .",158,163,Leafs,0,1,1
34XASH8KLQN2K9RZ58FXM0NNY24PMT,"Born in Fort William , Ontario , Stewart was called from the minors in 1942 to play in one game of the Stanley Cup Finals , where he helped the Toronto Maple Leafs win the Stanley Cup .",172,183,Stanley Cup,1,0,1
3UEDKCTP9VRIOFNWOA80714Y933K7C,"For orchestral works in A major , the timpani are typically set to A and E a fifth apart , rather than a fourth apart as for most other keys .",4,14,orchestral,10,9,19
3UEDKCTP9VRIOFNWOA80714Y933K7C,"For orchestral works in A major , the timpani are typically set to A and E a fifth apart , rather than a fourth apart as for most other keys .",4,20,orchestral works,1,1,2
3UEDKCTP9VRIOFNWOA80714Y933K7C,"For orchestral works in A major , the timpani are typically set to A and E a fifth apart , rather than a fourth apart as for most other keys .",38,45,timpani,10,9,19
3UEDKCTP9VRIOFNWOA80714Y933K7C,"For orchestral works in A major , the timpani are typically set to A and E a fifth apart , rather than a fourth apart as for most other keys .",50,59,typically,3,1,4
3UEDKCTP9VRIOFNWOA80714Y933K7C,"For orchestral works in A major , the timpani are typically set to A and E a fifth apart , rather than a fourth apart as for most other keys .",60,63,set,0,1,1
3UEDKCTP9VRIOFNWOA80714Y933K7C,"Aboriginal land rights in Australia are grants of land to Indigenous Australians by the Commonwealth , state or territory governments of Australia .",0,10,Aboriginal,7,9,16
3UEDKCTP9VRIOFNWOA80714Y933K7C,"Aboriginal land rights in Australia are grants of land to Indigenous Australians by the Commonwealth , state or territory governments of Australia .",0,22,Aboriginal land rights,0,2,2
3UEDKCTP9VRIOFNWOA80714Y933K7C,"Aboriginal land rights in Australia are grants of land to Indigenous Australians by the Commonwealth , state or territory governments of Australia .",40,46,grants,1,1,2
3UEDKCTP9VRIOFNWOA80714Y933K7C,"Aboriginal land rights in Australia are grants of land to Indigenous Australians by the Commonwealth , state or territory governments of Australia .",58,68,Indigenous,10,7,17
3UEDKCTP9VRIOFNWOA80714Y933K7C,"Aboriginal land rights in Australia are grants of land to Indigenous Australians by the Commonwealth , state or territory governments of Australia .",88,100,Commonwealth,3,3,6
3UEDKCTP9VRIOFNWOA80714Y933K7C,"Aboriginal land rights in Australia are grants of land to Indigenous Australians by the Commonwealth , state or territory governments of Australia .",112,121,territory,6,3,9
3UEDKCTP9VRIOFNWOA80714Y933K7C,"Different types of land rights laws exist in Australia , allowing for the grant of land to Indigenous Australians under various conditions .",19,35,land rights laws,1,0,1
3UEDKCTP9VRIOFNWOA80714Y933K7C,"Different types of land rights laws exist in Australia , allowing for the grant of land to Indigenous Australians under various conditions .",31,35,laws,0,1,1
3UEDKCTP9VRIOFNWOA80714Y933K7C,"Different types of land rights laws exist in Australia , allowing for the grant of land to Indigenous Australians under various conditions .",36,41,exist,1,0,1
3UEDKCTP9VRIOFNWOA80714Y933K7C,"Different types of land rights laws exist in Australia , allowing for the grant of land to Indigenous Australians under various conditions .",74,79,grant,1,0,1
3UEDKCTP9VRIOFNWOA80714Y933K7C,"Different types of land rights laws exist in Australia , allowing for the grant of land to Indigenous Australians under various conditions .",74,87,grant of land,0,1,1
3UEDKCTP9VRIOFNWOA80714Y933K7C,"Different types of land rights laws exist in Australia , allowing for the grant of land to Indigenous Australians under various conditions .",91,101,Indigenous,4,0,4
3UEDKCTP9VRIOFNWOA80714Y933K7C,"Different types of land rights laws exist in Australia , allowing for the grant of land to Indigenous Australians under various conditions .",128,138,conditions,0,1,1
3UEDKCTP9VRIOFNWOA80714Y933K7C,"Land rights schemes are in place in the Northern Territory , Queensland , New South Wales , South Australia and Victoria .",12,19,schemes,10,2,12
3UEDKCTP9VRIOFNWOA80714Y933K7C,"Land rights schemes are in place in the Northern Territory , Queensland , New South Wales , South Australia and Victoria .",61,71,Queensland,0,1,1
3UEDKCTP9VRIOFNWOA80714Y933K7C,"The title is normally held by a community or an organization , not by individuals .",4,9,title,1,2,3
3UEDKCTP9VRIOFNWOA80714Y933K7C,"The title is normally held by a community or an organization , not by individuals .",13,21,normally,1,0,1
3UEDKCTP9VRIOFNWOA80714Y933K7C,"The title is normally held by a community or an organization , not by individuals .",22,26,held,0,1,1
3UEDKCTP9VRIOFNWOA80714Y933K7C,"The title is normally held by a community or an organization , not by individuals .",32,41,community,3,0,3
3UEDKCTP9VRIOFNWOA80714Y933K7C,"The title is normally held by a community or an organization , not by individuals .",48,60,organization,2,0,2
3UEDKCTP9VRIOFNWOA80714Y933K7C,"There are usually some restrictions on selling , and dealing with , land that has been granted in a land rights claim .",23,35,restrictions,7,3,10
3UEDKCTP9VRIOFNWOA80714Y933K7C,"There are usually some restrictions on selling , and dealing with , land that has been granted in a land rights claim .",53,60,dealing,0,1,1
3UEDKCTP9VRIOFNWOA80714Y933K7C,"There are usually some restrictions on selling , and dealing with , land that has been granted in a land rights claim .",53,65,dealing with,0,1,1
3UEDKCTP9VRIOFNWOA80714Y933K7C,"There are usually some restrictions on selling , and dealing with , land that has been granted in a land rights claim .",87,94,granted,0,3,3
3UEDKCTP9VRIOFNWOA80714Y933K7C,"There are usually some restrictions on selling , and dealing with , land that has been granted in a land rights claim .",112,117,claim,0,3,3
391JB9X4ZY919IUJSGAPQJ1O4SYKMN,"In 2003 , Dushku starred in the horror film Wrong Turn and The Kiss , an independent comedy-drama .",10,16,Dushku,0,1,1
391JB9X4ZY919IUJSGAPQJ1O4SYKMN,"In 2003 , Dushku starred in the horror film Wrong Turn and The Kiss , an independent comedy-drama .",17,24,starred,0,4,4
391JB9X4ZY919IUJSGAPQJ1O4SYKMN,"In 2003 , Dushku starred in the horror film Wrong Turn and The Kiss , an independent comedy-drama .",32,38,horror,2,1,3
391JB9X4ZY919IUJSGAPQJ1O4SYKMN,"In 2003 , Dushku starred in the horror film Wrong Turn and The Kiss , an independent comedy-drama .",73,84,independent,4,2,6
391JB9X4ZY919IUJSGAPQJ1O4SYKMN,"In 2003 , Dushku starred in the horror film Wrong Turn and The Kiss , an independent comedy-drama .",85,97,comedy-drama,3,1,4
391JB9X4ZY919IUJSGAPQJ1O4SYKMN,"She starred in Open Graves , a 2008 horror-thriller about a satanic game co-starring Mike Vogel .",20,26,Graves,0,3,3
391JB9X4ZY919IUJSGAPQJ1O4SYKMN,"She starred in Open Graves , a 2008 horror-thriller about a satanic game co-starring Mike Vogel .",36,51,horror-thriller,4,3,7
391JB9X4ZY919IUJSGAPQJ1O4SYKMN,"She starred in Open Graves , a 2008 horror-thriller about a satanic game co-starring Mike Vogel .",60,67,satanic,7,3,10
391JB9X4ZY919IUJSGAPQJ1O4SYKMN,"She starred in Open Graves , a 2008 horror-thriller about a satanic game co-starring Mike Vogel .",60,72,satanic game,0,2,2
391JB9X4ZY919IUJSGAPQJ1O4SYKMN,"She starred in Open Graves , a 2008 horror-thriller about a satanic game co-starring Mike Vogel .",73,84,co-starring,1,3,4
391JB9X4ZY919IUJSGAPQJ1O4SYKMN,"She starred in Open Graves , a 2008 horror-thriller about a satanic game co-starring Mike Vogel .",90,95,Vogel,0,1,1
391JB9X4ZY919IUJSGAPQJ1O4SYKMN,Dushku 's father is an Albanian from the city of Korçë and her mother is of Danish and English descent .,23,31,Albanian,1,0,1
391JB9X4ZY919IUJSGAPQJ1O4SYKMN,Dushku 's father is an Albanian from the city of Korçë and her mother is of Danish and English descent .,49,54,Korçë,1,0,1
391JB9X4ZY919IUJSGAPQJ1O4SYKMN,Dushku 's father is an Albanian from the city of Korçë and her mother is of Danish and English descent .,76,102,Danish and English descent,1,0,1
391JB9X4ZY919IUJSGAPQJ1O4SYKMN,Dushku 's father is an Albanian from the city of Korçë and her mother is of Danish and English descent .,95,102,descent,4,8,12
391JB9X4ZY919IUJSGAPQJ1O4SYKMN,"She played the main character in The Thacker Case and The Alphabet Killer , both thrillers based on real-life events , one of them directed by Rob Schmidt with whom she had worked on Wrong Turn .",15,29,main character,1,0,1
391JB9X4ZY919IUJSGAPQJ1O4SYKMN,"She played the main character in The Thacker Case and The Alphabet Killer , both thrillers based on real-life events , one of them directed by Rob Schmidt with whom she had worked on Wrong Turn .",20,29,character,1,2,3
391JB9X4ZY919IUJSGAPQJ1O4SYKMN,"She played the main character in The Thacker Case and The Alphabet Killer , both thrillers based on real-life events , one of them directed by Rob Schmidt with whom she had worked on Wrong Turn .",37,44,Thacker,1,1,2
391JB9X4ZY919IUJSGAPQJ1O4SYKMN,"She played the main character in The Thacker Case and The Alphabet Killer , both thrillers based on real-life events , one of them directed by Rob Schmidt with whom she had worked on Wrong Turn .",37,49,Thacker Case,1,0,1
391JB9X4ZY919IUJSGAPQJ1O4SYKMN,"She played the main character in The Thacker Case and The Alphabet Killer , both thrillers based on real-life events , one of them directed by Rob Schmidt with whom she had worked on Wrong Turn .",58,66,Alphabet,3,0,3
391JB9X4ZY919IUJSGAPQJ1O4SYKMN,"She played the main character in The Thacker Case and The Alphabet Killer , both thrillers based on real-life events , one of them directed by Rob Schmidt with whom she had worked on Wrong Turn .",58,73,Alphabet Killer,1,1,2
391JB9X4ZY919IUJSGAPQJ1O4SYKMN,"She played the main character in The Thacker Case and The Alphabet Killer , both thrillers based on real-life events , one of them directed by Rob Schmidt with whom she had worked on Wrong Turn .",81,90,thrillers,4,3,7
391JB9X4ZY919IUJSGAPQJ1O4SYKMN,"She played the main character in The Thacker Case and The Alphabet Killer , both thrillers based on real-life events , one of them directed by Rob Schmidt with whom she had worked on Wrong Turn .",100,116,real-life events,1,0,1
391JB9X4ZY919IUJSGAPQJ1O4SYKMN,"She played the main character in The Thacker Case and The Alphabet Killer , both thrillers based on real-life events , one of them directed by Rob Schmidt with whom she had worked on Wrong Turn .",147,154,Schmidt,1,2,3
391JB9X4ZY919IUJSGAPQJ1O4SYKMN,"She played the main character in The Thacker Case and The Alphabet Killer , both thrillers based on real-life events , one of them directed by Rob Schmidt with whom she had worked on Wrong Turn .",160,164,whom,1,1,2
391JB9X4ZY919IUJSGAPQJ1O4SYKMN,"After having a grant pulled out from under her , Tru is forced to take a job at a local morgue where she discovers her power to `` re-live '' the previous day over again if one of the deceased asks for her help to change what has happened .",15,20,grant,2,4,6
391JB9X4ZY919IUJSGAPQJ1O4SYKMN,"After having a grant pulled out from under her , Tru is forced to take a job at a local morgue where she discovers her power to `` re-live '' the previous day over again if one of the deceased asks for her help to change what has happened .",15,31,grant pulled out,0,1,1
391JB9X4ZY919IUJSGAPQJ1O4SYKMN,"After having a grant pulled out from under her , Tru is forced to take a job at a local morgue where she discovers her power to `` re-live '' the previous day over again if one of the deceased asks for her help to change what has happened .",21,31,pulled out,0,1,1
391JB9X4ZY919IUJSGAPQJ1O4SYKMN,"After having a grant pulled out from under her , Tru is forced to take a job at a local morgue where she discovers her power to `` re-live '' the previous day over again if one of the deceased asks for her help to change what has happened .",82,94,local morgue,0,1,1
391JB9X4ZY919IUJSGAPQJ1O4SYKMN,"After having a grant pulled out from under her , Tru is forced to take a job at a local morgue where she discovers her power to `` re-live '' the previous day over again if one of the deceased asks for her help to change what has happened .",88,94,morgue,10,7,17
391JB9X4ZY919IUJSGAPQJ1O4SYKMN,"After having a grant pulled out from under her , Tru is forced to take a job at a local morgue where she discovers her power to `` re-live '' the previous day over again if one of the deceased asks for her help to change what has happened .",105,114,discovers,1,0,1
391JB9X4ZY919IUJSGAPQJ1O4SYKMN,"After having a grant pulled out from under her , Tru is forced to take a job at a local morgue where she discovers her power to `` re-live '' the previous day over again if one of the deceased asks for her help to change what has happened .",131,138,re-live,2,3,5
391JB9X4ZY919IUJSGAPQJ1O4SYKMN,"After having a grant pulled out from under her , Tru is forced to take a job at a local morgue where she discovers her power to `` re-live '' the previous day over again if one of the deceased asks for her help to change what has happened .",146,154,previous,2,1,3
391JB9X4ZY919IUJSGAPQJ1O4SYKMN,"After having a grant pulled out from under her , Tru is forced to take a job at a local morgue where she discovers her power to `` re-live '' the previous day over again if one of the deceased asks for her help to change what has happened .",184,192,deceased,10,8,18
3IHWR4LC7DEVIY2RYCFU8LLGSJK8IC,"Two years later , on the first night of the 1969 festival , the concert hall was destroyed by fire .",49,57,festival,3,0,3
3IHWR4LC7DEVIY2RYCFU8LLGSJK8IC,"Two years later , on the first night of the 1969 festival , the concert hall was destroyed by fire .",64,71,concert,3,3,6
3IHWR4LC7DEVIY2RYCFU8LLGSJK8IC,"Two years later , on the first night of the 1969 festival , the concert hall was destroyed by fire .",64,76,concert hall,1,2,3
3IHWR4LC7DEVIY2RYCFU8LLGSJK8IC,"Two years later , on the first night of the 1969 festival , the concert hall was destroyed by fire .",81,90,destroyed,0,1,1
3IHWR4LC7DEVIY2RYCFU8LLGSJK8IC,"For that year the Festival was moved to other local venues but by the following year the hall had been rebuilt and once again it was opened by the Queen , this time at the start of the 1970 festival .",18,26,Festival,0,1,1
3IHWR4LC7DEVIY2RYCFU8LLGSJK8IC,"For that year the Festival was moved to other local venues but by the following year the hall had been rebuilt and once again it was opened by the Queen , this time at the start of the 1970 festival .",46,58,local venues,0,1,1
3IHWR4LC7DEVIY2RYCFU8LLGSJK8IC,"For that year the Festival was moved to other local venues but by the following year the hall had been rebuilt and once again it was opened by the Queen , this time at the start of the 1970 festival .",52,58,venues,4,7,11
3IHWR4LC7DEVIY2RYCFU8LLGSJK8IC,"For that year the Festival was moved to other local venues but by the following year the hall had been rebuilt and once again it was opened by the Queen , this time at the start of the 1970 festival .",103,110,rebuilt,1,3,4
3IHWR4LC7DEVIY2RYCFU8LLGSJK8IC,"For that year the Festival was moved to other local venues but by the following year the hall had been rebuilt and once again it was opened by the Queen , this time at the start of the 1970 festival .",147,152,Queen,1,0,1
3IHWR4LC7DEVIY2RYCFU8LLGSJK8IC,"For that year the Festival was moved to other local venues but by the following year the hall had been rebuilt and once again it was opened by the Queen , this time at the start of the 1970 festival .",190,198,festival,1,0,1
3IHWR4LC7DEVIY2RYCFU8LLGSJK8IC,"The festival is now operated by Aldeburgh Music , which also runs the Britten-Pears Young Artist Programme ( formerly the Britten-Pears School for Advanced Musical Studies ) , Aldeburgh Residencies - a program offering bespoke training and development opportunities to UK and international artists - as well as an extensive education program .",4,12,festival,1,0,1
3IHWR4LC7DEVIY2RYCFU8LLGSJK8IC,"The festival is now operated by Aldeburgh Music , which also runs the Britten-Pears Young Artist Programme ( formerly the Britten-Pears School for Advanced Musical Studies ) , Aldeburgh Residencies - a program offering bespoke training and development opportunities to UK and international artists - as well as an extensive education program .",20,28,operated,0,2,2
3IHWR4LC7DEVIY2RYCFU8LLGSJK8IC,"The festival is now operated by Aldeburgh Music , which also runs the Britten-Pears Young Artist Programme ( formerly the Britten-Pears School for Advanced Musical Studies ) , Aldeburgh Residencies - a program offering bespoke training and development opportunities to UK and international artists - as well as an extensive education program .",32,41,Aldeburgh,1,1,2
3IHWR4LC7DEVIY2RYCFU8LLGSJK8IC,"The festival is now operated by Aldeburgh Music , which also runs the Britten-Pears Young Artist Programme ( formerly the Britten-Pears School for Advanced Musical Studies ) , Aldeburgh Residencies - a program offering bespoke training and development opportunities to UK and international artists - as well as an extensive education program .",32,47,Aldeburgh Music,0,1,1
3IHWR4LC7DEVIY2RYCFU8LLGSJK8IC,"The festival is now operated by Aldeburgh Music , which also runs the Britten-Pears Young Artist Programme ( formerly the Britten-Pears School for Advanced Musical Studies ) , Aldeburgh Residencies - a program offering bespoke training and development opportunities to UK and international artists - as well as an extensive education program .",70,83,Britten-Pears,2,1,3
3IHWR4LC7DEVIY2RYCFU8LLGSJK8IC,"The festival is now operated by Aldeburgh Music , which also runs the Britten-Pears Young Artist Programme ( formerly the Britten-Pears School for Advanced Musical Studies ) , Aldeburgh Residencies - a program offering bespoke training and development opportunities to UK and international artists - as well as an extensive education program .",84,106,Young Artist Programme,0,1,1
3IHWR4LC7DEVIY2RYCFU8LLGSJK8IC,"The festival is now operated by Aldeburgh Music , which also runs the Britten-Pears Young Artist Programme ( formerly the Britten-Pears School for Advanced Musical Studies ) , Aldeburgh Residencies - a program offering bespoke training and development opportunities to UK and international artists - as well as an extensive education program .",97,106,Programme,3,1,4
3IHWR4LC7DEVIY2RYCFU8LLGSJK8IC,"The festival is now operated by Aldeburgh Music , which also runs the Britten-Pears Young Artist Programme ( formerly the Britten-Pears School for Advanced Musical Studies ) , Aldeburgh Residencies - a program offering bespoke training and development opportunities to UK and international artists - as well as an extensive education program .",176,185,Aldeburgh,1,1,2
3IHWR4LC7DEVIY2RYCFU8LLGSJK8IC,"The festival is now operated by Aldeburgh Music , which also runs the Britten-Pears Young Artist Programme ( formerly the Britten-Pears School for Advanced Musical Studies ) , Aldeburgh Residencies - a program offering bespoke training and development opportunities to UK and international artists - as well as an extensive education program .",186,197,Residencies,1,0,1
3IHWR4LC7DEVIY2RYCFU8LLGSJK8IC,"The festival is now operated by Aldeburgh Music , which also runs the Britten-Pears Young Artist Programme ( formerly the Britten-Pears School for Advanced Musical Studies ) , Aldeburgh Residencies - a program offering bespoke training and development opportunities to UK and international artists - as well as an extensive education program .",219,226,bespoke,9,9,18
3IHWR4LC7DEVIY2RYCFU8LLGSJK8IC,"The festival is now operated by Aldeburgh Music , which also runs the Britten-Pears Young Artist Programme ( formerly the Britten-Pears School for Advanced Musical Studies ) , Aldeburgh Residencies - a program offering bespoke training and development opportunities to UK and international artists - as well as an extensive education program .",219,235,bespoke training,1,3,4
3IHWR4LC7DEVIY2RYCFU8LLGSJK8IC,"The festival is now operated by Aldeburgh Music , which also runs the Britten-Pears Young Artist Programme ( formerly the Britten-Pears School for Advanced Musical Studies ) , Aldeburgh Residencies - a program offering bespoke training and development opportunities to UK and international artists - as well as an extensive education program .",240,251,development,0,1,1
3IHWR4LC7DEVIY2RYCFU8LLGSJK8IC,"The festival is now operated by Aldeburgh Music , which also runs the Britten-Pears Young Artist Programme ( formerly the Britten-Pears School for Advanced Musical Studies ) , Aldeburgh Residencies - a program offering bespoke training and development opportunities to UK and international artists - as well as an extensive education program .",240,265,development opportunities,2,0,2
3IHWR4LC7DEVIY2RYCFU8LLGSJK8IC,"The festival is now operated by Aldeburgh Music , which also runs the Britten-Pears Young Artist Programme ( formerly the Britten-Pears School for Advanced Musical Studies ) , Aldeburgh Residencies - a program offering bespoke training and development opportunities to UK and international artists - as well as an extensive education program .",252,265,opportunities,2,2,4
3IHWR4LC7DEVIY2RYCFU8LLGSJK8IC,"The festival is now operated by Aldeburgh Music , which also runs the Britten-Pears Young Artist Programme ( formerly the Britten-Pears School for Advanced Musical Studies ) , Aldeburgh Residencies - a program offering bespoke training and development opportunities to UK and international artists - as well as an extensive education program .",276,289,international,0,2,2
3IHWR4LC7DEVIY2RYCFU8LLGSJK8IC,"The festival is now operated by Aldeburgh Music , which also runs the Britten-Pears Young Artist Programme ( formerly the Britten-Pears School for Advanced Musical Studies ) , Aldeburgh Residencies - a program offering bespoke training and development opportunities to UK and international artists - as well as an extensive education program .",314,323,extensive,7,7,14
3IHWR4LC7DEVIY2RYCFU8LLGSJK8IC,"It has seen the premières of several works by Britten ( A Midsummer Night 's Dream in 1960 ; Death in Venice in 1973 ) and also Harrison Birtwistle 's Punch and Judy in 1968 , The Io Passion in 2004 and The Corridor in 2009 .",16,25,premières,10,10,20
3IHWR4LC7DEVIY2RYCFU8LLGSJK8IC,"It has seen the premières of several works by Britten ( A Midsummer Night 's Dream in 1960 ; Death in Venice in 1973 ) and also Harrison Birtwistle 's Punch and Judy in 1968 , The Io Passion in 2004 and The Corridor in 2009 .",137,147,Birtwistle,0,1,1
3IHWR4LC7DEVIY2RYCFU8LLGSJK8IC,"It has seen the premières of several works by Britten ( A Midsummer Night 's Dream in 1960 ; Death in Venice in 1973 ) and also Harrison Birtwistle 's Punch and Judy in 1968 , The Io Passion in 2004 and The Corridor in 2009 .",137,149,Birtwistle s,0,1,1
3IHWR4LC7DEVIY2RYCFU8LLGSJK8IC,"It has seen the premières of several works by Britten ( A Midsummer Night 's Dream in 1960 ; Death in Venice in 1973 ) and also Harrison Birtwistle 's Punch and Judy in 1968 , The Io Passion in 2004 and The Corridor in 2009 .",151,156,Punch,0,1,1
3IHWR4LC7DEVIY2RYCFU8LLGSJK8IC,"It has seen the premières of several works by Britten ( A Midsummer Night 's Dream in 1960 ; Death in Venice in 1973 ) and also Harrison Birtwistle 's Punch and Judy in 1968 , The Io Passion in 2004 and The Corridor in 2009 .",180,182,Io,1,0,1
3IHWR4LC7DEVIY2RYCFU8LLGSJK8IC,"It has seen the premières of several works by Britten ( A Midsummer Night 's Dream in 1960 ; Death in Venice in 1973 ) and also Harrison Birtwistle 's Punch and Judy in 1968 , The Io Passion in 2004 and The Corridor in 2009 .",183,190,Passion,0,1,1
3IHWR4LC7DEVIY2RYCFU8LLGSJK8IC,"It has seen the premières of several works by Britten ( A Midsummer Night 's Dream in 1960 ; Death in Venice in 1973 ) and also Harrison Birtwistle 's Punch and Judy in 1968 , The Io Passion in 2004 and The Corridor in 2009 .",207,215,Corridor,0,3,3
3126F2F5F8448LZMOARE9SIEP0DPE4,Elephants have four molars ; each weighs about 5 kg ( 11 lb ) and measures about 30 cm ( 12 in ) long .,0,9,Elephants,4,0,4
3126F2F5F8448LZMOARE9SIEP0DPE4,Elephants have four molars ; each weighs about 5 kg ( 11 lb ) and measures about 30 cm ( 12 in ) long .,20,26,molars,7,10,17
3126F2F5F8448LZMOARE9SIEP0DPE4,Elephants have four molars ; each weighs about 5 kg ( 11 lb ) and measures about 30 cm ( 12 in ) long .,34,40,weighs,1,0,1
3126F2F5F8448LZMOARE9SIEP0DPE4,Elephants have four molars ; each weighs about 5 kg ( 11 lb ) and measures about 30 cm ( 12 in ) long .,49,51,kg,1,0,1
3126F2F5F8448LZMOARE9SIEP0DPE4,Elephants have four molars ; each weighs about 5 kg ( 11 lb ) and measures about 30 cm ( 12 in ) long .,66,74,measures,1,2,3
3126F2F5F8448LZMOARE9SIEP0DPE4,"As the front pair wears down and drops out in pieces , the back pair shifts forward , and two new molars emerge in the back of the mouth .",18,23,wears,0,3,3
3126F2F5F8448LZMOARE9SIEP0DPE4,"As the front pair wears down and drops out in pieces , the back pair shifts forward , and two new molars emerge in the back of the mouth .",33,38,drops,0,1,1
3126F2F5F8448LZMOARE9SIEP0DPE4,"As the front pair wears down and drops out in pieces , the back pair shifts forward , and two new molars emerge in the back of the mouth .",69,75,shifts,1,3,4
3126F2F5F8448LZMOARE9SIEP0DPE4,"As the front pair wears down and drops out in pieces , the back pair shifts forward , and two new molars emerge in the back of the mouth .",98,104,molars,0,1,1
3126F2F5F8448LZMOARE9SIEP0DPE4,"As the front pair wears down and drops out in pieces , the back pair shifts forward , and two new molars emerge in the back of the mouth .",98,111,molars emerge,2,0,2
3126F2F5F8448LZMOARE9SIEP0DPE4,"As the front pair wears down and drops out in pieces , the back pair shifts forward , and two new molars emerge in the back of the mouth .",105,111,emerge,8,4,12
3126F2F5F8448LZMOARE9SIEP0DPE4,"As the front pair wears down and drops out in pieces , the back pair shifts forward , and two new molars emerge in the back of the mouth .",131,136,mouth,0,1,1
3126F2F5F8448LZMOARE9SIEP0DPE4,"At about 40 to 60 years of age , the elephant no longer has teeth and will likely die of starvation , a common cause of death .",89,99,starvation,10,10,20
3126F2F5F8448LZMOARE9SIEP0DPE4,Their tusks are firm teeth ; the second set of incisors become the tusks .,6,11,tusks,5,9,14
3126F2F5F8448LZMOARE9SIEP0DPE4,Their tusks are firm teeth ; the second set of incisors become the tusks .,16,20,firm,1,1,2
3126F2F5F8448LZMOARE9SIEP0DPE4,Their tusks are firm teeth ; the second set of incisors become the tusks .,47,55,incisors,10,9,19
3126F2F5F8448LZMOARE9SIEP0DPE4,Their tusks are firm teeth ; the second set of incisors become the tusks .,67,72,tusks,0,4,4
3126F2F5F8448LZMOARE9SIEP0DPE4,"They are used for digging for roots and stripping the bark off trees for food , for fighting each other during mating season , and for defending themselves against predators .",18,25,digging,1,5,6
3126F2F5F8448LZMOARE9SIEP0DPE4,"They are used for digging for roots and stripping the bark off trees for food , for fighting each other during mating season , and for defending themselves against predators .",40,49,stripping,4,7,11
3126F2F5F8448LZMOARE9SIEP0DPE4,"They are used for digging for roots and stripping the bark off trees for food , for fighting each other during mating season , and for defending themselves against predators .",54,58,bark,1,2,3
3126F2F5F8448LZMOARE9SIEP0DPE4,"They are used for digging for roots and stripping the bark off trees for food , for fighting each other during mating season , and for defending themselves against predators .",54,62,bark off,0,1,1
3126F2F5F8448LZMOARE9SIEP0DPE4,"They are used for digging for roots and stripping the bark off trees for food , for fighting each other during mating season , and for defending themselves against predators .",54,68,bark off trees,0,1,1
3126F2F5F8448LZMOARE9SIEP0DPE4,"They are used for digging for roots and stripping the bark off trees for food , for fighting each other during mating season , and for defending themselves against predators .",111,117,mating,1,3,4
3126F2F5F8448LZMOARE9SIEP0DPE4,"They are used for digging for roots and stripping the bark off trees for food , for fighting each other during mating season , and for defending themselves against predators .",111,124,mating season,1,2,3
3126F2F5F8448LZMOARE9SIEP0DPE4,"They are used for digging for roots and stripping the bark off trees for food , for fighting each other during mating season , and for defending themselves against predators .",135,144,defending,2,0,2
3126F2F5F8448LZMOARE9SIEP0DPE4,"They are used for digging for roots and stripping the bark off trees for food , for fighting each other during mating season , and for defending themselves against predators .",135,155,defending themselves,1,0,1
3126F2F5F8448LZMOARE9SIEP0DPE4,"They are used for digging for roots and stripping the bark off trees for food , for fighting each other during mating season , and for defending themselves against predators .",145,155,themselves,1,0,1
3126F2F5F8448LZMOARE9SIEP0DPE4,"They are used for digging for roots and stripping the bark off trees for food , for fighting each other during mating season , and for defending themselves against predators .",164,173,predators,10,9,19
3I7KR83SNAEM2YBP376KLXV44TRK9O,"Various species of kauri give diverse resins such as kauri copal , Manilla copal and Dammar gum .",0,7,Various,1,0,1
3I7KR83SNAEM2YBP376KLXV44TRK9O,"Various species of kauri give diverse resins such as kauri copal , Manilla copal and Dammar gum .",0,15,Various species,2,0,2
3I7KR83SNAEM2YBP376KLXV44TRK9O,"Various species of kauri give diverse resins such as kauri copal , Manilla copal and Dammar gum .",8,15,species,3,5,8
3I7KR83SNAEM2YBP376KLXV44TRK9O,"Various species of kauri give diverse resins such as kauri copal , Manilla copal and Dammar gum .",19,24,kauri,8,3,11
3I7KR83SNAEM2YBP376KLXV44TRK9O,"Various species of kauri give diverse resins such as kauri copal , Manilla copal and Dammar gum .",30,37,diverse,4,4,8
3I7KR83SNAEM2YBP376KLXV44TRK9O,"Various species of kauri give diverse resins such as kauri copal , Manilla copal and Dammar gum .",30,44,diverse resins,1,5,6
3I7KR83SNAEM2YBP376KLXV44TRK9O,"Various species of kauri give diverse resins such as kauri copal , Manilla copal and Dammar gum .",38,44,resins,7,2,9
3I7KR83SNAEM2YBP376KLXV44TRK9O,"Various species of kauri give diverse resins such as kauri copal , Manilla copal and Dammar gum .",53,58,kauri,1,0,1
3I7KR83SNAEM2YBP376KLXV44TRK9O,"Various species of kauri give diverse resins such as kauri copal , Manilla copal and Dammar gum .",53,64,kauri copal,3,1,4
3I7KR83SNAEM2YBP376KLXV44TRK9O,"Various species of kauri give diverse resins such as kauri copal , Manilla copal and Dammar gum .",59,64,copal,5,5,10
3I7KR83SNAEM2YBP376KLXV44TRK9O,"Various species of kauri give diverse resins such as kauri copal , Manilla copal and Dammar gum .",67,74,Manilla,1,0,1
3I7KR83SNAEM2YBP376KLXV44TRK9O,"Various species of kauri give diverse resins such as kauri copal , Manilla copal and Dammar gum .",67,80,Manilla copal,1,1,2
3I7KR83SNAEM2YBP376KLXV44TRK9O,"Various species of kauri give diverse resins such as kauri copal , Manilla copal and Dammar gum .",85,91,Dammar,1,0,1
3I7KR83SNAEM2YBP376KLXV44TRK9O,"Various species of kauri give diverse resins such as kauri copal , Manilla copal and Dammar gum .",85,95,Dammar gum,1,3,4
3I7KR83SNAEM2YBP376KLXV44TRK9O,"Various species of kauri give diverse resins such as kauri copal , Manilla copal and Dammar gum .",92,95,gum,0,1,1
3I7KR83SNAEM2YBP376KLXV44TRK9O,"According to the book , Akilam , Hari Gopalan Citar wrote this book on the twenty-seventh day of the Tamil month of Karthikai ( November\/December ) in the year 1841 CE .",24,30,Akilam,1,0,1
3I7KR83SNAEM2YBP376KLXV44TRK9O,"According to the book , Akilam , Hari Gopalan Citar wrote this book on the twenty-seventh day of the Tamil month of Karthikai ( November\/December ) in the year 1841 CE .",75,89,twenty-seventh,1,0,1
3I7KR83SNAEM2YBP376KLXV44TRK9O,"According to the book , Akilam , Hari Gopalan Citar wrote this book on the twenty-seventh day of the Tamil month of Karthikai ( November\/December ) in the year 1841 CE .",101,106,Tamil,2,0,2
3I7KR83SNAEM2YBP376KLXV44TRK9O,"According to the book , Akilam , Hari Gopalan Citar wrote this book on the twenty-seventh day of the Tamil month of Karthikai ( November\/December ) in the year 1841 CE .",101,112,Tamil month,0,1,1
3I7KR83SNAEM2YBP376KLXV44TRK9O,"According to the book , Akilam , Hari Gopalan Citar wrote this book on the twenty-seventh day of the Tamil month of Karthikai ( November\/December ) in the year 1841 CE .",101,125,Tamil month of Karthikai,1,0,1
3I7KR83SNAEM2YBP376KLXV44TRK9O,"According to the book , Akilam , Hari Gopalan Citar wrote this book on the twenty-seventh day of the Tamil month of Karthikai ( November\/December ) in the year 1841 CE .",116,125,Karthikai,4,0,4
3I7KR83SNAEM2YBP376KLXV44TRK9O,"According to the book , Akilam , Hari Gopalan Citar wrote this book on the twenty-seventh day of the Tamil month of Karthikai ( November\/December ) in the year 1841 CE .",166,168,CE,1,1,2
3I7KR83SNAEM2YBP376KLXV44TRK9O,The author claims that God woke him up during his sleep and commissioned him to take dictation of what he said .,11,17,claims,0,2,2
3I7KR83SNAEM2YBP376KLXV44TRK9O,The author claims that God woke him up during his sleep and commissioned him to take dictation of what he said .,60,72,commissioned,10,10,20
3I7KR83SNAEM2YBP376KLXV44TRK9O,The author claims that God woke him up during his sleep and commissioned him to take dictation of what he said .,80,94,take dictation,0,2,2
3I7KR83SNAEM2YBP376KLXV44TRK9O,The author claims that God woke him up during his sleep and commissioned him to take dictation of what he said .,85,94,dictation,7,8,15
3I7KR83SNAEM2YBP376KLXV44TRK9O,"According to the author , the book is the story of God coming in this age , the Kali Yukam or Iron Age , to rule the world by transforming it into the Dharma Yukam .",80,84,Kali,1,0,1
3I7KR83SNAEM2YBP376KLXV44TRK9O,"According to the author , the book is the story of God coming in this age , the Kali Yukam or Iron Age , to rule the world by transforming it into the Dharma Yukam .",80,90,Kali Yukam,3,1,4
3I7KR83SNAEM2YBP376KLXV44TRK9O,"According to the author , the book is the story of God coming in this age , the Kali Yukam or Iron Age , to rule the world by transforming it into the Dharma Yukam .",85,90,Yukam,1,0,1
3I7KR83SNAEM2YBP376KLXV44TRK9O,"According to the author , the book is the story of God coming in this age , the Kali Yukam or Iron Age , to rule the world by transforming it into the Dharma Yukam .",94,102,Iron Age,1,0,1
3I7KR83SNAEM2YBP376KLXV44TRK9O,"According to the author , the book is the story of God coming in this age , the Kali Yukam or Iron Age , to rule the world by transforming it into the Dharma Yukam .",126,138,transforming,7,5,12
3I7KR83SNAEM2YBP376KLXV44TRK9O,"According to the author , the book is the story of God coming in this age , the Kali Yukam or Iron Age , to rule the world by transforming it into the Dharma Yukam .",151,163,Dharma Yukam,0,2,2
3I7KR83SNAEM2YBP376KLXV44TRK9O,This story of faith has woven together the historical facts about Ayya Vaikundar and his activities with reinterpretations of episodes from the Hindu Puranas ( mythologies ) and Itihasas ( epics ) .,14,19,faith,1,2,3
3I7KR83SNAEM2YBP376KLXV44TRK9O,This story of faith has woven together the historical facts about Ayya Vaikundar and his activities with reinterpretations of episodes from the Hindu Puranas ( mythologies ) and Itihasas ( epics ) .,24,29,woven,3,4,7
3I7KR83SNAEM2YBP376KLXV44TRK9O,This story of faith has woven together the historical facts about Ayya Vaikundar and his activities with reinterpretations of episodes from the Hindu Puranas ( mythologies ) and Itihasas ( epics ) .,24,38,woven together,0,1,1
3I7KR83SNAEM2YBP376KLXV44TRK9O,This story of faith has woven together the historical facts about Ayya Vaikundar and his activities with reinterpretations of episodes from the Hindu Puranas ( mythologies ) and Itihasas ( epics ) .,43,53,historical,2,1,3
3I7KR83SNAEM2YBP376KLXV44TRK9O,This story of faith has woven together the historical facts about Ayya Vaikundar and his activities with reinterpretations of episodes from the Hindu Puranas ( mythologies ) and Itihasas ( epics ) .,66,80,Ayya Vaikundar,1,0,1
3I7KR83SNAEM2YBP376KLXV44TRK9O,This story of faith has woven together the historical facts about Ayya Vaikundar and his activities with reinterpretations of episodes from the Hindu Puranas ( mythologies ) and Itihasas ( epics ) .,105,122,reinterpretations,10,10,20
3I7KR83SNAEM2YBP376KLXV44TRK9O,This story of faith has woven together the historical facts about Ayya Vaikundar and his activities with reinterpretations of episodes from the Hindu Puranas ( mythologies ) and Itihasas ( epics ) .,126,134,episodes,1,2,3
3I7KR83SNAEM2YBP376KLXV44TRK9O,This story of faith has woven together the historical facts about Ayya Vaikundar and his activities with reinterpretations of episodes from the Hindu Puranas ( mythologies ) and Itihasas ( epics ) .,150,157,Puranas,1,0,1
3I7KR83SNAEM2YBP376KLXV44TRK9O,This story of faith has woven together the historical facts about Ayya Vaikundar and his activities with reinterpretations of episodes from the Hindu Puranas ( mythologies ) and Itihasas ( epics ) .,160,171,mythologies,3,3,6
3I7KR83SNAEM2YBP376KLXV44TRK9O,This story of faith has woven together the historical facts about Ayya Vaikundar and his activities with reinterpretations of episodes from the Hindu Puranas ( mythologies ) and Itihasas ( epics ) .,178,186,Itihasas,1,0,1
3I7KR83SNAEM2YBP376KLXV44TRK9O,This story of faith has woven together the historical facts about Ayya Vaikundar and his activities with reinterpretations of episodes from the Hindu Puranas ( mythologies ) and Itihasas ( epics ) .,189,194,epics,0,1,1
31JUPBOORN5X8ZAXJFC701D89NE8LQ,The gradual accumulation of decayed plant material in a bog functions as a carbon sink .,4,11,gradual,2,0,2
31JUPBOORN5X8ZAXJFC701D89NE8LQ,The gradual accumulation of decayed plant material in a bog functions as a carbon sink .,4,24,gradual accumulation,1,1,2
31JUPBOORN5X8ZAXJFC701D89NE8LQ,The gradual accumulation of decayed plant material in a bog functions as a carbon sink .,12,24,accumulation,7,8,15
31JUPBOORN5X8ZAXJFC701D89NE8LQ,The gradual accumulation of decayed plant material in a bog functions as a carbon sink .,28,35,decayed,4,10,14
31JUPBOORN5X8ZAXJFC701D89NE8LQ,The gradual accumulation of decayed plant material in a bog functions as a carbon sink .,56,59,bog,3,8,11
31JUPBOORN5X8ZAXJFC701D89NE8LQ,The gradual accumulation of decayed plant material in a bog functions as a carbon sink .,56,69,bog functions,1,0,1
31JUPBOORN5X8ZAXJFC701D89NE8LQ,The gradual accumulation of decayed plant material in a bog functions as a carbon sink .,75,86,carbon sink,2,2,4
31JUPBOORN5X8ZAXJFC701D89NE8LQ,The gradual accumulation of decayed plant material in a bog functions as a carbon sink .,82,86,sink,0,3,3
31JUPBOORN5X8ZAXJFC701D89NE8LQ,"Other names for bogs include mire , quagmire and muskeg ; alkaline mires are called fens .",16,20,bogs,1,0,1
31JUPBOORN5X8ZAXJFC701D89NE8LQ,"Other names for bogs include mire , quagmire and muskeg ; alkaline mires are called fens .",29,33,mire,3,3,6
31JUPBOORN5X8ZAXJFC701D89NE8LQ,"Other names for bogs include mire , quagmire and muskeg ; alkaline mires are called fens .",36,44,quagmire,7,7,14
31JUPBOORN5X8ZAXJFC701D89NE8LQ,"Other names for bogs include mire , quagmire and muskeg ; alkaline mires are called fens .",36,55,quagmire and muskeg,1,0,1
31JUPBOORN5X8ZAXJFC701D89NE8LQ,"Other names for bogs include mire , quagmire and muskeg ; alkaline mires are called fens .",49,55,muskeg,8,6,14
31JUPBOORN5X8ZAXJFC701D89NE8LQ,"Other names for bogs include mire , quagmire and muskeg ; alkaline mires are called fens .",58,66,alkaline,7,3,10
31JUPBOORN5X8ZAXJFC701D89NE8LQ,"Other names for bogs include mire , quagmire and muskeg ; alkaline mires are called fens .",58,72,alkaline mires,2,1,3
31JUPBOORN5X8ZAXJFC701D89NE8LQ,"Other names for bogs include mire , quagmire and muskeg ; alkaline mires are called fens .",67,72,mires,0,1,1
31JUPBOORN5X8ZAXJFC701D89NE8LQ,"Other names for bogs include mire , quagmire and muskeg ; alkaline mires are called fens .",84,88,fens,5,4,9
31JUPBOORN5X8ZAXJFC701D89NE8LQ,"A bog is a mire that accumulates peat , a deposit of dead plant material-often mosses , and in a majority of cases , sphagnum moss .",11,15,mire,1,1,2
31JUPBOORN5X8ZAXJFC701D89NE8LQ,"A bog is a mire that accumulates peat , a deposit of dead plant material-often mosses , and in a majority of cases , sphagnum moss .",21,32,accumulates,2,1,3
31JUPBOORN5X8ZAXJFC701D89NE8LQ,"A bog is a mire that accumulates peat , a deposit of dead plant material-often mosses , and in a majority of cases , sphagnum moss .",33,37,peat,2,8,10
31JUPBOORN5X8ZAXJFC701D89NE8LQ,"A bog is a mire that accumulates peat , a deposit of dead plant material-often mosses , and in a majority of cases , sphagnum moss .",42,49,deposit,1,0,1
31JUPBOORN5X8ZAXJFC701D89NE8LQ,"A bog is a mire that accumulates peat , a deposit of dead plant material-often mosses , and in a majority of cases , sphagnum moss .",64,78,material-often,1,1,2
31JUPBOORN5X8ZAXJFC701D89NE8LQ,"A bog is a mire that accumulates peat , a deposit of dead plant material-often mosses , and in a majority of cases , sphagnum moss .",79,85,mosses,0,6,6
31JUPBOORN5X8ZAXJFC701D89NE8LQ,"A bog is a mire that accumulates peat , a deposit of dead plant material-often mosses , and in a majority of cases , sphagnum moss .",97,114,majority of cases,1,0,1
31JUPBOORN5X8ZAXJFC701D89NE8LQ,"A bog is a mire that accumulates peat , a deposit of dead plant material-often mosses , and in a majority of cases , sphagnum moss .",117,125,sphagnum,3,1,4
31JUPBOORN5X8ZAXJFC701D89NE8LQ,"A bog is a mire that accumulates peat , a deposit of dead plant material-often mosses , and in a majority of cases , sphagnum moss .",117,130,sphagnum moss,1,3,4
31JUPBOORN5X8ZAXJFC701D89NE8LQ,"A bog is a mire that accumulates peat , a deposit of dead plant material-often mosses , and in a majority of cases , sphagnum moss .",126,130,moss,0,1,1
31JUPBOORN5X8ZAXJFC701D89NE8LQ,"Creatine is not an essential nutrient , as it is manufactured in the human body from L-arginine , glycine , and L-methionine .",0,8,Creatine,4,1,5
31JUPBOORN5X8ZAXJFC701D89NE8LQ,"Creatine is not an essential nutrient , as it is manufactured in the human body from L-arginine , glycine , and L-methionine .",19,28,essential,1,1,2
31JUPBOORN5X8ZAXJFC701D89NE8LQ,"Creatine is not an essential nutrient , as it is manufactured in the human body from L-arginine , glycine , and L-methionine .",19,37,essential nutrient,2,0,2
31JUPBOORN5X8ZAXJFC701D89NE8LQ,"Creatine is not an essential nutrient , as it is manufactured in the human body from L-arginine , glycine , and L-methionine .",29,37,nutrient,1,3,4
31JUPBOORN5X8ZAXJFC701D89NE8LQ,"Creatine is not an essential nutrient , as it is manufactured in the human body from L-arginine , glycine , and L-methionine .",85,95,L-arginine,3,0,3
31JUPBOORN5X8ZAXJFC701D89NE8LQ,"Creatine is not an essential nutrient , as it is manufactured in the human body from L-arginine , glycine , and L-methionine .",98,105,glycine,1,0,1
31JUPBOORN5X8ZAXJFC701D89NE8LQ,"Creatine is not an essential nutrient , as it is manufactured in the human body from L-arginine , glycine , and L-methionine .",112,124,L-methionine,2,0,2
31JUPBOORN5X8ZAXJFC701D89NE8LQ,There are fewer other expatriates than in the larger centers of Abu Dhabi and Dubai .,22,33,expatriates,7,10,17
31JUPBOORN5X8ZAXJFC701D89NE8LQ,"Social and governmental infrastructure includes United Arab Emirates University , Higher Colleges of Technology , Abu Dhabi University ( Al Ain campus ) , well-equipped medical facilities including the teaching hospital at Tawam , military training areas and Al Ain International Airport .",24,38,infrastructure,4,8,12
31JUPBOORN5X8ZAXJFC701D89NE8LQ,"Social and governmental infrastructure includes United Arab Emirates University , Higher Colleges of Technology , Abu Dhabi University ( Al Ain campus ) , well-equipped medical facilities including the teaching hospital at Tawam , military training areas and Al Ain International Airport .",124,134,University,1,0,1
31JUPBOORN5X8ZAXJFC701D89NE8LQ,"Social and governmental infrastructure includes United Arab Emirates University , Higher Colleges of Technology , Abu Dhabi University ( Al Ain campus ) , well-equipped medical facilities including the teaching hospital at Tawam , military training areas and Al Ain International Airport .",155,168,well-equipped,1,1,2
31JUPBOORN5X8ZAXJFC701D89NE8LQ,"Social and governmental infrastructure includes United Arab Emirates University , Higher Colleges of Technology , Abu Dhabi University ( Al Ain campus ) , well-equipped medical facilities including the teaching hospital at Tawam , military training areas and Al Ain International Airport .",177,187,facilities,2,1,3
3G4VVJO6PZH7ULRWKW2H7NVJ9X9PKO,"Wikipedia admins can never be absolutely sure about sockpuppetry , and the most abusive users can be very devious in attempting to evade detection .",0,16,Wikipedia admins,1,0,1
3G4VVJO6PZH7ULRWKW2H7NVJ9X9PKO,"Wikipedia admins can never be absolutely sure about sockpuppetry , and the most abusive users can be very devious in attempting to evade detection .",10,16,admins,1,2,3
3G4VVJO6PZH7ULRWKW2H7NVJ9X9PKO,"Wikipedia admins can never be absolutely sure about sockpuppetry , and the most abusive users can be very devious in attempting to evade detection .",30,40,absolutely,4,3,7
3G4VVJO6PZH7ULRWKW2H7NVJ9X9PKO,"Wikipedia admins can never be absolutely sure about sockpuppetry , and the most abusive users can be very devious in attempting to evade detection .",52,64,sockpuppetry,10,10,20
3G4VVJO6PZH7ULRWKW2H7NVJ9X9PKO,"Wikipedia admins can never be absolutely sure about sockpuppetry , and the most abusive users can be very devious in attempting to evade detection .",80,87,abusive,4,2,6
3G4VVJO6PZH7ULRWKW2H7NVJ9X9PKO,"Wikipedia admins can never be absolutely sure about sockpuppetry , and the most abusive users can be very devious in attempting to evade detection .",80,93,abusive users,0,1,1
3G4VVJO6PZH7ULRWKW2H7NVJ9X9PKO,"Wikipedia admins can never be absolutely sure about sockpuppetry , and the most abusive users can be very devious in attempting to evade detection .",106,113,devious,8,10,18
3G4VVJO6PZH7ULRWKW2H7NVJ9X9PKO,"Wikipedia admins can never be absolutely sure about sockpuppetry , and the most abusive users can be very devious in attempting to evade detection .",117,127,attempting,1,0,1
3G4VVJO6PZH7ULRWKW2H7NVJ9X9PKO,"Wikipedia admins can never be absolutely sure about sockpuppetry , and the most abusive users can be very devious in attempting to evade detection .",131,136,evade,6,7,13
3G4VVJO6PZH7ULRWKW2H7NVJ9X9PKO,"Wikipedia admins can never be absolutely sure about sockpuppetry , and the most abusive users can be very devious in attempting to evade detection .",137,146,detection,4,1,5
3G4VVJO6PZH7ULRWKW2H7NVJ9X9PKO,"Even without the use of the Checkuser tool , or with a result of `` unrelated '' , an account that makes the same edits as a different blocked account , has the same linguistic peculiarities and the same general interests may remain blocked under the `` quacks like a duck '' test .",28,37,Checkuser,0,3,3
3G4VVJO6PZH7ULRWKW2H7NVJ9X9PKO,"Even without the use of the Checkuser tool , or with a result of `` unrelated '' , an account that makes the same edits as a different blocked account , has the same linguistic peculiarities and the same general interests may remain blocked under the `` quacks like a duck '' test .",28,42,Checkuser tool,3,0,3
3G4VVJO6PZH7ULRWKW2H7NVJ9X9PKO,"Even without the use of the Checkuser tool , or with a result of `` unrelated '' , an account that makes the same edits as a different blocked account , has the same linguistic peculiarities and the same general interests may remain blocked under the `` quacks like a duck '' test .",135,142,blocked,0,1,1
3G4VVJO6PZH7ULRWKW2H7NVJ9X9PKO,"Even without the use of the Checkuser tool , or with a result of `` unrelated '' , an account that makes the same edits as a different blocked account , has the same linguistic peculiarities and the same general interests may remain blocked under the `` quacks like a duck '' test .",166,176,linguistic,8,4,12
3G4VVJO6PZH7ULRWKW2H7NVJ9X9PKO,"Even without the use of the Checkuser tool , or with a result of `` unrelated '' , an account that makes the same edits as a different blocked account , has the same linguistic peculiarities and the same general interests may remain blocked under the `` quacks like a duck '' test .",166,190,linguistic peculiarities,5,3,8
3G4VVJO6PZH7ULRWKW2H7NVJ9X9PKO,"Even without the use of the Checkuser tool , or with a result of `` unrelated '' , an account that makes the same edits as a different blocked account , has the same linguistic peculiarities and the same general interests may remain blocked under the `` quacks like a duck '' test .",177,190,peculiarities,10,7,17
3G4VVJO6PZH7ULRWKW2H7NVJ9X9PKO,"Even without the use of the Checkuser tool , or with a result of `` unrelated '' , an account that makes the same edits as a different blocked account , has the same linguistic peculiarities and the same general interests may remain blocked under the `` quacks like a duck '' test .",254,260,quacks,2,3,5
3G4VVJO6PZH7ULRWKW2H7NVJ9X9PKO,"Even without the use of the Checkuser tool , or with a result of `` unrelated '' , an account that makes the same edits as a different blocked account , has the same linguistic peculiarities and the same general interests may remain blocked under the `` quacks like a duck '' test .",254,272,quacks like a duck,1,2,3
3G4VVJO6PZH7ULRWKW2H7NVJ9X9PKO,"You , as a blocked editor , are responsible for convincing administrators : It also helps to clearly state your reasons for requesting an unblock because : To make an unblock request , copy the following text to the bottom of your user talk page : -LCB- -LCB- unblock  1 = Insert your reason to be unblocked here -RCB- -RCB- .",11,18,blocked,0,1,1
3G4VVJO6PZH7ULRWKW2H7NVJ9X9PKO,"You , as a blocked editor , are responsible for convincing administrators : It also helps to clearly state your reasons for requesting an unblock because : To make an unblock request , copy the following text to the bottom of your user talk page : -LCB- -LCB- unblock  1 = Insert your reason to be unblocked here -RCB- -RCB- .",11,25,blocked editor,1,0,1
3G4VVJO6PZH7ULRWKW2H7NVJ9X9PKO,"You , as a blocked editor , are responsible for convincing administrators : It also helps to clearly state your reasons for requesting an unblock because : To make an unblock request , copy the following text to the bottom of your user talk page : -LCB- -LCB- unblock  1 = Insert your reason to be unblocked here -RCB- -RCB- .",19,25,editor,1,0,1
3G4VVJO6PZH7ULRWKW2H7NVJ9X9PKO,"You , as a blocked editor , are responsible for convincing administrators : It also helps to clearly state your reasons for requesting an unblock because : To make an unblock request , copy the following text to the bottom of your user talk page : -LCB- -LCB- unblock  1 = Insert your reason to be unblocked here -RCB- -RCB- .",32,43,responsible,1,0,1
3G4VVJO6PZH7ULRWKW2H7NVJ9X9PKO,"You , as a blocked editor , are responsible for convincing administrators : It also helps to clearly state your reasons for requesting an unblock because : To make an unblock request , copy the following text to the bottom of your user talk page : -LCB- -LCB- unblock  1 = Insert your reason to be unblocked here -RCB- -RCB- .",48,58,convincing,6,4,10
3G4VVJO6PZH7ULRWKW2H7NVJ9X9PKO,"You , as a blocked editor , are responsible for convincing administrators : It also helps to clearly state your reasons for requesting an unblock because : To make an unblock request , copy the following text to the bottom of your user talk page : -LCB- -LCB- unblock  1 = Insert your reason to be unblocked here -RCB- -RCB- .",48,73,convincing administrators,0,1,1
3G4VVJO6PZH7ULRWKW2H7NVJ9X9PKO,"You , as a blocked editor , are responsible for convincing administrators : It also helps to clearly state your reasons for requesting an unblock because : To make an unblock request , copy the following text to the bottom of your user talk page : -LCB- -LCB- unblock  1 = Insert your reason to be unblocked here -RCB- -RCB- .",59,73,administrators,2,0,2
3G4VVJO6PZH7ULRWKW2H7NVJ9X9PKO,"You , as a blocked editor , are responsible for convincing administrators : It also helps to clearly state your reasons for requesting an unblock because : To make an unblock request , copy the following text to the bottom of your user talk page : -LCB- -LCB- unblock  1 = Insert your reason to be unblocked here -RCB- -RCB- .",138,145,unblock,1,0,1
3G4VVJO6PZH7ULRWKW2H7NVJ9X9PKO,"You , as a blocked editor , are responsible for convincing administrators : It also helps to clearly state your reasons for requesting an unblock because : To make an unblock request , copy the following text to the bottom of your user talk page : -LCB- -LCB- unblock  1 = Insert your reason to be unblocked here -RCB- -RCB- .",231,245,user talk page,1,0,1
3G4VVJO6PZH7ULRWKW2H7NVJ9X9PKO,"You , as a blocked editor , are responsible for convincing administrators : It also helps to clearly state your reasons for requesting an unblock because : To make an unblock request , copy the following text to the bottom of your user talk page : -LCB- -LCB- unblock  1 = Insert your reason to be unblocked here -RCB- -RCB- .",273,279,Insert,0,1,1
3SCKNODZ0XHJWL8ZLN0GZTL23Y8N7K,"In addition to the traditional metals , lanthanides , actinides , and semimetals , elements such as boron , silicon , arsenic , and selenium are considered to form organometallic compounds , e.g. organoborane compounds such as triethylborane ( Et3B ) .",19,30,traditional,0,2,2
3SCKNODZ0XHJWL8ZLN0GZTL23Y8N7K,"In addition to the traditional metals , lanthanides , actinides , and semimetals , elements such as boron , silicon , arsenic , and selenium are considered to form organometallic compounds , e.g. organoborane compounds such as triethylborane ( Et3B ) .",19,37,traditional metals,1,0,1
3SCKNODZ0XHJWL8ZLN0GZTL23Y8N7K,"In addition to the traditional metals , lanthanides , actinides , and semimetals , elements such as boron , silicon , arsenic , and selenium are considered to form organometallic compounds , e.g. organoborane compounds such as triethylborane ( Et3B ) .",40,51,lanthanides,10,7,17
3SCKNODZ0XHJWL8ZLN0GZTL23Y8N7K,"In addition to the traditional metals , lanthanides , actinides , and semimetals , elements such as boron , silicon , arsenic , and selenium are considered to form organometallic compounds , e.g. organoborane compounds such as triethylborane ( Et3B ) .",40,80,"lanthanides , actinides , and semimetals",1,0,1
3SCKNODZ0XHJWL8ZLN0GZTL23Y8N7K,"In addition to the traditional metals , lanthanides , actinides , and semimetals , elements such as boron , silicon , arsenic , and selenium are considered to form organometallic compounds , e.g. organoborane compounds such as triethylborane ( Et3B ) .",54,63,actinides,0,7,7
3SCKNODZ0XHJWL8ZLN0GZTL23Y8N7K,"In addition to the traditional metals , lanthanides , actinides , and semimetals , elements such as boron , silicon , arsenic , and selenium are considered to form organometallic compounds , e.g. organoborane compounds such as triethylborane ( Et3B ) .",70,80,semimetals,9,5,14
3SCKNODZ0XHJWL8ZLN0GZTL23Y8N7K,"In addition to the traditional metals , lanthanides , actinides , and semimetals , elements such as boron , silicon , arsenic , and selenium are considered to form organometallic compounds , e.g. organoborane compounds such as triethylborane ( Et3B ) .",83,91,elements,1,0,1
3SCKNODZ0XHJWL8ZLN0GZTL23Y8N7K,"In addition to the traditional metals , lanthanides , actinides , and semimetals , elements such as boron , silicon , arsenic , and selenium are considered to form organometallic compounds , e.g. organoborane compounds such as triethylborane ( Et3B ) .",100,105,boron,2,2,4
3SCKNODZ0XHJWL8ZLN0GZTL23Y8N7K,"In addition to the traditional metals , lanthanides , actinides , and semimetals , elements such as boron , silicon , arsenic , and selenium are considered to form organometallic compounds , e.g. organoborane compounds such as triethylborane ( Et3B ) .",100,140,"boron , silicon , arsenic , and selenium",1,0,1
3SCKNODZ0XHJWL8ZLN0GZTL23Y8N7K,"In addition to the traditional metals , lanthanides , actinides , and semimetals , elements such as boron , silicon , arsenic , and selenium are considered to form organometallic compounds , e.g. organoborane compounds such as triethylborane ( Et3B ) .",108,115,silicon,1,0,1
3SCKNODZ0XHJWL8ZLN0GZTL23Y8N7K,"In addition to the traditional metals , lanthanides , actinides , and semimetals , elements such as boron , silicon , arsenic , and selenium are considered to form organometallic compounds , e.g. organoborane compounds such as triethylborane ( Et3B ) .",118,125,arsenic,3,1,4
3SCKNODZ0XHJWL8ZLN0GZTL23Y8N7K,"In addition to the traditional metals , lanthanides , actinides , and semimetals , elements such as boron , silicon , arsenic , and selenium are considered to form organometallic compounds , e.g. organoborane compounds such as triethylborane ( Et3B ) .",132,140,selenium,8,1,9
3SCKNODZ0XHJWL8ZLN0GZTL23Y8N7K,"In addition to the traditional metals , lanthanides , actinides , and semimetals , elements such as boron , silicon , arsenic , and selenium are considered to form organometallic compounds , e.g. organoborane compounds such as triethylborane ( Et3B ) .",164,178,organometallic,10,9,19
3SCKNODZ0XHJWL8ZLN0GZTL23Y8N7K,"In addition to the traditional metals , lanthanides , actinides , and semimetals , elements such as boron , silicon , arsenic , and selenium are considered to form organometallic compounds , e.g. organoborane compounds such as triethylborane ( Et3B ) .",164,188,organometallic compounds,1,3,4
3SCKNODZ0XHJWL8ZLN0GZTL23Y8N7K,"In addition to the traditional metals , lanthanides , actinides , and semimetals , elements such as boron , silicon , arsenic , and selenium are considered to form organometallic compounds , e.g. organoborane compounds such as triethylborane ( Et3B ) .",179,188,compounds,2,2,4
3SCKNODZ0XHJWL8ZLN0GZTL23Y8N7K,"In addition to the traditional metals , lanthanides , actinides , and semimetals , elements such as boron , silicon , arsenic , and selenium are considered to form organometallic compounds , e.g. organoborane compounds such as triethylborane ( Et3B ) .",196,208,organoborane,7,4,11
3SCKNODZ0XHJWL8ZLN0GZTL23Y8N7K,"In addition to the traditional metals , lanthanides , actinides , and semimetals , elements such as boron , silicon , arsenic , and selenium are considered to form organometallic compounds , e.g. organoborane compounds such as triethylborane ( Et3B ) .",196,218,organoborane compounds,0,1,1
3SCKNODZ0XHJWL8ZLN0GZTL23Y8N7K,"In addition to the traditional metals , lanthanides , actinides , and semimetals , elements such as boron , silicon , arsenic , and selenium are considered to form organometallic compounds , e.g. organoborane compounds such as triethylborane ( Et3B ) .",209,218,compounds,1,1,2
3SCKNODZ0XHJWL8ZLN0GZTL23Y8N7K,"In addition to the traditional metals , lanthanides , actinides , and semimetals , elements such as boron , silicon , arsenic , and selenium are considered to form organometallic compounds , e.g. organoborane compounds such as triethylborane ( Et3B ) .",227,241,triethylborane,6,4,10
3SCKNODZ0XHJWL8ZLN0GZTL23Y8N7K,The metal-carbon bond in organometallic compounds is generally of character intermediate between ionic and covalent .,4,16,metal-carbon,2,0,2
3SCKNODZ0XHJWL8ZLN0GZTL23Y8N7K,The metal-carbon bond in organometallic compounds is generally of character intermediate between ionic and covalent .,4,21,metal-carbon bond,0,1,1
3SCKNODZ0XHJWL8ZLN0GZTL23Y8N7K,The metal-carbon bond in organometallic compounds is generally of character intermediate between ionic and covalent .,25,39,organometallic,3,1,4
3SCKNODZ0XHJWL8ZLN0GZTL23Y8N7K,The metal-carbon bond in organometallic compounds is generally of character intermediate between ionic and covalent .,25,49,organometallic compounds,0,1,1
3SCKNODZ0XHJWL8ZLN0GZTL23Y8N7K,The metal-carbon bond in organometallic compounds is generally of character intermediate between ionic and covalent .,40,49,compounds,2,0,2
3SCKNODZ0XHJWL8ZLN0GZTL23Y8N7K,The metal-carbon bond in organometallic compounds is generally of character intermediate between ionic and covalent .,66,88,character intermediate,1,0,1
3SCKNODZ0XHJWL8ZLN0GZTL23Y8N7K,The metal-carbon bond in organometallic compounds is generally of character intermediate between ionic and covalent .,76,88,intermediate,3,7,10
3SCKNODZ0XHJWL8ZLN0GZTL23Y8N7K,The metal-carbon bond in organometallic compounds is generally of character intermediate between ionic and covalent .,97,102,ionic,5,2,7
3SCKNODZ0XHJWL8ZLN0GZTL23Y8N7K,The metal-carbon bond in organometallic compounds is generally of character intermediate between ionic and covalent .,97,115,ionic and covalent,1,1,2
3SCKNODZ0XHJWL8ZLN0GZTL23Y8N7K,The metal-carbon bond in organometallic compounds is generally of character intermediate between ionic and covalent .,107,115,covalent,10,8,18
3SCKNODZ0XHJWL8ZLN0GZTL23Y8N7K,"It is the tallest building in California , the tenth tallest in the United States , the tallest west of the Mississippi River , and the 56th tallest building in the world , by pinnacle height .",10,17,tallest,0,1,1
3SCKNODZ0XHJWL8ZLN0GZTL23Y8N7K,"It is the tallest building in California , the tenth tallest in the United States , the tallest west of the Mississippi River , and the 56th tallest building in the world , by pinnacle height .",47,52,tenth,0,1,1
3SCKNODZ0XHJWL8ZLN0GZTL23Y8N7K,"It is the tallest building in California , the tenth tallest in the United States , the tallest west of the Mississippi River , and the 56th tallest building in the world , by pinnacle height .",53,60,tallest,0,1,1
3SCKNODZ0XHJWL8ZLN0GZTL23Y8N7K,"It is the tallest building in California , the tenth tallest in the United States , the tallest west of the Mississippi River , and the 56th tallest building in the world , by pinnacle height .",88,95,tallest,0,1,1
3SCKNODZ0XHJWL8ZLN0GZTL23Y8N7K,"It is the tallest building in California , the tenth tallest in the United States , the tallest west of the Mississippi River , and the 56th tallest building in the world , by pinnacle height .",141,148,tallest,0,1,1
3SCKNODZ0XHJWL8ZLN0GZTL23Y8N7K,"It is the tallest building in California , the tenth tallest in the United States , the tallest west of the Mississippi River , and the 56th tallest building in the world , by pinnacle height .",176,184,pinnacle,8,9,17
3SCKNODZ0XHJWL8ZLN0GZTL23Y8N7K,"It is the tallest building in California , the tenth tallest in the United States , the tallest west of the Mississippi River , and the 56th tallest building in the world , by pinnacle height .",176,191,pinnacle height,1,1,2
3SCKNODZ0XHJWL8ZLN0GZTL23Y8N7K,"It is the tallest building in California , the tenth tallest in the United States , the tallest west of the Mississippi River , and the 56th tallest building in the world , by pinnacle height .",185,191,height,2,0,2
3SCKNODZ0XHJWL8ZLN0GZTL23Y8N7K,"US Bank Tower , formerly Library Tower and First Interstate Bank World Center , is a 1,018-foot ( 310 m ) skyscraper at 633 West Fifth Street in downtown Los Angeles , California .",49,59,Interstate,0,1,1
3SCKNODZ0XHJWL8ZLN0GZTL23Y8N7K,"US Bank Tower , formerly Library Tower and First Interstate Bank World Center , is a 1,018-foot ( 310 m ) skyscraper at 633 West Fifth Street in downtown Los Angeles , California .",106,116,skyscraper,3,7,10
3SCKNODZ0XHJWL8ZLN0GZTL23Y8N7K,"US Bank Tower , formerly Library Tower and First Interstate Bank World Center , is a 1,018-foot ( 310 m ) skyscraper at 633 West Fifth Street in downtown Los Angeles , California .",145,153,downtown,0,4,4
335HHSX8CD673YNY928PU1Y23X2DHU,"In the museum located on the north side of the lower cloister are wonderful pieces of great Quito sculptors such as the Saint Dominic de Guzmán by Father Carlos , the Saint John of God by Caspicara , and the Saint Thomas Aquinas by Legarda .",7,13,museum,1,3,4
335HHSX8CD673YNY928PU1Y23X2DHU,"In the museum located on the north side of the lower cloister are wonderful pieces of great Quito sculptors such as the Saint Dominic de Guzmán by Father Carlos , the Saint John of God by Caspicara , and the Saint Thomas Aquinas by Legarda .",14,21,located,0,1,1
335HHSX8CD673YNY928PU1Y23X2DHU,"In the museum located on the north side of the lower cloister are wonderful pieces of great Quito sculptors such as the Saint Dominic de Guzmán by Father Carlos , the Saint John of God by Caspicara , and the Saint Thomas Aquinas by Legarda .",47,61,lower cloister,1,0,1
335HHSX8CD673YNY928PU1Y23X2DHU,"In the museum located on the north side of the lower cloister are wonderful pieces of great Quito sculptors such as the Saint Dominic de Guzmán by Father Carlos , the Saint John of God by Caspicara , and the Saint Thomas Aquinas by Legarda .",53,61,cloister,10,10,20
335HHSX8CD673YNY928PU1Y23X2DHU,"In the museum located on the north side of the lower cloister are wonderful pieces of great Quito sculptors such as the Saint Dominic de Guzmán by Father Carlos , the Saint John of God by Caspicara , and the Saint Thomas Aquinas by Legarda .",92,107,Quito sculptors,1,1,2
335HHSX8CD673YNY928PU1Y23X2DHU,"In the museum located on the north side of the lower cloister are wonderful pieces of great Quito sculptors such as the Saint Dominic de Guzmán by Father Carlos , the Saint John of God by Caspicara , and the Saint Thomas Aquinas by Legarda .",98,107,sculptors,4,7,11
335HHSX8CD673YNY928PU1Y23X2DHU,"In the museum located on the north side of the lower cloister are wonderful pieces of great Quito sculptors such as the Saint Dominic de Guzmán by Father Carlos , the Saint John of God by Caspicara , and the Saint Thomas Aquinas by Legarda .",126,143,Dominic de Guzmán,1,0,1
335HHSX8CD673YNY928PU1Y23X2DHU,"In the museum located on the north side of the lower cloister are wonderful pieces of great Quito sculptors such as the Saint Dominic de Guzmán by Father Carlos , the Saint John of God by Caspicara , and the Saint Thomas Aquinas by Legarda .",188,197,Caspicara,2,1,3
335HHSX8CD673YNY928PU1Y23X2DHU,"In the museum located on the north side of the lower cloister are wonderful pieces of great Quito sculptors such as the Saint Dominic de Guzmán by Father Carlos , the Saint John of God by Caspicara , and the Saint Thomas Aquinas by Legarda .",221,228,Aquinas,2,0,2
335HHSX8CD673YNY928PU1Y23X2DHU,"In the museum located on the north side of the lower cloister are wonderful pieces of great Quito sculptors such as the Saint Dominic de Guzmán by Father Carlos , the Saint John of God by Caspicara , and the Saint Thomas Aquinas by Legarda .",232,239,Legarda,2,0,2
335HHSX8CD673YNY928PU1Y23X2DHU,"Its central arch leads to a dome decorated with frescoes of biblical scenes featuring archangels , work by Francisco Albán .",12,16,arch,0,2,2
335HHSX8CD673YNY928PU1Y23X2DHU,"Its central arch leads to a dome decorated with frescoes of biblical scenes featuring archangels , work by Francisco Albán .",28,32,dome,0,3,3
335HHSX8CD673YNY928PU1Y23X2DHU,"Its central arch leads to a dome decorated with frescoes of biblical scenes featuring archangels , work by Francisco Albán .",33,42,decorated,0,1,1
335HHSX8CD673YNY928PU1Y23X2DHU,"Its central arch leads to a dome decorated with frescoes of biblical scenes featuring archangels , work by Francisco Albán .",48,56,frescoes,10,10,20
335HHSX8CD673YNY928PU1Y23X2DHU,"Its central arch leads to a dome decorated with frescoes of biblical scenes featuring archangels , work by Francisco Albán .",60,68,biblical,2,2,4
335HHSX8CD673YNY928PU1Y23X2DHU,"Its central arch leads to a dome decorated with frescoes of biblical scenes featuring archangels , work by Francisco Albán .",76,85,featuring,0,1,1
335HHSX8CD673YNY928PU1Y23X2DHU,"Its central arch leads to a dome decorated with frescoes of biblical scenes featuring archangels , work by Francisco Albán .",86,96,archangels,8,3,11
335HHSX8CD673YNY928PU1Y23X2DHU,"Its central arch leads to a dome decorated with frescoes of biblical scenes featuring archangels , work by Francisco Albán .",107,122,Francisco Albán,2,0,2
335HHSX8CD673YNY928PU1Y23X2DHU,"In 1976 , the Spanish artist Agustín de la Herrán Matorras was commissioned by the religious order of the Oblates to build a 41 metres ( 135 ft ) - tall aluminum monument of a madonna , which was assembled on a high pedestal on the top of Panecillo .",29,58,Agustín de la Herrán Matorras,2,0,2
335HHSX8CD673YNY928PU1Y23X2DHU,"In 1976 , the Spanish artist Agustín de la Herrán Matorras was commissioned by the religious order of the Oblates to build a 41 metres ( 135 ft ) - tall aluminum monument of a madonna , which was assembled on a high pedestal on the top of Panecillo .",63,75,commissioned,8,5,13
335HHSX8CD673YNY928PU1Y23X2DHU,"In 1976 , the Spanish artist Agustín de la Herrán Matorras was commissioned by the religious order of the Oblates to build a 41 metres ( 135 ft ) - tall aluminum monument of a madonna , which was assembled on a high pedestal on the top of Panecillo .",83,92,religious,3,0,3
335HHSX8CD673YNY928PU1Y23X2DHU,"In 1976 , the Spanish artist Agustín de la Herrán Matorras was commissioned by the religious order of the Oblates to build a 41 metres ( 135 ft ) - tall aluminum monument of a madonna , which was assembled on a high pedestal on the top of Panecillo .",83,98,religious order,1,0,1
335HHSX8CD673YNY928PU1Y23X2DHU,"In 1976 , the Spanish artist Agustín de la Herrán Matorras was commissioned by the religious order of the Oblates to build a 41 metres ( 135 ft ) - tall aluminum monument of a madonna , which was assembled on a high pedestal on the top of Panecillo .",106,113,Oblates,3,3,6
335HHSX8CD673YNY928PU1Y23X2DHU,"In 1976 , the Spanish artist Agustín de la Herrán Matorras was commissioned by the religious order of the Oblates to build a 41 metres ( 135 ft ) - tall aluminum monument of a madonna , which was assembled on a high pedestal on the top of Panecillo .",128,134,metres,1,0,1
335HHSX8CD673YNY928PU1Y23X2DHU,"In 1976 , the Spanish artist Agustín de la Herrán Matorras was commissioned by the religious order of the Oblates to build a 41 metres ( 135 ft ) - tall aluminum monument of a madonna , which was assembled on a high pedestal on the top of Panecillo .",153,161,aluminum,4,1,5
335HHSX8CD673YNY928PU1Y23X2DHU,"In 1976 , the Spanish artist Agustín de la Herrán Matorras was commissioned by the religious order of the Oblates to build a 41 metres ( 135 ft ) - tall aluminum monument of a madonna , which was assembled on a high pedestal on the top of Panecillo .",153,170,aluminum monument,1,0,1
335HHSX8CD673YNY928PU1Y23X2DHU,"In 1976 , the Spanish artist Agustín de la Herrán Matorras was commissioned by the religious order of the Oblates to build a 41 metres ( 135 ft ) - tall aluminum monument of a madonna , which was assembled on a high pedestal on the top of Panecillo .",162,170,monument,2,5,7
335HHSX8CD673YNY928PU1Y23X2DHU,"In 1976 , the Spanish artist Agustín de la Herrán Matorras was commissioned by the religious order of the Oblates to build a 41 metres ( 135 ft ) - tall aluminum monument of a madonna , which was assembled on a high pedestal on the top of Panecillo .",176,183,madonna,2,1,3
335HHSX8CD673YNY928PU1Y23X2DHU,"In 1976 , the Spanish artist Agustín de la Herrán Matorras was commissioned by the religious order of the Oblates to build a 41 metres ( 135 ft ) - tall aluminum monument of a madonna , which was assembled on a high pedestal on the top of Panecillo .",196,205,assembled,2,3,5
335HHSX8CD673YNY928PU1Y23X2DHU,"In 1976 , the Spanish artist Agustín de la Herrán Matorras was commissioned by the religious order of the Oblates to build a 41 metres ( 135 ft ) - tall aluminum monument of a madonna , which was assembled on a high pedestal on the top of Panecillo .",216,224,pedestal,5,10,15
335HHSX8CD673YNY928PU1Y23X2DHU,"In 1976 , the Spanish artist Agustín de la Herrán Matorras was commissioned by the religious order of the Oblates to build a 41 metres ( 135 ft ) - tall aluminum monument of a madonna , which was assembled on a high pedestal on the top of Panecillo .",239,248,Panecillo,3,1,4
335HHSX8CD673YNY928PU1Y23X2DHU,"The Historic Centre of Quito is located in the center south of the capital on an area of 320 hectares ( 790 acres ) , and is considered one of the most important historic areas in Latin America .",4,28,Historic Centre of Quito,1,0,1
335HHSX8CD673YNY928PU1Y23X2DHU,"The Historic Centre of Quito is located in the center south of the capital on an area of 320 hectares ( 790 acres ) , and is considered one of the most important historic areas in Latin America .",23,28,Quito,1,0,1
335HHSX8CD673YNY928PU1Y23X2DHU,"The Historic Centre of Quito is located in the center south of the capital on an area of 320 hectares ( 790 acres ) , and is considered one of the most important historic areas in Latin America .",93,101,hectares,4,1,5
335HHSX8CD673YNY928PU1Y23X2DHU,"The Historic Centre of Quito is located in the center south of the capital on an area of 320 hectares ( 790 acres ) , and is considered one of the most important historic areas in Latin America .",162,170,historic,1,1,2
335HHSX8CD673YNY928PU1Y23X2DHU,"The Historic Centre of Quito is located in the center south of the capital on an area of 320 hectares ( 790 acres ) , and is considered one of the most important historic areas in Latin America .",162,176,historic areas,0,1,1
3QX22DUVOOIFPTOVRKOWSSC5KQ5MVB,Alex Chernov AC QC ( born 12 May 1938 ) is an Australian jurist and the current Governor of Victoria .,46,56,Australian,0,1,1
3QX22DUVOOIFPTOVRKOWSSC5KQ5MVB,Alex Chernov AC QC ( born 12 May 1938 ) is an Australian jurist and the current Governor of Victoria .,57,63,jurist,10,9,19
3QX22DUVOOIFPTOVRKOWSSC5KQ5MVB,Alex Chernov AC QC ( born 12 May 1938 ) is an Australian jurist and the current Governor of Victoria .,72,79,current,0,1,1
3QX22DUVOOIFPTOVRKOWSSC5KQ5MVB,"Chernov was born in Lithuania to Russian parents , and migrated with his family to Salzburg , Austria where he commenced his schooling .",12,16,born,0,1,1
3QX22DUVOOIFPTOVRKOWSSC5KQ5MVB,"Chernov was born in Lithuania to Russian parents , and migrated with his family to Salzburg , Austria where he commenced his schooling .",20,29,Lithuania,0,1,1
3QX22DUVOOIFPTOVRKOWSSC5KQ5MVB,"Chernov was born in Lithuania to Russian parents , and migrated with his family to Salzburg , Austria where he commenced his schooling .",55,63,migrated,10,9,19
3QX22DUVOOIFPTOVRKOWSSC5KQ5MVB,"Chernov was born in Lithuania to Russian parents , and migrated with his family to Salzburg , Austria where he commenced his schooling .",83,91,Salzburg,0,1,1
3QX22DUVOOIFPTOVRKOWSSC5KQ5MVB,"Chernov was born in Lithuania to Russian parents , and migrated with his family to Salzburg , Austria where he commenced his schooling .",111,120,commenced,10,8,18
3QX22DUVOOIFPTOVRKOWSSC5KQ5MVB,"Chernov was born in Lithuania to Russian parents , and migrated with his family to Salzburg , Austria where he commenced his schooling .",125,134,schooling,2,1,3
3QX22DUVOOIFPTOVRKOWSSC5KQ5MVB,In 1949 his family migrated to Australia and he completed his schooling at Melbourne High School .,19,27,migrated,3,3,6
3QX22DUVOOIFPTOVRKOWSSC5KQ5MVB,In 1949 his family migrated to Australia and he completed his schooling at Melbourne High School .,62,71,schooling,2,2,4
3QX22DUVOOIFPTOVRKOWSSC5KQ5MVB,"Chernov was admitted to practice and signed the Roll of Counsel as a barrister in 1968 , practising mostly in commercial law and equity .",12,20,admitted,2,2,4
3QX22DUVOOIFPTOVRKOWSSC5KQ5MVB,"Chernov was admitted to practice and signed the Roll of Counsel as a barrister in 1968 , practising mostly in commercial law and equity .",12,32,admitted to practice,1,0,1
3QX22DUVOOIFPTOVRKOWSSC5KQ5MVB,"Chernov was admitted to practice and signed the Roll of Counsel as a barrister in 1968 , practising mostly in commercial law and equity .",24,32,practice,0,1,1
3QX22DUVOOIFPTOVRKOWSSC5KQ5MVB,"Chernov was admitted to practice and signed the Roll of Counsel as a barrister in 1968 , practising mostly in commercial law and equity .",37,43,signed,0,1,1
3QX22DUVOOIFPTOVRKOWSSC5KQ5MVB,"Chernov was admitted to practice and signed the Roll of Counsel as a barrister in 1968 , practising mostly in commercial law and equity .",56,63,Counsel,2,2,4
3QX22DUVOOIFPTOVRKOWSSC5KQ5MVB,"Chernov was admitted to practice and signed the Roll of Counsel as a barrister in 1968 , practising mostly in commercial law and equity .",69,78,barrister,9,6,15
3QX22DUVOOIFPTOVRKOWSSC5KQ5MVB,"Chernov was admitted to practice and signed the Roll of Counsel as a barrister in 1968 , practising mostly in commercial law and equity .",89,99,practising,2,2,4
3QX22DUVOOIFPTOVRKOWSSC5KQ5MVB,"Chernov was admitted to practice and signed the Roll of Counsel as a barrister in 1968 , practising mostly in commercial law and equity .",110,120,commercial,1,2,3
3QX22DUVOOIFPTOVRKOWSSC5KQ5MVB,"Chernov was admitted to practice and signed the Roll of Counsel as a barrister in 1968 , practising mostly in commercial law and equity .",110,124,commercial law,0,1,1
3QX22DUVOOIFPTOVRKOWSSC5KQ5MVB,"Chernov was admitted to practice and signed the Roll of Counsel as a barrister in 1968 , practising mostly in commercial law and equity .",129,135,equity,4,8,12
3QX22DUVOOIFPTOVRKOWSSC5KQ5MVB,"He was Chairman of the Victorian Bar 1985-86 , Vice-President of the Australian Bar Association 1986-87 and President of the Law Council of Australia 1990-91 .",7,15,Chairman,0,1,1
3QX22DUVOOIFPTOVRKOWSSC5KQ5MVB,"He was Chairman of the Victorian Bar 1985-86 , Vice-President of the Australian Bar Association 1986-87 and President of the Law Council of Australia 1990-91 .",69,95,Australian Bar Association,1,0,1
3QX22DUVOOIFPTOVRKOWSSC5KQ5MVB,"He was Chairman of the Victorian Bar 1985-86 , Vice-President of the Australian Bar Association 1986-87 and President of the Law Council of Australia 1990-91 .",80,95,Bar Association,0,1,1
3QX22DUVOOIFPTOVRKOWSSC5KQ5MVB,"He was Chairman of the Victorian Bar 1985-86 , Vice-President of the Australian Bar Association 1986-87 and President of the Law Council of Australia 1990-91 .",125,136,Law Council,0,1,1
3QX22DUVOOIFPTOVRKOWSSC5KQ5MVB,He was the co-author with Robert Brooking AO of Tenancy Law and Practice : Victoria ( 1972 ) and the editor of its second edition ( 1980 ) .,11,20,co-author,2,4,6
3QX22DUVOOIFPTOVRKOWSSC5KQ5MVB,He was the co-author with Robert Brooking AO of Tenancy Law and Practice : Victoria ( 1972 ) and the editor of its second edition ( 1980 ) .,26,41,Robert Brooking,0,1,1
3QX22DUVOOIFPTOVRKOWSSC5KQ5MVB,He was the co-author with Robert Brooking AO of Tenancy Law and Practice : Victoria ( 1972 ) and the editor of its second edition ( 1980 ) .,48,55,Tenancy,2,1,3
3QX22DUVOOIFPTOVRKOWSSC5KQ5MVB,He was the co-author with Robert Brooking AO of Tenancy Law and Practice : Victoria ( 1972 ) and the editor of its second edition ( 1980 ) .,48,59,Tenancy Law,1,1,2
3QX22DUVOOIFPTOVRKOWSSC5KQ5MVB,He was the co-author with Robert Brooking AO of Tenancy Law and Practice : Victoria ( 1972 ) and the editor of its second edition ( 1980 ) .,122,129,edition,1,1,2
3YLTXLH3DF7GSVQOEBZKUVFRHG5PHK,"Alexander succeeded his father , Philip II of Macedon , to the throne in 336 BC after Philip was assassinated .",10,19,succeeded,8,6,14
3YLTXLH3DF7GSVQOEBZKUVFRHG5PHK,"Alexander succeeded his father , Philip II of Macedon , to the throne in 336 BC after Philip was assassinated .",46,53,Macedon,0,1,1
3YLTXLH3DF7GSVQOEBZKUVFRHG5PHK,"Alexander succeeded his father , Philip II of Macedon , to the throne in 336 BC after Philip was assassinated .",63,69,throne,3,1,4
3YLTXLH3DF7GSVQOEBZKUVFRHG5PHK,"Alexander succeeded his father , Philip II of Macedon , to the throne in 336 BC after Philip was assassinated .",97,109,assassinated,10,10,20
3YLTXLH3DF7GSVQOEBZKUVFRHG5PHK,He showed his intent to conquer the entirety of the Persian Empire by throwing a spear into Asian soil and saying he accepted Asia as a gift from the gods .,14,20,intent,3,4,7
3YLTXLH3DF7GSVQOEBZKUVFRHG5PHK,He showed his intent to conquer the entirety of the Persian Empire by throwing a spear into Asian soil and saying he accepted Asia as a gift from the gods .,14,31,intent to conquer,0,1,1
3YLTXLH3DF7GSVQOEBZKUVFRHG5PHK,He showed his intent to conquer the entirety of the Persian Empire by throwing a spear into Asian soil and saying he accepted Asia as a gift from the gods .,24,31,conquer,5,5,10
3YLTXLH3DF7GSVQOEBZKUVFRHG5PHK,He showed his intent to conquer the entirety of the Persian Empire by throwing a spear into Asian soil and saying he accepted Asia as a gift from the gods .,36,44,entirety,8,4,12
3YLTXLH3DF7GSVQOEBZKUVFRHG5PHK,He showed his intent to conquer the entirety of the Persian Empire by throwing a spear into Asian soil and saying he accepted Asia as a gift from the gods .,52,59,Persian,1,0,1
3YLTXLH3DF7GSVQOEBZKUVFRHG5PHK,He showed his intent to conquer the entirety of the Persian Empire by throwing a spear into Asian soil and saying he accepted Asia as a gift from the gods .,52,66,Persian Empire,1,0,1
3YLTXLH3DF7GSVQOEBZKUVFRHG5PHK,He showed his intent to conquer the entirety of the Persian Empire by throwing a spear into Asian soil and saying he accepted Asia as a gift from the gods .,70,78,throwing,0,1,1
3YLTXLH3DF7GSVQOEBZKUVFRHG5PHK,He showed his intent to conquer the entirety of the Persian Empire by throwing a spear into Asian soil and saying he accepted Asia as a gift from the gods .,81,86,spear,0,6,6
3YLTXLH3DF7GSVQOEBZKUVFRHG5PHK,He showed his intent to conquer the entirety of the Persian Empire by throwing a spear into Asian soil and saying he accepted Asia as a gift from the gods .,98,102,soil,1,2,3
3YLTXLH3DF7GSVQOEBZKUVFRHG5PHK,He showed his intent to conquer the entirety of the Persian Empire by throwing a spear into Asian soil and saying he accepted Asia as a gift from the gods .,117,125,accepted,0,1,1
3YLTXLH3DF7GSVQOEBZKUVFRHG5PHK,"Fearing the prospect of facing other large armies and exhausted by years of campaigning , Alexander 's army mutinied at the Hyphasis River , refusing to march further east .",0,7,Fearing,0,1,1
3YLTXLH3DF7GSVQOEBZKUVFRHG5PHK,"Fearing the prospect of facing other large armies and exhausted by years of campaigning , Alexander 's army mutinied at the Hyphasis River , refusing to march further east .",8,23,the prospect of,1,0,1
3YLTXLH3DF7GSVQOEBZKUVFRHG5PHK,"Fearing the prospect of facing other large armies and exhausted by years of campaigning , Alexander 's army mutinied at the Hyphasis River , refusing to march further east .",12,20,prospect,4,3,7
3YLTXLH3DF7GSVQOEBZKUVFRHG5PHK,"Fearing the prospect of facing other large armies and exhausted by years of campaigning , Alexander 's army mutinied at the Hyphasis River , refusing to march further east .",54,63,exhausted,8,8,16
3YLTXLH3DF7GSVQOEBZKUVFRHG5PHK,"Fearing the prospect of facing other large armies and exhausted by years of campaigning , Alexander 's army mutinied at the Hyphasis River , refusing to march further east .",76,87,campaigning,8,2,10
3YLTXLH3DF7GSVQOEBZKUVFRHG5PHK,"Fearing the prospect of facing other large armies and exhausted by years of campaigning , Alexander 's army mutinied at the Hyphasis River , refusing to march further east .",108,116,mutinied,10,10,20
3YLTXLH3DF7GSVQOEBZKUVFRHG5PHK,"Fearing the prospect of facing other large armies and exhausted by years of campaigning , Alexander 's army mutinied at the Hyphasis River , refusing to march further east .",124,132,Hyphasis,1,1,2
3YLTXLH3DF7GSVQOEBZKUVFRHG5PHK,"started as a political youth organization in 2000 and became a political party in January 2006 , running in 2006 elections .",13,41,political youth organization,1,0,1
3YLTXLH3DF7GSVQOEBZKUVFRHG5PHK,"started as a political youth organization in 2000 and became a political party in January 2006 , running in 2006 elections .",63,72,political,0,1,1
3YLTXLH3DF7GSVQOEBZKUVFRHG5PHK,"started as a political youth organization in 2000 and became a political party in January 2006 , running in 2006 elections .",113,122,elections,1,0,1
3YLTXLH3DF7GSVQOEBZKUVFRHG5PHK,"Alfons Maria Mucha ( Czech pronunciation : ( ˈalfons ˈmuxa ) ( listen ) ; 24 July 1860 - 14 July 1939 ) , known in English as Alphonse Mucha , was a Czech Art Nouveau painter and decorative artist , known best for his distinct style .",21,26,Czech,1,1,2
3YLTXLH3DF7GSVQOEBZKUVFRHG5PHK,"Alfons Maria Mucha ( Czech pronunciation : ( ˈalfons ˈmuxa ) ( listen ) ; 24 July 1860 - 14 July 1939 ) , known in English as Alphonse Mucha , was a Czech Art Nouveau painter and decorative artist , known best for his distinct style .",21,40,Czech pronunciation,1,0,1
3YLTXLH3DF7GSVQOEBZKUVFRHG5PHK,"Alfons Maria Mucha ( Czech pronunciation : ( ˈalfons ˈmuxa ) ( listen ) ; 24 July 1860 - 14 July 1939 ) , known in English as Alphonse Mucha , was a Czech Art Nouveau painter and decorative artist , known best for his distinct style .",27,40,pronunciation,3,1,4
3YLTXLH3DF7GSVQOEBZKUVFRHG5PHK,"Alfons Maria Mucha ( Czech pronunciation : ( ˈalfons ˈmuxa ) ( listen ) ; 24 July 1860 - 14 July 1939 ) , known in English as Alphonse Mucha , was a Czech Art Nouveau painter and decorative artist , known best for his distinct style .",45,58,ˈalfons ˈmuxa,1,0,1
3YLTXLH3DF7GSVQOEBZKUVFRHG5PHK,"Alfons Maria Mucha ( Czech pronunciation : ( ˈalfons ˈmuxa ) ( listen ) ; 24 July 1860 - 14 July 1939 ) , known in English as Alphonse Mucha , was a Czech Art Nouveau painter and decorative artist , known best for his distinct style .",149,154,Czech,0,1,1
3YLTXLH3DF7GSVQOEBZKUVFRHG5PHK,"Alfons Maria Mucha ( Czech pronunciation : ( ˈalfons ˈmuxa ) ( listen ) ; 24 July 1860 - 14 July 1939 ) , known in English as Alphonse Mucha , was a Czech Art Nouveau painter and decorative artist , known best for his distinct style .",155,166,Art Nouveau,3,0,3
3YLTXLH3DF7GSVQOEBZKUVFRHG5PHK,"Alfons Maria Mucha ( Czech pronunciation : ( ˈalfons ˈmuxa ) ( listen ) ; 24 July 1860 - 14 July 1939 ) , known in English as Alphonse Mucha , was a Czech Art Nouveau painter and decorative artist , known best for his distinct style .",155,174,Art Nouveau painter,2,0,2
3YLTXLH3DF7GSVQOEBZKUVFRHG5PHK,"Alfons Maria Mucha ( Czech pronunciation : ( ˈalfons ˈmuxa ) ( listen ) ; 24 July 1860 - 14 July 1939 ) , known in English as Alphonse Mucha , was a Czech Art Nouveau painter and decorative artist , known best for his distinct style .",159,166,Nouveau,1,1,2
3YLTXLH3DF7GSVQOEBZKUVFRHG5PHK,"Alfons Maria Mucha ( Czech pronunciation : ( ˈalfons ˈmuxa ) ( listen ) ; 24 July 1860 - 14 July 1939 ) , known in English as Alphonse Mucha , was a Czech Art Nouveau painter and decorative artist , known best for his distinct style .",159,174,Nouveau painter,0,1,1
3YLTXLH3DF7GSVQOEBZKUVFRHG5PHK,"Alfons Maria Mucha ( Czech pronunciation : ( ˈalfons ˈmuxa ) ( listen ) ; 24 July 1860 - 14 July 1939 ) , known in English as Alphonse Mucha , was a Czech Art Nouveau painter and decorative artist , known best for his distinct style .",179,189,decorative,2,2,4
3YLTXLH3DF7GSVQOEBZKUVFRHG5PHK,"Alfons Maria Mucha ( Czech pronunciation : ( ˈalfons ˈmuxa ) ( listen ) ; 24 July 1860 - 14 July 1939 ) , known in English as Alphonse Mucha , was a Czech Art Nouveau painter and decorative artist , known best for his distinct style .",179,196,decorative artist,3,0,3
3YLTXLH3DF7GSVQOEBZKUVFRHG5PHK,"Alfons Maria Mucha ( Czech pronunciation : ( ˈalfons ˈmuxa ) ( listen ) ; 24 July 1860 - 14 July 1939 ) , known in English as Alphonse Mucha , was a Czech Art Nouveau painter and decorative artist , known best for his distinct style .",218,226,distinct,6,5,11
3YLTXLH3DF7GSVQOEBZKUVFRHG5PHK,"Alfons Maria Mucha ( Czech pronunciation : ( ˈalfons ˈmuxa ) ( listen ) ; 24 July 1860 - 14 July 1939 ) , known in English as Alphonse Mucha , was a Czech Art Nouveau painter and decorative artist , known best for his distinct style .",218,232,distinct style,0,1,1
3RHLQY6EDT5DRMZ3UVO60CPYYSGD48,It is presented as if Vishnu is narrating the whole story to his consort Lakshmi .,22,28,Vishnu,0,1,1
3RHLQY6EDT5DRMZ3UVO60CPYYSGD48,It is presented as if Vishnu is narrating the whole story to his consort Lakshmi .,32,41,narrating,7,9,16
3RHLQY6EDT5DRMZ3UVO60CPYYSGD48,It is presented as if Vishnu is narrating the whole story to his consort Lakshmi .,65,72,consort,8,10,18
3RHLQY6EDT5DRMZ3UVO60CPYYSGD48,It is presented as if Vishnu is narrating the whole story to his consort Lakshmi .,73,80,Lakshmi,1,1,2
3RHLQY6EDT5DRMZ3UVO60CPYYSGD48,"Though the Citar Hari Gopalan wrote the book Akilam , he claimed that he did not know any thing about the contents of the book .",11,16,Citar,0,1,1
3RHLQY6EDT5DRMZ3UVO60CPYYSGD48,"Though the Citar Hari Gopalan wrote the book Akilam , he claimed that he did not know any thing about the contents of the book .",45,51,Akilam,2,0,2
3RHLQY6EDT5DRMZ3UVO60CPYYSGD48,"Though the Citar Hari Gopalan wrote the book Akilam , he claimed that he did not know any thing about the contents of the book .",57,64,claimed,1,2,3
3RHLQY6EDT5DRMZ3UVO60CPYYSGD48,"Though the Citar Hari Gopalan wrote the book Akilam , he claimed that he did not know any thing about the contents of the book .",106,114,contents,0,1,1
3RHLQY6EDT5DRMZ3UVO60CPYYSGD48,He woke up in the morning as usual and he did n't know what he had written the day before .,3,10,woke up,0,1,1
3RHLQY6EDT5DRMZ3UVO60CPYYSGD48,He woke up in the morning as usual and he did n't know what he had written the day before .,26,34,as usual,1,0,1
3RHLQY6EDT5DRMZ3UVO60CPYYSGD48,"When Ayya Vaikundar died , the tied-up palm leaf manuscript , which was until then not opened , was unfolded .",10,19,Vaikundar,1,0,1
3RHLQY6EDT5DRMZ3UVO60CPYYSGD48,"When Ayya Vaikundar died , the tied-up palm leaf manuscript , which was until then not opened , was unfolded .",31,38,tied-up,0,4,4
3RHLQY6EDT5DRMZ3UVO60CPYYSGD48,"When Ayya Vaikundar died , the tied-up palm leaf manuscript , which was until then not opened , was unfolded .",31,59,tied-up palm leaf manuscript,1,0,1
3RHLQY6EDT5DRMZ3UVO60CPYYSGD48,"When Ayya Vaikundar died , the tied-up palm leaf manuscript , which was until then not opened , was unfolded .",39,43,palm,1,0,1
3RHLQY6EDT5DRMZ3UVO60CPYYSGD48,"When Ayya Vaikundar died , the tied-up palm leaf manuscript , which was until then not opened , was unfolded .",39,59,palm leaf manuscript,1,1,2
3RHLQY6EDT5DRMZ3UVO60CPYYSGD48,"When Ayya Vaikundar died , the tied-up palm leaf manuscript , which was until then not opened , was unfolded .",49,59,manuscript,6,10,16
3RHLQY6EDT5DRMZ3UVO60CPYYSGD48,"When Ayya Vaikundar died , the tied-up palm leaf manuscript , which was until then not opened , was unfolded .",100,108,unfolded,1,7,8
3RHLQY6EDT5DRMZ3UVO60CPYYSGD48,"As per the instructions found there in Akilam , Ayyavazhi was preached by the Citars far and wide .",39,45,Akilam,1,0,1
3RHLQY6EDT5DRMZ3UVO60CPYYSGD48,"As per the instructions found there in Akilam , Ayyavazhi was preached by the Citars far and wide .",48,57,Ayyavazhi,2,0,2
3RHLQY6EDT5DRMZ3UVO60CPYYSGD48,"As per the instructions found there in Akilam , Ayyavazhi was preached by the Citars far and wide .",62,70,preached,3,3,6
3RHLQY6EDT5DRMZ3UVO60CPYYSGD48,"As per the instructions found there in Akilam , Ayyavazhi was preached by the Citars far and wide .",78,84,Citars,1,1,2
3RHLQY6EDT5DRMZ3UVO60CPYYSGD48,"As per the instructions found there in Akilam , Ayyavazhi was preached by the Citars far and wide .",85,97,far and wide,0,1,1
3RHLQY6EDT5DRMZ3UVO60CPYYSGD48,Western alchemy is recognized as a protoscience that contributed to the development of modern chemistry and medicine .,0,15,Western alchemy,0,1,1
3RHLQY6EDT5DRMZ3UVO60CPYYSGD48,Western alchemy is recognized as a protoscience that contributed to the development of modern chemistry and medicine .,8,15,alchemy,8,5,13
3RHLQY6EDT5DRMZ3UVO60CPYYSGD48,Western alchemy is recognized as a protoscience that contributed to the development of modern chemistry and medicine .,35,47,protoscience,10,10,20
3RHLQY6EDT5DRMZ3UVO60CPYYSGD48,Western alchemy is recognized as a protoscience that contributed to the development of modern chemistry and medicine .,53,64,contributed,1,1,2
3RHLQY6EDT5DRMZ3UVO60CPYYSGD48,Western alchemy is recognized as a protoscience that contributed to the development of modern chemistry and medicine .,72,83,development,1,0,1
3RHLQY6EDT5DRMZ3UVO60CPYYSGD48,Western alchemy is recognized as a protoscience that contributed to the development of modern chemistry and medicine .,94,103,chemistry,1,1,2
3RHLQY6EDT5DRMZ3UVO60CPYYSGD48,"It is a popular belief that alchemists made contributions to the `` chemical '' industries of the day-ore testing and refining , metalworking , production of gunpowder , ink , dyes , paints , cosmetics , leather tanning , ceramics , glass manufacture , preparation of extracts , liquors , and so on ( it seems that the preparation of aqua vitae , the `` water of life '' , was a fairly popular `` experiment '' among European alchemists ) .",28,38,alchemists,5,6,11
3RHLQY6EDT5DRMZ3UVO60CPYYSGD48,"It is a popular belief that alchemists made contributions to the `` chemical '' industries of the day-ore testing and refining , metalworking , production of gunpowder , ink , dyes , paints , cosmetics , leather tanning , ceramics , glass manufacture , preparation of extracts , liquors , and so on ( it seems that the preparation of aqua vitae , the `` water of life '' , was a fairly popular `` experiment '' among European alchemists ) .",68,76,chemical,1,0,1
3RHLQY6EDT5DRMZ3UVO60CPYYSGD48,"It is a popular belief that alchemists made contributions to the `` chemical '' industries of the day-ore testing and refining , metalworking , production of gunpowder , ink , dyes , paints , cosmetics , leather tanning , ceramics , glass manufacture , preparation of extracts , liquors , and so on ( it seems that the preparation of aqua vitae , the `` water of life '' , was a fairly popular `` experiment '' among European alchemists ) .",80,90,industries,1,0,1
3RHLQY6EDT5DRMZ3UVO60CPYYSGD48,"It is a popular belief that alchemists made contributions to the `` chemical '' industries of the day-ore testing and refining , metalworking , production of gunpowder , ink , dyes , paints , cosmetics , leather tanning , ceramics , glass manufacture , preparation of extracts , liquors , and so on ( it seems that the preparation of aqua vitae , the `` water of life '' , was a fairly popular `` experiment '' among European alchemists ) .",98,105,day-ore,1,4,5
3RHLQY6EDT5DRMZ3UVO60CPYYSGD48,"It is a popular belief that alchemists made contributions to the `` chemical '' industries of the day-ore testing and refining , metalworking , production of gunpowder , ink , dyes , paints , cosmetics , leather tanning , ceramics , glass manufacture , preparation of extracts , liquors , and so on ( it seems that the preparation of aqua vitae , the `` water of life '' , was a fairly popular `` experiment '' among European alchemists ) .",118,126,refining,2,1,3
3RHLQY6EDT5DRMZ3UVO60CPYYSGD48,"It is a popular belief that alchemists made contributions to the `` chemical '' industries of the day-ore testing and refining , metalworking , production of gunpowder , ink , dyes , paints , cosmetics , leather tanning , ceramics , glass manufacture , preparation of extracts , liquors , and so on ( it seems that the preparation of aqua vitae , the `` water of life '' , was a fairly popular `` experiment '' among European alchemists ) .",129,141,metalworking,1,2,3
3RHLQY6EDT5DRMZ3UVO60CPYYSGD48,"It is a popular belief that alchemists made contributions to the `` chemical '' industries of the day-ore testing and refining , metalworking , production of gunpowder , ink , dyes , paints , cosmetics , leather tanning , ceramics , glass manufacture , preparation of extracts , liquors , and so on ( it seems that the preparation of aqua vitae , the `` water of life '' , was a fairly popular `` experiment '' among European alchemists ) .",144,154,production,0,2,2
3RHLQY6EDT5DRMZ3UVO60CPYYSGD48,"It is a popular belief that alchemists made contributions to the `` chemical '' industries of the day-ore testing and refining , metalworking , production of gunpowder , ink , dyes , paints , cosmetics , leather tanning , ceramics , glass manufacture , preparation of extracts , liquors , and so on ( it seems that the preparation of aqua vitae , the `` water of life '' , was a fairly popular `` experiment '' among European alchemists ) .",158,167,gunpowder,1,1,2
3RHLQY6EDT5DRMZ3UVO60CPYYSGD48,"It is a popular belief that alchemists made contributions to the `` chemical '' industries of the day-ore testing and refining , metalworking , production of gunpowder , ink , dyes , paints , cosmetics , leather tanning , ceramics , glass manufacture , preparation of extracts , liquors , and so on ( it seems that the preparation of aqua vitae , the `` water of life '' , was a fairly popular `` experiment '' among European alchemists ) .",176,180,dyes,0,1,1
3RHLQY6EDT5DRMZ3UVO60CPYYSGD48,"It is a popular belief that alchemists made contributions to the `` chemical '' industries of the day-ore testing and refining , metalworking , production of gunpowder , ink , dyes , paints , cosmetics , leather tanning , ceramics , glass manufacture , preparation of extracts , liquors , and so on ( it seems that the preparation of aqua vitae , the `` water of life '' , was a fairly popular `` experiment '' among European alchemists ) .",192,201,cosmetics,2,0,2
3RHLQY6EDT5DRMZ3UVO60CPYYSGD48,"It is a popular belief that alchemists made contributions to the `` chemical '' industries of the day-ore testing and refining , metalworking , production of gunpowder , ink , dyes , paints , cosmetics , leather tanning , ceramics , glass manufacture , preparation of extracts , liquors , and so on ( it seems that the preparation of aqua vitae , the `` water of life '' , was a fairly popular `` experiment '' among European alchemists ) .",204,219,leather tanning,2,1,3
3RHLQY6EDT5DRMZ3UVO60CPYYSGD48,"It is a popular belief that alchemists made contributions to the `` chemical '' industries of the day-ore testing and refining , metalworking , production of gunpowder , ink , dyes , paints , cosmetics , leather tanning , ceramics , glass manufacture , preparation of extracts , liquors , and so on ( it seems that the preparation of aqua vitae , the `` water of life '' , was a fairly popular `` experiment '' among European alchemists ) .",212,219,tanning,0,2,2
3RHLQY6EDT5DRMZ3UVO60CPYYSGD48,"It is a popular belief that alchemists made contributions to the `` chemical '' industries of the day-ore testing and refining , metalworking , production of gunpowder , ink , dyes , paints , cosmetics , leather tanning , ceramics , glass manufacture , preparation of extracts , liquors , and so on ( it seems that the preparation of aqua vitae , the `` water of life '' , was a fairly popular `` experiment '' among European alchemists ) .",222,230,ceramics,2,0,2
3RHLQY6EDT5DRMZ3UVO60CPYYSGD48,"It is a popular belief that alchemists made contributions to the `` chemical '' industries of the day-ore testing and refining , metalworking , production of gunpowder , ink , dyes , paints , cosmetics , leather tanning , ceramics , glass manufacture , preparation of extracts , liquors , and so on ( it seems that the preparation of aqua vitae , the `` water of life '' , was a fairly popular `` experiment '' among European alchemists ) .",239,250,manufacture,1,0,1
3RHLQY6EDT5DRMZ3UVO60CPYYSGD48,"It is a popular belief that alchemists made contributions to the `` chemical '' industries of the day-ore testing and refining , metalworking , production of gunpowder , ink , dyes , paints , cosmetics , leather tanning , ceramics , glass manufacture , preparation of extracts , liquors , and so on ( it seems that the preparation of aqua vitae , the `` water of life '' , was a fairly popular `` experiment '' among European alchemists ) .",253,264,preparation,1,0,1
3RHLQY6EDT5DRMZ3UVO60CPYYSGD48,"It is a popular belief that alchemists made contributions to the `` chemical '' industries of the day-ore testing and refining , metalworking , production of gunpowder , ink , dyes , paints , cosmetics , leather tanning , ceramics , glass manufacture , preparation of extracts , liquors , and so on ( it seems that the preparation of aqua vitae , the `` water of life '' , was a fairly popular `` experiment '' among European alchemists ) .",253,276,preparation of extracts,1,0,1
3RHLQY6EDT5DRMZ3UVO60CPYYSGD48,"It is a popular belief that alchemists made contributions to the `` chemical '' industries of the day-ore testing and refining , metalworking , production of gunpowder , ink , dyes , paints , cosmetics , leather tanning , ceramics , glass manufacture , preparation of extracts , liquors , and so on ( it seems that the preparation of aqua vitae , the `` water of life '' , was a fairly popular `` experiment '' among European alchemists ) .",268,276,extracts,5,3,8
3RHLQY6EDT5DRMZ3UVO60CPYYSGD48,"It is a popular belief that alchemists made contributions to the `` chemical '' industries of the day-ore testing and refining , metalworking , production of gunpowder , ink , dyes , paints , cosmetics , leather tanning , ceramics , glass manufacture , preparation of extracts , liquors , and so on ( it seems that the preparation of aqua vitae , the `` water of life '' , was a fairly popular `` experiment '' among European alchemists ) .",278,286, liquors,1,0,1
3RHLQY6EDT5DRMZ3UVO60CPYYSGD48,"It is a popular belief that alchemists made contributions to the `` chemical '' industries of the day-ore testing and refining , metalworking , production of gunpowder , ink , dyes , paints , cosmetics , leather tanning , ceramics , glass manufacture , preparation of extracts , liquors , and so on ( it seems that the preparation of aqua vitae , the `` water of life '' , was a fairly popular `` experiment '' among European alchemists ) .",279,286,liquors,2,0,2
3RHLQY6EDT5DRMZ3UVO60CPYYSGD48,"It is a popular belief that alchemists made contributions to the `` chemical '' industries of the day-ore testing and refining , metalworking , production of gunpowder , ink , dyes , paints , cosmetics , leather tanning , ceramics , glass manufacture , preparation of extracts , liquors , and so on ( it seems that the preparation of aqua vitae , the `` water of life '' , was a fairly popular `` experiment '' among European alchemists ) .",334,344,aqua vitae,7,3,10
3RHLQY6EDT5DRMZ3UVO60CPYYSGD48,"It is a popular belief that alchemists made contributions to the `` chemical '' industries of the day-ore testing and refining , metalworking , production of gunpowder , ink , dyes , paints , cosmetics , leather tanning , ceramics , glass manufacture , preparation of extracts , liquors , and so on ( it seems that the preparation of aqua vitae , the `` water of life '' , was a fairly popular `` experiment '' among European alchemists ) .",339,344,vitae,0,1,1
3RHLQY6EDT5DRMZ3UVO60CPYYSGD48,"It is a popular belief that alchemists made contributions to the `` chemical '' industries of the day-ore testing and refining , metalworking , production of gunpowder , ink , dyes , paints , cosmetics , leather tanning , ceramics , glass manufacture , preparation of extracts , liquors , and so on ( it seems that the preparation of aqua vitae , the `` water of life '' , was a fairly popular `` experiment '' among European alchemists ) .",397,407,experiment,1,0,1
3RHLQY6EDT5DRMZ3UVO60CPYYSGD48,"It is a popular belief that alchemists made contributions to the `` chemical '' industries of the day-ore testing and refining , metalworking , production of gunpowder , ink , dyes , paints , cosmetics , leather tanning , ceramics , glass manufacture , preparation of extracts , liquors , and so on ( it seems that the preparation of aqua vitae , the `` water of life '' , was a fairly popular `` experiment '' among European alchemists ) .",426,436,alchemists,2,1,3
3OID399FXG8NP2WSECKPRGMPNIPFDY,"According to author and graphic designer Tristan Manco and the book Home Sweet Home , Banksy `` was born in 1974 and raised in Bristol , England .",0,9,According,1,0,1
3OID399FXG8NP2WSECKPRGMPNIPFDY,"According to author and graphic designer Tristan Manco and the book Home Sweet Home , Banksy `` was born in 1974 and raised in Bristol , England .",13,19,author,1,0,1
3OID399FXG8NP2WSECKPRGMPNIPFDY,"According to author and graphic designer Tristan Manco and the book Home Sweet Home , Banksy `` was born in 1974 and raised in Bristol , England .",24,31,graphic,2,1,3
3OID399FXG8NP2WSECKPRGMPNIPFDY,"According to author and graphic designer Tristan Manco and the book Home Sweet Home , Banksy `` was born in 1974 and raised in Bristol , England .",24,40,graphic designer,3,3,6
3OID399FXG8NP2WSECKPRGMPNIPFDY,"According to author and graphic designer Tristan Manco and the book Home Sweet Home , Banksy `` was born in 1974 and raised in Bristol , England .",32,40,designer,2,1,3
3OID399FXG8NP2WSECKPRGMPNIPFDY,"According to author and graphic designer Tristan Manco and the book Home Sweet Home , Banksy `` was born in 1974 and raised in Bristol , England .",41,54,Tristan Manco,1,0,1
3OID399FXG8NP2WSECKPRGMPNIPFDY,"According to author and graphic designer Tristan Manco and the book Home Sweet Home , Banksy `` was born in 1974 and raised in Bristol , England .",86,92,Banksy,1,0,1
3OID399FXG8NP2WSECKPRGMPNIPFDY,"According to author and graphic designer Tristan Manco and the book Home Sweet Home , Banksy `` was born in 1974 and raised in Bristol , England .",117,123,raised,0,2,2
3OID399FXG8NP2WSECKPRGMPNIPFDY,Banksy 's work was made up of the Bristol underground scene which involved collaborations between artists and musicians .,42,53,underground,0,4,4
3OID399FXG8NP2WSECKPRGMPNIPFDY,Banksy 's work was made up of the Bristol underground scene which involved collaborations between artists and musicians .,42,59,underground scene,4,0,4
3OID399FXG8NP2WSECKPRGMPNIPFDY,Banksy 's work was made up of the Bristol underground scene which involved collaborations between artists and musicians .,54,59,scene,1,0,1
3OID399FXG8NP2WSECKPRGMPNIPFDY,Banksy 's work was made up of the Bristol underground scene which involved collaborations between artists and musicians .,66,74,involved,0,1,1
3OID399FXG8NP2WSECKPRGMPNIPFDY,Banksy 's work was made up of the Bristol underground scene which involved collaborations between artists and musicians .,75,89,collaborations,10,7,17
3OID399FXG8NP2WSECKPRGMPNIPFDY,"Banksy does not sell photographs or reproductions of his street graffiti , however , art auctioneers have been known to attempt to sell his street art on location and leave the problem of its removal in the hands of the winning bidder .",21,32,photographs,1,1,2
3OID399FXG8NP2WSECKPRGMPNIPFDY,"Banksy does not sell photographs or reproductions of his street graffiti , however , art auctioneers have been known to attempt to sell his street art on location and leave the problem of its removal in the hands of the winning bidder .",36,49,reproductions,5,3,8
3OID399FXG8NP2WSECKPRGMPNIPFDY,"Banksy does not sell photographs or reproductions of his street graffiti , however , art auctioneers have been known to attempt to sell his street art on location and leave the problem of its removal in the hands of the winning bidder .",57,72,street graffiti,2,1,3
3OID399FXG8NP2WSECKPRGMPNIPFDY,"Banksy does not sell photographs or reproductions of his street graffiti , however , art auctioneers have been known to attempt to sell his street art on location and leave the problem of its removal in the hands of the winning bidder .",64,72,graffiti,4,7,11
3OID399FXG8NP2WSECKPRGMPNIPFDY,"Banksy does not sell photographs or reproductions of his street graffiti , however , art auctioneers have been known to attempt to sell his street art on location and leave the problem of its removal in the hands of the winning bidder .",85,100,art auctioneers,1,1,2
3OID399FXG8NP2WSECKPRGMPNIPFDY,"Banksy does not sell photographs or reproductions of his street graffiti , however , art auctioneers have been known to attempt to sell his street art on location and leave the problem of its removal in the hands of the winning bidder .",89,100,auctioneers,10,10,20
3OID399FXG8NP2WSECKPRGMPNIPFDY,"Banksy does not sell photographs or reproductions of his street graffiti , however , art auctioneers have been known to attempt to sell his street art on location and leave the problem of its removal in the hands of the winning bidder .",120,127,attempt,1,1,2
3OID399FXG8NP2WSECKPRGMPNIPFDY,"Banksy does not sell photographs or reproductions of his street graffiti , however , art auctioneers have been known to attempt to sell his street art on location and leave the problem of its removal in the hands of the winning bidder .",192,199,removal,0,1,1
3OID399FXG8NP2WSECKPRGMPNIPFDY,"Banksy does not sell photographs or reproductions of his street graffiti , however , art auctioneers have been known to attempt to sell his street art on location and leave the problem of its removal in the hands of the winning bidder .",220,234,winning bidder,0,1,1
3OID399FXG8NP2WSECKPRGMPNIPFDY,"Banksy does not sell photographs or reproductions of his street graffiti , however , art auctioneers have been known to attempt to sell his street art on location and leave the problem of its removal in the hands of the winning bidder .",228,234,bidder,1,7,8
3OID399FXG8NP2WSECKPRGMPNIPFDY,His satirical street art and subversive epigrams combine dark humor with graffiti executed in a distinctive stencilling technique .,4,13,satirical,10,9,19
3OID399FXG8NP2WSECKPRGMPNIPFDY,His satirical street art and subversive epigrams combine dark humor with graffiti executed in a distinctive stencilling technique .,29,39,subversive,10,6,16
3OID399FXG8NP2WSECKPRGMPNIPFDY,His satirical street art and subversive epigrams combine dark humor with graffiti executed in a distinctive stencilling technique .,29,48,subversive epigrams,5,3,8
3OID399FXG8NP2WSECKPRGMPNIPFDY,His satirical street art and subversive epigrams combine dark humor with graffiti executed in a distinctive stencilling technique .,40,48,epigrams,10,5,15
3OID399FXG8NP2WSECKPRGMPNIPFDY,His satirical street art and subversive epigrams combine dark humor with graffiti executed in a distinctive stencilling technique .,62,67,humor,1,0,1
3OID399FXG8NP2WSECKPRGMPNIPFDY,His satirical street art and subversive epigrams combine dark humor with graffiti executed in a distinctive stencilling technique .,73,81,graffiti,2,2,4
3OID399FXG8NP2WSECKPRGMPNIPFDY,His satirical street art and subversive epigrams combine dark humor with graffiti executed in a distinctive stencilling technique .,82,90,executed,1,0,1
3OID399FXG8NP2WSECKPRGMPNIPFDY,His satirical street art and subversive epigrams combine dark humor with graffiti executed in a distinctive stencilling technique .,96,107,distinctive,5,0,5
3OID399FXG8NP2WSECKPRGMPNIPFDY,His satirical street art and subversive epigrams combine dark humor with graffiti executed in a distinctive stencilling technique .,96,119,distinctive stencilling,0,1,1
3OID399FXG8NP2WSECKPRGMPNIPFDY,His satirical street art and subversive epigrams combine dark humor with graffiti executed in a distinctive stencilling technique .,108,119,stencilling,5,7,12
3OID399FXG8NP2WSECKPRGMPNIPFDY,His satirical street art and subversive epigrams combine dark humor with graffiti executed in a distinctive stencilling technique .,108,129,stencilling technique,2,2,4
3OID399FXG8NP2WSECKPRGMPNIPFDY,His satirical street art and subversive epigrams combine dark humor with graffiti executed in a distinctive stencilling technique .,120,129,technique,1,0,1
3OID399FXG8NP2WSECKPRGMPNIPFDY,"Known for his contempt for the government in labeling graffiti as vandalism , Banksy displays his art on publicly visible surfaces such as walls , even going as far as to build physical prop pieces .",14,22,contempt,1,4,5
3OID399FXG8NP2WSECKPRGMPNIPFDY,"Known for his contempt for the government in labeling graffiti as vandalism , Banksy displays his art on publicly visible surfaces such as walls , even going as far as to build physical prop pieces .",45,53,labeling,0,2,2
3OID399FXG8NP2WSECKPRGMPNIPFDY,"Known for his contempt for the government in labeling graffiti as vandalism , Banksy displays his art on publicly visible surfaces such as walls , even going as far as to build physical prop pieces .",54,62,graffiti,1,1,2
3OID399FXG8NP2WSECKPRGMPNIPFDY,"Known for his contempt for the government in labeling graffiti as vandalism , Banksy displays his art on publicly visible surfaces such as walls , even going as far as to build physical prop pieces .",66,75,vandalism,8,8,16
3OID399FXG8NP2WSECKPRGMPNIPFDY,"Known for his contempt for the government in labeling graffiti as vandalism , Banksy displays his art on publicly visible surfaces such as walls , even going as far as to build physical prop pieces .",177,197,physical prop pieces,1,0,1
3OID399FXG8NP2WSECKPRGMPNIPFDY,"Known for his contempt for the government in labeling graffiti as vandalism , Banksy displays his art on publicly visible surfaces such as walls , even going as far as to build physical prop pieces .",186,190,prop,2,2,4
3OID399FXG8NP2WSECKPRGMPNIPFDY,"Known for his contempt for the government in labeling graffiti as vandalism , Banksy displays his art on publicly visible surfaces such as walls , even going as far as to build physical prop pieces .",186,197,prop pieces,0,1,1
3ZLW647WALW56GIJXSZ6UO6ON1V324,"The Order was the first national decoration awarded by the Japanese Government , created on 10 April 1875 by decree of the Council of State .",24,32,national,2,0,2
3ZLW647WALW56GIJXSZ6UO6ON1V324,"The Order was the first national decoration awarded by the Japanese Government , created on 10 April 1875 by decree of the Council of State .",24,43,national decoration,1,0,1
3ZLW647WALW56GIJXSZ6UO6ON1V324,"The Order was the first national decoration awarded by the Japanese Government , created on 10 April 1875 by decree of the Council of State .",33,43,decoration,6,5,11
3ZLW647WALW56GIJXSZ6UO6ON1V324,"The Order was the first national decoration awarded by the Japanese Government , created on 10 April 1875 by decree of the Council of State .",44,51,awarded,0,3,3
3ZLW647WALW56GIJXSZ6UO6ON1V324,"The Order was the first national decoration awarded by the Japanese Government , created on 10 April 1875 by decree of the Council of State .",109,115,decree,7,10,17
3ZLW647WALW56GIJXSZ6UO6ON1V324,"The Order was awarded in nine classes until 2003 , when the Grand Cordon with Paulownia Flowers was made a separate order , and the lowest two classes were abolished .",14,21,awarded,0,2,2
3ZLW647WALW56GIJXSZ6UO6ON1V324,"The Order was awarded in nine classes until 2003 , when the Grand Cordon with Paulownia Flowers was made a separate order , and the lowest two classes were abolished .",60,72,Grand Cordon,0,1,1
3ZLW647WALW56GIJXSZ6UO6ON1V324,"The Order was awarded in nine classes until 2003 , when the Grand Cordon with Paulownia Flowers was made a separate order , and the lowest two classes were abolished .",60,95,Grand Cordon with Paulownia Flowers,1,0,1
3ZLW647WALW56GIJXSZ6UO6ON1V324,"The Order was awarded in nine classes until 2003 , when the Grand Cordon with Paulownia Flowers was made a separate order , and the lowest two classes were abolished .",78,87,Paulownia,2,1,3
3ZLW647WALW56GIJXSZ6UO6ON1V324,"The Order was awarded in nine classes until 2003 , when the Grand Cordon with Paulownia Flowers was made a separate order , and the lowest two classes were abolished .",78,95,Paulownia Flowers,0,1,1
3ZLW647WALW56GIJXSZ6UO6ON1V324,"The Order was awarded in nine classes until 2003 , when the Grand Cordon with Paulownia Flowers was made a separate order , and the lowest two classes were abolished .",156,165,abolished,10,10,20
3ZLW647WALW56GIJXSZ6UO6ON1V324,"The modern version of this honor has been conferred on non-Japanese recipients beginning in 1981 ( although several foreigners were given the honor before World War II ) ; and women were awarded the Order starting in 2003 ( previously , women were awarded the Order of the Precious Crown ) .",4,18,modern version,0,1,1
3ZLW647WALW56GIJXSZ6UO6ON1V324,"The modern version of this honor has been conferred on non-Japanese recipients beginning in 1981 ( although several foreigners were given the honor before World War II ) ; and women were awarded the Order starting in 2003 ( previously , women were awarded the Order of the Precious Crown ) .",11,18,version,3,1,4
3ZLW647WALW56GIJXSZ6UO6ON1V324,"The modern version of this honor has been conferred on non-Japanese recipients beginning in 1981 ( although several foreigners were given the honor before World War II ) ; and women were awarded the Order starting in 2003 ( previously , women were awarded the Order of the Precious Crown ) .",27,32,honor,0,1,1
3ZLW647WALW56GIJXSZ6UO6ON1V324,"The modern version of this honor has been conferred on non-Japanese recipients beginning in 1981 ( although several foreigners were given the honor before World War II ) ; and women were awarded the Order starting in 2003 ( previously , women were awarded the Order of the Precious Crown ) .",42,51,conferred,9,10,19
3ZLW647WALW56GIJXSZ6UO6ON1V324,"The modern version of this honor has been conferred on non-Japanese recipients beginning in 1981 ( although several foreigners were given the honor before World War II ) ; and women were awarded the Order starting in 2003 ( previously , women were awarded the Order of the Precious Crown ) .",55,67,non-Japanese,0,1,1
3ZLW647WALW56GIJXSZ6UO6ON1V324,"The modern version of this honor has been conferred on non-Japanese recipients beginning in 1981 ( although several foreigners were given the honor before World War II ) ; and women were awarded the Order starting in 2003 ( previously , women were awarded the Order of the Precious Crown ) .",55,78,non-Japanese recipients,0,1,1
3ZLW647WALW56GIJXSZ6UO6ON1V324,"The modern version of this honor has been conferred on non-Japanese recipients beginning in 1981 ( although several foreigners were given the honor before World War II ) ; and women were awarded the Order starting in 2003 ( previously , women were awarded the Order of the Precious Crown ) .",68,78,recipients,9,5,14
3ZLW647WALW56GIJXSZ6UO6ON1V324,"The modern version of this honor has been conferred on non-Japanese recipients beginning in 1981 ( although several foreigners were given the honor before World War II ) ; and women were awarded the Order starting in 2003 ( previously , women were awarded the Order of the Precious Crown ) .",116,126,foreigners,5,2,7
3ZLW647WALW56GIJXSZ6UO6ON1V324,"The modern version of this honor has been conferred on non-Japanese recipients beginning in 1981 ( although several foreigners were given the honor before World War II ) ; and women were awarded the Order starting in 2003 ( previously , women were awarded the Order of the Precious Crown ) .",142,147,honor,2,1,3
3ZLW647WALW56GIJXSZ6UO6ON1V324,"The modern version of this honor has been conferred on non-Japanese recipients beginning in 1981 ( although several foreigners were given the honor before World War II ) ; and women were awarded the Order starting in 2003 ( previously , women were awarded the Order of the Precious Crown ) .",187,194,awarded,0,1,1
3ZLW647WALW56GIJXSZ6UO6ON1V324,"The modern version of this honor has been conferred on non-Japanese recipients beginning in 1981 ( although several foreigners were given the honor before World War II ) ; and women were awarded the Order starting in 2003 ( previously , women were awarded the Order of the Precious Crown ) .",224,234,previously,0,2,2
3ZLW647WALW56GIJXSZ6UO6ON1V324,"The modern version of this honor has been conferred on non-Japanese recipients beginning in 1981 ( although several foreigners were given the honor before World War II ) ; and women were awarded the Order starting in 2003 ( previously , women were awarded the Order of the Precious Crown ) .",248,255,awarded,0,1,1
3ZLW647WALW56GIJXSZ6UO6ON1V324,"The modern version of this honor has been conferred on non-Japanese recipients beginning in 1981 ( although several foreigners were given the honor before World War II ) ; and women were awarded the Order starting in 2003 ( previously , women were awarded the Order of the Precious Crown ) .",273,281,Precious,2,1,3
3ZLW647WALW56GIJXSZ6UO6ON1V324,"The modern version of this honor has been conferred on non-Japanese recipients beginning in 1981 ( although several foreigners were given the honor before World War II ) ; and women were awarded the Order starting in 2003 ( previously , women were awarded the Order of the Precious Crown ) .",273,287,Precious Crown,0,1,1
3ZLW647WALW56GIJXSZ6UO6ON1V324,They called this object Teide 1 and it was found in the Pleiades open cluster .,17,23,object,1,0,1
3ZLW647WALW56GIJXSZ6UO6ON1V324,They called this object Teide 1 and it was found in the Pleiades open cluster .,24,29,Teide,2,0,2
3ZLW647WALW56GIJXSZ6UO6ON1V324,They called this object Teide 1 and it was found in the Pleiades open cluster .,56,64,Pleiades,3,3,6
3ZLW647WALW56GIJXSZ6UO6ON1V324,They called this object Teide 1 and it was found in the Pleiades open cluster .,56,77,Pleiades open cluster,2,2,4
3ZLW647WALW56GIJXSZ6UO6ON1V324,They called this object Teide 1 and it was found in the Pleiades open cluster .,65,77,open cluster,2,0,2
3ZLW647WALW56GIJXSZ6UO6ON1V324,They called this object Teide 1 and it was found in the Pleiades open cluster .,70,77,cluster,3,10,13
36FFXPMST9PY7VENZBM55VA17B9HOV,"Al - ` Ain is located in the Emirate of Abu Dhabi , inland on the border with ` Oman .",0,9,Al -  Ain,1,0,1
36FFXPMST9PY7VENZBM55VA17B9HOV,"Al - ` Ain is located in the Emirate of Abu Dhabi , inland on the border with ` Oman .",14,21,located,1,1,2
36FFXPMST9PY7VENZBM55VA17B9HOV,"Al - ` Ain is located in the Emirate of Abu Dhabi , inland on the border with ` Oman .",25,49,the Emirate of Abu Dhabi,1,0,1
36FFXPMST9PY7VENZBM55VA17B9HOV,"Al - ` Ain is located in the Emirate of Abu Dhabi , inland on the border with ` Oman .",29,36,Emirate,1,1,2
36FFXPMST9PY7VENZBM55VA17B9HOV,"Al - ` Ain is located in the Emirate of Abu Dhabi , inland on the border with ` Oman .",29,49,Emirate of Abu Dhabi,2,0,2
36FFXPMST9PY7VENZBM55VA17B9HOV,"Al - ` Ain is located in the Emirate of Abu Dhabi , inland on the border with ` Oman .",52,58,inland,5,6,11
36FFXPMST9PY7VENZBM55VA17B9HOV,"Al - ` Ain is located in the Emirate of Abu Dhabi , inland on the border with ` Oman .",66,72,border,0,1,1
36FFXPMST9PY7VENZBM55VA17B9HOV,"Al - ` Ain has a higher proportion of Emirati nationals than elsewhere in the country , but the majority of its residents are expatriates particularly from the Indian sub-continent .",15,34,a higher proportion,1,0,1
36FFXPMST9PY7VENZBM55VA17B9HOV,"Al - ` Ain has a higher proportion of Emirati nationals than elsewhere in the country , but the majority of its residents are expatriates particularly from the Indian sub-continent .",17,34,higher proportion,2,1,3
36FFXPMST9PY7VENZBM55VA17B9HOV,"Al - ` Ain has a higher proportion of Emirati nationals than elsewhere in the country , but the majority of its residents are expatriates particularly from the Indian sub-continent .",24,34,proportion,10,5,15
36FFXPMST9PY7VENZBM55VA17B9HOV,"Al - ` Ain has a higher proportion of Emirati nationals than elsewhere in the country , but the majority of its residents are expatriates particularly from the Indian sub-continent .",38,45,Emirati,1,1,2
36FFXPMST9PY7VENZBM55VA17B9HOV,"Al - ` Ain has a higher proportion of Emirati nationals than elsewhere in the country , but the majority of its residents are expatriates particularly from the Indian sub-continent .",38,55,Emirati nationals,4,0,4
36FFXPMST9PY7VENZBM55VA17B9HOV,"Al - ` Ain has a higher proportion of Emirati nationals than elsewhere in the country , but the majority of its residents are expatriates particularly from the Indian sub-continent .",61,70,elsewhere,3,1,4
36FFXPMST9PY7VENZBM55VA17B9HOV,"Al - ` Ain has a higher proportion of Emirati nationals than elsewhere in the country , but the majority of its residents are expatriates particularly from the Indian sub-continent .",96,104,majority,1,1,2
36FFXPMST9PY7VENZBM55VA17B9HOV,"Al - ` Ain has a higher proportion of Emirati nationals than elsewhere in the country , but the majority of its residents are expatriates particularly from the Indian sub-continent .",112,121,residents,1,2,3
36FFXPMST9PY7VENZBM55VA17B9HOV,"Al - ` Ain has a higher proportion of Emirati nationals than elsewhere in the country , but the majority of its residents are expatriates particularly from the Indian sub-continent .",126,137,expatriates,10,10,20
36FFXPMST9PY7VENZBM55VA17B9HOV,"Al - ` Ain has a higher proportion of Emirati nationals than elsewhere in the country , but the majority of its residents are expatriates particularly from the Indian sub-continent .",126,150,expatriates particularly,2,0,2
36FFXPMST9PY7VENZBM55VA17B9HOV,"Al - ` Ain has a higher proportion of Emirati nationals than elsewhere in the country , but the majority of its residents are expatriates particularly from the Indian sub-continent .",138,150,particularly,2,0,2
36FFXPMST9PY7VENZBM55VA17B9HOV,"Al - ` Ain has a higher proportion of Emirati nationals than elsewhere in the country , but the majority of its residents are expatriates particularly from the Indian sub-continent .",160,180,Indian sub-continent,2,0,2
36FFXPMST9PY7VENZBM55VA17B9HOV,"Al - ` Ain has a higher proportion of Emirati nationals than elsewhere in the country , but the majority of its residents are expatriates particularly from the Indian sub-continent .",167,180,sub-continent,4,5,9
36FFXPMST9PY7VENZBM55VA17B9HOV,This performance won Tallari the ` Best Newcomer ' award at the 2008 Man of Ice Awards and ensured his selection for the 2007-08 EIHL All-Star team .,5,16,performance,2,1,3
36FFXPMST9PY7VENZBM55VA17B9HOV,This performance won Tallari the ` Best Newcomer ' award at the 2008 Man of Ice Awards and ensured his selection for the 2007-08 EIHL All-Star team .,21,28,Tallari,1,0,1
36FFXPMST9PY7VENZBM55VA17B9HOV,This performance won Tallari the ` Best Newcomer ' award at the 2008 Man of Ice Awards and ensured his selection for the 2007-08 EIHL All-Star team .,35,48,Best Newcomer,1,0,1
36FFXPMST9PY7VENZBM55VA17B9HOV,This performance won Tallari the ` Best Newcomer ' award at the 2008 Man of Ice Awards and ensured his selection for the 2007-08 EIHL All-Star team .,40,48,Newcomer,0,1,1
36FFXPMST9PY7VENZBM55VA17B9HOV,This performance won Tallari the ` Best Newcomer ' award at the 2008 Man of Ice Awards and ensured his selection for the 2007-08 EIHL All-Star team .,91,98,ensured,6,8,14
36FFXPMST9PY7VENZBM55VA17B9HOV,This performance won Tallari the ` Best Newcomer ' award at the 2008 Man of Ice Awards and ensured his selection for the 2007-08 EIHL All-Star team .,103,112,selection,1,0,1
36FFXPMST9PY7VENZBM55VA17B9HOV,"Tallari moved to the Hartford Wolf Pack , the farm team for the New York Rangers .",8,13,moved,1,0,1
36FFXPMST9PY7VENZBM55VA17B9HOV,"Tallari moved to the Hartford Wolf Pack , the farm team for the New York Rangers .",21,39,Hartford Wolf Pack,2,0,2
36FFXPMST9PY7VENZBM55VA17B9HOV,"Tallari moved to the Hartford Wolf Pack , the farm team for the New York Rangers .",30,39,Wolf Pack,1,0,1
36FFXPMST9PY7VENZBM55VA17B9HOV,"Tallari moved to the Hartford Wolf Pack , the farm team for the New York Rangers .",46,55,farm team,1,0,1
36FFXPMST9PY7VENZBM55VA17B9HOV,In 2001 Tallari began his career playing for Niagara University where he was team 's senior captain .,26,32,career,1,2,3
36FFXPMST9PY7VENZBM55VA17B9HOV,In 2001 Tallari began his career playing for Niagara University where he was team 's senior captain .,45,52,Niagara,0,1,1
36FFXPMST9PY7VENZBM55VA17B9HOV,In 2001 Tallari began his career playing for Niagara University where he was team 's senior captain .,45,63,Niagara University,1,0,1
36FFXPMST9PY7VENZBM55VA17B9HOV,In 2001 Tallari began his career playing for Niagara University where he was team 's senior captain .,64,83,where he was team s,1,0,1
36FFXPMST9PY7VENZBM55VA17B9HOV,In 2001 Tallari began his career playing for Niagara University where he was team 's senior captain .,85,91,senior,1,2,3
36FFXPMST9PY7VENZBM55VA17B9HOV,In 2001 Tallari began his career playing for Niagara University where he was team 's senior captain .,85,99,senior captain,1,0,1
36FFXPMST9PY7VENZBM55VA17B9HOV,"Joe Tallari ( born October 5 , 1980 in Thunder Bay , Ontario ) is a Canadian professional ice hockey player .",77,89,professional,3,3,6
36FFXPMST9PY7VENZBM55VA17B9HOV,"Joe Tallari ( born October 5 , 1980 in Thunder Bay , Ontario ) is a Canadian professional ice hockey player .",77,107,professional ice hockey player,1,0,1
36FFXPMST9PY7VENZBM55VA17B9HOV,"Joe Tallari ( born October 5 , 1980 in Thunder Bay , Ontario ) is a Canadian professional ice hockey player .",90,100,ice hockey,1,0,1
36FFXPMST9PY7VENZBM55VA17B9HOV,"Joe Tallari ( born October 5 , 1980 in Thunder Bay , Ontario ) is a Canadian professional ice hockey player .",90,107,ice hockey player,1,0,1
37PGLWGSJT7FDZ4S71CXYQU7NJEKI7,"They occupy the mass range between the heaviest gas giants and the lightest stars , with an upper limit around 75 to 80 Jupiter masses ( MJ ) .",5,11,occupy,2,0,2
37PGLWGSJT7FDZ4S71CXYQU7NJEKI7,"They occupy the mass range between the heaviest gas giants and the lightest stars , with an upper limit around 75 to 80 Jupiter masses ( MJ ) .",16,20,mass,1,1,2
37PGLWGSJT7FDZ4S71CXYQU7NJEKI7,"They occupy the mass range between the heaviest gas giants and the lightest stars , with an upper limit around 75 to 80 Jupiter masses ( MJ ) .",16,26,mass range,1,0,1
37PGLWGSJT7FDZ4S71CXYQU7NJEKI7,"They occupy the mass range between the heaviest gas giants and the lightest stars , with an upper limit around 75 to 80 Jupiter masses ( MJ ) .",21,26,range,0,2,2
37PGLWGSJT7FDZ4S71CXYQU7NJEKI7,"They occupy the mass range between the heaviest gas giants and the lightest stars , with an upper limit around 75 to 80 Jupiter masses ( MJ ) .",39,47,heaviest,1,2,3
37PGLWGSJT7FDZ4S71CXYQU7NJEKI7,"They occupy the mass range between the heaviest gas giants and the lightest stars , with an upper limit around 75 to 80 Jupiter masses ( MJ ) .",48,58,gas giants,3,1,4
37PGLWGSJT7FDZ4S71CXYQU7NJEKI7,"They occupy the mass range between the heaviest gas giants and the lightest stars , with an upper limit around 75 to 80 Jupiter masses ( MJ ) .",67,75,lightest,0,2,2
37PGLWGSJT7FDZ4S71CXYQU7NJEKI7,"They occupy the mass range between the heaviest gas giants and the lightest stars , with an upper limit around 75 to 80 Jupiter masses ( MJ ) .",92,97,upper,0,1,1
37PGLWGSJT7FDZ4S71CXYQU7NJEKI7,"They occupy the mass range between the heaviest gas giants and the lightest stars , with an upper limit around 75 to 80 Jupiter masses ( MJ ) .",120,127,Jupiter,1,1,2
37PGLWGSJT7FDZ4S71CXYQU7NJEKI7,"They occupy the mass range between the heaviest gas giants and the lightest stars , with an upper limit around 75 to 80 Jupiter masses ( MJ ) .",128,134,masses,1,0,1
37PGLWGSJT7FDZ4S71CXYQU7NJEKI7,"High-quality spectral data acquired by the Keck 1 telescope in November 1995 showed that Teide 1 had kept the initial lithium amount of the original molecular cloud from which Pleiades stars formed , proving the lack of thermonuclear fusion in its core .",0,26,High-quality spectral data,1,0,1
37PGLWGSJT7FDZ4S71CXYQU7NJEKI7,"High-quality spectral data acquired by the Keck 1 telescope in November 1995 showed that Teide 1 had kept the initial lithium amount of the original molecular cloud from which Pleiades stars formed , proving the lack of thermonuclear fusion in its core .",13,21,spectral,8,4,12
37PGLWGSJT7FDZ4S71CXYQU7NJEKI7,"High-quality spectral data acquired by the Keck 1 telescope in November 1995 showed that Teide 1 had kept the initial lithium amount of the original molecular cloud from which Pleiades stars formed , proving the lack of thermonuclear fusion in its core .",13,26,spectral data,4,3,7
37PGLWGSJT7FDZ4S71CXYQU7NJEKI7,"High-quality spectral data acquired by the Keck 1 telescope in November 1995 showed that Teide 1 had kept the initial lithium amount of the original molecular cloud from which Pleiades stars formed , proving the lack of thermonuclear fusion in its core .",27,35,acquired,3,3,6
37PGLWGSJT7FDZ4S71CXYQU7NJEKI7,"High-quality spectral data acquired by the Keck 1 telescope in November 1995 showed that Teide 1 had kept the initial lithium amount of the original molecular cloud from which Pleiades stars formed , proving the lack of thermonuclear fusion in its core .",43,47,Keck,1,0,1
37PGLWGSJT7FDZ4S71CXYQU7NJEKI7,"High-quality spectral data acquired by the Keck 1 telescope in November 1995 showed that Teide 1 had kept the initial lithium amount of the original molecular cloud from which Pleiades stars formed , proving the lack of thermonuclear fusion in its core .",50,59,telescope,2,2,4
37PGLWGSJT7FDZ4S71CXYQU7NJEKI7,"High-quality spectral data acquired by the Keck 1 telescope in November 1995 showed that Teide 1 had kept the initial lithium amount of the original molecular cloud from which Pleiades stars formed , proving the lack of thermonuclear fusion in its core .",89,94,Teide,1,0,1
37PGLWGSJT7FDZ4S71CXYQU7NJEKI7,"High-quality spectral data acquired by the Keck 1 telescope in November 1995 showed that Teide 1 had kept the initial lithium amount of the original molecular cloud from which Pleiades stars formed , proving the lack of thermonuclear fusion in its core .",110,117,initial,4,0,4
37PGLWGSJT7FDZ4S71CXYQU7NJEKI7,"High-quality spectral data acquired by the Keck 1 telescope in November 1995 showed that Teide 1 had kept the initial lithium amount of the original molecular cloud from which Pleiades stars formed , proving the lack of thermonuclear fusion in its core .",118,125,lithium,7,2,9
37PGLWGSJT7FDZ4S71CXYQU7NJEKI7,"High-quality spectral data acquired by the Keck 1 telescope in November 1995 showed that Teide 1 had kept the initial lithium amount of the original molecular cloud from which Pleiades stars formed , proving the lack of thermonuclear fusion in its core .",140,148,original,0,1,1
37PGLWGSJT7FDZ4S71CXYQU7NJEKI7,"High-quality spectral data acquired by the Keck 1 telescope in November 1995 showed that Teide 1 had kept the initial lithium amount of the original molecular cloud from which Pleiades stars formed , proving the lack of thermonuclear fusion in its core .",140,164,original molecular cloud,0,1,1
37PGLWGSJT7FDZ4S71CXYQU7NJEKI7,"High-quality spectral data acquired by the Keck 1 telescope in November 1995 showed that Teide 1 had kept the initial lithium amount of the original molecular cloud from which Pleiades stars formed , proving the lack of thermonuclear fusion in its core .",149,158,molecular,7,1,8
37PGLWGSJT7FDZ4S71CXYQU7NJEKI7,"High-quality spectral data acquired by the Keck 1 telescope in November 1995 showed that Teide 1 had kept the initial lithium amount of the original molecular cloud from which Pleiades stars formed , proving the lack of thermonuclear fusion in its core .",149,164,molecular cloud,3,1,4
37PGLWGSJT7FDZ4S71CXYQU7NJEKI7,"High-quality spectral data acquired by the Keck 1 telescope in November 1995 showed that Teide 1 had kept the initial lithium amount of the original molecular cloud from which Pleiades stars formed , proving the lack of thermonuclear fusion in its core .",176,184,Pleiades,4,0,4
37PGLWGSJT7FDZ4S71CXYQU7NJEKI7,"High-quality spectral data acquired by the Keck 1 telescope in November 1995 showed that Teide 1 had kept the initial lithium amount of the original molecular cloud from which Pleiades stars formed , proving the lack of thermonuclear fusion in its core .",220,233,thermonuclear,7,3,10
37PGLWGSJT7FDZ4S71CXYQU7NJEKI7,"High-quality spectral data acquired by the Keck 1 telescope in November 1995 showed that Teide 1 had kept the initial lithium amount of the original molecular cloud from which Pleiades stars formed , proving the lack of thermonuclear fusion in its core .",220,240,thermonuclear fusion,6,4,10
37PGLWGSJT7FDZ4S71CXYQU7NJEKI7,"High-quality spectral data acquired by the Keck 1 telescope in November 1995 showed that Teide 1 had kept the initial lithium amount of the original molecular cloud from which Pleiades stars formed , proving the lack of thermonuclear fusion in its core .",234,240,fusion,1,2,3
37PGLWGSJT7FDZ4S71CXYQU7NJEKI7,"High-quality spectral data acquired by the Keck 1 telescope in November 1995 showed that Teide 1 had kept the initial lithium amount of the original molecular cloud from which Pleiades stars formed , proving the lack of thermonuclear fusion in its core .",248,252,core,0,4,4
37PGLWGSJT7FDZ4S71CXYQU7NJEKI7,"In 1995 , the study of brown dwarfs changed substantially with the discovery of two incontrovertible substellar objects ( Teide 1 and Gliese 229B ) , which were identified by the presence of the 670.8 nm lithium line .",23,35,brown dwarfs,1,2,3
37PGLWGSJT7FDZ4S71CXYQU7NJEKI7,"In 1995 , the study of brown dwarfs changed substantially with the discovery of two incontrovertible substellar objects ( Teide 1 and Gliese 229B ) , which were identified by the presence of the 670.8 nm lithium line .",29,35,dwarfs,5,6,11
37PGLWGSJT7FDZ4S71CXYQU7NJEKI7,"In 1995 , the study of brown dwarfs changed substantially with the discovery of two incontrovertible substellar objects ( Teide 1 and Gliese 229B ) , which were identified by the presence of the 670.8 nm lithium line .",44,57,substantially,9,5,14
37PGLWGSJT7FDZ4S71CXYQU7NJEKI7,"In 1995 , the study of brown dwarfs changed substantially with the discovery of two incontrovertible substellar objects ( Teide 1 and Gliese 229B ) , which were identified by the presence of the 670.8 nm lithium line .",84,100,incontrovertible,10,6,16
37PGLWGSJT7FDZ4S71CXYQU7NJEKI7,"In 1995 , the study of brown dwarfs changed substantially with the discovery of two incontrovertible substellar objects ( Teide 1 and Gliese 229B ) , which were identified by the presence of the 670.8 nm lithium line .",84,111,incontrovertible substellar,2,3,5
37PGLWGSJT7FDZ4S71CXYQU7NJEKI7,"In 1995 , the study of brown dwarfs changed substantially with the discovery of two incontrovertible substellar objects ( Teide 1 and Gliese 229B ) , which were identified by the presence of the 670.8 nm lithium line .",84,119,incontrovertible substellar objects,1,0,1
37PGLWGSJT7FDZ4S71CXYQU7NJEKI7,"In 1995 , the study of brown dwarfs changed substantially with the discovery of two incontrovertible substellar objects ( Teide 1 and Gliese 229B ) , which were identified by the presence of the 670.8 nm lithium line .",101,111,substellar,7,3,10
37PGLWGSJT7FDZ4S71CXYQU7NJEKI7,"In 1995 , the study of brown dwarfs changed substantially with the discovery of two incontrovertible substellar objects ( Teide 1 and Gliese 229B ) , which were identified by the presence of the 670.8 nm lithium line .",101,119,substellar objects,1,1,2
37PGLWGSJT7FDZ4S71CXYQU7NJEKI7,"In 1995 , the study of brown dwarfs changed substantially with the discovery of two incontrovertible substellar objects ( Teide 1 and Gliese 229B ) , which were identified by the presence of the 670.8 nm lithium line .",134,140,Gliese,1,0,1
37PGLWGSJT7FDZ4S71CXYQU7NJEKI7,"In 1995 , the study of brown dwarfs changed substantially with the discovery of two incontrovertible substellar objects ( Teide 1 and Gliese 229B ) , which were identified by the presence of the 670.8 nm lithium line .",179,187,presence,1,0,1
37PGLWGSJT7FDZ4S71CXYQU7NJEKI7,"In 1995 , the study of brown dwarfs changed substantially with the discovery of two incontrovertible substellar objects ( Teide 1 and Gliese 229B ) , which were identified by the presence of the 670.8 nm lithium line .",204,211,lithium,2,0,2
37PGLWGSJT7FDZ4S71CXYQU7NJEKI7,"Nonetheless , one school of thought is based on formation ; another , on physics in the interior .",0,11,Nonetheless,3,1,4
37PGLWGSJT7FDZ4S71CXYQU7NJEKI7,"Nonetheless , one school of thought is based on formation ; another , on physics in the interior .",18,35,school of thought,1,0,1
37PGLWGSJT7FDZ4S71CXYQU7NJEKI7,"Nonetheless , one school of thought is based on formation ; another , on physics in the interior .",48,57,formation,1,1,2
37PGLWGSJT7FDZ4S71CXYQU7NJEKI7,"Nonetheless , one school of thought is based on formation ; another , on physics in the interior .",73,80,physics,1,0,1
37PGLWGSJT7FDZ4S71CXYQU7NJEKI7,"Nonetheless , one school of thought is based on formation ; another , on physics in the interior .",88,96,interior,1,2,3
388CL5C1RJOQ1ABQMJ6DDE67C64HLE,"Currently , it is marketed in Belgium , Brazil , Hong Kong , Italy , Japan , Luxembourg , Macau , Morocco , Netherlands , Peru , Portugal , Spain and Taiwan and the majority of its consumers are non-athletes .",0,9,Currently,1,2,3
388CL5C1RJOQ1ABQMJ6DDE67C64HLE,"Currently , it is marketed in Belgium , Brazil , Hong Kong , Italy , Japan , Luxembourg , Macau , Morocco , Netherlands , Peru , Portugal , Spain and Taiwan and the majority of its consumers are non-athletes .",18,26,marketed,3,6,9
388CL5C1RJOQ1ABQMJ6DDE67C64HLE,"Currently , it is marketed in Belgium , Brazil , Hong Kong , Italy , Japan , Luxembourg , Macau , Morocco , Netherlands , Peru , Portugal , Spain and Taiwan and the majority of its consumers are non-athletes .",77,87,Luxembourg,2,0,2
388CL5C1RJOQ1ABQMJ6DDE67C64HLE,"Currently , it is marketed in Belgium , Brazil , Hong Kong , Italy , Japan , Luxembourg , Macau , Morocco , Netherlands , Peru , Portugal , Spain and Taiwan and the majority of its consumers are non-athletes .",165,173,majority,3,1,4
388CL5C1RJOQ1ABQMJ6DDE67C64HLE,"Currently , it is marketed in Belgium , Brazil , Hong Kong , Italy , Japan , Luxembourg , Macau , Morocco , Netherlands , Peru , Portugal , Spain and Taiwan and the majority of its consumers are non-athletes .",165,190,majority of its consumers,1,0,1
388CL5C1RJOQ1ABQMJ6DDE67C64HLE,"Currently , it is marketed in Belgium , Brazil , Hong Kong , Italy , Japan , Luxembourg , Macau , Morocco , Netherlands , Peru , Portugal , Spain and Taiwan and the majority of its consumers are non-athletes .",181,190,consumers,3,1,4
388CL5C1RJOQ1ABQMJ6DDE67C64HLE,"Currently , it is marketed in Belgium , Brazil , Hong Kong , Italy , Japan , Luxembourg , Macau , Morocco , Netherlands , Peru , Portugal , Spain and Taiwan and the majority of its consumers are non-athletes .",195,207,non-athletes,2,2,4
388CL5C1RJOQ1ABQMJ6DDE67C64HLE,"Aquarius is available in the following flavors : Carrot Orange , Citrus Blend , Grapefruit , Honey Lemon , Lemon , Orange , Watermelon and Coca-Cola .",0,8,Aquarius,5,2,7
388CL5C1RJOQ1ABQMJ6DDE67C64HLE,"Aquarius is available in the following flavors : Carrot Orange , Citrus Blend , Grapefruit , Honey Lemon , Lemon , Orange , Watermelon and Coca-Cola .",12,21,available,0,1,1
388CL5C1RJOQ1ABQMJ6DDE67C64HLE,"Aquarius is available in the following flavors : Carrot Orange , Citrus Blend , Grapefruit , Honey Lemon , Lemon , Orange , Watermelon and Coca-Cola .",39,46,flavors,0,3,3
388CL5C1RJOQ1ABQMJ6DDE67C64HLE,"Aquarius is available in the following flavors : Carrot Orange , Citrus Blend , Grapefruit , Honey Lemon , Lemon , Orange , Watermelon and Coca-Cola .",72,77,Blend,0,1,1
388CL5C1RJOQ1ABQMJ6DDE67C64HLE,"An archivist ( `` AR-kiv-ist '' or `` AR-kive-ist '' ) is a professional who assesses , collects , organizes , preserves , maintains control over , and provides access to information determined to have long-term value .",3,12,archivist,10,2,12
388CL5C1RJOQ1ABQMJ6DDE67C64HLE,"An archivist ( `` AR-kiv-ist '' or `` AR-kive-ist '' ) is a professional who assesses , collects , organizes , preserves , maintains control over , and provides access to information determined to have long-term value .",18,28,AR-kiv-ist,2,0,2
388CL5C1RJOQ1ABQMJ6DDE67C64HLE,"An archivist ( `` AR-kiv-ist '' or `` AR-kive-ist '' ) is a professional who assesses , collects , organizes , preserves , maintains control over , and provides access to information determined to have long-term value .",38,49,AR-kive-ist,1,0,1
388CL5C1RJOQ1ABQMJ6DDE67C64HLE,"An archivist ( `` AR-kiv-ist '' or `` AR-kive-ist '' ) is a professional who assesses , collects , organizes , preserves , maintains control over , and provides access to information determined to have long-term value .",60,72,professional,1,4,5
388CL5C1RJOQ1ABQMJ6DDE67C64HLE,"An archivist ( `` AR-kiv-ist '' or `` AR-kive-ist '' ) is a professional who assesses , collects , organizes , preserves , maintains control over , and provides access to information determined to have long-term value .",77,85,assesses,9,6,15
388CL5C1RJOQ1ABQMJ6DDE67C64HLE,"An archivist ( `` AR-kiv-ist '' or `` AR-kive-ist '' ) is a professional who assesses , collects , organizes , preserves , maintains control over , and provides access to information determined to have long-term value .",99,108,organizes,2,1,3
388CL5C1RJOQ1ABQMJ6DDE67C64HLE,"An archivist ( `` AR-kiv-ist '' or `` AR-kive-ist '' ) is a professional who assesses , collects , organizes , preserves , maintains control over , and provides access to information determined to have long-term value .",111,120,preserves,3,6,9
388CL5C1RJOQ1ABQMJ6DDE67C64HLE,"An archivist ( `` AR-kiv-ist '' or `` AR-kive-ist '' ) is a professional who assesses , collects , organizes , preserves , maintains control over , and provides access to information determined to have long-term value .",123,132,maintains,0,1,1
388CL5C1RJOQ1ABQMJ6DDE67C64HLE,"An archivist ( `` AR-kiv-ist '' or `` AR-kive-ist '' ) is a professional who assesses , collects , organizes , preserves , maintains control over , and provides access to information determined to have long-term value .",152,160,provides,1,0,1
388CL5C1RJOQ1ABQMJ6DDE67C64HLE,"An archivist ( `` AR-kiv-ist '' or `` AR-kive-ist '' ) is a professional who assesses , collects , organizes , preserves , maintains control over , and provides access to information determined to have long-term value .",152,170,provides access to,1,0,1
388CL5C1RJOQ1ABQMJ6DDE67C64HLE,"An archivist ( `` AR-kiv-ist '' or `` AR-kive-ist '' ) is a professional who assesses , collects , organizes , preserves , maintains control over , and provides access to information determined to have long-term value .",161,167,access,1,0,1
388CL5C1RJOQ1ABQMJ6DDE67C64HLE,"An archivist ( `` AR-kiv-ist '' or `` AR-kive-ist '' ) is a professional who assesses , collects , organizes , preserves , maintains control over , and provides access to information determined to have long-term value .",183,193,determined,2,5,7
388CL5C1RJOQ1ABQMJ6DDE67C64HLE,"An archivist ( `` AR-kiv-ist '' or `` AR-kive-ist '' ) is a professional who assesses , collects , organizes , preserves , maintains control over , and provides access to information determined to have long-term value .",202,211,long-term,1,2,3
388CL5C1RJOQ1ABQMJ6DDE67C64HLE,"An archivist ( `` AR-kiv-ist '' or `` AR-kive-ist '' ) is a professional who assesses , collects , organizes , preserves , maintains control over , and provides access to information determined to have long-term value .",202,217,long-term value,1,1,2
388CL5C1RJOQ1ABQMJ6DDE67C64HLE,"The information maintained by an archivist can be any form of media ( photographs , video or sound recordings , letters , documents , electronic records , etc. ) .",4,15,information,0,1,1
388CL5C1RJOQ1ABQMJ6DDE67C64HLE,"The information maintained by an archivist can be any form of media ( photographs , video or sound recordings , letters , documents , electronic records , etc. ) .",16,26,maintained,2,2,4
388CL5C1RJOQ1ABQMJ6DDE67C64HLE,"The information maintained by an archivist can be any form of media ( photographs , video or sound recordings , letters , documents , electronic records , etc. ) .",33,42,archivist,7,4,11
388CL5C1RJOQ1ABQMJ6DDE67C64HLE,"The information maintained by an archivist can be any form of media ( photographs , video or sound recordings , letters , documents , electronic records , etc. ) .",62,67,media,2,0,2
388CL5C1RJOQ1ABQMJ6DDE67C64HLE,"The information maintained by an archivist can be any form of media ( photographs , video or sound recordings , letters , documents , electronic records , etc. ) .",70,81,photographs,1,0,1
388CL5C1RJOQ1ABQMJ6DDE67C64HLE,"The information maintained by an archivist can be any form of media ( photographs , video or sound recordings , letters , documents , electronic records , etc. ) .",99,109,recordings,0,1,1
388CL5C1RJOQ1ABQMJ6DDE67C64HLE,"The information maintained by an archivist can be any form of media ( photographs , video or sound recordings , letters , documents , electronic records , etc. ) .",134,144,electronic,1,0,1
388CL5C1RJOQ1ABQMJ6DDE67C64HLE,"The information maintained by an archivist can be any form of media ( photographs , video or sound recordings , letters , documents , electronic records , etc. ) .",134,152,electronic records,2,0,2
37J05LC5AXK3U4IOX2BA6EEHGP6DJZ,"Diffraction occurs with all waves , including sound waves , water waves , and electromagnetic waves such as visible light , X-rays and radio waves .",0,11,Diffraction,10,10,20
37J05LC5AXK3U4IOX2BA6EEHGP6DJZ,"Diffraction occurs with all waves , including sound waves , water waves , and electromagnetic waves such as visible light , X-rays and radio waves .",12,18,occurs,1,0,1
37J05LC5AXK3U4IOX2BA6EEHGP6DJZ,"Diffraction occurs with all waves , including sound waves , water waves , and electromagnetic waves such as visible light , X-rays and radio waves .",78,93,electromagnetic,10,4,14
37J05LC5AXK3U4IOX2BA6EEHGP6DJZ,"Diffraction occurs with all waves , including sound waves , water waves , and electromagnetic waves such as visible light , X-rays and radio waves .",78,99,electromagnetic waves,0,1,1
37J05LC5AXK3U4IOX2BA6EEHGP6DJZ,"Diffraction occurs with all waves , including sound waves , water waves , and electromagnetic waves such as visible light , X-rays and radio waves .",94,99,waves,0,1,1
37J05LC5AXK3U4IOX2BA6EEHGP6DJZ,"Diffraction occurs with all waves , including sound waves , water waves , and electromagnetic waves such as visible light , X-rays and radio waves .",108,115,visible,1,0,1
37J05LC5AXK3U4IOX2BA6EEHGP6DJZ,"Diffraction occurs with all waves , including sound waves , water waves , and electromagnetic waves such as visible light , X-rays and radio waves .",124,130,X-rays,1,1,2
37J05LC5AXK3U4IOX2BA6EEHGP6DJZ,"Diffraction occurs with all waves , including sound waves , water waves , and electromagnetic waves such as visible light , X-rays and radio waves .",135,146,radio waves,1,0,1
37J05LC5AXK3U4IOX2BA6EEHGP6DJZ,Ellison co-founded Oracle Corporation in 1977 with Bob Miner and Ed Oates under the name Software Development Laboratories ( SDL ) .,8,18,co-founded,4,1,5
37J05LC5AXK3U4IOX2BA6EEHGP6DJZ,Ellison co-founded Oracle Corporation in 1977 with Bob Miner and Ed Oates under the name Software Development Laboratories ( SDL ) .,19,25,Oracle,1,0,1
37J05LC5AXK3U4IOX2BA6EEHGP6DJZ,Ellison co-founded Oracle Corporation in 1977 with Bob Miner and Ed Oates under the name Software Development Laboratories ( SDL ) .,19,37,Oracle Corporation,1,0,1
37J05LC5AXK3U4IOX2BA6EEHGP6DJZ,Ellison co-founded Oracle Corporation in 1977 with Bob Miner and Ed Oates under the name Software Development Laboratories ( SDL ) .,89,97,Software,1,1,2
37J05LC5AXK3U4IOX2BA6EEHGP6DJZ,Ellison co-founded Oracle Corporation in 1977 with Bob Miner and Ed Oates under the name Software Development Laboratories ( SDL ) .,89,122,Software Development Laboratories,2,0,2
37J05LC5AXK3U4IOX2BA6EEHGP6DJZ,Ellison co-founded Oracle Corporation in 1977 with Bob Miner and Ed Oates under the name Software Development Laboratories ( SDL ) .,98,109,Development,1,0,1
37J05LC5AXK3U4IOX2BA6EEHGP6DJZ,Ellison co-founded Oracle Corporation in 1977 with Bob Miner and Ed Oates under the name Software Development Laboratories ( SDL ) .,110,122,Laboratories,2,0,2
37J05LC5AXK3U4IOX2BA6EEHGP6DJZ,He also served as the Chairman of the Board until his replacement by Jeffrey O. Henley in 2004 .,22,30,Chairman,0,1,1
37J05LC5AXK3U4IOX2BA6EEHGP6DJZ,He also served as the Chairman of the Board until his replacement by Jeffrey O. Henley in 2004 .,22,43,Chairman of the Board,4,1,5
37J05LC5AXK3U4IOX2BA6EEHGP6DJZ,He also served as the Chairman of the Board until his replacement by Jeffrey O. Henley in 2004 .,38,43,Board,0,2,2
37J05LC5AXK3U4IOX2BA6EEHGP6DJZ,He also served as the Chairman of the Board until his replacement by Jeffrey O. Henley in 2004 .,54,65,replacement,1,6,7
37J05LC5AXK3U4IOX2BA6EEHGP6DJZ,"On August 22 , 2008 , the Associated Press ranked Ellison as the top-paid chief executive in the world .",26,36,Associated,1,0,1
37J05LC5AXK3U4IOX2BA6EEHGP6DJZ,"On August 22 , 2008 , the Associated Press ranked Ellison as the top-paid chief executive in the world .",26,42,Associated Press,1,0,1
37J05LC5AXK3U4IOX2BA6EEHGP6DJZ,"On August 22 , 2008 , the Associated Press ranked Ellison as the top-paid chief executive in the world .",43,49,ranked,0,3,3
37J05LC5AXK3U4IOX2BA6EEHGP6DJZ,"On August 22 , 2008 , the Associated Press ranked Ellison as the top-paid chief executive in the world .",65,73,top-paid,1,4,5
37J05LC5AXK3U4IOX2BA6EEHGP6DJZ,"On August 22 , 2008 , the Associated Press ranked Ellison as the top-paid chief executive in the world .",65,89,top-paid chief executive,0,1,1
37J05LC5AXK3U4IOX2BA6EEHGP6DJZ,"On August 22 , 2008 , the Associated Press ranked Ellison as the top-paid chief executive in the world .",74,89,chief executive,2,0,2
37J05LC5AXK3U4IOX2BA6EEHGP6DJZ,"On August 22 , 2008 , the Associated Press ranked Ellison as the top-paid chief executive in the world .",80,89,executive,2,2,4
37J05LC5AXK3U4IOX2BA6EEHGP6DJZ,"The company also builds tools for database development and systems of middle-tier software , enterprise resource planning ( ERP ) software , customer relationship management ( CRM ) software and supply chain management ( SCM ) software .",34,42,database,5,4,9
37J05LC5AXK3U4IOX2BA6EEHGP6DJZ,"The company also builds tools for database development and systems of middle-tier software , enterprise resource planning ( ERP ) software , customer relationship management ( CRM ) software and supply chain management ( SCM ) software .",34,54,database development,1,0,1
37J05LC5AXK3U4IOX2BA6EEHGP6DJZ,"The company also builds tools for database development and systems of middle-tier software , enterprise resource planning ( ERP ) software , customer relationship management ( CRM ) software and supply chain management ( SCM ) software .",43,54,development,0,2,2
37J05LC5AXK3U4IOX2BA6EEHGP6DJZ,"The company also builds tools for database development and systems of middle-tier software , enterprise resource planning ( ERP ) software , customer relationship management ( CRM ) software and supply chain management ( SCM ) software .",70,81,middle-tier,6,7,13
37J05LC5AXK3U4IOX2BA6EEHGP6DJZ,"The company also builds tools for database development and systems of middle-tier software , enterprise resource planning ( ERP ) software , customer relationship management ( CRM ) software and supply chain management ( SCM ) software .",70,90,middle-tier software,2,0,2
37J05LC5AXK3U4IOX2BA6EEHGP6DJZ,"The company also builds tools for database development and systems of middle-tier software , enterprise resource planning ( ERP ) software , customer relationship management ( CRM ) software and supply chain management ( SCM ) software .",82,90,software,0,1,1
37J05LC5AXK3U4IOX2BA6EEHGP6DJZ,"The company also builds tools for database development and systems of middle-tier software , enterprise resource planning ( ERP ) software , customer relationship management ( CRM ) software and supply chain management ( SCM ) software .",93,103,enterprise,5,2,7
37J05LC5AXK3U4IOX2BA6EEHGP6DJZ,"The company also builds tools for database development and systems of middle-tier software , enterprise resource planning ( ERP ) software , customer relationship management ( CRM ) software and supply chain management ( SCM ) software .",93,121,enterprise resource planning,3,1,4
37J05LC5AXK3U4IOX2BA6EEHGP6DJZ,"The company also builds tools for database development and systems of middle-tier software , enterprise resource planning ( ERP ) software , customer relationship management ( CRM ) software and supply chain management ( SCM ) software .",104,112,resource,0,1,1
37J05LC5AXK3U4IOX2BA6EEHGP6DJZ,"The company also builds tools for database development and systems of middle-tier software , enterprise resource planning ( ERP ) software , customer relationship management ( CRM ) software and supply chain management ( SCM ) software .",104,121,resource planning,0,1,1
37J05LC5AXK3U4IOX2BA6EEHGP6DJZ,"The company also builds tools for database development and systems of middle-tier software , enterprise resource planning ( ERP ) software , customer relationship management ( CRM ) software and supply chain management ( SCM ) software .",130,138,software,1,0,1
37J05LC5AXK3U4IOX2BA6EEHGP6DJZ,"The company also builds tools for database development and systems of middle-tier software , enterprise resource planning ( ERP ) software , customer relationship management ( CRM ) software and supply chain management ( SCM ) software .",141,173,customer relationship management,1,1,2
37J05LC5AXK3U4IOX2BA6EEHGP6DJZ,"The company also builds tools for database development and systems of middle-tier software , enterprise resource planning ( ERP ) software , customer relationship management ( CRM ) software and supply chain management ( SCM ) software .",195,201,supply,0,1,1
37J05LC5AXK3U4IOX2BA6EEHGP6DJZ,"The company also builds tools for database development and systems of middle-tier software , enterprise resource planning ( ERP ) software , customer relationship management ( CRM ) software and supply chain management ( SCM ) software .",195,207,supply chain,2,0,2
37J05LC5AXK3U4IOX2BA6EEHGP6DJZ,"The company also builds tools for database development and systems of middle-tier software , enterprise resource planning ( ERP ) software , customer relationship management ( CRM ) software and supply chain management ( SCM ) software .",195,218,supply chain management,3,0,3
37J05LC5AXK3U4IOX2BA6EEHGP6DJZ,"The company also builds tools for database development and systems of middle-tier software , enterprise resource planning ( ERP ) software , customer relationship management ( CRM ) software and supply chain management ( SCM ) software .",208,218,management,1,0,1
3D06DR5225KVX5LXGPX0W5YSZG4AMY,"Sir Andrew Fielding Huxley , OM , FRS ( 22 November 1917 - 30 May 2012 ) was a Nobel Prize-winning English physiologist and biophysicist .",0,26,Sir Andrew Fielding Huxley,1,0,1
3D06DR5225KVX5LXGPX0W5YSZG4AMY,"Sir Andrew Fielding Huxley , OM , FRS ( 22 November 1917 - 30 May 2012 ) was a Nobel Prize-winning English physiologist and biophysicist .",11,19,Fielding,0,1,1
3D06DR5225KVX5LXGPX0W5YSZG4AMY,"Sir Andrew Fielding Huxley , OM , FRS ( 22 November 1917 - 30 May 2012 ) was a Nobel Prize-winning English physiologist and biophysicist .",79,98,Nobel Prize-winning,3,0,3
3D06DR5225KVX5LXGPX0W5YSZG4AMY,"Sir Andrew Fielding Huxley , OM , FRS ( 22 November 1917 - 30 May 2012 ) was a Nobel Prize-winning English physiologist and biophysicist .",107,119,physiologist,10,10,20
3D06DR5225KVX5LXGPX0W5YSZG4AMY,"Sir Andrew Fielding Huxley , OM , FRS ( 22 November 1917 - 30 May 2012 ) was a Nobel Prize-winning English physiologist and biophysicist .",124,136,biophysicist,10,9,19
3D06DR5225KVX5LXGPX0W5YSZG4AMY,"Hodgkin and Huxley shared the prize that year with John Eccles , who was cited for research on synapses .",19,25,shared,0,1,1
3D06DR5225KVX5LXGPX0W5YSZG4AMY,"Hodgkin and Huxley shared the prize that year with John Eccles , who was cited for research on synapses .",73,78,cited,4,1,5
3D06DR5225KVX5LXGPX0W5YSZG4AMY,"Hodgkin and Huxley shared the prize that year with John Eccles , who was cited for research on synapses .",83,91,research,2,1,3
3D06DR5225KVX5LXGPX0W5YSZG4AMY,"Hodgkin and Huxley shared the prize that year with John Eccles , who was cited for research on synapses .",95,103,synapses,10,10,20
3D06DR5225KVX5LXGPX0W5YSZG4AMY,"Hodgkin and Huxley 's findings led the pair to hypothesize the existence of ion channels , which were isolated only decades later .",47,58,hypothesize,10,7,17
3D06DR5225KVX5LXGPX0W5YSZG4AMY,"Hodgkin and Huxley 's findings led the pair to hypothesize the existence of ion channels , which were isolated only decades later .",63,72,existence,6,1,7
3D06DR5225KVX5LXGPX0W5YSZG4AMY,"Hodgkin and Huxley 's findings led the pair to hypothesize the existence of ion channels , which were isolated only decades later .",76,79,ion,2,0,2
3D06DR5225KVX5LXGPX0W5YSZG4AMY,"Hodgkin and Huxley 's findings led the pair to hypothesize the existence of ion channels , which were isolated only decades later .",76,88,ion channels,2,2,4
3D06DR5225KVX5LXGPX0W5YSZG4AMY,"Hodgkin and Huxley 's findings led the pair to hypothesize the existence of ion channels , which were isolated only decades later .",80,88,channels,1,1,2
3D06DR5225KVX5LXGPX0W5YSZG4AMY,"Hodgkin and Huxley 's findings led the pair to hypothesize the existence of ion channels , which were isolated only decades later .",102,110,isolated,3,3,6
3D06DR5225KVX5LXGPX0W5YSZG4AMY,"Hodgkin and Huxley 's findings led the pair to hypothesize the existence of ion channels , which were isolated only decades later .",116,123,decades,0,5,5
3D06DR5225KVX5LXGPX0W5YSZG4AMY,"Angers proper has a population of 157,000 inhabitants , while c. 283,000 live in its metropolitan area .",0,6,Angers,0,2,2
3D06DR5225KVX5LXGPX0W5YSZG4AMY,"Angers proper has a population of 157,000 inhabitants , while c. 283,000 live in its metropolitan area .",7,13,proper,1,0,1
3D06DR5225KVX5LXGPX0W5YSZG4AMY,"Angers proper has a population of 157,000 inhabitants , while c. 283,000 live in its metropolitan area .",20,30,population,0,1,1
3D06DR5225KVX5LXGPX0W5YSZG4AMY,"Angers proper has a population of 157,000 inhabitants , while c. 283,000 live in its metropolitan area .",42,53,inhabitants,8,7,15
3D06DR5225KVX5LXGPX0W5YSZG4AMY,"Angers proper has a population of 157,000 inhabitants , while c. 283,000 live in its metropolitan area .",85,97,metropolitan,7,2,9
3D06DR5225KVX5LXGPX0W5YSZG4AMY,"Angers proper has a population of 157,000 inhabitants , while c. 283,000 live in its metropolitan area .",85,102,metropolitan area,0,1,1
3D06DR5225KVX5LXGPX0W5YSZG4AMY,"It is also well known for being the seat of important cultural events , such as the film festival Premiers Plans , Tour de Scènes ( free concerts in the streets ) and Les Accroche-Coeurs ( free street festival ) .",11,21,well known,0,1,1
3D06DR5225KVX5LXGPX0W5YSZG4AMY,"It is also well known for being the seat of important cultural events , such as the film festival Premiers Plans , Tour de Scènes ( free concerts in the streets ) and Les Accroche-Coeurs ( free street festival ) .",36,40,seat,0,2,2
3D06DR5225KVX5LXGPX0W5YSZG4AMY,"It is also well known for being the seat of important cultural events , such as the film festival Premiers Plans , Tour de Scènes ( free concerts in the streets ) and Les Accroche-Coeurs ( free street festival ) .",54,62,cultural,1,1,2
3D06DR5225KVX5LXGPX0W5YSZG4AMY,"It is also well known for being the seat of important cultural events , such as the film festival Premiers Plans , Tour de Scènes ( free concerts in the streets ) and Les Accroche-Coeurs ( free street festival ) .",54,69,cultural events,1,0,1
3D06DR5225KVX5LXGPX0W5YSZG4AMY,"It is also well known for being the seat of important cultural events , such as the film festival Premiers Plans , Tour de Scènes ( free concerts in the streets ) and Les Accroche-Coeurs ( free street festival ) .",89,97,festival,1,0,1
3D06DR5225KVX5LXGPX0W5YSZG4AMY,"It is also well known for being the seat of important cultural events , such as the film festival Premiers Plans , Tour de Scènes ( free concerts in the streets ) and Les Accroche-Coeurs ( free street festival ) .",98,106,Premiers,0,2,2
3D06DR5225KVX5LXGPX0W5YSZG4AMY,"It is also well known for being the seat of important cultural events , such as the film festival Premiers Plans , Tour de Scènes ( free concerts in the streets ) and Les Accroche-Coeurs ( free street festival ) .",115,129,Tour de Scènes,2,0,2
3D06DR5225KVX5LXGPX0W5YSZG4AMY,"It is also well known for being the seat of important cultural events , such as the film festival Premiers Plans , Tour de Scènes ( free concerts in the streets ) and Les Accroche-Coeurs ( free street festival ) .",137,145,concerts,2,1,3
3D06DR5225KVX5LXGPX0W5YSZG4AMY,"It is also well known for being the seat of important cultural events , such as the film festival Premiers Plans , Tour de Scènes ( free concerts in the streets ) and Les Accroche-Coeurs ( free street festival ) .",167,186,Les Accroche-Coeurs,2,0,2
3D06DR5225KVX5LXGPX0W5YSZG4AMY,"It is also well known for being the seat of important cultural events , such as the film festival Premiers Plans , Tour de Scènes ( free concerts in the streets ) and Les Accroche-Coeurs ( free street festival ) .",171,186,Accroche-Coeurs,1,1,2
3YLTXLH3DF7GSVQOEBZKUVFRHG5HPC,"In 1835 the family moved to Le Havre , where Boudin 's father opened a store for stationery and picture frames .",28,36,Le Havre,2,0,2
3YLTXLH3DF7GSVQOEBZKUVFRHG5HPC,"In 1835 the family moved to Le Havre , where Boudin 's father opened a store for stationery and picture frames .",81,91,stationery,10,10,20
3YLTXLH3DF7GSVQOEBZKUVFRHG5HPC,"In 1835 the family moved to Le Havre , where Boudin 's father opened a store for stationery and picture frames .",96,110,picture frames,0,2,2
3YLTXLH3DF7GSVQOEBZKUVFRHG5HPC,"In 1835 the family moved to Le Havre , where Boudin 's father opened a store for stationery and picture frames .",104,110,frames,0,1,1
3YLTXLH3DF7GSVQOEBZKUVFRHG5HPC,Eugène Louis Boudin ( French : ( budɛ̃ ) ; 12 July 1824 - 8 August 1898 ) was one of the first French landscape painters to paint outdoors .,33,38,budɛ̃,1,0,1
3YLTXLH3DF7GSVQOEBZKUVFRHG5HPC,Eugène Louis Boudin ( French : ( budɛ̃ ) ; 12 July 1824 - 8 August 1898 ) was one of the first French landscape painters to paint outdoors .,102,111,landscape,6,5,11
3YLTXLH3DF7GSVQOEBZKUVFRHG5HPC,Eugène Louis Boudin ( French : ( budɛ̃ ) ; 12 July 1824 - 8 August 1898 ) was one of the first French landscape painters to paint outdoors .,102,120,landscape painters,0,2,2
3YLTXLH3DF7GSVQOEBZKUVFRHG5HPC,Eugène Louis Boudin ( French : ( budɛ̃ ) ; 12 July 1824 - 8 August 1898 ) was one of the first French landscape painters to paint outdoors .,130,138,outdoors,0,2,2
3YLTXLH3DF7GSVQOEBZKUVFRHG5HPC,The Angara rocket family is a family of space-launch vehicles being developed by the Moscow-based Khrunichev State Research and Production Space Center .,4,10,Angara,1,0,1
3YLTXLH3DF7GSVQOEBZKUVFRHG5HPC,The Angara rocket family is a family of space-launch vehicles being developed by the Moscow-based Khrunichev State Research and Production Space Center .,11,17,rocket,0,1,1
3YLTXLH3DF7GSVQOEBZKUVFRHG5HPC,The Angara rocket family is a family of space-launch vehicles being developed by the Moscow-based Khrunichev State Research and Production Space Center .,11,24,rocket family,0,1,1
3YLTXLH3DF7GSVQOEBZKUVFRHG5HPC,The Angara rocket family is a family of space-launch vehicles being developed by the Moscow-based Khrunichev State Research and Production Space Center .,40,52,space-launch,5,6,11
3YLTXLH3DF7GSVQOEBZKUVFRHG5HPC,The Angara rocket family is a family of space-launch vehicles being developed by the Moscow-based Khrunichev State Research and Production Space Center .,40,61,space-launch vehicles,1,0,1
3YLTXLH3DF7GSVQOEBZKUVFRHG5HPC,The Angara rocket family is a family of space-launch vehicles being developed by the Moscow-based Khrunichev State Research and Production Space Center .,53,61,vehicles,2,0,2
3YLTXLH3DF7GSVQOEBZKUVFRHG5HPC,The Angara rocket family is a family of space-launch vehicles being developed by the Moscow-based Khrunichev State Research and Production Space Center .,128,138,Production,1,0,1
3YLTXLH3DF7GSVQOEBZKUVFRHG5HPC,The Angara rocket family is a family of space-launch vehicles being developed by the Moscow-based Khrunichev State Research and Production Space Center .,139,151,Space Center,0,1,1
3YLTXLH3DF7GSVQOEBZKUVFRHG5HPC,A single launch pad can be used for launching all Angara versions except Angara A7 .,9,15,launch,0,1,1
3YLTXLH3DF7GSVQOEBZKUVFRHG5HPC,A single launch pad can be used for launching all Angara versions except Angara A7 .,9,19,launch pad,1,4,5
3YLTXLH3DF7GSVQOEBZKUVFRHG5HPC,A single launch pad can be used for launching all Angara versions except Angara A7 .,16,19,pad,0,1,1
3YLTXLH3DF7GSVQOEBZKUVFRHG5HPC,A single launch pad can be used for launching all Angara versions except Angara A7 .,36,45,launching,4,0,4
3YLTXLH3DF7GSVQOEBZKUVFRHG5HPC,A single launch pad can be used for launching all Angara versions except Angara A7 .,57,65,versions,1,2,3
3YLTXLH3DF7GSVQOEBZKUVFRHG5HPC,A single launch pad can be used for launching all Angara versions except Angara A7 .,66,72,except,1,1,2
3YLTXLH3DF7GSVQOEBZKUVFRHG5HPC,A single launch pad can be used for launching all Angara versions except Angara A7 .,73,79,Angara,1,0,1
3YLTXLH3DF7GSVQOEBZKUVFRHG5HPC,All Angara launch vehicles have a modular design with each module based on a common Universal Rocket Module ( URM ) .,4,10,Angara,1,0,1
3YLTXLH3DF7GSVQOEBZKUVFRHG5HPC,All Angara launch vehicles have a modular design with each module based on a common Universal Rocket Module ( URM ) .,18,26,vehicles,1,0,1
3YLTXLH3DF7GSVQOEBZKUVFRHG5HPC,All Angara launch vehicles have a modular design with each module based on a common Universal Rocket Module ( URM ) .,34,41,modular,9,6,15
3YLTXLH3DF7GSVQOEBZKUVFRHG5HPC,All Angara launch vehicles have a modular design with each module based on a common Universal Rocket Module ( URM ) .,34,48,modular design,3,2,5
3YLTXLH3DF7GSVQOEBZKUVFRHG5HPC,All Angara launch vehicles have a modular design with each module based on a common Universal Rocket Module ( URM ) .,59,65,module,3,1,4
3YLTXLH3DF7GSVQOEBZKUVFRHG5HPC,All Angara launch vehicles have a modular design with each module based on a common Universal Rocket Module ( URM ) .,84,93,Universal,0,1,1
3YLTXLH3DF7GSVQOEBZKUVFRHG5HPC,All Angara launch vehicles have a modular design with each module based on a common Universal Rocket Module ( URM ) .,84,107,Universal Rocket Module,1,0,1
3YLTXLH3DF7GSVQOEBZKUVFRHG5HPC,All Angara launch vehicles have a modular design with each module based on a common Universal Rocket Module ( URM ) .,101,107,Module,1,0,1
3YLTXLH3DF7GSVQOEBZKUVFRHG5HPC,The Angara 1.1 version was expected to be completed first ; its first launch was scheduled to take place in 2013 from the Plesetsk Cosmodrome .,4,10,Angara,1,0,1
3YLTXLH3DF7GSVQOEBZKUVFRHG5HPC,The Angara 1.1 version was expected to be completed first ; its first launch was scheduled to take place in 2013 from the Plesetsk Cosmodrome .,27,35,expected,0,1,1
3YLTXLH3DF7GSVQOEBZKUVFRHG5HPC,The Angara 1.1 version was expected to be completed first ; its first launch was scheduled to take place in 2013 from the Plesetsk Cosmodrome .,70,76,launch,0,1,1
3YLTXLH3DF7GSVQOEBZKUVFRHG5HPC,The Angara 1.1 version was expected to be completed first ; its first launch was scheduled to take place in 2013 from the Plesetsk Cosmodrome .,81,90,scheduled,3,5,8
3YLTXLH3DF7GSVQOEBZKUVFRHG5HPC,The Angara 1.1 version was expected to be completed first ; its first launch was scheduled to take place in 2013 from the Plesetsk Cosmodrome .,122,130,Plesetsk,1,0,1
3YLTXLH3DF7GSVQOEBZKUVFRHG5HPC,The Angara 1.1 version was expected to be completed first ; its first launch was scheduled to take place in 2013 from the Plesetsk Cosmodrome .,122,141,Plesetsk Cosmodrome,5,1,6
3YLTXLH3DF7GSVQOEBZKUVFRHG5HPC,The Angara 1.1 version was expected to be completed first ; its first launch was scheduled to take place in 2013 from the Plesetsk Cosmodrome .,131,141,Cosmodrome,1,4,5
3P458N04Q1IHMEPXHH6U14VSUWW2X3,"According to the 2005 U.S. Census estimates , the city had a population of 23,741 .",0,9,According,1,0,1
3P458N04Q1IHMEPXHH6U14VSUWW2X3,"According to the 2005 U.S. Census estimates , the city had a population of 23,741 .",0,12,According to,0,1,1
3P458N04Q1IHMEPXHH6U14VSUWW2X3,"According to the 2005 U.S. Census estimates , the city had a population of 23,741 .",22,33,U.S. Census,1,0,1
3P458N04Q1IHMEPXHH6U14VSUWW2X3,"According to the 2005 U.S. Census estimates , the city had a population of 23,741 .",27,33,Census,4,6,10
3P458N04Q1IHMEPXHH6U14VSUWW2X3,"According to the 2005 U.S. Census estimates , the city had a population of 23,741 .",27,43,Census estimates,1,1,2
3P458N04Q1IHMEPXHH6U14VSUWW2X3,"According to the 2005 U.S. Census estimates , the city had a population of 23,741 .",34,43,estimates,9,3,12
3P458N04Q1IHMEPXHH6U14VSUWW2X3,"According to the 2005 U.S. Census estimates , the city had a population of 23,741 .",61,71,population,3,2,5
3P458N04Q1IHMEPXHH6U14VSUWW2X3,"As of the census of 2000 , there were 24,276 people , 10,447 households , and 6,414 families residing in the city .",0,5,As of,0,1,1
3P458N04Q1IHMEPXHH6U14VSUWW2X3,"As of the census of 2000 , there were 24,276 people , 10,447 households , and 6,414 families residing in the city .",10,16,census,4,1,5
3P458N04Q1IHMEPXHH6U14VSUWW2X3,"As of the census of 2000 , there were 24,276 people , 10,447 households , and 6,414 families residing in the city .",61,71,households,3,6,9
3P458N04Q1IHMEPXHH6U14VSUWW2X3,"As of the census of 2000 , there were 24,276 people , 10,447 households , and 6,414 families residing in the city .",93,101,residing,6,2,8
3P458N04Q1IHMEPXHH6U14VSUWW2X3,"Sir Anthony Richard Wagner , KCB , KCVO , FSA ( 6 September 1908 - 5 May 1995 ) was a long-serving officer of arms at the College of Arms in London .",29,32,KCB,0,1,1
3P458N04Q1IHMEPXHH6U14VSUWW2X3,"Sir Anthony Richard Wagner , KCB , KCVO , FSA ( 6 September 1908 - 5 May 1995 ) was a long-serving officer of arms at the College of Arms in London .",35,39,KCVO,0,1,1
3P458N04Q1IHMEPXHH6U14VSUWW2X3,"Sir Anthony Richard Wagner , KCB , KCVO , FSA ( 6 September 1908 - 5 May 1995 ) was a long-serving officer of arms at the College of Arms in London .",42,45,FSA,0,1,1
3P458N04Q1IHMEPXHH6U14VSUWW2X3,"Sir Anthony Richard Wagner , KCB , KCVO , FSA ( 6 September 1908 - 5 May 1995 ) was a long-serving officer of arms at the College of Arms in London .",86,98,long-serving,3,5,8
3P458N04Q1IHMEPXHH6U14VSUWW2X3,"Sir Anthony Richard Wagner , KCB , KCVO , FSA ( 6 September 1908 - 5 May 1995 ) was a long-serving officer of arms at the College of Arms in London .",86,106,long-serving officer,0,1,1
3P458N04Q1IHMEPXHH6U14VSUWW2X3,"Sir Anthony Richard Wagner , KCB , KCVO , FSA ( 6 September 1908 - 5 May 1995 ) was a long-serving officer of arms at the College of Arms in London .",99,114,officer of arms,2,0,2
3P458N04Q1IHMEPXHH6U14VSUWW2X3,"Sir Anthony Richard Wagner , KCB , KCVO , FSA ( 6 September 1908 - 5 May 1995 ) was a long-serving officer of arms at the College of Arms in London .",110,114,arms,1,0,1
3P458N04Q1IHMEPXHH6U14VSUWW2X3,"It originated in , and was first introduced in 1983 in Japan as a grapefruit-flavored sports drink , as a response to a competitor 's brand of sports drink called Pocari Sweat .",3,13,originated,7,6,13
3P458N04Q1IHMEPXHH6U14VSUWW2X3,"It originated in , and was first introduced in 1983 in Japan as a grapefruit-flavored sports drink , as a response to a competitor 's brand of sports drink called Pocari Sweat .",33,43,introduced,1,2,3
3P458N04Q1IHMEPXHH6U14VSUWW2X3,"It originated in , and was first introduced in 1983 in Japan as a grapefruit-flavored sports drink , as a response to a competitor 's brand of sports drink called Pocari Sweat .",66,85,grapefruit-flavored,3,9,12
3P458N04Q1IHMEPXHH6U14VSUWW2X3,"It originated in , and was first introduced in 1983 in Japan as a grapefruit-flavored sports drink , as a response to a competitor 's brand of sports drink called Pocari Sweat .",86,98,sports drink,1,0,1
3P458N04Q1IHMEPXHH6U14VSUWW2X3,"It originated in , and was first introduced in 1983 in Japan as a grapefruit-flavored sports drink , as a response to a competitor 's brand of sports drink called Pocari Sweat .",106,114,response,2,1,3
3P458N04Q1IHMEPXHH6U14VSUWW2X3,"It originated in , and was first introduced in 1983 in Japan as a grapefruit-flavored sports drink , as a response to a competitor 's brand of sports drink called Pocari Sweat .",120,130,competitor,4,4,8
3P458N04Q1IHMEPXHH6U14VSUWW2X3,"It originated in , and was first introduced in 1983 in Japan as a grapefruit-flavored sports drink , as a response to a competitor 's brand of sports drink called Pocari Sweat .",120,132,competitor s,3,0,3
3P458N04Q1IHMEPXHH6U14VSUWW2X3,"It originated in , and was first introduced in 1983 in Japan as a grapefruit-flavored sports drink , as a response to a competitor 's brand of sports drink called Pocari Sweat .",120,138,competitor s brand,0,1,1
3P458N04Q1IHMEPXHH6U14VSUWW2X3,"It originated in , and was first introduced in 1983 in Japan as a grapefruit-flavored sports drink , as a response to a competitor 's brand of sports drink called Pocari Sweat .",134,139,brand,0,1,1
3P458N04Q1IHMEPXHH6U14VSUWW2X3,"It originated in , and was first introduced in 1983 in Japan as a grapefruit-flavored sports drink , as a response to a competitor 's brand of sports drink called Pocari Sweat .",163,169,Pocari,1,0,1
3P458N04Q1IHMEPXHH6U14VSUWW2X3,"It originated in , and was first introduced in 1983 in Japan as a grapefruit-flavored sports drink , as a response to a competitor 's brand of sports drink called Pocari Sweat .",163,175,Pocari Sweat,1,0,1
3P458N04Q1IHMEPXHH6U14VSUWW2X3,"It originated in , and was first introduced in 1983 in Japan as a grapefruit-flavored sports drink , as a response to a competitor 's brand of sports drink called Pocari Sweat .",170,175,Sweat,0,1,1
3P458N04Q1IHMEPXHH6U14VSUWW2X3,"It was introduced to Spain and Portugal in 1991 , and it became the official drink of the 1992 Summer Olympics in Barcelona .",7,17,introduced,5,0,5
3P458N04Q1IHMEPXHH6U14VSUWW2X3,"It was introduced to Spain and Portugal in 1991 , and it became the official drink of the 1992 Summer Olympics in Barcelona .",68,76,official,0,3,3
3P458N04Q1IHMEPXHH6U14VSUWW2X3,"It was introduced to Spain and Portugal in 1991 , and it became the official drink of the 1992 Summer Olympics in Barcelona .",68,82,official drink,1,1,2
3P458N04Q1IHMEPXHH6U14VSUWW2X3,"It was introduced to Spain and Portugal in 1991 , and it became the official drink of the 1992 Summer Olympics in Barcelona .",95,110,Summer Olympics,1,0,1
3JAOYN9IHL3URYE21SDBDYBGTFV33F,The discovery of deuterium-burning down to 0.012 solar masses and the impact of dust formation in the cool outer atmospheres of brown dwarfs in the late 1980s brought these theories into question .,4,13,discovery,1,1,2
3JAOYN9IHL3URYE21SDBDYBGTFV33F,The discovery of deuterium-burning down to 0.012 solar masses and the impact of dust formation in the cool outer atmospheres of brown dwarfs in the late 1980s brought these theories into question .,17,34,deuterium-burning,10,5,15
3JAOYN9IHL3URYE21SDBDYBGTFV33F,The discovery of deuterium-burning down to 0.012 solar masses and the impact of dust formation in the cool outer atmospheres of brown dwarfs in the late 1980s brought these theories into question .,17,39,deuterium-burning down,1,0,1
3JAOYN9IHL3URYE21SDBDYBGTFV33F,The discovery of deuterium-burning down to 0.012 solar masses and the impact of dust formation in the cool outer atmospheres of brown dwarfs in the late 1980s brought these theories into question .,49,61,solar masses,3,1,4
3JAOYN9IHL3URYE21SDBDYBGTFV33F,The discovery of deuterium-burning down to 0.012 solar masses and the impact of dust formation in the cool outer atmospheres of brown dwarfs in the late 1980s brought these theories into question .,55,61,masses,0,1,1
3JAOYN9IHL3URYE21SDBDYBGTFV33F,The discovery of deuterium-burning down to 0.012 solar masses and the impact of dust formation in the cool outer atmospheres of brown dwarfs in the late 1980s brought these theories into question .,70,76,impact,0,2,2
3JAOYN9IHL3URYE21SDBDYBGTFV33F,The discovery of deuterium-burning down to 0.012 solar masses and the impact of dust formation in the cool outer atmospheres of brown dwarfs in the late 1980s brought these theories into question .,80,84,dust,0,1,1
3JAOYN9IHL3URYE21SDBDYBGTFV33F,The discovery of deuterium-burning down to 0.012 solar masses and the impact of dust formation in the cool outer atmospheres of brown dwarfs in the late 1980s brought these theories into question .,85,94,formation,1,2,3
3JAOYN9IHL3URYE21SDBDYBGTFV33F,The discovery of deuterium-burning down to 0.012 solar masses and the impact of dust formation in the cool outer atmospheres of brown dwarfs in the late 1980s brought these theories into question .,107,112,outer,0,1,1
3JAOYN9IHL3URYE21SDBDYBGTFV33F,The discovery of deuterium-burning down to 0.012 solar masses and the impact of dust formation in the cool outer atmospheres of brown dwarfs in the late 1980s brought these theories into question .,113,124,atmospheres,4,3,7
3JAOYN9IHL3URYE21SDBDYBGTFV33F,The discovery of deuterium-burning down to 0.012 solar masses and the impact of dust formation in the cool outer atmospheres of brown dwarfs in the late 1980s brought these theories into question .,128,140,brown dwarfs,3,1,4
3JAOYN9IHL3URYE21SDBDYBGTFV33F,The discovery of deuterium-burning down to 0.012 solar masses and the impact of dust formation in the cool outer atmospheres of brown dwarfs in the late 1980s brought these theories into question .,134,140,dwarfs,2,10,12
3JAOYN9IHL3URYE21SDBDYBGTFV33F,The discovery of deuterium-burning down to 0.012 solar masses and the impact of dust formation in the cool outer atmospheres of brown dwarfs in the late 1980s brought these theories into question .,159,166,brought,0,1,1
3JAOYN9IHL3URYE21SDBDYBGTFV33F,The discovery of deuterium-burning down to 0.012 solar masses and the impact of dust formation in the cool outer atmospheres of brown dwarfs in the late 1980s brought these theories into question .,173,181,theories,3,1,4
3JAOYN9IHL3URYE21SDBDYBGTFV33F,"This discovery helped to establish yet another spectral class even cooler than L dwarfs , known as `` T dwarfs '' , for which Gliese 229B is the prototype .",25,34,establish,1,0,1
3JAOYN9IHL3URYE21SDBDYBGTFV33F,"This discovery helped to establish yet another spectral class even cooler than L dwarfs , known as `` T dwarfs '' , for which Gliese 229B is the prototype .",47,55,spectral,9,6,15
3JAOYN9IHL3URYE21SDBDYBGTFV33F,"This discovery helped to establish yet another spectral class even cooler than L dwarfs , known as `` T dwarfs '' , for which Gliese 229B is the prototype .",47,61,spectral class,2,3,5
3JAOYN9IHL3URYE21SDBDYBGTFV33F,"This discovery helped to establish yet another spectral class even cooler than L dwarfs , known as `` T dwarfs '' , for which Gliese 229B is the prototype .",81,87,dwarfs,2,1,3
3JAOYN9IHL3URYE21SDBDYBGTFV33F,"This discovery helped to establish yet another spectral class even cooler than L dwarfs , known as `` T dwarfs '' , for which Gliese 229B is the prototype .",102,110,T dwarfs,1,0,1
3JAOYN9IHL3URYE21SDBDYBGTFV33F,"This discovery helped to establish yet another spectral class even cooler than L dwarfs , known as `` T dwarfs '' , for which Gliese 229B is the prototype .",104,110,dwarfs,0,1,1
3JAOYN9IHL3URYE21SDBDYBGTFV33F,"This discovery helped to establish yet another spectral class even cooler than L dwarfs , known as `` T dwarfs '' , for which Gliese 229B is the prototype .",126,132,Gliese,1,0,1
3JAOYN9IHL3URYE21SDBDYBGTFV33F,"This discovery helped to establish yet another spectral class even cooler than L dwarfs , known as `` T dwarfs '' , for which Gliese 229B is the prototype .",145,154,prototype,10,8,18
3JAOYN9IHL3URYE21SDBDYBGTFV33F,"Remarkably , its near-infrared spectrum clearly exhibited a methane absorption band at 2 micrometres , a feature that had previously only been observed in the atmospheres of giant planets and that of Saturn 's moon Titan .",0,10,Remarkably,0,2,2
3JAOYN9IHL3URYE21SDBDYBGTFV33F,"Remarkably , its near-infrared spectrum clearly exhibited a methane absorption band at 2 micrometres , a feature that had previously only been observed in the atmospheres of giant planets and that of Saturn 's moon Titan .",17,30,near-infrared,3,1,4
3JAOYN9IHL3URYE21SDBDYBGTFV33F,"Remarkably , its near-infrared spectrum clearly exhibited a methane absorption band at 2 micrometres , a feature that had previously only been observed in the atmospheres of giant planets and that of Saturn 's moon Titan .",17,39,near-infrared spectrum,4,2,6
3JAOYN9IHL3URYE21SDBDYBGTFV33F,"Remarkably , its near-infrared spectrum clearly exhibited a methane absorption band at 2 micrometres , a feature that had previously only been observed in the atmospheres of giant planets and that of Saturn 's moon Titan .",31,39,spectrum,3,3,6
3JAOYN9IHL3URYE21SDBDYBGTFV33F,"Remarkably , its near-infrared spectrum clearly exhibited a methane absorption band at 2 micrometres , a feature that had previously only been observed in the atmospheres of giant planets and that of Saturn 's moon Titan .",48,57,exhibited,3,3,6
3JAOYN9IHL3URYE21SDBDYBGTFV33F,"Remarkably , its near-infrared spectrum clearly exhibited a methane absorption band at 2 micrometres , a feature that had previously only been observed in the atmospheres of giant planets and that of Saturn 's moon Titan .",60,67,methane,4,2,6
3JAOYN9IHL3URYE21SDBDYBGTFV33F,"Remarkably , its near-infrared spectrum clearly exhibited a methane absorption band at 2 micrometres , a feature that had previously only been observed in the atmospheres of giant planets and that of Saturn 's moon Titan .",60,83,methane absorption band,1,0,1
3JAOYN9IHL3URYE21SDBDYBGTFV33F,"Remarkably , its near-infrared spectrum clearly exhibited a methane absorption band at 2 micrometres , a feature that had previously only been observed in the atmospheres of giant planets and that of Saturn 's moon Titan .",68,78,absorption,2,3,5
3JAOYN9IHL3URYE21SDBDYBGTFV33F,"Remarkably , its near-infrared spectrum clearly exhibited a methane absorption band at 2 micrometres , a feature that had previously only been observed in the atmospheres of giant planets and that of Saturn 's moon Titan .",68,83,absorption band,0,1,1
3JAOYN9IHL3URYE21SDBDYBGTFV33F,"Remarkably , its near-infrared spectrum clearly exhibited a methane absorption band at 2 micrometres , a feature that had previously only been observed in the atmospheres of giant planets and that of Saturn 's moon Titan .",89,100,micrometres,3,2,5
3JAOYN9IHL3URYE21SDBDYBGTFV33F,"Remarkably , its near-infrared spectrum clearly exhibited a methane absorption band at 2 micrometres , a feature that had previously only been observed in the atmospheres of giant planets and that of Saturn 's moon Titan .",105,112,feature,0,1,1
3JAOYN9IHL3URYE21SDBDYBGTFV33F,"Remarkably , its near-infrared spectrum clearly exhibited a methane absorption band at 2 micrometres , a feature that had previously only been observed in the atmospheres of giant planets and that of Saturn 's moon Titan .",159,170,atmospheres,1,1,2
3JAOYN9IHL3URYE21SDBDYBGTFV33F,"Although the discovery of the coolest dwarf was highly significant at the time , it was debated whether GD 165B would be classified as a brown dwarf or simply a very-low-mass star , because observationally it is very difficult to distinguish between the two .",30,43,coolest dwarf,1,0,1
3JAOYN9IHL3URYE21SDBDYBGTFV33F,"Although the discovery of the coolest dwarf was highly significant at the time , it was debated whether GD 165B would be classified as a brown dwarf or simply a very-low-mass star , because observationally it is very difficult to distinguish between the two .",38,43,dwarf,0,2,2
3JAOYN9IHL3URYE21SDBDYBGTFV33F,"Although the discovery of the coolest dwarf was highly significant at the time , it was debated whether GD 165B would be classified as a brown dwarf or simply a very-low-mass star , because observationally it is very difficult to distinguish between the two .",55,66,significant,4,4,8
3JAOYN9IHL3URYE21SDBDYBGTFV33F,"Although the discovery of the coolest dwarf was highly significant at the time , it was debated whether GD 165B would be classified as a brown dwarf or simply a very-low-mass star , because observationally it is very difficult to distinguish between the two .",88,95,debated,0,1,1
3JAOYN9IHL3URYE21SDBDYBGTFV33F,"Although the discovery of the coolest dwarf was highly significant at the time , it was debated whether GD 165B would be classified as a brown dwarf or simply a very-low-mass star , because observationally it is very difficult to distinguish between the two .",88,106,debated whether GD,0,1,1
3JAOYN9IHL3URYE21SDBDYBGTFV33F,"Although the discovery of the coolest dwarf was highly significant at the time , it was debated whether GD 165B would be classified as a brown dwarf or simply a very-low-mass star , because observationally it is very difficult to distinguish between the two .",121,131,classified,1,0,1
3JAOYN9IHL3URYE21SDBDYBGTFV33F,"Although the discovery of the coolest dwarf was highly significant at the time , it was debated whether GD 165B would be classified as a brown dwarf or simply a very-low-mass star , because observationally it is very difficult to distinguish between the two .",143,148,dwarf,2,1,3
3JAOYN9IHL3URYE21SDBDYBGTFV33F,"Although the discovery of the coolest dwarf was highly significant at the time , it was debated whether GD 165B would be classified as a brown dwarf or simply a very-low-mass star , because observationally it is very difficult to distinguish between the two .",161,179,very-low-mass star,1,0,1
3JAOYN9IHL3URYE21SDBDYBGTFV33F,"Although the discovery of the coolest dwarf was highly significant at the time , it was debated whether GD 165B would be classified as a brown dwarf or simply a very-low-mass star , because observationally it is very difficult to distinguish between the two .",190,205,observationally,7,7,14
3JAOYN9IHL3URYE21SDBDYBGTFV33F,"Although the discovery of the coolest dwarf was highly significant at the time , it was debated whether GD 165B would be classified as a brown dwarf or simply a very-low-mass star , because observationally it is very difficult to distinguish between the two .",217,241,difficult to distinguish,1,0,1
3JAOYN9IHL3URYE21SDBDYBGTFV33F,"Although the discovery of the coolest dwarf was highly significant at the time , it was debated whether GD 165B would be classified as a brown dwarf or simply a very-low-mass star , because observationally it is very difficult to distinguish between the two .",230,241,distinguish,4,3,7
3Y40HMYLL1JQ6QYZ01G07NQKDNGUXE,Among his notable film roles were Minnesota Fats in the 1961 drama The Hustler ( starring Paul Newman ) and Buford T. Justice in the Smokey and the Bandit series .,10,17,notable,7,9,16
3Y40HMYLL1JQ6QYZ01G07NQKDNGUXE,Among his notable film roles were Minnesota Fats in the 1961 drama The Hustler ( starring Paul Newman ) and Buford T. Justice in the Smokey and the Bandit series .,10,22,notable film,0,1,1
3Y40HMYLL1JQ6QYZ01G07NQKDNGUXE,Among his notable film roles were Minnesota Fats in the 1961 drama The Hustler ( starring Paul Newman ) and Buford T. Justice in the Smokey and the Bandit series .,10,28,notable film roles,1,0,1
3Y40HMYLL1JQ6QYZ01G07NQKDNGUXE,Among his notable film roles were Minnesota Fats in the 1961 drama The Hustler ( starring Paul Newman ) and Buford T. Justice in the Smokey and the Bandit series .,34,48,Minnesota Fats,1,0,1
3Y40HMYLL1JQ6QYZ01G07NQKDNGUXE,Among his notable film roles were Minnesota Fats in the 1961 drama The Hustler ( starring Paul Newman ) and Buford T. Justice in the Smokey and the Bandit series .,71,78,Hustler,0,1,1
3Y40HMYLL1JQ6QYZ01G07NQKDNGUXE,Among his notable film roles were Minnesota Fats in the 1961 drama The Hustler ( starring Paul Newman ) and Buford T. Justice in the Smokey and the Bandit series .,81,89,starring,1,1,2
3Y40HMYLL1JQ6QYZ01G07NQKDNGUXE,Among his notable film roles were Minnesota Fats in the 1961 drama The Hustler ( starring Paul Newman ) and Buford T. Justice in the Smokey and the Bandit series .,133,139,Smokey,0,1,1
3Y40HMYLL1JQ6QYZ01G07NQKDNGUXE,Among his notable film roles were Minnesota Fats in the 1961 drama The Hustler ( starring Paul Newman ) and Buford T. Justice in the Smokey and the Bandit series .,148,154,Bandit,0,1,1
3Y40HMYLL1JQ6QYZ01G07NQKDNGUXE,Among his notable film roles were Minnesota Fats in the 1961 drama The Hustler ( starring Paul Newman ) and Buford T. Justice in the Smokey and the Bandit series .,155,161,series,0,2,2
3Y40HMYLL1JQ6QYZ01G07NQKDNGUXE,"An HCL usually consists of a glass tube containing a cathode , an anode , and a buffer gas ( usually a noble gas ) .",3,6,HCL,3,1,4
3Y40HMYLL1JQ6QYZ01G07NQKDNGUXE,"An HCL usually consists of a glass tube containing a cathode , an anode , and a buffer gas ( usually a noble gas ) .",7,14,usually,1,0,1
3Y40HMYLL1JQ6QYZ01G07NQKDNGUXE,"An HCL usually consists of a glass tube containing a cathode , an anode , and a buffer gas ( usually a noble gas ) .",7,23,usually consists,0,1,1
3Y40HMYLL1JQ6QYZ01G07NQKDNGUXE,"An HCL usually consists of a glass tube containing a cathode , an anode , and a buffer gas ( usually a noble gas ) .",15,26,consists of,1,0,1
3Y40HMYLL1JQ6QYZ01G07NQKDNGUXE,"An HCL usually consists of a glass tube containing a cathode , an anode , and a buffer gas ( usually a noble gas ) .",40,50,containing,1,1,2
3Y40HMYLL1JQ6QYZ01G07NQKDNGUXE,"An HCL usually consists of a glass tube containing a cathode , an anode , and a buffer gas ( usually a noble gas ) .",53,60,cathode,0,9,9
3Y40HMYLL1JQ6QYZ01G07NQKDNGUXE,"An HCL usually consists of a glass tube containing a cathode , an anode , and a buffer gas ( usually a noble gas ) .",66,71,anode,10,9,19
3Y40HMYLL1JQ6QYZ01G07NQKDNGUXE,"An HCL usually consists of a glass tube containing a cathode , an anode , and a buffer gas ( usually a noble gas ) .",80,86,buffer,5,9,14
3Y40HMYLL1JQ6QYZ01G07NQKDNGUXE,"An HCL usually consists of a glass tube containing a cathode , an anode , and a buffer gas ( usually a noble gas ) .",80,90,buffer gas,5,2,7
3Y40HMYLL1JQ6QYZ01G07NQKDNGUXE,"An HCL usually consists of a glass tube containing a cathode , an anode , and a buffer gas ( usually a noble gas ) .",103,112,noble gas,5,1,6
3Y40HMYLL1JQ6QYZ01G07NQKDNGUXE,"He played 502 career NHL games , scoring 185 goals and 159 assists for 344 points .",14,30,career NHL games,1,0,1
3Y40HMYLL1JQ6QYZ01G07NQKDNGUXE,"He played 502 career NHL games , scoring 185 goals and 159 assists for 344 points .",33,40,scoring,1,0,1
3Y40HMYLL1JQ6QYZ01G07NQKDNGUXE,"He played 502 career NHL games , scoring 185 goals and 159 assists for 344 points .",59,66,assists,1,2,3
3Y40HMYLL1JQ6QYZ01G07NQKDNGUXE,"Stewart died on November 18 , 2010 , in a hospital in Burlington , Ontario , at the age of 87 .",42,50,hospital,1,0,1
3Y40HMYLL1JQ6QYZ01G07NQKDNGUXE,"Stewart died on November 18 , 2010 , in a hospital in Burlington , Ontario , at the age of 87 .",54,74,"Burlington , Ontario",1,0,1
3Y40HMYLL1JQ6QYZ01G07NQKDNGUXE,"James Gaye Stewart ( June 28 , 1923 - November 18 , 2010 ) was a professional ice hockey forward .",65,77,professional,1,6,7
3Y40HMYLL1JQ6QYZ01G07NQKDNGUXE,"James Gaye Stewart ( June 28 , 1923 - November 18 , 2010 ) was a professional ice hockey forward .",65,96,professional ice hockey forward,2,0,2
3Y40HMYLL1JQ6QYZ01G07NQKDNGUXE,"James Gaye Stewart ( June 28 , 1923 - November 18 , 2010 ) was a professional ice hockey forward .",82,96,hockey forward,1,0,1
3Y40HMYLL1JQ6QYZ01G07NQKDNGUXE,"In all , Gaye Stewart played for five of the NHL 's Original Six teams , all except the Boston Bruins .",52,70,Original Six teams,1,0,1
3Y40HMYLL1JQ6QYZ01G07NQKDNGUXE,"In all , Gaye Stewart played for five of the NHL 's Original Six teams , all except the Boston Bruins .",77,83,except,0,2,2
3EQVJH0T40MEKNJVVS84Z5GO6JQHTH,"This is due to two competing physical effects : gravity , which causes the air to be as close as possible to the ground ; and the heat content of the air , which causes the molecules to bounce off each other and expand .",19,28,competing,3,5,8
3EQVJH0T40MEKNJVVS84Z5GO6JQHTH,"This is due to two competing physical effects : gravity , which causes the air to be as close as possible to the ground ; and the heat content of the air , which causes the molecules to bounce off each other and expand .",19,45,competing physical effects,1,0,1
3EQVJH0T40MEKNJVVS84Z5GO6JQHTH,"This is due to two competing physical effects : gravity , which causes the air to be as close as possible to the ground ; and the heat content of the air , which causes the molecules to bounce off each other and expand .",29,37,physical,1,0,1
3EQVJH0T40MEKNJVVS84Z5GO6JQHTH,"This is due to two competing physical effects : gravity , which causes the air to be as close as possible to the ground ; and the heat content of the air , which causes the molecules to bounce off each other and expand .",29,45,physical effects,2,0,2
3EQVJH0T40MEKNJVVS84Z5GO6JQHTH,"This is due to two competing physical effects : gravity , which causes the air to be as close as possible to the ground ; and the heat content of the air , which causes the molecules to bounce off each other and expand .",48,55,gravity,4,0,4
3EQVJH0T40MEKNJVVS84Z5GO6JQHTH,"This is due to two competing physical effects : gravity , which causes the air to be as close as possible to the ground ; and the heat content of the air , which causes the molecules to bounce off each other and expand .",113,119,ground,0,1,1
3EQVJH0T40MEKNJVVS84Z5GO6JQHTH,"This is due to two competing physical effects : gravity , which causes the air to be as close as possible to the ground ; and the heat content of the air , which causes the molecules to bounce off each other and expand .",130,142,heat content,0,1,1
3EQVJH0T40MEKNJVVS84Z5GO6JQHTH,"This is due to two competing physical effects : gravity , which causes the air to be as close as possible to the ground ; and the heat content of the air , which causes the molecules to bounce off each other and expand .",135,142,content,0,1,1
3EQVJH0T40MEKNJVVS84Z5GO6JQHTH,"This is due to two competing physical effects : gravity , which causes the air to be as close as possible to the ground ; and the heat content of the air , which causes the molecules to bounce off each other and expand .",173,182,molecules,10,5,15
3EQVJH0T40MEKNJVVS84Z5GO6JQHTH,"This is due to two competing physical effects : gravity , which causes the air to be as close as possible to the ground ; and the heat content of the air , which causes the molecules to bounce off each other and expand .",186,192,bounce,1,1,2
3EQVJH0T40MEKNJVVS84Z5GO6JQHTH,"This is due to two competing physical effects : gravity , which causes the air to be as close as possible to the ground ; and the heat content of the air , which causes the molecules to bounce off each other and expand .",186,196,bounce off,1,2,3
3EQVJH0T40MEKNJVVS84Z5GO6JQHTH,"On the flight deck , the definitive instrument for measuring altitude is the pressure altimeter , which is an aneroid barometer with a front face indicating distance ( feet or metres ) instead of atmospheric pressure .",7,18,flight deck,2,2,4
3EQVJH0T40MEKNJVVS84Z5GO6JQHTH,"On the flight deck , the definitive instrument for measuring altitude is the pressure altimeter , which is an aneroid barometer with a front face indicating distance ( feet or metres ) instead of atmospheric pressure .",25,35,definitive,6,8,14
3EQVJH0T40MEKNJVVS84Z5GO6JQHTH,"On the flight deck , the definitive instrument for measuring altitude is the pressure altimeter , which is an aneroid barometer with a front face indicating distance ( feet or metres ) instead of atmospheric pressure .",25,46,definitive instrument,3,0,3
3EQVJH0T40MEKNJVVS84Z5GO6JQHTH,"On the flight deck , the definitive instrument for measuring altitude is the pressure altimeter , which is an aneroid barometer with a front face indicating distance ( feet or metres ) instead of atmospheric pressure .",61,69,altitude,5,6,11
3EQVJH0T40MEKNJVVS84Z5GO6JQHTH,"On the flight deck , the definitive instrument for measuring altitude is the pressure altimeter , which is an aneroid barometer with a front face indicating distance ( feet or metres ) instead of atmospheric pressure .",77,95,pressure altimeter,5,2,7
3EQVJH0T40MEKNJVVS84Z5GO6JQHTH,"On the flight deck , the definitive instrument for measuring altitude is the pressure altimeter , which is an aneroid barometer with a front face indicating distance ( feet or metres ) instead of atmospheric pressure .",86,95,altimeter,7,5,12
3EQVJH0T40MEKNJVVS84Z5GO6JQHTH,"On the flight deck , the definitive instrument for measuring altitude is the pressure altimeter , which is an aneroid barometer with a front face indicating distance ( feet or metres ) instead of atmospheric pressure .",110,117,aneroid,7,4,11
3EQVJH0T40MEKNJVVS84Z5GO6JQHTH,"On the flight deck , the definitive instrument for measuring altitude is the pressure altimeter , which is an aneroid barometer with a front face indicating distance ( feet or metres ) instead of atmospheric pressure .",110,127,aneroid barometer,8,4,12
3EQVJH0T40MEKNJVVS84Z5GO6JQHTH,"On the flight deck , the definitive instrument for measuring altitude is the pressure altimeter , which is an aneroid barometer with a front face indicating distance ( feet or metres ) instead of atmospheric pressure .",118,127,barometer,4,2,6
3EQVJH0T40MEKNJVVS84Z5GO6JQHTH,"On the flight deck , the definitive instrument for measuring altitude is the pressure altimeter , which is an aneroid barometer with a front face indicating distance ( feet or metres ) instead of atmospheric pressure .",146,156,indicating,2,1,3
3EQVJH0T40MEKNJVVS84Z5GO6JQHTH,"On the flight deck , the definitive instrument for measuring altitude is the pressure altimeter , which is an aneroid barometer with a front face indicating distance ( feet or metres ) instead of atmospheric pressure .",176,182,metres,1,0,1
3EQVJH0T40MEKNJVVS84Z5GO6JQHTH,"On the flight deck , the definitive instrument for measuring altitude is the pressure altimeter , which is an aneroid barometer with a front face indicating distance ( feet or metres ) instead of atmospheric pressure .",185,192,instead,0,1,1
3EQVJH0T40MEKNJVVS84Z5GO6JQHTH,"On the flight deck , the definitive instrument for measuring altitude is the pressure altimeter , which is an aneroid barometer with a front face indicating distance ( feet or metres ) instead of atmospheric pressure .",196,207,atmospheric,4,4,8
3EQVJH0T40MEKNJVVS84Z5GO6JQHTH,"On the flight deck , the definitive instrument for measuring altitude is the pressure altimeter , which is an aneroid barometer with a front face indicating distance ( feet or metres ) instead of atmospheric pressure .",196,216,atmospheric pressure,3,0,3
3EQVJH0T40MEKNJVVS84Z5GO6JQHTH,"The human body can adapt to high altitude by breathing faster , having a higher heart rate , and adjusting its blood chemistry .",19,24,adapt,1,2,3
3EQVJH0T40MEKNJVVS84Z5GO6JQHTH,"The human body can adapt to high altitude by breathing faster , having a higher heart rate , and adjusting its blood chemistry .",28,41,high altitude,0,1,1
3EQVJH0T40MEKNJVVS84Z5GO6JQHTH,"The human body can adapt to high altitude by breathing faster , having a higher heart rate , and adjusting its blood chemistry .",33,41,altitude,2,0,2
3EQVJH0T40MEKNJVVS84Z5GO6JQHTH,"The human body can adapt to high altitude by breathing faster , having a higher heart rate , and adjusting its blood chemistry .",97,106,adjusting,1,0,1
3EQVJH0T40MEKNJVVS84Z5GO6JQHTH,"The human body can adapt to high altitude by breathing faster , having a higher heart rate , and adjusting its blood chemistry .",111,126,blood chemistry,2,1,3
3EQVJH0T40MEKNJVVS84Z5GO6JQHTH,"The human body can adapt to high altitude by breathing faster , having a higher heart rate , and adjusting its blood chemistry .",117,126,chemistry,3,0,3
3EQVJH0T40MEKNJVVS84Z5GO6JQHTH,"Because of the lower pressure , the air expands as it rises , which causes it to cool .",15,29,lower pressure,1,0,1
3EQVJH0T40MEKNJVVS84Z5GO6JQHTH,"Because of the lower pressure , the air expands as it rises , which causes it to cool .",40,47,expands,1,0,1
3EQVJH0T40MEKNJVVS84Z5GO6JQHTH,"Because of the lower pressure , the air expands as it rises , which causes it to cool .",54,59,rises,0,1,1
3K1H3NEY7L0T32SNPWQ791M1OXPDGV,"She taught English literature at the private , church-run University of Nanking 金陵大學 , Ginling College 金陵女子大学 and at the National Central University 國立中央大學 .",4,10,taught,2,3,5
3K1H3NEY7L0T32SNPWQ791M1OXPDGV,"She taught English literature at the private , church-run University of Nanking 金陵大學 , Ginling College 金陵女子大学 and at the National Central University 國立中央大學 .",11,29,English literature,1,0,1
3K1H3NEY7L0T32SNPWQ791M1OXPDGV,"She taught English literature at the private , church-run University of Nanking 金陵大學 , Ginling College 金陵女子大学 and at the National Central University 國立中央大學 .",19,29,literature,5,3,8
3K1H3NEY7L0T32SNPWQ791M1OXPDGV,"She taught English literature at the private , church-run University of Nanking 金陵大學 , Ginling College 金陵女子大学 and at the National Central University 國立中央大學 .",37,44,private,2,1,3
3K1H3NEY7L0T32SNPWQ791M1OXPDGV,"She taught English literature at the private , church-run University of Nanking 金陵大學 , Ginling College 金陵女子大学 and at the National Central University 國立中央大學 .",47,57,church-run,4,3,7
3K1H3NEY7L0T32SNPWQ791M1OXPDGV,"In 1978 , sharp , curved claws on the suction cups of squid tentacles cut up the rubber coating on the hull of the USS Stein .",10,15,sharp,0,1,1
3K1H3NEY7L0T32SNPWQ791M1OXPDGV,"In 1978 , sharp , curved claws on the suction cups of squid tentacles cut up the rubber coating on the hull of the USS Stein .",18,24,curved,0,1,1
3K1H3NEY7L0T32SNPWQ791M1OXPDGV,"In 1978 , sharp , curved claws on the suction cups of squid tentacles cut up the rubber coating on the hull of the USS Stein .",18,30,curved claws,2,2,4
3K1H3NEY7L0T32SNPWQ791M1OXPDGV,"In 1978 , sharp , curved claws on the suction cups of squid tentacles cut up the rubber coating on the hull of the USS Stein .",25,30,claws,1,5,6
3K1H3NEY7L0T32SNPWQ791M1OXPDGV,"In 1978 , sharp , curved claws on the suction cups of squid tentacles cut up the rubber coating on the hull of the USS Stein .",38,45,suction,4,4,8
3K1H3NEY7L0T32SNPWQ791M1OXPDGV,"In 1978 , sharp , curved claws on the suction cups of squid tentacles cut up the rubber coating on the hull of the USS Stein .",38,50,suction cups,4,3,7
3K1H3NEY7L0T32SNPWQ791M1OXPDGV,"In 1978 , sharp , curved claws on the suction cups of squid tentacles cut up the rubber coating on the hull of the USS Stein .",54,59,squid,0,4,4
3K1H3NEY7L0T32SNPWQ791M1OXPDGV,"In 1978 , sharp , curved claws on the suction cups of squid tentacles cut up the rubber coating on the hull of the USS Stein .",54,69,squid tentacles,6,2,8
3K1H3NEY7L0T32SNPWQ791M1OXPDGV,"In 1978 , sharp , curved claws on the suction cups of squid tentacles cut up the rubber coating on the hull of the USS Stein .",60,69,tentacles,7,6,13
3K1H3NEY7L0T32SNPWQ791M1OXPDGV,"In 1978 , sharp , curved claws on the suction cups of squid tentacles cut up the rubber coating on the hull of the USS Stein .",81,95,rubber coating,1,0,1
3K1H3NEY7L0T32SNPWQ791M1OXPDGV,"In 1978 , sharp , curved claws on the suction cups of squid tentacles cut up the rubber coating on the hull of the USS Stein .",88,95,coating,0,1,1
3K1H3NEY7L0T32SNPWQ791M1OXPDGV,"In 1978 , sharp , curved claws on the suction cups of squid tentacles cut up the rubber coating on the hull of the USS Stein .",103,107,hull,5,7,12
3K1H3NEY7L0T32SNPWQ791M1OXPDGV,"In 1978 , sharp , curved claws on the suction cups of squid tentacles cut up the rubber coating on the hull of the USS Stein .",119,124,Stein,1,0,1
3K1H3NEY7L0T32SNPWQ791M1OXPDGV,The kraken is a legendary tentacled monster possibly based on sightings of real giant squid .,4,10,kraken,10,1,11
3K1H3NEY7L0T32SNPWQ791M1OXPDGV,The kraken is a legendary tentacled monster possibly based on sightings of real giant squid .,16,25,legendary,3,6,9
3K1H3NEY7L0T32SNPWQ791M1OXPDGV,The kraken is a legendary tentacled monster possibly based on sightings of real giant squid .,16,35,legendary tentacled,1,1,2
3K1H3NEY7L0T32SNPWQ791M1OXPDGV,The kraken is a legendary tentacled monster possibly based on sightings of real giant squid .,26,35,tentacled,3,0,3
3K1H3NEY7L0T32SNPWQ791M1OXPDGV,The kraken is a legendary tentacled monster possibly based on sightings of real giant squid .,36,43,monster,1,1,2
3K1H3NEY7L0T32SNPWQ791M1OXPDGV,The kraken is a legendary tentacled monster possibly based on sightings of real giant squid .,62,71,sightings,1,5,6
3K1H3NEY7L0T32SNPWQ791M1OXPDGV,The kraken is a legendary tentacled monster possibly based on sightings of real giant squid .,80,85,giant,1,0,1
3K1H3NEY7L0T32SNPWQ791M1OXPDGV,The kraken is a legendary tentacled monster possibly based on sightings of real giant squid .,86,91,squid,1,0,1
3K1H3NEY7L0T32SNPWQ791M1OXPDGV,"In February 2007 , a New Zealand fishing vessel caught a colossal squid weighing 495 kg ( 1,091 lb ) and measuring around 10 m ( 33 ft ) off the coast of Antarctica .",33,47,fishing vessel,0,1,1
3K1H3NEY7L0T32SNPWQ791M1OXPDGV,"In February 2007 , a New Zealand fishing vessel caught a colossal squid weighing 495 kg ( 1,091 lb ) and measuring around 10 m ( 33 ft ) off the coast of Antarctica .",41,47,vessel,1,2,3
3K1H3NEY7L0T32SNPWQ791M1OXPDGV,"In February 2007 , a New Zealand fishing vessel caught a colossal squid weighing 495 kg ( 1,091 lb ) and measuring around 10 m ( 33 ft ) off the coast of Antarctica .",57,65,colossal,10,7,17
3K1H3NEY7L0T32SNPWQ791M1OXPDGV,"In February 2007 , a New Zealand fishing vessel caught a colossal squid weighing 495 kg ( 1,091 lb ) and measuring around 10 m ( 33 ft ) off the coast of Antarctica .",57,71,colossal squid,1,1,2
3K1H3NEY7L0T32SNPWQ791M1OXPDGV,"In February 2007 , a New Zealand fishing vessel caught a colossal squid weighing 495 kg ( 1,091 lb ) and measuring around 10 m ( 33 ft ) off the coast of Antarctica .",72,80,weighing,1,1,2
3K1H3NEY7L0T32SNPWQ791M1OXPDGV,"The majority are no more than 60 cm ( 24 in ) long , although the giant squid may reach 13 metres ( 43 ft ) .",4,12,majority,3,0,3
3K1H3NEY7L0T32SNPWQ791M1OXPDGV,"The majority are no more than 60 cm ( 24 in ) long , although the giant squid may reach 13 metres ( 43 ft ) .",66,71,giant,0,1,1
3JUDR1D0D6SXDHOLV3B27WZZXT92Q6,"Advanced Audio Coding ( AAC ) is a standardized , lossy compression and encoding scheme for digital audio .",0,21,Advanced Audio Coding,2,0,2
3JUDR1D0D6SXDHOLV3B27WZZXT92Q6,"Advanced Audio Coding ( AAC ) is a standardized , lossy compression and encoding scheme for digital audio .",15,21,Coding,1,1,2
3JUDR1D0D6SXDHOLV3B27WZZXT92Q6,"Advanced Audio Coding ( AAC ) is a standardized , lossy compression and encoding scheme for digital audio .",35,47,standardized,9,8,17
3JUDR1D0D6SXDHOLV3B27WZZXT92Q6,"Advanced Audio Coding ( AAC ) is a standardized , lossy compression and encoding scheme for digital audio .",50,55,lossy,2,4,6
3JUDR1D0D6SXDHOLV3B27WZZXT92Q6,"Advanced Audio Coding ( AAC ) is a standardized , lossy compression and encoding scheme for digital audio .",50,67,lossy compression,6,2,8
3JUDR1D0D6SXDHOLV3B27WZZXT92Q6,"Advanced Audio Coding ( AAC ) is a standardized , lossy compression and encoding scheme for digital audio .",56,67,compression,5,2,7
3JUDR1D0D6SXDHOLV3B27WZZXT92Q6,"Advanced Audio Coding ( AAC ) is a standardized , lossy compression and encoding scheme for digital audio .",72,80,encoding,6,4,10
3JUDR1D0D6SXDHOLV3B27WZZXT92Q6,"Advanced Audio Coding ( AAC ) is a standardized , lossy compression and encoding scheme for digital audio .",72,87,encoding scheme,3,1,4
3JUDR1D0D6SXDHOLV3B27WZZXT92Q6,"Advanced Audio Coding ( AAC ) is a standardized , lossy compression and encoding scheme for digital audio .",81,87,scheme,5,1,6
3JUDR1D0D6SXDHOLV3B27WZZXT92Q6,"Advanced Audio Coding ( AAC ) is a standardized , lossy compression and encoding scheme for digital audio .",92,99,digital,1,0,1
3JUDR1D0D6SXDHOLV3B27WZZXT92Q6,"Advanced Audio Coding ( AAC ) is a standardized , lossy compression and encoding scheme for digital audio .",92,105,digital audio,1,0,1
3JUDR1D0D6SXDHOLV3B27WZZXT92Q6,"In April 2003 , Apple brought mainstream attention to AAC by announcing that its iTunes and iPod products would support songs in MPEG-4 AAC format ( via a firmware update for older iPods ) .",30,40,mainstream,7,8,15
3JUDR1D0D6SXDHOLV3B27WZZXT92Q6,"In April 2003 , Apple brought mainstream attention to AAC by announcing that its iTunes and iPod products would support songs in MPEG-4 AAC format ( via a firmware update for older iPods ) .",54,57,AAC,0,1,1
3JUDR1D0D6SXDHOLV3B27WZZXT92Q6,"In April 2003 , Apple brought mainstream attention to AAC by announcing that its iTunes and iPod products would support songs in MPEG-4 AAC format ( via a firmware update for older iPods ) .",155,163,firmware,3,8,11
3JUDR1D0D6SXDHOLV3B27WZZXT92Q6,"In April 2003 , Apple brought mainstream attention to AAC by announcing that its iTunes and iPod products would support songs in MPEG-4 AAC format ( via a firmware update for older iPods ) .",155,170,firmware update,1,0,1
3JUDR1D0D6SXDHOLV3B27WZZXT92Q6,"In April 2003 , Apple brought mainstream attention to AAC by announcing that its iTunes and iPod products would support songs in MPEG-4 AAC format ( via a firmware update for older iPods ) .",181,186,iPods,0,1,1
3JUDR1D0D6SXDHOLV3B27WZZXT92Q6,"A major ( or the key of A ) is a major scale based on A , with the pitches A , B , C ♯ , D , E , F ♯ , and G ♯ .",33,44,major scale,1,0,1
3JUDR1D0D6SXDHOLV3B27WZZXT92Q6,"A major ( or the key of A ) is a major scale based on A , with the pitches A , B , C ♯ , D , E , F ♯ , and G ♯ .",67,74,pitches,1,5,6
3JUDR1D0D6SXDHOLV3B27WZZXT92Q6,The key of A major is the only key where a Neapolitan sixth chord on requires both a flat and a natural accidental .,43,53,Neapolitan,3,6,9
3JUDR1D0D6SXDHOLV3B27WZZXT92Q6,The key of A major is the only key where a Neapolitan sixth chord on requires both a flat and a natural accidental .,43,65,Neapolitan sixth chord,2,1,3
3JUDR1D0D6SXDHOLV3B27WZZXT92Q6,The key of A major is the only key where a Neapolitan sixth chord on requires both a flat and a natural accidental .,54,65,sixth chord,1,0,1
3JUDR1D0D6SXDHOLV3B27WZZXT92Q6,The key of A major is the only key where a Neapolitan sixth chord on requires both a flat and a natural accidental .,60,65,chord,5,2,7
3JUDR1D0D6SXDHOLV3B27WZZXT92Q6,The key of A major is the only key where a Neapolitan sixth chord on requires both a flat and a natural accidental .,85,89,flat,0,2,2
3JUDR1D0D6SXDHOLV3B27WZZXT92Q6,The key of A major is the only key where a Neapolitan sixth chord on requires both a flat and a natural accidental .,96,114,natural accidental,4,0,4
3JUDR1D0D6SXDHOLV3B27WZZXT92Q6,The key of A major is the only key where a Neapolitan sixth chord on requires both a flat and a natural accidental .,104,114,accidental,3,3,6
3JUDR1D0D6SXDHOLV3B27WZZXT92Q6,"Although not as rare in the symphonic literature as sharper keys , examples of symphonies in A major are not as numerous as for D major or G major .",28,37,symphonic,8,6,14
3JUDR1D0D6SXDHOLV3B27WZZXT92Q6,"Although not as rare in the symphonic literature as sharper keys , examples of symphonies in A major are not as numerous as for D major or G major .",28,48,symphonic literature,4,1,5
3JUDR1D0D6SXDHOLV3B27WZZXT92Q6,"Although not as rare in the symphonic literature as sharper keys , examples of symphonies in A major are not as numerous as for D major or G major .",38,48,literature,2,0,2
3JUDR1D0D6SXDHOLV3B27WZZXT92Q6,"Although not as rare in the symphonic literature as sharper keys , examples of symphonies in A major are not as numerous as for D major or G major .",52,59,sharper,0,1,1
3JUDR1D0D6SXDHOLV3B27WZZXT92Q6,"Although not as rare in the symphonic literature as sharper keys , examples of symphonies in A major are not as numerous as for D major or G major .",52,64,sharper keys,1,1,2
3JUDR1D0D6SXDHOLV3B27WZZXT92Q6,"Although not as rare in the symphonic literature as sharper keys , examples of symphonies in A major are not as numerous as for D major or G major .",79,89,symphonies,3,1,4
3JUDR1D0D6SXDHOLV3B27WZZXT92Q6,"Although not as rare in the symphonic literature as sharper keys , examples of symphonies in A major are not as numerous as for D major or G major .",112,120,numerous,7,3,10
3P7RGTLO6EE07HLUVDKKHS6OAB9AKT,"Most of Shakespeare 's comedies include instances of overt cross-dressing , such as Francis Flute in A Midsummer Night 's Dream .",8,19,Shakespeare,0,1,1
3P7RGTLO6EE07HLUVDKKHS6OAB9AKT,"Most of Shakespeare 's comedies include instances of overt cross-dressing , such as Francis Flute in A Midsummer Night 's Dream .",23,31,comedies,1,1,2
3P7RGTLO6EE07HLUVDKKHS6OAB9AKT,"Most of Shakespeare 's comedies include instances of overt cross-dressing , such as Francis Flute in A Midsummer Night 's Dream .",32,39,include,0,1,1
3P7RGTLO6EE07HLUVDKKHS6OAB9AKT,"Most of Shakespeare 's comedies include instances of overt cross-dressing , such as Francis Flute in A Midsummer Night 's Dream .",40,49,instances,6,5,11
3P7RGTLO6EE07HLUVDKKHS6OAB9AKT,"Most of Shakespeare 's comedies include instances of overt cross-dressing , such as Francis Flute in A Midsummer Night 's Dream .",53,58,overt,7,4,11
3P7RGTLO6EE07HLUVDKKHS6OAB9AKT,"Most of Shakespeare 's comedies include instances of overt cross-dressing , such as Francis Flute in A Midsummer Night 's Dream .",53,73,overt cross-dressing,0,4,4
3P7RGTLO6EE07HLUVDKKHS6OAB9AKT,"Most of Shakespeare 's comedies include instances of overt cross-dressing , such as Francis Flute in A Midsummer Night 's Dream .",59,73,cross-dressing,8,9,17
3P7RGTLO6EE07HLUVDKKHS6OAB9AKT,"Most of Shakespeare 's comedies include instances of overt cross-dressing , such as Francis Flute in A Midsummer Night 's Dream .",92,97,Flute,0,1,1
3P7RGTLO6EE07HLUVDKKHS6OAB9AKT,"Most of Shakespeare 's comedies include instances of overt cross-dressing , such as Francis Flute in A Midsummer Night 's Dream .",103,112,Midsummer,0,2,2
3P7RGTLO6EE07HLUVDKKHS6OAB9AKT,"Dustin Hoffman and Robin Williams have each appeared in a hit comedy film ( Tootsie and Mrs. Doubtfire , respectively ) in which they played most scenes dressed as a woman .",44,52,appeared,0,3,3
3P7RGTLO6EE07HLUVDKKHS6OAB9AKT,"Dustin Hoffman and Robin Williams have each appeared in a hit comedy film ( Tootsie and Mrs. Doubtfire , respectively ) in which they played most scenes dressed as a woman .",58,61,hit,0,2,2
3P7RGTLO6EE07HLUVDKKHS6OAB9AKT,"Dustin Hoffman and Robin Williams have each appeared in a hit comedy film ( Tootsie and Mrs. Doubtfire , respectively ) in which they played most scenes dressed as a woman .",88,102,Mrs. Doubtfire,1,0,1
3P7RGTLO6EE07HLUVDKKHS6OAB9AKT,"Dustin Hoffman and Robin Williams have each appeared in a hit comedy film ( Tootsie and Mrs. Doubtfire , respectively ) in which they played most scenes dressed as a woman .",105,117,respectively,7,1,8
3P7RGTLO6EE07HLUVDKKHS6OAB9AKT,"Dustin Hoffman and Robin Williams have each appeared in a hit comedy film ( Tootsie and Mrs. Doubtfire , respectively ) in which they played most scenes dressed as a woman .",153,160,dressed,1,1,2
3P7RGTLO6EE07HLUVDKKHS6OAB9AKT,Linda Hunt won an Academy Award for Best Supporting Actress for playing Billy Kwan in The Year of Living Dangerously .,18,25,Academy,1,0,1
3P7RGTLO6EE07HLUVDKKHS6OAB9AKT,Linda Hunt won an Academy Award for Best Supporting Actress for playing Billy Kwan in The Year of Living Dangerously .,36,51,Best Supporting,0,1,1
3P7RGTLO6EE07HLUVDKKHS6OAB9AKT,Linda Hunt won an Academy Award for Best Supporting Actress for playing Billy Kwan in The Year of Living Dangerously .,36,59,Best Supporting Actress,1,0,1
3P7RGTLO6EE07HLUVDKKHS6OAB9AKT,Linda Hunt won an Academy Award for Best Supporting Actress for playing Billy Kwan in The Year of Living Dangerously .,41,51,Supporting,0,2,2
3P7RGTLO6EE07HLUVDKKHS6OAB9AKT,Linda Hunt won an Academy Award for Best Supporting Actress for playing Billy Kwan in The Year of Living Dangerously .,41,59,Supporting Actress,0,1,1
3P7RGTLO6EE07HLUVDKKHS6OAB9AKT,Linda Hunt won an Academy Award for Best Supporting Actress for playing Billy Kwan in The Year of Living Dangerously .,105,116,Dangerously,1,2,3
3P7RGTLO6EE07HLUVDKKHS6OAB9AKT,Adolf von Henselt ( 12 May 1814 - 10 October 1889 ) was a German composer and pianist .,6,17,von Henselt,1,0,1
3P7RGTLO6EE07HLUVDKKHS6OAB9AKT,Adolf von Henselt ( 12 May 1814 - 10 October 1889 ) was a German composer and pianist .,58,73,German composer,0,1,1
3P7RGTLO6EE07HLUVDKKHS6OAB9AKT,Adolf von Henselt ( 12 May 1814 - 10 October 1889 ) was a German composer and pianist .,65,73,composer,7,5,12
3P7RGTLO6EE07HLUVDKKHS6OAB9AKT,Adolf von Henselt ( 12 May 1814 - 10 October 1889 ) was a German composer and pianist .,65,85,composer and pianist,0,1,1
3P7RGTLO6EE07HLUVDKKHS6OAB9AKT,Adolf von Henselt ( 12 May 1814 - 10 October 1889 ) was a German composer and pianist .,78,85,pianist,7,6,13
3P7RGTLO6EE07HLUVDKKHS6OAB9AKT,"At the 1988 Seoul Games , he won two gold medals in the Men 's 4x100 m Relay A2A4-7 and Men 's 4x400 m Relay A2A4-7 events , and three silver medals in the Men 's 100 m A4A9 , Men 's 200 m A4A9 , and Men 's 400 m A4A9 events .",12,23,Seoul Games,1,0,1
3P7RGTLO6EE07HLUVDKKHS6OAB9AKT,"At the 1988 Seoul Games , he won two gold medals in the Men 's 4x100 m Relay A2A4-7 and Men 's 4x400 m Relay A2A4-7 events , and three silver medals in the Men 's 100 m A4A9 , Men 's 200 m A4A9 , and Men 's 400 m A4A9 events .",71,76,Relay,0,3,3
3P7RGTLO6EE07HLUVDKKHS6OAB9AKT,"At the 1988 Seoul Games , he won two gold medals in the Men 's 4x100 m Relay A2A4-7 and Men 's 4x400 m Relay A2A4-7 events , and three silver medals in the Men 's 100 m A4A9 , Men 's 200 m A4A9 , and Men 's 400 m A4A9 events .",135,141,silver,0,1,1
3P7RGTLO6EE07HLUVDKKHS6OAB9AKT,"At the 1988 Seoul Games , he won two gold medals in the Men 's 4x100 m Relay A2A4-7 and Men 's 4x400 m Relay A2A4-7 events , and three silver medals in the Men 's 100 m A4A9 , Men 's 200 m A4A9 , and Men 's 400 m A4A9 events .",218,224,events,0,1,1
3ZG552ORAM5PIPK2H25CDJY7ELO2V0,"Mucha moved to Paris in 1887 , and continued his studies at Académie Julian and Académie Colarossi .",35,44,continued,1,1,2
3ZG552ORAM5PIPK2H25CDJY7ELO2V0,"Mucha moved to Paris in 1887 , and continued his studies at Académie Julian and Académie Colarossi .",60,68,Académie,1,1,2
3ZG552ORAM5PIPK2H25CDJY7ELO2V0,"Mucha moved to Paris in 1887 , and continued his studies at Académie Julian and Académie Colarossi .",60,75,Académie Julian,1,0,1
3ZG552ORAM5PIPK2H25CDJY7ELO2V0,"Mucha moved to Paris in 1887 , and continued his studies at Académie Julian and Académie Colarossi .",60,98,Académie Julian and Académie Colarossi,1,0,1
3ZG552ORAM5PIPK2H25CDJY7ELO2V0,"Mucha moved to Paris in 1887 , and continued his studies at Académie Julian and Académie Colarossi .",80,98,Académie Colarossi,0,1,1
3ZG552ORAM5PIPK2H25CDJY7ELO2V0,"Mucha moved to Paris in 1887 , and continued his studies at Académie Julian and Académie Colarossi .",89,98,Colarossi,2,0,2
3ZG552ORAM5PIPK2H25CDJY7ELO2V0,"About Christmas 1894 , Mucha happened to go into a print shop where there was a sudden and unexpected need for a new advertising poster for a play featuring Sarah Bernhardt , the most famous actress in Paris , at the Théâtre de la Renaissance on the Boulevard Saint-Martin .",29,37,happened,1,1,2
3ZG552ORAM5PIPK2H25CDJY7ELO2V0,"About Christmas 1894 , Mucha happened to go into a print shop where there was a sudden and unexpected need for a new advertising poster for a play featuring Sarah Bernhardt , the most famous actress in Paris , at the Théâtre de la Renaissance on the Boulevard Saint-Martin .",51,56,print,0,1,1
3ZG552ORAM5PIPK2H25CDJY7ELO2V0,"About Christmas 1894 , Mucha happened to go into a print shop where there was a sudden and unexpected need for a new advertising poster for a play featuring Sarah Bernhardt , the most famous actress in Paris , at the Théâtre de la Renaissance on the Boulevard Saint-Martin .",51,61,print shop,2,3,5
3ZG552ORAM5PIPK2H25CDJY7ELO2V0,"About Christmas 1894 , Mucha happened to go into a print shop where there was a sudden and unexpected need for a new advertising poster for a play featuring Sarah Bernhardt , the most famous actress in Paris , at the Théâtre de la Renaissance on the Boulevard Saint-Martin .",80,86,sudden,0,1,1
3ZG552ORAM5PIPK2H25CDJY7ELO2V0,"About Christmas 1894 , Mucha happened to go into a print shop where there was a sudden and unexpected need for a new advertising poster for a play featuring Sarah Bernhardt , the most famous actress in Paris , at the Théâtre de la Renaissance on the Boulevard Saint-Martin .",80,101,sudden and unexpected,0,1,1
3ZG552ORAM5PIPK2H25CDJY7ELO2V0,"About Christmas 1894 , Mucha happened to go into a print shop where there was a sudden and unexpected need for a new advertising poster for a play featuring Sarah Bernhardt , the most famous actress in Paris , at the Théâtre de la Renaissance on the Boulevard Saint-Martin .",91,101,unexpected,3,8,11
3ZG552ORAM5PIPK2H25CDJY7ELO2V0,"About Christmas 1894 , Mucha happened to go into a print shop where there was a sudden and unexpected need for a new advertising poster for a play featuring Sarah Bernhardt , the most famous actress in Paris , at the Théâtre de la Renaissance on the Boulevard Saint-Martin .",117,128,advertising,3,3,6
3ZG552ORAM5PIPK2H25CDJY7ELO2V0,"About Christmas 1894 , Mucha happened to go into a print shop where there was a sudden and unexpected need for a new advertising poster for a play featuring Sarah Bernhardt , the most famous actress in Paris , at the Théâtre de la Renaissance on the Boulevard Saint-Martin .",117,135,advertising poster,1,2,3
3ZG552ORAM5PIPK2H25CDJY7ELO2V0,"About Christmas 1894 , Mucha happened to go into a print shop where there was a sudden and unexpected need for a new advertising poster for a play featuring Sarah Bernhardt , the most famous actress in Paris , at the Théâtre de la Renaissance on the Boulevard Saint-Martin .",142,146,play,1,0,1
3ZG552ORAM5PIPK2H25CDJY7ELO2V0,"About Christmas 1894 , Mucha happened to go into a print shop where there was a sudden and unexpected need for a new advertising poster for a play featuring Sarah Bernhardt , the most famous actress in Paris , at the Théâtre de la Renaissance on the Boulevard Saint-Martin .",147,156,featuring,0,6,6
3ZG552ORAM5PIPK2H25CDJY7ELO2V0,"About Christmas 1894 , Mucha happened to go into a print shop where there was a sudden and unexpected need for a new advertising poster for a play featuring Sarah Bernhardt , the most famous actress in Paris , at the Théâtre de la Renaissance on the Boulevard Saint-Martin .",163,172,Bernhardt,1,0,1
3ZG552ORAM5PIPK2H25CDJY7ELO2V0,"About Christmas 1894 , Mucha happened to go into a print shop where there was a sudden and unexpected need for a new advertising poster for a play featuring Sarah Bernhardt , the most famous actress in Paris , at the Théâtre de la Renaissance on the Boulevard Saint-Martin .",217,224,Théâtre,0,1,1
3ZG552ORAM5PIPK2H25CDJY7ELO2V0,"About Christmas 1894 , Mucha happened to go into a print shop where there was a sudden and unexpected need for a new advertising poster for a play featuring Sarah Bernhardt , the most famous actress in Paris , at the Théâtre de la Renaissance on the Boulevard Saint-Martin .",217,242,Théâtre de la Renaissance,1,0,1
3ZG552ORAM5PIPK2H25CDJY7ELO2V0,"About Christmas 1894 , Mucha happened to go into a print shop where there was a sudden and unexpected need for a new advertising poster for a play featuring Sarah Bernhardt , the most famous actress in Paris , at the Théâtre de la Renaissance on the Boulevard Saint-Martin .",231,242,Renaissance,4,3,7
3ZG552ORAM5PIPK2H25CDJY7ELO2V0,"About Christmas 1894 , Mucha happened to go into a print shop where there was a sudden and unexpected need for a new advertising poster for a play featuring Sarah Bernhardt , the most famous actress in Paris , at the Théâtre de la Renaissance on the Boulevard Saint-Martin .",250,272,Boulevard Saint-Martin,1,0,1
3ZG552ORAM5PIPK2H25CDJY7ELO2V0,"Mucha volunteered to produce a lithographed poster within two weeks , and on 1 January 1895 , the advertisement for the play Gismonda by Victorien Sardou was posted in the city , where it attracted much attention .",6,17,volunteered,3,9,12
3ZG552ORAM5PIPK2H25CDJY7ELO2V0,"Mucha volunteered to produce a lithographed poster within two weeks , and on 1 January 1895 , the advertisement for the play Gismonda by Victorien Sardou was posted in the city , where it attracted much attention .",21,28,produce,1,0,1
3ZG552ORAM5PIPK2H25CDJY7ELO2V0,"Mucha volunteered to produce a lithographed poster within two weeks , and on 1 January 1895 , the advertisement for the play Gismonda by Victorien Sardou was posted in the city , where it attracted much attention .",31,43,lithographed,10,10,20
3ZG552ORAM5PIPK2H25CDJY7ELO2V0,"Mucha volunteered to produce a lithographed poster within two weeks , and on 1 January 1895 , the advertisement for the play Gismonda by Victorien Sardou was posted in the city , where it attracted much attention .",31,50,lithographed poster,1,5,6
3ZG552ORAM5PIPK2H25CDJY7ELO2V0,"Mucha volunteered to produce a lithographed poster within two weeks , and on 1 January 1895 , the advertisement for the play Gismonda by Victorien Sardou was posted in the city , where it attracted much attention .",98,111,advertisement,3,1,4
3ZG552ORAM5PIPK2H25CDJY7ELO2V0,"Mucha volunteered to produce a lithographed poster within two weeks , and on 1 January 1895 , the advertisement for the play Gismonda by Victorien Sardou was posted in the city , where it attracted much attention .",125,133,Gismonda,1,0,1
3ZG552ORAM5PIPK2H25CDJY7ELO2V0,"Mucha volunteered to produce a lithographed poster within two weeks , and on 1 January 1895 , the advertisement for the play Gismonda by Victorien Sardou was posted in the city , where it attracted much attention .",188,197,attracted,2,1,3
3ZG552ORAM5PIPK2H25CDJY7ELO2V0,"Mucha volunteered to produce a lithographed poster within two weeks , and on 1 January 1895 , the advertisement for the play Gismonda by Victorien Sardou was posted in the city , where it attracted much attention .",203,212,attention,0,2,2
3ZG552ORAM5PIPK2H25CDJY7ELO2V0,Bernhardt was so satisfied with the success of this first poster that she began a six-year contract with Mucha .,17,26,satisfied,2,1,3
3ZG552ORAM5PIPK2H25CDJY7ELO2V0,Bernhardt was so satisfied with the success of this first poster that she began a six-year contract with Mucha .,36,43,success,0,1,1
3ZG552ORAM5PIPK2H25CDJY7ELO2V0,Bernhardt was so satisfied with the success of this first poster that she began a six-year contract with Mucha .,58,64,poster,0,1,1
3ZG552ORAM5PIPK2H25CDJY7ELO2V0,Bernhardt was so satisfied with the success of this first poster that she began a six-year contract with Mucha .,91,99,contract,0,2,2
3VDI8GSXAFUHM7WW8OFRN980D6S8GK,"The word actor refers to a person who acts regardless of gender , and this term `` is increasingly preferred '' , while actress refers specifically to a female person who acts .",15,21,refers,2,2,4
3VDI8GSXAFUHM7WW8OFRN980D6S8GK,"The word actor refers to a person who acts regardless of gender , and this term `` is increasingly preferred '' , while actress refers specifically to a female person who acts .",43,53,regardless,9,7,16
3VDI8GSXAFUHM7WW8OFRN980D6S8GK,"The word actor refers to a person who acts regardless of gender , and this term `` is increasingly preferred '' , while actress refers specifically to a female person who acts .",86,98,increasingly,3,3,6
3VDI8GSXAFUHM7WW8OFRN980D6S8GK,"The word actor refers to a person who acts regardless of gender , and this term `` is increasingly preferred '' , while actress refers specifically to a female person who acts .",86,108,increasingly preferred,3,1,4
3VDI8GSXAFUHM7WW8OFRN980D6S8GK,"The word actor refers to a person who acts regardless of gender , and this term `` is increasingly preferred '' , while actress refers specifically to a female person who acts .",99,108,preferred,2,4,6
3VDI8GSXAFUHM7WW8OFRN980D6S8GK,"The word actor refers to a person who acts regardless of gender , and this term `` is increasingly preferred '' , while actress refers specifically to a female person who acts .",135,147,specifically,5,3,8
3VDI8GSXAFUHM7WW8OFRN980D6S8GK,The first recorded case of an actor performing took place in 534 BC ( though the changes in calendar over the years make it hard to determine exactly ) when the Greek performer Thespis stepped on to the stage at the Theatre Dionysus and became the first known person to speak words as a character in a play or story .,10,18,recorded,0,2,2
3VDI8GSXAFUHM7WW8OFRN980D6S8GK,The first recorded case of an actor performing took place in 534 BC ( though the changes in calendar over the years make it hard to determine exactly ) when the Greek performer Thespis stepped on to the stage at the Theatre Dionysus and became the first known person to speak words as a character in a play or story .,36,46,performing,1,0,1
3VDI8GSXAFUHM7WW8OFRN980D6S8GK,The first recorded case of an actor performing took place in 534 BC ( though the changes in calendar over the years make it hard to determine exactly ) when the Greek performer Thespis stepped on to the stage at the Theatre Dionysus and became the first known person to speak words as a character in a play or story .,132,141,determine,4,3,7
3VDI8GSXAFUHM7WW8OFRN980D6S8GK,The first recorded case of an actor performing took place in 534 BC ( though the changes in calendar over the years make it hard to determine exactly ) when the Greek performer Thespis stepped on to the stage at the Theatre Dionysus and became the first known person to speak words as a character in a play or story .,167,176,performer,1,2,3
3VDI8GSXAFUHM7WW8OFRN980D6S8GK,The first recorded case of an actor performing took place in 534 BC ( though the changes in calendar over the years make it hard to determine exactly ) when the Greek performer Thespis stepped on to the stage at the Theatre Dionysus and became the first known person to speak words as a character in a play or story .,177,184,Thespis,1,0,1
3VDI8GSXAFUHM7WW8OFRN980D6S8GK,The first recorded case of an actor performing took place in 534 BC ( though the changes in calendar over the years make it hard to determine exactly ) when the Greek performer Thespis stepped on to the stage at the Theatre Dionysus and became the first known person to speak words as a character in a play or story .,185,192,stepped,0,3,3
3VDI8GSXAFUHM7WW8OFRN980D6S8GK,The first recorded case of an actor performing took place in 534 BC ( though the changes in calendar over the years make it hard to determine exactly ) when the Greek performer Thespis stepped on to the stage at the Theatre Dionysus and became the first known person to speak words as a character in a play or story .,216,223,Theatre,1,0,1
3VDI8GSXAFUHM7WW8OFRN980D6S8GK,The first recorded case of an actor performing took place in 534 BC ( though the changes in calendar over the years make it hard to determine exactly ) when the Greek performer Thespis stepped on to the stage at the Theatre Dionysus and became the first known person to speak words as a character in a play or story .,216,232,Theatre Dionysus,2,0,2
3VDI8GSXAFUHM7WW8OFRN980D6S8GK,The first recorded case of an actor performing took place in 534 BC ( though the changes in calendar over the years make it hard to determine exactly ) when the Greek performer Thespis stepped on to the stage at the Theatre Dionysus and became the first known person to speak words as a character in a play or story .,224,232,Dionysus,0,1,1
3VDI8GSXAFUHM7WW8OFRN980D6S8GK,The first recorded case of an actor performing took place in 534 BC ( though the changes in calendar over the years make it hard to determine exactly ) when the Greek performer Thespis stepped on to the stage at the Theatre Dionysus and became the first known person to speak words as a character in a play or story .,287,296,character,3,1,4
3VDI8GSXAFUHM7WW8OFRN980D6S8GK,"Prior to Thespis ' act , stories were only known to be told in song and dance and in third person narrative .",9,16,Thespis,0,2,2
3VDI8GSXAFUHM7WW8OFRN980D6S8GK,"Prior to Thespis ' act , stories were only known to be told in song and dance and in third person narrative .",9,21,Thespis  act,1,0,1
3VDI8GSXAFUHM7WW8OFRN980D6S8GK,"Prior to Thespis ' act , stories were only known to be told in song and dance and in third person narrative .",85,97,third person,1,0,1
3VDI8GSXAFUHM7WW8OFRN980D6S8GK,"Prior to Thespis ' act , stories were only known to be told in song and dance and in third person narrative .",85,107,third person narrative,2,0,2
3VDI8GSXAFUHM7WW8OFRN980D6S8GK,"Prior to Thespis ' act , stories were only known to be told in song and dance and in third person narrative .",98,107,narrative,10,9,19
3VDI8GSXAFUHM7WW8OFRN980D6S8GK,"In the ancient Greece and Rome and the medieval world , it was considered disgraceful for a woman to go on the stage , and this belief persisted until the 17th century , when in Venice it was broken .",7,14,ancient,2,2,4
3VDI8GSXAFUHM7WW8OFRN980D6S8GK,"In the ancient Greece and Rome and the medieval world , it was considered disgraceful for a woman to go on the stage , and this belief persisted until the 17th century , when in Venice it was broken .",39,47,medieval,10,6,16
3VDI8GSXAFUHM7WW8OFRN980D6S8GK,"In the ancient Greece and Rome and the medieval world , it was considered disgraceful for a woman to go on the stage , and this belief persisted until the 17th century , when in Venice it was broken .",39,53,medieval world,1,0,1
3VDI8GSXAFUHM7WW8OFRN980D6S8GK,"In the ancient Greece and Rome and the medieval world , it was considered disgraceful for a woman to go on the stage , and this belief persisted until the 17th century , when in Venice it was broken .",74,85,disgraceful,8,9,17
3VDI8GSXAFUHM7WW8OFRN980D6S8GK,"In the ancient Greece and Rome and the medieval world , it was considered disgraceful for a woman to go on the stage , and this belief persisted until the 17th century , when in Venice it was broken .",128,134,belief,1,1,2
3VDI8GSXAFUHM7WW8OFRN980D6S8GK,"In the ancient Greece and Rome and the medieval world , it was considered disgraceful for a woman to go on the stage , and this belief persisted until the 17th century , when in Venice it was broken .",135,144,persisted,10,10,20
3VDI8GSXAFUHM7WW8OFRN980D6S8GK,"In the ancient Greece and Rome and the medieval world , it was considered disgraceful for a woman to go on the stage , and this belief persisted until the 17th century , when in Venice it was broken .",160,167,century,1,0,1
3FHTJGYT8N12SZVDU5H29V3Q2GSPGL,"The first festival was held from the 5 June 1948 to the 13 June 1948 and used the Aldeburgh Jubilee Hall , a few doors away from Britten 's house in Crabbe Street , as its main venue .",0,18,The first festival,0,1,1
3FHTJGYT8N12SZVDU5H29V3Q2GSPGL,"The first festival was held from the 5 June 1948 to the 13 June 1948 and used the Aldeburgh Jubilee Hall , a few doors away from Britten 's house in Crabbe Street , as its main venue .",10,18,festival,2,1,3
3FHTJGYT8N12SZVDU5H29V3Q2GSPGL,"The first festival was held from the 5 June 1948 to the 13 June 1948 and used the Aldeburgh Jubilee Hall , a few doors away from Britten 's house in Crabbe Street , as its main venue .",82,91,Aldeburgh,0,1,1
3FHTJGYT8N12SZVDU5H29V3Q2GSPGL,"The first festival was held from the 5 June 1948 to the 13 June 1948 and used the Aldeburgh Jubilee Hall , a few doors away from Britten 's house in Crabbe Street , as its main venue .",82,104,Aldeburgh Jubilee Hall,1,1,2
3FHTJGYT8N12SZVDU5H29V3Q2GSPGL,"The first festival was held from the 5 June 1948 to the 13 June 1948 and used the Aldeburgh Jubilee Hall , a few doors away from Britten 's house in Crabbe Street , as its main venue .",92,99,Jubilee,0,1,1
3FHTJGYT8N12SZVDU5H29V3Q2GSPGL,"The first festival was held from the 5 June 1948 to the 13 June 1948 and used the Aldeburgh Jubilee Hall , a few doors away from Britten 's house in Crabbe Street , as its main venue .",129,144,Britten s house,1,0,1
3FHTJGYT8N12SZVDU5H29V3Q2GSPGL,"The first festival was held from the 5 June 1948 to the 13 June 1948 and used the Aldeburgh Jubilee Hall , a few doors away from Britten 's house in Crabbe Street , as its main venue .",149,162,Crabbe Street,0,1,1
3FHTJGYT8N12SZVDU5H29V3Q2GSPGL,"The first festival was held from the 5 June 1948 to the 13 June 1948 and used the Aldeburgh Jubilee Hall , a few doors away from Britten 's house in Crabbe Street , as its main venue .",172,182,main venue,0,1,1
3FHTJGYT8N12SZVDU5H29V3Q2GSPGL,"The first festival was held from the 5 June 1948 to the 13 June 1948 and used the Aldeburgh Jubilee Hall , a few doors away from Britten 's house in Crabbe Street , as its main venue .",177,182,venue,7,3,10
3FHTJGYT8N12SZVDU5H29V3Q2GSPGL,"It featured a performance of Albert Herring by the English Opera Group ; Britten 's newly-written St. Nicolas cantata , op .42 ; and performances by Clifford Curzon and the Zorian String Quartet .",3,11,featured,1,8,9
3FHTJGYT8N12SZVDU5H29V3Q2GSPGL,"It featured a performance of Albert Herring by the English Opera Group ; Britten 's newly-written St. Nicolas cantata , op .42 ; and performances by Clifford Curzon and the Zorian String Quartet .",14,25,performance,3,7,10
3FHTJGYT8N12SZVDU5H29V3Q2GSPGL,"It featured a performance of Albert Herring by the English Opera Group ; Britten 's newly-written St. Nicolas cantata , op .42 ; and performances by Clifford Curzon and the Zorian String Quartet .",59,64,Opera,0,1,1
3FHTJGYT8N12SZVDU5H29V3Q2GSPGL,"It featured a performance of Albert Herring by the English Opera Group ; Britten 's newly-written St. Nicolas cantata , op .42 ; and performances by Clifford Curzon and the Zorian String Quartet .",84,97,newly-written,0,2,2
3FHTJGYT8N12SZVDU5H29V3Q2GSPGL,"It featured a performance of Albert Herring by the English Opera Group ; Britten 's newly-written St. Nicolas cantata , op .42 ; and performances by Clifford Curzon and the Zorian String Quartet .",98,117,St. Nicolas cantata,1,0,1
3FHTJGYT8N12SZVDU5H29V3Q2GSPGL,"It featured a performance of Albert Herring by the English Opera Group ; Britten 's newly-written St. Nicolas cantata , op .42 ; and performances by Clifford Curzon and the Zorian String Quartet .",110,117,cantata,5,0,5
3FHTJGYT8N12SZVDU5H29V3Q2GSPGL,"It featured a performance of Albert Herring by the English Opera Group ; Britten 's newly-written St. Nicolas cantata , op .42 ; and performances by Clifford Curzon and the Zorian String Quartet .",120,122,op,1,0,1
3FHTJGYT8N12SZVDU5H29V3Q2GSPGL,"It featured a performance of Albert Herring by the English Opera Group ; Britten 's newly-written St. Nicolas cantata , op .42 ; and performances by Clifford Curzon and the Zorian String Quartet .",133,145,performances,1,1,2
3FHTJGYT8N12SZVDU5H29V3Q2GSPGL,"It featured a performance of Albert Herring by the English Opera Group ; Britten 's newly-written St. Nicolas cantata , op .42 ; and performances by Clifford Curzon and the Zorian String Quartet .",158,164,Curzon,1,1,2
3FHTJGYT8N12SZVDU5H29V3Q2GSPGL,"It featured a performance of Albert Herring by the English Opera Group ; Britten 's newly-written St. Nicolas cantata , op .42 ; and performances by Clifford Curzon and the Zorian String Quartet .",180,186,String,0,1,1
3FHTJGYT8N12SZVDU5H29V3Q2GSPGL,"It featured a performance of Albert Herring by the English Opera Group ; Britten 's newly-written St. Nicolas cantata , op .42 ; and performances by Clifford Curzon and the Zorian String Quartet .",180,194,String Quartet,0,1,1
3FHTJGYT8N12SZVDU5H29V3Q2GSPGL,"It featured a performance of Albert Herring by the English Opera Group ; Britten 's newly-written St. Nicolas cantata , op .42 ; and performances by Clifford Curzon and the Zorian String Quartet .",187,194,Quartet,1,0,1
3FHTJGYT8N12SZVDU5H29V3Q2GSPGL,"Over the years the festival grew and took in additional venues such as Aldeburgh 's fifteenth-century church of Saint Peter and Saint Paul and venues in nearby Orford , Blythburgh and Framlingham .",19,27,festival,2,0,2
3FHTJGYT8N12SZVDU5H29V3Q2GSPGL,"Over the years the festival grew and took in additional venues such as Aldeburgh 's fifteenth-century church of Saint Peter and Saint Paul and venues in nearby Orford , Blythburgh and Framlingham .",28,32,grew,1,2,3
3FHTJGYT8N12SZVDU5H29V3Q2GSPGL,"Over the years the festival grew and took in additional venues such as Aldeburgh 's fifteenth-century church of Saint Peter and Saint Paul and venues in nearby Orford , Blythburgh and Framlingham .",45,55,additional,3,1,4
3FHTJGYT8N12SZVDU5H29V3Q2GSPGL,"Over the years the festival grew and took in additional venues such as Aldeburgh 's fifteenth-century church of Saint Peter and Saint Paul and venues in nearby Orford , Blythburgh and Framlingham .",45,62,additional venues,1,1,2
3FHTJGYT8N12SZVDU5H29V3Q2GSPGL,"Over the years the festival grew and took in additional venues such as Aldeburgh 's fifteenth-century church of Saint Peter and Saint Paul and venues in nearby Orford , Blythburgh and Framlingham .",56,62,venues,2,8,10
3FHTJGYT8N12SZVDU5H29V3Q2GSPGL,"Over the years the festival grew and took in additional venues such as Aldeburgh 's fifteenth-century church of Saint Peter and Saint Paul and venues in nearby Orford , Blythburgh and Framlingham .",71,80,Aldeburgh,1,0,1
3FHTJGYT8N12SZVDU5H29V3Q2GSPGL,"Over the years the festival grew and took in additional venues such as Aldeburgh 's fifteenth-century church of Saint Peter and Saint Paul and venues in nearby Orford , Blythburgh and Framlingham .",143,149,venues,3,3,6
3FHTJGYT8N12SZVDU5H29V3Q2GSPGL,"Over the years the festival grew and took in additional venues such as Aldeburgh 's fifteenth-century church of Saint Peter and Saint Paul and venues in nearby Orford , Blythburgh and Framlingham .",153,159,nearby,0,3,3
3FHTJGYT8N12SZVDU5H29V3Q2GSPGL,"Over the years the festival grew and took in additional venues such as Aldeburgh 's fifteenth-century church of Saint Peter and Saint Paul and venues in nearby Orford , Blythburgh and Framlingham .",169,179,Blythburgh,1,1,2
3FHTJGYT8N12SZVDU5H29V3Q2GSPGL,"Over the years the festival grew and took in additional venues such as Aldeburgh 's fifteenth-century church of Saint Peter and Saint Paul and venues in nearby Orford , Blythburgh and Framlingham .",184,195,Framlingham,1,1,2
3FHTJGYT8N12SZVDU5H29V3Q2GSPGL,"The new concert hall was opened by the Queen on 2 June 1967 , at the start of the twentieth Aldeburgh Festival .",8,15,concert,6,6,12
3FHTJGYT8N12SZVDU5H29V3Q2GSPGL,"The new concert hall was opened by the Queen on 2 June 1967 , at the start of the twentieth Aldeburgh Festival .",8,20,concert hall,0,1,1
3FHTJGYT8N12SZVDU5H29V3Q2GSPGL,"The new concert hall was opened by the Queen on 2 June 1967 , at the start of the twentieth Aldeburgh Festival .",16,20,hall,0,1,1
3FHTJGYT8N12SZVDU5H29V3Q2GSPGL,"The new concert hall was opened by the Queen on 2 June 1967 , at the start of the twentieth Aldeburgh Festival .",82,91,twentieth,0,2,2
3FHTJGYT8N12SZVDU5H29V3Q2GSPGL,"The new concert hall was opened by the Queen on 2 June 1967 , at the start of the twentieth Aldeburgh Festival .",82,110,twentieth Aldeburgh Festival,1,0,1
3FHTJGYT8N12SZVDU5H29V3Q2GSPGL,"The new concert hall was opened by the Queen on 2 June 1967 , at the start of the twentieth Aldeburgh Festival .",92,110,Aldeburgh Festival,1,0,1
3FHTJGYT8N12SZVDU5H29V3Q2GSPGL,"The new concert hall was opened by the Queen on 2 June 1967 , at the start of the twentieth Aldeburgh Festival .",102,110,Festival,1,0,1
3PZDSVZ3J5IMDYQGJP29WH1SCWIN40,"Repentant and rededicated , Faith returned as a heroine in other episodes of Angel and in the last five episodes of Buffy .",0,9,Repentant,10,9,19
3PZDSVZ3J5IMDYQGJP29WH1SCWIN40,"Repentant and rededicated , Faith returned as a heroine in other episodes of Angel and in the last five episodes of Buffy .",0,25,Repentant and rededicated,3,1,4
3PZDSVZ3J5IMDYQGJP29WH1SCWIN40,"Repentant and rededicated , Faith returned as a heroine in other episodes of Angel and in the last five episodes of Buffy .",14,25,rededicated,10,9,19
3PZDSVZ3J5IMDYQGJP29WH1SCWIN40,"Repentant and rededicated , Faith returned as a heroine in other episodes of Angel and in the last five episodes of Buffy .",48,55,heroine,10,1,11
3PZDSVZ3J5IMDYQGJP29WH1SCWIN40,"Repentant and rededicated , Faith returned as a heroine in other episodes of Angel and in the last five episodes of Buffy .",65,73,episodes,1,4,5
3PZDSVZ3J5IMDYQGJP29WH1SCWIN40,"Repentant and rededicated , Faith returned as a heroine in other episodes of Angel and in the last five episodes of Buffy .",77,82,Angel,1,0,1
3PZDSVZ3J5IMDYQGJP29WH1SCWIN40,"Repentant and rededicated , Faith returned as a heroine in other episodes of Angel and in the last five episodes of Buffy .",104,112,episodes,2,0,2
3PZDSVZ3J5IMDYQGJP29WH1SCWIN40,"Starting that same year , she starred in a new Fox TV series , Tru Calling , where she played the main character , medical student Tru Davies .",30,37,starred,1,1,2
3PZDSVZ3J5IMDYQGJP29WH1SCWIN40,"Starting that same year , she starred in a new Fox TV series , Tru Calling , where she played the main character , medical student Tru Davies .",103,112,character,2,0,2
3PZDSVZ3J5IMDYQGJP29WH1SCWIN40,"Starting that same year , she starred in a new Fox TV series , Tru Calling , where she played the main character , medical student Tru Davies .",115,122,medical,1,0,1
3PZDSVZ3J5IMDYQGJP29WH1SCWIN40,"Starting that same year , she starred in a new Fox TV series , Tru Calling , where she played the main character , medical student Tru Davies .",115,130,medical student,2,0,2
3PZDSVZ3J5IMDYQGJP29WH1SCWIN40,"Starting that same year , she starred in a new Fox TV series , Tru Calling , where she played the main character , medical student Tru Davies .",131,141,Tru Davies,1,0,1
3PZDSVZ3J5IMDYQGJP29WH1SCWIN40,"In 1993 , Dushku landed a role as Pearl alongside Robert De Niro and Leonardo DiCaprio in This Boy 's Life , a role that she said opened a lot of doors .",17,23,landed,3,2,5
3PZDSVZ3J5IMDYQGJP29WH1SCWIN40,"In 1993 , Dushku landed a role as Pearl alongside Robert De Niro and Leonardo DiCaprio in This Boy 's Life , a role that she said opened a lot of doors .",40,49,alongside,5,4,9
3PZDSVZ3J5IMDYQGJP29WH1SCWIN40,"She had parts as Paul Reiser 's daughter in Bye Bye Love , as Cindy Johnson in Race the Sun , and roles in a television movie and a short film .",32,40,daughter,1,1,2
3PZDSVZ3J5IMDYQGJP29WH1SCWIN40,"She had parts as Paul Reiser 's daughter in Bye Bye Love , as Cindy Johnson in Race the Sun , and roles in a television movie and a short film .",98,103,roles,2,2,4
3PZDSVZ3J5IMDYQGJP29WH1SCWIN40,"She had parts as Paul Reiser 's daughter in Bye Bye Love , as Cindy Johnson in Race the Sun , and roles in a television movie and a short film .",109,125,television movie,1,0,1
3PZDSVZ3J5IMDYQGJP29WH1SCWIN40,"After completing high school , Dushku returned to acting with the role of Faith on Buffy the Vampire Slayer , a Slayer much more troubled than the main character Buffy Summers .",6,16,completing,1,0,1
3PZDSVZ3J5IMDYQGJP29WH1SCWIN40,"After completing high school , Dushku returned to acting with the role of Faith on Buffy the Vampire Slayer , a Slayer much more troubled than the main character Buffy Summers .",66,79,role of Faith,0,1,1
3PZDSVZ3J5IMDYQGJP29WH1SCWIN40,"After completing high school , Dushku returned to acting with the role of Faith on Buffy the Vampire Slayer , a Slayer much more troubled than the main character Buffy Summers .",74,79,Faith,1,0,1
3PZDSVZ3J5IMDYQGJP29WH1SCWIN40,"After completing high school , Dushku returned to acting with the role of Faith on Buffy the Vampire Slayer , a Slayer much more troubled than the main character Buffy Summers .",83,88,Buffy,0,1,1
3PZDSVZ3J5IMDYQGJP29WH1SCWIN40,"After completing high school , Dushku returned to acting with the role of Faith on Buffy the Vampire Slayer , a Slayer much more troubled than the main character Buffy Summers .",83,107,Buffy the Vampire Slayer,1,0,1
3PZDSVZ3J5IMDYQGJP29WH1SCWIN40,"After completing high school , Dushku returned to acting with the role of Faith on Buffy the Vampire Slayer , a Slayer much more troubled than the main character Buffy Summers .",93,100,Vampire,1,1,2
3PZDSVZ3J5IMDYQGJP29WH1SCWIN40,"After completing high school , Dushku returned to acting with the role of Faith on Buffy the Vampire Slayer , a Slayer much more troubled than the main character Buffy Summers .",93,107,Vampire Slayer,2,1,3
3PZDSVZ3J5IMDYQGJP29WH1SCWIN40,"After completing high school , Dushku returned to acting with the role of Faith on Buffy the Vampire Slayer , a Slayer much more troubled than the main character Buffy Summers .",129,137,troubled,1,4,5
3PZDSVZ3J5IMDYQGJP29WH1SCWIN40,"After completing high school , Dushku returned to acting with the role of Faith on Buffy the Vampire Slayer , a Slayer much more troubled than the main character Buffy Summers .",152,161,character,2,0,2
3PZDSVZ3J5IMDYQGJP29WH1SCWIN40,"After completing high school , Dushku returned to acting with the role of Faith on Buffy the Vampire Slayer , a Slayer much more troubled than the main character Buffy Summers .",162,167,Buffy,1,0,1
3WGZLY9VCHNEANM56YEJHO530EC8DA,"Tony Teixeira took control of the series in 2006 , leading it to liquidation by 2009 .",5,13,Teixeira,1,0,1
3WGZLY9VCHNEANM56YEJHO530EC8DA,"Tony Teixeira took control of the series in 2006 , leading it to liquidation by 2009 .",51,58,leading,0,1,1
3WGZLY9VCHNEANM56YEJHO530EC8DA,"Tony Teixeira took control of the series in 2006 , leading it to liquidation by 2009 .",65,76,liquidation,10,10,20
3WGZLY9VCHNEANM56YEJHO530EC8DA,"Once the series had received the backing of the FIA , a management structure including new executive directors Brian Menell and Tony Teixeira were appointed to oversee the sale of franchises for the operation of international teams .",48,51,FIA,1,0,1
3WGZLY9VCHNEANM56YEJHO530EC8DA,"Once the series had received the backing of the FIA , a management structure including new executive directors Brian Menell and Tony Teixeira were appointed to oversee the sale of franchises for the operation of international teams .",56,66,management,2,1,3
3WGZLY9VCHNEANM56YEJHO530EC8DA,"Once the series had received the backing of the FIA , a management structure including new executive directors Brian Menell and Tony Teixeira were appointed to oversee the sale of franchises for the operation of international teams .",56,76,management structure,4,3,7
3WGZLY9VCHNEANM56YEJHO530EC8DA,"Once the series had received the backing of the FIA , a management structure including new executive directors Brian Menell and Tony Teixeira were appointed to oversee the sale of franchises for the operation of international teams .",67,76,structure,0,1,1
3WGZLY9VCHNEANM56YEJHO530EC8DA,"Once the series had received the backing of the FIA , a management structure including new executive directors Brian Menell and Tony Teixeira were appointed to oversee the sale of franchises for the operation of international teams .",91,100,executive,4,2,6
3WGZLY9VCHNEANM56YEJHO530EC8DA,"Once the series had received the backing of the FIA , a management structure including new executive directors Brian Menell and Tony Teixeira were appointed to oversee the sale of franchises for the operation of international teams .",91,110,executive directors,2,1,3
3WGZLY9VCHNEANM56YEJHO530EC8DA,"Once the series had received the backing of the FIA , a management structure including new executive directors Brian Menell and Tony Teixeira were appointed to oversee the sale of franchises for the operation of international teams .",133,141,Teixeira,1,1,2
3WGZLY9VCHNEANM56YEJHO530EC8DA,"Once the series had received the backing of the FIA , a management structure including new executive directors Brian Menell and Tony Teixeira were appointed to oversee the sale of franchises for the operation of international teams .",147,156,appointed,1,1,2
3WGZLY9VCHNEANM56YEJHO530EC8DA,"Once the series had received the backing of the FIA , a management structure including new executive directors Brian Menell and Tony Teixeira were appointed to oversee the sale of franchises for the operation of international teams .",147,167,appointed to oversee,1,0,1
3WGZLY9VCHNEANM56YEJHO530EC8DA,"Once the series had received the backing of the FIA , a management structure including new executive directors Brian Menell and Tony Teixeira were appointed to oversee the sale of franchises for the operation of international teams .",157,167,to oversee,1,0,1
3WGZLY9VCHNEANM56YEJHO530EC8DA,"Once the series had received the backing of the FIA , a management structure including new executive directors Brian Menell and Tony Teixeira were appointed to oversee the sale of franchises for the operation of international teams .",160,167,oversee,4,4,8
3WGZLY9VCHNEANM56YEJHO530EC8DA,"Once the series had received the backing of the FIA , a management structure including new executive directors Brian Menell and Tony Teixeira were appointed to oversee the sale of franchises for the operation of international teams .",160,176,oversee the sale,0,1,1
3WGZLY9VCHNEANM56YEJHO530EC8DA,"Once the series had received the backing of the FIA , a management structure including new executive directors Brian Menell and Tony Teixeira were appointed to oversee the sale of franchises for the operation of international teams .",180,190,franchises,9,9,18
3WGZLY9VCHNEANM56YEJHO530EC8DA,"Once the series had received the backing of the FIA , a management structure including new executive directors Brian Menell and Tony Teixeira were appointed to oversee the sale of franchises for the operation of international teams .",199,208,operation,2,0,2
3WGZLY9VCHNEANM56YEJHO530EC8DA,"Once the series had received the backing of the FIA , a management structure including new executive directors Brian Menell and Tony Teixeira were appointed to oversee the sale of franchises for the operation of international teams .",199,231,operation of international teams,1,0,1
3WGZLY9VCHNEANM56YEJHO530EC8DA,"Nelson Piquet , Jr. won the inaugural race of the series for A1 Team Brazil .",28,37,inaugural,10,10,20
3WGZLY9VCHNEANM56YEJHO530EC8DA,"Nelson Piquet , Jr. won the inaugural race of the series for A1 Team Brazil .",28,42,inaugural race,0,2,2
3WGZLY9VCHNEANM56YEJHO530EC8DA,"At the final race of the season in Shanghai , A1 Team France were crowned the first-ever A1 Grand Prix world champions with 172 points .",13,17,race,0,1,1
3WGZLY9VCHNEANM56YEJHO530EC8DA,"At the final race of the season in Shanghai , A1 Team France were crowned the first-ever A1 Grand Prix world champions with 172 points .",66,73,crowned,2,5,7
3WGZLY9VCHNEANM56YEJHO530EC8DA,"At the final race of the season in Shanghai , A1 Team France were crowned the first-ever A1 Grand Prix world champions with 172 points .",78,88,first-ever,1,0,1
3WGZLY9VCHNEANM56YEJHO530EC8DA,"At the final race of the season in Shanghai , A1 Team France were crowned the first-ever A1 Grand Prix world champions with 172 points .",92,118,Grand Prix world champions,1,0,1
3WGZLY9VCHNEANM56YEJHO530EC8DA,"The 2006-07 schedule was released on 7 July 2006 , with the first race at Circuit Park Zandvoort on 1 October 2006 , and the last race at Brands Hatch on 29 April 2007 .",12,20,schedule,0,4,4
3WGZLY9VCHNEANM56YEJHO530EC8DA,"The 2006-07 schedule was released on 7 July 2006 , with the first race at Circuit Park Zandvoort on 1 October 2006 , and the last race at Brands Hatch on 29 April 2007 .",25,33,released,0,2,2
3WGZLY9VCHNEANM56YEJHO530EC8DA,"The 2006-07 schedule was released on 7 July 2006 , with the first race at Circuit Park Zandvoort on 1 October 2006 , and the last race at Brands Hatch on 29 April 2007 .",74,96,Circuit Park Zandvoort,1,0,1
3WGZLY9VCHNEANM56YEJHO530EC8DA,"The 2006-07 schedule was released on 7 July 2006 , with the first race at Circuit Park Zandvoort on 1 October 2006 , and the last race at Brands Hatch on 29 April 2007 .",87,96,Zandvoort,2,0,2
3WGZLY9VCHNEANM56YEJHO530EC8DA,"The 2006-07 schedule was released on 7 July 2006 , with the first race at Circuit Park Zandvoort on 1 October 2006 , and the last race at Brands Hatch on 29 April 2007 .",138,144,Brands,0,1,1
3WGZLY9VCHNEANM56YEJHO530EC8DA,"The 2006-07 schedule was released on 7 July 2006 , with the first race at Circuit Park Zandvoort on 1 October 2006 , and the last race at Brands Hatch on 29 April 2007 .",138,150,Brands Hatch,1,0,1
3WGZLY9VCHNEANM56YEJHO530EC8DA,"The 2006-07 schedule was released on 7 July 2006 , with the first race at Circuit Park Zandvoort on 1 October 2006 , and the last race at Brands Hatch on 29 April 2007 .",145,150,Hatch,0,1,1
3OYHVNTV5TZP9LFV5WP2INQTZSDKO2,"Two is the smallest and the first prime number , and the only even prime number ( for this reason it is sometimes called `` the oddest prime '' ) .",34,39,prime,4,2,6
3OYHVNTV5TZP9LFV5WP2INQTZSDKO2,"Two is the smallest and the first prime number , and the only even prime number ( for this reason it is sometimes called `` the oddest prime '' ) .",34,46,prime number,4,4,8
3OYHVNTV5TZP9LFV5WP2INQTZSDKO2,"Two is the smallest and the first prime number , and the only even prime number ( for this reason it is sometimes called `` the oddest prime '' ) .",67,72,prime,0,1,1
3OYHVNTV5TZP9LFV5WP2INQTZSDKO2,"Two is the smallest and the first prime number , and the only even prime number ( for this reason it is sometimes called `` the oddest prime '' ) .",128,134,oddest,3,4,7
3OYHVNTV5TZP9LFV5WP2INQTZSDKO2,"Two is the smallest and the first prime number , and the only even prime number ( for this reason it is sometimes called `` the oddest prime '' ) .",128,140,oddest prime,1,0,1
3OYHVNTV5TZP9LFV5WP2INQTZSDKO2,"Two is the base of the simplest numeral system in which natural numbers can be written concisely , being the length of the number a logarithm of the value of the number ( whereas in base 1 the length of the number is the value of the number itself ) ; the binary system is used in computers .",11,15,base,2,0,2
3OYHVNTV5TZP9LFV5WP2INQTZSDKO2,"Two is the base of the simplest numeral system in which natural numbers can be written concisely , being the length of the number a logarithm of the value of the number ( whereas in base 1 the length of the number is the value of the number itself ) ; the binary system is used in computers .",23,31,simplest,0,1,1
3OYHVNTV5TZP9LFV5WP2INQTZSDKO2,"Two is the base of the simplest numeral system in which natural numbers can be written concisely , being the length of the number a logarithm of the value of the number ( whereas in base 1 the length of the number is the value of the number itself ) ; the binary system is used in computers .",23,46,simplest numeral system,1,0,1
3OYHVNTV5TZP9LFV5WP2INQTZSDKO2,"Two is the base of the simplest numeral system in which natural numbers can be written concisely , being the length of the number a logarithm of the value of the number ( whereas in base 1 the length of the number is the value of the number itself ) ; the binary system is used in computers .",32,39,numeral,7,1,8
3OYHVNTV5TZP9LFV5WP2INQTZSDKO2,"Two is the base of the simplest numeral system in which natural numbers can be written concisely , being the length of the number a logarithm of the value of the number ( whereas in base 1 the length of the number is the value of the number itself ) ; the binary system is used in computers .",32,46,numeral system,1,3,4
3OYHVNTV5TZP9LFV5WP2INQTZSDKO2,"Two is the base of the simplest numeral system in which natural numbers can be written concisely , being the length of the number a logarithm of the value of the number ( whereas in base 1 the length of the number is the value of the number itself ) ; the binary system is used in computers .",56,71,natural numbers,1,1,2
3OYHVNTV5TZP9LFV5WP2INQTZSDKO2,"Two is the base of the simplest numeral system in which natural numbers can be written concisely , being the length of the number a logarithm of the value of the number ( whereas in base 1 the length of the number is the value of the number itself ) ; the binary system is used in computers .",79,86,written,0,1,1
3OYHVNTV5TZP9LFV5WP2INQTZSDKO2,"Two is the base of the simplest numeral system in which natural numbers can be written concisely , being the length of the number a logarithm of the value of the number ( whereas in base 1 the length of the number is the value of the number itself ) ; the binary system is used in computers .",87,96,concisely,10,10,20
3OYHVNTV5TZP9LFV5WP2INQTZSDKO2,"Two is the base of the simplest numeral system in which natural numbers can be written concisely , being the length of the number a logarithm of the value of the number ( whereas in base 1 the length of the number is the value of the number itself ) ; the binary system is used in computers .",109,115,length,1,0,1
3OYHVNTV5TZP9LFV5WP2INQTZSDKO2,"Two is the base of the simplest numeral system in which natural numbers can be written concisely , being the length of the number a logarithm of the value of the number ( whereas in base 1 the length of the number is the value of the number itself ) ; the binary system is used in computers .",132,141,logarithm,10,10,20
3OYHVNTV5TZP9LFV5WP2INQTZSDKO2,"Two is the base of the simplest numeral system in which natural numbers can be written concisely , being the length of the number a logarithm of the value of the number ( whereas in base 1 the length of the number is the value of the number itself ) ; the binary system is used in computers .",149,154,value,1,0,1
3OYHVNTV5TZP9LFV5WP2INQTZSDKO2,"Two is the base of the simplest numeral system in which natural numbers can be written concisely , being the length of the number a logarithm of the value of the number ( whereas in base 1 the length of the number is the value of the number itself ) ; the binary system is used in computers .",171,178,whereas,1,0,1
3OYHVNTV5TZP9LFV5WP2INQTZSDKO2,"Two is the base of the simplest numeral system in which natural numbers can be written concisely , being the length of the number a logarithm of the value of the number ( whereas in base 1 the length of the number is the value of the number itself ) ; the binary system is used in computers .",256,262,binary,8,4,12
3OYHVNTV5TZP9LFV5WP2INQTZSDKO2,"Two is the base of the simplest numeral system in which natural numbers can be written concisely , being the length of the number a logarithm of the value of the number ( whereas in base 1 the length of the number is the value of the number itself ) ; the binary system is used in computers .",256,269,binary system,4,3,7
3OYHVNTV5TZP9LFV5WP2INQTZSDKO2,"Harju County ( Estonian : Harju maakond ) , or Harjumaa ( German : Harrien , Latin : Harria ) is one of the 15 counties of Estonia .",0,5,Harju,1,0,1
3OYHVNTV5TZP9LFV5WP2INQTZSDKO2,"Harju County ( Estonian : Harju maakond ) , or Harjumaa ( German : Harrien , Latin : Harria ) is one of the 15 counties of Estonia .",6,12,County,0,1,1
3OYHVNTV5TZP9LFV5WP2INQTZSDKO2,"Harju County ( Estonian : Harju maakond ) , or Harjumaa ( German : Harrien , Latin : Harria ) is one of the 15 counties of Estonia .",15,23,Estonian,2,0,2
3OYHVNTV5TZP9LFV5WP2INQTZSDKO2,"Harju County ( Estonian : Harju maakond ) , or Harjumaa ( German : Harrien , Latin : Harria ) is one of the 15 counties of Estonia .",47,55,Harjumaa,3,0,3
3OYHVNTV5TZP9LFV5WP2INQTZSDKO2,"Harju County ( Estonian : Harju maakond ) , or Harjumaa ( German : Harrien , Latin : Harria ) is one of the 15 counties of Estonia .",85,91,Harria,1,0,1
3OYHVNTV5TZP9LFV5WP2INQTZSDKO2,"Harju County ( Estonian : Harju maakond ) , or Harjumaa ( German : Harrien , Latin : Harria ) is one of the 15 counties of Estonia .",123,130,Estonia,2,0,2
3OYHVNTV5TZP9LFV5WP2INQTZSDKO2,"Mercuric chloride is occasionally used to form an amalgam with metals , such as aluminium .",0,8,Mercuric,1,1,2
3OYHVNTV5TZP9LFV5WP2INQTZSDKO2,"Mercuric chloride is occasionally used to form an amalgam with metals , such as aluminium .",0,17,Mercuric chloride,8,3,11
3OYHVNTV5TZP9LFV5WP2INQTZSDKO2,"Mercuric chloride is occasionally used to form an amalgam with metals , such as aluminium .",9,17,chloride,1,2,3
3OYHVNTV5TZP9LFV5WP2INQTZSDKO2,"Mercuric chloride is occasionally used to form an amalgam with metals , such as aluminium .",21,33,occasionally,4,2,6
3OYHVNTV5TZP9LFV5WP2INQTZSDKO2,"Mercuric chloride is occasionally used to form an amalgam with metals , such as aluminium .",50,57,amalgam,10,10,20
3OYHVNTV5TZP9LFV5WP2INQTZSDKO2,"Mercuric chloride is occasionally used to form an amalgam with metals , such as aluminium .",80,89,aluminium,3,1,4
36MUZ9VAE63VJOWWJ10J9Y1PBHADEE,"Although the term altitude is commonly used to mean the height above sea level of a location , in geography the term elevation is often preferred for this usage .",18,26,altitude,10,4,14
36MUZ9VAE63VJOWWJ10J9Y1PBHADEE,"Although the term altitude is commonly used to mean the height above sea level of a location , in geography the term elevation is often preferred for this usage .",56,78,height above sea level,0,1,1
36MUZ9VAE63VJOWWJ10J9Y1PBHADEE,"Although the term altitude is commonly used to mean the height above sea level of a location , in geography the term elevation is often preferred for this usage .",98,107,geography,5,1,6
36MUZ9VAE63VJOWWJ10J9Y1PBHADEE,"Although the term altitude is commonly used to mean the height above sea level of a location , in geography the term elevation is often preferred for this usage .",117,126,elevation,8,5,13
36MUZ9VAE63VJOWWJ10J9Y1PBHADEE,"Although the term altitude is commonly used to mean the height above sea level of a location , in geography the term elevation is often preferred for this usage .",136,145,preferred,2,4,6
36MUZ9VAE63VJOWWJ10J9Y1PBHADEE,"Although the term altitude is commonly used to mean the height above sea level of a location , in geography the term elevation is often preferred for this usage .",155,160,usage,4,1,5
36MUZ9VAE63VJOWWJ10J9Y1PBHADEE,"The statuette given , a nude male figure holding both a mask of comedy and a mask of tragedy , is called `` The Actor '' .",4,13,statuette,10,10,20
36MUZ9VAE63VJOWWJ10J9Y1PBHADEE,"The statuette given , a nude male figure holding both a mask of comedy and a mask of tragedy , is called `` The Actor '' .",56,60,mask,0,1,1
36MUZ9VAE63VJOWWJ10J9Y1PBHADEE,"The statuette given , a nude male figure holding both a mask of comedy and a mask of tragedy , is called `` The Actor '' .",56,70,mask of comedy,0,1,1
36MUZ9VAE63VJOWWJ10J9Y1PBHADEE,"The statuette given , a nude male figure holding both a mask of comedy and a mask of tragedy , is called `` The Actor '' .",64,70,comedy,0,1,1
36MUZ9VAE63VJOWWJ10J9Y1PBHADEE,"The statuette given , a nude male figure holding both a mask of comedy and a mask of tragedy , is called `` The Actor '' .",77,92,mask of tragedy,1,1,2
36MUZ9VAE63VJOWWJ10J9Y1PBHADEE,"The statuette given , a nude male figure holding both a mask of comedy and a mask of tragedy , is called `` The Actor '' .",85,92,tragedy,1,3,4
36MUZ9VAE63VJOWWJ10J9Y1PBHADEE,"The second SAG awards aired live from the Santa Monica Civic Auditorium , while subsequent awards have been held at the Shrine Exposition Center .",11,14,SAG,1,0,1
36MUZ9VAE63VJOWWJ10J9Y1PBHADEE,"The second SAG awards aired live from the Santa Monica Civic Auditorium , while subsequent awards have been held at the Shrine Exposition Center .",11,21,SAG awards,1,0,1
36MUZ9VAE63VJOWWJ10J9Y1PBHADEE,"The second SAG awards aired live from the Santa Monica Civic Auditorium , while subsequent awards have been held at the Shrine Exposition Center .",15,21,awards,0,1,1
36MUZ9VAE63VJOWWJ10J9Y1PBHADEE,"The second SAG awards aired live from the Santa Monica Civic Auditorium , while subsequent awards have been held at the Shrine Exposition Center .",22,27,aired,0,4,4
36MUZ9VAE63VJOWWJ10J9Y1PBHADEE,"The second SAG awards aired live from the Santa Monica Civic Auditorium , while subsequent awards have been held at the Shrine Exposition Center .",22,32,aired live,0,1,1
36MUZ9VAE63VJOWWJ10J9Y1PBHADEE,"The second SAG awards aired live from the Santa Monica Civic Auditorium , while subsequent awards have been held at the Shrine Exposition Center .",61,71,Auditorium,1,0,1
36MUZ9VAE63VJOWWJ10J9Y1PBHADEE,"The second SAG awards aired live from the Santa Monica Civic Auditorium , while subsequent awards have been held at the Shrine Exposition Center .",80,90,subsequent,10,6,16
36MUZ9VAE63VJOWWJ10J9Y1PBHADEE,"The second SAG awards aired live from the Santa Monica Civic Auditorium , while subsequent awards have been held at the Shrine Exposition Center .",108,112,held,0,2,2
36MUZ9VAE63VJOWWJ10J9Y1PBHADEE,"The second SAG awards aired live from the Santa Monica Civic Auditorium , while subsequent awards have been held at the Shrine Exposition Center .",120,126,Shrine,0,1,1
36MUZ9VAE63VJOWWJ10J9Y1PBHADEE,"The second SAG awards aired live from the Santa Monica Civic Auditorium , while subsequent awards have been held at the Shrine Exposition Center .",120,137,Shrine Exposition,1,0,1
36MUZ9VAE63VJOWWJ10J9Y1PBHADEE,"The second SAG awards aired live from the Santa Monica Civic Auditorium , while subsequent awards have been held at the Shrine Exposition Center .",120,144,Shrine Exposition Center,1,0,1
36MUZ9VAE63VJOWWJ10J9Y1PBHADEE,"The second SAG awards aired live from the Santa Monica Civic Auditorium , while subsequent awards have been held at the Shrine Exposition Center .",127,137,Exposition,6,4,10
36MUZ9VAE63VJOWWJ10J9Y1PBHADEE,"The inaugural SAG Awards aired live on February 25 , 1995 from Stage 12 , Universal Studios .",4,13,inaugural,10,4,14
36MUZ9VAE63VJOWWJ10J9Y1PBHADEE,"The inaugural SAG Awards aired live on February 25 , 1995 from Stage 12 , Universal Studios .",25,30,aired,1,1,2
36MUZ9VAE63VJOWWJ10J9Y1PBHADEE,"The inaugural SAG Awards aired live on February 25 , 1995 from Stage 12 , Universal Studios .",74,83,Universal,1,0,1
36MUZ9VAE63VJOWWJ10J9Y1PBHADEE,"The inaugural SAG Awards aired live on February 25 , 1995 from Stage 12 , Universal Studios .",74,91,Universal Studios,0,1,1
36MUZ9VAE63VJOWWJ10J9Y1PBHADEE,"It is 16 inches ( 41 cm ) tall , weighs over 12 pounds ( 5.4 kg ) , is cast in solid bronze , and produced by the American Fine Arts Foundry in Burbank , California .",71,75,cast,1,5,6
36MUZ9VAE63VJOWWJ10J9Y1PBHADEE,"It is 16 inches ( 41 cm ) tall , weighs over 12 pounds ( 5.4 kg ) , is cast in solid bronze , and produced by the American Fine Arts Foundry in Burbank , California .",85,91,bronze,4,0,4
36MUZ9VAE63VJOWWJ10J9Y1PBHADEE,"It is 16 inches ( 41 cm ) tall , weighs over 12 pounds ( 5.4 kg ) , is cast in solid bronze , and produced by the American Fine Arts Foundry in Burbank , California .",133,140,Foundry,1,2,3
3FDWKV9VCN3FCEZVMUERW6AM6JWMUM,"Aerospace engineering is the primary branch of engineering concerned with the design , construction , and science of aircraft and spacecraft .",0,9,Aerospace,7,3,10
3FDWKV9VCN3FCEZVMUERW6AM6JWMUM,"Aerospace engineering is the primary branch of engineering concerned with the design , construction , and science of aircraft and spacecraft .",0,21,Aerospace engineering,4,0,4
3FDWKV9VCN3FCEZVMUERW6AM6JWMUM,"Aerospace engineering is the primary branch of engineering concerned with the design , construction , and science of aircraft and spacecraft .",10,21,engineering,3,0,3
3FDWKV9VCN3FCEZVMUERW6AM6JWMUM,"Aerospace engineering is the primary branch of engineering concerned with the design , construction , and science of aircraft and spacecraft .",29,36,primary,0,2,2
3FDWKV9VCN3FCEZVMUERW6AM6JWMUM,"Aerospace engineering is the primary branch of engineering concerned with the design , construction , and science of aircraft and spacecraft .",29,43,primary branch,1,0,1
3FDWKV9VCN3FCEZVMUERW6AM6JWMUM,"Aerospace engineering is the primary branch of engineering concerned with the design , construction , and science of aircraft and spacecraft .",37,43,branch,0,3,3
3FDWKV9VCN3FCEZVMUERW6AM6JWMUM,"Aerospace engineering is the primary branch of engineering concerned with the design , construction , and science of aircraft and spacecraft .",47,58,engineering,1,0,1
3FDWKV9VCN3FCEZVMUERW6AM6JWMUM,"Aerospace engineering is the primary branch of engineering concerned with the design , construction , and science of aircraft and spacecraft .",59,68,concerned,2,4,6
3FDWKV9VCN3FCEZVMUERW6AM6JWMUM,"Aerospace engineering is the primary branch of engineering concerned with the design , construction , and science of aircraft and spacecraft .",78,84,design,1,0,1
3FDWKV9VCN3FCEZVMUERW6AM6JWMUM,"Aerospace engineering is the primary branch of engineering concerned with the design , construction , and science of aircraft and spacecraft .",87,99,construction,1,2,3
3FDWKV9VCN3FCEZVMUERW6AM6JWMUM,"Aerospace engineering is the primary branch of engineering concerned with the design , construction , and science of aircraft and spacecraft .",106,113,science,1,0,1
3FDWKV9VCN3FCEZVMUERW6AM6JWMUM,"Aerospace engineering is the primary branch of engineering concerned with the design , construction , and science of aircraft and spacecraft .",117,125,aircraft,0,4,4
3FDWKV9VCN3FCEZVMUERW6AM6JWMUM,"Aerospace engineering is the primary branch of engineering concerned with the design , construction , and science of aircraft and spacecraft .",130,140,spacecraft,1,6,7
3FDWKV9VCN3FCEZVMUERW6AM6JWMUM,"Although it is commonly believed that the genus was named by Georges Cuvier in 1825 , Cuvier spelled it Loxodonte .",15,23,commonly,1,0,1
3FDWKV9VCN3FCEZVMUERW6AM6JWMUM,"Although it is commonly believed that the genus was named by Georges Cuvier in 1825 , Cuvier spelled it Loxodonte .",42,47,genus,6,6,12
3FDWKV9VCN3FCEZVMUERW6AM6JWMUM,"Although it is commonly believed that the genus was named by Georges Cuvier in 1825 , Cuvier spelled it Loxodonte .",69,75,Cuvier,0,1,1
3FDWKV9VCN3FCEZVMUERW6AM6JWMUM,"Although it is commonly believed that the genus was named by Georges Cuvier in 1825 , Cuvier spelled it Loxodonte .",93,100,spelled,0,3,3
3FDWKV9VCN3FCEZVMUERW6AM6JWMUM,"Although it is commonly believed that the genus was named by Georges Cuvier in 1825 , Cuvier spelled it Loxodonte .",104,113,Loxodonte,6,1,7
3FDWKV9VCN3FCEZVMUERW6AM6JWMUM,An anonymous author romanized the spelling to Loxodonta and the International Code of Zoological Nomenclature ( ICZN ) recognizes this as the proper authority .,3,12,anonymous,8,8,16
3FDWKV9VCN3FCEZVMUERW6AM6JWMUM,An anonymous author romanized the spelling to Loxodonta and the International Code of Zoological Nomenclature ( ICZN ) recognizes this as the proper authority .,20,29,romanized,10,10,20
3FDWKV9VCN3FCEZVMUERW6AM6JWMUM,An anonymous author romanized the spelling to Loxodonta and the International Code of Zoological Nomenclature ( ICZN ) recognizes this as the proper authority .,34,42,spelling,0,1,1
3FDWKV9VCN3FCEZVMUERW6AM6JWMUM,An anonymous author romanized the spelling to Loxodonta and the International Code of Zoological Nomenclature ( ICZN ) recognizes this as the proper authority .,46,55,Loxodonta,1,1,2
3FDWKV9VCN3FCEZVMUERW6AM6JWMUM,An anonymous author romanized the spelling to Loxodonta and the International Code of Zoological Nomenclature ( ICZN ) recognizes this as the proper authority .,64,109,International Code of Zoological Nomenclature,1,0,1
3FDWKV9VCN3FCEZVMUERW6AM6JWMUM,An anonymous author romanized the spelling to Loxodonta and the International Code of Zoological Nomenclature ( ICZN ) recognizes this as the proper authority .,86,96,Zoological,1,0,1
3FDWKV9VCN3FCEZVMUERW6AM6JWMUM,An anonymous author romanized the spelling to Loxodonta and the International Code of Zoological Nomenclature ( ICZN ) recognizes this as the proper authority .,97,109,Nomenclature,5,2,7
3FDWKV9VCN3FCEZVMUERW6AM6JWMUM,An anonymous author romanized the spelling to Loxodonta and the International Code of Zoological Nomenclature ( ICZN ) recognizes this as the proper authority .,119,129,recognizes,0,3,3
3FDWKV9VCN3FCEZVMUERW6AM6JWMUM,An anonymous author romanized the spelling to Loxodonta and the International Code of Zoological Nomenclature ( ICZN ) recognizes this as the proper authority .,142,158,proper authority,2,0,2
3FDWKV9VCN3FCEZVMUERW6AM6JWMUM,An anonymous author romanized the spelling to Loxodonta and the International Code of Zoological Nomenclature ( ICZN ) recognizes this as the proper authority .,149,158,authority,1,1,2
3FDWKV9VCN3FCEZVMUERW6AM6JWMUM,"Fossil members of Loxodonta have only been found in Africa , where they developed in the middle Pliocene .",0,6,Fossil,5,4,9
3FDWKV9VCN3FCEZVMUERW6AM6JWMUM,"Fossil members of Loxodonta have only been found in Africa , where they developed in the middle Pliocene .",0,14,Fossil members,0,1,1
3FDWKV9VCN3FCEZVMUERW6AM6JWMUM,"Fossil members of Loxodonta have only been found in Africa , where they developed in the middle Pliocene .",18,27,Loxodonta,1,1,2
3FDWKV9VCN3FCEZVMUERW6AM6JWMUM,"Fossil members of Loxodonta have only been found in Africa , where they developed in the middle Pliocene .",72,81,developed,0,1,1
3FDWKV9VCN3FCEZVMUERW6AM6JWMUM,"Fossil members of Loxodonta have only been found in Africa , where they developed in the middle Pliocene .",89,104,middle Pliocene,0,1,1
3FDWKV9VCN3FCEZVMUERW6AM6JWMUM,"Fossil members of Loxodonta have only been found in Africa , where they developed in the middle Pliocene .",96,104,Pliocene,1,4,5
3FDWKV9VCN3FCEZVMUERW6AM6JWMUM,"Males stand 3.2-4 .0 m ( 10-13 ft ) tall at the shoulder and weigh 4,700-6 ,048 kg ( 10,000-13 ,330 lb ) , while females stand 2.2-2 .6 m ( 7.2-8 .5 ft ) tall and weigh 2,160-3 ,232 kg ( 4,800-7 ,130 lb ) .",6,11,stand,0,1,1
3FDWKV9VCN3FCEZVMUERW6AM6JWMUM,"Males stand 3.2-4 .0 m ( 10-13 ft ) tall at the shoulder and weigh 4,700-6 ,048 kg ( 10,000-13 ,330 lb ) , while females stand 2.2-2 .6 m ( 7.2-8 .5 ft ) tall and weigh 2,160-3 ,232 kg ( 4,800-7 ,130 lb ) .",48,56,shoulder,1,0,1
3AJA9FLWSCZ4XDCE6QL0ID22FNXFI0,The natural beauty of the area is attracting many tourists from both the rest of Cuba and from overseas .,4,18,natural beauty,1,0,1
3AJA9FLWSCZ4XDCE6QL0ID22FNXFI0,The natural beauty of the area is attracting many tourists from both the rest of Cuba and from overseas .,34,44,attracting,1,1,2
3AJA9FLWSCZ4XDCE6QL0ID22FNXFI0,The natural beauty of the area is attracting many tourists from both the rest of Cuba and from overseas .,50,58,tourists,2,1,3
3AJA9FLWSCZ4XDCE6QL0ID22FNXFI0,The natural beauty of the area is attracting many tourists from both the rest of Cuba and from overseas .,95,103,overseas,2,8,10
3AJA9FLWSCZ4XDCE6QL0ID22FNXFI0,"One of these was Oriente province , which was , prior to 1905 , known as Santiago de Cuba province .",17,24,Oriente,2,1,3
3AJA9FLWSCZ4XDCE6QL0ID22FNXFI0,"One of these was Oriente province , which was , prior to 1905 , known as Santiago de Cuba province .",17,33,Oriente province,1,1,2
3AJA9FLWSCZ4XDCE6QL0ID22FNXFI0,"One of these was Oriente province , which was , prior to 1905 , known as Santiago de Cuba province .",25,33,province,8,3,11
3AJA9FLWSCZ4XDCE6QL0ID22FNXFI0,"One of these was Oriente province , which was , prior to 1905 , known as Santiago de Cuba province .",48,53,prior,1,1,2
3AJA9FLWSCZ4XDCE6QL0ID22FNXFI0,"One of these was Oriente province , which was , prior to 1905 , known as Santiago de Cuba province .",73,89,Santiago de Cuba,2,0,2
3AJA9FLWSCZ4XDCE6QL0ID22FNXFI0,"The economy , however , relies mostly on agriculture , with large plantations growing bananas , cacao , and coffee dotting the landscape .",4,11,economy,1,1,2
3AJA9FLWSCZ4XDCE6QL0ID22FNXFI0,"The economy , however , relies mostly on agriculture , with large plantations growing bananas , cacao , and coffee dotting the landscape .",24,30,relies,2,1,3
3AJA9FLWSCZ4XDCE6QL0ID22FNXFI0,"The economy , however , relies mostly on agriculture , with large plantations growing bananas , cacao , and coffee dotting the landscape .",41,52,agriculture,4,1,5
3AJA9FLWSCZ4XDCE6QL0ID22FNXFI0,"The economy , however , relies mostly on agriculture , with large plantations growing bananas , cacao , and coffee dotting the landscape .",60,77,large plantations,1,0,1
3AJA9FLWSCZ4XDCE6QL0ID22FNXFI0,"The economy , however , relies mostly on agriculture , with large plantations growing bananas , cacao , and coffee dotting the landscape .",66,77,plantations,9,5,14
3AJA9FLWSCZ4XDCE6QL0ID22FNXFI0,"The economy , however , relies mostly on agriculture , with large plantations growing bananas , cacao , and coffee dotting the landscape .",96,101,cacao,1,0,1
3AJA9FLWSCZ4XDCE6QL0ID22FNXFI0,"The economy , however , relies mostly on agriculture , with large plantations growing bananas , cacao , and coffee dotting the landscape .",108,136,coffee dotting the landscape,1,0,1
3AJA9FLWSCZ4XDCE6QL0ID22FNXFI0,"The economy , however , relies mostly on agriculture , with large plantations growing bananas , cacao , and coffee dotting the landscape .",115,122,dotting,1,6,7
3AJA9FLWSCZ4XDCE6QL0ID22FNXFI0,"The economy , however , relies mostly on agriculture , with large plantations growing bananas , cacao , and coffee dotting the landscape .",127,136,landscape,1,1,2
3AJA9FLWSCZ4XDCE6QL0ID22FNXFI0,"Examples of such organometallic compounds include all Gilman reagents , which contain lithium and copper .",17,31,organometallic,10,6,16
3AJA9FLWSCZ4XDCE6QL0ID22FNXFI0,"Examples of such organometallic compounds include all Gilman reagents , which contain lithium and copper .",17,41,organometallic compounds,4,6,10
3AJA9FLWSCZ4XDCE6QL0ID22FNXFI0,"Examples of such organometallic compounds include all Gilman reagents , which contain lithium and copper .",32,41,compounds,2,0,2
3AJA9FLWSCZ4XDCE6QL0ID22FNXFI0,"Examples of such organometallic compounds include all Gilman reagents , which contain lithium and copper .",54,69,Gilman reagents,2,2,4
3AJA9FLWSCZ4XDCE6QL0ID22FNXFI0,"Examples of such organometallic compounds include all Gilman reagents , which contain lithium and copper .",61,69,reagents,5,3,8
3AJA9FLWSCZ4XDCE6QL0ID22FNXFI0,"Examples of such organometallic compounds include all Gilman reagents , which contain lithium and copper .",86,93,lithium,3,0,3
3AJA9FLWSCZ4XDCE6QL0ID22FNXFI0,"Examples of such organometallic compounds include all Gilman reagents , which contain lithium and copper .",86,104,lithium and copper,1,0,1
3AJA9FLWSCZ4XDCE6QL0ID22FNXFI0,"Examples of such organometallic compounds include all Gilman reagents , which contain lithium and copper .",98,104,copper,0,2,2
3AJA9FLWSCZ4XDCE6QL0ID22FNXFI0,"For example , hemoglobin and myoglobin contain an iron center coordinated to the nitrogen atoms of a porphyrin ring ; magnesium is the center of a chlorin ring in chlorophyll .",14,24,hemoglobin,10,2,12
3AJA9FLWSCZ4XDCE6QL0ID22FNXFI0,"For example , hemoglobin and myoglobin contain an iron center coordinated to the nitrogen atoms of a porphyrin ring ; magnesium is the center of a chlorin ring in chlorophyll .",29,38,myoglobin,10,2,12
3AJA9FLWSCZ4XDCE6QL0ID22FNXFI0,"For example , hemoglobin and myoglobin contain an iron center coordinated to the nitrogen atoms of a porphyrin ring ; magnesium is the center of a chlorin ring in chlorophyll .",62,73,coordinated,1,4,5
3AJA9FLWSCZ4XDCE6QL0ID22FNXFI0,"For example , hemoglobin and myoglobin contain an iron center coordinated to the nitrogen atoms of a porphyrin ring ; magnesium is the center of a chlorin ring in chlorophyll .",81,89,nitrogen,2,0,2
3AJA9FLWSCZ4XDCE6QL0ID22FNXFI0,"For example , hemoglobin and myoglobin contain an iron center coordinated to the nitrogen atoms of a porphyrin ring ; magnesium is the center of a chlorin ring in chlorophyll .",81,95,nitrogen atoms,0,1,1
3AJA9FLWSCZ4XDCE6QL0ID22FNXFI0,"For example , hemoglobin and myoglobin contain an iron center coordinated to the nitrogen atoms of a porphyrin ring ; magnesium is the center of a chlorin ring in chlorophyll .",101,110,porphyrin,8,4,12
3AJA9FLWSCZ4XDCE6QL0ID22FNXFI0,"For example , hemoglobin and myoglobin contain an iron center coordinated to the nitrogen atoms of a porphyrin ring ; magnesium is the center of a chlorin ring in chlorophyll .",101,115,porphyrin ring,1,3,4
3AJA9FLWSCZ4XDCE6QL0ID22FNXFI0,"For example , hemoglobin and myoglobin contain an iron center coordinated to the nitrogen atoms of a porphyrin ring ; magnesium is the center of a chlorin ring in chlorophyll .",118,127,magnesium,3,2,5
3AJA9FLWSCZ4XDCE6QL0ID22FNXFI0,"For example , hemoglobin and myoglobin contain an iron center coordinated to the nitrogen atoms of a porphyrin ring ; magnesium is the center of a chlorin ring in chlorophyll .",147,154,chlorin,4,0,4
3AJA9FLWSCZ4XDCE6QL0ID22FNXFI0,"For example , hemoglobin and myoglobin contain an iron center coordinated to the nitrogen atoms of a porphyrin ring ; magnesium is the center of a chlorin ring in chlorophyll .",147,159,chlorin ring,1,1,2
3AJA9FLWSCZ4XDCE6QL0ID22FNXFI0,"For example , hemoglobin and myoglobin contain an iron center coordinated to the nitrogen atoms of a porphyrin ring ; magnesium is the center of a chlorin ring in chlorophyll .",147,174,chlorin ring in chlorophyll,1,0,1
3AJA9FLWSCZ4XDCE6QL0ID22FNXFI0,"For example , hemoglobin and myoglobin contain an iron center coordinated to the nitrogen atoms of a porphyrin ring ; magnesium is the center of a chlorin ring in chlorophyll .",163,174,chlorophyll,5,1,6
3AJA9FLWSCZ4XDCE6QL0ID22FNXFI0,Organometallic chemistry is the study of chemical compounds containing bonds between carbon and a metal .,0,14,Organometallic,4,2,6
3AJA9FLWSCZ4XDCE6QL0ID22FNXFI0,Organometallic chemistry is the study of chemical compounds containing bonds between carbon and a metal .,0,24,Organometallic chemistry,1,2,3
3AJA9FLWSCZ4XDCE6QL0ID22FNXFI0,Organometallic chemistry is the study of chemical compounds containing bonds between carbon and a metal .,15,24,chemistry,1,0,1
3AJA9FLWSCZ4XDCE6QL0ID22FNXFI0,Organometallic chemistry is the study of chemical compounds containing bonds between carbon and a metal .,41,59,chemical compounds,1,0,1
3AJA9FLWSCZ4XDCE6QL0ID22FNXFI0,Organometallic chemistry is the study of chemical compounds containing bonds between carbon and a metal .,50,59,compounds,0,2,2
3AJA9FLWSCZ4XDCE6QL0ID22FNXFI0,Organometallic chemistry is the study of chemical compounds containing bonds between carbon and a metal .,71,76,bonds,1,3,4
3SX4X51T80AJX869T5CDO9NXUGJAOD,"While it is possible to request a change in username , this takes a little longer and requires that a user with bureaucrat access do so .",24,31,request,0,2,2
3SX4X51T80AJX869T5CDO9NXUGJAOD,"While it is possible to request a change in username , this takes a little longer and requires that a user with bureaucrat access do so .",34,52,change in username,1,0,1
3SX4X51T80AJX869T5CDO9NXUGJAOD,"While it is possible to request a change in username , this takes a little longer and requires that a user with bureaucrat access do so .",44,52,username,3,1,4
3SX4X51T80AJX869T5CDO9NXUGJAOD,"While it is possible to request a change in username , this takes a little longer and requires that a user with bureaucrat access do so .",112,122,bureaucrat,10,10,20
3SX4X51T80AJX869T5CDO9NXUGJAOD,"While it is possible to request a change in username , this takes a little longer and requires that a user with bureaucrat access do so .",112,129,bureaucrat access,2,0,2
3SX4X51T80AJX869T5CDO9NXUGJAOD,"While it is possible to request a change in username , this takes a little longer and requires that a user with bureaucrat access do so .",123,129,access,1,1,2
3SX4X51T80AJX869T5CDO9NXUGJAOD,These messages should include the names or abbreviations of those of our site rules ( the `` policies and guidelines '' ) that the blocking administrator believes you have violated .,43,56,abbreviations,10,9,19
3SX4X51T80AJX869T5CDO9NXUGJAOD,These messages should include the names or abbreviations of those of our site rules ( the `` policies and guidelines '' ) that the blocking administrator believes you have violated .,93,101,policies,0,1,1
3SX4X51T80AJX869T5CDO9NXUGJAOD,These messages should include the names or abbreviations of those of our site rules ( the `` policies and guidelines '' ) that the blocking administrator believes you have violated .,93,116,policies and guidelines,1,0,1
3SX4X51T80AJX869T5CDO9NXUGJAOD,These messages should include the names or abbreviations of those of our site rules ( the `` policies and guidelines '' ) that the blocking administrator believes you have violated .,106,116,guidelines,0,2,2
3SX4X51T80AJX869T5CDO9NXUGJAOD,These messages should include the names or abbreviations of those of our site rules ( the `` policies and guidelines '' ) that the blocking administrator believes you have violated .,131,153,blocking administrator,4,2,6
3SX4X51T80AJX869T5CDO9NXUGJAOD,These messages should include the names or abbreviations of those of our site rules ( the `` policies and guidelines '' ) that the blocking administrator believes you have violated .,140,153,administrator,4,1,5
3SX4X51T80AJX869T5CDO9NXUGJAOD,These messages should include the names or abbreviations of those of our site rules ( the `` policies and guidelines '' ) that the blocking administrator believes you have violated .,154,162,believes,0,1,1
3SX4X51T80AJX869T5CDO9NXUGJAOD,These messages should include the names or abbreviations of those of our site rules ( the `` policies and guidelines '' ) that the blocking administrator believes you have violated .,172,180,violated,8,2,10
3SX4X51T80AJX869T5CDO9NXUGJAOD,"Whichever method you choose , it is a good idea to have some review of the proposed new username first , to avoid ending up in the same quandary .",0,9,Whichever,0,1,1
3SX4X51T80AJX869T5CDO9NXUGJAOD,"Whichever method you choose , it is a good idea to have some review of the proposed new username first , to avoid ending up in the same quandary .",75,83,proposed,2,0,2
3SX4X51T80AJX869T5CDO9NXUGJAOD,"Whichever method you choose , it is a good idea to have some review of the proposed new username first , to avoid ending up in the same quandary .",136,144,quandary,10,10,20
3SX4X51T80AJX869T5CDO9NXUGJAOD,"If you are improperly blocked for sockpuppetry , you should realize that it may not always be easy or even possible to correct the situation .",11,21,improperly,4,2,6
3SX4X51T80AJX869T5CDO9NXUGJAOD,"If you are improperly blocked for sockpuppetry , you should realize that it may not always be easy or even possible to correct the situation .",34,46,sockpuppetry,10,10,20
3SX4X51T80AJX869T5CDO9NXUGJAOD,Users confirmed or believed to have engaged in the practice must request unblock at their main account .,6,15,confirmed,1,1,2
3SX4X51T80AJX869T5CDO9NXUGJAOD,Users confirmed or believed to have engaged in the practice must request unblock at their main account .,36,43,engaged,2,3,5
3SX4X51T80AJX869T5CDO9NXUGJAOD,Users confirmed or believed to have engaged in the practice must request unblock at their main account .,36,59,engaged in the practice,1,0,1
3SX4X51T80AJX869T5CDO9NXUGJAOD,Users confirmed or believed to have engaged in the practice must request unblock at their main account .,73,80,unblock,2,1,3
363A7XIFV4NENSF6UHYRJ1H5Q9GAVF,Part of Oracle Corporation 's early success arose from using the C programming language to implement its products .,8,14,Oracle,1,0,1
363A7XIFV4NENSF6UHYRJ1H5Q9GAVF,Part of Oracle Corporation 's early success arose from using the C programming language to implement its products .,8,26,Oracle Corporation,1,0,1
363A7XIFV4NENSF6UHYRJ1H5Q9GAVF,Part of Oracle Corporation 's early success arose from using the C programming language to implement its products .,15,26,Corporation,0,1,1
363A7XIFV4NENSF6UHYRJ1H5Q9GAVF,Part of Oracle Corporation 's early success arose from using the C programming language to implement its products .,44,49,arose,3,4,7
363A7XIFV4NENSF6UHYRJ1H5Q9GAVF,Part of Oracle Corporation 's early success arose from using the C programming language to implement its products .,65,78,C programming,1,0,1
363A7XIFV4NENSF6UHYRJ1H5Q9GAVF,Part of Oracle Corporation 's early success arose from using the C programming language to implement its products .,65,87,C programming language,1,0,1
363A7XIFV4NENSF6UHYRJ1H5Q9GAVF,Part of Oracle Corporation 's early success arose from using the C programming language to implement its products .,67,78,programming,2,1,3
363A7XIFV4NENSF6UHYRJ1H5Q9GAVF,Part of Oracle Corporation 's early success arose from using the C programming language to implement its products .,67,87,programming language,1,0,1
363A7XIFV4NENSF6UHYRJ1H5Q9GAVF,Part of Oracle Corporation 's early success arose from using the C programming language to implement its products .,79,87,language,2,0,2
363A7XIFV4NENSF6UHYRJ1H5Q9GAVF,Part of Oracle Corporation 's early success arose from using the C programming language to implement its products .,91,100,implement,10,10,20
363A7XIFV4NENSF6UHYRJ1H5Q9GAVF,He heard about the IBM System R database from an article in the IBM Research Journal provided by Ed Oates ( a future co-founder of Oracle ) .,19,22,IBM,1,0,1
363A7XIFV4NENSF6UHYRJ1H5Q9GAVF,He heard about the IBM System R database from an article in the IBM Research Journal provided by Ed Oates ( a future co-founder of Oracle ) .,23,31,System R,1,0,1
363A7XIFV4NENSF6UHYRJ1H5Q9GAVF,He heard about the IBM System R database from an article in the IBM Research Journal provided by Ed Oates ( a future co-founder of Oracle ) .,23,40,System R database,1,0,1
363A7XIFV4NENSF6UHYRJ1H5Q9GAVF,He heard about the IBM System R database from an article in the IBM Research Journal provided by Ed Oates ( a future co-founder of Oracle ) .,32,40,database,3,6,9
363A7XIFV4NENSF6UHYRJ1H5Q9GAVF,He heard about the IBM System R database from an article in the IBM Research Journal provided by Ed Oates ( a future co-founder of Oracle ) .,68,84,Research Journal,0,1,1
363A7XIFV4NENSF6UHYRJ1H5Q9GAVF,He heard about the IBM System R database from an article in the IBM Research Journal provided by Ed Oates ( a future co-founder of Oracle ) .,77,84,Journal,0,2,2
363A7XIFV4NENSF6UHYRJ1H5Q9GAVF,He heard about the IBM System R database from an article in the IBM Research Journal provided by Ed Oates ( a future co-founder of Oracle ) .,110,116,future,1,0,1
363A7XIFV4NENSF6UHYRJ1H5Q9GAVF,He heard about the IBM System R database from an article in the IBM Research Journal provided by Ed Oates ( a future co-founder of Oracle ) .,117,127,co-founder,0,1,1
363A7XIFV4NENSF6UHYRJ1H5Q9GAVF,"System R also derived from Codd 's theories , and Ellison wanted to make Oracle 's product compatible with System R , but IBM stopped this by keeping the error codes for their DBMS secret .",14,21,derived,7,4,11
363A7XIFV4NENSF6UHYRJ1H5Q9GAVF,"System R also derived from Codd 's theories , and Ellison wanted to make Oracle 's product compatible with System R , but IBM stopped this by keeping the error codes for their DBMS secret .",27,33,Codd s,1,0,1
363A7XIFV4NENSF6UHYRJ1H5Q9GAVF,"System R also derived from Codd 's theories , and Ellison wanted to make Oracle 's product compatible with System R , but IBM stopped this by keeping the error codes for their DBMS secret .",27,42,Codd s theories,1,2,3
363A7XIFV4NENSF6UHYRJ1H5Q9GAVF,"System R also derived from Codd 's theories , and Ellison wanted to make Oracle 's product compatible with System R , but IBM stopped this by keeping the error codes for their DBMS secret .",35,43,theories,3,0,3
363A7XIFV4NENSF6UHYRJ1H5Q9GAVF,"System R also derived from Codd 's theories , and Ellison wanted to make Oracle 's product compatible with System R , but IBM stopped this by keeping the error codes for their DBMS secret .",91,101,compatible,4,7,11
363A7XIFV4NENSF6UHYRJ1H5Q9GAVF,"System R also derived from Codd 's theories , and Ellison wanted to make Oracle 's product compatible with System R , but IBM stopped this by keeping the error codes for their DBMS secret .",142,149,keeping,0,2,2
363A7XIFV4NENSF6UHYRJ1H5Q9GAVF,"System R also derived from Codd 's theories , and Ellison wanted to make Oracle 's product compatible with System R , but IBM stopped this by keeping the error codes for their DBMS secret .",154,159,error,1,2,3
363A7XIFV4NENSF6UHYRJ1H5Q9GAVF,"System R also derived from Codd 's theories , and Ellison wanted to make Oracle 's product compatible with System R , but IBM stopped this by keeping the error codes for their DBMS secret .",154,165,error codes,3,1,4
363A7XIFV4NENSF6UHYRJ1H5Q9GAVF,"System R also derived from Codd 's theories , and Ellison wanted to make Oracle 's product compatible with System R , but IBM stopped this by keeping the error codes for their DBMS secret .",176,180,DBMS,1,0,1
363A7XIFV4NENSF6UHYRJ1H5Q9GAVF,Ellison took inspiration from the 1970 paper written by Edgar F. Codd on relational database management systems ( RDBMS ) named `` A Relational Model of Data for Large Shared Data Banks . '',13,24,inspiration,5,8,13
363A7XIFV4NENSF6UHYRJ1H5Q9GAVF,Ellison took inspiration from the 1970 paper written by Edgar F. Codd on relational database management systems ( RDBMS ) named `` A Relational Model of Data for Large Shared Data Banks . '',56,61,Edgar,0,1,1
363A7XIFV4NENSF6UHYRJ1H5Q9GAVF,Ellison took inspiration from the 1970 paper written by Edgar F. Codd on relational database management systems ( RDBMS ) named `` A Relational Model of Data for Large Shared Data Banks . '',73,83,relational,3,1,4
363A7XIFV4NENSF6UHYRJ1H5Q9GAVF,Ellison took inspiration from the 1970 paper written by Edgar F. Codd on relational database management systems ( RDBMS ) named `` A Relational Model of Data for Large Shared Data Banks . '',73,92,relational database,1,1,2
363A7XIFV4NENSF6UHYRJ1H5Q9GAVF,Ellison took inspiration from the 1970 paper written by Edgar F. Codd on relational database management systems ( RDBMS ) named `` A Relational Model of Data for Large Shared Data Banks . '',73,111,relational database management systems,2,0,2
363A7XIFV4NENSF6UHYRJ1H5Q9GAVF,Ellison took inspiration from the 1970 paper written by Edgar F. Codd on relational database management systems ( RDBMS ) named `` A Relational Model of Data for Large Shared Data Banks . '',84,92,database,1,0,1
363A7XIFV4NENSF6UHYRJ1H5Q9GAVF,Ellison took inspiration from the 1970 paper written by Edgar F. Codd on relational database management systems ( RDBMS ) named `` A Relational Model of Data for Large Shared Data Banks . '',84,111,database management systems,0,1,1
363A7XIFV4NENSF6UHYRJ1H5Q9GAVF,Ellison took inspiration from the 1970 paper written by Edgar F. Codd on relational database management systems ( RDBMS ) named `` A Relational Model of Data for Large Shared Data Banks . '',93,103,management,2,1,3
363A7XIFV4NENSF6UHYRJ1H5Q9GAVF,Ellison took inspiration from the 1970 paper written by Edgar F. Codd on relational database management systems ( RDBMS ) named `` A Relational Model of Data for Large Shared Data Banks . '',133,143,Relational,3,2,5
363A7XIFV4NENSF6UHYRJ1H5Q9GAVF,Ellison took inspiration from the 1970 paper written by Edgar F. Codd on relational database management systems ( RDBMS ) named `` A Relational Model of Data for Large Shared Data Banks . '',133,149,Relational Model,1,0,1
363A7XIFV4NENSF6UHYRJ1H5Q9GAVF,Ellison took inspiration from the 1970 paper written by Edgar F. Codd on relational database management systems ( RDBMS ) named `` A Relational Model of Data for Large Shared Data Banks . '',144,149,Model,0,1,1
363A7XIFV4NENSF6UHYRJ1H5Q9GAVF,Ellison took inspiration from the 1970 paper written by Edgar F. Codd on relational database management systems ( RDBMS ) named `` A Relational Model of Data for Large Shared Data Banks . '',168,185,Shared Data Banks,0,1,1
363A7XIFV4NENSF6UHYRJ1H5Q9GAVF,Ellison took inspiration from the 1970 paper written by Edgar F. Codd on relational database management systems ( RDBMS ) named `` A Relational Model of Data for Large Shared Data Banks . '',175,185,Data Banks,1,1,2
363A7XIFV4NENSF6UHYRJ1H5Q9GAVF,"Larry Ellison , a co-founder of Oracle , has served as Oracle 's CEO throughout its history .",18,28,co-founder,1,2,3
363A7XIFV4NENSF6UHYRJ1H5Q9GAVF,"Larry Ellison , a co-founder of Oracle , has served as Oracle 's CEO throughout its history .",45,51,served,1,1,2
363A7XIFV4NENSF6UHYRJ1H5Q9GAVF,"Larry Ellison , a co-founder of Oracle , has served as Oracle 's CEO throughout its history .",65,68,CEO,2,0,2
363A7XIFV4NENSF6UHYRJ1H5Q9GAVF,"Larry Ellison , a co-founder of Oracle , has served as Oracle 's CEO throughout its history .",65,79,CEO throughout,0,1,1
363A7XIFV4NENSF6UHYRJ1H5Q9GAVF,"Larry Ellison , a co-founder of Oracle , has served as Oracle 's CEO throughout its history .",69,79,throughout,0,3,3
3N5YJ55YXG41FN6XSQC09KNS46EANY,"As Richard Pearce-Moses wrote , `` Archivists keep records that have enduring value as reliable memories of the past , and they help people find and understand the information they need in those records . ''",35,45,Archivists,10,9,19
3N5YJ55YXG41FN6XSQC09KNS46EANY,"As Richard Pearce-Moses wrote , `` Archivists keep records that have enduring value as reliable memories of the past , and they help people find and understand the information they need in those records . ''",69,77,enduring,7,10,17
3N5YJ55YXG41FN6XSQC09KNS46EANY,"As Richard Pearce-Moses wrote , `` Archivists keep records that have enduring value as reliable memories of the past , and they help people find and understand the information they need in those records . ''",87,95,reliable,6,5,11
3N5YJ55YXG41FN6XSQC09KNS46EANY,"As Richard Pearce-Moses wrote , `` Archivists keep records that have enduring value as reliable memories of the past , and they help people find and understand the information they need in those records . ''",87,104,reliable memories,0,1,1
3N5YJ55YXG41FN6XSQC09KNS46EANY,"As Richard Pearce-Moses wrote , `` Archivists keep records that have enduring value as reliable memories of the past , and they help people find and understand the information they need in those records . ''",96,104,memories,1,1,2
3N5YJ55YXG41FN6XSQC09KNS46EANY,"As Richard Pearce-Moses wrote , `` Archivists keep records that have enduring value as reliable memories of the past , and they help people find and understand the information they need in those records . ''",164,175,information,0,1,1
3N5YJ55YXG41FN6XSQC09KNS46EANY,"Archivists must also select records valuable enough to justify the costs of storage and preservation , plus the labor intensive expenses of arrangement , description , and reference service .",0,10,Archivists,2,1,3
3N5YJ55YXG41FN6XSQC09KNS46EANY,"Archivists must also select records valuable enough to justify the costs of storage and preservation , plus the labor intensive expenses of arrangement , description , and reference service .",36,44,valuable,0,3,3
3N5YJ55YXG41FN6XSQC09KNS46EANY,"Archivists must also select records valuable enough to justify the costs of storage and preservation , plus the labor intensive expenses of arrangement , description , and reference service .",55,62,justify,5,1,6
3N5YJ55YXG41FN6XSQC09KNS46EANY,"Archivists must also select records valuable enough to justify the costs of storage and preservation , plus the labor intensive expenses of arrangement , description , and reference service .",76,83,storage,0,2,2
3N5YJ55YXG41FN6XSQC09KNS46EANY,"Archivists must also select records valuable enough to justify the costs of storage and preservation , plus the labor intensive expenses of arrangement , description , and reference service .",88,100,preservation,8,5,13
3N5YJ55YXG41FN6XSQC09KNS46EANY,"Archivists must also select records valuable enough to justify the costs of storage and preservation , plus the labor intensive expenses of arrangement , description , and reference service .",112,117,labor,0,2,2
3N5YJ55YXG41FN6XSQC09KNS46EANY,"Archivists must also select records valuable enough to justify the costs of storage and preservation , plus the labor intensive expenses of arrangement , description , and reference service .",112,127,labor intensive,3,1,4
3N5YJ55YXG41FN6XSQC09KNS46EANY,"Archivists must also select records valuable enough to justify the costs of storage and preservation , plus the labor intensive expenses of arrangement , description , and reference service .",112,136,labor intensive expenses,1,0,1
3N5YJ55YXG41FN6XSQC09KNS46EANY,"Archivists must also select records valuable enough to justify the costs of storage and preservation , plus the labor intensive expenses of arrangement , description , and reference service .",118,127,intensive,6,2,8
3N5YJ55YXG41FN6XSQC09KNS46EANY,"Archivists must also select records valuable enough to justify the costs of storage and preservation , plus the labor intensive expenses of arrangement , description , and reference service .",128,136,expenses,1,0,1
3N5YJ55YXG41FN6XSQC09KNS46EANY,"Archivists must also select records valuable enough to justify the costs of storage and preservation , plus the labor intensive expenses of arrangement , description , and reference service .",140,151,arrangement,3,5,8
3N5YJ55YXG41FN6XSQC09KNS46EANY,"Archivists must also select records valuable enough to justify the costs of storage and preservation , plus the labor intensive expenses of arrangement , description , and reference service .",140,189,"arrangement , description , and reference service",1,0,1
3N5YJ55YXG41FN6XSQC09KNS46EANY,"Archivists must also select records valuable enough to justify the costs of storage and preservation , plus the labor intensive expenses of arrangement , description , and reference service .",154,165,description,1,1,2
3N5YJ55YXG41FN6XSQC09KNS46EANY,"Archivists must also select records valuable enough to justify the costs of storage and preservation , plus the labor intensive expenses of arrangement , description , and reference service .",172,181,reference,1,3,4
3N5YJ55YXG41FN6XSQC09KNS46EANY,"Archivists must also select records valuable enough to justify the costs of storage and preservation , plus the labor intensive expenses of arrangement , description , and reference service .",172,189,reference service,2,1,3
3N5YJ55YXG41FN6XSQC09KNS46EANY,"Voruzhonnije Síly Rossíyskoj Federátsii ) are the military services of Russia , established after the dissolution of the Soviet Union .",0,39,Voruzhonnije Síly Rossíyskoj Federátsii,1,1,2
3N5YJ55YXG41FN6XSQC09KNS46EANY,"Voruzhonnije Síly Rossíyskoj Federátsii ) are the military services of Russia , established after the dissolution of the Soviet Union .",80,91,established,1,3,4
3N5YJ55YXG41FN6XSQC09KNS46EANY,"Voruzhonnije Síly Rossíyskoj Federátsii ) are the military services of Russia , established after the dissolution of the Soviet Union .",102,113,dissolution,10,9,19
3N5YJ55YXG41FN6XSQC09KNS46EANY,"As the Soviet Union officially dissolved on December 31 , 1991 , the Soviet military was left in limbo .",20,30,officially,0,1,1
3N5YJ55YXG41FN6XSQC09KNS46EANY,"As the Soviet Union officially dissolved on December 31 , 1991 , the Soviet military was left in limbo .",31,40,dissolved,3,1,4
3N5YJ55YXG41FN6XSQC09KNS46EANY,"As the Soviet Union officially dissolved on December 31 , 1991 , the Soviet military was left in limbo .",97,102,limbo,8,6,14
3N5YJ55YXG41FN6XSQC09KNS46EANY,"On 7 May 1992 , Yeltsin appointed himself as the new Russian minister of defense , marking a crucial step in the creation of the new Armed Forces .",24,33,appointed,3,2,5
3N5YJ55YXG41FN6XSQC09KNS46EANY,"On 7 May 1992 , Yeltsin appointed himself as the new Russian minister of defense , marking a crucial step in the creation of the new Armed Forces .",73,80,defense,1,2,3
3N5YJ55YXG41FN6XSQC09KNS46EANY,"On 7 May 1992 , Yeltsin appointed himself as the new Russian minister of defense , marking a crucial step in the creation of the new Armed Forces .",93,100,crucial,5,7,12
3N5YJ55YXG41FN6XSQC09KNS46EANY,"On 7 May 1992 , Yeltsin appointed himself as the new Russian minister of defense , marking a crucial step in the creation of the new Armed Forces .",93,105,crucial step,0,1,1
3UUSLRKAUL4AA9HMWTMD3O98PU6D7S,"The Art Nouveau style however , was one that Mucha attempted to disassociate himself from throughout his life ; he always insisted that rather than maintaining any fashionable stylistic form , his paintings were entirely a product of himself and Czech art .",4,15,Art Nouveau,6,1,7
3UUSLRKAUL4AA9HMWTMD3O98PU6D7S,"The Art Nouveau style however , was one that Mucha attempted to disassociate himself from throughout his life ; he always insisted that rather than maintaining any fashionable stylistic form , his paintings were entirely a product of himself and Czech art .",8,15,Nouveau,3,0,3
3UUSLRKAUL4AA9HMWTMD3O98PU6D7S,"The Art Nouveau style however , was one that Mucha attempted to disassociate himself from throughout his life ; he always insisted that rather than maintaining any fashionable stylistic form , his paintings were entirely a product of himself and Czech art .",51,60,attempted,1,3,4
3UUSLRKAUL4AA9HMWTMD3O98PU6D7S,"The Art Nouveau style however , was one that Mucha attempted to disassociate himself from throughout his life ; he always insisted that rather than maintaining any fashionable stylistic form , his paintings were entirely a product of himself and Czech art .",64,76,disassociate,10,10,20
3UUSLRKAUL4AA9HMWTMD3O98PU6D7S,"The Art Nouveau style however , was one that Mucha attempted to disassociate himself from throughout his life ; he always insisted that rather than maintaining any fashionable stylistic form , his paintings were entirely a product of himself and Czech art .",90,100,throughout,1,3,4
3UUSLRKAUL4AA9HMWTMD3O98PU6D7S,"The Art Nouveau style however , was one that Mucha attempted to disassociate himself from throughout his life ; he always insisted that rather than maintaining any fashionable stylistic form , his paintings were entirely a product of himself and Czech art .",122,130,insisted,0,4,4
3UUSLRKAUL4AA9HMWTMD3O98PU6D7S,"The Art Nouveau style however , was one that Mucha attempted to disassociate himself from throughout his life ; he always insisted that rather than maintaining any fashionable stylistic form , his paintings were entirely a product of himself and Czech art .",148,159,maintaining,1,1,2
3UUSLRKAUL4AA9HMWTMD3O98PU6D7S,"The Art Nouveau style however , was one that Mucha attempted to disassociate himself from throughout his life ; he always insisted that rather than maintaining any fashionable stylistic form , his paintings were entirely a product of himself and Czech art .",164,175,fashionable,2,3,5
3UUSLRKAUL4AA9HMWTMD3O98PU6D7S,"The Art Nouveau style however , was one that Mucha attempted to disassociate himself from throughout his life ; he always insisted that rather than maintaining any fashionable stylistic form , his paintings were entirely a product of himself and Czech art .",164,185,fashionable stylistic,0,1,1
3UUSLRKAUL4AA9HMWTMD3O98PU6D7S,"The Art Nouveau style however , was one that Mucha attempted to disassociate himself from throughout his life ; he always insisted that rather than maintaining any fashionable stylistic form , his paintings were entirely a product of himself and Czech art .",164,190,fashionable stylistic form,2,2,4
3UUSLRKAUL4AA9HMWTMD3O98PU6D7S,"The Art Nouveau style however , was one that Mucha attempted to disassociate himself from throughout his life ; he always insisted that rather than maintaining any fashionable stylistic form , his paintings were entirely a product of himself and Czech art .",176,185,stylistic,5,1,6
3UUSLRKAUL4AA9HMWTMD3O98PU6D7S,"The Art Nouveau style however , was one that Mucha attempted to disassociate himself from throughout his life ; he always insisted that rather than maintaining any fashionable stylistic form , his paintings were entirely a product of himself and Czech art .",246,251,Czech,2,0,2
3UUSLRKAUL4AA9HMWTMD3O98PU6D7S,"He declared that art existed only to communicate a spiritual message , and nothing more ; hence his frustration at the fame he gained by his commercial art , when he most wanted to concentrate on more artistic projects .",37,48,communicate,1,1,2
3UUSLRKAUL4AA9HMWTMD3O98PU6D7S,"He declared that art existed only to communicate a spiritual message , and nothing more ; hence his frustration at the fame he gained by his commercial art , when he most wanted to concentrate on more artistic projects .",51,60,spiritual,6,3,9
3UUSLRKAUL4AA9HMWTMD3O98PU6D7S,"He declared that art existed only to communicate a spiritual message , and nothing more ; hence his frustration at the fame he gained by his commercial art , when he most wanted to concentrate on more artistic projects .",51,68,spiritual message,3,1,4
3UUSLRKAUL4AA9HMWTMD3O98PU6D7S,"He declared that art existed only to communicate a spiritual message , and nothing more ; hence his frustration at the fame he gained by his commercial art , when he most wanted to concentrate on more artistic projects .",90,95,hence,1,3,4
3UUSLRKAUL4AA9HMWTMD3O98PU6D7S,"He declared that art existed only to communicate a spiritual message , and nothing more ; hence his frustration at the fame he gained by his commercial art , when he most wanted to concentrate on more artistic projects .",100,111,frustration,4,8,12
3UUSLRKAUL4AA9HMWTMD3O98PU6D7S,"He declared that art existed only to communicate a spiritual message , and nothing more ; hence his frustration at the fame he gained by his commercial art , when he most wanted to concentrate on more artistic projects .",119,123,fame,1,0,1
3UUSLRKAUL4AA9HMWTMD3O98PU6D7S,"He declared that art existed only to communicate a spiritual message , and nothing more ; hence his frustration at the fame he gained by his commercial art , when he most wanted to concentrate on more artistic projects .",127,133,gained,0,1,1
3UUSLRKAUL4AA9HMWTMD3O98PU6D7S,"He declared that art existed only to communicate a spiritual message , and nothing more ; hence his frustration at the fame he gained by his commercial art , when he most wanted to concentrate on more artistic projects .",141,151,commercial,1,0,1
3UUSLRKAUL4AA9HMWTMD3O98PU6D7S,"He declared that art existed only to communicate a spiritual message , and nothing more ; hence his frustration at the fame he gained by his commercial art , when he most wanted to concentrate on more artistic projects .",141,155,commercial art,3,0,3
3UUSLRKAUL4AA9HMWTMD3O98PU6D7S,"He declared that art existed only to communicate a spiritual message , and nothing more ; hence his frustration at the fame he gained by his commercial art , when he most wanted to concentrate on more artistic projects .",181,192,concentrate,4,3,7
3UUSLRKAUL4AA9HMWTMD3O98PU6D7S,"He declared that art existed only to communicate a spiritual message , and nothing more ; hence his frustration at the fame he gained by his commercial art , when he most wanted to concentrate on more artistic projects .",201,209,artistic,1,1,2
3UUSLRKAUL4AA9HMWTMD3O98PU6D7S,"He declared that art existed only to communicate a spiritual message , and nothing more ; hence his frustration at the fame he gained by his commercial art , when he most wanted to concentrate on more artistic projects .",201,218,artistic projects,0,1,1
3UUSLRKAUL4AA9HMWTMD3O98PU6D7S,The American Lacrosse Conference ( ALC ) is a NCAA Division I women 's lacrosse-only college athletic conference whose six members are located in the eastern half of the United States .,4,32,American Lacrosse Conference,1,0,1
3UUSLRKAUL4AA9HMWTMD3O98PU6D7S,The American Lacrosse Conference ( ALC ) is a NCAA Division I women 's lacrosse-only college athletic conference whose six members are located in the eastern half of the United States .,13,21,Lacrosse,2,0,2
3UUSLRKAUL4AA9HMWTMD3O98PU6D7S,The American Lacrosse Conference ( ALC ) is a NCAA Division I women 's lacrosse-only college athletic conference whose six members are located in the eastern half of the United States .,71,84,lacrosse-only,6,4,10
3UUSLRKAUL4AA9HMWTMD3O98PU6D7S,The American Lacrosse Conference ( ALC ) is a NCAA Division I women 's lacrosse-only college athletic conference whose six members are located in the eastern half of the United States .,102,112,conference,2,2,4
3UUSLRKAUL4AA9HMWTMD3O98PU6D7S,"In 1989 , through the leadership of President Borislav Stanković , FIBA approved the rule that allowed NBA players to compete in international tournaments , including the Olympics .",22,32,leadership,0,1,1
3UUSLRKAUL4AA9HMWTMD3O98PU6D7S,"In 1989 , through the leadership of President Borislav Stanković , FIBA approved the rule that allowed NBA players to compete in international tournaments , including the Olympics .",46,64,Borislav Stanković,1,0,1
3UUSLRKAUL4AA9HMWTMD3O98PU6D7S,"In 1989 , through the leadership of President Borislav Stanković , FIBA approved the rule that allowed NBA players to compete in international tournaments , including the Olympics .",67,71,FIBA,1,0,1
3UUSLRKAUL4AA9HMWTMD3O98PU6D7S,"In 1989 , through the leadership of President Borislav Stanković , FIBA approved the rule that allowed NBA players to compete in international tournaments , including the Olympics .",103,106,NBA,1,0,1
3UUSLRKAUL4AA9HMWTMD3O98PU6D7S,"In 1989 , through the leadership of President Borislav Stanković , FIBA approved the rule that allowed NBA players to compete in international tournaments , including the Olympics .",118,125,compete,0,1,1
3UUSLRKAUL4AA9HMWTMD3O98PU6D7S,"In 1989 , through the leadership of President Borislav Stanković , FIBA approved the rule that allowed NBA players to compete in international tournaments , including the Olympics .",129,142,international,1,0,1
3UUSLRKAUL4AA9HMWTMD3O98PU6D7S,"In 1989 , through the leadership of President Borislav Stanković , FIBA approved the rule that allowed NBA players to compete in international tournaments , including the Olympics .",129,154,international tournaments,2,0,2
3UUSLRKAUL4AA9HMWTMD3O98PU6D7S,"In 1989 , through the leadership of President Borislav Stanković , FIBA approved the rule that allowed NBA players to compete in international tournaments , including the Olympics .",143,154,tournaments,1,8,9
3O2Y2UIUCQVV38226T6CVTHF7RMKFG,"His masterpiece is the Selimiye Mosque in Edirne , although his most famous work is the Suleiman Mosque in Istanbul .",4,15,masterpiece,10,10,20
3O2Y2UIUCQVV38226T6CVTHF7RMKFG,"His masterpiece is the Selimiye Mosque in Edirne , although his most famous work is the Suleiman Mosque in Istanbul .",23,31,Selimiye,3,0,3
3O2Y2UIUCQVV38226T6CVTHF7RMKFG,"His masterpiece is the Selimiye Mosque in Edirne , although his most famous work is the Suleiman Mosque in Istanbul .",32,38,Mosque,1,0,1
3O2Y2UIUCQVV38226T6CVTHF7RMKFG,"His masterpiece is the Selimiye Mosque in Edirne , although his most famous work is the Suleiman Mosque in Istanbul .",42,48,Edirne,1,0,1
3O2Y2UIUCQVV38226T6CVTHF7RMKFG,"His masterpiece is the Selimiye Mosque in Edirne , although his most famous work is the Suleiman Mosque in Istanbul .",69,75,famous,1,0,1
3O2Y2UIUCQVV38226T6CVTHF7RMKFG,"His masterpiece is the Selimiye Mosque in Edirne , although his most famous work is the Suleiman Mosque in Istanbul .",88,96,Suleiman,1,0,1
3O2Y2UIUCQVV38226T6CVTHF7RMKFG,"Koca Mi 'm âr Sinân Âğâ ( Ottoman Turkish : معمار سينان ; Modern Turkish : Mimar Sinan , pronounced ( miːˈmaːɾ siˈnan ) ) ( c. 1489\/1490 - July 17 , 1588 ) was the chief Ottoman architect ( Turkish : `` Mimar '' ) and civil engineer for sultans Suleiman the Magnificent , Selim II , and Murad III .",0,22,Koca Mi m âr Sinân Âğâ,2,0,2
3O2Y2UIUCQVV38226T6CVTHF7RMKFG,"Koca Mi 'm âr Sinân Âğâ ( Ottoman Turkish : معمار سينان ; Modern Turkish : Mimar Sinan , pronounced ( miːˈmaːɾ siˈnan ) ) ( c. 1489\/1490 - July 17 , 1588 ) was the chief Ottoman architect ( Turkish : `` Mimar '' ) and civil engineer for sultans Suleiman the Magnificent , Selim II , and Murad III .",26,33,Ottoman,1,0,1
3O2Y2UIUCQVV38226T6CVTHF7RMKFG,"Koca Mi 'm âr Sinân Âğâ ( Ottoman Turkish : معمار سينان ; Modern Turkish : Mimar Sinan , pronounced ( miːˈmaːɾ siˈnan ) ) ( c. 1489\/1490 - July 17 , 1588 ) was the chief Ottoman architect ( Turkish : `` Mimar '' ) and civil engineer for sultans Suleiman the Magnificent , Selim II , and Murad III .",26,41,Ottoman Turkish,1,0,1
3O2Y2UIUCQVV38226T6CVTHF7RMKFG,"Koca Mi 'm âr Sinân Âğâ ( Ottoman Turkish : معمار سينان ; Modern Turkish : Mimar Sinan , pronounced ( miːˈmaːɾ siˈnan ) ) ( c. 1489\/1490 - July 17 , 1588 ) was the chief Ottoman architect ( Turkish : `` Mimar '' ) and civil engineer for sultans Suleiman the Magnificent , Selim II , and Murad III .",34,55,Turkish : معمار سينان,1,0,1
3O2Y2UIUCQVV38226T6CVTHF7RMKFG,"Koca Mi 'm âr Sinân Âğâ ( Ottoman Turkish : معمار سينان ; Modern Turkish : Mimar Sinan , pronounced ( miːˈmaːɾ siˈnan ) ) ( c. 1489\/1490 - July 17 , 1588 ) was the chief Ottoman architect ( Turkish : `` Mimar '' ) and civil engineer for sultans Suleiman the Magnificent , Selim II , and Murad III .",44,55,معمار سينان,1,0,1
3O2Y2UIUCQVV38226T6CVTHF7RMKFG,"Koca Mi 'm âr Sinân Âğâ ( Ottoman Turkish : معمار سينان ; Modern Turkish : Mimar Sinan , pronounced ( miːˈmaːɾ siˈnan ) ) ( c. 1489\/1490 - July 17 , 1588 ) was the chief Ottoman architect ( Turkish : `` Mimar '' ) and civil engineer for sultans Suleiman the Magnificent , Selim II , and Murad III .",75,86,Mimar Sinan,1,0,1
3O2Y2UIUCQVV38226T6CVTHF7RMKFG,"Koca Mi 'm âr Sinân Âğâ ( Ottoman Turkish : معمار سينان ; Modern Turkish : Mimar Sinan , pronounced ( miːˈmaːɾ siˈnan ) ) ( c. 1489\/1490 - July 17 , 1588 ) was the chief Ottoman architect ( Turkish : `` Mimar '' ) and civil engineer for sultans Suleiman the Magnificent , Selim II , and Murad III .",89,99,pronounced,5,2,7
3O2Y2UIUCQVV38226T6CVTHF7RMKFG,"Koca Mi 'm âr Sinân Âğâ ( Ottoman Turkish : معمار سينان ; Modern Turkish : Mimar Sinan , pronounced ( miːˈmaːɾ siˈnan ) ) ( c. 1489\/1490 - July 17 , 1588 ) was the chief Ottoman architect ( Turkish : `` Mimar '' ) and civil engineer for sultans Suleiman the Magnificent , Selim II , and Murad III .",102,117,miːˈmaːɾ siˈnan,2,0,2
3O2Y2UIUCQVV38226T6CVTHF7RMKFG,"Koca Mi 'm âr Sinân Âğâ ( Ottoman Turkish : معمار سينان ; Modern Turkish : Mimar Sinan , pronounced ( miːˈmaːɾ siˈnan ) ) ( c. 1489\/1490 - July 17 , 1588 ) was the chief Ottoman architect ( Turkish : `` Mimar '' ) and civil engineer for sultans Suleiman the Magnificent , Selim II , and Murad III .",171,188,Ottoman architect,1,1,2
3O2Y2UIUCQVV38226T6CVTHF7RMKFG,"Koca Mi 'm âr Sinân Âğâ ( Ottoman Turkish : معمار سينان ; Modern Turkish : Mimar Sinan , pronounced ( miːˈmaːɾ siˈnan ) ) ( c. 1489\/1490 - July 17 , 1588 ) was the chief Ottoman architect ( Turkish : `` Mimar '' ) and civil engineer for sultans Suleiman the Magnificent , Selim II , and Murad III .",179,188,architect,4,3,7
3O2Y2UIUCQVV38226T6CVTHF7RMKFG,"Koca Mi 'm âr Sinân Âğâ ( Ottoman Turkish : معمار سينان ; Modern Turkish : Mimar Sinan , pronounced ( miːˈmaːɾ siˈnan ) ) ( c. 1489\/1490 - July 17 , 1588 ) was the chief Ottoman architect ( Turkish : `` Mimar '' ) and civil engineer for sultans Suleiman the Magnificent , Selim II , and Murad III .",219,233,civil engineer,5,1,6
3O2Y2UIUCQVV38226T6CVTHF7RMKFG,"Koca Mi 'm âr Sinân Âğâ ( Ottoman Turkish : معمار سينان ; Modern Turkish : Mimar Sinan , pronounced ( miːˈmaːɾ siˈnan ) ) ( c. 1489\/1490 - July 17 , 1588 ) was the chief Ottoman architect ( Turkish : `` Mimar '' ) and civil engineer for sultans Suleiman the Magnificent , Selim II , and Murad III .",225,233,engineer,1,1,2
3O2Y2UIUCQVV38226T6CVTHF7RMKFG,"Koca Mi 'm âr Sinân Âğâ ( Ottoman Turkish : معمار سينان ; Modern Turkish : Mimar Sinan , pronounced ( miːˈmaːɾ siˈnan ) ) ( c. 1489\/1490 - July 17 , 1588 ) was the chief Ottoman architect ( Turkish : `` Mimar '' ) and civil engineer for sultans Suleiman the Magnificent , Selim II , and Murad III .",238,245,sultans,7,1,8
3O2Y2UIUCQVV38226T6CVTHF7RMKFG,"Koca Mi 'm âr Sinân Âğâ ( Ottoman Turkish : معمار سينان ; Modern Turkish : Mimar Sinan , pronounced ( miːˈmaːɾ siˈnan ) ) ( c. 1489\/1490 - July 17 , 1588 ) was the chief Ottoman architect ( Turkish : `` Mimar '' ) and civil engineer for sultans Suleiman the Magnificent , Selim II , and Murad III .",246,254,Suleiman,1,0,1
3O2Y2UIUCQVV38226T6CVTHF7RMKFG,"Koca Mi 'm âr Sinân Âğâ ( Ottoman Turkish : معمار سينان ; Modern Turkish : Mimar Sinan , pronounced ( miːˈmaːɾ siˈnan ) ) ( c. 1489\/1490 - July 17 , 1588 ) was the chief Ottoman architect ( Turkish : `` Mimar '' ) and civil engineer for sultans Suleiman the Magnificent , Selim II , and Murad III .",259,270,Magnificent,2,3,5
3O2Y2UIUCQVV38226T6CVTHF7RMKFG,"The Matrix Reloaded is a 2003 American science fiction action film and the second installment in The Matrix trilogy , written and directed by The Wachowski Brothers .",11,19,Reloaded,1,2,3
3O2Y2UIUCQVV38226T6CVTHF7RMKFG,"The Matrix Reloaded is a 2003 American science fiction action film and the second installment in The Matrix trilogy , written and directed by The Wachowski Brothers .",39,54,science fiction,1,3,4
3O2Y2UIUCQVV38226T6CVTHF7RMKFG,"The Matrix Reloaded is a 2003 American science fiction action film and the second installment in The Matrix trilogy , written and directed by The Wachowski Brothers .",39,66,science fiction action film,1,0,1
3O2Y2UIUCQVV38226T6CVTHF7RMKFG,"The Matrix Reloaded is a 2003 American science fiction action film and the second installment in The Matrix trilogy , written and directed by The Wachowski Brothers .",47,54,fiction,1,4,5
3O2Y2UIUCQVV38226T6CVTHF7RMKFG,"The Matrix Reloaded is a 2003 American science fiction action film and the second installment in The Matrix trilogy , written and directed by The Wachowski Brothers .",55,61,action,1,0,1
3O2Y2UIUCQVV38226T6CVTHF7RMKFG,"The Matrix Reloaded is a 2003 American science fiction action film and the second installment in The Matrix trilogy , written and directed by The Wachowski Brothers .",82,93,installment,5,5,10
3O2Y2UIUCQVV38226T6CVTHF7RMKFG,"The Matrix Reloaded is a 2003 American science fiction action film and the second installment in The Matrix trilogy , written and directed by The Wachowski Brothers .",101,107,Matrix,0,1,1
3O2Y2UIUCQVV38226T6CVTHF7RMKFG,"The Matrix Reloaded is a 2003 American science fiction action film and the second installment in The Matrix trilogy , written and directed by The Wachowski Brothers .",101,115,Matrix trilogy,1,0,1
3O2Y2UIUCQVV38226T6CVTHF7RMKFG,"The Matrix Reloaded is a 2003 American science fiction action film and the second installment in The Matrix trilogy , written and directed by The Wachowski Brothers .",108,115,trilogy,7,2,9
3O2Y2UIUCQVV38226T6CVTHF7RMKFG,"The Matrix Reloaded is a 2003 American science fiction action film and the second installment in The Matrix trilogy , written and directed by The Wachowski Brothers .",146,155,Wachowski,2,0,2
3O2Y2UIUCQVV38226T6CVTHF7RMKFG,The awarding of the Order is administered by the Decoration Bureau of Office of the Prime Minister .,4,12,awarding,0,1,1
3O2Y2UIUCQVV38226T6CVTHF7RMKFG,The awarding of the Order is administered by the Decoration Bureau of Office of the Prime Minister .,29,41,administered,7,6,13
3O2Y2UIUCQVV38226T6CVTHF7RMKFG,The awarding of the Order is administered by the Decoration Bureau of Office of the Prime Minister .,49,59,Decoration,2,0,2
3O2Y2UIUCQVV38226T6CVTHF7RMKFG,The awarding of the Order is administered by the Decoration Bureau of Office of the Prime Minister .,49,66,Decoration Bureau,2,0,2
3O2Y2UIUCQVV38226T6CVTHF7RMKFG,The awarding of the Order is administered by the Decoration Bureau of Office of the Prime Minister .,60,66,Bureau,4,0,4
3DGDV62G7OACD5N6VQWD7R9PSXN2PF,"Team Germany won it with 128 points , 35 points lead ahead of Team New Zealand .",0,4,Team,0,1,1
3DGDV62G7OACD5N6VQWD7R9PSXN2PF,"Team Germany won it with 128 points , 35 points lead ahead of Team New Zealand .",0,12,Team Germany,1,0,1
3DGDV62G7OACD5N6VQWD7R9PSXN2PF,"Team Germany won it with 128 points , 35 points lead ahead of Team New Zealand .",48,52,lead,0,1,1
3DGDV62G7OACD5N6VQWD7R9PSXN2PF,"Team Germany won it with 128 points , 35 points lead ahead of Team New Zealand .",48,58,lead ahead,0,2,2
3DGDV62G7OACD5N6VQWD7R9PSXN2PF,"Team Germany won it with 128 points , 35 points lead ahead of Team New Zealand .",53,58,ahead,0,2,2
3DGDV62G7OACD5N6VQWD7R9PSXN2PF,"Team Germany won it with 128 points , 35 points lead ahead of Team New Zealand .",62,78,Team New Zealand,1,0,1
3DGDV62G7OACD5N6VQWD7R9PSXN2PF,The 2008-09 season was the first season in which the new `` Powered by Ferrari '' A1GP car was used .,12,18,season,1,0,1
3DGDV62G7OACD5N6VQWD7R9PSXN2PF,The 2008-09 season was the first season in which the new `` Powered by Ferrari '' A1GP car was used .,60,67,Powered,1,1,2
3DGDV62G7OACD5N6VQWD7R9PSXN2PF,The 2008-09 season was the first season in which the new `` Powered by Ferrari '' A1GP car was used .,60,78,Powered by Ferrari,2,1,3
3DGDV62G7OACD5N6VQWD7R9PSXN2PF,The 2008-09 season was the first season in which the new `` Powered by Ferrari '' A1GP car was used .,71,78,Ferrari,1,2,3
3DGDV62G7OACD5N6VQWD7R9PSXN2PF,"The opening round of the season , scheduled as part of the already well established Nikon SuperGP race meeting , was canceled five days before practice was due to begin .",4,17,opening round,1,0,1
3DGDV62G7OACD5N6VQWD7R9PSXN2PF,"The opening round of the season , scheduled as part of the already well established Nikon SuperGP race meeting , was canceled five days before practice was due to begin .",12,17,round,0,1,1
3DGDV62G7OACD5N6VQWD7R9PSXN2PF,"The opening round of the season , scheduled as part of the already well established Nikon SuperGP race meeting , was canceled five days before practice was due to begin .",25,31,season,0,2,2
3DGDV62G7OACD5N6VQWD7R9PSXN2PF,"The opening round of the season , scheduled as part of the already well established Nikon SuperGP race meeting , was canceled five days before practice was due to begin .",34,43,scheduled,9,10,19
3DGDV62G7OACD5N6VQWD7R9PSXN2PF,"The opening round of the season , scheduled as part of the already well established Nikon SuperGP race meeting , was canceled five days before practice was due to begin .",67,83,well established,2,1,3
3DGDV62G7OACD5N6VQWD7R9PSXN2PF,"The opening round of the season , scheduled as part of the already well established Nikon SuperGP race meeting , was canceled five days before practice was due to begin .",72,83,established,6,5,11
3DGDV62G7OACD5N6VQWD7R9PSXN2PF,"The opening round of the season , scheduled as part of the already well established Nikon SuperGP race meeting , was canceled five days before practice was due to begin .",84,89,Nikon,1,1,2
3DGDV62G7OACD5N6VQWD7R9PSXN2PF,"The opening round of the season , scheduled as part of the already well established Nikon SuperGP race meeting , was canceled five days before practice was due to begin .",84,110,Nikon SuperGP race meeting,1,0,1
3DGDV62G7OACD5N6VQWD7R9PSXN2PF,"The opening round of the season , scheduled as part of the already well established Nikon SuperGP race meeting , was canceled five days before practice was due to begin .",90,97,SuperGP,1,0,1
3DGDV62G7OACD5N6VQWD7R9PSXN2PF,"The opening round of the season , scheduled as part of the already well established Nikon SuperGP race meeting , was canceled five days before practice was due to begin .",98,110,race meeting,0,1,1
3DGDV62G7OACD5N6VQWD7R9PSXN2PF,"The opening round of the season , scheduled as part of the already well established Nikon SuperGP race meeting , was canceled five days before practice was due to begin .",117,125,canceled,4,2,6
3DGDV62G7OACD5N6VQWD7R9PSXN2PF,"The opening round of the season , scheduled as part of the already well established Nikon SuperGP race meeting , was canceled five days before practice was due to begin .",143,151,practice,2,0,2
3DGDV62G7OACD5N6VQWD7R9PSXN2PF,"The opening round of the season , scheduled as part of the already well established Nikon SuperGP race meeting , was canceled five days before practice was due to begin .",156,159,due,0,1,1
3DGDV62G7OACD5N6VQWD7R9PSXN2PF,"The series was thrown into further doubt as more races were canceled , with an announcement made on 5 November 2009 stating that the races in China and Malaysia would not be taking place .",4,10,series,0,2,2
3DGDV62G7OACD5N6VQWD7R9PSXN2PF,"The series was thrown into further doubt as more races were canceled , with an announcement made on 5 November 2009 stating that the races in China and Malaysia would not be taking place .",15,21,thrown,0,3,3
3DGDV62G7OACD5N6VQWD7R9PSXN2PF,"The series was thrown into further doubt as more races were canceled , with an announcement made on 5 November 2009 stating that the races in China and Malaysia would not be taking place .",35,40,doubt,4,0,4
3DGDV62G7OACD5N6VQWD7R9PSXN2PF,"The series was thrown into further doubt as more races were canceled , with an announcement made on 5 November 2009 stating that the races in China and Malaysia would not be taking place .",49,54,races,0,1,1
3DGDV62G7OACD5N6VQWD7R9PSXN2PF,"The series was thrown into further doubt as more races were canceled , with an announcement made on 5 November 2009 stating that the races in China and Malaysia would not be taking place .",60,68,canceled,2,1,3
3DGDV62G7OACD5N6VQWD7R9PSXN2PF,"The series was thrown into further doubt as more races were canceled , with an announcement made on 5 November 2009 stating that the races in China and Malaysia would not be taking place .",79,91,announcement,10,4,14
3DGDV62G7OACD5N6VQWD7R9PSXN2PF,"The series was thrown into further doubt as more races were canceled , with an announcement made on 5 November 2009 stating that the races in China and Malaysia would not be taking place .",116,123,stating,1,0,1
3DGDV62G7OACD5N6VQWD7R9PSXN2PF,"The series was thrown into further doubt as more races were canceled , with an announcement made on 5 November 2009 stating that the races in China and Malaysia would not be taking place .",142,160,China and Malaysia,1,0,1
3DGDV62G7OACD5N6VQWD7R9PSXN2PF,"The series was thrown into further doubt as more races were canceled , with an announcement made on 5 November 2009 stating that the races in China and Malaysia would not be taking place .",152,160,Malaysia,1,0,1
3DGDV62G7OACD5N6VQWD7R9PSXN2PF,This put an end to the hopes the season would start and also put the future of the series in doubt .,23,28,hopes,0,1,1
3DGDV62G7OACD5N6VQWD7R9PSXN2PF,This put an end to the hopes the season would start and also put the future of the series in doubt .,83,89,series,3,2,5
3DGDV62G7OACD5N6VQWD7R9PSXN2PF,This put an end to the hopes the season would start and also put the future of the series in doubt .,90,98,in doubt,1,0,1
3DGDV62G7OACD5N6VQWD7R9PSXN2PF,This put an end to the hopes the season would start and also put the future of the series in doubt .,93,98,doubt,2,3,5
3J6BHNX0U9T7R0FJ4HPP3YQO9I8KNN,Sites rejected at this shortlisting phase included : On 30 January 2007 it was announced that the first regional casino would be built in East Manchester near the City of Manchester Stadium .,0,5,Sites,1,0,1
3J6BHNX0U9T7R0FJ4HPP3YQO9I8KNN,Sites rejected at this shortlisting phase included : On 30 January 2007 it was announced that the first regional casino would be built in East Manchester near the City of Manchester Stadium .,6,14,rejected,4,2,6
3J6BHNX0U9T7R0FJ4HPP3YQO9I8KNN,Sites rejected at this shortlisting phase included : On 30 January 2007 it was announced that the first regional casino would be built in East Manchester near the City of Manchester Stadium .,23,35,shortlisting,8,10,18
3J6BHNX0U9T7R0FJ4HPP3YQO9I8KNN,Sites rejected at this shortlisting phase included : On 30 January 2007 it was announced that the first regional casino would be built in East Manchester near the City of Manchester Stadium .,23,41,shortlisting phase,3,1,4
3J6BHNX0U9T7R0FJ4HPP3YQO9I8KNN,Sites rejected at this shortlisting phase included : On 30 January 2007 it was announced that the first regional casino would be built in East Manchester near the City of Manchester Stadium .,36,41,phase,1,2,3
3J6BHNX0U9T7R0FJ4HPP3YQO9I8KNN,Sites rejected at this shortlisting phase included : On 30 January 2007 it was announced that the first regional casino would be built in East Manchester near the City of Manchester Stadium .,79,88,announced,1,2,3
3J6BHNX0U9T7R0FJ4HPP3YQO9I8KNN,Sites rejected at this shortlisting phase included : On 30 January 2007 it was announced that the first regional casino would be built in East Manchester near the City of Manchester Stadium .,104,112,regional,2,1,3
3J6BHNX0U9T7R0FJ4HPP3YQO9I8KNN,Sites rejected at this shortlisting phase included : On 30 January 2007 it was announced that the first regional casino would be built in East Manchester near the City of Manchester Stadium .,104,119,regional casino,2,1,3
3J6BHNX0U9T7R0FJ4HPP3YQO9I8KNN,Sites rejected at this shortlisting phase included : On 30 January 2007 it was announced that the first regional casino would be built in East Manchester near the City of Manchester Stadium .,113,119,casino,3,4,7
3J6BHNX0U9T7R0FJ4HPP3YQO9I8KNN,Sites rejected at this shortlisting phase included : On 30 January 2007 it was announced that the first regional casino would be built in East Manchester near the City of Manchester Stadium .,129,134,built,0,1,1
3J6BHNX0U9T7R0FJ4HPP3YQO9I8KNN,Sites rejected at this shortlisting phase included : On 30 January 2007 it was announced that the first regional casino would be built in East Manchester near the City of Manchester Stadium .,163,189,City of Manchester Stadium,1,0,1
3J6BHNX0U9T7R0FJ4HPP3YQO9I8KNN,Sites rejected at this shortlisting phase included : On 30 January 2007 it was announced that the first regional casino would be built in East Manchester near the City of Manchester Stadium .,182,189,Stadium,1,0,1
3J6BHNX0U9T7R0FJ4HPP3YQO9I8KNN,"This was regarded as a shock to the Blackpool and The O2 ( formerly the Millennium Dome ) bids , both of whom were regarded as the favorites .",9,17,regarded,3,2,5
3J6BHNX0U9T7R0FJ4HPP3YQO9I8KNN,"This was regarded as a shock to the Blackpool and The O2 ( formerly the Millennium Dome ) bids , both of whom were regarded as the favorites .",36,45,Blackpool,0,1,1
3J6BHNX0U9T7R0FJ4HPP3YQO9I8KNN,"This was regarded as a shock to the Blackpool and The O2 ( formerly the Millennium Dome ) bids , both of whom were regarded as the favorites .",72,82,Millennium,0,2,2
3J6BHNX0U9T7R0FJ4HPP3YQO9I8KNN,"This was regarded as a shock to the Blackpool and The O2 ( formerly the Millennium Dome ) bids , both of whom were regarded as the favorites .",72,87,Millennium Dome,1,1,2
3J6BHNX0U9T7R0FJ4HPP3YQO9I8KNN,"This was regarded as a shock to the Blackpool and The O2 ( formerly the Millennium Dome ) bids , both of whom were regarded as the favorites .",83,87,Dome,0,1,1
3J6BHNX0U9T7R0FJ4HPP3YQO9I8KNN,"This was regarded as a shock to the Blackpool and The O2 ( formerly the Millennium Dome ) bids , both of whom were regarded as the favorites .",90,94,bids,1,6,7
3J6BHNX0U9T7R0FJ4HPP3YQO9I8KNN,"This was regarded as a shock to the Blackpool and The O2 ( formerly the Millennium Dome ) bids , both of whom were regarded as the favorites .",105,109,whom,1,1,2
3J6BHNX0U9T7R0FJ4HPP3YQO9I8KNN,"This was regarded as a shock to the Blackpool and The O2 ( formerly the Millennium Dome ) bids , both of whom were regarded as the favorites .",115,123,regarded,1,2,3
3J6BHNX0U9T7R0FJ4HPP3YQO9I8KNN,"This was regarded as a shock to the Blackpool and The O2 ( formerly the Millennium Dome ) bids , both of whom were regarded as the favorites .",131,140,favorites,0,4,4
3J6BHNX0U9T7R0FJ4HPP3YQO9I8KNN,"The first regional casino was initially proposed to be in the City of Manchester , but this has since been scrapped by the UK government soon after Gordon Brown became Prime Minister of the United Kingdom .",10,18,regional,1,0,1
3J6BHNX0U9T7R0FJ4HPP3YQO9I8KNN,"The first regional casino was initially proposed to be in the City of Manchester , but this has since been scrapped by the UK government soon after Gordon Brown became Prime Minister of the United Kingdom .",19,25,casino,1,0,1
3J6BHNX0U9T7R0FJ4HPP3YQO9I8KNN,"The first regional casino was initially proposed to be in the City of Manchester , but this has since been scrapped by the UK government soon after Gordon Brown became Prime Minister of the United Kingdom .",30,39,initially,4,1,5
3J6BHNX0U9T7R0FJ4HPP3YQO9I8KNN,"The first regional casino was initially proposed to be in the City of Manchester , but this has since been scrapped by the UK government soon after Gordon Brown became Prime Minister of the United Kingdom .",30,48,initially proposed,0,1,1
3J6BHNX0U9T7R0FJ4HPP3YQO9I8KNN,"The first regional casino was initially proposed to be in the City of Manchester , but this has since been scrapped by the UK government soon after Gordon Brown became Prime Minister of the United Kingdom .",40,48,proposed,2,1,3
3J6BHNX0U9T7R0FJ4HPP3YQO9I8KNN,"The first regional casino was initially proposed to be in the City of Manchester , but this has since been scrapped by the UK government soon after Gordon Brown became Prime Minister of the United Kingdom .",107,115,scrapped,9,10,19
3J6BHNX0U9T7R0FJ4HPP3YQO9I8KNN,"The first regional casino was initially proposed to be in the City of Manchester , but this has since been scrapped by the UK government soon after Gordon Brown became Prime Minister of the United Kingdom .",126,136,government,2,0,2
3J6BHNX0U9T7R0FJ4HPP3YQO9I8KNN,"The first regional casino was initially proposed to be in the City of Manchester , but this has since been scrapped by the UK government soon after Gordon Brown became Prime Minister of the United Kingdom .",168,182,Prime Minister,3,0,3
3J6BHNX0U9T7R0FJ4HPP3YQO9I8KNN,"John Herbert `` Jackie '' Gleason ( February 26 , 1916 - June 24 , 1987 ) was an American comedian , actor and musician .",90,98,comedian,2,2,4
39KV3A5D188GCY04TJH2YNV8QXGS71,"Afterwards large parts belonged to the duchy of Mecklenburg-Schwerin , a small portion to the duchy of Mecklenburg-Strelitz ( see Mecklenburg ) .",0,10,Afterwards,3,4,7
39KV3A5D188GCY04TJH2YNV8QXGS71,"Afterwards large parts belonged to the duchy of Mecklenburg-Schwerin , a small portion to the duchy of Mecklenburg-Strelitz ( see Mecklenburg ) .",23,31,belonged,1,5,6
39KV3A5D188GCY04TJH2YNV8QXGS71,"Afterwards large parts belonged to the duchy of Mecklenburg-Schwerin , a small portion to the duchy of Mecklenburg-Strelitz ( see Mecklenburg ) .",39,44,duchy,7,5,12
39KV3A5D188GCY04TJH2YNV8QXGS71,"Afterwards large parts belonged to the duchy of Mecklenburg-Schwerin , a small portion to the duchy of Mecklenburg-Strelitz ( see Mecklenburg ) .",48,68,Mecklenburg-Schwerin,1,0,1
39KV3A5D188GCY04TJH2YNV8QXGS71,"Afterwards large parts belonged to the duchy of Mecklenburg-Schwerin , a small portion to the duchy of Mecklenburg-Strelitz ( see Mecklenburg ) .",79,86,portion,1,0,1
39KV3A5D188GCY04TJH2YNV8QXGS71,"Afterwards large parts belonged to the duchy of Mecklenburg-Schwerin , a small portion to the duchy of Mecklenburg-Strelitz ( see Mecklenburg ) .",94,99,duchy,3,2,5
39KV3A5D188GCY04TJH2YNV8QXGS71,"The district of Güstrow was established in 1994 by merging the former districts of Güstrow , Teterow and Bützow .",4,12,district,1,0,1
39KV3A5D188GCY04TJH2YNV8QXGS71,"The district of Güstrow was established in 1994 by merging the former districts of Güstrow , Teterow and Bützow .",16,23,Güstrow,1,1,2
39KV3A5D188GCY04TJH2YNV8QXGS71,"The district of Güstrow was established in 1994 by merging the former districts of Güstrow , Teterow and Bützow .",28,39,established,5,4,9
39KV3A5D188GCY04TJH2YNV8QXGS71,"The district of Güstrow was established in 1994 by merging the former districts of Güstrow , Teterow and Bützow .",51,58,merging,6,8,14
39KV3A5D188GCY04TJH2YNV8QXGS71,"The district of Güstrow was established in 1994 by merging the former districts of Güstrow , Teterow and Bützow .",70,79,districts,3,0,3
39KV3A5D188GCY04TJH2YNV8QXGS71,"The district of Güstrow was established in 1994 by merging the former districts of Güstrow , Teterow and Bützow .",83,90,Güstrow,1,0,1
39KV3A5D188GCY04TJH2YNV8QXGS71,"The district of Güstrow was established in 1994 by merging the former districts of Güstrow , Teterow and Bützow .",93,100,Teterow,1,0,1
39KV3A5D188GCY04TJH2YNV8QXGS71,"The district of Güstrow was established in 1994 by merging the former districts of Güstrow , Teterow and Bützow .",105,111,Bützow,1,0,1
39KV3A5D188GCY04TJH2YNV8QXGS71,From 1621 to 1695 the present-day district was occupied by the small duchy of Mecklenburg-Güstrow .,22,33,present-day,2,2,4
39KV3A5D188GCY04TJH2YNV8QXGS71,From 1621 to 1695 the present-day district was occupied by the small duchy of Mecklenburg-Güstrow .,34,42,district,1,0,1
39KV3A5D188GCY04TJH2YNV8QXGS71,From 1621 to 1695 the present-day district was occupied by the small duchy of Mecklenburg-Güstrow .,47,55,occupied,3,2,5
39KV3A5D188GCY04TJH2YNV8QXGS71,From 1621 to 1695 the present-day district was occupied by the small duchy of Mecklenburg-Güstrow .,69,74,duchy,2,3,5
39KV3A5D188GCY04TJH2YNV8QXGS71,From 1621 to 1695 the present-day district was occupied by the small duchy of Mecklenburg-Güstrow .,78,97,Mecklenburg-Güstrow,1,0,1
39KV3A5D188GCY04TJH2YNV8QXGS71,"He was taken to a police station , where he would write a name : Kaspar Hauser .",18,32,police station,1,0,1
39KV3A5D188GCY04TJH2YNV8QXGS71,"He was taken to a police station , where he would write a name : Kaspar Hauser .",72,78,Hauser,1,0,1
39KV3A5D188GCY04TJH2YNV8QXGS71,"On such occasions , when he awakened , his straw was changed and his hair and nails were cut .",8,17,occasions,4,3,7
39KV3A5D188GCY04TJH2YNV8QXGS71,"On such occasions , when he awakened , his straw was changed and his hair and nails were cut .",28,36,awakened,6,8,14
39KV3A5D188GCY04TJH2YNV8QXGS71,"On such occasions , when he awakened , his straw was changed and his hair and nails were cut .",43,48,straw,4,9,13
39KV3A5D188GCY04TJH2YNV8QXGS71,"On such occasions , when he awakened , his straw was changed and his hair and nails were cut .",43,60,straw was changed,1,0,1
39KV3A5D188GCY04TJH2YNV8QXGS71,"On such occasions , when he awakened , his straw was changed and his hair and nails were cut .",78,83,nails,0,2,2
39KV3A5D188GCY04TJH2YNV8QXGS71,The letter stated that the boy would now like to be a cavalryman `` as his father was '' and invited the captain either to take him in or to hang him .,54,64,cavalryman,10,10,20
39KV3A5D188GCY04TJH2YNV8QXGS71,The letter stated that the boy would now like to be a cavalryman `` as his father was '' and invited the captain either to take him in or to hang him .,93,100,invited,1,2,3
39KV3A5D188GCY04TJH2YNV8QXGS71,The letter stated that the boy would now like to be a cavalryman `` as his father was '' and invited the captain either to take him in or to hang him .,138,145,to hang,0,1,1
39KV3A5D188GCY04TJH2YNV8QXGS71,The letter stated that the boy would now like to be a cavalryman `` as his father was '' and invited the captain either to take him in or to hang him .,141,145,hang,0,2,2
34D9ZRXCYRVYV0Y20MTM8EXYR5MSAS,"The skin is covered in chromatophores , which enable the squid to change color to suit its surroundings , making it practically invisible .",23,37,chromatophores,10,10,20
34D9ZRXCYRVYV0Y20MTM8EXYR5MSAS,"The skin is covered in chromatophores , which enable the squid to change color to suit its surroundings , making it practically invisible .",46,52,enable,1,2,3
34D9ZRXCYRVYV0Y20MTM8EXYR5MSAS,"The skin is covered in chromatophores , which enable the squid to change color to suit its surroundings , making it practically invisible .",57,62,squid,2,4,6
34D9ZRXCYRVYV0Y20MTM8EXYR5MSAS,"The skin is covered in chromatophores , which enable the squid to change color to suit its surroundings , making it practically invisible .",91,103,surroundings,1,4,5
34D9ZRXCYRVYV0Y20MTM8EXYR5MSAS,"The skin is covered in chromatophores , which enable the squid to change color to suit its surroundings , making it practically invisible .",116,127,practically,0,1,1
34D9ZRXCYRVYV0Y20MTM8EXYR5MSAS,"The skin is covered in chromatophores , which enable the squid to change color to suit its surroundings , making it practically invisible .",116,137,practically invisible,2,0,2
34D9ZRXCYRVYV0Y20MTM8EXYR5MSAS,"The skin is covered in chromatophores , which enable the squid to change color to suit its surroundings , making it practically invisible .",128,137,invisible,1,2,3
34D9ZRXCYRVYV0Y20MTM8EXYR5MSAS,"Squid , like cuttlefish , have eight arms arranged in pairs and two , usually longer , tentacles .",0,5,Squid,1,1,2
34D9ZRXCYRVYV0Y20MTM8EXYR5MSAS,"Squid , like cuttlefish , have eight arms arranged in pairs and two , usually longer , tentacles .",13,23,cuttlefish,4,5,9
34D9ZRXCYRVYV0Y20MTM8EXYR5MSAS,"Squid , like cuttlefish , have eight arms arranged in pairs and two , usually longer , tentacles .",42,50,arranged,0,4,4
34D9ZRXCYRVYV0Y20MTM8EXYR5MSAS,"Squid , like cuttlefish , have eight arms arranged in pairs and two , usually longer , tentacles .",87,96,tentacles,7,7,14
34D9ZRXCYRVYV0Y20MTM8EXYR5MSAS,The construction is of the Italian Renaissance style and was built in the late 17th century .,4,16,construction,0,1,1
34D9ZRXCYRVYV0Y20MTM8EXYR5MSAS,The construction is of the Italian Renaissance style and was built in the late 17th century .,27,46,Italian Renaissance,1,0,1
34D9ZRXCYRVYV0Y20MTM8EXYR5MSAS,The construction is of the Italian Renaissance style and was built in the late 17th century .,27,52,Italian Renaissance style,0,1,1
34D9ZRXCYRVYV0Y20MTM8EXYR5MSAS,The construction is of the Italian Renaissance style and was built in the late 17th century .,35,46,Renaissance,6,5,11
34D9ZRXCYRVYV0Y20MTM8EXYR5MSAS,The construction is of the Italian Renaissance style and was built in the late 17th century .,35,52,Renaissance style,1,0,1
34D9ZRXCYRVYV0Y20MTM8EXYR5MSAS,"Church of El Sagrario In colonial times , the Church of El Sagrario was one of the largest architectural marvels of Quito .",10,21,El Sagrario,1,0,1
34D9ZRXCYRVYV0Y20MTM8EXYR5MSAS,"Church of El Sagrario In colonial times , the Church of El Sagrario was one of the largest architectural marvels of Quito .",25,33,colonial,2,5,7
34D9ZRXCYRVYV0Y20MTM8EXYR5MSAS,"Church of El Sagrario In colonial times , the Church of El Sagrario was one of the largest architectural marvels of Quito .",25,39,colonial times,1,1,2
34D9ZRXCYRVYV0Y20MTM8EXYR5MSAS,"Church of El Sagrario In colonial times , the Church of El Sagrario was one of the largest architectural marvels of Quito .",91,104,architectural,6,4,10
34D9ZRXCYRVYV0Y20MTM8EXYR5MSAS,"Church of El Sagrario In colonial times , the Church of El Sagrario was one of the largest architectural marvels of Quito .",91,112,architectural marvels,2,0,2
34D9ZRXCYRVYV0Y20MTM8EXYR5MSAS,"Church of El Sagrario In colonial times , the Church of El Sagrario was one of the largest architectural marvels of Quito .",105,112,marvels,4,10,14
34D9ZRXCYRVYV0Y20MTM8EXYR5MSAS,"There are about 130 monumental buildings ( which hosts a variety of pictorial art and sculpture , mostly of religious inspired in a multi-faceted range of schools and styles ) and 5,000 properties registered in the municipal inventory of heritage properties .",20,30,monumental,4,6,10
34D9ZRXCYRVYV0Y20MTM8EXYR5MSAS,"There are about 130 monumental buildings ( which hosts a variety of pictorial art and sculpture , mostly of religious inspired in a multi-faceted range of schools and styles ) and 5,000 properties registered in the municipal inventory of heritage properties .",20,40,monumental buildings,1,1,2
34D9ZRXCYRVYV0Y20MTM8EXYR5MSAS,"There are about 130 monumental buildings ( which hosts a variety of pictorial art and sculpture , mostly of religious inspired in a multi-faceted range of schools and styles ) and 5,000 properties registered in the municipal inventory of heritage properties .",49,54,hosts,0,1,1
34D9ZRXCYRVYV0Y20MTM8EXYR5MSAS,"There are about 130 monumental buildings ( which hosts a variety of pictorial art and sculpture , mostly of religious inspired in a multi-faceted range of schools and styles ) and 5,000 properties registered in the municipal inventory of heritage properties .",68,77,pictorial,4,4,8
34D9ZRXCYRVYV0Y20MTM8EXYR5MSAS,"There are about 130 monumental buildings ( which hosts a variety of pictorial art and sculpture , mostly of religious inspired in a multi-faceted range of schools and styles ) and 5,000 properties registered in the municipal inventory of heritage properties .",68,81,pictorial art,1,2,3
34D9ZRXCYRVYV0Y20MTM8EXYR5MSAS,"There are about 130 monumental buildings ( which hosts a variety of pictorial art and sculpture , mostly of religious inspired in a multi-faceted range of schools and styles ) and 5,000 properties registered in the municipal inventory of heritage properties .",86,95,sculpture,0,2,2
34D9ZRXCYRVYV0Y20MTM8EXYR5MSAS,"There are about 130 monumental buildings ( which hosts a variety of pictorial art and sculpture , mostly of religious inspired in a multi-faceted range of schools and styles ) and 5,000 properties registered in the municipal inventory of heritage properties .",118,126,inspired,0,1,1
34D9ZRXCYRVYV0Y20MTM8EXYR5MSAS,"There are about 130 monumental buildings ( which hosts a variety of pictorial art and sculpture , mostly of religious inspired in a multi-faceted range of schools and styles ) and 5,000 properties registered in the municipal inventory of heritage properties .",132,145,multi-faceted,8,10,18
34D9ZRXCYRVYV0Y20MTM8EXYR5MSAS,"There are about 130 monumental buildings ( which hosts a variety of pictorial art and sculpture , mostly of religious inspired in a multi-faceted range of schools and styles ) and 5,000 properties registered in the municipal inventory of heritage properties .",215,224,municipal,5,0,5
34D9ZRXCYRVYV0Y20MTM8EXYR5MSAS,"There are about 130 monumental buildings ( which hosts a variety of pictorial art and sculpture , mostly of religious inspired in a multi-faceted range of schools and styles ) and 5,000 properties registered in the municipal inventory of heritage properties .",215,234,municipal inventory,1,2,3
34D9ZRXCYRVYV0Y20MTM8EXYR5MSAS,"There are about 130 monumental buildings ( which hosts a variety of pictorial art and sculpture , mostly of religious inspired in a multi-faceted range of schools and styles ) and 5,000 properties registered in the municipal inventory of heritage properties .",225,234,inventory,2,2,4
34D9ZRXCYRVYV0Y20MTM8EXYR5MSAS,"There are about 130 monumental buildings ( which hosts a variety of pictorial art and sculpture , mostly of religious inspired in a multi-faceted range of schools and styles ) and 5,000 properties registered in the municipal inventory of heritage properties .",238,246,heritage,5,10,15
34D9ZRXCYRVYV0Y20MTM8EXYR5MSAS,"There are about 130 monumental buildings ( which hosts a variety of pictorial art and sculpture , mostly of religious inspired in a multi-faceted range of schools and styles ) and 5,000 properties registered in the municipal inventory of heritage properties .",238,257,heritage properties,2,0,2
3GL25Y6843V7TITQRZPEGD9Q01DMXE,"He then moved to Europe , signing with the Manchester Phoenix in the summer of 2007 to play under Tony Hand .",8,13,moved,0,1,1
3GL25Y6843V7TITQRZPEGD9Q01DMXE,"He then moved to Europe , signing with the Manchester Phoenix in the summer of 2007 to play under Tony Hand .",17,23,Europe,0,1,1
3GL25Y6843V7TITQRZPEGD9Q01DMXE,"He then moved to Europe , signing with the Manchester Phoenix in the summer of 2007 to play under Tony Hand .",26,33,signing,3,3,6
3GL25Y6843V7TITQRZPEGD9Q01DMXE,"He then moved to Europe , signing with the Manchester Phoenix in the summer of 2007 to play under Tony Hand .",43,53,Manchester,0,1,1
3GL25Y6843V7TITQRZPEGD9Q01DMXE,"He then moved to Europe , signing with the Manchester Phoenix in the summer of 2007 to play under Tony Hand .",43,61,Manchester Phoenix,2,0,2
3GL25Y6843V7TITQRZPEGD9Q01DMXE,"He then moved to Europe , signing with the Manchester Phoenix in the summer of 2007 to play under Tony Hand .",54,61,Phoenix,2,0,2
3GL25Y6843V7TITQRZPEGD9Q01DMXE,On 7 May 2009 he left Hockey Club Pustertal-Val Pusteria and signed a contract with HC Eppan Pirats Internorm .,17,21,left,0,1,1
3GL25Y6843V7TITQRZPEGD9Q01DMXE,On 7 May 2009 he left Hockey Club Pustertal-Val Pusteria and signed a contract with HC Eppan Pirats Internorm .,22,56,Hockey Club Pustertal-Val Pusteria,1,0,1
3GL25Y6843V7TITQRZPEGD9Q01DMXE,On 7 May 2009 he left Hockey Club Pustertal-Val Pusteria and signed a contract with HC Eppan Pirats Internorm .,48,56,Pusteria,1,1,2
3GL25Y6843V7TITQRZPEGD9Q01DMXE,On 7 May 2009 he left Hockey Club Pustertal-Val Pusteria and signed a contract with HC Eppan Pirats Internorm .,61,67,signed,1,2,3
3GL25Y6843V7TITQRZPEGD9Q01DMXE,On 7 May 2009 he left Hockey Club Pustertal-Val Pusteria and signed a contract with HC Eppan Pirats Internorm .,70,78,contract,3,3,6
3GL25Y6843V7TITQRZPEGD9Q01DMXE,On 7 May 2009 he left Hockey Club Pustertal-Val Pusteria and signed a contract with HC Eppan Pirats Internorm .,84,109,HC Eppan Pirats Internorm,2,0,2
3GL25Y6843V7TITQRZPEGD9Q01DMXE,On 7 May 2009 he left Hockey Club Pustertal-Val Pusteria and signed a contract with HC Eppan Pirats Internorm .,87,92,Eppan,1,0,1
3GL25Y6843V7TITQRZPEGD9Q01DMXE,On 7 May 2009 he left Hockey Club Pustertal-Val Pusteria and signed a contract with HC Eppan Pirats Internorm .,93,109,Pirats Internorm,2,0,2
3GL25Y6843V7TITQRZPEGD9Q01DMXE,On 7 May 2009 he left Hockey Club Pustertal-Val Pusteria and signed a contract with HC Eppan Pirats Internorm .,100,109,Internorm,1,1,2
3GL25Y6843V7TITQRZPEGD9Q01DMXE,In April 2008 it was announced that Tallari would leave Manchester to sign for the Hockey Club Pustertal-Val Pusteria to try to qualify for the Italian national team .,21,30,announced,3,4,7
3GL25Y6843V7TITQRZPEGD9Q01DMXE,In April 2008 it was announced that Tallari would leave Manchester to sign for the Hockey Club Pustertal-Val Pusteria to try to qualify for the Italian national team .,70,74,sign,0,1,1
3GL25Y6843V7TITQRZPEGD9Q01DMXE,In April 2008 it was announced that Tallari would leave Manchester to sign for the Hockey Club Pustertal-Val Pusteria to try to qualify for the Italian national team .,95,108,Pustertal-Val,1,0,1
3GL25Y6843V7TITQRZPEGD9Q01DMXE,In April 2008 it was announced that Tallari would leave Manchester to sign for the Hockey Club Pustertal-Val Pusteria to try to qualify for the Italian national team .,125,135,to qualify,1,0,1
3GL25Y6843V7TITQRZPEGD9Q01DMXE,In April 2008 it was announced that Tallari would leave Manchester to sign for the Hockey Club Pustertal-Val Pusteria to try to qualify for the Italian national team .,128,135,qualify,7,5,12
3GL25Y6843V7TITQRZPEGD9Q01DMXE,"He stayed for just one season before moving to the Johnstown Chiefs of the ECHL , where he topped the 50 point margin .",3,9,stayed,0,2,2
3GL25Y6843V7TITQRZPEGD9Q01DMXE,"He stayed for just one season before moving to the Johnstown Chiefs of the ECHL , where he topped the 50 point margin .",23,29,season,2,0,2
3GL25Y6843V7TITQRZPEGD9Q01DMXE,"He stayed for just one season before moving to the Johnstown Chiefs of the ECHL , where he topped the 50 point margin .",61,67,Chiefs,1,0,1
3GL25Y6843V7TITQRZPEGD9Q01DMXE,"He stayed for just one season before moving to the Johnstown Chiefs of the ECHL , where he topped the 50 point margin .",91,97,topped,4,7,11
3GL25Y6843V7TITQRZPEGD9Q01DMXE,"He stayed for just one season before moving to the Johnstown Chiefs of the ECHL , where he topped the 50 point margin .",105,117,point margin,2,0,2
3GL25Y6843V7TITQRZPEGD9Q01DMXE,"He stayed for just one season before moving to the Johnstown Chiefs of the ECHL , where he topped the 50 point margin .",111,117,margin,3,5,8
3GL25Y6843V7TITQRZPEGD9Q01DMXE,"Over the following three seasons , Tallari switched between teams in the ECHL and the AHL , with stints at the Cleveland Barons , the Bridgeport Sound Tigers ( on two occasions ) and the Las Vegas Wranglers .",25,32,seasons,1,0,1
3GL25Y6843V7TITQRZPEGD9Q01DMXE,"Over the following three seasons , Tallari switched between teams in the ECHL and the AHL , with stints at the Cleveland Barons , the Bridgeport Sound Tigers ( on two occasions ) and the Las Vegas Wranglers .",35,42,Tallari,1,0,1
3GL25Y6843V7TITQRZPEGD9Q01DMXE,"Over the following three seasons , Tallari switched between teams in the ECHL and the AHL , with stints at the Cleveland Barons , the Bridgeport Sound Tigers ( on two occasions ) and the Las Vegas Wranglers .",43,51,switched,3,5,8
3GL25Y6843V7TITQRZPEGD9Q01DMXE,"Over the following three seasons , Tallari switched between teams in the ECHL and the AHL , with stints at the Cleveland Barons , the Bridgeport Sound Tigers ( on two occasions ) and the Las Vegas Wranglers .",43,65,switched between teams,1,0,1
3GL25Y6843V7TITQRZPEGD9Q01DMXE,"Over the following three seasons , Tallari switched between teams in the ECHL and the AHL , with stints at the Cleveland Barons , the Bridgeport Sound Tigers ( on two occasions ) and the Las Vegas Wranglers .",97,103,stints,4,8,12
3GL25Y6843V7TITQRZPEGD9Q01DMXE,"Over the following three seasons , Tallari switched between teams in the ECHL and the AHL , with stints at the Cleveland Barons , the Bridgeport Sound Tigers ( on two occasions ) and the Las Vegas Wranglers .",111,127,Cleveland Barons,0,1,1
3GL25Y6843V7TITQRZPEGD9Q01DMXE,"Over the following three seasons , Tallari switched between teams in the ECHL and the AHL , with stints at the Cleveland Barons , the Bridgeport Sound Tigers ( on two occasions ) and the Las Vegas Wranglers .",134,144,Bridgeport,0,1,1
3GL25Y6843V7TITQRZPEGD9Q01DMXE,"Over the following three seasons , Tallari switched between teams in the ECHL and the AHL , with stints at the Cleveland Barons , the Bridgeport Sound Tigers ( on two occasions ) and the Las Vegas Wranglers .",167,176,occasions,3,2,5
3GL25Y6843V7TITQRZPEGD9Q01DMXE,"Over the following three seasons , Tallari switched between teams in the ECHL and the AHL , with stints at the Cleveland Barons , the Bridgeport Sound Tigers ( on two occasions ) and the Las Vegas Wranglers .",187,206,Las Vegas Wranglers,0,1,1
3GL25Y6843V7TITQRZPEGD9Q01DMXE,"Over the following three seasons , Tallari switched between teams in the ECHL and the AHL , with stints at the Cleveland Barons , the Bridgeport Sound Tigers ( on two occasions ) and the Las Vegas Wranglers .",197,206,Wranglers,0,2,2
3L4YG5VW9NTQRIIWN6PZ3GJ4B59DDL,"Amongst the most controversial provisions was the establishment of a number of ` destination casinos ' in the style of Las Vegas , commonly referred to in the media as ` super casinos ' Initial drafts of the act proposed eight regional casinos but concerns expressed in the national media and by a range of addiction related social and religious groups meant that the final revision of the act permitted only one casino of the largest size , referred to as a ` regional casino ' , with a further eight ` large ' and eight ` small ' casinos of a smaller sizes and with reduced jackpot limits .",0,7,Amongst,4,2,6
3L4YG5VW9NTQRIIWN6PZ3GJ4B59DDL,"Amongst the most controversial provisions was the establishment of a number of ` destination casinos ' in the style of Las Vegas , commonly referred to in the media as ` super casinos ' Initial drafts of the act proposed eight regional casinos but concerns expressed in the national media and by a range of addiction related social and religious groups meant that the final revision of the act permitted only one casino of the largest size , referred to as a ` regional casino ' , with a further eight ` large ' and eight ` small ' casinos of a smaller sizes and with reduced jackpot limits .",17,30,controversial,10,10,20
3L4YG5VW9NTQRIIWN6PZ3GJ4B59DDL,"Amongst the most controversial provisions was the establishment of a number of ` destination casinos ' in the style of Las Vegas , commonly referred to in the media as ` super casinos ' Initial drafts of the act proposed eight regional casinos but concerns expressed in the national media and by a range of addiction related social and religious groups meant that the final revision of the act permitted only one casino of the largest size , referred to as a ` regional casino ' , with a further eight ` large ' and eight ` small ' casinos of a smaller sizes and with reduced jackpot limits .",17,41,controversial provisions,2,2,4
3L4YG5VW9NTQRIIWN6PZ3GJ4B59DDL,"Amongst the most controversial provisions was the establishment of a number of ` destination casinos ' in the style of Las Vegas , commonly referred to in the media as ` super casinos ' Initial drafts of the act proposed eight regional casinos but concerns expressed in the national media and by a range of addiction related social and religious groups meant that the final revision of the act permitted only one casino of the largest size , referred to as a ` regional casino ' , with a further eight ` large ' and eight ` small ' casinos of a smaller sizes and with reduced jackpot limits .",31,41,provisions,7,8,15
3L4YG5VW9NTQRIIWN6PZ3GJ4B59DDL,"Amongst the most controversial provisions was the establishment of a number of ` destination casinos ' in the style of Las Vegas , commonly referred to in the media as ` super casinos ' Initial drafts of the act proposed eight regional casinos but concerns expressed in the national media and by a range of addiction related social and religious groups meant that the final revision of the act permitted only one casino of the largest size , referred to as a ` regional casino ' , with a further eight ` large ' and eight ` small ' casinos of a smaller sizes and with reduced jackpot limits .",50,63,establishment,6,6,12
3L4YG5VW9NTQRIIWN6PZ3GJ4B59DDL,"Amongst the most controversial provisions was the establishment of a number of ` destination casinos ' in the style of Las Vegas , commonly referred to in the media as ` super casinos ' Initial drafts of the act proposed eight regional casinos but concerns expressed in the national media and by a range of addiction related social and religious groups meant that the final revision of the act permitted only one casino of the largest size , referred to as a ` regional casino ' , with a further eight ` large ' and eight ` small ' casinos of a smaller sizes and with reduced jackpot limits .",81,92,destination,3,2,5
3L4YG5VW9NTQRIIWN6PZ3GJ4B59DDL,"Amongst the most controversial provisions was the establishment of a number of ` destination casinos ' in the style of Las Vegas , commonly referred to in the media as ` super casinos ' Initial drafts of the act proposed eight regional casinos but concerns expressed in the national media and by a range of addiction related social and religious groups meant that the final revision of the act permitted only one casino of the largest size , referred to as a ` regional casino ' , with a further eight ` large ' and eight ` small ' casinos of a smaller sizes and with reduced jackpot limits .",81,100,destination casinos,2,4,6
3L4YG5VW9NTQRIIWN6PZ3GJ4B59DDL,"Amongst the most controversial provisions was the establishment of a number of ` destination casinos ' in the style of Las Vegas , commonly referred to in the media as ` super casinos ' Initial drafts of the act proposed eight regional casinos but concerns expressed in the national media and by a range of addiction related social and religious groups meant that the final revision of the act permitted only one casino of the largest size , referred to as a ` regional casino ' , with a further eight ` large ' and eight ` small ' casinos of a smaller sizes and with reduced jackpot limits .",93,100,casinos,0,1,1
3L4YG5VW9NTQRIIWN6PZ3GJ4B59DDL,"Amongst the most controversial provisions was the establishment of a number of ` destination casinos ' in the style of Las Vegas , commonly referred to in the media as ` super casinos ' Initial drafts of the act proposed eight regional casinos but concerns expressed in the national media and by a range of addiction related social and religious groups meant that the final revision of the act permitted only one casino of the largest size , referred to as a ` regional casino ' , with a further eight ` large ' and eight ` small ' casinos of a smaller sizes and with reduced jackpot limits .",119,128,Las Vegas,0,1,1
3L4YG5VW9NTQRIIWN6PZ3GJ4B59DDL,"Amongst the most controversial provisions was the establishment of a number of ` destination casinos ' in the style of Las Vegas , commonly referred to in the media as ` super casinos ' Initial drafts of the act proposed eight regional casinos but concerns expressed in the national media and by a range of addiction related social and religious groups meant that the final revision of the act permitted only one casino of the largest size , referred to as a ` regional casino ' , with a further eight ` large ' and eight ` small ' casinos of a smaller sizes and with reduced jackpot limits .",140,148,referred,1,1,2
3L4YG5VW9NTQRIIWN6PZ3GJ4B59DDL,"Amongst the most controversial provisions was the establishment of a number of ` destination casinos ' in the style of Las Vegas , commonly referred to in the media as ` super casinos ' Initial drafts of the act proposed eight regional casinos but concerns expressed in the national media and by a range of addiction related social and religious groups meant that the final revision of the act permitted only one casino of the largest size , referred to as a ` regional casino ' , with a further eight ` large ' and eight ` small ' casinos of a smaller sizes and with reduced jackpot limits .",159,164,media,1,0,1
3L4YG5VW9NTQRIIWN6PZ3GJ4B59DDL,"Amongst the most controversial provisions was the establishment of a number of ` destination casinos ' in the style of Las Vegas , commonly referred to in the media as ` super casinos ' Initial drafts of the act proposed eight regional casinos but concerns expressed in the national media and by a range of addiction related social and religious groups meant that the final revision of the act permitted only one casino of the largest size , referred to as a ` regional casino ' , with a further eight ` large ' and eight ` small ' casinos of a smaller sizes and with reduced jackpot limits .",186,193,Initial,2,0,2
3L4YG5VW9NTQRIIWN6PZ3GJ4B59DDL,"Amongst the most controversial provisions was the establishment of a number of ` destination casinos ' in the style of Las Vegas , commonly referred to in the media as ` super casinos ' Initial drafts of the act proposed eight regional casinos but concerns expressed in the national media and by a range of addiction related social and religious groups meant that the final revision of the act permitted only one casino of the largest size , referred to as a ` regional casino ' , with a further eight ` large ' and eight ` small ' casinos of a smaller sizes and with reduced jackpot limits .",186,200,Initial drafts,1,0,1
3L4YG5VW9NTQRIIWN6PZ3GJ4B59DDL,"Amongst the most controversial provisions was the establishment of a number of ` destination casinos ' in the style of Las Vegas , commonly referred to in the media as ` super casinos ' Initial drafts of the act proposed eight regional casinos but concerns expressed in the national media and by a range of addiction related social and religious groups meant that the final revision of the act permitted only one casino of the largest size , referred to as a ` regional casino ' , with a further eight ` large ' and eight ` small ' casinos of a smaller sizes and with reduced jackpot limits .",194,200,drafts,2,5,7
3L4YG5VW9NTQRIIWN6PZ3GJ4B59DDL,"Amongst the most controversial provisions was the establishment of a number of ` destination casinos ' in the style of Las Vegas , commonly referred to in the media as ` super casinos ' Initial drafts of the act proposed eight regional casinos but concerns expressed in the national media and by a range of addiction related social and religious groups meant that the final revision of the act permitted only one casino of the largest size , referred to as a ` regional casino ' , with a further eight ` large ' and eight ` small ' casinos of a smaller sizes and with reduced jackpot limits .",212,220,proposed,5,1,6
3L4YG5VW9NTQRIIWN6PZ3GJ4B59DDL,"Amongst the most controversial provisions was the establishment of a number of ` destination casinos ' in the style of Las Vegas , commonly referred to in the media as ` super casinos ' Initial drafts of the act proposed eight regional casinos but concerns expressed in the national media and by a range of addiction related social and religious groups meant that the final revision of the act permitted only one casino of the largest size , referred to as a ` regional casino ' , with a further eight ` large ' and eight ` small ' casinos of a smaller sizes and with reduced jackpot limits .",227,235,regional,2,0,2
3L4YG5VW9NTQRIIWN6PZ3GJ4B59DDL,"Amongst the most controversial provisions was the establishment of a number of ` destination casinos ' in the style of Las Vegas , commonly referred to in the media as ` super casinos ' Initial drafts of the act proposed eight regional casinos but concerns expressed in the national media and by a range of addiction related social and religious groups meant that the final revision of the act permitted only one casino of the largest size , referred to as a ` regional casino ' , with a further eight ` large ' and eight ` small ' casinos of a smaller sizes and with reduced jackpot limits .",248,256,concerns,0,3,3
3L4YG5VW9NTQRIIWN6PZ3GJ4B59DDL,"Amongst the most controversial provisions was the establishment of a number of ` destination casinos ' in the style of Las Vegas , commonly referred to in the media as ` super casinos ' Initial drafts of the act proposed eight regional casinos but concerns expressed in the national media and by a range of addiction related social and religious groups meant that the final revision of the act permitted only one casino of the largest size , referred to as a ` regional casino ' , with a further eight ` large ' and eight ` small ' casinos of a smaller sizes and with reduced jackpot limits .",248,266,concerns expressed,0,1,1
3L4YG5VW9NTQRIIWN6PZ3GJ4B59DDL,"Amongst the most controversial provisions was the establishment of a number of ` destination casinos ' in the style of Las Vegas , commonly referred to in the media as ` super casinos ' Initial drafts of the act proposed eight regional casinos but concerns expressed in the national media and by a range of addiction related social and religious groups meant that the final revision of the act permitted only one casino of the largest size , referred to as a ` regional casino ' , with a further eight ` large ' and eight ` small ' casinos of a smaller sizes and with reduced jackpot limits .",257,266,expressed,0,2,2
3L4YG5VW9NTQRIIWN6PZ3GJ4B59DDL,"Amongst the most controversial provisions was the establishment of a number of ` destination casinos ' in the style of Las Vegas , commonly referred to in the media as ` super casinos ' Initial drafts of the act proposed eight regional casinos but concerns expressed in the national media and by a range of addiction related social and religious groups meant that the final revision of the act permitted only one casino of the largest size , referred to as a ` regional casino ' , with a further eight ` large ' and eight ` small ' casinos of a smaller sizes and with reduced jackpot limits .",274,288,national media,1,0,1
3L4YG5VW9NTQRIIWN6PZ3GJ4B59DDL,"Amongst the most controversial provisions was the establishment of a number of ` destination casinos ' in the style of Las Vegas , commonly referred to in the media as ` super casinos ' Initial drafts of the act proposed eight regional casinos but concerns expressed in the national media and by a range of addiction related social and religious groups meant that the final revision of the act permitted only one casino of the largest size , referred to as a ` regional casino ' , with a further eight ` large ' and eight ` small ' casinos of a smaller sizes and with reduced jackpot limits .",298,303,range,0,3,3
3L4YG5VW9NTQRIIWN6PZ3GJ4B59DDL,"Amongst the most controversial provisions was the establishment of a number of ` destination casinos ' in the style of Las Vegas , commonly referred to in the media as ` super casinos ' Initial drafts of the act proposed eight regional casinos but concerns expressed in the national media and by a range of addiction related social and religious groups meant that the final revision of the act permitted only one casino of the largest size , referred to as a ` regional casino ' , with a further eight ` large ' and eight ` small ' casinos of a smaller sizes and with reduced jackpot limits .",307,316,addiction,5,4,9
3L4YG5VW9NTQRIIWN6PZ3GJ4B59DDL,"Amongst the most controversial provisions was the establishment of a number of ` destination casinos ' in the style of Las Vegas , commonly referred to in the media as ` super casinos ' Initial drafts of the act proposed eight regional casinos but concerns expressed in the national media and by a range of addiction related social and religious groups meant that the final revision of the act permitted only one casino of the largest size , referred to as a ` regional casino ' , with a further eight ` large ' and eight ` small ' casinos of a smaller sizes and with reduced jackpot limits .",336,345,religious,1,0,1
3L4YG5VW9NTQRIIWN6PZ3GJ4B59DDL,"Amongst the most controversial provisions was the establishment of a number of ` destination casinos ' in the style of Las Vegas , commonly referred to in the media as ` super casinos ' Initial drafts of the act proposed eight regional casinos but concerns expressed in the national media and by a range of addiction related social and religious groups meant that the final revision of the act permitted only one casino of the largest size , referred to as a ` regional casino ' , with a further eight ` large ' and eight ` small ' casinos of a smaller sizes and with reduced jackpot limits .",353,358,meant,0,2,2
3L4YG5VW9NTQRIIWN6PZ3GJ4B59DDL,"Amongst the most controversial provisions was the establishment of a number of ` destination casinos ' in the style of Las Vegas , commonly referred to in the media as ` super casinos ' Initial drafts of the act proposed eight regional casinos but concerns expressed in the national media and by a range of addiction related social and religious groups meant that the final revision of the act permitted only one casino of the largest size , referred to as a ` regional casino ' , with a further eight ` large ' and eight ` small ' casinos of a smaller sizes and with reduced jackpot limits .",368,382,final revision,1,2,3
3L4YG5VW9NTQRIIWN6PZ3GJ4B59DDL,"Amongst the most controversial provisions was the establishment of a number of ` destination casinos ' in the style of Las Vegas , commonly referred to in the media as ` super casinos ' Initial drafts of the act proposed eight regional casinos but concerns expressed in the national media and by a range of addiction related social and religious groups meant that the final revision of the act permitted only one casino of the largest size , referred to as a ` regional casino ' , with a further eight ` large ' and eight ` small ' casinos of a smaller sizes and with reduced jackpot limits .",374,382,revision,5,5,10
3L4YG5VW9NTQRIIWN6PZ3GJ4B59DDL,"Amongst the most controversial provisions was the establishment of a number of ` destination casinos ' in the style of Las Vegas , commonly referred to in the media as ` super casinos ' Initial drafts of the act proposed eight regional casinos but concerns expressed in the national media and by a range of addiction related social and religious groups meant that the final revision of the act permitted only one casino of the largest size , referred to as a ` regional casino ' , with a further eight ` large ' and eight ` small ' casinos of a smaller sizes and with reduced jackpot limits .",394,403,permitted,4,1,5
3L4YG5VW9NTQRIIWN6PZ3GJ4B59DDL,"Amongst the most controversial provisions was the establishment of a number of ` destination casinos ' in the style of Las Vegas , commonly referred to in the media as ` super casinos ' Initial drafts of the act proposed eight regional casinos but concerns expressed in the national media and by a range of addiction related social and religious groups meant that the final revision of the act permitted only one casino of the largest size , referred to as a ` regional casino ' , with a further eight ` large ' and eight ` small ' casinos of a smaller sizes and with reduced jackpot limits .",442,450,referred,0,1,1
3L4YG5VW9NTQRIIWN6PZ3GJ4B59DDL,"Amongst the most controversial provisions was the establishment of a number of ` destination casinos ' in the style of Las Vegas , commonly referred to in the media as ` super casinos ' Initial drafts of the act proposed eight regional casinos but concerns expressed in the national media and by a range of addiction related social and religious groups meant that the final revision of the act permitted only one casino of the largest size , referred to as a ` regional casino ' , with a further eight ` large ' and eight ` small ' casinos of a smaller sizes and with reduced jackpot limits .",461,469,regional,0,1,1
3L4YG5VW9NTQRIIWN6PZ3GJ4B59DDL,"Amongst the most controversial provisions was the establishment of a number of ` destination casinos ' in the style of Las Vegas , commonly referred to in the media as ` super casinos ' Initial drafts of the act proposed eight regional casinos but concerns expressed in the national media and by a range of addiction related social and religious groups meant that the final revision of the act permitted only one casino of the largest size , referred to as a ` regional casino ' , with a further eight ` large ' and eight ` small ' casinos of a smaller sizes and with reduced jackpot limits .",461,476,regional casino,0,1,1
3L4YG5VW9NTQRIIWN6PZ3GJ4B59DDL,"Amongst the most controversial provisions was the establishment of a number of ` destination casinos ' in the style of Las Vegas , commonly referred to in the media as ` super casinos ' Initial drafts of the act proposed eight regional casinos but concerns expressed in the national media and by a range of addiction related social and religious groups meant that the final revision of the act permitted only one casino of the largest size , referred to as a ` regional casino ' , with a further eight ` large ' and eight ` small ' casinos of a smaller sizes and with reduced jackpot limits .",568,590,reduced jackpot limits,1,1,2
3L4YG5VW9NTQRIIWN6PZ3GJ4B59DDL,"Amongst the most controversial provisions was the establishment of a number of ` destination casinos ' in the style of Las Vegas , commonly referred to in the media as ` super casinos ' Initial drafts of the act proposed eight regional casinos but concerns expressed in the national media and by a range of addiction related social and religious groups meant that the final revision of the act permitted only one casino of the largest size , referred to as a ` regional casino ' , with a further eight ` large ' and eight ` small ' casinos of a smaller sizes and with reduced jackpot limits .",576,583,jackpot,2,7,9
3L4YG5VW9NTQRIIWN6PZ3GJ4B59DDL,"Amongst the most controversial provisions was the establishment of a number of ` destination casinos ' in the style of Las Vegas , commonly referred to in the media as ` super casinos ' Initial drafts of the act proposed eight regional casinos but concerns expressed in the national media and by a range of addiction related social and religious groups meant that the final revision of the act permitted only one casino of the largest size , referred to as a ` regional casino ' , with a further eight ` large ' and eight ` small ' casinos of a smaller sizes and with reduced jackpot limits .",576,590,jackpot limits,0,1,1
3L4YG5VW9NTQRIIWN6PZ3GJ4B59DDL,"In May 2006 , a short-list of eight sites , selected from various ones submitted by local councils , was announced for the location of the regional casino .",16,26,short-list,1,4,5
3L4YG5VW9NTQRIIWN6PZ3GJ4B59DDL,"In May 2006 , a short-list of eight sites , selected from various ones submitted by local councils , was announced for the location of the regional casino .",58,65,various,1,0,1
3L4YG5VW9NTQRIIWN6PZ3GJ4B59DDL,"In May 2006 , a short-list of eight sites , selected from various ones submitted by local councils , was announced for the location of the regional casino .",71,80,submitted,1,2,3
3L4YG5VW9NTQRIIWN6PZ3GJ4B59DDL,"In May 2006 , a short-list of eight sites , selected from various ones submitted by local councils , was announced for the location of the regional casino .",84,98,local councils,1,1,2
3L4YG5VW9NTQRIIWN6PZ3GJ4B59DDL,"In May 2006 , a short-list of eight sites , selected from various ones submitted by local councils , was announced for the location of the regional casino .",90,98,councils,3,2,5
3L4YG5VW9NTQRIIWN6PZ3GJ4B59DDL,"In May 2006 , a short-list of eight sites , selected from various ones submitted by local councils , was announced for the location of the regional casino .",105,114,announced,1,1,2
3L4YG5VW9NTQRIIWN6PZ3GJ4B59DDL,"In May 2006 , a short-list of eight sites , selected from various ones submitted by local councils , was announced for the location of the regional casino .",139,147,regional,0,1,1
34HEO7RUG6VMULYPLXTHI4S2533ARM,The Screen Actors Guild Award ( also known as the SAG Award ) is an accolade given by the Screen Actors Guild‐American Federation of Television and Radio Artists ( SAG-AFTRA ) to recognize outstanding performances in film and primetime television .,4,29,Screen Actors Guild Award,1,0,1
34HEO7RUG6VMULYPLXTHI4S2533ARM,The Screen Actors Guild Award ( also known as the SAG Award ) is an accolade given by the Screen Actors Guild‐American Federation of Television and Radio Artists ( SAG-AFTRA ) to recognize outstanding performances in film and primetime television .,18,23,Guild,1,4,5
34HEO7RUG6VMULYPLXTHI4S2533ARM,The Screen Actors Guild Award ( also known as the SAG Award ) is an accolade given by the Screen Actors Guild‐American Federation of Television and Radio Artists ( SAG-AFTRA ) to recognize outstanding performances in film and primetime television .,18,29,Guild Award,0,1,1
34HEO7RUG6VMULYPLXTHI4S2533ARM,The Screen Actors Guild Award ( also known as the SAG Award ) is an accolade given by the Screen Actors Guild‐American Federation of Television and Radio Artists ( SAG-AFTRA ) to recognize outstanding performances in film and primetime television .,50,59,SAG Award,0,1,1
34HEO7RUG6VMULYPLXTHI4S2533ARM,The Screen Actors Guild Award ( also known as the SAG Award ) is an accolade given by the Screen Actors Guild‐American Federation of Television and Radio Artists ( SAG-AFTRA ) to recognize outstanding performances in film and primetime television .,68,76,accolade,10,10,20
34HEO7RUG6VMULYPLXTHI4S2533ARM,The Screen Actors Guild Award ( also known as the SAG Award ) is an accolade given by the Screen Actors Guild‐American Federation of Television and Radio Artists ( SAG-AFTRA ) to recognize outstanding performances in film and primetime television .,104,118,Guild‐American,1,0,1
34HEO7RUG6VMULYPLXTHI4S2533ARM,The Screen Actors Guild Award ( also known as the SAG Award ) is an accolade given by the Screen Actors Guild‐American Federation of Television and Radio Artists ( SAG-AFTRA ) to recognize outstanding performances in film and primetime television .,119,129,Federation,3,2,5
34HEO7RUG6VMULYPLXTHI4S2533ARM,The Screen Actors Guild Award ( also known as the SAG Award ) is an accolade given by the Screen Actors Guild‐American Federation of Television and Radio Artists ( SAG-AFTRA ) to recognize outstanding performances in film and primetime television .,164,173,SAG-AFTRA,0,1,1
34HEO7RUG6VMULYPLXTHI4S2533ARM,The Screen Actors Guild Award ( also known as the SAG Award ) is an accolade given by the Screen Actors Guild‐American Federation of Television and Radio Artists ( SAG-AFTRA ) to recognize outstanding performances in film and primetime television .,179,188,recognize,1,1,2
34HEO7RUG6VMULYPLXTHI4S2533ARM,The Screen Actors Guild Award ( also known as the SAG Award ) is an accolade given by the Screen Actors Guild‐American Federation of Television and Radio Artists ( SAG-AFTRA ) to recognize outstanding performances in film and primetime television .,189,200,outstanding,1,7,8
34HEO7RUG6VMULYPLXTHI4S2533ARM,The Screen Actors Guild Award ( also known as the SAG Award ) is an accolade given by the Screen Actors Guild‐American Federation of Television and Radio Artists ( SAG-AFTRA ) to recognize outstanding performances in film and primetime television .,189,213,outstanding performances,0,1,1
34HEO7RUG6VMULYPLXTHI4S2533ARM,The Screen Actors Guild Award ( also known as the SAG Award ) is an accolade given by the Screen Actors Guild‐American Federation of Television and Radio Artists ( SAG-AFTRA ) to recognize outstanding performances in film and primetime television .,226,235,primetime,6,10,16
34HEO7RUG6VMULYPLXTHI4S2533ARM,The Screen Actors Guild Award ( also known as the SAG Award ) is an accolade given by the Screen Actors Guild‐American Federation of Television and Radio Artists ( SAG-AFTRA ) to recognize outstanding performances in film and primetime television .,226,246,primetime television,0,1,1
34HEO7RUG6VMULYPLXTHI4S2533ARM,"Nominations for the awards come from two committees , one for film and one for television , each numbering 2100 members of the union , randomly selected anew each year , with the full membership ( 165,000 as of 2012 ) available to vote for the winners .",0,11,Nominations,6,5,11
34HEO7RUG6VMULYPLXTHI4S2533ARM,"Nominations for the awards come from two committees , one for film and one for television , each numbering 2100 members of the union , randomly selected anew each year , with the full membership ( 165,000 as of 2012 ) available to vote for the winners .",41,51,committees,5,2,7
34HEO7RUG6VMULYPLXTHI4S2533ARM,"Nominations for the awards come from two committees , one for film and one for television , each numbering 2100 members of the union , randomly selected anew each year , with the full membership ( 165,000 as of 2012 ) available to vote for the winners .",97,106,numbering,0,1,1
34HEO7RUG6VMULYPLXTHI4S2533ARM,"Nominations for the awards come from two committees , one for film and one for television , each numbering 2100 members of the union , randomly selected anew each year , with the full membership ( 165,000 as of 2012 ) available to vote for the winners .",127,132,union,1,1,2
34HEO7RUG6VMULYPLXTHI4S2533ARM,"Nominations for the awards come from two committees , one for film and one for television , each numbering 2100 members of the union , randomly selected anew each year , with the full membership ( 165,000 as of 2012 ) available to vote for the winners .",135,143,randomly,3,9,12
34HEO7RUG6VMULYPLXTHI4S2533ARM,"Nominations for the awards come from two committees , one for film and one for television , each numbering 2100 members of the union , randomly selected anew each year , with the full membership ( 165,000 as of 2012 ) available to vote for the winners .",135,152,randomly selected,0,1,1
34HEO7RUG6VMULYPLXTHI4S2533ARM,"Nominations for the awards come from two committees , one for film and one for television , each numbering 2100 members of the union , randomly selected anew each year , with the full membership ( 165,000 as of 2012 ) available to vote for the winners .",153,157,anew,5,6,11
34HEO7RUG6VMULYPLXTHI4S2533ARM,"Nominations for the awards come from two committees , one for film and one for television , each numbering 2100 members of the union , randomly selected anew each year , with the full membership ( 165,000 as of 2012 ) available to vote for the winners .",184,194,membership,0,1,1
34HEO7RUG6VMULYPLXTHI4S2533ARM,"Nominations for the awards come from two committees , one for film and one for television , each numbering 2100 members of the union , randomly selected anew each year , with the full membership ( 165,000 as of 2012 ) available to vote for the winners .",244,251,winners,0,1,1
34HEO7RUG6VMULYPLXTHI4S2533ARM,"In 1708 , Peter the Great gave the estate to his wife , the future Empress Catherine I , as a present .",35,41,estate,2,3,5
34HEO7RUG6VMULYPLXTHI4S2533ARM,"In 1708 , Peter the Great gave the estate to his wife , the future Empress Catherine I , as a present .",67,74,Empress,3,2,5
34HEO7RUG6VMULYPLXTHI4S2533ARM,"In 1708 , Peter the Great gave the estate to his wife , the future Empress Catherine I , as a present .",75,84,Catherine,0,1,1
34HEO7RUG6VMULYPLXTHI4S2533ARM,It was Catherine I who started to develop the place as a royal country residence .,34,41,develop,0,1,1
34HEO7RUG6VMULYPLXTHI4S2533ARM,It was Catherine I who started to develop the place as a royal country residence .,57,62,royal,1,4,5
34HEO7RUG6VMULYPLXTHI4S2533ARM,It was Catherine I who started to develop the place as a royal country residence .,57,80,royal country residence,2,1,3
34HEO7RUG6VMULYPLXTHI4S2533ARM,It was Catherine I who started to develop the place as a royal country residence .,71,80,residence,3,2,5
3UY4PIS8QRM5LZTXW7J7YJUP0C8N1N,"At a distance of about 6.5 light years , the nearest known brown dwarf is Luhman 16 , a binary system of brown dwarfs discovered in 2013 .",27,38,light years,3,1,4
3UY4PIS8QRM5LZTXW7J7YJUP0C8N1N,"At a distance of about 6.5 light years , the nearest known brown dwarf is Luhman 16 , a binary system of brown dwarfs discovered in 2013 .",59,70,brown dwarf,2,2,4
3UY4PIS8QRM5LZTXW7J7YJUP0C8N1N,"At a distance of about 6.5 light years , the nearest known brown dwarf is Luhman 16 , a binary system of brown dwarfs discovered in 2013 .",65,70,dwarf,4,10,14
3UY4PIS8QRM5LZTXW7J7YJUP0C8N1N,"At a distance of about 6.5 light years , the nearest known brown dwarf is Luhman 16 , a binary system of brown dwarfs discovered in 2013 .",74,80,Luhman,1,0,1
3UY4PIS8QRM5LZTXW7J7YJUP0C8N1N,"At a distance of about 6.5 light years , the nearest known brown dwarf is Luhman 16 , a binary system of brown dwarfs discovered in 2013 .",88,94,binary,4,2,6
3UY4PIS8QRM5LZTXW7J7YJUP0C8N1N,"At a distance of about 6.5 light years , the nearest known brown dwarf is Luhman 16 , a binary system of brown dwarfs discovered in 2013 .",88,101,binary system,4,3,7
3UY4PIS8QRM5LZTXW7J7YJUP0C8N1N,"At a distance of about 6.5 light years , the nearest known brown dwarf is Luhman 16 , a binary system of brown dwarfs discovered in 2013 .",111,117,dwarfs,0,1,1
3UY4PIS8QRM5LZTXW7J7YJUP0C8N1N,"In other words , the detection of lithium in the atmosphere of a candidate object ensures that , as long as it is older than the relatively young age of 100 Myr , it is a brown dwarf .",21,30,detection,5,2,7
3UY4PIS8QRM5LZTXW7J7YJUP0C8N1N,"In other words , the detection of lithium in the atmosphere of a candidate object ensures that , as long as it is older than the relatively young age of 100 Myr , it is a brown dwarf .",21,41,detection of lithium,1,0,1
3UY4PIS8QRM5LZTXW7J7YJUP0C8N1N,"In other words , the detection of lithium in the atmosphere of a candidate object ensures that , as long as it is older than the relatively young age of 100 Myr , it is a brown dwarf .",34,41,lithium,8,2,10
3UY4PIS8QRM5LZTXW7J7YJUP0C8N1N,"In other words , the detection of lithium in the atmosphere of a candidate object ensures that , as long as it is older than the relatively young age of 100 Myr , it is a brown dwarf .",49,59,atmosphere,6,1,7
3UY4PIS8QRM5LZTXW7J7YJUP0C8N1N,"In other words , the detection of lithium in the atmosphere of a candidate object ensures that , as long as it is older than the relatively young age of 100 Myr , it is a brown dwarf .",65,74,candidate,2,1,3
3UY4PIS8QRM5LZTXW7J7YJUP0C8N1N,"In other words , the detection of lithium in the atmosphere of a candidate object ensures that , as long as it is older than the relatively young age of 100 Myr , it is a brown dwarf .",65,81,candidate object,3,1,4
3UY4PIS8QRM5LZTXW7J7YJUP0C8N1N,"In other words , the detection of lithium in the atmosphere of a candidate object ensures that , as long as it is older than the relatively young age of 100 Myr , it is a brown dwarf .",82,89,ensures,2,3,5
3UY4PIS8QRM5LZTXW7J7YJUP0C8N1N,"In other words , the detection of lithium in the atmosphere of a candidate object ensures that , as long as it is older than the relatively young age of 100 Myr , it is a brown dwarf .",129,139,relatively,2,2,4
3UY4PIS8QRM5LZTXW7J7YJUP0C8N1N,"In other words , the detection of lithium in the atmosphere of a candidate object ensures that , as long as it is older than the relatively young age of 100 Myr , it is a brown dwarf .",157,160,Myr,1,1,2
3UY4PIS8QRM5LZTXW7J7YJUP0C8N1N,"In other words , the detection of lithium in the atmosphere of a candidate object ensures that , as long as it is older than the relatively young age of 100 Myr , it is a brown dwarf .",177,182,dwarf,0,1,1
3UY4PIS8QRM5LZTXW7J7YJUP0C8N1N,"The most notable of these objects was the latter , which was found to have a temperature and luminosity well below the stellar range .",9,16,notable,3,2,5
3UY4PIS8QRM5LZTXW7J7YJUP0C8N1N,"The most notable of these objects was the latter , which was found to have a temperature and luminosity well below the stellar range .",42,48,latter,1,3,4
3UY4PIS8QRM5LZTXW7J7YJUP0C8N1N,"The most notable of these objects was the latter , which was found to have a temperature and luminosity well below the stellar range .",77,88,temperature,1,1,2
3UY4PIS8QRM5LZTXW7J7YJUP0C8N1N,"The most notable of these objects was the latter , which was found to have a temperature and luminosity well below the stellar range .",77,103,temperature and luminosity,1,0,1
3UY4PIS8QRM5LZTXW7J7YJUP0C8N1N,"The most notable of these objects was the latter , which was found to have a temperature and luminosity well below the stellar range .",93,103,luminosity,10,10,20
3UY4PIS8QRM5LZTXW7J7YJUP0C8N1N,"The most notable of these objects was the latter , which was found to have a temperature and luminosity well below the stellar range .",119,126,stellar,7,4,11
3UY4PIS8QRM5LZTXW7J7YJUP0C8N1N,"The most notable of these objects was the latter , which was found to have a temperature and luminosity well below the stellar range .",119,132,stellar range,3,4,7
3UY4PIS8QRM5LZTXW7J7YJUP0C8N1N,"The most notable of these objects was the latter , which was found to have a temperature and luminosity well below the stellar range .",127,132,range,0,2,2
3UY4PIS8QRM5LZTXW7J7YJUP0C8N1N,"About a Girl is a Canadian comedy series which premiered on October 5 , 2007 on The N in the U.S. and Global in Canada .",18,26,Canadian,2,0,2
3UY4PIS8QRM5LZTXW7J7YJUP0C8N1N,"About a Girl is a Canadian comedy series which premiered on October 5 , 2007 on The N in the U.S. and Global in Canada .",47,56,premiered,3,5,8
3UY4PIS8QRM5LZTXW7J7YJUP0C8N1N,It was the first scripted comedy for The N. The series ended with 13 episodes in its only season .,11,32,first scripted comedy,0,1,1
3UY4PIS8QRM5LZTXW7J7YJUP0C8N1N,It was the first scripted comedy for The N. The series ended with 13 episodes in its only season .,17,25,scripted,6,6,12
3UY4PIS8QRM5LZTXW7J7YJUP0C8N1N,It was the first scripted comedy for The N. The series ended with 13 episodes in its only season .,17,32,scripted comedy,2,0,2
3UY4PIS8QRM5LZTXW7J7YJUP0C8N1N,It was the first scripted comedy for The N. The series ended with 13 episodes in its only season .,48,54,series,0,1,1
3UY4PIS8QRM5LZTXW7J7YJUP0C8N1N,It was the first scripted comedy for The N. The series ended with 13 episodes in its only season .,69,77,episodes,0,3,3
3IV1AEQ4DRERD9MXGU0UKM0G5Y98JO,"Under the name of Liam Donnelly 's solution , it was once recommended to treat rheumatism , arthritis , malaria , trypanosome infections , tuberculosis , and diabetes .",35,43,solution,1,1,2
3IV1AEQ4DRERD9MXGU0UKM0G5Y98JO,"Under the name of Liam Donnelly 's solution , it was once recommended to treat rheumatism , arthritis , malaria , trypanosome infections , tuberculosis , and diabetes .",58,69,recommended,2,4,6
3IV1AEQ4DRERD9MXGU0UKM0G5Y98JO,"Under the name of Liam Donnelly 's solution , it was once recommended to treat rheumatism , arthritis , malaria , trypanosome infections , tuberculosis , and diabetes .",79,89,rheumatism,10,7,17
3IV1AEQ4DRERD9MXGU0UKM0G5Y98JO,"Under the name of Liam Donnelly 's solution , it was once recommended to treat rheumatism , arthritis , malaria , trypanosome infections , tuberculosis , and diabetes .",92,101,arthritis,10,5,15
3IV1AEQ4DRERD9MXGU0UKM0G5Y98JO,"Under the name of Liam Donnelly 's solution , it was once recommended to treat rheumatism , arthritis , malaria , trypanosome infections , tuberculosis , and diabetes .",104,111,malaria,5,0,5
3IV1AEQ4DRERD9MXGU0UKM0G5Y98JO,"Under the name of Liam Donnelly 's solution , it was once recommended to treat rheumatism , arthritis , malaria , trypanosome infections , tuberculosis , and diabetes .",114,125,trypanosome,10,3,13
3IV1AEQ4DRERD9MXGU0UKM0G5Y98JO,"Under the name of Liam Donnelly 's solution , it was once recommended to treat rheumatism , arthritis , malaria , trypanosome infections , tuberculosis , and diabetes .",114,136,trypanosome infections,3,3,6
3IV1AEQ4DRERD9MXGU0UKM0G5Y98JO,"Under the name of Liam Donnelly 's solution , it was once recommended to treat rheumatism , arthritis , malaria , trypanosome infections , tuberculosis , and diabetes .",126,136,infections,1,0,1
3IV1AEQ4DRERD9MXGU0UKM0G5Y98JO,"Under the name of Liam Donnelly 's solution , it was once recommended to treat rheumatism , arthritis , malaria , trypanosome infections , tuberculosis , and diabetes .",139,151,tuberculosis,8,0,8
3IV1AEQ4DRERD9MXGU0UKM0G5Y98JO,"Under the name of Liam Donnelly 's solution , it was once recommended to treat rheumatism , arthritis , malaria , trypanosome infections , tuberculosis , and diabetes .",158,166,diabetes,5,1,6
3IV1AEQ4DRERD9MXGU0UKM0G5Y98JO,It was found hidden within the walls of a much larger and more recent building that was being used by the Papal Nuncio until 1978 .,13,19,hidden,1,5,6
3IV1AEQ4DRERD9MXGU0UKM0G5Y98JO,It was found hidden within the walls of a much larger and more recent building that was being used by the Papal Nuncio until 1978 .,112,118,Nuncio,1,0,1
3IV1AEQ4DRERD9MXGU0UKM0G5Y98JO,"At that time , the more recent and larger building was deemed structurally irreparable due to dry rot .",55,61,deemed,3,10,13
3IV1AEQ4DRERD9MXGU0UKM0G5Y98JO,"At that time , the more recent and larger building was deemed structurally irreparable due to dry rot .",62,74,structurally,2,0,2
3IV1AEQ4DRERD9MXGU0UKM0G5Y98JO,"At that time , the more recent and larger building was deemed structurally irreparable due to dry rot .",62,86,structurally irreparable,3,2,5
3IV1AEQ4DRERD9MXGU0UKM0G5Y98JO,"At that time , the more recent and larger building was deemed structurally irreparable due to dry rot .",75,86,irreparable,5,6,11
3IV1AEQ4DRERD9MXGU0UKM0G5Y98JO,"At that time , the more recent and larger building was deemed structurally irreparable due to dry rot .",94,101,dry rot,1,1,2
3IV1AEQ4DRERD9MXGU0UKM0G5Y98JO,"At that time , the more recent and larger building was deemed structurally irreparable due to dry rot .",98,101,rot,0,2,2
3IV1AEQ4DRERD9MXGU0UKM0G5Y98JO,The castle was later incorporated into the construction of Ashtown Lodge which was to serve as the official residence of the Under Secretary from 1782 .,21,33,incorporated,3,5,8
3IV1AEQ4DRERD9MXGU0UKM0G5Y98JO,The castle was later incorporated into the construction of Ashtown Lodge which was to serve as the official residence of the Under Secretary from 1782 .,43,55,construction,0,1,1
3IV1AEQ4DRERD9MXGU0UKM0G5Y98JO,The castle was later incorporated into the construction of Ashtown Lodge which was to serve as the official residence of the Under Secretary from 1782 .,99,107,official,0,1,1
3IV1AEQ4DRERD9MXGU0UKM0G5Y98JO,"Prior to the introduction of antivenom , envenomation resulted in significant morbidity and mortality .",0,5,Prior,0,1,1
3IV1AEQ4DRERD9MXGU0UKM0G5Y98JO,"Prior to the introduction of antivenom , envenomation resulted in significant morbidity and mortality .",13,25,introduction,0,1,1
3IV1AEQ4DRERD9MXGU0UKM0G5Y98JO,"Prior to the introduction of antivenom , envenomation resulted in significant morbidity and mortality .",29,38,antivenom,8,8,16
3IV1AEQ4DRERD9MXGU0UKM0G5Y98JO,"Prior to the introduction of antivenom , envenomation resulted in significant morbidity and mortality .",41,53,envenomation,10,8,18
3IV1AEQ4DRERD9MXGU0UKM0G5Y98JO,"Prior to the introduction of antivenom , envenomation resulted in significant morbidity and mortality .",66,77,significant,2,0,2
3IV1AEQ4DRERD9MXGU0UKM0G5Y98JO,"Prior to the introduction of antivenom , envenomation resulted in significant morbidity and mortality .",78,87,morbidity,8,9,17
3IV1AEQ4DRERD9MXGU0UKM0G5Y98JO,"Prior to the introduction of antivenom , envenomation resulted in significant morbidity and mortality .",78,101,morbidity and mortality,1,2,3
3IV1AEQ4DRERD9MXGU0UKM0G5Y98JO,"Prior to the introduction of antivenom , envenomation resulted in significant morbidity and mortality .",92,101,mortality,8,6,14
3IV1AEQ4DRERD9MXGU0UKM0G5Y98JO,", also spelled adzuki or aduki ) is an annual vine , Vigna angularis , widely grown throughout East Asia and the Himalayas for its small ( approximately 5 mm ) bean .",39,50,annual vine,2,0,2
3IV1AEQ4DRERD9MXGU0UKM0G5Y98JO,", also spelled adzuki or aduki ) is an annual vine , Vigna angularis , widely grown throughout East Asia and the Himalayas for its small ( approximately 5 mm ) bean .",46,50,vine,0,1,1
3IV1AEQ4DRERD9MXGU0UKM0G5Y98JO,", also spelled adzuki or aduki ) is an annual vine , Vigna angularis , widely grown throughout East Asia and the Himalayas for its small ( approximately 5 mm ) bean .",139,152,approximately,0,1,1
3IV1AEQ4DRERD9MXGU0UKM0G5Y98JO,", also spelled adzuki or aduki ) is an annual vine , Vigna angularis , widely grown throughout East Asia and the Himalayas for its small ( approximately 5 mm ) bean .",160,164,bean,0,1,1
3YZ7A3YHR5U1PUML5Q2503HCZRLS5M,"It is known from a well preserved partial skeleton that includes four long feathers on the tail , composed of a central rachis and vanes .",19,33,well preserved,3,1,4
3YZ7A3YHR5U1PUML5Q2503HCZRLS5M,"It is known from a well preserved partial skeleton that includes four long feathers on the tail , composed of a central rachis and vanes .",24,33,preserved,2,3,5
3YZ7A3YHR5U1PUML5Q2503HCZRLS5M,"It is known from a well preserved partial skeleton that includes four long feathers on the tail , composed of a central rachis and vanes .",34,41,partial,3,1,4
3YZ7A3YHR5U1PUML5Q2503HCZRLS5M,"It is known from a well preserved partial skeleton that includes four long feathers on the tail , composed of a central rachis and vanes .",34,50,partial skeleton,1,1,2
3YZ7A3YHR5U1PUML5Q2503HCZRLS5M,"It is known from a well preserved partial skeleton that includes four long feathers on the tail , composed of a central rachis and vanes .",42,50,skeleton,4,4,8
3YZ7A3YHR5U1PUML5Q2503HCZRLS5M,"It is known from a well preserved partial skeleton that includes four long feathers on the tail , composed of a central rachis and vanes .",75,83,feathers,0,4,4
3YZ7A3YHR5U1PUML5Q2503HCZRLS5M,"It is known from a well preserved partial skeleton that includes four long feathers on the tail , composed of a central rachis and vanes .",91,95,tail,0,1,1
3YZ7A3YHR5U1PUML5Q2503HCZRLS5M,"It is known from a well preserved partial skeleton that includes four long feathers on the tail , composed of a central rachis and vanes .",98,106,composed,3,0,3
3YZ7A3YHR5U1PUML5Q2503HCZRLS5M,"It is known from a well preserved partial skeleton that includes four long feathers on the tail , composed of a central rachis and vanes .",112,126,central rachis,0,1,1
3YZ7A3YHR5U1PUML5Q2503HCZRLS5M,"It is known from a well preserved partial skeleton that includes four long feathers on the tail , composed of a central rachis and vanes .",120,126,rachis,6,9,15
3YZ7A3YHR5U1PUML5Q2503HCZRLS5M,"It is known from a well preserved partial skeleton that includes four long feathers on the tail , composed of a central rachis and vanes .",120,136,rachis and vanes,2,2,4
3YZ7A3YHR5U1PUML5Q2503HCZRLS5M,"It is known from a well preserved partial skeleton that includes four long feathers on the tail , composed of a central rachis and vanes .",131,136,vanes,5,8,13
3YZ7A3YHR5U1PUML5Q2503HCZRLS5M,"Zhang et al. suggest that unless Epidexipteryx evolved from flying ancestors and subsequently lost its wings , this may indicate that advanced display feathers on the tail may have predated flying or gliding flight .",6,11,et al,0,3,3
3YZ7A3YHR5U1PUML5Q2503HCZRLS5M,"Zhang et al. suggest that unless Epidexipteryx evolved from flying ancestors and subsequently lost its wings , this may indicate that advanced display feathers on the tail may have predated flying or gliding flight .",33,46,Epidexipteryx,6,5,11
3YZ7A3YHR5U1PUML5Q2503HCZRLS5M,"Zhang et al. suggest that unless Epidexipteryx evolved from flying ancestors and subsequently lost its wings , this may indicate that advanced display feathers on the tail may have predated flying or gliding flight .",47,54,evolved,2,3,5
3YZ7A3YHR5U1PUML5Q2503HCZRLS5M,"Zhang et al. suggest that unless Epidexipteryx evolved from flying ancestors and subsequently lost its wings , this may indicate that advanced display feathers on the tail may have predated flying or gliding flight .",67,76,ancestors,5,5,10
3YZ7A3YHR5U1PUML5Q2503HCZRLS5M,"Zhang et al. suggest that unless Epidexipteryx evolved from flying ancestors and subsequently lost its wings , this may indicate that advanced display feathers on the tail may have predated flying or gliding flight .",81,93,subsequently,8,6,14
3YZ7A3YHR5U1PUML5Q2503HCZRLS5M,"Zhang et al. suggest that unless Epidexipteryx evolved from flying ancestors and subsequently lost its wings , this may indicate that advanced display feathers on the tail may have predated flying or gliding flight .",103,108,wings,0,1,1
3YZ7A3YHR5U1PUML5Q2503HCZRLS5M,"Zhang et al. suggest that unless Epidexipteryx evolved from flying ancestors and subsequently lost its wings , this may indicate that advanced display feathers on the tail may have predated flying or gliding flight .",120,128,indicate,0,1,1
3YZ7A3YHR5U1PUML5Q2503HCZRLS5M,"Zhang et al. suggest that unless Epidexipteryx evolved from flying ancestors and subsequently lost its wings , this may indicate that advanced display feathers on the tail may have predated flying or gliding flight .",134,142,advanced,1,0,1
3YZ7A3YHR5U1PUML5Q2503HCZRLS5M,"Zhang et al. suggest that unless Epidexipteryx evolved from flying ancestors and subsequently lost its wings , this may indicate that advanced display feathers on the tail may have predated flying or gliding flight .",143,150,display,0,1,1
3YZ7A3YHR5U1PUML5Q2503HCZRLS5M,"Zhang et al. suggest that unless Epidexipteryx evolved from flying ancestors and subsequently lost its wings , this may indicate that advanced display feathers on the tail may have predated flying or gliding flight .",181,189,predated,6,9,15
3YZ7A3YHR5U1PUML5Q2503HCZRLS5M,"Zhang et al. suggest that unless Epidexipteryx evolved from flying ancestors and subsequently lost its wings , this may indicate that advanced display feathers on the tail may have predated flying or gliding flight .",181,196,predated flying,0,1,1
3YZ7A3YHR5U1PUML5Q2503HCZRLS5M,"Zhang et al. suggest that unless Epidexipteryx evolved from flying ancestors and subsequently lost its wings , this may indicate that advanced display feathers on the tail may have predated flying or gliding flight .",200,207,gliding,0,4,4
3YZ7A3YHR5U1PUML5Q2503HCZRLS5M,"Zhang et al. suggest that unless Epidexipteryx evolved from flying ancestors and subsequently lost its wings , this may indicate that advanced display feathers on the tail may have predated flying or gliding flight .",200,214,gliding flight,1,1,2
3YZ7A3YHR5U1PUML5Q2503HCZRLS5M,"It had teeth only in the front of the jaws , with unusually long front teeth angled forward , a feature only seen in Masiakasaurus among other theropods .",7,12,teeth,0,1,1
3YZ7A3YHR5U1PUML5Q2503HCZRLS5M,"It had teeth only in the front of the jaws , with unusually long front teeth angled forward , a feature only seen in Masiakasaurus among other theropods .",38,42,jaws,0,4,4
3YZ7A3YHR5U1PUML5Q2503HCZRLS5M,"It had teeth only in the front of the jaws , with unusually long front teeth angled forward , a feature only seen in Masiakasaurus among other theropods .",50,59,unusually,2,1,3
3YZ7A3YHR5U1PUML5Q2503HCZRLS5M,"It had teeth only in the front of the jaws , with unusually long front teeth angled forward , a feature only seen in Masiakasaurus among other theropods .",77,83,angled,0,2,2
3YZ7A3YHR5U1PUML5Q2503HCZRLS5M,"It had teeth only in the front of the jaws , with unusually long front teeth angled forward , a feature only seen in Masiakasaurus among other theropods .",96,103,feature,0,1,1
3YZ7A3YHR5U1PUML5Q2503HCZRLS5M,"It had teeth only in the front of the jaws , with unusually long front teeth angled forward , a feature only seen in Masiakasaurus among other theropods .",117,130,Masiakasaurus,3,3,6
3YZ7A3YHR5U1PUML5Q2503HCZRLS5M,"It had teeth only in the front of the jaws , with unusually long front teeth angled forward , a feature only seen in Masiakasaurus among other theropods .",143,152,theropods,9,10,19
3YZ7A3YHR5U1PUML5Q2503HCZRLS5M,"In all , the skeleton of Epidexipteryx hui measures 25 centimeters ( 10 inches ) in length ( 44.5 cm or 17.5 in including the incomplete tail feathers ) , and the authors estimated a weight of 164 grams , smaller than most other basal avialans .",25,38,Epidexipteryx,1,0,1
3YZ7A3YHR5U1PUML5Q2503HCZRLS5M,"In all , the skeleton of Epidexipteryx hui measures 25 centimeters ( 10 inches ) in length ( 44.5 cm or 17.5 in including the incomplete tail feathers ) , and the authors estimated a weight of 164 grams , smaller than most other basal avialans .",25,42,Epidexipteryx hui,2,1,3
3YZ7A3YHR5U1PUML5Q2503HCZRLS5M,"In all , the skeleton of Epidexipteryx hui measures 25 centimeters ( 10 inches ) in length ( 44.5 cm or 17.5 in including the incomplete tail feathers ) , and the authors estimated a weight of 164 grams , smaller than most other basal avialans .",39,42,hui,0,1,1
3YZ7A3YHR5U1PUML5Q2503HCZRLS5M,"In all , the skeleton of Epidexipteryx hui measures 25 centimeters ( 10 inches ) in length ( 44.5 cm or 17.5 in including the incomplete tail feathers ) , and the authors estimated a weight of 164 grams , smaller than most other basal avialans .",137,150,tail feathers,0,1,1
3YZ7A3YHR5U1PUML5Q2503HCZRLS5M,"In all , the skeleton of Epidexipteryx hui measures 25 centimeters ( 10 inches ) in length ( 44.5 cm or 17.5 in including the incomplete tail feathers ) , and the authors estimated a weight of 164 grams , smaller than most other basal avialans .",171,180,estimated,4,0,4
3YZ7A3YHR5U1PUML5Q2503HCZRLS5M,"In all , the skeleton of Epidexipteryx hui measures 25 centimeters ( 10 inches ) in length ( 44.5 cm or 17.5 in including the incomplete tail feathers ) , and the authors estimated a weight of 164 grams , smaller than most other basal avialans .",183,189,weight,1,0,1
3YZ7A3YHR5U1PUML5Q2503HCZRLS5M,"In all , the skeleton of Epidexipteryx hui measures 25 centimeters ( 10 inches ) in length ( 44.5 cm or 17.5 in including the incomplete tail feathers ) , and the authors estimated a weight of 164 grams , smaller than most other basal avialans .",229,234,basal,1,2,3
3YZ7A3YHR5U1PUML5Q2503HCZRLS5M,"In all , the skeleton of Epidexipteryx hui measures 25 centimeters ( 10 inches ) in length ( 44.5 cm or 17.5 in including the incomplete tail feathers ) , and the authors estimated a weight of 164 grams , smaller than most other basal avialans .",229,243,basal avialans,10,5,15
3YZ7A3YHR5U1PUML5Q2503HCZRLS5M,"In all , the skeleton of Epidexipteryx hui measures 25 centimeters ( 10 inches ) in length ( 44.5 cm or 17.5 in including the incomplete tail feathers ) , and the authors estimated a weight of 164 grams , smaller than most other basal avialans .",235,243,avialans,3,5,8
3A3KKYU7P3IS4IO0HUTSEUVJRZ7MWL,"Observers have noted that his style is similar to Blek le Rat , who began to work with stencils in 1981 in Paris .",0,9,Observers,4,3,7
3A3KKYU7P3IS4IO0HUTSEUVJRZ7MWL,"Observers have noted that his style is similar to Blek le Rat , who began to work with stencils in 1981 in Paris .",15,20,noted,0,1,1
3A3KKYU7P3IS4IO0HUTSEUVJRZ7MWL,"Observers have noted that his style is similar to Blek le Rat , who began to work with stencils in 1981 in Paris .",50,61,Blek le Rat,0,1,1
3A3KKYU7P3IS4IO0HUTSEUVJRZ7MWL,"Observers have noted that his style is similar to Blek le Rat , who began to work with stencils in 1981 in Paris .",87,95,stencils,8,10,18
3A3KKYU7P3IS4IO0HUTSEUVJRZ7MWL,"Such artistic works of political and social commentary have been featured on streets , walls , and bridges of cities throughout the world .",5,13,artistic,1,0,1
3A3KKYU7P3IS4IO0HUTSEUVJRZ7MWL,"Such artistic works of political and social commentary have been featured on streets , walls , and bridges of cities throughout the world .",23,32,political,1,0,1
3A3KKYU7P3IS4IO0HUTSEUVJRZ7MWL,"Such artistic works of political and social commentary have been featured on streets , walls , and bridges of cities throughout the world .",23,54,political and social commentary,1,0,1
3A3KKYU7P3IS4IO0HUTSEUVJRZ7MWL,"Such artistic works of political and social commentary have been featured on streets , walls , and bridges of cities throughout the world .",37,54,social commentary,2,2,4
3A3KKYU7P3IS4IO0HUTSEUVJRZ7MWL,"Such artistic works of political and social commentary have been featured on streets , walls , and bridges of cities throughout the world .",44,54,commentary,4,2,6
3A3KKYU7P3IS4IO0HUTSEUVJRZ7MWL,"Such artistic works of political and social commentary have been featured on streets , walls , and bridges of cities throughout the world .",65,73,featured,0,4,4
3A3KKYU7P3IS4IO0HUTSEUVJRZ7MWL,"Such artistic works of political and social commentary have been featured on streets , walls , and bridges of cities throughout the world .",99,106,bridges,0,1,1
3A3KKYU7P3IS4IO0HUTSEUVJRZ7MWL,"Such artistic works of political and social commentary have been featured on streets , walls , and bridges of cities throughout the world .",117,127,throughout,1,4,5
3A3KKYU7P3IS4IO0HUTSEUVJRZ7MWL,"Water flowing out of bogs has a characteristic brown color , which comes from dissolved peat tannins .",6,13,flowing,0,1,1
3A3KKYU7P3IS4IO0HUTSEUVJRZ7MWL,"Water flowing out of bogs has a characteristic brown color , which comes from dissolved peat tannins .",21,25,bogs,3,7,10
3A3KKYU7P3IS4IO0HUTSEUVJRZ7MWL,"Water flowing out of bogs has a characteristic brown color , which comes from dissolved peat tannins .",32,46,characteristic,8,2,10
3A3KKYU7P3IS4IO0HUTSEUVJRZ7MWL,"Water flowing out of bogs has a characteristic brown color , which comes from dissolved peat tannins .",78,87,dissolved,3,0,3
3A3KKYU7P3IS4IO0HUTSEUVJRZ7MWL,"Water flowing out of bogs has a characteristic brown color , which comes from dissolved peat tannins .",78,100,dissolved peat tannins,3,1,4
3A3KKYU7P3IS4IO0HUTSEUVJRZ7MWL,"Water flowing out of bogs has a characteristic brown color , which comes from dissolved peat tannins .",88,92,peat,2,1,3
3A3KKYU7P3IS4IO0HUTSEUVJRZ7MWL,"Water flowing out of bogs has a characteristic brown color , which comes from dissolved peat tannins .",88,100,peat tannins,4,4,8
3A3KKYU7P3IS4IO0HUTSEUVJRZ7MWL,"Water flowing out of bogs has a characteristic brown color , which comes from dissolved peat tannins .",93,100,tannins,7,3,10
3A3KKYU7P3IS4IO0HUTSEUVJRZ7MWL,"In general the low fertility and cool climate results in relatively slow plant growth , but decay is even slower owing to the saturated soil .",19,28,fertility,4,2,6
3A3KKYU7P3IS4IO0HUTSEUVJRZ7MWL,"In general the low fertility and cool climate results in relatively slow plant growth , but decay is even slower owing to the saturated soil .",38,45,climate,0,1,1
3A3KKYU7P3IS4IO0HUTSEUVJRZ7MWL,"In general the low fertility and cool climate results in relatively slow plant growth , but decay is even slower owing to the saturated soil .",57,67,relatively,1,2,3
3A3KKYU7P3IS4IO0HUTSEUVJRZ7MWL,"In general the low fertility and cool climate results in relatively slow plant growth , but decay is even slower owing to the saturated soil .",79,85,growth,0,1,1
3A3KKYU7P3IS4IO0HUTSEUVJRZ7MWL,"In general the low fertility and cool climate results in relatively slow plant growth , but decay is even slower owing to the saturated soil .",92,97,decay,2,6,8
3A3KKYU7P3IS4IO0HUTSEUVJRZ7MWL,"In general the low fertility and cool climate results in relatively slow plant growth , but decay is even slower owing to the saturated soil .",113,118,owing,2,3,5
3A3KKYU7P3IS4IO0HUTSEUVJRZ7MWL,"In general the low fertility and cool climate results in relatively slow plant growth , but decay is even slower owing to the saturated soil .",126,135,saturated,5,6,11
3A3KKYU7P3IS4IO0HUTSEUVJRZ7MWL,"In general the low fertility and cool climate results in relatively slow plant growth , but decay is even slower owing to the saturated soil .",126,140,saturated soil,3,1,4
3A3KKYU7P3IS4IO0HUTSEUVJRZ7MWL,"In general the low fertility and cool climate results in relatively slow plant growth , but decay is even slower owing to the saturated soil .",136,140,soil,0,2,2
3A3KKYU7P3IS4IO0HUTSEUVJRZ7MWL,"Bogs have distinctive assemblages of plant and animal species and are of high importance for biodiversity , particularly in landscapes that are otherwise settled and farmed .",0,4,Bogs,0,1,1
3A3KKYU7P3IS4IO0HUTSEUVJRZ7MWL,"Bogs have distinctive assemblages of plant and animal species and are of high importance for biodiversity , particularly in landscapes that are otherwise settled and farmed .",10,21,distinctive,4,0,4
3A3KKYU7P3IS4IO0HUTSEUVJRZ7MWL,"Bogs have distinctive assemblages of plant and animal species and are of high importance for biodiversity , particularly in landscapes that are otherwise settled and farmed .",10,33,distinctive assemblages,2,3,5
3A3KKYU7P3IS4IO0HUTSEUVJRZ7MWL,"Bogs have distinctive assemblages of plant and animal species and are of high importance for biodiversity , particularly in landscapes that are otherwise settled and farmed .",22,33,assemblages,10,8,18
3A3KKYU7P3IS4IO0HUTSEUVJRZ7MWL,"Bogs have distinctive assemblages of plant and animal species and are of high importance for biodiversity , particularly in landscapes that are otherwise settled and farmed .",54,61,species,1,0,1
3A3KKYU7P3IS4IO0HUTSEUVJRZ7MWL,"Bogs have distinctive assemblages of plant and animal species and are of high importance for biodiversity , particularly in landscapes that are otherwise settled and farmed .",78,88,importance,1,0,1
3A3KKYU7P3IS4IO0HUTSEUVJRZ7MWL,"Bogs have distinctive assemblages of plant and animal species and are of high importance for biodiversity , particularly in landscapes that are otherwise settled and farmed .",93,105,biodiversity,10,7,17
3A3KKYU7P3IS4IO0HUTSEUVJRZ7MWL,"Bogs have distinctive assemblages of plant and animal species and are of high importance for biodiversity , particularly in landscapes that are otherwise settled and farmed .",108,120,particularly,2,1,3
3A3KKYU7P3IS4IO0HUTSEUVJRZ7MWL,"Bogs have distinctive assemblages of plant and animal species and are of high importance for biodiversity , particularly in landscapes that are otherwise settled and farmed .",124,134,landscapes,1,5,6
3A3KKYU7P3IS4IO0HUTSEUVJRZ7MWL,"Bogs have distinctive assemblages of plant and animal species and are of high importance for biodiversity , particularly in landscapes that are otherwise settled and farmed .",154,161,settled,0,3,3
3A3KKYU7P3IS4IO0HUTSEUVJRZ7MWL,"Bogs have distinctive assemblages of plant and animal species and are of high importance for biodiversity , particularly in landscapes that are otherwise settled and farmed .",166,172,farmed,0,2,2
3A3KKYU7P3IS4IO0HUTSEUVJRZ7MWL,Bogs occur where the water at the ground surface is acidic and low in nutrients .,0,4,Bogs,1,0,1
3A3KKYU7P3IS4IO0HUTSEUVJRZ7MWL,Bogs occur where the water at the ground surface is acidic and low in nutrients .,5,10,occur,0,1,1
3A3KKYU7P3IS4IO0HUTSEUVJRZ7MWL,Bogs occur where the water at the ground surface is acidic and low in nutrients .,52,58,acidic,6,0,6
3A3KKYU7P3IS4IO0HUTSEUVJRZ7MWL,Bogs occur where the water at the ground surface is acidic and low in nutrients .,70,79,nutrients,5,1,6
3LN50BUKPVCIER9E5WEIMN8YYXEPLR,"The following year , she played the teenage daughter of Arnold Schwarzenegger and Jamie Lee Curtis in True Lies .",4,13,following,3,0,3
3LN50BUKPVCIER9E5WEIMN8YYXEPLR,"The following year , she played the teenage daughter of Arnold Schwarzenegger and Jamie Lee Curtis in True Lies .",4,18,following year,0,1,1
3LN50BUKPVCIER9E5WEIMN8YYXEPLR,"The following year , she played the teenage daughter of Arnold Schwarzenegger and Jamie Lee Curtis in True Lies .",36,43,teenage,7,10,17
3LN50BUKPVCIER9E5WEIMN8YYXEPLR,"The following year , she played the teenage daughter of Arnold Schwarzenegger and Jamie Lee Curtis in True Lies .",36,52,teenage daughter,0,1,1
3LN50BUKPVCIER9E5WEIMN8YYXEPLR,"The following year , she played the teenage daughter of Arnold Schwarzenegger and Jamie Lee Curtis in True Lies .",44,52,daughter,1,1,2
3LN50BUKPVCIER9E5WEIMN8YYXEPLR,"The following year , she played the teenage daughter of Arnold Schwarzenegger and Jamie Lee Curtis in True Lies .",56,77,Arnold Schwarzenegger,1,0,1
3LN50BUKPVCIER9E5WEIMN8YYXEPLR,"The following year , she played the teenage daughter of Arnold Schwarzenegger and Jamie Lee Curtis in True Lies .",63,77,Schwarzenegger,1,1,2
3LN50BUKPVCIER9E5WEIMN8YYXEPLR,"The following year , she played the teenage daughter of Arnold Schwarzenegger and Jamie Lee Curtis in True Lies .",102,111,True Lies,0,1,1
3LN50BUKPVCIER9E5WEIMN8YYXEPLR,"The following year , she played the teenage daughter of Arnold Schwarzenegger and Jamie Lee Curtis in True Lies .",107,111,Lies,0,2,2
3LN50BUKPVCIER9E5WEIMN8YYXEPLR,"She appeared in the Simple Plan music video , `` I 'm Just a Kid '' , as the band 's love interest , as well as Nickelback 's video for `` Rockstar '' .",4,12,appeared,3,4,7
3LN50BUKPVCIER9E5WEIMN8YYXEPLR,"She appeared in the Simple Plan music video , `` I 'm Just a Kid '' , as the band 's love interest , as well as Nickelback 's video for `` Rockstar '' .",20,43,Simple Plan music video,0,1,1
3LN50BUKPVCIER9E5WEIMN8YYXEPLR,"She appeared in the Simple Plan music video , `` I 'm Just a Kid '' , as the band 's love interest , as well as Nickelback 's video for `` Rockstar '' .",61,64,Kid,1,0,1
3LN50BUKPVCIER9E5WEIMN8YYXEPLR,"She appeared in the Simple Plan music video , `` I 'm Just a Kid '' , as the band 's love interest , as well as Nickelback 's video for `` Rockstar '' .",77,81,band,1,0,1
3LN50BUKPVCIER9E5WEIMN8YYXEPLR,"She appeared in the Simple Plan music video , `` I 'm Just a Kid '' , as the band 's love interest , as well as Nickelback 's video for `` Rockstar '' .",85,98,love interest,4,1,5
3LN50BUKPVCIER9E5WEIMN8YYXEPLR,"She appeared in the Simple Plan music video , `` I 'm Just a Kid '' , as the band 's love interest , as well as Nickelback 's video for `` Rockstar '' .",112,122,Nickelback,1,1,2
3LN50BUKPVCIER9E5WEIMN8YYXEPLR,"She appeared in the Simple Plan music video , `` I 'm Just a Kid '' , as the band 's love interest , as well as Nickelback 's video for `` Rockstar '' .",139,147,Rockstar,2,0,2
3LN50BUKPVCIER9E5WEIMN8YYXEPLR,"Variety announced on August 2 , 2006 , that Dushku would co-star with Macaulay Culkin in Sex and Breakfast , a dark comedy written and directed by Miles Brandman .",0,7,Variety,3,1,4
3LN50BUKPVCIER9E5WEIMN8YYXEPLR,"Variety announced on August 2 , 2006 , that Dushku would co-star with Macaulay Culkin in Sex and Breakfast , a dark comedy written and directed by Miles Brandman .",8,17,announced,4,4,8
3LN50BUKPVCIER9E5WEIMN8YYXEPLR,"Variety announced on August 2 , 2006 , that Dushku would co-star with Macaulay Culkin in Sex and Breakfast , a dark comedy written and directed by Miles Brandman .",57,64,co-star,4,7,11
3LN50BUKPVCIER9E5WEIMN8YYXEPLR,"Variety announced on August 2 , 2006 , that Dushku would co-star with Macaulay Culkin in Sex and Breakfast , a dark comedy written and directed by Miles Brandman .",70,78,Macaulay,0,1,1
3LN50BUKPVCIER9E5WEIMN8YYXEPLR,"Variety announced on August 2 , 2006 , that Dushku would co-star with Macaulay Culkin in Sex and Breakfast , a dark comedy written and directed by Miles Brandman .",70,85,Macaulay Culkin,1,0,1
3LN50BUKPVCIER9E5WEIMN8YYXEPLR,"Variety announced on August 2 , 2006 , that Dushku would co-star with Macaulay Culkin in Sex and Breakfast , a dark comedy written and directed by Miles Brandman .",111,115,dark,1,0,1
3LN50BUKPVCIER9E5WEIMN8YYXEPLR,"Variety announced on August 2 , 2006 , that Dushku would co-star with Macaulay Culkin in Sex and Breakfast , a dark comedy written and directed by Miles Brandman .",111,122,dark comedy,6,4,10
3LN50BUKPVCIER9E5WEIMN8YYXEPLR,"Variety announced on August 2 , 2006 , that Dushku would co-star with Macaulay Culkin in Sex and Breakfast , a dark comedy written and directed by Miles Brandman .",116,122,comedy,1,2,3
3LN50BUKPVCIER9E5WEIMN8YYXEPLR,"Variety announced on August 2 , 2006 , that Dushku would co-star with Macaulay Culkin in Sex and Breakfast , a dark comedy written and directed by Miles Brandman .",135,143,directed,2,0,2
3LN50BUKPVCIER9E5WEIMN8YYXEPLR,"The movie was released in Los Angeles on November 30 , 2007 , and on DVD on January 22 , 2008 .",14,22,released,7,7,14
3LN50BUKPVCIER9E5WEIMN8YYXEPLR,"The movie was released in Los Angeles on November 30 , 2007 , and on DVD on January 22 , 2008 .",69,72,DVD,2,0,2
3LN50BUKPVCIER9E5WEIMN8YYXEPLR,"The same year , Kevin Smith invited Dushku to be a part of Jay and Silent Bob Strike Back .",28,35,invited,4,1,5
3LN50BUKPVCIER9E5WEIMN8YYXEPLR,"The same year , Kevin Smith invited Dushku to be a part of Jay and Silent Bob Strike Back .",36,42,Dushku,0,1,1
3LN50BUKPVCIER9E5WEIMN8YYXEPLR,"The same year , Kevin Smith invited Dushku to be a part of Jay and Silent Bob Strike Back .",43,58,to be a part of,0,1,1
3LN50BUKPVCIER9E5WEIMN8YYXEPLR,"The same year , Kevin Smith invited Dushku to be a part of Jay and Silent Bob Strike Back .",78,89,Strike Back,0,2,2
3KTZHH2ONIGHEHSIJRDM0ESX9S48MS,"This is done because it is the account name , not the behavior of the person behind it , which is the problem .",31,43,account name,1,0,1
3KTZHH2ONIGHEHSIJRDM0ESX9S48MS,"This is done because it is the account name , not the behavior of the person behind it , which is the problem .",54,62,behavior,2,6,8
3KTZHH2ONIGHEHSIJRDM0ESX9S48MS,"Before you make an unblock request , you should attentively read the policies and guidelines named in your block reason .",19,26,unblock,0,8,8
3KTZHH2ONIGHEHSIJRDM0ESX9S48MS,"Before you make an unblock request , you should attentively read the policies and guidelines named in your block reason .",19,34,unblock request,0,1,1
3KTZHH2ONIGHEHSIJRDM0ESX9S48MS,"Before you make an unblock request , you should attentively read the policies and guidelines named in your block reason .",48,59,attentively,7,6,13
3KTZHH2ONIGHEHSIJRDM0ESX9S48MS,"Before you make an unblock request , you should attentively read the policies and guidelines named in your block reason .",69,77,policies,1,2,3
3KTZHH2ONIGHEHSIJRDM0ESX9S48MS,"Before you make an unblock request , you should attentively read the policies and guidelines named in your block reason .",82,92,guidelines,2,4,6
3KTZHH2ONIGHEHSIJRDM0ESX9S48MS,"An account with a username that uses hateful or obscene language or otherwise indicates disruptive or provocative intent will be hard blocked , meaning that an unblock request will be required .",18,26,username,1,1,2
3KTZHH2ONIGHEHSIJRDM0ESX9S48MS,"An account with a username that uses hateful or obscene language or otherwise indicates disruptive or provocative intent will be hard blocked , meaning that an unblock request will be required .",37,44,hateful,0,2,2
3KTZHH2ONIGHEHSIJRDM0ESX9S48MS,"An account with a username that uses hateful or obscene language or otherwise indicates disruptive or provocative intent will be hard blocked , meaning that an unblock request will be required .",37,55,hateful or obscene,0,1,1
3KTZHH2ONIGHEHSIJRDM0ESX9S48MS,"An account with a username that uses hateful or obscene language or otherwise indicates disruptive or provocative intent will be hard blocked , meaning that an unblock request will be required .",48,55,obscene,8,8,16
3KTZHH2ONIGHEHSIJRDM0ESX9S48MS,"An account with a username that uses hateful or obscene language or otherwise indicates disruptive or provocative intent will be hard blocked , meaning that an unblock request will be required .",48,64,obscene language,2,2,4
3KTZHH2ONIGHEHSIJRDM0ESX9S48MS,"An account with a username that uses hateful or obscene language or otherwise indicates disruptive or provocative intent will be hard blocked , meaning that an unblock request will be required .",78,87,indicates,1,1,2
3KTZHH2ONIGHEHSIJRDM0ESX9S48MS,"An account with a username that uses hateful or obscene language or otherwise indicates disruptive or provocative intent will be hard blocked , meaning that an unblock request will be required .",88,98,disruptive,8,10,18
3KTZHH2ONIGHEHSIJRDM0ESX9S48MS,"An account with a username that uses hateful or obscene language or otherwise indicates disruptive or provocative intent will be hard blocked , meaning that an unblock request will be required .",88,120,disruptive or provocative intent,0,1,1
3KTZHH2ONIGHEHSIJRDM0ESX9S48MS,"An account with a username that uses hateful or obscene language or otherwise indicates disruptive or provocative intent will be hard blocked , meaning that an unblock request will be required .",102,113,provocative,10,8,18
3KTZHH2ONIGHEHSIJRDM0ESX9S48MS,"An account with a username that uses hateful or obscene language or otherwise indicates disruptive or provocative intent will be hard blocked , meaning that an unblock request will be required .",102,120,provocative intent,1,2,3
3KTZHH2ONIGHEHSIJRDM0ESX9S48MS,"An account with a username that uses hateful or obscene language or otherwise indicates disruptive or provocative intent will be hard blocked , meaning that an unblock request will be required .",114,120,intent,2,0,2
3KTZHH2ONIGHEHSIJRDM0ESX9S48MS,"An account with a username that uses hateful or obscene language or otherwise indicates disruptive or provocative intent will be hard blocked , meaning that an unblock request will be required .",129,141,hard blocked,1,3,4
3KTZHH2ONIGHEHSIJRDM0ESX9S48MS,"If your server has been blocked as an open proxy , you will probably need to edit via another connection : in most cases , proxies are `` hard blocked '' , which prevents even logged-in users from using the connection to edit .",38,48,open proxy,3,4,7
3KTZHH2ONIGHEHSIJRDM0ESX9S48MS,"If your server has been blocked as an open proxy , you will probably need to edit via another connection : in most cases , proxies are `` hard blocked '' , which prevents even logged-in users from using the connection to edit .",43,48,proxy,6,6,12
3KTZHH2ONIGHEHSIJRDM0ESX9S48MS,"If your server has been blocked as an open proxy , you will probably need to edit via another connection : in most cases , proxies are `` hard blocked '' , which prevents even logged-in users from using the connection to edit .",60,68,probably,0,1,1
3KTZHH2ONIGHEHSIJRDM0ESX9S48MS,"If your server has been blocked as an open proxy , you will probably need to edit via another connection : in most cases , proxies are `` hard blocked '' , which prevents even logged-in users from using the connection to edit .",82,85,via,1,0,1
3KTZHH2ONIGHEHSIJRDM0ESX9S48MS,"If your server has been blocked as an open proxy , you will probably need to edit via another connection : in most cases , proxies are `` hard blocked '' , which prevents even logged-in users from using the connection to edit .",94,104,connection,0,1,1
3KTZHH2ONIGHEHSIJRDM0ESX9S48MS,"If your server has been blocked as an open proxy , you will probably need to edit via another connection : in most cases , proxies are `` hard blocked '' , which prevents even logged-in users from using the connection to edit .",123,130,proxies,4,1,5
3KTZHH2ONIGHEHSIJRDM0ESX9S48MS,"If your server has been blocked as an open proxy , you will probably need to edit via another connection : in most cases , proxies are `` hard blocked '' , which prevents even logged-in users from using the connection to edit .",138,150,hard blocked,1,2,3
3KTZHH2ONIGHEHSIJRDM0ESX9S48MS,"If your server has been blocked as an open proxy , you will probably need to edit via another connection : in most cases , proxies are `` hard blocked '' , which prevents even logged-in users from using the connection to edit .",176,185,logged-in,2,6,8
3KTZHH2ONIGHEHSIJRDM0ESX9S48MS,"If your server has been blocked as an open proxy , you will probably need to edit via another connection : in most cases , proxies are `` hard blocked '' , which prevents even logged-in users from using the connection to edit .",207,217,connection,0,1,1
3KTZHH2ONIGHEHSIJRDM0ESX9S48MS,"Reviewing admins will usually defer to the blocking admin in a sockpuppetry-based block , especially if the sock account has minimal edits .",0,9,Reviewing,1,1,2
3KTZHH2ONIGHEHSIJRDM0ESX9S48MS,"Reviewing admins will usually defer to the blocking admin in a sockpuppetry-based block , especially if the sock account has minimal edits .",10,16,admins,2,0,2
3KTZHH2ONIGHEHSIJRDM0ESX9S48MS,"Reviewing admins will usually defer to the blocking admin in a sockpuppetry-based block , especially if the sock account has minimal edits .",30,35,defer,2,5,7
3KTZHH2ONIGHEHSIJRDM0ESX9S48MS,"Reviewing admins will usually defer to the blocking admin in a sockpuppetry-based block , especially if the sock account has minimal edits .",63,81,sockpuppetry-based,8,7,15
3KTZHH2ONIGHEHSIJRDM0ESX9S48MS,"Reviewing admins will usually defer to the blocking admin in a sockpuppetry-based block , especially if the sock account has minimal edits .",63,87,sockpuppetry-based block,2,6,8
3KTZHH2ONIGHEHSIJRDM0ESX9S48MS,"Reviewing admins will usually defer to the blocking admin in a sockpuppetry-based block , especially if the sock account has minimal edits .",108,120,sock account,0,2,2
3KTZHH2ONIGHEHSIJRDM0ESX9S48MS,"Reviewing admins will usually defer to the blocking admin in a sockpuppetry-based block , especially if the sock account has minimal edits .",125,132,minimal,1,0,1
3KTZHH2ONIGHEHSIJRDM0ESX9S48MS,"Reviewing admins will usually defer to the blocking admin in a sockpuppetry-based block , especially if the sock account has minimal edits .",125,138,minimal edits,0,1,1
3I01FDIL6M93O8KGQH5I7XS0EEKD2C,"ACF Fiorentina , commonly referred to as simply Fiorentina , is a professional Italian football club from Florence , Tuscany .",0,3,ACF,0,1,1
3I01FDIL6M93O8KGQH5I7XS0EEKD2C,"ACF Fiorentina , commonly referred to as simply Fiorentina , is a professional Italian football club from Florence , Tuscany .",0,14,ACF Fiorentina,1,0,1
3I01FDIL6M93O8KGQH5I7XS0EEKD2C,"ACF Fiorentina , commonly referred to as simply Fiorentina , is a professional Italian football club from Florence , Tuscany .",26,34,referred,3,3,6
3I01FDIL6M93O8KGQH5I7XS0EEKD2C,"ACF Fiorentina , commonly referred to as simply Fiorentina , is a professional Italian football club from Florence , Tuscany .",48,58,Fiorentina,1,0,1
3I01FDIL6M93O8KGQH5I7XS0EEKD2C,"ACF Fiorentina , commonly referred to as simply Fiorentina , is a professional Italian football club from Florence , Tuscany .",66,78,professional,2,6,8
3I01FDIL6M93O8KGQH5I7XS0EEKD2C,"Fiorentina have won two Italian Championships , in 1955-56 and again in 1968-69 , as well as winning six Coppa Italia trophies and one Italian Super Cup .",32,45,Championships,1,2,3
3I01FDIL6M93O8KGQH5I7XS0EEKD2C,"Fiorentina have won two Italian Championships , in 1955-56 and again in 1968-69 , as well as winning six Coppa Italia trophies and one Italian Super Cup .",105,110,Coppa,0,1,1
3I01FDIL6M93O8KGQH5I7XS0EEKD2C,"Fiorentina have won two Italian Championships , in 1955-56 and again in 1968-69 , as well as winning six Coppa Italia trophies and one Italian Super Cup .",105,117,Coppa Italia,3,0,3
3I01FDIL6M93O8KGQH5I7XS0EEKD2C,"Fiorentina have won two Italian Championships , in 1955-56 and again in 1968-69 , as well as winning six Coppa Italia trophies and one Italian Super Cup .",118,126,trophies,3,3,6
3I01FDIL6M93O8KGQH5I7XS0EEKD2C,"Fiorentina are known widely by the nickname Viola , a reference to their distinctive purple colors .",0,10,Fiorentina,0,1,1
3I01FDIL6M93O8KGQH5I7XS0EEKD2C,"Fiorentina are known widely by the nickname Viola , a reference to their distinctive purple colors .",21,27,widely,1,4,5
3I01FDIL6M93O8KGQH5I7XS0EEKD2C,"Fiorentina are known widely by the nickname Viola , a reference to their distinctive purple colors .",35,43,nickname,3,5,8
3I01FDIL6M93O8KGQH5I7XS0EEKD2C,"Fiorentina are known widely by the nickname Viola , a reference to their distinctive purple colors .",54,63,reference,5,0,5
3I01FDIL6M93O8KGQH5I7XS0EEKD2C,"Fiorentina are known widely by the nickname Viola , a reference to their distinctive purple colors .",73,84,distinctive,9,8,17
3I01FDIL6M93O8KGQH5I7XS0EEKD2C,"Fiorentina are known widely by the nickname Viola , a reference to their distinctive purple colors .",85,91,purple,1,1,2
3I01FDIL6M93O8KGQH5I7XS0EEKD2C,A1 Grand Prix ( A1GP ) was a ` single make ' open-wheel auto racing series .,3,13,Grand Prix,1,0,1
3I01FDIL6M93O8KGQH5I7XS0EEKD2C,A1 Grand Prix ( A1GP ) was a ` single make ' open-wheel auto racing series .,31,42,single make,1,3,4
3I01FDIL6M93O8KGQH5I7XS0EEKD2C,A1 Grand Prix ( A1GP ) was a ` single make ' open-wheel auto racing series .,45,55,open-wheel,3,7,10
3I01FDIL6M93O8KGQH5I7XS0EEKD2C,A1 Grand Prix ( A1GP ) was a ` single make ' open-wheel auto racing series .,68,74,series,1,1,2
3I01FDIL6M93O8KGQH5I7XS0EEKD2C,"It was unique in its field in that competitors solely represented their nation as opposed to themselves or a team , the usual format in most formula racing series .",7,13,unique,3,2,5
3I01FDIL6M93O8KGQH5I7XS0EEKD2C,"It was unique in its field in that competitors solely represented their nation as opposed to themselves or a team , the usual format in most formula racing series .",35,46,competitors,6,3,9
3I01FDIL6M93O8KGQH5I7XS0EEKD2C,"It was unique in its field in that competitors solely represented their nation as opposed to themselves or a team , the usual format in most formula racing series .",47,53,solely,3,8,11
3I01FDIL6M93O8KGQH5I7XS0EEKD2C,"It was unique in its field in that competitors solely represented their nation as opposed to themselves or a team , the usual format in most formula racing series .",54,65,represented,4,1,5
3I01FDIL6M93O8KGQH5I7XS0EEKD2C,"It was unique in its field in that competitors solely represented their nation as opposed to themselves or a team , the usual format in most formula racing series .",82,89,opposed,2,0,2
3I01FDIL6M93O8KGQH5I7XS0EEKD2C,"It was unique in its field in that competitors solely represented their nation as opposed to themselves or a team , the usual format in most formula racing series .",120,132,usual format,0,1,1
3I01FDIL6M93O8KGQH5I7XS0EEKD2C,"It was unique in its field in that competitors solely represented their nation as opposed to themselves or a team , the usual format in most formula racing series .",126,132,format,2,1,3
3I01FDIL6M93O8KGQH5I7XS0EEKD2C,"It was unique in its field in that competitors solely represented their nation as opposed to themselves or a team , the usual format in most formula racing series .",141,148,formula,2,0,2
3I01FDIL6M93O8KGQH5I7XS0EEKD2C,"It was unique in its field in that competitors solely represented their nation as opposed to themselves or a team , the usual format in most formula racing series .",141,155,formula racing,0,1,1
3I01FDIL6M93O8KGQH5I7XS0EEKD2C,"It was unique in its field in that competitors solely represented their nation as opposed to themselves or a team , the usual format in most formula racing series .",141,162,formula racing series,1,1,2
3I01FDIL6M93O8KGQH5I7XS0EEKD2C,"The nation-based A1GP concept was founded by Sheikh Maktoum Hasher Maktoum Al Maktoum of Dubai , initially in 2003 .",4,16,nation-based,2,3,5
3I01FDIL6M93O8KGQH5I7XS0EEKD2C,"The nation-based A1GP concept was founded by Sheikh Maktoum Hasher Maktoum Al Maktoum of Dubai , initially in 2003 .",22,29,concept,4,2,6
3I01FDIL6M93O8KGQH5I7XS0EEKD2C,"The nation-based A1GP concept was founded by Sheikh Maktoum Hasher Maktoum Al Maktoum of Dubai , initially in 2003 .",52,59,Maktoum,0,1,1
3I01FDIL6M93O8KGQH5I7XS0EEKD2C,"The nation-based A1GP concept was founded by Sheikh Maktoum Hasher Maktoum Al Maktoum of Dubai , initially in 2003 .",97,106,initially,2,1,3
34ZTTGSNJXP1S7R3EOE9U051MCRHQ3,"The spectrum of the companion GD 165B was very red and enigmatic , showing none of the features expected of a low-mass red dwarf star .",4,12,spectrum,10,10,20
34ZTTGSNJXP1S7R3EOE9U051MCRHQ3,"The spectrum of the companion GD 165B was very red and enigmatic , showing none of the features expected of a low-mass red dwarf star .",20,29,companion,3,1,4
34ZTTGSNJXP1S7R3EOE9U051MCRHQ3,"The spectrum of the companion GD 165B was very red and enigmatic , showing none of the features expected of a low-mass red dwarf star .",55,64,enigmatic,10,10,20
34ZTTGSNJXP1S7R3EOE9U051MCRHQ3,"The spectrum of the companion GD 165B was very red and enigmatic , showing none of the features expected of a low-mass red dwarf star .",87,95,features,0,1,1
34ZTTGSNJXP1S7R3EOE9U051MCRHQ3,"The spectrum of the companion GD 165B was very red and enigmatic , showing none of the features expected of a low-mass red dwarf star .",96,104,expected,1,0,1
34ZTTGSNJXP1S7R3EOE9U051MCRHQ3,"The spectrum of the companion GD 165B was very red and enigmatic , showing none of the features expected of a low-mass red dwarf star .",110,118,low-mass,5,1,6
34ZTTGSNJXP1S7R3EOE9U051MCRHQ3,"The spectrum of the companion GD 165B was very red and enigmatic , showing none of the features expected of a low-mass red dwarf star .",110,133,low-mass red dwarf star,0,1,1
34ZTTGSNJXP1S7R3EOE9U051MCRHQ3,"The spectrum of the companion GD 165B was very red and enigmatic , showing none of the features expected of a low-mass red dwarf star .",119,128,red dwarf,1,0,1
34ZTTGSNJXP1S7R3EOE9U051MCRHQ3,"The spectrum of the companion GD 165B was very red and enigmatic , showing none of the features expected of a low-mass red dwarf star .",119,133,red dwarf star,0,1,1
34ZTTGSNJXP1S7R3EOE9U051MCRHQ3,"The spectrum of the companion GD 165B was very red and enigmatic , showing none of the features expected of a low-mass red dwarf star .",123,128,dwarf,4,6,10
34ZTTGSNJXP1S7R3EOE9U051MCRHQ3,"The spectrum of the companion GD 165B was very red and enigmatic , showing none of the features expected of a low-mass red dwarf star .",123,133,dwarf star,0,2,2
34ZTTGSNJXP1S7R3EOE9U051MCRHQ3,The difference between a very-low-mass brown dwarf and a giant planet ( ~ 13 Jupiter masses ) has been recently debated .,25,38,very-low-mass,2,0,2
34ZTTGSNJXP1S7R3EOE9U051MCRHQ3,The difference between a very-low-mass brown dwarf and a giant planet ( ~ 13 Jupiter masses ) has been recently debated .,25,50,very-low-mass brown dwarf,1,0,1
34ZTTGSNJXP1S7R3EOE9U051MCRHQ3,The difference between a very-low-mass brown dwarf and a giant planet ( ~ 13 Jupiter masses ) has been recently debated .,39,50,brown dwarf,0,1,1
34ZTTGSNJXP1S7R3EOE9U051MCRHQ3,The difference between a very-low-mass brown dwarf and a giant planet ( ~ 13 Jupiter masses ) has been recently debated .,45,50,dwarf,1,1,2
34ZTTGSNJXP1S7R3EOE9U051MCRHQ3,The difference between a very-low-mass brown dwarf and a giant planet ( ~ 13 Jupiter masses ) has been recently debated .,63,69,planet,0,1,1
34ZTTGSNJXP1S7R3EOE9U051MCRHQ3,The difference between a very-low-mass brown dwarf and a giant planet ( ~ 13 Jupiter masses ) has been recently debated .,112,119,debated,5,5,10
34ZTTGSNJXP1S7R3EOE9U051MCRHQ3,Early theories concerning the nature of the lowest-mass stars and the hydrogen-burning limit suggested that a Population I object with a mass less than 0.07 solar masses or a Population II object less than 0.09 solar masses would never go through normal stellar evolution and would become a completely degenerate star ( Kumar 1963 ) .,6,14,theories,6,1,7
34ZTTGSNJXP1S7R3EOE9U051MCRHQ3,Early theories concerning the nature of the lowest-mass stars and the hydrogen-burning limit suggested that a Population I object with a mass less than 0.07 solar masses or a Population II object less than 0.09 solar masses would never go through normal stellar evolution and would become a completely degenerate star ( Kumar 1963 ) .,6,25,theories concerning,1,0,1
34ZTTGSNJXP1S7R3EOE9U051MCRHQ3,Early theories concerning the nature of the lowest-mass stars and the hydrogen-burning limit suggested that a Population I object with a mass less than 0.07 solar masses or a Population II object less than 0.09 solar masses would never go through normal stellar evolution and would become a completely degenerate star ( Kumar 1963 ) .,15,25,concerning,0,1,1
34ZTTGSNJXP1S7R3EOE9U051MCRHQ3,Early theories concerning the nature of the lowest-mass stars and the hydrogen-burning limit suggested that a Population I object with a mass less than 0.07 solar masses or a Population II object less than 0.09 solar masses would never go through normal stellar evolution and would become a completely degenerate star ( Kumar 1963 ) .,44,55,lowest-mass,0,2,2
34ZTTGSNJXP1S7R3EOE9U051MCRHQ3,Early theories concerning the nature of the lowest-mass stars and the hydrogen-burning limit suggested that a Population I object with a mass less than 0.07 solar masses or a Population II object less than 0.09 solar masses would never go through normal stellar evolution and would become a completely degenerate star ( Kumar 1963 ) .,70,86,hydrogen-burning,6,3,9
34ZTTGSNJXP1S7R3EOE9U051MCRHQ3,Early theories concerning the nature of the lowest-mass stars and the hydrogen-burning limit suggested that a Population I object with a mass less than 0.07 solar masses or a Population II object less than 0.09 solar masses would never go through normal stellar evolution and would become a completely degenerate star ( Kumar 1963 ) .,70,92,hydrogen-burning limit,1,0,1
34ZTTGSNJXP1S7R3EOE9U051MCRHQ3,Early theories concerning the nature of the lowest-mass stars and the hydrogen-burning limit suggested that a Population I object with a mass less than 0.07 solar masses or a Population II object less than 0.09 solar masses would never go through normal stellar evolution and would become a completely degenerate star ( Kumar 1963 ) .,93,102,suggested,0,1,1
34ZTTGSNJXP1S7R3EOE9U051MCRHQ3,Early theories concerning the nature of the lowest-mass stars and the hydrogen-burning limit suggested that a Population I object with a mass less than 0.07 solar masses or a Population II object less than 0.09 solar masses would never go through normal stellar evolution and would become a completely degenerate star ( Kumar 1963 ) .,110,129,Population I object,1,0,1
34ZTTGSNJXP1S7R3EOE9U051MCRHQ3,Early theories concerning the nature of the lowest-mass stars and the hydrogen-burning limit suggested that a Population I object with a mass less than 0.07 solar masses or a Population II object less than 0.09 solar masses would never go through normal stellar evolution and would become a completely degenerate star ( Kumar 1963 ) .,157,169,solar masses,1,0,1
34ZTTGSNJXP1S7R3EOE9U051MCRHQ3,Early theories concerning the nature of the lowest-mass stars and the hydrogen-burning limit suggested that a Population I object with a mass less than 0.07 solar masses or a Population II object less than 0.09 solar masses would never go through normal stellar evolution and would become a completely degenerate star ( Kumar 1963 ) .,175,185,Population,1,0,1
34ZTTGSNJXP1S7R3EOE9U051MCRHQ3,Early theories concerning the nature of the lowest-mass stars and the hydrogen-burning limit suggested that a Population I object with a mass less than 0.07 solar masses or a Population II object less than 0.09 solar masses would never go through normal stellar evolution and would become a completely degenerate star ( Kumar 1963 ) .,211,223,solar masses,2,0,2
34ZTTGSNJXP1S7R3EOE9U051MCRHQ3,Early theories concerning the nature of the lowest-mass stars and the hydrogen-burning limit suggested that a Population I object with a mass less than 0.07 solar masses or a Population II object less than 0.09 solar masses would never go through normal stellar evolution and would become a completely degenerate star ( Kumar 1963 ) .,247,271,normal stellar evolution,1,0,1
34ZTTGSNJXP1S7R3EOE9U051MCRHQ3,Early theories concerning the nature of the lowest-mass stars and the hydrogen-burning limit suggested that a Population I object with a mass less than 0.07 solar masses or a Population II object less than 0.09 solar masses would never go through normal stellar evolution and would become a completely degenerate star ( Kumar 1963 ) .,254,261,stellar,3,5,8
34ZTTGSNJXP1S7R3EOE9U051MCRHQ3,Early theories concerning the nature of the lowest-mass stars and the hydrogen-burning limit suggested that a Population I object with a mass less than 0.07 solar masses or a Population II object less than 0.09 solar masses would never go through normal stellar evolution and would become a completely degenerate star ( Kumar 1963 ) .,254,271,stellar evolution,3,1,4
34ZTTGSNJXP1S7R3EOE9U051MCRHQ3,Early theories concerning the nature of the lowest-mass stars and the hydrogen-burning limit suggested that a Population I object with a mass less than 0.07 solar masses or a Population II object less than 0.09 solar masses would never go through normal stellar evolution and would become a completely degenerate star ( Kumar 1963 ) .,262,271,evolution,2,2,4
34ZTTGSNJXP1S7R3EOE9U051MCRHQ3,Early theories concerning the nature of the lowest-mass stars and the hydrogen-burning limit suggested that a Population I object with a mass less than 0.07 solar masses or a Population II object less than 0.09 solar masses would never go through normal stellar evolution and would become a completely degenerate star ( Kumar 1963 ) .,302,312,degenerate,10,7,17
34ZTTGSNJXP1S7R3EOE9U051MCRHQ3,Early theories concerning the nature of the lowest-mass stars and the hydrogen-burning limit suggested that a Population I object with a mass less than 0.07 solar masses or a Population II object less than 0.09 solar masses would never go through normal stellar evolution and would become a completely degenerate star ( Kumar 1963 ) .,302,317,degenerate star,1,1,2
34ZTTGSNJXP1S7R3EOE9U051MCRHQ3,"True stars burn their lithium within a little over 100 Myr , whereas brown dwarfs ( which can , confusingly , have temperatures and luminosities similar to true stars ) will not .",22,29,lithium,7,2,9
34ZTTGSNJXP1S7R3EOE9U051MCRHQ3,"True stars burn their lithium within a little over 100 Myr , whereas brown dwarfs ( which can , confusingly , have temperatures and luminosities similar to true stars ) will not .",55,58,Myr,1,1,2
34ZTTGSNJXP1S7R3EOE9U051MCRHQ3,"True stars burn their lithium within a little over 100 Myr , whereas brown dwarfs ( which can , confusingly , have temperatures and luminosities similar to true stars ) will not .",61,68,whereas,1,0,1
34ZTTGSNJXP1S7R3EOE9U051MCRHQ3,"True stars burn their lithium within a little over 100 Myr , whereas brown dwarfs ( which can , confusingly , have temperatures and luminosities similar to true stars ) will not .",69,81,brown dwarfs,0,2,2
34ZTTGSNJXP1S7R3EOE9U051MCRHQ3,"True stars burn their lithium within a little over 100 Myr , whereas brown dwarfs ( which can , confusingly , have temperatures and luminosities similar to true stars ) will not .",96,107,confusingly,1,4,5
34ZTTGSNJXP1S7R3EOE9U051MCRHQ3,"True stars burn their lithium within a little over 100 Myr , whereas brown dwarfs ( which can , confusingly , have temperatures and luminosities similar to true stars ) will not .",132,144,luminosities,10,10,20
34KYK9TV2R93EA3U60TI3PH49N7SBN,"It was located in central Tasmania , and was named after Sir John Eardley-Wilmot , the sixth Lieutenant-Governor of Tasmania .",26,34,Tasmania,1,0,1
34KYK9TV2R93EA3U60TI3PH49N7SBN,"It was located in central Tasmania , and was named after Sir John Eardley-Wilmot , the sixth Lieutenant-Governor of Tasmania .",45,56,named after,0,1,1
34KYK9TV2R93EA3U60TI3PH49N7SBN,"It was located in central Tasmania , and was named after Sir John Eardley-Wilmot , the sixth Lieutenant-Governor of Tasmania .",66,80,Eardley-Wilmot,1,0,1
34KYK9TV2R93EA3U60TI3PH49N7SBN,"It was located in central Tasmania , and was named after Sir John Eardley-Wilmot , the sixth Lieutenant-Governor of Tasmania .",93,112,Lieutenant-Governor,4,2,6
34KYK9TV2R93EA3U60TI3PH49N7SBN,"It was located in central Tasmania , and was named after Sir John Eardley-Wilmot , the sixth Lieutenant-Governor of Tasmania .",93,124,Lieutenant-Governor of Tasmania,1,0,1
34KYK9TV2R93EA3U60TI3PH49N7SBN,"At various times it included the towns of Deloraine , Beaconsfield , Devonport , Latrobe , and New Norfolk .",3,10,various,1,0,1
34KYK9TV2R93EA3U60TI3PH49N7SBN,"At various times it included the towns of Deloraine , Beaconsfield , Devonport , Latrobe , and New Norfolk .",3,16,various times,1,0,1
34KYK9TV2R93EA3U60TI3PH49N7SBN,"At various times it included the towns of Deloraine , Beaconsfield , Devonport , Latrobe , and New Norfolk .",42,51,Deloraine,1,0,1
34KYK9TV2R93EA3U60TI3PH49N7SBN,"At various times it included the towns of Deloraine , Beaconsfield , Devonport , Latrobe , and New Norfolk .",54,66,Beaconsfield,1,0,1
34KYK9TV2R93EA3U60TI3PH49N7SBN,"At various times it included the towns of Deloraine , Beaconsfield , Devonport , Latrobe , and New Norfolk .",69,78,Devonport,1,0,1
34KYK9TV2R93EA3U60TI3PH49N7SBN,"At various times it included the towns of Deloraine , Beaconsfield , Devonport , Latrobe , and New Norfolk .",81,88,Latrobe,1,0,1
34KYK9TV2R93EA3U60TI3PH49N7SBN,"At various times it included the towns of Deloraine , Beaconsfield , Devonport , Latrobe , and New Norfolk .",99,106,Norfolk,1,0,1
34KYK9TV2R93EA3U60TI3PH49N7SBN,The stretch of DNA transcribed into an RNA molecule is called a transcription unit and encodes at least one gene .,4,11,stretch,3,2,5
34KYK9TV2R93EA3U60TI3PH49N7SBN,The stretch of DNA transcribed into an RNA molecule is called a transcription unit and encodes at least one gene .,15,18,DNA,2,0,2
34KYK9TV2R93EA3U60TI3PH49N7SBN,The stretch of DNA transcribed into an RNA molecule is called a transcription unit and encodes at least one gene .,15,51,DNA transcribed into an RNA molecule,1,0,1
34KYK9TV2R93EA3U60TI3PH49N7SBN,The stretch of DNA transcribed into an RNA molecule is called a transcription unit and encodes at least one gene .,19,30,transcribed,4,7,11
34KYK9TV2R93EA3U60TI3PH49N7SBN,The stretch of DNA transcribed into an RNA molecule is called a transcription unit and encodes at least one gene .,39,42,RNA,1,0,1
34KYK9TV2R93EA3U60TI3PH49N7SBN,The stretch of DNA transcribed into an RNA molecule is called a transcription unit and encodes at least one gene .,43,51,molecule,8,3,11
34KYK9TV2R93EA3U60TI3PH49N7SBN,The stretch of DNA transcribed into an RNA molecule is called a transcription unit and encodes at least one gene .,64,77,transcription,6,3,9
34KYK9TV2R93EA3U60TI3PH49N7SBN,The stretch of DNA transcribed into an RNA molecule is called a transcription unit and encodes at least one gene .,64,82,transcription unit,2,0,2
34KYK9TV2R93EA3U60TI3PH49N7SBN,The stretch of DNA transcribed into an RNA molecule is called a transcription unit and encodes at least one gene .,87,94,encodes,9,7,16
34KYK9TV2R93EA3U60TI3PH49N7SBN,The stretch of DNA transcribed into an RNA molecule is called a transcription unit and encodes at least one gene .,108,112,gene,4,1,5
34KYK9TV2R93EA3U60TI3PH49N7SBN,"The other DNA strand ( the non-template strand ) is called the coding strand , because its sequence is the same as the newly created RNA transcript ( except for the substitution of uracil for thymine ) .",14,20,strand,3,3,6
34KYK9TV2R93EA3U60TI3PH49N7SBN,"The other DNA strand ( the non-template strand ) is called the coding strand , because its sequence is the same as the newly created RNA transcript ( except for the substitution of uracil for thymine ) .",27,39,non-template,3,2,5
34KYK9TV2R93EA3U60TI3PH49N7SBN,"The other DNA strand ( the non-template strand ) is called the coding strand , because its sequence is the same as the newly created RNA transcript ( except for the substitution of uracil for thymine ) .",27,46,non-template strand,1,1,2
34KYK9TV2R93EA3U60TI3PH49N7SBN,"The other DNA strand ( the non-template strand ) is called the coding strand , because its sequence is the same as the newly created RNA transcript ( except for the substitution of uracil for thymine ) .",40,46,strand,0,3,3
34KYK9TV2R93EA3U60TI3PH49N7SBN,"The other DNA strand ( the non-template strand ) is called the coding strand , because its sequence is the same as the newly created RNA transcript ( except for the substitution of uracil for thymine ) .",63,76,coding strand,3,1,4
34KYK9TV2R93EA3U60TI3PH49N7SBN,"The other DNA strand ( the non-template strand ) is called the coding strand , because its sequence is the same as the newly created RNA transcript ( except for the substitution of uracil for thymine ) .",70,76,strand,0,1,1
34KYK9TV2R93EA3U60TI3PH49N7SBN,"The other DNA strand ( the non-template strand ) is called the coding strand , because its sequence is the same as the newly created RNA transcript ( except for the substitution of uracil for thymine ) .",91,99,sequence,5,5,10
34KYK9TV2R93EA3U60TI3PH49N7SBN,"The other DNA strand ( the non-template strand ) is called the coding strand , because its sequence is the same as the newly created RNA transcript ( except for the substitution of uracil for thymine ) .",119,124,newly,0,1,1
34KYK9TV2R93EA3U60TI3PH49N7SBN,"The other DNA strand ( the non-template strand ) is called the coding strand , because its sequence is the same as the newly created RNA transcript ( except for the substitution of uracil for thymine ) .",137,147,transcript,3,3,6
34KYK9TV2R93EA3U60TI3PH49N7SBN,"The other DNA strand ( the non-template strand ) is called the coding strand , because its sequence is the same as the newly created RNA transcript ( except for the substitution of uracil for thymine ) .",165,177,substitution,3,3,6
34KYK9TV2R93EA3U60TI3PH49N7SBN,"The other DNA strand ( the non-template strand ) is called the coding strand , because its sequence is the same as the newly created RNA transcript ( except for the substitution of uracil for thymine ) .",165,199,substitution of uracil for thymine,1,0,1
34KYK9TV2R93EA3U60TI3PH49N7SBN,"The other DNA strand ( the non-template strand ) is called the coding strand , because its sequence is the same as the newly created RNA transcript ( except for the substitution of uracil for thymine ) .",181,187,uracil,3,2,5
34KYK9TV2R93EA3U60TI3PH49N7SBN,"The other DNA strand ( the non-template strand ) is called the coding strand , because its sequence is the same as the newly created RNA transcript ( except for the substitution of uracil for thymine ) .",192,199,thymine,5,2,7
34KYK9TV2R93EA3U60TI3PH49N7SBN,"During transcription , a DNA sequence is read by an RNA polymerase , which produces a complementary , antiparallel RNA strand called a primary transcript .",7,20,transcription,2,1,3
34KYK9TV2R93EA3U60TI3PH49N7SBN,"During transcription , a DNA sequence is read by an RNA polymerase , which produces a complementary , antiparallel RNA strand called a primary transcript .",29,37,sequence,3,0,3
34KYK9TV2R93EA3U60TI3PH49N7SBN,"During transcription , a DNA sequence is read by an RNA polymerase , which produces a complementary , antiparallel RNA strand called a primary transcript .",52,66,RNA polymerase,2,1,3
34KYK9TV2R93EA3U60TI3PH49N7SBN,"During transcription , a DNA sequence is read by an RNA polymerase , which produces a complementary , antiparallel RNA strand called a primary transcript .",56,66,polymerase,10,2,12
34KYK9TV2R93EA3U60TI3PH49N7SBN,"During transcription , a DNA sequence is read by an RNA polymerase , which produces a complementary , antiparallel RNA strand called a primary transcript .",86,99,complementary,5,6,11
34KYK9TV2R93EA3U60TI3PH49N7SBN,"During transcription , a DNA sequence is read by an RNA polymerase , which produces a complementary , antiparallel RNA strand called a primary transcript .",102,114,antiparallel,10,9,19
34KYK9TV2R93EA3U60TI3PH49N7SBN,"During transcription , a DNA sequence is read by an RNA polymerase , which produces a complementary , antiparallel RNA strand called a primary transcript .",133,153,a primary transcript,1,0,1
34KYK9TV2R93EA3U60TI3PH49N7SBN,"During transcription , a DNA sequence is read by an RNA polymerase , which produces a complementary , antiparallel RNA strand called a primary transcript .",135,153,primary transcript,1,0,1
34KYK9TV2R93EA3U60TI3PH49N7SBN,"During transcription , a DNA sequence is read by an RNA polymerase , which produces a complementary , antiparallel RNA strand called a primary transcript .",143,153,transcript,2,0,2
3S8APUMBJXKUA5Y80GTJWQYPKXDFBR,Alchemical symbolism has been used by psychologists such as Carl Jung who reexamined alchemical symbolism and theory and presented the inner meaning of alchemical work as a spiritual path .,0,10,Alchemical,7,5,12
3S8APUMBJXKUA5Y80GTJWQYPKXDFBR,Alchemical symbolism has been used by psychologists such as Carl Jung who reexamined alchemical symbolism and theory and presented the inner meaning of alchemical work as a spiritual path .,0,20,Alchemical symbolism,5,2,7
3S8APUMBJXKUA5Y80GTJWQYPKXDFBR,Alchemical symbolism has been used by psychologists such as Carl Jung who reexamined alchemical symbolism and theory and presented the inner meaning of alchemical work as a spiritual path .,11,20,symbolism,4,5,9
3S8APUMBJXKUA5Y80GTJWQYPKXDFBR,Alchemical symbolism has been used by psychologists such as Carl Jung who reexamined alchemical symbolism and theory and presented the inner meaning of alchemical work as a spiritual path .,38,51,psychologists,8,6,14
3S8APUMBJXKUA5Y80GTJWQYPKXDFBR,Alchemical symbolism has been used by psychologists such as Carl Jung who reexamined alchemical symbolism and theory and presented the inner meaning of alchemical work as a spiritual path .,74,84,reexamined,6,4,10
3S8APUMBJXKUA5Y80GTJWQYPKXDFBR,Alchemical symbolism has been used by psychologists such as Carl Jung who reexamined alchemical symbolism and theory and presented the inner meaning of alchemical work as a spiritual path .,85,95,alchemical,2,2,4
3S8APUMBJXKUA5Y80GTJWQYPKXDFBR,Alchemical symbolism has been used by psychologists such as Carl Jung who reexamined alchemical symbolism and theory and presented the inner meaning of alchemical work as a spiritual path .,96,105,symbolism,3,0,3
3S8APUMBJXKUA5Y80GTJWQYPKXDFBR,Alchemical symbolism has been used by psychologists such as Carl Jung who reexamined alchemical symbolism and theory and presented the inner meaning of alchemical work as a spiritual path .,110,116,theory,3,0,3
3S8APUMBJXKUA5Y80GTJWQYPKXDFBR,Alchemical symbolism has been used by psychologists such as Carl Jung who reexamined alchemical symbolism and theory and presented the inner meaning of alchemical work as a spiritual path .,135,140,inner,0,2,2
3S8APUMBJXKUA5Y80GTJWQYPKXDFBR,Alchemical symbolism has been used by psychologists such as Carl Jung who reexamined alchemical symbolism and theory and presented the inner meaning of alchemical work as a spiritual path .,135,148,inner meaning,1,0,1
3S8APUMBJXKUA5Y80GTJWQYPKXDFBR,Alchemical symbolism has been used by psychologists such as Carl Jung who reexamined alchemical symbolism and theory and presented the inner meaning of alchemical work as a spiritual path .,173,182,spiritual,4,3,7
3S8APUMBJXKUA5Y80GTJWQYPKXDFBR,Alchemical symbolism has been used by psychologists such as Carl Jung who reexamined alchemical symbolism and theory and presented the inner meaning of alchemical work as a spiritual path .,173,187,spiritual path,1,1,2
3S8APUMBJXKUA5Y80GTJWQYPKXDFBR,Alchemical symbolism has been used by psychologists such as Carl Jung who reexamined alchemical symbolism and theory and presented the inner meaning of alchemical work as a spiritual path .,183,187,path,0,2,2
3S8APUMBJXKUA5Y80GTJWQYPKXDFBR,"The plot was originally taken from - but partly altered for better conformity - Ludovico Ariosto 's Orlando furioso ( like those of the Handel operas Orlando and Ariodante ) , an epic poem set in the time of Charlemagne 's wars against Islam .",4,8,plot,0,1,1
3S8APUMBJXKUA5Y80GTJWQYPKXDFBR,"The plot was originally taken from - but partly altered for better conformity - Ludovico Ariosto 's Orlando furioso ( like those of the Handel operas Orlando and Ariodante ) , an epic poem set in the time of Charlemagne 's wars against Islam .",48,55,altered,4,4,8
3S8APUMBJXKUA5Y80GTJWQYPKXDFBR,"The plot was originally taken from - but partly altered for better conformity - Ludovico Ariosto 's Orlando furioso ( like those of the Handel operas Orlando and Ariodante ) , an epic poem set in the time of Charlemagne 's wars against Islam .",67,77,conformity,6,8,14
3S8APUMBJXKUA5Y80GTJWQYPKXDFBR,"The plot was originally taken from - but partly altered for better conformity - Ludovico Ariosto 's Orlando furioso ( like those of the Handel operas Orlando and Ariodante ) , an epic poem set in the time of Charlemagne 's wars against Islam .",108,115,furioso,1,1,2
3S8APUMBJXKUA5Y80GTJWQYPKXDFBR,"The plot was originally taken from - but partly altered for better conformity - Ludovico Ariosto 's Orlando furioso ( like those of the Handel operas Orlando and Ariodante ) , an epic poem set in the time of Charlemagne 's wars against Islam .",162,171,Ariodante,0,1,1
3S8APUMBJXKUA5Y80GTJWQYPKXDFBR,"The plot was originally taken from - but partly altered for better conformity - Ludovico Ariosto 's Orlando furioso ( like those of the Handel operas Orlando and Ariodante ) , an epic poem set in the time of Charlemagne 's wars against Islam .",179,183,epic,1,3,4
3S8APUMBJXKUA5Y80GTJWQYPKXDFBR,"The plot was originally taken from - but partly altered for better conformity - Ludovico Ariosto 's Orlando furioso ( like those of the Handel operas Orlando and Ariodante ) , an epic poem set in the time of Charlemagne 's wars against Islam .",179,188,epic poem,1,1,2
3S8APUMBJXKUA5Y80GTJWQYPKXDFBR,"The plot was originally taken from - but partly altered for better conformity - Ludovico Ariosto 's Orlando furioso ( like those of the Handel operas Orlando and Ariodante ) , an epic poem set in the time of Charlemagne 's wars against Islam .",208,219,Charlemagne,1,0,1
3S8APUMBJXKUA5Y80GTJWQYPKXDFBR,"The plot was originally taken from - but partly altered for better conformity - Ludovico Ariosto 's Orlando furioso ( like those of the Handel operas Orlando and Ariodante ) , an epic poem set in the time of Charlemagne 's wars against Islam .",208,221,Charlemagne s,0,1,1
3S8APUMBJXKUA5Y80GTJWQYPKXDFBR,"The plot was originally taken from - but partly altered for better conformity - Ludovico Ariosto 's Orlando furioso ( like those of the Handel operas Orlando and Ariodante ) , an epic poem set in the time of Charlemagne 's wars against Islam .",236,241,Islam,1,0,1
3S8APUMBJXKUA5Y80GTJWQYPKXDFBR,The opera contains several musical sequences with opportunity for dance : these were composed for dancer Marie Sallé .,4,9,opera,0,3,3
3S8APUMBJXKUA5Y80GTJWQYPKXDFBR,The opera contains several musical sequences with opportunity for dance : these were composed for dancer Marie Sallé .,27,44,musical sequences,1,1,2
3S8APUMBJXKUA5Y80GTJWQYPKXDFBR,The opera contains several musical sequences with opportunity for dance : these were composed for dancer Marie Sallé .,35,44,sequences,8,3,11
3S8APUMBJXKUA5Y80GTJWQYPKXDFBR,The opera contains several musical sequences with opportunity for dance : these were composed for dancer Marie Sallé .,50,61,opportunity,2,1,3
3S8APUMBJXKUA5Y80GTJWQYPKXDFBR,The opera contains several musical sequences with opportunity for dance : these were composed for dancer Marie Sallé .,85,93,composed,0,2,2
3S8APUMBJXKUA5Y80GTJWQYPKXDFBR,The Australian soprano Joan Sutherland sang the role in a production by Franco Zeffirelli in which she made her debut at La Fenice in February 1960 and at the Dallas Opera in November of that year .,15,22,soprano,6,2,8
3S8APUMBJXKUA5Y80GTJWQYPKXDFBR,The Australian soprano Joan Sutherland sang the role in a production by Franco Zeffirelli in which she made her debut at La Fenice in February 1960 and at the Dallas Opera in November of that year .,39,43,sang,0,1,1
3S8APUMBJXKUA5Y80GTJWQYPKXDFBR,The Australian soprano Joan Sutherland sang the role in a production by Franco Zeffirelli in which she made her debut at La Fenice in February 1960 and at the Dallas Opera in November of that year .,58,68,production,0,1,1
3S8APUMBJXKUA5Y80GTJWQYPKXDFBR,The Australian soprano Joan Sutherland sang the role in a production by Franco Zeffirelli in which she made her debut at La Fenice in February 1960 and at the Dallas Opera in November of that year .,79,89,Zeffirelli,1,0,1
3S8APUMBJXKUA5Y80GTJWQYPKXDFBR,The Australian soprano Joan Sutherland sang the role in a production by Franco Zeffirelli in which she made her debut at La Fenice in February 1960 and at the Dallas Opera in November of that year .,112,117,debut,4,7,11
308KJXFUJR7ZA0BHPMYCIJTKTO0ATZ,"These mountain chains are separated from each other by several tributaries of the Rhine : the Mosel , the Lahn , and the Nahe .",6,21,mountain chains,3,0,3
308KJXFUJR7ZA0BHPMYCIJTKTO0ATZ,"These mountain chains are separated from each other by several tributaries of the Rhine : the Mosel , the Lahn , and the Nahe .",15,21,chains,1,2,3
308KJXFUJR7ZA0BHPMYCIJTKTO0ATZ,"These mountain chains are separated from each other by several tributaries of the Rhine : the Mosel , the Lahn , and the Nahe .",26,35,separated,1,0,1
308KJXFUJR7ZA0BHPMYCIJTKTO0ATZ,"These mountain chains are separated from each other by several tributaries of the Rhine : the Mosel , the Lahn , and the Nahe .",55,74,several tributaries,1,0,1
308KJXFUJR7ZA0BHPMYCIJTKTO0ATZ,"These mountain chains are separated from each other by several tributaries of the Rhine : the Mosel , the Lahn , and the Nahe .",63,74,tributaries,10,10,20
308KJXFUJR7ZA0BHPMYCIJTKTO0ATZ,"Located in western Germany , the Rhineland-Palatinate borders ( from the north and clockwise ) the German Bundesländer North Rhine-Westphalia , Hesse , and Baden-Württemberg .",33,53,Rhineland-Palatinate,4,1,5
308KJXFUJR7ZA0BHPMYCIJTKTO0ATZ,"Located in western Germany , the Rhineland-Palatinate borders ( from the north and clockwise ) the German Bundesländer North Rhine-Westphalia , Hesse , and Baden-Württemberg .",54,61,borders,1,0,1
308KJXFUJR7ZA0BHPMYCIJTKTO0ATZ,"Located in western Germany , the Rhineland-Palatinate borders ( from the north and clockwise ) the German Bundesländer North Rhine-Westphalia , Hesse , and Baden-Württemberg .",83,92,clockwise,2,4,6
308KJXFUJR7ZA0BHPMYCIJTKTO0ATZ,"Located in western Germany , the Rhineland-Palatinate borders ( from the north and clockwise ) the German Bundesländer North Rhine-Westphalia , Hesse , and Baden-Württemberg .",106,118,Bundesländer,2,0,2
308KJXFUJR7ZA0BHPMYCIJTKTO0ATZ,"Located in western Germany , the Rhineland-Palatinate borders ( from the north and clockwise ) the German Bundesländer North Rhine-Westphalia , Hesse , and Baden-Württemberg .",156,173,Baden-Württemberg,3,0,3
308KJXFUJR7ZA0BHPMYCIJTKTO0ATZ,The Rhine Valley is bounded by mountain chains and it containins several of the historically significant places in Germany .,20,27,bounded,2,4,6
308KJXFUJR7ZA0BHPMYCIJTKTO0ATZ,The Rhine Valley is bounded by mountain chains and it containins several of the historically significant places in Germany .,54,64,containins,3,1,4
308KJXFUJR7ZA0BHPMYCIJTKTO0ATZ,The Rhine Valley is bounded by mountain chains and it containins several of the historically significant places in Germany .,80,92,historically,3,0,3
308KJXFUJR7ZA0BHPMYCIJTKTO0ATZ,The Rhine Valley is bounded by mountain chains and it containins several of the historically significant places in Germany .,80,104,historically significant,2,1,3
308KJXFUJR7ZA0BHPMYCIJTKTO0ATZ,The Rhine Valley is bounded by mountain chains and it containins several of the historically significant places in Germany .,80,111,historically significant places,1,0,1
308KJXFUJR7ZA0BHPMYCIJTKTO0ATZ,The Rhine Valley is bounded by mountain chains and it containins several of the historically significant places in Germany .,93,104,significant,5,2,7
308KJXFUJR7ZA0BHPMYCIJTKTO0ATZ,"Pygmalion is a play by George Bernard Shaw , named after a Greek mythological character .",0,9,Pygmalion,5,3,8
308KJXFUJR7ZA0BHPMYCIJTKTO0ATZ,"Pygmalion is a play by George Bernard Shaw , named after a Greek mythological character .",59,87,Greek mythological character,1,0,1
308KJXFUJR7ZA0BHPMYCIJTKTO0ATZ,"Pygmalion is a play by George Bernard Shaw , named after a Greek mythological character .",65,77,mythological,10,7,17
308KJXFUJR7ZA0BHPMYCIJTKTO0ATZ,"Pygmalion is a play by George Bernard Shaw , named after a Greek mythological character .",65,87,mythological character,2,1,3
308KJXFUJR7ZA0BHPMYCIJTKTO0ATZ,"Santiago de Cuba province has been the site of many battles , both during the war for independence and the 1959 Cuban Revolution , where much of the guerrilla fighting took place in the mountainous province .",17,25,province,1,2,3
308KJXFUJR7ZA0BHPMYCIJTKTO0ATZ,"Santiago de Cuba province has been the site of many battles , both during the war for independence and the 1959 Cuban Revolution , where much of the guerrilla fighting took place in the mountainous province .",39,43,site,0,1,1
308KJXFUJR7ZA0BHPMYCIJTKTO0ATZ,"Santiago de Cuba province has been the site of many battles , both during the war for independence and the 1959 Cuban Revolution , where much of the guerrilla fighting took place in the mountainous province .",52,59,battles,0,1,1
308KJXFUJR7ZA0BHPMYCIJTKTO0ATZ,"Santiago de Cuba province has been the site of many battles , both during the war for independence and the 1959 Cuban Revolution , where much of the guerrilla fighting took place in the mountainous province .",86,98,independence,2,3,5
308KJXFUJR7ZA0BHPMYCIJTKTO0ATZ,"Santiago de Cuba province has been the site of many battles , both during the war for independence and the 1959 Cuban Revolution , where much of the guerrilla fighting took place in the mountainous province .",118,128,Revolution,2,2,4
308KJXFUJR7ZA0BHPMYCIJTKTO0ATZ,"Santiago de Cuba province has been the site of many battles , both during the war for independence and the 1959 Cuban Revolution , where much of the guerrilla fighting took place in the mountainous province .",149,158,guerrilla,10,5,15
308KJXFUJR7ZA0BHPMYCIJTKTO0ATZ,"Santiago de Cuba province has been the site of many battles , both during the war for independence and the 1959 Cuban Revolution , where much of the guerrilla fighting took place in the mountainous province .",149,167,guerrilla fighting,4,1,5
308KJXFUJR7ZA0BHPMYCIJTKTO0ATZ,"Santiago de Cuba province has been the site of many battles , both during the war for independence and the 1959 Cuban Revolution , where much of the guerrilla fighting took place in the mountainous province .",159,167,fighting,0,2,2
308KJXFUJR7ZA0BHPMYCIJTKTO0ATZ,"Santiago de Cuba province has been the site of many battles , both during the war for independence and the 1959 Cuban Revolution , where much of the guerrilla fighting took place in the mountainous province .",186,197,mountainous,0,3,3
308KJXFUJR7ZA0BHPMYCIJTKTO0ATZ,"Santiago de Cuba province has been the site of many battles , both during the war for independence and the 1959 Cuban Revolution , where much of the guerrilla fighting took place in the mountainous province .",186,206,mountainous province,2,1,3
308KJXFUJR7ZA0BHPMYCIJTKTO0ATZ,"Santiago de Cuba province has been the site of many battles , both during the war for independence and the 1959 Cuban Revolution , where much of the guerrilla fighting took place in the mountainous province .",198,206,province,3,0,3
308KJXFUJR7ZA0BHPMYCIJTKTO0ATZ,Santiago de Cuba Province is the second most populated province in the island of Cuba .,0,8,Santiago,0,1,1
308KJXFUJR7ZA0BHPMYCIJTKTO0ATZ,Santiago de Cuba Province is the second most populated province in the island of Cuba .,17,25,Province,1,0,1
308KJXFUJR7ZA0BHPMYCIJTKTO0ATZ,Santiago de Cuba Province is the second most populated province in the island of Cuba .,33,54,second most populated,1,0,1
308KJXFUJR7ZA0BHPMYCIJTKTO0ATZ,Santiago de Cuba Province is the second most populated province in the island of Cuba .,45,54,populated,2,3,5
3ZUE82NE0A2B8701X4995O8OCRS8FL,"It occurs as far east as India and western Saudi Arabia , and as far west as the Canary Islands and Azores .",3,9,occurs,1,0,1
3ZUE82NE0A2B8701X4995O8OCRS8FL,"It occurs as far east as India and western Saudi Arabia , and as far west as the Canary Islands and Azores .",13,21,far east,0,1,1
3ZUE82NE0A2B8701X4995O8OCRS8FL,"It occurs as far east as India and western Saudi Arabia , and as far west as the Canary Islands and Azores .",65,73,far west,0,1,1
3ZUE82NE0A2B8701X4995O8OCRS8FL,"It occurs as far east as India and western Saudi Arabia , and as far west as the Canary Islands and Azores .",81,87,Canary,0,1,1
3ZUE82NE0A2B8701X4995O8OCRS8FL,"It occurs as far east as India and western Saudi Arabia , and as far west as the Canary Islands and Azores .",81,95,Canary Islands,1,0,1
3ZUE82NE0A2B8701X4995O8OCRS8FL,"It occurs as far east as India and western Saudi Arabia , and as far west as the Canary Islands and Azores .",100,106,Azores,1,1,2
3ZUE82NE0A2B8701X4995O8OCRS8FL,"There are several generations of Acherontia atropos per year , with continuous broods in Africa .",18,29,generations,3,3,6
3ZUE82NE0A2B8701X4995O8OCRS8FL,"There are several generations of Acherontia atropos per year , with continuous broods in Africa .",33,43,Acherontia,2,0,2
3ZUE82NE0A2B8701X4995O8OCRS8FL,"There are several generations of Acherontia atropos per year , with continuous broods in Africa .",33,51,Acherontia atropos,5,2,7
3ZUE82NE0A2B8701X4995O8OCRS8FL,"There are several generations of Acherontia atropos per year , with continuous broods in Africa .",44,51,atropos,5,4,9
3ZUE82NE0A2B8701X4995O8OCRS8FL,"There are several generations of Acherontia atropos per year , with continuous broods in Africa .",68,78,continuous,3,2,5
3ZUE82NE0A2B8701X4995O8OCRS8FL,"There are several generations of Acherontia atropos per year , with continuous broods in Africa .",68,85,continuous broods,1,1,2
3ZUE82NE0A2B8701X4995O8OCRS8FL,"There are several generations of Acherontia atropos per year , with continuous broods in Africa .",79,85,broods,6,10,16
3ZUE82NE0A2B8701X4995O8OCRS8FL,"Eggs are laid singly under old leaves of Solanaceae : potato especially , but also Physalis and other nightshades .",14,20,singly,0,5,5
3ZUE82NE0A2B8701X4995O8OCRS8FL,"Eggs are laid singly under old leaves of Solanaceae : potato especially , but also Physalis and other nightshades .",41,51,Solanaceae,6,3,9
3ZUE82NE0A2B8701X4995O8OCRS8FL,"Eggs are laid singly under old leaves of Solanaceae : potato especially , but also Physalis and other nightshades .",83,91,Physalis,6,2,8
3ZUE82NE0A2B8701X4995O8OCRS8FL,"Eggs are laid singly under old leaves of Solanaceae : potato especially , but also Physalis and other nightshades .",102,113,nightshades,6,9,15
3ZUE82NE0A2B8701X4995O8OCRS8FL,"The newly-hatched larva starts out a light shade of green but darkens after feeding , with yellow stripes diagonally on the sides .",4,17,newly-hatched,3,6,9
3ZUE82NE0A2B8701X4995O8OCRS8FL,"The newly-hatched larva starts out a light shade of green but darkens after feeding , with yellow stripes diagonally on the sides .",4,23,newly-hatched larva,1,0,1
3ZUE82NE0A2B8701X4995O8OCRS8FL,"The newly-hatched larva starts out a light shade of green but darkens after feeding , with yellow stripes diagonally on the sides .",18,23,larva,5,3,8
3ZUE82NE0A2B8701X4995O8OCRS8FL,"The newly-hatched larva starts out a light shade of green but darkens after feeding , with yellow stripes diagonally on the sides .",98,105,stripes,1,2,3
3ZUE82NE0A2B8701X4995O8OCRS8FL,"The newly-hatched larva starts out a light shade of green but darkens after feeding , with yellow stripes diagonally on the sides .",98,116,stripes diagonally,0,1,1
3ZUE82NE0A2B8701X4995O8OCRS8FL,"The newly-hatched larva starts out a light shade of green but darkens after feeding , with yellow stripes diagonally on the sides .",106,116,diagonally,6,2,8
3ZUE82NE0A2B8701X4995O8OCRS8FL,"In the third instar , purple or blue edging develops on the yellow stripes and the tail horn turns from black to yellow .",7,19,third instar,0,1,1
3ZUE82NE0A2B8701X4995O8OCRS8FL,"In the third instar , purple or blue edging develops on the yellow stripes and the tail horn turns from black to yellow .",13,19,instar,6,6,12
3ZUE82NE0A2B8701X4995O8OCRS8FL,"In the third instar , purple or blue edging develops on the yellow stripes and the tail horn turns from black to yellow .",32,43,blue edging,1,0,1
3ZUE82NE0A2B8701X4995O8OCRS8FL,"In the third instar , purple or blue edging develops on the yellow stripes and the tail horn turns from black to yellow .",37,43,edging,0,3,3
3ZUE82NE0A2B8701X4995O8OCRS8FL,"In the third instar , purple or blue edging develops on the yellow stripes and the tail horn turns from black to yellow .",67,74,stripes,0,1,1
3ZUE82NE0A2B8701X4995O8OCRS8FL,"In the third instar , purple or blue edging develops on the yellow stripes and the tail horn turns from black to yellow .",83,92,tail horn,0,2,2
3ZUE82NE0A2B8701X4995O8OCRS8FL,"In the third instar , purple or blue edging develops on the yellow stripes and the tail horn turns from black to yellow .",88,92,horn,0,1,1
3ZUE82NE0A2B8701X4995O8OCRS8FL,"The larva grows to about 120-130 mm , and pupates in an underground chamber .",4,9,larva,3,0,3
3ZUE82NE0A2B8701X4995O8OCRS8FL,"The larva grows to about 120-130 mm , and pupates in an underground chamber .",42,49,pupates,9,10,19
3ZUE82NE0A2B8701X4995O8OCRS8FL,"The larva grows to about 120-130 mm , and pupates in an underground chamber .",56,67,underground,0,1,1
3ZUE82NE0A2B8701X4995O8OCRS8FL,"The larva grows to about 120-130 mm , and pupates in an underground chamber .",56,75,underground chamber,0,1,1
3ZUE82NE0A2B8701X4995O8OCRS8FL,"The larva grows to about 120-130 mm , and pupates in an underground chamber .",68,75,chamber,1,1,2
3ZUE82NE0A2B8701X4995O8OCRS8FL,"An actor ( sometimes actress for female ; see terminology ) is a person who acts in a dramatic or comic production and who works in film , television , theater , or radio in that capacity .",46,57,terminology,7,4,11
3ZUE82NE0A2B8701X4995O8OCRS8FL,"An actor ( sometimes actress for female ; see terminology ) is a person who acts in a dramatic or comic production and who works in film , television , theater , or radio in that capacity .",86,94,dramatic,5,2,7
3ZUE82NE0A2B8701X4995O8OCRS8FL,"An actor ( sometimes actress for female ; see terminology ) is a person who acts in a dramatic or comic production and who works in film , television , theater , or radio in that capacity .",98,103,comic,2,0,2
3ZUE82NE0A2B8701X4995O8OCRS8FL,"An actor ( sometimes actress for female ; see terminology ) is a person who acts in a dramatic or comic production and who works in film , television , theater , or radio in that capacity .",104,114,production,1,1,2
3ZUE82NE0A2B8701X4995O8OCRS8FL,"An actor ( sometimes actress for female ; see terminology ) is a person who acts in a dramatic or comic production and who works in film , television , theater , or radio in that capacity .",179,187,capacity,4,0,4
3QI9WAYOGQCX8YMZA9CAS9VCVMWS62,The tail of Epidexipteryx also bore unusual vertebrae towards the tip which resembled the feather-anchoring pygostyle of modern birds and some oviraptorosaurs .,4,8,tail,0,2,2
3QI9WAYOGQCX8YMZA9CAS9VCVMWS62,The tail of Epidexipteryx also bore unusual vertebrae towards the tip which resembled the feather-anchoring pygostyle of modern birds and some oviraptorosaurs .,12,25,Epidexipteryx,7,3,10
3QI9WAYOGQCX8YMZA9CAS9VCVMWS62,The tail of Epidexipteryx also bore unusual vertebrae towards the tip which resembled the feather-anchoring pygostyle of modern birds and some oviraptorosaurs .,31,35,bore,0,3,3
3QI9WAYOGQCX8YMZA9CAS9VCVMWS62,The tail of Epidexipteryx also bore unusual vertebrae towards the tip which resembled the feather-anchoring pygostyle of modern birds and some oviraptorosaurs .,31,53,bore unusual vertebrae,0,1,1
3QI9WAYOGQCX8YMZA9CAS9VCVMWS62,The tail of Epidexipteryx also bore unusual vertebrae towards the tip which resembled the feather-anchoring pygostyle of modern birds and some oviraptorosaurs .,36,53,unusual vertebrae,2,0,2
3QI9WAYOGQCX8YMZA9CAS9VCVMWS62,The tail of Epidexipteryx also bore unusual vertebrae towards the tip which resembled the feather-anchoring pygostyle of modern birds and some oviraptorosaurs .,44,53,vertebrae,8,6,14
3QI9WAYOGQCX8YMZA9CAS9VCVMWS62,The tail of Epidexipteryx also bore unusual vertebrae towards the tip which resembled the feather-anchoring pygostyle of modern birds and some oviraptorosaurs .,54,61,towards,0,1,1
3QI9WAYOGQCX8YMZA9CAS9VCVMWS62,The tail of Epidexipteryx also bore unusual vertebrae towards the tip which resembled the feather-anchoring pygostyle of modern birds and some oviraptorosaurs .,76,85,resembled,1,8,9
3QI9WAYOGQCX8YMZA9CAS9VCVMWS62,The tail of Epidexipteryx also bore unusual vertebrae towards the tip which resembled the feather-anchoring pygostyle of modern birds and some oviraptorosaurs .,90,107,feather-anchoring,4,4,8
3QI9WAYOGQCX8YMZA9CAS9VCVMWS62,The tail of Epidexipteryx also bore unusual vertebrae towards the tip which resembled the feather-anchoring pygostyle of modern birds and some oviraptorosaurs .,90,117,feather-anchoring pygostyle,3,0,3
3QI9WAYOGQCX8YMZA9CAS9VCVMWS62,The tail of Epidexipteryx also bore unusual vertebrae towards the tip which resembled the feather-anchoring pygostyle of modern birds and some oviraptorosaurs .,108,117,pygostyle,10,10,20
3QI9WAYOGQCX8YMZA9CAS9VCVMWS62,The tail of Epidexipteryx also bore unusual vertebrae towards the tip which resembled the feather-anchoring pygostyle of modern birds and some oviraptorosaurs .,143,158,oviraptorosaurs,10,6,16
3QI9WAYOGQCX8YMZA9CAS9VCVMWS62,"Epidexipteryx also preserved a covering of simpler body feathers , composed of parallel barbs as in more primitive feathered dinosaurs .",0,13,Epidexipteryx,2,1,3
3QI9WAYOGQCX8YMZA9CAS9VCVMWS62,"Epidexipteryx also preserved a covering of simpler body feathers , composed of parallel barbs as in more primitive feathered dinosaurs .",19,28,preserved,0,1,1
3QI9WAYOGQCX8YMZA9CAS9VCVMWS62,"Epidexipteryx also preserved a covering of simpler body feathers , composed of parallel barbs as in more primitive feathered dinosaurs .",67,78,composed of,0,1,1
3QI9WAYOGQCX8YMZA9CAS9VCVMWS62,"Epidexipteryx also preserved a covering of simpler body feathers , composed of parallel barbs as in more primitive feathered dinosaurs .",79,87,parallel,2,1,3
3QI9WAYOGQCX8YMZA9CAS9VCVMWS62,"Epidexipteryx also preserved a covering of simpler body feathers , composed of parallel barbs as in more primitive feathered dinosaurs .",79,93,parallel barbs,2,1,3
3QI9WAYOGQCX8YMZA9CAS9VCVMWS62,"Epidexipteryx also preserved a covering of simpler body feathers , composed of parallel barbs as in more primitive feathered dinosaurs .",88,93,barbs,4,8,12
3QI9WAYOGQCX8YMZA9CAS9VCVMWS62,"Epidexipteryx also preserved a covering of simpler body feathers , composed of parallel barbs as in more primitive feathered dinosaurs .",105,114,primitive,5,4,9
3QI9WAYOGQCX8YMZA9CAS9VCVMWS62,"Epidexipteryx also preserved a covering of simpler body feathers , composed of parallel barbs as in more primitive feathered dinosaurs .",115,124,feathered,0,1,1
3QI9WAYOGQCX8YMZA9CAS9VCVMWS62,"Epidexipteryx also preserved a covering of simpler body feathers , composed of parallel barbs as in more primitive feathered dinosaurs .",125,134,dinosaurs,1,0,1
3QI9WAYOGQCX8YMZA9CAS9VCVMWS62,"However , unlike in modern-style rectrices ( tail feathers ) , the vanes were not branched into individual filaments but made up of a single ribbon-like sheet .",20,32,modern-style,0,1,1
3QI9WAYOGQCX8YMZA9CAS9VCVMWS62,"However , unlike in modern-style rectrices ( tail feathers ) , the vanes were not branched into individual filaments but made up of a single ribbon-like sheet .",20,42,modern-style rectrices,1,0,1
3QI9WAYOGQCX8YMZA9CAS9VCVMWS62,"However , unlike in modern-style rectrices ( tail feathers ) , the vanes were not branched into individual filaments but made up of a single ribbon-like sheet .",33,42,rectrices,7,4,11
3QI9WAYOGQCX8YMZA9CAS9VCVMWS62,"However , unlike in modern-style rectrices ( tail feathers ) , the vanes were not branched into individual filaments but made up of a single ribbon-like sheet .",50,58,feathers,0,1,1
3QI9WAYOGQCX8YMZA9CAS9VCVMWS62,"However , unlike in modern-style rectrices ( tail feathers ) , the vanes were not branched into individual filaments but made up of a single ribbon-like sheet .",67,72,vanes,3,5,8
3QI9WAYOGQCX8YMZA9CAS9VCVMWS62,"However , unlike in modern-style rectrices ( tail feathers ) , the vanes were not branched into individual filaments but made up of a single ribbon-like sheet .",96,106,individual,1,0,1
3QI9WAYOGQCX8YMZA9CAS9VCVMWS62,"However , unlike in modern-style rectrices ( tail feathers ) , the vanes were not branched into individual filaments but made up of a single ribbon-like sheet .",96,116,individual filaments,0,1,1
3QI9WAYOGQCX8YMZA9CAS9VCVMWS62,"However , unlike in modern-style rectrices ( tail feathers ) , the vanes were not branched into individual filaments but made up of a single ribbon-like sheet .",107,116,filaments,10,3,13
3QI9WAYOGQCX8YMZA9CAS9VCVMWS62,"However , unlike in modern-style rectrices ( tail feathers ) , the vanes were not branched into individual filaments but made up of a single ribbon-like sheet .",141,152,ribbon-like,0,3,3
3QI9WAYOGQCX8YMZA9CAS9VCVMWS62,"However , unlike in modern-style rectrices ( tail feathers ) , the vanes were not branched into individual filaments but made up of a single ribbon-like sheet .",153,158,sheet,0,1,1
3QI9WAYOGQCX8YMZA9CAS9VCVMWS62,"It has been reported to be a maniraptoran dinosaur from the Middle Jurassic or Upper Jurassic age Daohugou Beds of Inner Mongolia , China ( about 160 or 168 mya ) .",29,41,maniraptoran,10,2,12
3QI9WAYOGQCX8YMZA9CAS9VCVMWS62,"It has been reported to be a maniraptoran dinosaur from the Middle Jurassic or Upper Jurassic age Daohugou Beds of Inner Mongolia , China ( about 160 or 168 mya ) .",67,75,Jurassic,4,0,4
3QI9WAYOGQCX8YMZA9CAS9VCVMWS62,"It has been reported to be a maniraptoran dinosaur from the Middle Jurassic or Upper Jurassic age Daohugou Beds of Inner Mongolia , China ( about 160 or 168 mya ) .",94,97,age,0,1,1
3QI9WAYOGQCX8YMZA9CAS9VCVMWS62,"It has been reported to be a maniraptoran dinosaur from the Middle Jurassic or Upper Jurassic age Daohugou Beds of Inner Mongolia , China ( about 160 or 168 mya ) .",98,106,Daohugou,2,1,3
3QI9WAYOGQCX8YMZA9CAS9VCVMWS62,"Epidexipteryx ( `` display feather '' ) is a genus of small paravian dinosaur , known from one fossil specimen in the collection of the Institute of Vertebrate Paleontology and Paleoanthropology in Beijing .",0,13,Epidexipteryx,2,2,4
3QI9WAYOGQCX8YMZA9CAS9VCVMWS62,"Epidexipteryx ( `` display feather '' ) is a genus of small paravian dinosaur , known from one fossil specimen in the collection of the Institute of Vertebrate Paleontology and Paleoanthropology in Beijing .",45,50,genus,2,1,3
3QI9WAYOGQCX8YMZA9CAS9VCVMWS62,"Epidexipteryx ( `` display feather '' ) is a genus of small paravian dinosaur , known from one fossil specimen in the collection of the Institute of Vertebrate Paleontology and Paleoanthropology in Beijing .",60,68,paravian,7,3,10
3QI9WAYOGQCX8YMZA9CAS9VCVMWS62,"Epidexipteryx ( `` display feather '' ) is a genus of small paravian dinosaur , known from one fossil specimen in the collection of the Institute of Vertebrate Paleontology and Paleoanthropology in Beijing .",60,77,paravian dinosaur,1,0,1
3QI9WAYOGQCX8YMZA9CAS9VCVMWS62,"Epidexipteryx ( `` display feather '' ) is a genus of small paravian dinosaur , known from one fossil specimen in the collection of the Institute of Vertebrate Paleontology and Paleoanthropology in Beijing .",69,77,dinosaur,1,0,1
3QI9WAYOGQCX8YMZA9CAS9VCVMWS62,"Epidexipteryx ( `` display feather '' ) is a genus of small paravian dinosaur , known from one fossil specimen in the collection of the Institute of Vertebrate Paleontology and Paleoanthropology in Beijing .",95,101,fossil,1,5,6
3QI9WAYOGQCX8YMZA9CAS9VCVMWS62,"Epidexipteryx ( `` display feather '' ) is a genus of small paravian dinosaur , known from one fossil specimen in the collection of the Institute of Vertebrate Paleontology and Paleoanthropology in Beijing .",95,110,fossil specimen,0,1,1
3QI9WAYOGQCX8YMZA9CAS9VCVMWS62,"Epidexipteryx ( `` display feather '' ) is a genus of small paravian dinosaur , known from one fossil specimen in the collection of the Institute of Vertebrate Paleontology and Paleoanthropology in Beijing .",102,110,specimen,2,4,6
3QI9WAYOGQCX8YMZA9CAS9VCVMWS62,"Epidexipteryx ( `` display feather '' ) is a genus of small paravian dinosaur , known from one fossil specimen in the collection of the Institute of Vertebrate Paleontology and Paleoanthropology in Beijing .",149,172,Vertebrate Paleontology,2,0,2
3QI9WAYOGQCX8YMZA9CAS9VCVMWS62,"Epidexipteryx ( `` display feather '' ) is a genus of small paravian dinosaur , known from one fossil specimen in the collection of the Institute of Vertebrate Paleontology and Paleoanthropology in Beijing .",149,194,Vertebrate Paleontology and Paleoanthropology,1,0,1
3QI9WAYOGQCX8YMZA9CAS9VCVMWS62,"Epidexipteryx ( `` display feather '' ) is a genus of small paravian dinosaur , known from one fossil specimen in the collection of the Institute of Vertebrate Paleontology and Paleoanthropology in Beijing .",160,172,Paleontology,1,3,4
3QI9WAYOGQCX8YMZA9CAS9VCVMWS62,"Epidexipteryx ( `` display feather '' ) is a genus of small paravian dinosaur , known from one fossil specimen in the collection of the Institute of Vertebrate Paleontology and Paleoanthropology in Beijing .",177,194,Paleoanthropology,2,4,6
36JW4WBR06L41I1U083FI11NFAIFH7,"Medicine recognizes that altitudes above 1,500 metres ( 4,900 ft ) start to affect humans , and there is no record of humans living at extreme altitudes above 5,500-6 ,000 metres ( 18,000-19 ,700 ft ) for more than two years .",0,8,Medicine,1,0,1
36JW4WBR06L41I1U083FI11NFAIFH7,"Medicine recognizes that altitudes above 1,500 metres ( 4,900 ft ) start to affect humans , and there is no record of humans living at extreme altitudes above 5,500-6 ,000 metres ( 18,000-19 ,700 ft ) for more than two years .",9,19,recognizes,3,6,9
36JW4WBR06L41I1U083FI11NFAIFH7,"Medicine recognizes that altitudes above 1,500 metres ( 4,900 ft ) start to affect humans , and there is no record of humans living at extreme altitudes above 5,500-6 ,000 metres ( 18,000-19 ,700 ft ) for more than two years .",25,34,altitudes,8,6,14
36JW4WBR06L41I1U083FI11NFAIFH7,"Medicine recognizes that altitudes above 1,500 metres ( 4,900 ft ) start to affect humans , and there is no record of humans living at extreme altitudes above 5,500-6 ,000 metres ( 18,000-19 ,700 ft ) for more than two years .",47,53,metres,1,0,1
36JW4WBR06L41I1U083FI11NFAIFH7,"Medicine recognizes that altitudes above 1,500 metres ( 4,900 ft ) start to affect humans , and there is no record of humans living at extreme altitudes above 5,500-6 ,000 metres ( 18,000-19 ,700 ft ) for more than two years .",67,72,start,0,1,1
36JW4WBR06L41I1U083FI11NFAIFH7,"Medicine recognizes that altitudes above 1,500 metres ( 4,900 ft ) start to affect humans , and there is no record of humans living at extreme altitudes above 5,500-6 ,000 metres ( 18,000-19 ,700 ft ) for more than two years .",76,82,affect,0,2,2
36JW4WBR06L41I1U083FI11NFAIFH7,"Medicine recognizes that altitudes above 1,500 metres ( 4,900 ft ) start to affect humans , and there is no record of humans living at extreme altitudes above 5,500-6 ,000 metres ( 18,000-19 ,700 ft ) for more than two years .",135,142,extreme,2,5,7
36JW4WBR06L41I1U083FI11NFAIFH7,"Medicine recognizes that altitudes above 1,500 metres ( 4,900 ft ) start to affect humans , and there is no record of humans living at extreme altitudes above 5,500-6 ,000 metres ( 18,000-19 ,700 ft ) for more than two years .",135,152,extreme altitudes,1,0,1
36JW4WBR06L41I1U083FI11NFAIFH7,There are several types of aviation altitude : These types of altitude can be explained more simply as various ways of measuring the altitude : The Earth 's atmosphere is divided into several altitude regions : Regions on the Earth 's surface ( or in its atmosphere ) that are high above mean sea level are referred to as high altitude .,27,35,aviation,9,7,16
36JW4WBR06L41I1U083FI11NFAIFH7,There are several types of aviation altitude : These types of altitude can be explained more simply as various ways of measuring the altitude : The Earth 's atmosphere is divided into several altitude regions : Regions on the Earth 's surface ( or in its atmosphere ) that are high above mean sea level are referred to as high altitude .,27,44,aviation altitude,2,3,5
36JW4WBR06L41I1U083FI11NFAIFH7,There are several types of aviation altitude : These types of altitude can be explained more simply as various ways of measuring the altitude : The Earth 's atmosphere is divided into several altitude regions : Regions on the Earth 's surface ( or in its atmosphere ) that are high above mean sea level are referred to as high altitude .,36,44,altitude,1,1,2
36JW4WBR06L41I1U083FI11NFAIFH7,There are several types of aviation altitude : These types of altitude can be explained more simply as various ways of measuring the altitude : The Earth 's atmosphere is divided into several altitude regions : Regions on the Earth 's surface ( or in its atmosphere ) that are high above mean sea level are referred to as high altitude .,62,70,altitude,0,1,1
36JW4WBR06L41I1U083FI11NFAIFH7,There are several types of aviation altitude : These types of altitude can be explained more simply as various ways of measuring the altitude : The Earth 's atmosphere is divided into several altitude regions : Regions on the Earth 's surface ( or in its atmosphere ) that are high above mean sea level are referred to as high altitude .,103,110,various,1,0,1
36JW4WBR06L41I1U083FI11NFAIFH7,There are several types of aviation altitude : These types of altitude can be explained more simply as various ways of measuring the altitude : The Earth 's atmosphere is divided into several altitude regions : Regions on the Earth 's surface ( or in its atmosphere ) that are high above mean sea level are referred to as high altitude .,119,128,measuring,1,3,4
36JW4WBR06L41I1U083FI11NFAIFH7,There are several types of aviation altitude : These types of altitude can be explained more simply as various ways of measuring the altitude : The Earth 's atmosphere is divided into several altitude regions : Regions on the Earth 's surface ( or in its atmosphere ) that are high above mean sea level are referred to as high altitude .,157,167,atmosphere,9,0,9
36JW4WBR06L41I1U083FI11NFAIFH7,There are several types of aviation altitude : These types of altitude can be explained more simply as various ways of measuring the altitude : The Earth 's atmosphere is divided into several altitude regions : Regions on the Earth 's surface ( or in its atmosphere ) that are high above mean sea level are referred to as high altitude .,171,178,divided,0,1,1
36JW4WBR06L41I1U083FI11NFAIFH7,There are several types of aviation altitude : These types of altitude can be explained more simply as various ways of measuring the altitude : The Earth 's atmosphere is divided into several altitude regions : Regions on the Earth 's surface ( or in its atmosphere ) that are high above mean sea level are referred to as high altitude .,192,208,altitude regions,0,1,1
36JW4WBR06L41I1U083FI11NFAIFH7,There are several types of aviation altitude : These types of altitude can be explained more simply as various ways of measuring the altitude : The Earth 's atmosphere is divided into several altitude regions : Regions on the Earth 's surface ( or in its atmosphere ) that are high above mean sea level are referred to as high altitude .,226,241,Earth s surface,0,1,1
36JW4WBR06L41I1U083FI11NFAIFH7,There are several types of aviation altitude : These types of altitude can be explained more simply as various ways of measuring the altitude : The Earth 's atmosphere is divided into several altitude regions : Regions on the Earth 's surface ( or in its atmosphere ) that are high above mean sea level are referred to as high altitude .,235,242,surface,0,3,3
36JW4WBR06L41I1U083FI11NFAIFH7,There are several types of aviation altitude : These types of altitude can be explained more simply as various ways of measuring the altitude : The Earth 's atmosphere is divided into several altitude regions : Regions on the Earth 's surface ( or in its atmosphere ) that are high above mean sea level are referred to as high altitude .,255,265,atmosphere,2,1,3
36JW4WBR06L41I1U083FI11NFAIFH7,There are several types of aviation altitude : These types of altitude can be explained more simply as various ways of measuring the altitude : The Earth 's atmosphere is divided into several altitude regions : Regions on the Earth 's surface ( or in its atmosphere ) that are high above mean sea level are referred to as high altitude .,288,292,mean,1,1,2
36JW4WBR06L41I1U083FI11NFAIFH7,There are several types of aviation altitude : These types of altitude can be explained more simply as various ways of measuring the altitude : The Earth 's atmosphere is divided into several altitude regions : Regions on the Earth 's surface ( or in its atmosphere ) that are high above mean sea level are referred to as high altitude .,288,302,mean sea level,2,0,2
36JW4WBR06L41I1U083FI11NFAIFH7,There are several types of aviation altitude : These types of altitude can be explained more simply as various ways of measuring the altitude : The Earth 's atmosphere is divided into several altitude regions : Regions on the Earth 's surface ( or in its atmosphere ) that are high above mean sea level are referred to as high altitude .,307,315,referred,1,2,3
36JW4WBR06L41I1U083FI11NFAIFH7,There are several types of aviation altitude : These types of altitude can be explained more simply as various ways of measuring the altitude : The Earth 's atmosphere is divided into several altitude regions : Regions on the Earth 's surface ( or in its atmosphere ) that are high above mean sea level are referred to as high altitude .,307,318,referred to,1,0,1
36JW4WBR06L41I1U083FI11NFAIFH7,There are several types of aviation altitude : These types of altitude can be explained more simply as various ways of measuring the altitude : The Earth 's atmosphere is divided into several altitude regions : Regions on the Earth 's surface ( or in its atmosphere ) that are high above mean sea level are referred to as high altitude .,327,335,altitude,1,0,1
36JW4WBR06L41I1U083FI11NFAIFH7,"Aviation altitude is measured using either Mean Sea Level ( MSL ) or local ground level ( Above Ground Level , or AGL ) as the reference datum .",0,8,Aviation,2,0,2
36JW4WBR06L41I1U083FI11NFAIFH7,"Aviation altitude is measured using either Mean Sea Level ( MSL ) or local ground level ( Above Ground Level , or AGL ) as the reference datum .",0,17,Aviation altitude,2,0,2
36JW4WBR06L41I1U083FI11NFAIFH7,"Aviation altitude is measured using either Mean Sea Level ( MSL ) or local ground level ( Above Ground Level , or AGL ) as the reference datum .",21,29,measured,0,1,1
36JW4WBR06L41I1U083FI11NFAIFH7,"Aviation altitude is measured using either Mean Sea Level ( MSL ) or local ground level ( Above Ground Level , or AGL ) as the reference datum .",43,47,Mean,1,0,1
36JW4WBR06L41I1U083FI11NFAIFH7,"Aviation altitude is measured using either Mean Sea Level ( MSL ) or local ground level ( Above Ground Level , or AGL ) as the reference datum .",43,57,Mean Sea Level,2,2,4
36JW4WBR06L41I1U083FI11NFAIFH7,"Aviation altitude is measured using either Mean Sea Level ( MSL ) or local ground level ( Above Ground Level , or AGL ) as the reference datum .",69,87,local ground level,0,2,2
36JW4WBR06L41I1U083FI11NFAIFH7,"Aviation altitude is measured using either Mean Sea Level ( MSL ) or local ground level ( Above Ground Level , or AGL ) as the reference datum .",90,108,Above Ground Level,1,0,1
36JW4WBR06L41I1U083FI11NFAIFH7,"Aviation altitude is measured using either Mean Sea Level ( MSL ) or local ground level ( Above Ground Level , or AGL ) as the reference datum .",127,136,reference,3,0,3
36JW4WBR06L41I1U083FI11NFAIFH7,"Aviation altitude is measured using either Mean Sea Level ( MSL ) or local ground level ( Above Ground Level , or AGL ) as the reference datum .",127,142,reference datum,3,5,8
36JW4WBR06L41I1U083FI11NFAIFH7,"Aviation altitude is measured using either Mean Sea Level ( MSL ) or local ground level ( Above Ground Level , or AGL ) as the reference datum .",137,142,datum,8,7,15
3P7RGTLO6EE07HLUVDKKHS6O7CCKA5,"The barren islands, reefs and coral outcrops are believed to be in rich in oil and gas and the overlapping claims have long been feared as Asia's next flashpoint for armed conflict.",4,18,barren islands,1,2,3
3P7RGTLO6EE07HLUVDKKHS6O7CCKA5,"The barren islands, reefs and coral outcrops are believed to be in rich in oil and gas and the overlapping claims have long been feared as Asia's next flashpoint for armed conflict.",20,25,reefs,2,4,6
3P7RGTLO6EE07HLUVDKKHS6O7CCKA5,"The barren islands, reefs and coral outcrops are believed to be in rich in oil and gas and the overlapping claims have long been feared as Asia's next flashpoint for armed conflict.",30,35,coral,1,0,1
3P7RGTLO6EE07HLUVDKKHS6O7CCKA5,"The barren islands, reefs and coral outcrops are believed to be in rich in oil and gas and the overlapping claims have long been feared as Asia's next flashpoint for armed conflict.",30,44,coral outcrops,3,0,3
3P7RGTLO6EE07HLUVDKKHS6O7CCKA5,"The barren islands, reefs and coral outcrops are believed to be in rich in oil and gas and the overlapping claims have long been feared as Asia's next flashpoint for armed conflict.",36,44,outcrops,6,7,13
3P7RGTLO6EE07HLUVDKKHS6O7CCKA5,"The barren islands, reefs and coral outcrops are believed to be in rich in oil and gas and the overlapping claims have long been feared as Asia's next flashpoint for armed conflict.",95,106,overlapping,4,6,10
3P7RGTLO6EE07HLUVDKKHS6O7CCKA5,"The barren islands, reefs and coral outcrops are believed to be in rich in oil and gas and the overlapping claims have long been feared as Asia's next flashpoint for armed conflict.",95,113,overlapping claims,2,2,4
3P7RGTLO6EE07HLUVDKKHS6O7CCKA5,"The barren islands, reefs and coral outcrops are believed to be in rich in oil and gas and the overlapping claims have long been feared as Asia's next flashpoint for armed conflict.",151,161,flashpoint,10,8,18
3P7RGTLO6EE07HLUVDKKHS6O7CCKA5,"The barren islands, reefs and coral outcrops are believed to be in rich in oil and gas and the overlapping claims have long been feared as Asia's next flashpoint for armed conflict.",166,180,armed conflict,1,1,2
3P7RGTLO6EE07HLUVDKKHS6O7CCKA5,"The barren islands, reefs and coral outcrops are believed to be in rich in oil and gas and the overlapping claims have long been feared as Asia's next flashpoint for armed conflict.",172,180,conflict,0,2,2
3P7RGTLO6EE07HLUVDKKHS6O7CCKA5,Both China and the Philippines flexed their muscles on Wednesday.,31,37,flexed,2,7,9
3P7RGTLO6EE07HLUVDKKHS6O7CCKA5,Both China and the Philippines flexed their muscles on Wednesday.,31,51,flexed their muscles,4,2,6
3P7RGTLO6EE07HLUVDKKHS6O7CCKA5,"Del Rosario said that he warned China's ambassador that ""if the Philippines is challenged, we are prepared to secure our sovereignty.""",40,50,ambassador,2,1,3
3P7RGTLO6EE07HLUVDKKHS6O7CCKA5,"Del Rosario said that he warned China's ambassador that ""if the Philippines is challenged, we are prepared to secure our sovereignty.""",79,89,challenged,1,2,3
3P7RGTLO6EE07HLUVDKKHS6O7CCKA5,"Del Rosario said that he warned China's ambassador that ""if the Philippines is challenged, we are prepared to secure our sovereignty.""",110,132,secure our sovereignty,1,0,1
3P7RGTLO6EE07HLUVDKKHS6O7CCKA5,"Del Rosario said that he warned China's ambassador that ""if the Philippines is challenged, we are prepared to secure our sovereignty.""",121,132,sovereignty,10,10,20
3P7RGTLO6EE07HLUVDKKHS6O7CCKA5,"The Philippine navy was sending additional vessels toward the shoal, which lies about 200 kilometers (124 miles) from the nearest Philippine coast, a Philippine navy official told The Associated Press.",43,50,vessels,4,4,8
3P7RGTLO6EE07HLUVDKKHS6O7CCKA5,"The Philippine navy was sending additional vessels toward the shoal, which lies about 200 kilometers (124 miles) from the nearest Philippine coast, a Philippine navy official told The Associated Press.",62,67,shoal,6,7,13
3P7RGTLO6EE07HLUVDKKHS6O7CCKA5,He spoke on condition of anonymity because of a lack of authority to discuss the situation with the media.,12,34,condition of anonymity,3,1,4
3P7RGTLO6EE07HLUVDKKHS6O7CCKA5,He spoke on condition of anonymity because of a lack of authority to discuss the situation with the media.,25,34,anonymity,8,9,17
3P7RGTLO6EE07HLUVDKKHS6O7CCKA5,He spoke on condition of anonymity because of a lack of authority to discuss the situation with the media.,48,65,lack of authority,1,1,2
3P7RGTLO6EE07HLUVDKKHS6O7CCKA5,He spoke on condition of anonymity because of a lack of authority to discuss the situation with the media.,56,65,authority,2,2,4
3P7RGTLO6EE07HLUVDKKHS6O7CCKA5,"The standoff began Sunday when a Philippine navy surveillance plane spotted eight Chinese fishing vessels anchored in a lagoon at Scarborough, the Philippine Foreign Affairs Department said.",4,12,standoff,6,6,12
3P7RGTLO6EE07HLUVDKKHS6O7CCKA5,"The standoff began Sunday when a Philippine navy surveillance plane spotted eight Chinese fishing vessels anchored in a lagoon at Scarborough, the Philippine Foreign Affairs Department said.",44,67,navy surveillance plane,0,1,1
3P7RGTLO6EE07HLUVDKKHS6O7CCKA5,"The standoff began Sunday when a Philippine navy surveillance plane spotted eight Chinese fishing vessels anchored in a lagoon at Scarborough, the Philippine Foreign Affairs Department said.",49,61,surveillance,7,8,15
3P7RGTLO6EE07HLUVDKKHS6O7CCKA5,"The standoff began Sunday when a Philippine navy surveillance plane spotted eight Chinese fishing vessels anchored in a lagoon at Scarborough, the Philippine Foreign Affairs Department said.",49,67,surveillance plane,0,1,1
3P7RGTLO6EE07HLUVDKKHS6O7CCKA5,"The standoff began Sunday when a Philippine navy surveillance plane spotted eight Chinese fishing vessels anchored in a lagoon at Scarborough, the Philippine Foreign Affairs Department said.",68,75,spotted,0,1,1
3P7RGTLO6EE07HLUVDKKHS6O7CCKA5,"The standoff began Sunday when a Philippine navy surveillance plane spotted eight Chinese fishing vessels anchored in a lagoon at Scarborough, the Philippine Foreign Affairs Department said.",90,114,fishing vessels anchored,1,0,1
3P7RGTLO6EE07HLUVDKKHS6O7CCKA5,"The standoff began Sunday when a Philippine navy surveillance plane spotted eight Chinese fishing vessels anchored in a lagoon at Scarborough, the Philippine Foreign Affairs Department said.",106,114,anchored,3,5,8
3P7RGTLO6EE07HLUVDKKHS6O7CCKA5,"The standoff began Sunday when a Philippine navy surveillance plane spotted eight Chinese fishing vessels anchored in a lagoon at Scarborough, the Philippine Foreign Affairs Department said.",120,126,lagoon,5,2,7
3JMQI2OLFZ6ZDU99C032ZLVYLXBNDL,"The market was bracing itself for at least 50 billion euros in new cash.	16	23	bracing	9	10	19
3JMQI2OLFZ6ZDU99C032ZLVYLXBNDL	The market was bracing itself for at least 50 billion euros in new cash.",16,30,bracing itself,1,2,3
3JMQI2OLFZ6ZDU99C032ZLVYLXBNDL,"The market was bracing itself for at least 50 billion euros in new cash.	64	72	new cash	0	1	1
3JMQI2OLFZ6ZDU99C032ZLVYLXBNDL	You can't put out a number as low as 15 billion without an explanation, said a London-based banking analyst who did not want to be named.",59,70,explanation,3,2,5
3JMQI2OLFZ6ZDU99C032ZLVYLXBNDL,"You can't put out a number as low as 15 billion without an explanation,"" said a London-based banking analyst who did not want to be named.",93,108,banking analyst,4,1,5
3JMQI2OLFZ6ZDU99C032ZLVYLXBNDL,"You can't put out a number as low as 15 billion without an explanation,"" said a London-based banking analyst who did not want to be named.",101,108,analyst,5,5,10
3JMQI2OLFZ6ZDU99C032ZLVYLXBNDL,"Spanish lenders must set aside 30 billion euros, on top of 54 billion euros ordered in February, as provisions against loans which are still performing as well as bad ones while defaults rise in an recession which has sent unemployment to 24 percent.",8,15,lenders,3,3,6
3JMQI2OLFZ6ZDU99C032ZLVYLXBNDL,"Spanish lenders must set aside 30 billion euros, on top of 54 billion euros ordered in February, as provisions against loans which are still performing as well as bad ones while defaults rise in an recession which has sent unemployment to 24 percent.",21,30,set aside,1,1,2
3JMQI2OLFZ6ZDU99C032ZLVYLXBNDL,"Spanish lenders must set aside 30 billion euros, on top of 54 billion euros ordered in February, as provisions against loans which are still performing as well as bad ones while defaults rise in an recession which has sent unemployment to 24 percent.",25,30,aside,0,1,1
3JMQI2OLFZ6ZDU99C032ZLVYLXBNDL,"Spanish lenders must set aside 30 billion euros, on top of 54 billion euros ordered in February, as provisions against loans which are still performing as well as bad ones while defaults rise in an recession which has sent unemployment to 24 percent.",100,110,provisions,10,6,16
3JMQI2OLFZ6ZDU99C032ZLVYLXBNDL,"Spanish lenders must set aside 30 billion euros, on top of 54 billion euros ordered in February, as provisions against loans which are still performing as well as bad ones while defaults rise in an recession which has sent unemployment to 24 percent.",100,124,provisions against loans,2,0,2
3JMQI2OLFZ6ZDU99C032ZLVYLXBNDL,"Spanish lenders must set aside 30 billion euros, on top of 54 billion euros ordered in February, as provisions against loans which are still performing as well as bad ones while defaults rise in an recession which has sent unemployment to 24 percent.",141,151,performing,2,2,4
3JMQI2OLFZ6ZDU99C032ZLVYLXBNDL,"Spanish lenders must set aside 30 billion euros, on top of 54 billion euros ordered in February, as provisions against loans which are still performing as well as bad ones while defaults rise in an recession which has sent unemployment to 24 percent.",178,186,defaults,7,7,14
3JMQI2OLFZ6ZDU99C032ZLVYLXBNDL,"Spanish lenders must set aside 30 billion euros, on top of 54 billion euros ordered in February, as provisions against loans which are still performing as well as bad ones while defaults rise in an recession which has sent unemployment to 24 percent.",178,191,defaults rise,1,0,1
3JMQI2OLFZ6ZDU99C032ZLVYLXBNDL,"Spanish lenders must set aside 30 billion euros, on top of 54 billion euros ordered in February, as provisions against loans which are still performing as well as bad ones while defaults rise in an recession which has sent unemployment to 24 percent.",198,207,recession,10,10,20
3JMQI2OLFZ6ZDU99C032ZLVYLXBNDL,"Spanish lenders must set aside 30 billion euros, on top of 54 billion euros ordered in February, as provisions against loans which are still performing as well as bad ones while defaults rise in an recession which has sent unemployment to 24 percent.",223,235,unemployment,4,2,6
3JMQI2OLFZ6ZDU99C032ZLVYLXBNDL,"The Spanish government source said the 30-billion euro provisions would have an impact in capital of about 20 billion which, added to another estimated 20 billion euros to rescue systemic lender Bankia SA and other smaller banks would make up the figure investors viewed as necessary.",12,22,government,1,0,1
3JMQI2OLFZ6ZDU99C032ZLVYLXBNDL,"The Spanish government source said the 30-billion euro provisions would have an impact in capital of about 20 billion which, added to another estimated 20 billion euros to rescue systemic lender Bankia SA and other smaller banks would make up the figure investors viewed as necessary.",23,29,source,2,0,2
3JMQI2OLFZ6ZDU99C032ZLVYLXBNDL,"The Spanish government source said the 30-billion euro provisions would have an impact in capital of about 20 billion which, added to another estimated 20 billion euros to rescue systemic lender Bankia SA and other smaller banks would make up the figure investors viewed as necessary.",55,65,provisions,5,5,10
3JMQI2OLFZ6ZDU99C032ZLVYLXBNDL,"The Spanish government source said the 30-billion euro provisions would have an impact in capital of about 20 billion which, added to another estimated 20 billion euros to rescue systemic lender Bankia SA and other smaller banks would make up the figure investors viewed as necessary.",80,86,impact,1,4,5
3JMQI2OLFZ6ZDU99C032ZLVYLXBNDL,"The Spanish government source said the 30-billion euro provisions would have an impact in capital of about 20 billion which, added to another estimated 20 billion euros to rescue systemic lender Bankia SA and other smaller banks would make up the figure investors viewed as necessary.",80,97,impact in capital,1,0,1
3JMQI2OLFZ6ZDU99C032ZLVYLXBNDL,"The Spanish government source said the 30-billion euro provisions would have an impact in capital of about 20 billion which, added to another estimated 20 billion euros to rescue systemic lender Bankia SA and other smaller banks would make up the figure investors viewed as necessary.",90,97,capital,2,0,2
3JMQI2OLFZ6ZDU99C032ZLVYLXBNDL,"The Spanish government source said the 30-billion euro provisions would have an impact in capital of about 20 billion which, added to another estimated 20 billion euros to rescue systemic lender Bankia SA and other smaller banks would make up the figure investors viewed as necessary.",142,151,estimated,0,3,3
3JMQI2OLFZ6ZDU99C032ZLVYLXBNDL,"The Spanish government source said the 30-billion euro provisions would have an impact in capital of about 20 billion which, added to another estimated 20 billion euros to rescue systemic lender Bankia SA and other smaller banks would make up the figure investors viewed as necessary.",172,178,rescue,3,6,9
3JMQI2OLFZ6ZDU99C032ZLVYLXBNDL,"The Spanish government source said the 30-billion euro provisions would have an impact in capital of about 20 billion which, added to another estimated 20 billion euros to rescue systemic lender Bankia SA and other smaller banks would make up the figure investors viewed as necessary.",172,194,rescue systemic lender,0,1,1
3JMQI2OLFZ6ZDU99C032ZLVYLXBNDL,"The Spanish government source said the 30-billion euro provisions would have an impact in capital of about 20 billion which, added to another estimated 20 billion euros to rescue systemic lender Bankia SA and other smaller banks would make up the figure investors viewed as necessary.",179,187,systemic,6,2,8
3JMQI2OLFZ6ZDU99C032ZLVYLXBNDL,"The Spanish government source said the 30-billion euro provisions would have an impact in capital of about 20 billion which, added to another estimated 20 billion euros to rescue systemic lender Bankia SA and other smaller banks would make up the figure investors viewed as necessary.",179,194,systemic lender,4,5,9
3JMQI2OLFZ6ZDU99C032ZLVYLXBNDL,"The Spanish government source said the 30-billion euro provisions would have an impact in capital of about 20 billion which, added to another estimated 20 billion euros to rescue systemic lender Bankia SA and other smaller banks would make up the figure investors viewed as necessary.",188,194,lender,0,1,1
3JMQI2OLFZ6ZDU99C032ZLVYLXBNDL,"The Spanish government source said the 30-billion euro provisions would have an impact in capital of about 20 billion which, added to another estimated 20 billion euros to rescue systemic lender Bankia SA and other smaller banks would make up the figure investors viewed as necessary.",247,263,figure investors,1,0,1
3JMQI2OLFZ6ZDU99C032ZLVYLXBNDL,"The Spanish government source said the 30-billion euro provisions would have an impact in capital of about 20 billion which, added to another estimated 20 billion euros to rescue systemic lender Bankia SA and other smaller banks would make up the figure investors viewed as necessary.",254,263,investors,2,2,4
3JMQI2OLFZ6ZDU99C032ZLVYLXBNDL,"The Spanish government source said the 30-billion euro provisions would have an impact in capital of about 20 billion which, added to another estimated 20 billion euros to rescue systemic lender Bankia SA and other smaller banks would make up the figure investors viewed as necessary.",264,270,viewed,0,1,1
3S8APUMBJXKUA5Y80GTJWQYPGLDBFV,"Western powers have no appetite for a repeat of the military intervention that helped Libyan rebels topple long-time ruler Moammar Gadhafi last year, and Moscow says arming Assad's opponents would only lead to years of inconclusive bloodshed.",23,31,appetite,8,8,16
3S8APUMBJXKUA5Y80GTJWQYPGLDBFV,"Western powers have no appetite for a repeat of the military intervention that helped Libyan rebels topple long-time ruler Moammar Gadhafi last year, and Moscow says arming Assad's opponents would only lead to years of inconclusive bloodshed.",52,73,military intervention,3,1,4
3S8APUMBJXKUA5Y80GTJWQYPGLDBFV,"Western powers have no appetite for a repeat of the military intervention that helped Libyan rebels topple long-time ruler Moammar Gadhafi last year, and Moscow says arming Assad's opponents would only lead to years of inconclusive bloodshed.",61,73,intervention,8,8,16
3S8APUMBJXKUA5Y80GTJWQYPGLDBFV,"Western powers have no appetite for a repeat of the military intervention that helped Libyan rebels topple long-time ruler Moammar Gadhafi last year, and Moscow says arming Assad's opponents would only lead to years of inconclusive bloodshed.",86,92,Libyan,1,0,1
3S8APUMBJXKUA5Y80GTJWQYPGLDBFV,"Western powers have no appetite for a repeat of the military intervention that helped Libyan rebels topple long-time ruler Moammar Gadhafi last year, and Moscow says arming Assad's opponents would only lead to years of inconclusive bloodshed.",93,99,rebels,0,1,1
3S8APUMBJXKUA5Y80GTJWQYPGLDBFV,"Western powers have no appetite for a repeat of the military intervention that helped Libyan rebels topple long-time ruler Moammar Gadhafi last year, and Moscow says arming Assad's opponents would only lead to years of inconclusive bloodshed.",100,106,topple,7,10,17
3S8APUMBJXKUA5Y80GTJWQYPGLDBFV,"Western powers have no appetite for a repeat of the military intervention that helped Libyan rebels topple long-time ruler Moammar Gadhafi last year, and Moscow says arming Assad's opponents would only lead to years of inconclusive bloodshed.",107,116,long-time,0,1,1
3S8APUMBJXKUA5Y80GTJWQYPGLDBFV,"Western powers have no appetite for a repeat of the military intervention that helped Libyan rebels topple long-time ruler Moammar Gadhafi last year, and Moscow says arming Assad's opponents would only lead to years of inconclusive bloodshed.",117,122,ruler,0,1,1
3S8APUMBJXKUA5Y80GTJWQYPGLDBFV,"Western powers have no appetite for a repeat of the military intervention that helped Libyan rebels topple long-time ruler Moammar Gadhafi last year, and Moscow says arming Assad's opponents would only lead to years of inconclusive bloodshed.",123,138,Moammar Gadhafi,1,0,1
3S8APUMBJXKUA5Y80GTJWQYPGLDBFV,"Western powers have no appetite for a repeat of the military intervention that helped Libyan rebels topple long-time ruler Moammar Gadhafi last year, and Moscow says arming Assad's opponents would only lead to years of inconclusive bloodshed.",166,172,arming,1,1,2
3S8APUMBJXKUA5Y80GTJWQYPGLDBFV,"Western powers have no appetite for a repeat of the military intervention that helped Libyan rebels topple long-time ruler Moammar Gadhafi last year, and Moscow says arming Assad's opponents would only lead to years of inconclusive bloodshed.",181,190,opponents,3,3,6
3S8APUMBJXKUA5Y80GTJWQYPGLDBFV,"Western powers have no appetite for a repeat of the military intervention that helped Libyan rebels topple long-time ruler Moammar Gadhafi last year, and Moscow says arming Assad's opponents would only lead to years of inconclusive bloodshed.",219,231,inconclusive,10,10,20
3S8APUMBJXKUA5Y80GTJWQYPGLDBFV,"Western powers have no appetite for a repeat of the military intervention that helped Libyan rebels topple long-time ruler Moammar Gadhafi last year, and Moscow says arming Assad's opponents would only lead to years of inconclusive bloodshed.",219,241,inconclusive bloodshed,2,2,4
3S8APUMBJXKUA5Y80GTJWQYPGLDBFV,"Western powers have no appetite for a repeat of the military intervention that helped Libyan rebels topple long-time ruler Moammar Gadhafi last year, and Moscow says arming Assad's opponents would only lead to years of inconclusive bloodshed.",232,241,bloodshed,0,5,5
3S8APUMBJXKUA5Y80GTJWQYPGLDBFV,"Fierce clashes between Syrian regime forces and armed rebels in the central city of Rastan on Monday left at least 23 soldiers dead and dozens wounded, the Syrian Observatory for Human Rights said.",0,6,Fierce,2,2,4
3S8APUMBJXKUA5Y80GTJWQYPGLDBFV,"Fierce clashes between Syrian regime forces and armed rebels in the central city of Rastan on Monday left at least 23 soldiers dead and dozens wounded, the Syrian Observatory for Human Rights said.",0,14,Fierce clashes,0,1,1
3S8APUMBJXKUA5Y80GTJWQYPGLDBFV,"Fierce clashes between Syrian regime forces and armed rebels in the central city of Rastan on Monday left at least 23 soldiers dead and dozens wounded, the Syrian Observatory for Human Rights said.",7,14,clashes,0,1,1
3S8APUMBJXKUA5Y80GTJWQYPGLDBFV,"Fierce clashes between Syrian regime forces and armed rebels in the central city of Rastan on Monday left at least 23 soldiers dead and dozens wounded, the Syrian Observatory for Human Rights said.",30,36,regime,0,3,3
3S8APUMBJXKUA5Y80GTJWQYPGLDBFV,"Fierce clashes between Syrian regime forces and armed rebels in the central city of Rastan on Monday left at least 23 soldiers dead and dozens wounded, the Syrian Observatory for Human Rights said.",54,60,rebels,0,1,1
3S8APUMBJXKUA5Y80GTJWQYPGLDBFV,"Fierce clashes between Syrian regime forces and armed rebels in the central city of Rastan on Monday left at least 23 soldiers dead and dozens wounded, the Syrian Observatory for Human Rights said.",143,150,wounded,0,1,1
3S8APUMBJXKUA5Y80GTJWQYPGLDBFV,"Fierce clashes between Syrian regime forces and armed rebels in the central city of Rastan on Monday left at least 23 soldiers dead and dozens wounded, the Syrian Observatory for Human Rights said.",156,191,Syrian Observatory for Human Rights,1,0,1
3S8APUMBJXKUA5Y80GTJWQYPGLDBFV,"Fierce clashes between Syrian regime forces and armed rebels in the central city of Rastan on Monday left at least 23 soldiers dead and dozens wounded, the Syrian Observatory for Human Rights said.",163,174,Observatory,1,2,3
3S8APUMBJXKUA5Y80GTJWQYPGLDBFV,"The Britain-based monitoring group said initial reports indicated that three troop carriers were destroyed in the clashes that began at dawn on the outskirts of the rebel-held city, located in Homs province.",4,34,Britain-based monitoring group,0,1,1
3S8APUMBJXKUA5Y80GTJWQYPGLDBFV,"The Britain-based monitoring group said initial reports indicated that three troop carriers were destroyed in the clashes that began at dawn on the outskirts of the rebel-held city, located in Homs province.",18,28,monitoring,6,3,9
3S8APUMBJXKUA5Y80GTJWQYPGLDBFV,"The Britain-based monitoring group said initial reports indicated that three troop carriers were destroyed in the clashes that began at dawn on the outskirts of the rebel-held city, located in Homs province.",18,34,monitoring group,2,0,2
3S8APUMBJXKUA5Y80GTJWQYPGLDBFV,"The Britain-based monitoring group said initial reports indicated that three troop carriers were destroyed in the clashes that began at dawn on the outskirts of the rebel-held city, located in Homs province.",56,65,indicated,0,2,2
3S8APUMBJXKUA5Y80GTJWQYPGLDBFV,"The Britain-based monitoring group said initial reports indicated that three troop carriers were destroyed in the clashes that began at dawn on the outskirts of the rebel-held city, located in Homs province.",77,82,troop,0,1,1
3S8APUMBJXKUA5Y80GTJWQYPGLDBFV,"The Britain-based monitoring group said initial reports indicated that three troop carriers were destroyed in the clashes that began at dawn on the outskirts of the rebel-held city, located in Homs province.",97,106,destroyed,1,1,2
3S8APUMBJXKUA5Y80GTJWQYPGLDBFV,"The Britain-based monitoring group said initial reports indicated that three troop carriers were destroyed in the clashes that began at dawn on the outskirts of the rebel-held city, located in Homs province.",114,121,clashes,2,0,2
3S8APUMBJXKUA5Y80GTJWQYPGLDBFV,"The Britain-based monitoring group said initial reports indicated that three troop carriers were destroyed in the clashes that began at dawn on the outskirts of the rebel-held city, located in Homs province.",136,140,dawn,0,2,2
3S8APUMBJXKUA5Y80GTJWQYPGLDBFV,"The Britain-based monitoring group said initial reports indicated that three troop carriers were destroyed in the clashes that began at dawn on the outskirts of the rebel-held city, located in Homs province.",148,157,outskirts,7,8,15
3S8APUMBJXKUA5Y80GTJWQYPGLDBFV,"The Britain-based monitoring group said initial reports indicated that three troop carriers were destroyed in the clashes that began at dawn on the outskirts of the rebel-held city, located in Homs province.",165,175,rebel-held,0,1,1
3S8APUMBJXKUA5Y80GTJWQYPGLDBFV,"The Britain-based monitoring group said initial reports indicated that three troop carriers were destroyed in the clashes that began at dawn on the outskirts of the rebel-held city, located in Homs province.",165,180,rebel-held city,1,1,2
3S8APUMBJXKUA5Y80GTJWQYPGLDBFV,"The Britain-based monitoring group said initial reports indicated that three troop carriers were destroyed in the clashes that began at dawn on the outskirts of the rebel-held city, located in Homs province.",198,206,province,2,3,5
3S8APUMBJXKUA5Y80GTJWQYPGLDBFV,A lieutenant who had defected was also killed in the clashes.,2,12,lieutenant,7,2,9
3S8APUMBJXKUA5Y80GTJWQYPGLDBFV,A lieutenant who had defected was also killed in the clashes.,21,29,defected,7,4,11
3S8APUMBJXKUA5Y80GTJWQYPGLDBFV,Regime forces launched an offensive on Rastan at the weekend but met with sharp resistance from rebels seeking the ouster of the regime of President Bashar al-Assad.,0,6,Regime,0,1,1
3S8APUMBJXKUA5Y80GTJWQYPGLDBFV,Regime forces launched an offensive on Rastan at the weekend but met with sharp resistance from rebels seeking the ouster of the regime of President Bashar al-Assad.,0,13,Regime forces,2,0,2
3S8APUMBJXKUA5Y80GTJWQYPGLDBFV,Regime forces launched an offensive on Rastan at the weekend but met with sharp resistance from rebels seeking the ouster of the regime of President Bashar al-Assad.,14,22,launched,1,2,3
3S8APUMBJXKUA5Y80GTJWQYPGLDBFV,Regime forces launched an offensive on Rastan at the weekend but met with sharp resistance from rebels seeking the ouster of the regime of President Bashar al-Assad.,26,35,offensive,1,1,2
3S8APUMBJXKUA5Y80GTJWQYPGLDBFV,Regime forces launched an offensive on Rastan at the weekend but met with sharp resistance from rebels seeking the ouster of the regime of President Bashar al-Assad.,74,79,sharp,0,2,2
3S8APUMBJXKUA5Y80GTJWQYPGLDBFV,Regime forces launched an offensive on Rastan at the weekend but met with sharp resistance from rebels seeking the ouster of the regime of President Bashar al-Assad.,74,90,sharp resistance,1,0,1
3S8APUMBJXKUA5Y80GTJWQYPGLDBFV,Regime forces launched an offensive on Rastan at the weekend but met with sharp resistance from rebels seeking the ouster of the regime of President Bashar al-Assad.,80,90,resistance,5,1,6
3S8APUMBJXKUA5Y80GTJWQYPGLDBFV,Regime forces launched an offensive on Rastan at the weekend but met with sharp resistance from rebels seeking the ouster of the regime of President Bashar al-Assad.,115,121,ouster,7,7,14
3S8APUMBJXKUA5Y80GTJWQYPGLDBFV,Regime forces launched an offensive on Rastan at the weekend but met with sharp resistance from rebels seeking the ouster of the regime of President Bashar al-Assad.,115,135,ouster of the regime,0,1,1
3S8APUMBJXKUA5Y80GTJWQYPGLDBFV,Regime forces launched an offensive on Rastan at the weekend but met with sharp resistance from rebels seeking the ouster of the regime of President Bashar al-Assad.,129,135,regime,3,0,3
3S8APUMBJXKUA5Y80GTJWQYPGLDBFV,Regime forces launched an offensive on Rastan at the weekend but met with sharp resistance from rebels seeking the ouster of the regime of President Bashar al-Assad.,149,164,Bashar al-Assad,1,0,1
3JY0Q5X05J7WFM2ERMRFFMPYXD5GGG,"However, after the trip, presumptive Republican presidential nominee Mitt Romney struck a somewhat somber tone in a press release.",25,36,presumptive,10,10,20
3JY0Q5X05J7WFM2ERMRFFMPYXD5GGG,"However, after the trip, presumptive Republican presidential nominee Mitt Romney struck a somewhat somber tone in a press release.",25,68,presumptive Republican presidential nominee,1,1,2
3JY0Q5X05J7WFM2ERMRFFMPYXD5GGG,"However, after the trip, presumptive Republican presidential nominee Mitt Romney struck a somewhat somber tone in a press release.",48,68,presidential nominee,0,1,1
3JY0Q5X05J7WFM2ERMRFFMPYXD5GGG,"However, after the trip, presumptive Republican presidential nominee Mitt Romney struck a somewhat somber tone in a press release.",61,68,nominee,9,3,12
3JY0Q5X05J7WFM2ERMRFFMPYXD5GGG,"However, after the trip, presumptive Republican presidential nominee Mitt Romney struck a somewhat somber tone in a press release.",81,87,struck,0,4,4
3JY0Q5X05J7WFM2ERMRFFMPYXD5GGG,"However, after the trip, presumptive Republican presidential nominee Mitt Romney struck a somewhat somber tone in a press release.",81,110,struck a somewhat somber tone,0,1,1
3JY0Q5X05J7WFM2ERMRFFMPYXD5GGG,"However, after the trip, presumptive Republican presidential nominee Mitt Romney struck a somewhat somber tone in a press release.",90,110,somewhat somber tone,1,0,1
3JY0Q5X05J7WFM2ERMRFFMPYXD5GGG,"However, after the trip, presumptive Republican presidential nominee Mitt Romney struck a somewhat somber tone in a press release.",99,105,somber,10,6,16
3JY0Q5X05J7WFM2ERMRFFMPYXD5GGG,"However, after the trip, presumptive Republican presidential nominee Mitt Romney struck a somewhat somber tone in a press release.",99,110,somber tone,2,3,5
3JY0Q5X05J7WFM2ERMRFFMPYXD5GGG,"However, after the trip, presumptive Republican presidential nominee Mitt Romney struck a somewhat somber tone in a press release.",116,129,press release,1,0,1
3JY0Q5X05J7WFM2ERMRFFMPYXD5GGG,Our troops and the American people deserve to hear from our President about what is at stake in this war.,35,42,deserve,0,2,2
3JY0Q5X05J7WFM2ERMRFFMPYXD5GGG,Our troops and the American people deserve to hear from our President about what is at stake in this war.,84,92,at stake,4,1,5
3JY0Q5X05J7WFM2ERMRFFMPYXD5GGG,Our troops and the American people deserve to hear from our President about what is at stake in this war.,87,92,stake,2,8,10
3JY0Q5X05J7WFM2ERMRFFMPYXD5GGG,Success in Afghanistan is vital to our nation's security.,26,31,vital,7,3,10
3JY0Q5X05J7WFM2ERMRFFMPYXD5GGG,Success in Afghanistan is vital to our nation's security.,39,55,nations security,0,1,1
3JY0Q5X05J7WFM2ERMRFFMPYXD5GGG,"It would be a tragedy for Afghanistan and a strategic setback for America if the Taliban returned to power and once again created a sanctuary for terrorists,"" Romney said in the release.",14,21,tragedy,3,7,10
3JY0Q5X05J7WFM2ERMRFFMPYXD5GGG,"It would be a tragedy for Afghanistan and a strategic setback for America if the Taliban returned to power and once again created a sanctuary for terrorists,"" Romney said in the release.",44,53,strategic,4,5,9
3JY0Q5X05J7WFM2ERMRFFMPYXD5GGG,"It would be a tragedy for Afghanistan and a strategic setback for America if the Taliban returned to power and once again created a sanctuary for terrorists,"" Romney said in the release.",44,61,strategic setback,6,4,10
3JY0Q5X05J7WFM2ERMRFFMPYXD5GGG,"It would be a tragedy for Afghanistan and a strategic setback for America if the Taliban returned to power and once again created a sanctuary for terrorists,"" Romney said in the release.",54,61,setback,1,3,4
3JY0Q5X05J7WFM2ERMRFFMPYXD5GGG,"It would be a tragedy for Afghanistan and a strategic setback for America if the Taliban returned to power and once again created a sanctuary for terrorists,"" Romney said in the release.",81,88,Taliban,1,0,1
3JY0Q5X05J7WFM2ERMRFFMPYXD5GGG,"It would be a tragedy for Afghanistan and a strategic setback for America if the Taliban returned to power and once again created a sanctuary for terrorists,"" Romney said in the release.",132,141,sanctuary,10,5,15
3JY0Q5X05J7WFM2ERMRFFMPYXD5GGG,"It would be a tragedy for Afghanistan and a strategic setback for America if the Taliban returned to power and once again created a sanctuary for terrorists,"" Romney said in the release.",132,156,sanctuary for terrorists,0,3,3
3JY0Q5X05J7WFM2ERMRFFMPYXD5GGG,"We tolerated such a sanctuary until we lost thousands on September 11, 2001.	4	13	tolerated	3	7	10
3JY0Q5X05J7WFM2ERMRFFMPYXD5GGG	We tolerated such a sanctuary until we lost thousands on September 11, 2001.",21,30,sanctuary,4,2,6
3JY0Q5X05J7WFM2ERMRFFMPYXD5GGG,Many brave Americans have sacrificed everything so that we could win this fight for a more secure future.,26,36,sacrificed,6,5,11
3JY0Q5X05J7WFM2ERMRFFMPYXD5GGG,Many brave Americans have sacrificed everything so that we could win this fight for a more secure future.,84,104,a more secure future,1,0,1
3JY0Q5X05J7WFM2ERMRFFMPYXD5GGG,Many brave Americans have sacrificed everything so that we could win this fight for a more secure future.,91,97,secure,0,2,2
3JY0Q5X05J7WFM2ERMRFFMPYXD5GGG,Many brave Americans have sacrificed everything so that we could win this fight for a more secure future.,91,104,secure future,1,1,2
3J94SKDEKIQVN533807G54VCVPED5F,The injured man was able to drive his car to Cloverhill Prison where he summoned assistance.,4,11,injured,0,2,2
3J94SKDEKIQVN533807G54VCVPED5F,The injured man was able to drive his car to Cloverhill Prison where he summoned assistance.,69,91,he summoned assistance,0,1,1
3J94SKDEKIQVN533807G54VCVPED5F,The injured man was able to drive his car to Cloverhill Prison where he summoned assistance.,72,80,summoned,10,10,20
3J94SKDEKIQVN533807G54VCVPED5F,The injured man was able to drive his car to Cloverhill Prison where he summoned assistance.,72,91,summoned assistance,3,1,4
3J94SKDEKIQVN533807G54VCVPED5F,The injured man was able to drive his car to Cloverhill Prison where he summoned assistance.,81,91,assistance,1,1,2
3J94SKDEKIQVN533807G54VCVPED5F,"He was taken to Tallaght General Hospital, his injuries are not thought to be life threatening.",60,94,not thought to be life threatening,0,1,1
3J94SKDEKIQVN533807G54VCVPED5F,"He was taken to Tallaght General Hospital, his injuries are not thought to be life threatening.",78,94,life threatening,5,6,11
3J94SKDEKIQVN533807G54VCVPED5F,"He was taken to Tallaght General Hospital, his injuries are not thought to be life threatening.",83,94,threatening,1,5,6
3J94SKDEKIQVN533807G54VCVPED5F,Witnesses at the scene of the shooting describe a silver saloon car leaving the area.,0,9,Witnesses,5,6,11
3J94SKDEKIQVN533807G54VCVPED5F,Witnesses at the scene of the shooting describe a silver saloon car leaving the area.,39,47,describe,0,1,1
3J94SKDEKIQVN533807G54VCVPED5F,Witnesses at the scene of the shooting describe a silver saloon car leaving the area.,50,63,silver saloon,1,0,1
3J94SKDEKIQVN533807G54VCVPED5F,Witnesses at the scene of the shooting describe a silver saloon car leaving the area.,50,67,silver saloon car,0,2,2
3J94SKDEKIQVN533807G54VCVPED5F,Witnesses at the scene of the shooting describe a silver saloon car leaving the area.,57,63,saloon,3,1,4
3J94SKDEKIQVN533807G54VCVPED5F,Witnesses at the scene of the shooting describe a silver saloon car leaving the area.,57,67,saloon car,3,1,4
3J94SKDEKIQVN533807G54VCVPED5F,"At about 11.30 pm a silver car was discovered on fire at Golden Bridge Terrace, Inchicore.",35,45,discovered,1,3,4
3J94SKDEKIQVN533807G54VCVPED5F,"At about 11.30 pm a silver car was discovered on fire at Golden Bridge Terrace, Inchicore.",80,89,Inchicore,1,1,2
3J94SKDEKIQVN533807G54VCVPED5F,The car has been removed from the scene for forensic technical examination.,17,24,removed,0,1,1
3J94SKDEKIQVN533807G54VCVPED5F,The car has been removed from the scene for forensic technical examination.,44,52,forensic,5,10,15
3J94SKDEKIQVN533807G54VCVPED5F,The car has been removed from the scene for forensic technical examination.,44,74,forensic technical examination,6,3,9
3J94SKDEKIQVN533807G54VCVPED5F,The car has been removed from the scene for forensic technical examination.,63,74,examination,2,0,2
3J94SKDEKIQVN533807G54VCVPED5F,Gardai are asking anyone who was in the Sarsfield Road area of Ballyfermot or in the Golden Bridge Terrace area to contact them on 01 666 7200.,0,6,Gardai,0,1,1
3J94SKDEKIQVN533807G54VCVPED5F,Ex-Soviet leader Mikhail Gorbachev says Russian authorities must annul the parliamentary vote results and hold a new election.,0,9,Ex-Soviet,2,0,2
3J94SKDEKIQVN533807G54VCVPED5F,Ex-Soviet leader Mikhail Gorbachev says Russian authorities must annul the parliamentary vote results and hold a new election.,48,59,authorities,1,3,4
3J94SKDEKIQVN533807G54VCVPED5F,Ex-Soviet leader Mikhail Gorbachev says Russian authorities must annul the parliamentary vote results and hold a new election.,65,70,annul,9,9,18
3J94SKDEKIQVN533807G54VCVPED5F,Ex-Soviet leader Mikhail Gorbachev says Russian authorities must annul the parliamentary vote results and hold a new election.,65,88,annul the parliamentary,0,1,1
3J94SKDEKIQVN533807G54VCVPED5F,Ex-Soviet leader Mikhail Gorbachev says Russian authorities must annul the parliamentary vote results and hold a new election.,75,88,parliamentary,9,2,11
3J94SKDEKIQVN533807G54VCVPED5F,Ex-Soviet leader Mikhail Gorbachev says Russian authorities must annul the parliamentary vote results and hold a new election.,75,101,parliamentary vote results,1,0,1
3J94SKDEKIQVN533807G54VCVPED5F,Ex-Soviet leader Mikhail Gorbachev says Russian authorities must annul the parliamentary vote results and hold a new election.,117,125,election,1,0,1
3WRBLBQ2GR9Z4IRTDK2CUU2IR9J0GR,He said most of the village's residents had fled and regime forces were setting fire to houses and looting shops.,40,48,had fled,0,1,1
3WRBLBQ2GR9Z4IRTDK2CUU2IR9J0GR,He said most of the village's residents had fled and regime forces were setting fire to houses and looting shops.,44,48,fled,1,5,6
3WRBLBQ2GR9Z4IRTDK2CUU2IR9J0GR,He said most of the village's residents had fled and regime forces were setting fire to houses and looting shops.,53,59,regime,8,3,11
3WRBLBQ2GR9Z4IRTDK2CUU2IR9J0GR,He said most of the village's residents had fled and regime forces were setting fire to houses and looting shops.,53,66,regime forces,5,1,6
3WRBLBQ2GR9Z4IRTDK2CUU2IR9J0GR,He said most of the village's residents had fled and regime forces were setting fire to houses and looting shops.,72,84,setting fire,0,1,1
3WRBLBQ2GR9Z4IRTDK2CUU2IR9J0GR,He said most of the village's residents had fled and regime forces were setting fire to houses and looting shops.,99,106,looting,6,6,12
3WRBLBQ2GR9Z4IRTDK2CUU2IR9J0GR,He said most of the village's residents had fled and regime forces were setting fire to houses and looting shops.,99,112,looting shops,3,2,5
3WRBLBQ2GR9Z4IRTDK2CUU2IR9J0GR,"He and the Observatory also reported shelling in a nearby village, Hayaleen.",11,22,Observatory,4,4,8
3WRBLBQ2GR9Z4IRTDK2CUU2IR9J0GR,"He and the Observatory also reported shelling in a nearby village, Hayaleen.",28,45,reported shelling,1,0,1
3WRBLBQ2GR9Z4IRTDK2CUU2IR9J0GR,"He and the Observatory also reported shelling in a nearby village, Hayaleen.",37,45,shelling,10,9,19
3WRBLBQ2GR9Z4IRTDK2CUU2IR9J0GR,"The regime is trying to punish these villages and to put an end to this revolution as quickly as it can, he said.",5,11,regime,6,2,8
3WRBLBQ2GR9Z4IRTDK2CUU2IR9J0GR,"The regime is trying to punish these villages and to put an end to this revolution as quickly as it can, he said.",73,83,revolution,6,6,12
3WRBLBQ2GR9Z4IRTDK2CUU2IR9J0GR,"In northern Lebanon, meanwhile, residents said running gunbattles broke out in the city Saturday and continued through Sunday morning, primarily between a neighborhood populated by Sunni Muslims opposed to Assad and another area with many Assad backers from his Alawite sect.",32,41,residents,1,0,1
3WRBLBQ2GR9Z4IRTDK2CUU2IR9J0GR,"In northern Lebanon, meanwhile, residents said running gunbattles broke out in the city Saturday and continued through Sunday morning, primarily between a neighborhood populated by Sunni Muslims opposed to Assad and another area with many Assad backers from his Alawite sect.",55,65,gunbattles,2,4,6
3WRBLBQ2GR9Z4IRTDK2CUU2IR9J0GR,"In northern Lebanon, meanwhile, residents said running gunbattles broke out in the city Saturday and continued through Sunday morning, primarily between a neighborhood populated by Sunni Muslims opposed to Assad and another area with many Assad backers from his Alawite sect.",135,144,primarily,2,0,2
3WRBLBQ2GR9Z4IRTDK2CUU2IR9J0GR,"In northern Lebanon, meanwhile, residents said running gunbattles broke out in the city Saturday and continued through Sunday morning, primarily between a neighborhood populated by Sunni Muslims opposed to Assad and another area with many Assad backers from his Alawite sect.",153,180,a neighborhood populated by,1,0,1
3WRBLBQ2GR9Z4IRTDK2CUU2IR9J0GR,"In northern Lebanon, meanwhile, residents said running gunbattles broke out in the city Saturday and continued through Sunday morning, primarily between a neighborhood populated by Sunni Muslims opposed to Assad and another area with many Assad backers from his Alawite sect.",168,177,populated,0,1,1
3WRBLBQ2GR9Z4IRTDK2CUU2IR9J0GR,"In northern Lebanon, meanwhile, residents said running gunbattles broke out in the city Saturday and continued through Sunday morning, primarily between a neighborhood populated by Sunni Muslims opposed to Assad and another area with many Assad backers from his Alawite sect.",181,186,Sunni,0,1,1
3WRBLBQ2GR9Z4IRTDK2CUU2IR9J0GR,"In northern Lebanon, meanwhile, residents said running gunbattles broke out in the city Saturday and continued through Sunday morning, primarily between a neighborhood populated by Sunni Muslims opposed to Assad and another area with many Assad backers from his Alawite sect.",181,194,Sunni Muslims,1,0,1
3WRBLBQ2GR9Z4IRTDK2CUU2IR9J0GR,"In northern Lebanon, meanwhile, residents said running gunbattles broke out in the city Saturday and continued through Sunday morning, primarily between a neighborhood populated by Sunni Muslims opposed to Assad and another area with many Assad backers from his Alawite sect.",239,252,Assad backers,0,1,1
3WRBLBQ2GR9Z4IRTDK2CUU2IR9J0GR,"In northern Lebanon, meanwhile, residents said running gunbattles broke out in the city Saturday and continued through Sunday morning, primarily between a neighborhood populated by Sunni Muslims opposed to Assad and another area with many Assad backers from his Alawite sect.",245,252,backers,2,3,5
3WRBLBQ2GR9Z4IRTDK2CUU2IR9J0GR,"In northern Lebanon, meanwhile, residents said running gunbattles broke out in the city Saturday and continued through Sunday morning, primarily between a neighborhood populated by Sunni Muslims opposed to Assad and another area with many Assad backers from his Alawite sect.",262,269,Alawite,1,2,3
3WRBLBQ2GR9Z4IRTDK2CUU2IR9J0GR,"In northern Lebanon, meanwhile, residents said running gunbattles broke out in the city Saturday and continued through Sunday morning, primarily between a neighborhood populated by Sunni Muslims opposed to Assad and another area with many Assad backers from his Alawite sect.",262,274,Alawite sect,2,1,3
3WRBLBQ2GR9Z4IRTDK2CUU2IR9J0GR,"In northern Lebanon, meanwhile, residents said running gunbattles broke out in the city Saturday and continued through Sunday morning, primarily between a neighborhood populated by Sunni Muslims opposed to Assad and another area with many Assad backers from his Alawite sect.",270,274,sect,3,1,4
3WRBLBQ2GR9Z4IRTDK2CUU2IR9J0GR,"The fighting highlights how easily trouble in Syria can raise tensions in neighboring Lebanon, with which it shares a complex web of political and sectarian ties and rivalries.",4,23,fighting highlights,0,1,1
3WRBLBQ2GR9Z4IRTDK2CUU2IR9J0GR,"The fighting highlights how easily trouble in Syria can raise tensions in neighboring Lebanon, with which it shares a complex web of political and sectarian ties and rivalries.",13,23,highlights,1,3,4
3WRBLBQ2GR9Z4IRTDK2CUU2IR9J0GR,"The fighting highlights how easily trouble in Syria can raise tensions in neighboring Lebanon, with which it shares a complex web of political and sectarian ties and rivalries.",28,42,easily trouble,1,0,1
3WRBLBQ2GR9Z4IRTDK2CUU2IR9J0GR,"The fighting highlights how easily trouble in Syria can raise tensions in neighboring Lebanon, with which it shares a complex web of political and sectarian ties and rivalries.",35,42,trouble,0,1,1
3WRBLBQ2GR9Z4IRTDK2CUU2IR9J0GR,"The fighting highlights how easily trouble in Syria can raise tensions in neighboring Lebanon, with which it shares a complex web of political and sectarian ties and rivalries.",56,70,raise tensions,0,2,2
3WRBLBQ2GR9Z4IRTDK2CUU2IR9J0GR,"The fighting highlights how easily trouble in Syria can raise tensions in neighboring Lebanon, with which it shares a complex web of political and sectarian ties and rivalries.",95,105,with which,1,0,1
3WRBLBQ2GR9Z4IRTDK2CUU2IR9J0GR,"The fighting highlights how easily trouble in Syria can raise tensions in neighboring Lebanon, with which it shares a complex web of political and sectarian ties and rivalries.",118,125,complex,1,0,1
3WRBLBQ2GR9Z4IRTDK2CUU2IR9J0GR,"The fighting highlights how easily trouble in Syria can raise tensions in neighboring Lebanon, with which it shares a complex web of political and sectarian ties and rivalries.",118,129,complex web,3,1,4
3WRBLBQ2GR9Z4IRTDK2CUU2IR9J0GR,"The fighting highlights how easily trouble in Syria can raise tensions in neighboring Lebanon, with which it shares a complex web of political and sectarian ties and rivalries.",118,161,complex web of political and sectarian ties,1,0,1
3WRBLBQ2GR9Z4IRTDK2CUU2IR9J0GR,"The fighting highlights how easily trouble in Syria can raise tensions in neighboring Lebanon, with which it shares a complex web of political and sectarian ties and rivalries.",126,175,web of political and sectarian ties and rivalries,1,0,1
3WRBLBQ2GR9Z4IRTDK2CUU2IR9J0GR,"The fighting highlights how easily trouble in Syria can raise tensions in neighboring Lebanon, with which it shares a complex web of political and sectarian ties and rivalries.",147,156,sectarian,9,6,15
3WRBLBQ2GR9Z4IRTDK2CUU2IR9J0GR,"The fighting highlights how easily trouble in Syria can raise tensions in neighboring Lebanon, with which it shares a complex web of political and sectarian ties and rivalries.",147,161,sectarian ties,4,0,4
3WRBLBQ2GR9Z4IRTDK2CUU2IR9J0GR,"The fighting highlights how easily trouble in Syria can raise tensions in neighboring Lebanon, with which it shares a complex web of political and sectarian ties and rivalries.",147,175,sectarian ties and rivalries,0,2,2
3WRBLBQ2GR9Z4IRTDK2CUU2IR9J0GR,"The fighting highlights how easily trouble in Syria can raise tensions in neighboring Lebanon, with which it shares a complex web of political and sectarian ties and rivalries.",166,175,rivalries,7,7,14
3B9J25CZ25EMOFV0K0PDE9NMN8MCSP,“Duck and cover here at the embassy.,0,5,“Duck,0,1,1
3B9J25CZ25EMOFV0K0PDE9NMN8MCSP,“Duck and cover here at the embassy.,0,15,“Duck and cover,7,2,9
3B9J25CZ25EMOFV0K0PDE9NMN8MCSP,“Duck and cover here at the embassy.,28,35,embassy,4,3,7
3B9J25CZ25EMOFV0K0PDE9NMN8MCSP,"Not a drill -- avoid the area,” the U.S. embassy said on Twitter.",0,11,Not a drill,0,1,1
3B9J25CZ25EMOFV0K0PDE9NMN8MCSP,"Not a drill -- avoid the area,” the U.S. embassy said on Twitter.",6,11,drill,2,8,10
3B9J25CZ25EMOFV0K0PDE9NMN8MCSP,"Not a drill -- avoid the area,” the U.S. embassy said on Twitter.",15,20,avoid,0,1,1
3B9J25CZ25EMOFV0K0PDE9NMN8MCSP,"Not a drill -- avoid the area,” the U.S. embassy said on Twitter.",41,48,embassy,1,0,1
3B9J25CZ25EMOFV0K0PDE9NMN8MCSP,"Not a drill -- avoid the area,” the U.S. embassy said on Twitter.",57,64,Twitter,0,1,1
3B9J25CZ25EMOFV0K0PDE9NMN8MCSP,"Karzai said the U.S. pact “is not threatening any third country, including the neighboring countries, but we are hoping that this leads to stability, prosperity and development in the region.”",0,6,Karzai,0,1,1
3B9J25CZ25EMOFV0K0PDE9NMN8MCSP,"Karzai said the U.S. pact “is not threatening any third country, including the neighboring countries, but we are hoping that this leads to stability, prosperity and development in the region.”",21,25,pact,4,1,5
3B9J25CZ25EMOFV0K0PDE9NMN8MCSP,"Karzai said the U.S. pact “is not threatening any third country, including the neighboring countries, but we are hoping that this leads to stability, prosperity and development in the region.”",34,45,threatening,1,6,7
3B9J25CZ25EMOFV0K0PDE9NMN8MCSP,"Karzai said the U.S. pact “is not threatening any third country, including the neighboring countries, but we are hoping that this leads to stability, prosperity and development in the region.”",50,63,third country,0,1,1
3B9J25CZ25EMOFV0K0PDE9NMN8MCSP,"Karzai said the U.S. pact “is not threatening any third country, including the neighboring countries, but we are hoping that this leads to stability, prosperity and development in the region.”",65,74,including,0,1,1
3B9J25CZ25EMOFV0K0PDE9NMN8MCSP,"Karzai said the U.S. pact “is not threatening any third country, including the neighboring countries, but we are hoping that this leads to stability, prosperity and development in the region.”",79,90,neighboring,2,0,2
3B9J25CZ25EMOFV0K0PDE9NMN8MCSP,"Karzai said the U.S. pact “is not threatening any third country, including the neighboring countries, but we are hoping that this leads to stability, prosperity and development in the region.”",130,135,leads,0,1,1
3B9J25CZ25EMOFV0K0PDE9NMN8MCSP,"Karzai said the U.S. pact “is not threatening any third country, including the neighboring countries, but we are hoping that this leads to stability, prosperity and development in the region.”",139,148,stability,8,4,12
3B9J25CZ25EMOFV0K0PDE9NMN8MCSP,"Karzai said the U.S. pact “is not threatening any third country, including the neighboring countries, but we are hoping that this leads to stability, prosperity and development in the region.”",139,176,"stability, prosperity and development",1,0,1
3B9J25CZ25EMOFV0K0PDE9NMN8MCSP,"Karzai said the U.S. pact “is not threatening any third country, including the neighboring countries, but we are hoping that this leads to stability, prosperity and development in the region.”",150,160,prosperity,10,6,16
3B9J25CZ25EMOFV0K0PDE9NMN8MCSP,"Karzai said the U.S. pact “is not threatening any third country, including the neighboring countries, but we are hoping that this leads to stability, prosperity and development in the region.”",165,176,development,2,1,3
3B9J25CZ25EMOFV0K0PDE9NMN8MCSP,"“Neither Americans nor the Afghan people asked for this war, yet for a decade we’ve stood together,” Obama said at the signing ceremony.",19,22,nor,0,1,1
3B9J25CZ25EMOFV0K0PDE9NMN8MCSP,"“Neither Americans nor the Afghan people asked for this war, yet for a decade we’ve stood together,” Obama said at the signing ceremony.",71,77,decade,0,4,4
3B9J25CZ25EMOFV0K0PDE9NMN8MCSP,"“Neither Americans nor the Afghan people asked for this war, yet for a decade we’ve stood together,” Obama said at the signing ceremony.",84,89,stood,0,2,2
3B9J25CZ25EMOFV0K0PDE9NMN8MCSP,"“Neither Americans nor the Afghan people asked for this war, yet for a decade we’ve stood together,” Obama said at the signing ceremony.",119,135,signing ceremony,4,3,7
3B9J25CZ25EMOFV0K0PDE9NMN8MCSP,"“Neither Americans nor the Afghan people asked for this war, yet for a decade we’ve stood together,” Obama said at the signing ceremony.",127,135,ceremony,3,2,5
3B9J25CZ25EMOFV0K0PDE9NMN8MCSP,“We look forward to a future of peace.,4,16,look forward,0,1,1
3B9J25CZ25EMOFV0K0PDE9NMN8MCSP,“We look forward to a future of peace.,22,37,future of peace,1,1,2
3B9J25CZ25EMOFV0K0PDE9NMN8MCSP,"We’re agreeing to be long-term partners,” said Obama, who later headed home aboard Air Force One after just six hours on the ground.",21,30,long-term,1,0,1
3B9J25CZ25EMOFV0K0PDE9NMN8MCSP,"We’re agreeing to be long-term partners,” said Obama, who later headed home aboard Air Force One after just six hours on the ground.",21,39,long-term partners,1,0,1
3B9J25CZ25EMOFV0K0PDE9NMN8MCSP,"We’re agreeing to be long-term partners,” said Obama, who later headed home aboard Air Force One after just six hours on the ground.",64,70,headed,1,1,2
3B9J25CZ25EMOFV0K0PDE9NMN8MCSP,"The pact, agreed last month, sees the possibility of American forces staying behind to train Afghan forces and pursue the remnants of al-Qaeda for 10 years after 2014.",4,8,pact,4,1,5
3B9J25CZ25EMOFV0K0PDE9NMN8MCSP,"The pact, agreed last month, sees the possibility of American forces staying behind to train Afghan forces and pursue the remnants of al-Qaeda for 10 years after 2014.",38,49,possibility,1,2,3
3B9J25CZ25EMOFV0K0PDE9NMN8MCSP,"The pact, agreed last month, sees the possibility of American forces staying behind to train Afghan forces and pursue the remnants of al-Qaeda for 10 years after 2014.",69,83,staying behind,0,1,1
3B9J25CZ25EMOFV0K0PDE9NMN8MCSP,"The pact, agreed last month, sees the possibility of American forces staying behind to train Afghan forces and pursue the remnants of al-Qaeda for 10 years after 2014.",111,117,pursue,6,8,14
3B9J25CZ25EMOFV0K0PDE9NMN8MCSP,"The pact, agreed last month, sees the possibility of American forces staying behind to train Afghan forces and pursue the remnants of al-Qaeda for 10 years after 2014.",122,130,remnants,10,10,20
3PZDSVZ3J5IMDYQGJP29WH1S9XLN42,"Putin officially registered on Wednesday to run for the presidency in March, but the unusually sustained protests of the past two days showed the indignation of the Russian opposition and suggested his drive to retake the job he held from 2000-2008 may not go as smoothly as expected.",6,16,officially,0,1,1
3PZDSVZ3J5IMDYQGJP29WH1S9XLN42,"Putin officially registered on Wednesday to run for the presidency in March, but the unusually sustained protests of the past two days showed the indignation of the Russian opposition and suggested his drive to retake the job he held from 2000-2008 may not go as smoothly as expected.",17,27,registered,0,1,1
3PZDSVZ3J5IMDYQGJP29WH1S9XLN42,"Putin officially registered on Wednesday to run for the presidency in March, but the unusually sustained protests of the past two days showed the indignation of the Russian opposition and suggested his drive to retake the job he held from 2000-2008 may not go as smoothly as expected.",56,66,presidency,0,1,1
3PZDSVZ3J5IMDYQGJP29WH1S9XLN42,"Putin officially registered on Wednesday to run for the presidency in March, but the unusually sustained protests of the past two days showed the indignation of the Russian opposition and suggested his drive to retake the job he held from 2000-2008 may not go as smoothly as expected.",85,94,unusually,1,0,1
3PZDSVZ3J5IMDYQGJP29WH1S9XLN42,"Putin officially registered on Wednesday to run for the presidency in March, but the unusually sustained protests of the past two days showed the indignation of the Russian opposition and suggested his drive to retake the job he held from 2000-2008 may not go as smoothly as expected.",85,104,unusually sustained,1,0,1
3PZDSVZ3J5IMDYQGJP29WH1S9XLN42,"Putin officially registered on Wednesday to run for the presidency in March, but the unusually sustained protests of the past two days showed the indignation of the Russian opposition and suggested his drive to retake the job he held from 2000-2008 may not go as smoothly as expected.",85,113,unusually sustained protests,1,0,1
3PZDSVZ3J5IMDYQGJP29WH1S9XLN42,"Putin officially registered on Wednesday to run for the presidency in March, but the unusually sustained protests of the past two days showed the indignation of the Russian opposition and suggested his drive to retake the job he held from 2000-2008 may not go as smoothly as expected.",95,104,sustained,9,6,15
3PZDSVZ3J5IMDYQGJP29WH1S9XLN42,"Putin officially registered on Wednesday to run for the presidency in March, but the unusually sustained protests of the past two days showed the indignation of the Russian opposition and suggested his drive to retake the job he held from 2000-2008 may not go as smoothly as expected.",95,113,sustained protests,1,3,4
3PZDSVZ3J5IMDYQGJP29WH1S9XLN42,"Putin officially registered on Wednesday to run for the presidency in March, but the unusually sustained protests of the past two days showed the indignation of the Russian opposition and suggested his drive to retake the job he held from 2000-2008 may not go as smoothly as expected.",105,113,protests,1,2,3
3PZDSVZ3J5IMDYQGJP29WH1S9XLN42,"Putin officially registered on Wednesday to run for the presidency in March, but the unusually sustained protests of the past two days showed the indignation of the Russian opposition and suggested his drive to retake the job he held from 2000-2008 may not go as smoothly as expected.",146,157,indignation,10,10,20
3PZDSVZ3J5IMDYQGJP29WH1S9XLN42,"Putin officially registered on Wednesday to run for the presidency in March, but the unusually sustained protests of the past two days showed the indignation of the Russian opposition and suggested his drive to retake the job he held from 2000-2008 may not go as smoothly as expected.",173,183,opposition,4,1,5
3PZDSVZ3J5IMDYQGJP29WH1S9XLN42,"Putin officially registered on Wednesday to run for the presidency in March, but the unusually sustained protests of the past two days showed the indignation of the Russian opposition and suggested his drive to retake the job he held from 2000-2008 may not go as smoothly as expected.",188,197,suggested,0,1,1
3PZDSVZ3J5IMDYQGJP29WH1S9XLN42,"Putin officially registered on Wednesday to run for the presidency in March, but the unusually sustained protests of the past two days showed the indignation of the Russian opposition and suggested his drive to retake the job he held from 2000-2008 may not go as smoothly as expected.",202,207,drive,0,1,1
3PZDSVZ3J5IMDYQGJP29WH1S9XLN42,"Putin officially registered on Wednesday to run for the presidency in March, but the unusually sustained protests of the past two days showed the indignation of the Russian opposition and suggested his drive to retake the job he held from 2000-2008 may not go as smoothly as expected.",211,217,retake,0,2,2
3PZDSVZ3J5IMDYQGJP29WH1S9XLN42,"Putin officially registered on Wednesday to run for the presidency in March, but the unusually sustained protests of the past two days showed the indignation of the Russian opposition and suggested his drive to retake the job he held from 2000-2008 may not go as smoothly as expected.",260,283,as smoothly as expected,1,0,1
3PZDSVZ3J5IMDYQGJP29WH1S9XLN42,"Putin officially registered on Wednesday to run for the presidency in March, but the unusually sustained protests of the past two days showed the indignation of the Russian opposition and suggested his drive to retake the job he held from 2000-2008 may not go as smoothly as expected.",263,271,smoothly,0,1,1
3PZDSVZ3J5IMDYQGJP29WH1S9XLN42,"Putin officially registered on Wednesday to run for the presidency in March, but the unusually sustained protests of the past two days showed the indignation of the Russian opposition and suggested his drive to retake the job he held from 2000-2008 may not go as smoothly as expected.",275,283,expected,0,1,1
3PZDSVZ3J5IMDYQGJP29WH1S9XLN42,"The Russian Union of Journalists on Wednesday condemned police violence and called for a probe into the dozens of attacks and arrests of journalists, describing them as ""an attempt to gag and intimidate society.""",46,55,condemned,9,10,19
3PZDSVZ3J5IMDYQGJP29WH1S9XLN42,"The Russian Union of Journalists on Wednesday condemned police violence and called for a probe into the dozens of attacks and arrests of journalists, describing them as ""an attempt to gag and intimidate society.""",63,71,violence,0,2,2
3PZDSVZ3J5IMDYQGJP29WH1S9XLN42,"The Russian Union of Journalists on Wednesday condemned police violence and called for a probe into the dozens of attacks and arrests of journalists, describing them as ""an attempt to gag and intimidate society.""",89,94,probe,2,8,10
3PZDSVZ3J5IMDYQGJP29WH1S9XLN42,"The Russian Union of Journalists on Wednesday condemned police violence and called for a probe into the dozens of attacks and arrests of journalists, describing them as ""an attempt to gag and intimidate society.""",104,110,dozens,0,1,1
3PZDSVZ3J5IMDYQGJP29WH1S9XLN42,"The Russian Union of Journalists on Wednesday condemned police violence and called for a probe into the dozens of attacks and arrests of journalists, describing them as ""an attempt to gag and intimidate society.""",150,160,describing,0,1,1
3PZDSVZ3J5IMDYQGJP29WH1S9XLN42,"The Russian Union of Journalists on Wednesday condemned police violence and called for a probe into the dozens of attacks and arrests of journalists, describing them as ""an attempt to gag and intimidate society.""",181,187,to gag,1,0,1
3PZDSVZ3J5IMDYQGJP29WH1S9XLN42,"The Russian Union of Journalists on Wednesday condemned police violence and called for a probe into the dozens of attacks and arrests of journalists, describing them as ""an attempt to gag and intimidate society.""",184,187,gag,6,10,16
3PZDSVZ3J5IMDYQGJP29WH1S9XLN42,"The Russian Union of Journalists on Wednesday condemned police violence and called for a probe into the dozens of attacks and arrests of journalists, describing them as ""an attempt to gag and intimidate society.""",184,202,gag and intimidate,1,0,1
3PZDSVZ3J5IMDYQGJP29WH1S9XLN42,"The Russian Union of Journalists on Wednesday condemned police violence and called for a probe into the dozens of attacks and arrests of journalists, describing them as ""an attempt to gag and intimidate society.""",192,202,intimidate,7,8,15
3PZDSVZ3J5IMDYQGJP29WH1S9XLN42,"The Russian Union of Journalists on Wednesday condemned police violence and called for a probe into the dozens of attacks and arrests of journalists, describing them as ""an attempt to gag and intimidate society.""",192,210,intimidate society,0,3,3
3PZDSVZ3J5IMDYQGJP29WH1S9XLN42,"More opposition rallies were expected Wednesday, along with a pro-Putin gathering in central Moscow that had attracted a few hundred people so far.",5,15,opposition,3,0,3
3PZDSVZ3J5IMDYQGJP29WH1S9XLN42,"More opposition rallies were expected Wednesday, along with a pro-Putin gathering in central Moscow that had attracted a few hundred people so far.",5,23,opposition rallies,5,0,5
3PZDSVZ3J5IMDYQGJP29WH1S9XLN42,"More opposition rallies were expected Wednesday, along with a pro-Putin gathering in central Moscow that had attracted a few hundred people so far.",16,23,rallies,0,4,4
3PZDSVZ3J5IMDYQGJP29WH1S9XLN42,"More opposition rallies were expected Wednesday, along with a pro-Putin gathering in central Moscow that had attracted a few hundred people so far.",62,71,pro-Putin,1,1,2
3PZDSVZ3J5IMDYQGJP29WH1S9XLN42,"More opposition rallies were expected Wednesday, along with a pro-Putin gathering in central Moscow that had attracted a few hundred people so far.",62,81,pro-Putin gathering,2,1,3
3PZDSVZ3J5IMDYQGJP29WH1S9XLN42,"More opposition rallies were expected Wednesday, along with a pro-Putin gathering in central Moscow that had attracted a few hundred people so far.",72,81,gathering,0,3,3
3PZDSVZ3J5IMDYQGJP29WH1S9XLN42,"Sunday's parliamentary vote suggested Russians are tiring of Putin and his United Russia party, which has strongly overshadowed all other political forces in Russia for the past dozen years and earned a reputation for corruption.",9,22,parliamentary,5,2,7
3PZDSVZ3J5IMDYQGJP29WH1S9XLN42,"Sunday's parliamentary vote suggested Russians are tiring of Putin and his United Russia party, which has strongly overshadowed all other political forces in Russia for the past dozen years and earned a reputation for corruption.",9,27,parliamentary vote,1,0,1
3PZDSVZ3J5IMDYQGJP29WH1S9XLN42,"Sunday's parliamentary vote suggested Russians are tiring of Putin and his United Russia party, which has strongly overshadowed all other political forces in Russia for the past dozen years and earned a reputation for corruption.",28,37,suggested,0,1,1
3PZDSVZ3J5IMDYQGJP29WH1S9XLN42,"Sunday's parliamentary vote suggested Russians are tiring of Putin and his United Russia party, which has strongly overshadowed all other political forces in Russia for the past dozen years and earned a reputation for corruption.",51,57,tiring,1,2,3
3PZDSVZ3J5IMDYQGJP29WH1S9XLN42,"Sunday's parliamentary vote suggested Russians are tiring of Putin and his United Russia party, which has strongly overshadowed all other political forces in Russia for the past dozen years and earned a reputation for corruption.",51,66,tiring of Putin,0,1,1
3PZDSVZ3J5IMDYQGJP29WH1S9XLN42,"Sunday's parliamentary vote suggested Russians are tiring of Putin and his United Russia party, which has strongly overshadowed all other political forces in Russia for the past dozen years and earned a reputation for corruption.",61,66,Putin,0,1,1
3PZDSVZ3J5IMDYQGJP29WH1S9XLN42,"Sunday's parliamentary vote suggested Russians are tiring of Putin and his United Russia party, which has strongly overshadowed all other political forces in Russia for the past dozen years and earned a reputation for corruption.",75,94,United Russia party,1,0,1
3PZDSVZ3J5IMDYQGJP29WH1S9XLN42,"Sunday's parliamentary vote suggested Russians are tiring of Putin and his United Russia party, which has strongly overshadowed all other political forces in Russia for the past dozen years and earned a reputation for corruption.",106,127,strongly overshadowed,1,0,1
3PZDSVZ3J5IMDYQGJP29WH1S9XLN42,"Sunday's parliamentary vote suggested Russians are tiring of Putin and his United Russia party, which has strongly overshadowed all other political forces in Russia for the past dozen years and earned a reputation for corruption.",115,127,overshadowed,7,10,17
3PZDSVZ3J5IMDYQGJP29WH1S9XLN42,"Sunday's parliamentary vote suggested Russians are tiring of Putin and his United Russia party, which has strongly overshadowed all other political forces in Russia for the past dozen years and earned a reputation for corruption.",138,154,political forces,1,0,1
3PZDSVZ3J5IMDYQGJP29WH1S9XLN42,"Sunday's parliamentary vote suggested Russians are tiring of Putin and his United Russia party, which has strongly overshadowed all other political forces in Russia for the past dozen years and earned a reputation for corruption.",203,213,reputation,5,4,9
3PZDSVZ3J5IMDYQGJP29WH1S9XLN42,"Sunday's parliamentary vote suggested Russians are tiring of Putin and his United Russia party, which has strongly overshadowed all other political forces in Russia for the past dozen years and earned a reputation for corruption.",203,228,reputation for corruption,1,0,1
3PZDSVZ3J5IMDYQGJP29WH1S9XLN42,"Sunday's parliamentary vote suggested Russians are tiring of Putin and his United Russia party, which has strongly overshadowed all other political forces in Russia for the past dozen years and earned a reputation for corruption.",218,228,corruption,7,6,13
3Z33IC0JC0N0I9512BKRN66LGRD9VA,The assault raises fresh concern about the resilience of the insurgency on the anniversary of Osama bin Laden's death as NATO winds down its combat presence in the next two years and hands over responsibility for security to Afghan forces.,4,11,assault,2,6,8
3Z33IC0JC0N0I9512BKRN66LGRD9VA,The assault raises fresh concern about the resilience of the insurgency on the anniversary of Osama bin Laden's death as NATO winds down its combat presence in the next two years and hands over responsibility for security to Afghan forces.,12,18,raises,1,1,2
3Z33IC0JC0N0I9512BKRN66LGRD9VA,The assault raises fresh concern about the resilience of the insurgency on the anniversary of Osama bin Laden's death as NATO winds down its combat presence in the next two years and hands over responsibility for security to Afghan forces.,12,32,raises fresh concern,1,0,1
3Z33IC0JC0N0I9512BKRN66LGRD9VA,The assault raises fresh concern about the resilience of the insurgency on the anniversary of Osama bin Laden's death as NATO winds down its combat presence in the next two years and hands over responsibility for security to Afghan forces.,19,32,fresh concern,1,0,1
3Z33IC0JC0N0I9512BKRN66LGRD9VA,The assault raises fresh concern about the resilience of the insurgency on the anniversary of Osama bin Laden's death as NATO winds down its combat presence in the next two years and hands over responsibility for security to Afghan forces.,25,32,concern,0,3,3
3Z33IC0JC0N0I9512BKRN66LGRD9VA,The assault raises fresh concern about the resilience of the insurgency on the anniversary of Osama bin Laden's death as NATO winds down its combat presence in the next two years and hands over responsibility for security to Afghan forces.,43,53,resilience,10,10,20
3Z33IC0JC0N0I9512BKRN66LGRD9VA,The assault raises fresh concern about the resilience of the insurgency on the anniversary of Osama bin Laden's death as NATO winds down its combat presence in the next two years and hands over responsibility for security to Afghan forces.,61,71,insurgency,10,9,19
3Z33IC0JC0N0I9512BKRN66LGRD9VA,The assault raises fresh concern about the resilience of the insurgency on the anniversary of Osama bin Laden's death as NATO winds down its combat presence in the next two years and hands over responsibility for security to Afghan forces.,79,90,anniversary,2,2,4
3Z33IC0JC0N0I9512BKRN66LGRD9VA,The assault raises fresh concern about the resilience of the insurgency on the anniversary of Osama bin Laden's death as NATO winds down its combat presence in the next two years and hands over responsibility for security to Afghan forces.,94,135,Osama bin Ladens death as NATO winds down,1,0,1
3Z33IC0JC0N0I9512BKRN66LGRD9VA,The assault raises fresh concern about the resilience of the insurgency on the anniversary of Osama bin Laden's death as NATO winds down its combat presence in the next two years and hands over responsibility for security to Afghan forces.,121,125,NATO,1,0,1
3Z33IC0JC0N0I9512BKRN66LGRD9VA,The assault raises fresh concern about the resilience of the insurgency on the anniversary of Osama bin Laden's death as NATO winds down its combat presence in the next two years and hands over responsibility for security to Afghan forces.,126,131,winds,0,1,1
3Z33IC0JC0N0I9512BKRN66LGRD9VA,The assault raises fresh concern about the resilience of the insurgency on the anniversary of Osama bin Laden's death as NATO winds down its combat presence in the next two years and hands over responsibility for security to Afghan forces.,126,136,winds down,0,2,2
3Z33IC0JC0N0I9512BKRN66LGRD9VA,The assault raises fresh concern about the resilience of the insurgency on the anniversary of Osama bin Laden's death as NATO winds down its combat presence in the next two years and hands over responsibility for security to Afghan forces.,141,147,combat,0,3,3
3Z33IC0JC0N0I9512BKRN66LGRD9VA,The assault raises fresh concern about the resilience of the insurgency on the anniversary of Osama bin Laden's death as NATO winds down its combat presence in the next two years and hands over responsibility for security to Afghan forces.,141,156,combat presence,1,0,1
3Z33IC0JC0N0I9512BKRN66LGRD9VA,The assault raises fresh concern about the resilience of the insurgency on the anniversary of Osama bin Laden's death as NATO winds down its combat presence in the next two years and hands over responsibility for security to Afghan forces.,148,156,presence,1,0,1
3Z33IC0JC0N0I9512BKRN66LGRD9VA,The assault raises fresh concern about the resilience of the insurgency on the anniversary of Osama bin Laden's death as NATO winds down its combat presence in the next two years and hands over responsibility for security to Afghan forces.,183,193,hands over,0,1,1
3Z33IC0JC0N0I9512BKRN66LGRD9VA,The assault raises fresh concern about the resilience of the insurgency on the anniversary of Osama bin Laden's death as NATO winds down its combat presence in the next two years and hands over responsibility for security to Afghan forces.,194,208,responsibility,1,0,1
3Z33IC0JC0N0I9512BKRN66LGRD9VA,"The Taliban said the assault was a riposte to Obama, who just hours earlier signed a new partnership pact in Kabul to govern Afghan-US relations after 2014 -- a deal the insurgents dismissed as ""illegitimate"".",21,28,assault,2,0,2
3Z33IC0JC0N0I9512BKRN66LGRD9VA,"The Taliban said the assault was a riposte to Obama, who just hours earlier signed a new partnership pact in Kabul to govern Afghan-US relations after 2014 -- a deal the insurgents dismissed as ""illegitimate"".",35,42,riposte,10,8,18
3Z33IC0JC0N0I9512BKRN66LGRD9VA,"The Taliban said the assault was a riposte to Obama, who just hours earlier signed a new partnership pact in Kabul to govern Afghan-US relations after 2014 -- a deal the insurgents dismissed as ""illegitimate"".",89,105,partnership pact,2,0,2
3Z33IC0JC0N0I9512BKRN66LGRD9VA,"The Taliban said the assault was a riposte to Obama, who just hours earlier signed a new partnership pact in Kabul to govern Afghan-US relations after 2014 -- a deal the insurgents dismissed as ""illegitimate"".",101,105,pact,1,0,1
3Z33IC0JC0N0I9512BKRN66LGRD9VA,"The Taliban said the assault was a riposte to Obama, who just hours earlier signed a new partnership pact in Kabul to govern Afghan-US relations after 2014 -- a deal the insurgents dismissed as ""illegitimate"".",161,165,deal,0,1,1
3Z33IC0JC0N0I9512BKRN66LGRD9VA,"The Taliban said the assault was a riposte to Obama, who just hours earlier signed a new partnership pact in Kabul to govern Afghan-US relations after 2014 -- a deal the insurgents dismissed as ""illegitimate"".",170,180,insurgents,7,4,11
3Z33IC0JC0N0I9512BKRN66LGRD9VA,"The Taliban said the assault was a riposte to Obama, who just hours earlier signed a new partnership pact in Kabul to govern Afghan-US relations after 2014 -- a deal the insurgents dismissed as ""illegitimate"".",170,190,insurgents dismissed,0,1,1
3Z33IC0JC0N0I9512BKRN66LGRD9VA,"The Taliban said the assault was a riposte to Obama, who just hours earlier signed a new partnership pact in Kabul to govern Afghan-US relations after 2014 -- a deal the insurgents dismissed as ""illegitimate"".",181,190,dismissed,0,3,3
3Z33IC0JC0N0I9512BKRN66LGRD9VA,"The Taliban said the assault was a riposte to Obama, who just hours earlier signed a new partnership pact in Kabul to govern Afghan-US relations after 2014 -- a deal the insurgents dismissed as ""illegitimate"".",195,207,illegitimate,10,9,19
3Z33IC0JC0N0I9512BKRN66LGRD9VA,"In an election-year address, Obama presented himself as a commander-in-chief capable of ending two long wars, following the US withdrawal from Iraq, and crushing Al-Qaeda, and tried to conjure up a new dawn for a US public exhausted by conflict and recession.",58,76,commander-in-chief,3,4,7
3Z33IC0JC0N0I9512BKRN66LGRD9VA,"In an election-year address, Obama presented himself as a commander-in-chief capable of ending two long wars, following the US withdrawal from Iraq, and crushing Al-Qaeda, and tried to conjure up a new dawn for a US public exhausted by conflict and recession.",77,84,capable,1,0,1
3Z33IC0JC0N0I9512BKRN66LGRD9VA,"In an election-year address, Obama presented himself as a commander-in-chief capable of ending two long wars, following the US withdrawal from Iraq, and crushing Al-Qaeda, and tried to conjure up a new dawn for a US public exhausted by conflict and recession.",124,147,US withdrawal from Iraq,1,0,1
3Z33IC0JC0N0I9512BKRN66LGRD9VA,"In an election-year address, Obama presented himself as a commander-in-chief capable of ending two long wars, following the US withdrawal from Iraq, and crushing Al-Qaeda, and tried to conjure up a new dawn for a US public exhausted by conflict and recession.",127,137,withdrawal,2,5,7
3Z33IC0JC0N0I9512BKRN66LGRD9VA,"In an election-year address, Obama presented himself as a commander-in-chief capable of ending two long wars, following the US withdrawal from Iraq, and crushing Al-Qaeda, and tried to conjure up a new dawn for a US public exhausted by conflict and recession.",153,161,crushing,0,1,1
3Z33IC0JC0N0I9512BKRN66LGRD9VA,"In an election-year address, Obama presented himself as a commander-in-chief capable of ending two long wars, following the US withdrawal from Iraq, and crushing Al-Qaeda, and tried to conjure up a new dawn for a US public exhausted by conflict and recession.",153,170,crushing Al-Qaeda,1,1,2
3Z33IC0JC0N0I9512BKRN66LGRD9VA,"In an election-year address, Obama presented himself as a commander-in-chief capable of ending two long wars, following the US withdrawal from Iraq, and crushing Al-Qaeda, and tried to conjure up a new dawn for a US public exhausted by conflict and recession.",176,222,tried to conjure up a new dawn for a US public,1,0,1
3Z33IC0JC0N0I9512BKRN66LGRD9VA,"In an election-year address, Obama presented himself as a commander-in-chief capable of ending two long wars, following the US withdrawal from Iraq, and crushing Al-Qaeda, and tried to conjure up a new dawn for a US public exhausted by conflict and recession.",185,192,conjure,6,10,16
3Z33IC0JC0N0I9512BKRN66LGRD9VA,"In an election-year address, Obama presented himself as a commander-in-chief capable of ending two long wars, following the US withdrawal from Iraq, and crushing Al-Qaeda, and tried to conjure up a new dawn for a US public exhausted by conflict and recession.",185,195,conjure up,3,2,5
3Z33IC0JC0N0I9512BKRN66LGRD9VA,"In an election-year address, Obama presented himself as a commander-in-chief capable of ending two long wars, following the US withdrawal from Iraq, and crushing Al-Qaeda, and tried to conjure up a new dawn for a US public exhausted by conflict and recession.",198,206,new dawn,0,1,1
3Z33IC0JC0N0I9512BKRN66LGRD9VA,"In an election-year address, Obama presented himself as a commander-in-chief capable of ending two long wars, following the US withdrawal from Iraq, and crushing Al-Qaeda, and tried to conjure up a new dawn for a US public exhausted by conflict and recession.",202,206,dawn,0,1,1
3Z33IC0JC0N0I9512BKRN66LGRD9VA,"In an election-year address, Obama presented himself as a commander-in-chief capable of ending two long wars, following the US withdrawal from Iraq, and crushing Al-Qaeda, and tried to conjure up a new dawn for a US public exhausted by conflict and recession.",223,232,exhausted,1,5,6
3Z33IC0JC0N0I9512BKRN66LGRD9VA,"In an election-year address, Obama presented himself as a commander-in-chief capable of ending two long wars, following the US withdrawal from Iraq, and crushing Al-Qaeda, and tried to conjure up a new dawn for a US public exhausted by conflict and recession.",236,244,conflict,1,2,3
3Z33IC0JC0N0I9512BKRN66LGRD9VA,"In an election-year address, Obama presented himself as a commander-in-chief capable of ending two long wars, following the US withdrawal from Iraq, and crushing Al-Qaeda, and tried to conjure up a new dawn for a US public exhausted by conflict and recession.",249,258,recession,4,5,9
3Z33IC0JC0N0I9512BKRN66LGRD9VA,"This time of war began in Afghanistan, and this is where it will end, Obama said, recalling a decade-long ""dark cloud of war"" after bin Laden plotted the September 11 attacks in 2001.",84,93,recalling,2,2,4
3Z33IC0JC0N0I9512BKRN66LGRD9VA,"This time of war began in Afghanistan, and this is where it will end, Obama said, recalling a decade-long ""dark cloud of war"" after bin Laden plotted the September 11 attacks in 2001.",96,107,decade-long,0,1,1
3Z33IC0JC0N0I9512BKRN66LGRD9VA,"This time of war began in Afghanistan, and this is where it will end, Obama said, recalling a decade-long ""dark cloud of war"" after bin Laden plotted the September 11 attacks in 2001.",109,126,dark cloud of war,2,1,3
3Z33IC0JC0N0I9512BKRN66LGRD9VA,"This time of war began in Afghanistan, and this is where it will end, Obama said, recalling a decade-long ""dark cloud of war"" after bin Laden plotted the September 11 attacks in 2001.",144,151,plotted,3,3,6
3TKXBROM5TBK2FYAPGCLXBUU4IEIJE,"Dozens more were wounded in Monday's violence, the UK-based Syrian Observatory for Human Rights said.",0,6,Dozens,0,1,1
3TKXBROM5TBK2FYAPGCLXBUU4IEIJE,"Dozens more were wounded in Monday's violence, the UK-based Syrian Observatory for Human Rights said.",17,24,wounded,0,3,3
3TKXBROM5TBK2FYAPGCLXBUU4IEIJE,"Dozens more were wounded in Monday's violence, the UK-based Syrian Observatory for Human Rights said.",37,45,violence,0,1,1
3TKXBROM5TBK2FYAPGCLXBUU4IEIJE,"Dozens more were wounded in Monday's violence, the UK-based Syrian Observatory for Human Rights said.",60,78,Syrian Observatory,0,1,1
3TKXBROM5TBK2FYAPGCLXBUU4IEIJE,"Dozens more were wounded in Monday's violence, the UK-based Syrian Observatory for Human Rights said.",67,78,Observatory,3,6,9
3TKXBROM5TBK2FYAPGCLXBUU4IEIJE,"Opposition sources also said the army had shelled the town, which they say has been under rebel control since January.",0,10,Opposition,6,0,6
3TKXBROM5TBK2FYAPGCLXBUU4IEIJE,"Opposition sources also said the army had shelled the town, which they say has been under rebel control since January.",0,18,Opposition sources,2,0,2
3TKXBROM5TBK2FYAPGCLXBUU4IEIJE,"Opposition sources also said the army had shelled the town, which they say has been under rebel control since January.",42,49,shelled,10,10,20
3TKXBROM5TBK2FYAPGCLXBUU4IEIJE,"Opposition sources also said the army had shelled the town, which they say has been under rebel control since January.",42,58,shelled the town,0,1,1
3TKXBROM5TBK2FYAPGCLXBUU4IEIJE,"Opposition sources also said the army had shelled the town, which they say has been under rebel control since January.",90,95,rebel,0,3,3
3TKXBROM5TBK2FYAPGCLXBUU4IEIJE,"Opposition sources also said the army had shelled the town, which they say has been under rebel control since January.",90,103,rebel control,2,1,3
3TKXBROM5TBK2FYAPGCLXBUU4IEIJE,Nine people were reportedly killed in the bombardment.,17,27,reportedly,0,1,1
3TKXBROM5TBK2FYAPGCLXBUU4IEIJE,Nine people were reportedly killed in the bombardment.,42,53,bombardment,10,10,20
3TKXBROM5TBK2FYAPGCLXBUU4IEIJE,"Shells and rockets have been hitting the town since 3am (12:00 GMT) at a rate of one a minute.	1	7	Shells	3	2	5
3TKXBROM5TBK2FYAPGCLXBUU4IEIJE	Rastan has been destroyed, a member of the opposition Free Syrian Army in Rastan who declined to be named told Reuters news agency by satellite phone.",16,25,destroyed,0,1,1
3TKXBROM5TBK2FYAPGCLXBUU4IEIJE,"Rastan has been destroyed,"" a member of the opposition Free Syrian Army in Rastan who declined to be named told Reuters news agency by satellite phone.",44,54,opposition,2,1,3
3TKXBROM5TBK2FYAPGCLXBUU4IEIJE,"Rastan has been destroyed,"" a member of the opposition Free Syrian Army in Rastan who declined to be named told Reuters news agency by satellite phone.",86,94,declined,1,6,7
3TKXBROM5TBK2FYAPGCLXBUU4IEIJE,"Rastan has been destroyed,"" a member of the opposition Free Syrian Army in Rastan who declined to be named told Reuters news agency by satellite phone.",86,106,declined to be named,1,0,1
3TKXBROM5TBK2FYAPGCLXBUU4IEIJE,"Rastan has been destroyed,"" a member of the opposition Free Syrian Army in Rastan who declined to be named told Reuters news agency by satellite phone.",112,119,Reuters,1,0,1
3TKXBROM5TBK2FYAPGCLXBUU4IEIJE,"Rastan has been destroyed,"" a member of the opposition Free Syrian Army in Rastan who declined to be named told Reuters news agency by satellite phone.",120,131,news agency,1,0,1
3TKXBROM5TBK2FYAPGCLXBUU4IEIJE,"Rastan has been destroyed,"" a member of the opposition Free Syrian Army in Rastan who declined to be named told Reuters news agency by satellite phone.",135,144,satellite,3,1,4
3TKXBROM5TBK2FYAPGCLXBUU4IEIJE,"Rastan has been destroyed,"" a member of the opposition Free Syrian Army in Rastan who declined to be named told Reuters news agency by satellite phone.",135,150,satellite phone,5,1,6
3TKXBROM5TBK2FYAPGCLXBUU4IEIJE,"Al Jazeera's Rula Amin, reporting from Beirut in neighbouring Lebanon, said three armoured vehicles carrying government troops had been attacked as they were heading to Rastan, in Homs province.",49,61,neighbouring,1,1,2
3TKXBROM5TBK2FYAPGCLXBUU4IEIJE,"Al Jazeera's Rula Amin, reporting from Beirut in neighbouring Lebanon, said three armoured vehicles carrying government troops had been attacked as they were heading to Rastan, in Homs province.",82,90,armoured,6,6,12
3TKXBROM5TBK2FYAPGCLXBUU4IEIJE,"Al Jazeera's Rula Amin, reporting from Beirut in neighbouring Lebanon, said three armoured vehicles carrying government troops had been attacked as they were heading to Rastan, in Homs province.",82,99,armoured vehicles,2,2,4
3TKXBROM5TBK2FYAPGCLXBUU4IEIJE,"Al Jazeera's Rula Amin, reporting from Beirut in neighbouring Lebanon, said three armoured vehicles carrying government troops had been attacked as they were heading to Rastan, in Homs province.",109,119,government,1,0,1
3TKXBROM5TBK2FYAPGCLXBUU4IEIJE,"Al Jazeera's Rula Amin, reporting from Beirut in neighbouring Lebanon, said three armoured vehicles carrying government troops had been attacked as they were heading to Rastan, in Homs province.",120,126,troops,0,1,1
3TKXBROM5TBK2FYAPGCLXBUU4IEIJE,"Al Jazeera's Rula Amin, reporting from Beirut in neighbouring Lebanon, said three armoured vehicles carrying government troops had been attacked as they were heading to Rastan, in Homs province.",158,168,heading to,1,0,1
3TKXBROM5TBK2FYAPGCLXBUU4IEIJE,"Al Jazeera's Rula Amin, reporting from Beirut in neighbouring Lebanon, said three armoured vehicles carrying government troops had been attacked as they were heading to Rastan, in Homs province.",185,193,province,2,2,4
3TKXBROM5TBK2FYAPGCLXBUU4IEIJE,"Rastan is a strategic town and a stronghold of the Free Syrian Army, she said.",13,22,strategic,6,10,16
3TKXBROM5TBK2FYAPGCLXBUU4IEIJE,"Rastan is a strategic town and a stronghold of the Free Syrian Army, she said.",13,27,strategic town,2,0,2
3TKXBROM5TBK2FYAPGCLXBUU4IEIJE,"Rastan is a strategic town and a stronghold of the Free Syrian Army, she said.",34,44,stronghold,9,10,19
3PUOXASB574HRTAB389U8CJH5379Z1,Lebanon's national news agency NNA said one soldier was shot dead by a sniper in the city early Sunday.,10,18,national,1,0,1
3PUOXASB574HRTAB389U8CJH5379Z1,Lebanon's national news agency NNA said one soldier was shot dead by a sniper in the city early Sunday.,24,30,agency,2,0,2
3PUOXASB574HRTAB389U8CJH5379Z1,Lebanon's national news agency NNA said one soldier was shot dead by a sniper in the city early Sunday.,71,77,sniper,9,10,19
3PUOXASB574HRTAB389U8CJH5379Z1,Another man was found dead on the side of a road while a third died after a shell landed in a residential neighborhood.,76,81,shell,3,6,9
3PUOXASB574HRTAB389U8CJH5379Z1,Another man was found dead on the side of a road while a third died after a shell landed in a residential neighborhood.,94,105,residential,7,0,7
3PUOXASB574HRTAB389U8CJH5379Z1,Another man was found dead on the side of a road while a third died after a shell landed in a residential neighborhood.,94,118,residential neighborhood,2,1,3
3PUOXASB574HRTAB389U8CJH5379Z1,Another man was found dead on the side of a road while a third died after a shell landed in a residential neighborhood.,106,118,neighborhood,0,1,1
3PUOXASB574HRTAB389U8CJH5379Z1,"An Associated Press reporter in Tripoli said the Lebanese army sent reinforcements to the city, but that intermittent clashes continued Sunday with gunmen shooting at each other with automatic rifles.",3,13,Associated,1,0,1
3PUOXASB574HRTAB389U8CJH5379Z1,"An Associated Press reporter in Tripoli said the Lebanese army sent reinforcements to the city, but that intermittent clashes continued Sunday with gunmen shooting at each other with automatic rifles.",20,28,reporter,1,0,1
3PUOXASB574HRTAB389U8CJH5379Z1,"An Associated Press reporter in Tripoli said the Lebanese army sent reinforcements to the city, but that intermittent clashes continued Sunday with gunmen shooting at each other with automatic rifles.",68,82,reinforcements,10,10,20
3PUOXASB574HRTAB389U8CJH5379Z1,"An Associated Press reporter in Tripoli said the Lebanese army sent reinforcements to the city, but that intermittent clashes continued Sunday with gunmen shooting at each other with automatic rifles.",105,117,intermittent,8,10,18
3PUOXASB574HRTAB389U8CJH5379Z1,"An Associated Press reporter in Tripoli said the Lebanese army sent reinforcements to the city, but that intermittent clashes continued Sunday with gunmen shooting at each other with automatic rifles.",105,125,intermittent clashes,4,3,7
3PUOXASB574HRTAB389U8CJH5379Z1,"An Associated Press reporter in Tripoli said the Lebanese army sent reinforcements to the city, but that intermittent clashes continued Sunday with gunmen shooting at each other with automatic rifles.",118,125,clashes,0,2,2
3PUOXASB574HRTAB389U8CJH5379Z1,"An Associated Press reporter in Tripoli said the Lebanese army sent reinforcements to the city, but that intermittent clashes continued Sunday with gunmen shooting at each other with automatic rifles.",126,135,continued,1,0,1
3PUOXASB574HRTAB389U8CJH5379Z1,"An Associated Press reporter in Tripoli said the Lebanese army sent reinforcements to the city, but that intermittent clashes continued Sunday with gunmen shooting at each other with automatic rifles.",148,154,gunmen,2,1,3
3PUOXASB574HRTAB389U8CJH5379Z1,"An Associated Press reporter in Tripoli said the Lebanese army sent reinforcements to the city, but that intermittent clashes continued Sunday with gunmen shooting at each other with automatic rifles.",183,192,automatic,1,0,1
3PUOXASB574HRTAB389U8CJH5379Z1,"An Associated Press reporter in Tripoli said the Lebanese army sent reinforcements to the city, but that intermittent clashes continued Sunday with gunmen shooting at each other with automatic rifles.",183,199,automatic rifles,1,0,1
3PUOXASB574HRTAB389U8CJH5379Z1,"An Associated Press reporter in Tripoli said the Lebanese army sent reinforcements to the city, but that intermittent clashes continued Sunday with gunmen shooting at each other with automatic rifles.",193,199,rifles,0,2,2
3PUOXASB574HRTAB389U8CJH5379Z1,"Heavier weapons, like rocket-propelled grenades, have also been fired.",22,38,rocket-propelled,3,4,7
3PUOXASB574HRTAB389U8CJH5379Z1,"Heavier weapons, like rocket-propelled grenades, have also been fired.",22,47,rocket-propelled grenades,2,1,3
3PUOXASB574HRTAB389U8CJH5379Z1,"Heavier weapons, like rocket-propelled grenades, have also been fired.",39,47,grenades,6,2,8
3PUOXASB574HRTAB389U8CJH5379Z1,"Lebanon is sharply split along sectarian lines, with 18 religious sects.",11,18,sharply,0,1,1
3PUOXASB574HRTAB389U8CJH5379Z1,"Lebanon is sharply split along sectarian lines, with 18 religious sects.",31,40,sectarian,8,5,13
3PUOXASB574HRTAB389U8CJH5379Z1,"Lebanon is sharply split along sectarian lines, with 18 religious sects.",31,46,sectarian lines,3,4,7
3PUOXASB574HRTAB389U8CJH5379Z1,"Lebanon is sharply split along sectarian lines, with 18 religious sects.",56,71,religious sects,1,1,2
3PUOXASB574HRTAB389U8CJH5379Z1,"Lebanon is sharply split along sectarian lines, with 18 religious sects.",66,71,sects,3,3,6
3PUOXASB574HRTAB389U8CJH5379Z1,But it also has a fragile political fault line precisely over the issue of Syria.,18,25,fragile,7,10,17
3PUOXASB574HRTAB389U8CJH5379Z1,But it also has a fragile political fault line precisely over the issue of Syria.,18,35,fragile political,1,0,1
3PUOXASB574HRTAB389U8CJH5379Z1,But it also has a fragile political fault line precisely over the issue of Syria.,18,46,fragile political fault line,3,0,3
3PUOXASB574HRTAB389U8CJH5379Z1,But it also has a fragile political fault line precisely over the issue of Syria.,26,46,political fault line,1,1,2
3PUOXASB574HRTAB389U8CJH5379Z1,But it also has a fragile political fault line precisely over the issue of Syria.,36,46,fault line,2,0,2
3PUOXASB574HRTAB389U8CJH5379Z1,But it also has a fragile political fault line precisely over the issue of Syria.,47,56,precisely,4,3,7
3PUOXASB574HRTAB389U8CJH5379Z1,"An array of pro-Syrian parties support Assad's regime, as do many Lebanese citizens.",3,8,array,4,4,8
3PUOXASB574HRTAB389U8CJH5379Z1,"An array of pro-Syrian parties support Assad's regime, as do many Lebanese citizens.",12,30,pro-Syrian parties,1,0,1
3PUOXASB574HRTAB389U8CJH5379Z1,"An array of pro-Syrian parties support Assad's regime, as do many Lebanese citizens.",47,53,regime,6,5,11
3PUOXASB574HRTAB389U8CJH5379Z1,"An array of pro-Syrian parties support Assad's regime, as do many Lebanese citizens.",75,83,citizens,0,3,3
3KWGG5KP6J3JQKIV03TR20OGWKSCM4,"More opposition rallies were expected Wednesday, along with another new pro-Putin gathering in central Moscow.",5,15,opposition,3,0,3
3KWGG5KP6J3JQKIV03TR20OGWKSCM4,"More opposition rallies were expected Wednesday, along with another new pro-Putin gathering in central Moscow.",5,23,opposition rallies,9,0,9
3KWGG5KP6J3JQKIV03TR20OGWKSCM4,"More opposition rallies were expected Wednesday, along with another new pro-Putin gathering in central Moscow.",16,23,rallies,5,4,9
3KWGG5KP6J3JQKIV03TR20OGWKSCM4,"More opposition rallies were expected Wednesday, along with another new pro-Putin gathering in central Moscow.",29,37,expected,0,1,1
3KWGG5KP6J3JQKIV03TR20OGWKSCM4,"More opposition rallies were expected Wednesday, along with another new pro-Putin gathering in central Moscow.",72,81,pro-Putin,1,0,1
3KWGG5KP6J3JQKIV03TR20OGWKSCM4,"More opposition rallies were expected Wednesday, along with another new pro-Putin gathering in central Moscow.",72,91,pro-Putin gathering,2,0,2
3KWGG5KP6J3JQKIV03TR20OGWKSCM4,"More opposition rallies were expected Wednesday, along with another new pro-Putin gathering in central Moscow.",82,91,gathering,0,4,4
3KWGG5KP6J3JQKIV03TR20OGWKSCM4,"Thousands of security forces were out in the Russian capital and helicopters roamed the sky Wednesday, a show of force following two days of protest.",0,9,Thousands,1,0,1
3KWGG5KP6J3JQKIV03TR20OGWKSCM4,"Thousands of security forces were out in the Russian capital and helicopters roamed the sky Wednesday, a show of force following two days of protest.",13,21,security,1,0,1
3KWGG5KP6J3JQKIV03TR20OGWKSCM4,"Thousands of security forces were out in the Russian capital and helicopters roamed the sky Wednesday, a show of force following two days of protest.",13,28,security forces,4,0,4
3KWGG5KP6J3JQKIV03TR20OGWKSCM4,"Thousands of security forces were out in the Russian capital and helicopters roamed the sky Wednesday, a show of force following two days of protest.",65,76,helicopters,1,0,1
3KWGG5KP6J3JQKIV03TR20OGWKSCM4,"Thousands of security forces were out in the Russian capital and helicopters roamed the sky Wednesday, a show of force following two days of protest.",77,83,roamed,2,5,7
3KWGG5KP6J3JQKIV03TR20OGWKSCM4,"Thousands of security forces were out in the Russian capital and helicopters roamed the sky Wednesday, a show of force following two days of protest.",105,118,show of force,3,0,3
3KWGG5KP6J3JQKIV03TR20OGWKSCM4,"Thousands of security forces were out in the Russian capital and helicopters roamed the sky Wednesday, a show of force following two days of protest.",141,148,protest,0,2,2
3KWGG5KP6J3JQKIV03TR20OGWKSCM4,"Authorities said Tuesday at least 51,500 police officers and 2,000 Interior Ministry troops have been deployed in Moscow since the election.",0,11,Authorities,0,3,3
3KWGG5KP6J3JQKIV03TR20OGWKSCM4,"Authorities said Tuesday at least 51,500 police officers and 2,000 Interior Ministry troops have been deployed in Moscow since the election.",67,84,Interior Ministry,1,0,1
3KWGG5KP6J3JQKIV03TR20OGWKSCM4,"Authorities said Tuesday at least 51,500 police officers and 2,000 Interior Ministry troops have been deployed in Moscow since the election.",67,91,Interior Ministry troops,3,0,3
3KWGG5KP6J3JQKIV03TR20OGWKSCM4,"Authorities said Tuesday at least 51,500 police officers and 2,000 Interior Ministry troops have been deployed in Moscow since the election.",85,91,troops,0,1,1
3KWGG5KP6J3JQKIV03TR20OGWKSCM4,"Authorities said Tuesday at least 51,500 police officers and 2,000 Interior Ministry troops have been deployed in Moscow since the election.",102,110,deployed,9,10,19
3KWGG5KP6J3JQKIV03TR20OGWKSCM4,"Unlike the police, Interior Ministry troops are an armed force, largely manned by conscripts.",19,36,Interior Ministry,0,1,1
3KWGG5KP6J3JQKIV03TR20OGWKSCM4,"Unlike the police, Interior Ministry troops are an armed force, largely manned by conscripts.",19,43,Interior Ministry troops,2,0,2
3KWGG5KP6J3JQKIV03TR20OGWKSCM4,"Unlike the police, Interior Ministry troops are an armed force, largely manned by conscripts.",72,78,manned,3,6,9
3KWGG5KP6J3JQKIV03TR20OGWKSCM4,"Unlike the police, Interior Ministry troops are an armed force, largely manned by conscripts.",72,92,manned by conscripts,1,0,1
3KWGG5KP6J3JQKIV03TR20OGWKSCM4,"Unlike the police, Interior Ministry troops are an armed force, largely manned by conscripts.",82,92,conscripts,10,10,20
3KWGG5KP6J3JQKIV03TR20OGWKSCM4,"The Russian Union of Journalists condemned police violence and called for a probe into the dozens of attacks and arrests of journalists, describing them as ""an attempt to gag and intimidate society.""",33,42,condemned,10,8,18
3KWGG5KP6J3JQKIV03TR20OGWKSCM4,"The Russian Union of Journalists condemned police violence and called for a probe into the dozens of attacks and arrests of journalists, describing them as ""an attempt to gag and intimidate society.""",50,58,violence,0,1,1
3KWGG5KP6J3JQKIV03TR20OGWKSCM4,"The Russian Union of Journalists condemned police violence and called for a probe into the dozens of attacks and arrests of journalists, describing them as ""an attempt to gag and intimidate society.""",76,81,probe,6,6,12
3KWGG5KP6J3JQKIV03TR20OGWKSCM4,"The Russian Union of Journalists condemned police violence and called for a probe into the dozens of attacks and arrests of journalists, describing them as ""an attempt to gag and intimidate society.""",101,108,attacks,1,0,1
3KWGG5KP6J3JQKIV03TR20OGWKSCM4,"The Russian Union of Journalists condemned police violence and called for a probe into the dozens of attacks and arrests of journalists, describing them as ""an attempt to gag and intimidate society.""",124,135,journalists,1,0,1
3KWGG5KP6J3JQKIV03TR20OGWKSCM4,"The Russian Union of Journalists condemned police violence and called for a probe into the dozens of attacks and arrests of journalists, describing them as ""an attempt to gag and intimidate society.""",137,147,describing,0,1,1
3KWGG5KP6J3JQKIV03TR20OGWKSCM4,"The Russian Union of Journalists condemned police violence and called for a probe into the dozens of attacks and arrests of journalists, describing them as ""an attempt to gag and intimidate society.""",160,167,attempt,0,1,1
3KWGG5KP6J3JQKIV03TR20OGWKSCM4,"The Russian Union of Journalists condemned police violence and called for a probe into the dozens of attacks and arrests of journalists, describing them as ""an attempt to gag and intimidate society.""",160,174,attempt to gag,1,1,2
3KWGG5KP6J3JQKIV03TR20OGWKSCM4,"The Russian Union of Journalists condemned police violence and called for a probe into the dozens of attacks and arrests of journalists, describing them as ""an attempt to gag and intimidate society.""",160,197,attempt to gag and intimidate society,1,0,1
3KWGG5KP6J3JQKIV03TR20OGWKSCM4,"The Russian Union of Journalists condemned police violence and called for a probe into the dozens of attacks and arrests of journalists, describing them as ""an attempt to gag and intimidate society.""",171,174,gag,7,5,12
3KWGG5KP6J3JQKIV03TR20OGWKSCM4,"The Russian Union of Journalists condemned police violence and called for a probe into the dozens of attacks and arrests of journalists, describing them as ""an attempt to gag and intimidate society.""",171,189,gag and intimidate,1,1,2
3KWGG5KP6J3JQKIV03TR20OGWKSCM4,"The Russian Union of Journalists condemned police violence and called for a probe into the dozens of attacks and arrests of journalists, describing them as ""an attempt to gag and intimidate society.""",179,189,intimidate,7,6,13
3KWGG5KP6J3JQKIV03TR20OGWKSCM4,"The Russian Union of Journalists condemned police violence and called for a probe into the dozens of attacks and arrests of journalists, describing them as ""an attempt to gag and intimidate society.""",179,197,intimidate society,1,1,2
3KWGG5KP6J3JQKIV03TR20OGWKSCM4,"On Wednesday, two video journalists working for the state-owned RIA Novosti news agency were briefly detained outside the Election Commission building where Putin was handing in his application to run.",18,35,video journalists,1,0,1
3KWGG5KP6J3JQKIV03TR20OGWKSCM4,"On Wednesday, two video journalists working for the state-owned RIA Novosti news agency were briefly detained outside the Election Commission building where Putin was handing in his application to run.",24,35,journalists,1,0,1
3KWGG5KP6J3JQKIV03TR20OGWKSCM4,"On Wednesday, two video journalists working for the state-owned RIA Novosti news agency were briefly detained outside the Election Commission building where Putin was handing in his application to run.",52,63,state-owned,0,2,2
3KWGG5KP6J3JQKIV03TR20OGWKSCM4,"On Wednesday, two video journalists working for the state-owned RIA Novosti news agency were briefly detained outside the Election Commission building where Putin was handing in his application to run.",52,87,state-owned RIA Novosti news agency,1,0,1
3KWGG5KP6J3JQKIV03TR20OGWKSCM4,"On Wednesday, two video journalists working for the state-owned RIA Novosti news agency were briefly detained outside the Election Commission building where Putin was handing in his application to run.",64,75,RIA Novosti,1,0,1
3KWGG5KP6J3JQKIV03TR20OGWKSCM4,"On Wednesday, two video journalists working for the state-owned RIA Novosti news agency were briefly detained outside the Election Commission building where Putin was handing in his application to run.",93,109,briefly detained,1,1,2
3KWGG5KP6J3JQKIV03TR20OGWKSCM4,"On Wednesday, two video journalists working for the state-owned RIA Novosti news agency were briefly detained outside the Election Commission building where Putin was handing in his application to run.",101,109,detained,8,4,12
3KWGG5KP6J3JQKIV03TR20OGWKSCM4,"On Wednesday, two video journalists working for the state-owned RIA Novosti news agency were briefly detained outside the Election Commission building where Putin was handing in his application to run.",131,141,Commission,1,0,1
3KWGG5KP6J3JQKIV03TR20OGWKSCM4,"On Wednesday, two video journalists working for the state-owned RIA Novosti news agency were briefly detained outside the Election Commission building where Putin was handing in his application to run.",182,193,application,0,1,1
3JUDR1D0D6SXDHOLV3B27WZZTH9Q22,Hajar said his cousin was not affiliated with any terrorist group.,30,40,affiliated,10,9,19
3JUDR1D0D6SXDHOLV3B27WZZTH9Q22,Hajar said his cousin was not affiliated with any terrorist group.,50,59,terrorist,1,1,2
3JUDR1D0D6SXDHOLV3B27WZZTH9Q22,CNN cannot independently verify reports of deaths and violence because the Syrian government has severely restricted access to international media.,11,24,independently,2,1,3
3JUDR1D0D6SXDHOLV3B27WZZTH9Q22,CNN cannot independently verify reports of deaths and violence because the Syrian government has severely restricted access to international media.,11,31,independently verify,2,0,2
3JUDR1D0D6SXDHOLV3B27WZZTH9Q22,CNN cannot independently verify reports of deaths and violence because the Syrian government has severely restricted access to international media.,25,31,verify,2,0,2
3JUDR1D0D6SXDHOLV3B27WZZTH9Q22,CNN cannot independently verify reports of deaths and violence because the Syrian government has severely restricted access to international media.,54,62,violence,0,1,1
3JUDR1D0D6SXDHOLV3B27WZZTH9Q22,CNN cannot independently verify reports of deaths and violence because the Syrian government has severely restricted access to international media.,97,105,severely,0,1,1
3JUDR1D0D6SXDHOLV3B27WZZTH9Q22,CNN cannot independently verify reports of deaths and violence because the Syrian government has severely restricted access to international media.,97,116,severely restricted,2,1,3
3JUDR1D0D6SXDHOLV3B27WZZTH9Q22,CNN cannot independently verify reports of deaths and violence because the Syrian government has severely restricted access to international media.,97,123,severely restricted access,1,0,1
3JUDR1D0D6SXDHOLV3B27WZZTH9Q22,CNN cannot independently verify reports of deaths and violence because the Syrian government has severely restricted access to international media.,106,116,restricted,4,2,6
3JUDR1D0D6SXDHOLV3B27WZZTH9Q22,CNN cannot independently verify reports of deaths and violence because the Syrian government has severely restricted access to international media.,106,123,restricted access,2,0,2
3JUDR1D0D6SXDHOLV3B27WZZTH9Q22,CNN cannot independently verify reports of deaths and violence because the Syrian government has severely restricted access to international media.,117,123,access,1,2,3
3JUDR1D0D6SXDHOLV3B27WZZTH9Q22,A team of U.N. monitors is on the ground to observe the progress of a so-called cease-fire and encourage the implementation of the peace plan.,15,23,monitors,3,0,3
3JUDR1D0D6SXDHOLV3B27WZZTH9Q22,A team of U.N. monitors is on the ground to observe the progress of a so-called cease-fire and encourage the implementation of the peace plan.,70,79,so-called,1,1,2
3JUDR1D0D6SXDHOLV3B27WZZTH9Q22,A team of U.N. monitors is on the ground to observe the progress of a so-called cease-fire and encourage the implementation of the peace plan.,70,90,so-called cease-fire,2,1,3
3JUDR1D0D6SXDHOLV3B27WZZTH9Q22,A team of U.N. monitors is on the ground to observe the progress of a so-called cease-fire and encourage the implementation of the peace plan.,80,90,cease-fire,5,8,13
3JUDR1D0D6SXDHOLV3B27WZZTH9Q22,A team of U.N. monitors is on the ground to observe the progress of a so-called cease-fire and encourage the implementation of the peace plan.,95,104,encourage,1,2,3
3JUDR1D0D6SXDHOLV3B27WZZTH9Q22,A team of U.N. monitors is on the ground to observe the progress of a so-called cease-fire and encourage the implementation of the peace plan.,95,123,encourage the implementation,1,0,1
3JUDR1D0D6SXDHOLV3B27WZZTH9Q22,A team of U.N. monitors is on the ground to observe the progress of a so-called cease-fire and encourage the implementation of the peace plan.,109,123,implementation,10,7,17
3JUDR1D0D6SXDHOLV3B27WZZTH9Q22,A team of U.N. monitors is on the ground to observe the progress of a so-called cease-fire and encourage the implementation of the peace plan.,131,141,peace plan,1,0,1
3JUDR1D0D6SXDHOLV3B27WZZTH9Q22,"On Saturday, the head of the U.N. observer mission, Maj. Gen. Robert Mood, said 157 civilian and military monitors were in the provinces of Daraa, Idleb, Hama and Homs, the state-run Syrian Arab News Agency reported.",34,50,observer mission,1,1,2
3JUDR1D0D6SXDHOLV3B27WZZTH9Q22,"On Saturday, the head of the U.N. observer mission, Maj. Gen. Robert Mood, said 157 civilian and military monitors were in the provinces of Daraa, Idleb, Hama and Homs, the state-run Syrian Arab News Agency reported.",97,114,military monitors,2,1,3
3JUDR1D0D6SXDHOLV3B27WZZTH9Q22,"On Saturday, the head of the U.N. observer mission, Maj. Gen. Robert Mood, said 157 civilian and military monitors were in the provinces of Daraa, Idleb, Hama and Homs, the state-run Syrian Arab News Agency reported.",106,114,monitors,2,2,4
3JUDR1D0D6SXDHOLV3B27WZZTH9Q22,"On Saturday, the head of the U.N. observer mission, Maj. Gen. Robert Mood, said 157 civilian and military monitors were in the provinces of Daraa, Idleb, Hama and Homs, the state-run Syrian Arab News Agency reported.",127,136,provinces,5,2,7
3JUDR1D0D6SXDHOLV3B27WZZTH9Q22,"On Saturday, the head of the U.N. observer mission, Maj. Gen. Robert Mood, said 157 civilian and military monitors were in the provinces of Daraa, Idleb, Hama and Homs, the state-run Syrian Arab News Agency reported.",140,152,"Daraa, Idleb",1,0,1
3JUDR1D0D6SXDHOLV3B27WZZTH9Q22,"On Saturday, the head of the U.N. observer mission, Maj. Gen. Robert Mood, said 157 civilian and military monitors were in the provinces of Daraa, Idleb, Hama and Homs, the state-run Syrian Arab News Agency reported.",173,182,state-run,0,2,2
3JUDR1D0D6SXDHOLV3B27WZZTH9Q22,About 300 observers are expected within weeks.,10,19,observers,0,1,1
3JUDR1D0D6SXDHOLV3B27WZZTH9Q22,But the observers' presence hasn't stopped the bloodshed.,8,17,observers,0,1,1
3JUDR1D0D6SXDHOLV3B27WZZTH9Q22,But the observers' presence hasn't stopped the bloodshed.,19,27,presence,1,0,1
3JUDR1D0D6SXDHOLV3B27WZZTH9Q22,But the observers' presence hasn't stopped the bloodshed.,47,56,bloodshed,8,7,15
3JUDR1D0D6SXDHOLV3B27WZZTH9Q22,"More than 1,000 people have died in Syria since a cease-fire was supposed to go into effect on April 12, according to the LCC.",50,60,cease-fire,7,2,9
3JUDR1D0D6SXDHOLV3B27WZZTH9Q22,"More than 1,000 people have died in Syria since a cease-fire was supposed to go into effect on April 12, according to the LCC.",65,73,supposed,0,2,2
3JUDR1D0D6SXDHOLV3B27WZZTH9Q22,"More than 1,000 people have died in Syria since a cease-fire was supposed to go into effect on April 12, according to the LCC.",118,125,the LCC,1,0,1
3GL25Y6843V7TITQRZPEGD9QW1SMXP,"Obama's visit came a year after U.S. special forces troops killed al Qaeda leader Osama bin Laden, the architect of the September 11, 2001, attacks, in a raid in neighboring Pakistan.",37,51,special forces,1,0,1
3GL25Y6843V7TITQRZPEGD9QW1SMXP,"Obama's visit came a year after U.S. special forces troops killed al Qaeda leader Osama bin Laden, the architect of the September 11, 2001, attacks, in a raid in neighboring Pakistan.",37,58,special forces troops,2,0,2
3GL25Y6843V7TITQRZPEGD9QW1SMXP,"Obama's visit came a year after U.S. special forces troops killed al Qaeda leader Osama bin Laden, the architect of the September 11, 2001, attacks, in a raid in neighboring Pakistan.",66,74,al Qaeda,1,0,1
3GL25Y6843V7TITQRZPEGD9QW1SMXP,"Obama's visit came a year after U.S. special forces troops killed al Qaeda leader Osama bin Laden, the architect of the September 11, 2001, attacks, in a raid in neighboring Pakistan.",82,97,Osama bin Laden,1,0,1
3GL25Y6843V7TITQRZPEGD9QW1SMXP,"Obama's visit came a year after U.S. special forces troops killed al Qaeda leader Osama bin Laden, the architect of the September 11, 2001, attacks, in a raid in neighboring Pakistan.",103,112,architect,9,7,16
3GL25Y6843V7TITQRZPEGD9QW1SMXP,"Obama's visit came a year after U.S. special forces troops killed al Qaeda leader Osama bin Laden, the architect of the September 11, 2001, attacks, in a raid in neighboring Pakistan.",149,158,in a raid,0,1,1
3GL25Y6843V7TITQRZPEGD9QW1SMXP,"Obama's visit came a year after U.S. special forces troops killed al Qaeda leader Osama bin Laden, the architect of the September 11, 2001, attacks, in a raid in neighboring Pakistan.",154,158,raid,3,1,4
3GL25Y6843V7TITQRZPEGD9QW1SMXP,"Obama's visit came a year after U.S. special forces troops killed al Qaeda leader Osama bin Laden, the architect of the September 11, 2001, attacks, in a raid in neighboring Pakistan.",162,173,neighboring,1,2,3
3GL25Y6843V7TITQRZPEGD9QW1SMXP,"In a televised address to the American people from a base north of Kabul, he said the war in Afghanistan was winding down.",5,14,televised,1,1,2
3GL25Y6843V7TITQRZPEGD9QW1SMXP,"In a televised address to the American people from a base north of Kabul, he said the war in Afghanistan was winding down.",5,22,televised address,3,1,4
3GL25Y6843V7TITQRZPEGD9QW1SMXP,"In a televised address to the American people from a base north of Kabul, he said the war in Afghanistan was winding down.",53,57,base,2,0,2
3GL25Y6843V7TITQRZPEGD9QW1SMXP,"In a televised address to the American people from a base north of Kabul, he said the war in Afghanistan was winding down.",109,116,winding,0,3,3
3GL25Y6843V7TITQRZPEGD9QW1SMXP,"In a televised address to the American people from a base north of Kabul, he said the war in Afghanistan was winding down.",109,121,winding down,3,7,10
3GL25Y6843V7TITQRZPEGD9QW1SMXP,"As we emerge from a decade of conflict abroad and economic crisis at home, it's time to renew America, Obama said, speaking against a backdrop of armored vehicles and a U.S. flag.",7,13,emerge,7,6,13
3GL25Y6843V7TITQRZPEGD9QW1SMXP,"As we emerge from a decade of conflict abroad and economic crisis at home, it's time to renew America, Obama said, speaking against a backdrop of armored vehicles and a U.S. flag.",21,27,decade,1,3,4
3GL25Y6843V7TITQRZPEGD9QW1SMXP,"As we emerge from a decade of conflict abroad and economic crisis at home, it's time to renew America, Obama said, speaking against a backdrop of armored vehicles and a U.S. flag.",21,39,decade of conflict,0,1,1
3GL25Y6843V7TITQRZPEGD9QW1SMXP,"As we emerge from a decade of conflict abroad and economic crisis at home, it's time to renew America, Obama said, speaking against a backdrop of armored vehicles and a U.S. flag.",31,39,conflict,1,4,5
3GL25Y6843V7TITQRZPEGD9QW1SMXP,"As we emerge from a decade of conflict abroad and economic crisis at home, it's time to renew America, Obama said, speaking against a backdrop of armored vehicles and a U.S. flag.",40,46,abroad,1,2,3
3GL25Y6843V7TITQRZPEGD9QW1SMXP,"As we emerge from a decade of conflict abroad and economic crisis at home, it's time to renew America, Obama said, speaking against a backdrop of armored vehicles and a U.S. flag.",51,59,economic,2,0,2
3GL25Y6843V7TITQRZPEGD9QW1SMXP,"As we emerge from a decade of conflict abroad and economic crisis at home, it's time to renew America, Obama said, speaking against a backdrop of armored vehicles and a U.S. flag.",51,66,economic crisis,1,4,5
3GL25Y6843V7TITQRZPEGD9QW1SMXP,"As we emerge from a decade of conflict abroad and economic crisis at home, it's time to renew America, Obama said, speaking against a backdrop of armored vehicles and a U.S. flag.",60,66,crisis,1,1,2
3GL25Y6843V7TITQRZPEGD9QW1SMXP,"As we emerge from a decade of conflict abroad and economic crisis at home, it's time to renew America, Obama said, speaking against a backdrop of armored vehicles and a U.S. flag.",89,94,renew,2,1,3
3GL25Y6843V7TITQRZPEGD9QW1SMXP,"As we emerge from a decade of conflict abroad and economic crisis at home, it's time to renew America, Obama said, speaking against a backdrop of armored vehicles and a U.S. flag.",136,144,backdrop,6,10,16
3GL25Y6843V7TITQRZPEGD9QW1SMXP,"As we emerge from a decade of conflict abroad and economic crisis at home, it's time to renew America, Obama said, speaking against a backdrop of armored vehicles and a U.S. flag.",136,164,backdrop of armored vehicles,1,0,1
3GL25Y6843V7TITQRZPEGD9QW1SMXP,"As we emerge from a decade of conflict abroad and economic crisis at home, it's time to renew America, Obama said, speaking against a backdrop of armored vehicles and a U.S. flag.",148,155,armored,4,4,8
3GL25Y6843V7TITQRZPEGD9QW1SMXP,"As we emerge from a decade of conflict abroad and economic crisis at home, it's time to renew America, Obama said, speaking against a backdrop of armored vehicles and a U.S. flag.",148,164,armored vehicles,3,0,3
3GL25Y6843V7TITQRZPEGD9QW1SMXP,"Nearly 3,000 U.S. and NATO soldiers have been killed in Afghanistan since the Taliban rulers were ousted in 2001.",22,26,NATO,1,0,1
3GL25Y6843V7TITQRZPEGD9QW1SMXP,"Nearly 3,000 U.S. and NATO soldiers have been killed in Afghanistan since the Taliban rulers were ousted in 2001.",78,85,Taliban,2,0,2
3GL25Y6843V7TITQRZPEGD9QW1SMXP,"Nearly 3,000 U.S. and NATO soldiers have been killed in Afghanistan since the Taliban rulers were ousted in 2001.",86,92,rulers,0,1,1
3GL25Y6843V7TITQRZPEGD9QW1SMXP,"Nearly 3,000 U.S. and NATO soldiers have been killed in Afghanistan since the Taliban rulers were ousted in 2001.",98,104,ousted,5,10,15
3GL25Y6843V7TITQRZPEGD9QW1SMXP,"The Taliban, overthrown by U.S.-backed Afghan forces for harboring bin Laden and other militants, were quick to take credit for Wednesday's attack at Green Village, one of several compounds for Westerners on a main road out of the capital.",13,23,overthrown,5,10,15
3GL25Y6843V7TITQRZPEGD9QW1SMXP,"The Taliban, overthrown by U.S.-backed Afghan forces for harboring bin Laden and other militants, were quick to take credit for Wednesday's attack at Green Village, one of several compounds for Westerners on a main road out of the capital.",57,66,harboring,9,10,19
3GL25Y6843V7TITQRZPEGD9QW1SMXP,"The Taliban, overthrown by U.S.-backed Afghan forces for harboring bin Laden and other militants, were quick to take credit for Wednesday's attack at Green Village, one of several compounds for Westerners on a main road out of the capital.",87,96,militants,3,1,4
3GL25Y6843V7TITQRZPEGD9QW1SMXP,"The Taliban, overthrown by U.S.-backed Afghan forces for harboring bin Laden and other militants, were quick to take credit for Wednesday's attack at Green Village, one of several compounds for Westerners on a main road out of the capital.",112,123,take credit,0,2,2
3GL25Y6843V7TITQRZPEGD9QW1SMXP,"The Taliban, overthrown by U.S.-backed Afghan forces for harboring bin Laden and other militants, were quick to take credit for Wednesday's attack at Green Village, one of several compounds for Westerners on a main road out of the capital.",172,189,several compounds,1,0,1
3GL25Y6843V7TITQRZPEGD9QW1SMXP,"The Taliban, overthrown by U.S.-backed Afghan forces for harboring bin Laden and other militants, were quick to take credit for Wednesday's attack at Green Village, one of several compounds for Westerners on a main road out of the capital.",180,189,compounds,7,3,10
3DWGDA5POF5IT426YY5Y80O2JGDV1E,"Lauren O'Neill who had only recently celebrated her birthday was killed in a gun attack in the small Northern Ireland village of Bellaghy, Co Derry, on Saturday morning.",28,47,recently celebrated,1,1,2
3DWGDA5POF5IT426YY5Y80O2JGDV1E,"Lauren O'Neill who had only recently celebrated her birthday was killed in a gun attack in the small Northern Ireland village of Bellaghy, Co Derry, on Saturday morning.",37,47,celebrated,3,1,4
3DWGDA5POF5IT426YY5Y80O2JGDV1E,Her 21-year-old sister is in a critical condition in hospital after the shooting at a house in William Court which is now at the centre of a major police investigation.,31,39,critical,5,3,8
3DWGDA5POF5IT426YY5Y80O2JGDV1E,Her 21-year-old sister is in a critical condition in hospital after the shooting at a house in William Court which is now at the centre of a major police investigation.,31,49,critical condition,4,2,6
3DWGDA5POF5IT426YY5Y80O2JGDV1E,Her 21-year-old sister is in a critical condition in hospital after the shooting at a house in William Court which is now at the centre of a major police investigation.,40,49,condition,2,0,2
3DWGDA5POF5IT426YY5Y80O2JGDV1E,Her 21-year-old sister is in a critical condition in hospital after the shooting at a house in William Court which is now at the centre of a major police investigation.,129,135,centre,2,0,2
3DWGDA5POF5IT426YY5Y80O2JGDV1E,Her 21-year-old sister is in a critical condition in hospital after the shooting at a house in William Court which is now at the centre of a major police investigation.,147,167,police investigation,1,1,2
3DWGDA5POF5IT426YY5Y80O2JGDV1E,Her 21-year-old sister is in a critical condition in hospital after the shooting at a house in William Court which is now at the centre of a major police investigation.,154,167,investigation,5,4,9
3DWGDA5POF5IT426YY5Y80O2JGDV1E,A 26-year-old man was arrested in nearby Toomebridge on suspicion of murder within an hour of the shooting and is still being questioned by the Police Service of Northern Ireland (PSNI).,22,30,arrested,1,2,3
3DWGDA5POF5IT426YY5Y80O2JGDV1E,A 26-year-old man was arrested in nearby Toomebridge on suspicion of murder within an hour of the shooting and is still being questioned by the Police Service of Northern Ireland (PSNI).,34,40,nearby,0,1,1
3DWGDA5POF5IT426YY5Y80O2JGDV1E,A 26-year-old man was arrested in nearby Toomebridge on suspicion of murder within an hour of the shooting and is still being questioned by the Police Service of Northern Ireland (PSNI).,41,52,Toomebridge,1,1,2
3DWGDA5POF5IT426YY5Y80O2JGDV1E,A 26-year-old man was arrested in nearby Toomebridge on suspicion of murder within an hour of the shooting and is still being questioned by the Police Service of Northern Ireland (PSNI).,56,65,suspicion,6,5,11
3DWGDA5POF5IT426YY5Y80O2JGDV1E,A 26-year-old man was arrested in nearby Toomebridge on suspicion of murder within an hour of the shooting and is still being questioned by the Police Service of Northern Ireland (PSNI).,56,75,suspicion of murder,4,2,6
3DWGDA5POF5IT426YY5Y80O2JGDV1E,A 26-year-old man was arrested in nearby Toomebridge on suspicion of murder within an hour of the shooting and is still being questioned by the Police Service of Northern Ireland (PSNI).,69,75,murder,0,1,1
3DWGDA5POF5IT426YY5Y80O2JGDV1E,A 26-year-old man was arrested in nearby Toomebridge on suspicion of murder within an hour of the shooting and is still being questioned by the Police Service of Northern Ireland (PSNI).,126,136,questioned,1,1,2
3DWGDA5POF5IT426YY5Y80O2JGDV1E,"Another man and a woman, both aged 28, were arrested on suspicion of assisting an offender but were released unconditionally on Saturday night by detectives.",56,65,suspicion,4,2,6
3DWGDA5POF5IT426YY5Y80O2JGDV1E,"Another man and a woman, both aged 28, were arrested on suspicion of assisting an offender but were released unconditionally on Saturday night by detectives.",56,78,suspicion of assisting,1,0,1
3DWGDA5POF5IT426YY5Y80O2JGDV1E,"Another man and a woman, both aged 28, were arrested on suspicion of assisting an offender but were released unconditionally on Saturday night by detectives.",56,90,suspicion of assisting an offender,1,0,1
3DWGDA5POF5IT426YY5Y80O2JGDV1E,"Another man and a woman, both aged 28, were arrested on suspicion of assisting an offender but were released unconditionally on Saturday night by detectives.",69,78,assisting,2,1,3
3DWGDA5POF5IT426YY5Y80O2JGDV1E,"Another man and a woman, both aged 28, were arrested on suspicion of assisting an offender but were released unconditionally on Saturday night by detectives.",69,90,assisting an offender,1,0,1
3DWGDA5POF5IT426YY5Y80O2JGDV1E,"Another man and a woman, both aged 28, were arrested on suspicion of assisting an offender but were released unconditionally on Saturday night by detectives.",82,90,offender,5,5,10
3DWGDA5POF5IT426YY5Y80O2JGDV1E,"Another man and a woman, both aged 28, were arrested on suspicion of assisting an offender but were released unconditionally on Saturday night by detectives.",100,108,released,1,1,2
3DWGDA5POF5IT426YY5Y80O2JGDV1E,"Another man and a woman, both aged 28, were arrested on suspicion of assisting an offender but were released unconditionally on Saturday night by detectives.",100,124,released unconditionally,3,0,3
3DWGDA5POF5IT426YY5Y80O2JGDV1E,"Another man and a woman, both aged 28, were arrested on suspicion of assisting an offender but were released unconditionally on Saturday night by detectives.",109,124,unconditionally,10,9,19
3DWGDA5POF5IT426YY5Y80O2JGDV1E,"Another man and a woman, both aged 28, were arrested on suspicion of assisting an offender but were released unconditionally on Saturday night by detectives.",146,156,detectives,0,4,4
3DWGDA5POF5IT426YY5Y80O2JGDV1E,"Since then a priest said he believed Lauren died trying to protect her sister, while Stormont deputy First Minister Martin McGuinness visited the family and said they are in trauma.",13,19,priest,0,1,1
3DWGDA5POF5IT426YY5Y80O2JGDV1E,"Since then a priest said he believed Lauren died trying to protect her sister, while Stormont deputy First Minister Martin McGuinness visited the family and said they are in trauma.",28,36,believed,1,1,2
3DWGDA5POF5IT426YY5Y80O2JGDV1E,"Since then a priest said he believed Lauren died trying to protect her sister, while Stormont deputy First Minister Martin McGuinness visited the family and said they are in trauma.",59,66,protect,0,1,1
3DWGDA5POF5IT426YY5Y80O2JGDV1E,"Since then a priest said he believed Lauren died trying to protect her sister, while Stormont deputy First Minister Martin McGuinness visited the family and said they are in trauma.",94,100,deputy,1,2,3
3DWGDA5POF5IT426YY5Y80O2JGDV1E,"Since then a priest said he believed Lauren died trying to protect her sister, while Stormont deputy First Minister Martin McGuinness visited the family and said they are in trauma.",134,141,visited,0,1,1
3DWGDA5POF5IT426YY5Y80O2JGDV1E,"Since then a priest said he believed Lauren died trying to protect her sister, while Stormont deputy First Minister Martin McGuinness visited the family and said they are in trauma.",162,180,they are in trauma,1,0,1
3DWGDA5POF5IT426YY5Y80O2JGDV1E,"Since then a priest said he believed Lauren died trying to protect her sister, while Stormont deputy First Minister Martin McGuinness visited the family and said they are in trauma.",171,180,in trauma,1,0,1
3DWGDA5POF5IT426YY5Y80O2JGDV1E,"Since then a priest said he believed Lauren died trying to protect her sister, while Stormont deputy First Minister Martin McGuinness visited the family and said they are in trauma.",174,180,trauma,10,8,18
3VO4XFFP15N4ZILR1FSX3NG75AY7QT,Russian news agencies reported about 200 were arrested at a similar attempt to hold an unsanctioned rally in St. Petersburg and another 25 in the southern city of Rostov-on-Don.,8,21,news agencies,1,0,1
3VO4XFFP15N4ZILR1FSX3NG75AY7QT,Russian news agencies reported about 200 were arrested at a similar attempt to hold an unsanctioned rally in St. Petersburg and another 25 in the southern city of Rostov-on-Don.,13,21,agencies,1,0,1
3VO4XFFP15N4ZILR1FSX3NG75AY7QT,Russian news agencies reported about 200 were arrested at a similar attempt to hold an unsanctioned rally in St. Petersburg and another 25 in the southern city of Rostov-on-Don.,46,54,arrested,1,1,2
3VO4XFFP15N4ZILR1FSX3NG75AY7QT,Russian news agencies reported about 200 were arrested at a similar attempt to hold an unsanctioned rally in St. Petersburg and another 25 in the southern city of Rostov-on-Don.,68,75,attempt,0,2,2
3VO4XFFP15N4ZILR1FSX3NG75AY7QT,Russian news agencies reported about 200 were arrested at a similar attempt to hold an unsanctioned rally in St. Petersburg and another 25 in the southern city of Rostov-on-Don.,87,99,unsanctioned,8,10,18
3VO4XFFP15N4ZILR1FSX3NG75AY7QT,Russian news agencies reported about 200 were arrested at a similar attempt to hold an unsanctioned rally in St. Petersburg and another 25 in the southern city of Rostov-on-Don.,87,105,unsanctioned rally,6,2,8
3VO4XFFP15N4ZILR1FSX3NG75AY7QT,Russian news agencies reported about 200 were arrested at a similar attempt to hold an unsanctioned rally in St. Petersburg and another 25 in the southern city of Rostov-on-Don.,100,105,rally,0,4,4
3VO4XFFP15N4ZILR1FSX3NG75AY7QT,Russian news agencies reported about 200 were arrested at a similar attempt to hold an unsanctioned rally in St. Petersburg and another 25 in the southern city of Rostov-on-Don.,163,176,Rostov-on-Don,1,0,1
3VO4XFFP15N4ZILR1FSX3NG75AY7QT,The Moscow protest ended after around 3 ½ hours and the others were broken up by police.,11,18,protest,0,2,2
3VO4XFFP15N4ZILR1FSX3NG75AY7QT,The Moscow protest ended after around 3 ½ hours and the others were broken up by police.,68,77,broken up,0,2,2
3VO4XFFP15N4ZILR1FSX3NG75AY7QT,The protests Monday and Tuesday were an unusually sustained show of indignation for the Russian opposition.,40,49,unusually,0,1,1
3VO4XFFP15N4ZILR1FSX3NG75AY7QT,The protests Monday and Tuesday were an unusually sustained show of indignation for the Russian opposition.,40,59,unusually sustained,3,1,4
3VO4XFFP15N4ZILR1FSX3NG75AY7QT,The protests Monday and Tuesday were an unusually sustained show of indignation for the Russian opposition.,40,64,unusually sustained show,1,0,1
3VO4XFFP15N4ZILR1FSX3NG75AY7QT,The protests Monday and Tuesday were an unusually sustained show of indignation for the Russian opposition.,50,59,sustained,9,7,16
3VO4XFFP15N4ZILR1FSX3NG75AY7QT,The protests Monday and Tuesday were an unusually sustained show of indignation for the Russian opposition.,50,79,sustained show of indignation,1,0,1
3VO4XFFP15N4ZILR1FSX3NG75AY7QT,The protests Monday and Tuesday were an unusually sustained show of indignation for the Russian opposition.,68,79,indignation,10,10,20
3VO4XFFP15N4ZILR1FSX3NG75AY7QT,The protests Monday and Tuesday were an unusually sustained show of indignation for the Russian opposition.,96,106,opposition,7,0,7
3VO4XFFP15N4ZILR1FSX3NG75AY7QT,"The thousands of Russians who rallied in Moscow and St. Petersburg faced off with police and Interior Ministry troops, who detained hundreds of protesters.",30,37,rallied,3,6,9
3VO4XFFP15N4ZILR1FSX3NG75AY7QT,"The thousands of Russians who rallied in Moscow and St. Petersburg faced off with police and Interior Ministry troops, who detained hundreds of protesters.",67,76,faced off,1,4,5
3VO4XFFP15N4ZILR1FSX3NG75AY7QT,"The thousands of Russians who rallied in Moscow and St. Petersburg faced off with police and Interior Ministry troops, who detained hundreds of protesters.",93,101,Interior,0,1,1
3VO4XFFP15N4ZILR1FSX3NG75AY7QT,"The thousands of Russians who rallied in Moscow and St. Petersburg faced off with police and Interior Ministry troops, who detained hundreds of protesters.",93,117,Interior Ministry troops,2,0,2
3VO4XFFP15N4ZILR1FSX3NG75AY7QT,"The thousands of Russians who rallied in Moscow and St. Petersburg faced off with police and Interior Ministry troops, who detained hundreds of protesters.",123,131,detained,8,9,17
3VO4XFFP15N4ZILR1FSX3NG75AY7QT,"The thousands of Russians who rallied in Moscow and St. Petersburg faced off with police and Interior Ministry troops, who detained hundreds of protesters.",144,154,protesters,0,2,2
3VO4XFFP15N4ZILR1FSX3NG75AY7QT,"More opposition rallies were expected Wednesday, along with some pro-Putin gatherings.",5,15,opposition,3,1,4
3VO4XFFP15N4ZILR1FSX3NG75AY7QT,"More opposition rallies were expected Wednesday, along with some pro-Putin gatherings.",5,23,opposition rallies,3,0,3
3VO4XFFP15N4ZILR1FSX3NG75AY7QT,"More opposition rallies were expected Wednesday, along with some pro-Putin gatherings.",16,23,rallies,1,2,3
3VO4XFFP15N4ZILR1FSX3NG75AY7QT,"More opposition rallies were expected Wednesday, along with some pro-Putin gatherings.",29,37,expected,1,0,1
3VO4XFFP15N4ZILR1FSX3NG75AY7QT,"More opposition rallies were expected Wednesday, along with some pro-Putin gatherings.",65,85,pro-Putin gatherings,2,1,3
3VO4XFFP15N4ZILR1FSX3NG75AY7QT,"More opposition rallies were expected Wednesday, along with some pro-Putin gatherings.",75,85,gatherings,0,5,5
3VO4XFFP15N4ZILR1FSX3NG75AY7QT,"Putin was expected to formally register later in the day to run for president, a position he held from 2000-2008, a period in which he grew more authoritarian.",10,18,expected,1,0,1
3VO4XFFP15N4ZILR1FSX3NG75AY7QT,"Putin was expected to formally register later in the day to run for president, a position he held from 2000-2008, a period in which he grew more authoritarian.",22,39,formally register,1,0,1
3VO4XFFP15N4ZILR1FSX3NG75AY7QT,"Putin was expected to formally register later in the day to run for president, a position he held from 2000-2008, a period in which he grew more authoritarian.",31,39,register,0,1,1
3VO4XFFP15N4ZILR1FSX3NG75AY7QT,"Putin was expected to formally register later in the day to run for president, a position he held from 2000-2008, a period in which he grew more authoritarian.",93,97,held,0,1,1
3VO4XFFP15N4ZILR1FSX3NG75AY7QT,"Putin was expected to formally register later in the day to run for president, a position he held from 2000-2008, a period in which he grew more authoritarian.",135,139,grew,0,1,1
3VO4XFFP15N4ZILR1FSX3NG75AY7QT,"Putin was expected to formally register later in the day to run for president, a position he held from 2000-2008, a period in which he grew more authoritarian.",145,158,authoritarian,10,10,20
3NFWQRSHVEFQ1M6JG2LXX1PMXB8FGA,"A bad part of the investigation is that we may not get the why.	3	11	bad part	1	0	1
3NFWQRSHVEFQ1M6JG2LXX1PMXB8FGA	A bad part of the investigation is that we may not get the why.",19,32,investigation,10,9,19
3NFWQRSHVEFQ1M6JG2LXX1PMXB8FGA,"A bad part of the investigation is that we may not get the why.	52	63	get the why	1	1	2
3NFWQRSHVEFQ1M6JG2LXX1PMXB8FGA	Unless she left a note somewhere or told somebody, she may have taken it to the grave.",18,22,note,1,1,2
3NFWQRSHVEFQ1M6JG2LXX1PMXB8FGA,"Unless she left a note somewhere or told somebody, she may have taken it to the grave.""",64,85,taken it to the grave,3,0,3
3NFWQRSHVEFQ1M6JG2LXX1PMXB8FGA,"Unless she left a note somewhere or told somebody, she may have taken it to the grave.""",80,85,grave,3,6,9
3NFWQRSHVEFQ1M6JG2LXX1PMXB8FGA,"According to Goodyear, a neighbor heard gun shots.",0,9,According,2,0,2
3NFWQRSHVEFQ1M6JG2LXX1PMXB8FGA,"According to Goodyear, a neighbor heard gun shots.",0,12,According to,1,0,1
3NFWQRSHVEFQ1M6JG2LXX1PMXB8FGA,"According to Goodyear, a neighbor heard gun shots.",25,33,neighbor,0,2,2
3NFWQRSHVEFQ1M6JG2LXX1PMXB8FGA,"According to Goodyear, a neighbor heard gun shots.",34,39,heard,0,1,1
3NFWQRSHVEFQ1M6JG2LXX1PMXB8FGA,"According to Goodyear, a neighbor heard gun shots.",40,49,gun shots,0,1,1
3NFWQRSHVEFQ1M6JG2LXX1PMXB8FGA,Minutes later two of the children arrived on his doorstep.,34,41,arrived,1,0,1
3NFWQRSHVEFQ1M6JG2LXX1PMXB8FGA,Minutes later two of the children arrived on his doorstep.,49,57,doorstep,1,3,4
3NFWQRSHVEFQ1M6JG2LXX1PMXB8FGA,"One of the boys, police believe it was Joel, was covered in blood and told the neighbor his mom had shot them.",79,87,neighbor,1,0,1
3NFWQRSHVEFQ1M6JG2LXX1PMXB8FGA,"The oldest child, Pebbles, could be seen walking back towards the family home, Goodyear said.",18,25,Pebbles,0,2,2
3NFWQRSHVEFQ1M6JG2LXX1PMXB8FGA,"The oldest child, Pebbles, could be seen walking back towards the family home, Goodyear said.",41,61,walking back towards,1,0,1
3NFWQRSHVEFQ1M6JG2LXX1PMXB8FGA,"The oldest child, Pebbles, could be seen walking back towards the family home, Goodyear said.",54,61,towards,0,1,1
3NFWQRSHVEFQ1M6JG2LXX1PMXB8FGA,The children's mother came outside and lured the kids back into the house.,39,44,lured,10,10,20
3NFWQRSHVEFQ1M6JG2LXX1PMXB8FGA,"She was very calm, called them in, Goodyear said.",14,18,calm,1,2,3
3NFWQRSHVEFQ1M6JG2LXX1PMXB8FGA,"She didn't seem to be stressed or mad, just stepped out.	23	31	stressed	7	9	16
3NFWQRSHVEFQ1M6JG2LXX1PMXB8FGA	She didn't seem to be stressed or mad, just stepped out.",35,38,mad,0,2,2
3NFWQRSHVEFQ1M6JG2LXX1PMXB8FGA,"She didn't seem to be stressed or mad, just stepped out.	45	52	stepped	0	1	1
3NFWQRSHVEFQ1M6JG2LXX1PMXB8FGA	She didn't seem to be stressed or mad, just stepped out.",45,56,stepped out,2,4,6
38B7Q9C28G6F3JQ013CJBEQMZM769D,"Companies must raise £28 trillion Chinese sovereign wealth fund stops buying Euro debt Surprise weakening in China import and exports Spain nationalises Bankia as euro crisis escalates Germany warns Greece 'no bailout agreement, no aid' Bankia, in which the state is taking a 45pc stake as a crisis measure to save    it from crippling bad loans, had €37.5bn in exposure to the property sector    at the end of 2011.",25,33,trillion,1,0,1
38B7Q9C28G6F3JQ013CJBEQMZM769D,"Companies must raise £28 trillion Chinese sovereign wealth fund stops buying Euro debt Surprise weakening in China import and exports Spain nationalises Bankia as euro crisis escalates Germany warns Greece 'no bailout agreement, no aid' Bankia, in which the state is taking a 45pc stake as a crisis measure to save    it from crippling bad loans, had €37.5bn in exposure to the property sector    at the end of 2011.",34,63,Chinese sovereign wealth fund,1,1,2
38B7Q9C28G6F3JQ013CJBEQMZM769D,"Companies must raise £28 trillion Chinese sovereign wealth fund stops buying Euro debt Surprise weakening in China import and exports Spain nationalises Bankia as euro crisis escalates Germany warns Greece 'no bailout agreement, no aid' Bankia, in which the state is taking a 45pc stake as a crisis measure to save    it from crippling bad loans, had €37.5bn in exposure to the property sector    at the end of 2011.",42,51,sovereign,6,8,14
38B7Q9C28G6F3JQ013CJBEQMZM769D,"Companies must raise £28 trillion Chinese sovereign wealth fund stops buying Euro debt Surprise weakening in China import and exports Spain nationalises Bankia as euro crisis escalates Germany warns Greece 'no bailout agreement, no aid' Bankia, in which the state is taking a 45pc stake as a crisis measure to save    it from crippling bad loans, had €37.5bn in exposure to the property sector    at the end of 2011.",42,58,sovereign wealth,0,1,1
38B7Q9C28G6F3JQ013CJBEQMZM769D,"Companies must raise £28 trillion Chinese sovereign wealth fund stops buying Euro debt Surprise weakening in China import and exports Spain nationalises Bankia as euro crisis escalates Germany warns Greece 'no bailout agreement, no aid' Bankia, in which the state is taking a 45pc stake as a crisis measure to save    it from crippling bad loans, had €37.5bn in exposure to the property sector    at the end of 2011.",42,63,sovereign wealth fund,3,1,4
38B7Q9C28G6F3JQ013CJBEQMZM769D,"Companies must raise £28 trillion Chinese sovereign wealth fund stops buying Euro debt Surprise weakening in China import and exports Spain nationalises Bankia as euro crisis escalates Germany warns Greece 'no bailout agreement, no aid' Bankia, in which the state is taking a 45pc stake as a crisis measure to save    it from crippling bad loans, had €37.5bn in exposure to the property sector    at the end of 2011.",52,58,wealth,0,1,1
38B7Q9C28G6F3JQ013CJBEQMZM769D,"Companies must raise £28 trillion Chinese sovereign wealth fund stops buying Euro debt Surprise weakening in China import and exports Spain nationalises Bankia as euro crisis escalates Germany warns Greece 'no bailout agreement, no aid' Bankia, in which the state is taking a 45pc stake as a crisis measure to save    it from crippling bad loans, had €37.5bn in exposure to the property sector    at the end of 2011.",82,86,debt,0,1,1
38B7Q9C28G6F3JQ013CJBEQMZM769D,"Companies must raise £28 trillion Chinese sovereign wealth fund stops buying Euro debt Surprise weakening in China import and exports Spain nationalises Bankia as euro crisis escalates Germany warns Greece 'no bailout agreement, no aid' Bankia, in which the state is taking a 45pc stake as a crisis measure to save    it from crippling bad loans, had €37.5bn in exposure to the property sector    at the end of 2011.",82,96,debt  Surprise,1,0,1
38B7Q9C28G6F3JQ013CJBEQMZM769D,"Companies must raise £28 trillion Chinese sovereign wealth fund stops buying Euro debt Surprise weakening in China import and exports Spain nationalises Bankia as euro crisis escalates Germany warns Greece 'no bailout agreement, no aid' Bankia, in which the state is taking a 45pc stake as a crisis measure to save    it from crippling bad loans, had €37.5bn in exposure to the property sector    at the end of 2011.",96,105,weakening,1,3,4
38B7Q9C28G6F3JQ013CJBEQMZM769D,"Companies must raise £28 trillion Chinese sovereign wealth fund stops buying Euro debt Surprise weakening in China import and exports Spain nationalises Bankia as euro crisis escalates Germany warns Greece 'no bailout agreement, no aid' Bankia, in which the state is taking a 45pc stake as a crisis measure to save    it from crippling bad loans, had €37.5bn in exposure to the property sector    at the end of 2011.",115,133,import and exports,0,1,1
38B7Q9C28G6F3JQ013CJBEQMZM769D,"Companies must raise £28 trillion Chinese sovereign wealth fund stops buying Euro debt Surprise weakening in China import and exports Spain nationalises Bankia as euro crisis escalates Germany warns Greece 'no bailout agreement, no aid' Bankia, in which the state is taking a 45pc stake as a crisis measure to save    it from crippling bad loans, had €37.5bn in exposure to the property sector    at the end of 2011.",140,152,nationalises,6,1,7
38B7Q9C28G6F3JQ013CJBEQMZM769D,"Companies must raise £28 trillion Chinese sovereign wealth fund stops buying Euro debt Surprise weakening in China import and exports Spain nationalises Bankia as euro crisis escalates Germany warns Greece 'no bailout agreement, no aid' Bankia, in which the state is taking a 45pc stake as a crisis measure to save    it from crippling bad loans, had €37.5bn in exposure to the property sector    at the end of 2011.",163,174,euro crisis,2,0,2
38B7Q9C28G6F3JQ013CJBEQMZM769D,"Companies must raise £28 trillion Chinese sovereign wealth fund stops buying Euro debt Surprise weakening in China import and exports Spain nationalises Bankia as euro crisis escalates Germany warns Greece 'no bailout agreement, no aid' Bankia, in which the state is taking a 45pc stake as a crisis measure to save    it from crippling bad loans, had €37.5bn in exposure to the property sector    at the end of 2011.",163,184,euro crisis escalates,1,0,1
38B7Q9C28G6F3JQ013CJBEQMZM769D,"Companies must raise £28 trillion Chinese sovereign wealth fund stops buying Euro debt Surprise weakening in China import and exports Spain nationalises Bankia as euro crisis escalates Germany warns Greece 'no bailout agreement, no aid' Bankia, in which the state is taking a 45pc stake as a crisis measure to save    it from crippling bad loans, had €37.5bn in exposure to the property sector    at the end of 2011.",168,174,crisis,1,1,2
38B7Q9C28G6F3JQ013CJBEQMZM769D,"Companies must raise £28 trillion Chinese sovereign wealth fund stops buying Euro debt Surprise weakening in China import and exports Spain nationalises Bankia as euro crisis escalates Germany warns Greece 'no bailout agreement, no aid' Bankia, in which the state is taking a 45pc stake as a crisis measure to save    it from crippling bad loans, had €37.5bn in exposure to the property sector    at the end of 2011.",168,184,crisis escalates,1,0,1
38B7Q9C28G6F3JQ013CJBEQMZM769D,"Companies must raise £28 trillion Chinese sovereign wealth fund stops buying Euro debt Surprise weakening in China import and exports Spain nationalises Bankia as euro crisis escalates Germany warns Greece 'no bailout agreement, no aid' Bankia, in which the state is taking a 45pc stake as a crisis measure to save    it from crippling bad loans, had €37.5bn in exposure to the property sector    at the end of 2011.",175,184,escalates,6,7,13
38B7Q9C28G6F3JQ013CJBEQMZM769D,"Companies must raise £28 trillion Chinese sovereign wealth fund stops buying Euro debt Surprise weakening in China import and exports Spain nationalises Bankia as euro crisis escalates Germany warns Greece 'no bailout agreement, no aid' Bankia, in which the state is taking a 45pc stake as a crisis measure to save    it from crippling bad loans, had €37.5bn in exposure to the property sector    at the end of 2011.",207,217,no bailout,0,1,1
38B7Q9C28G6F3JQ013CJBEQMZM769D,"Companies must raise £28 trillion Chinese sovereign wealth fund stops buying Euro debt Surprise weakening in China import and exports Spain nationalises Bankia as euro crisis escalates Germany warns Greece 'no bailout agreement, no aid' Bankia, in which the state is taking a 45pc stake as a crisis measure to save    it from crippling bad loans, had €37.5bn in exposure to the property sector    at the end of 2011.",207,227,no bailout agreement,2,0,2
38B7Q9C28G6F3JQ013CJBEQMZM769D,"Companies must raise £28 trillion Chinese sovereign wealth fund stops buying Euro debt Surprise weakening in China import and exports Spain nationalises Bankia as euro crisis escalates Germany warns Greece 'no bailout agreement, no aid' Bankia, in which the state is taking a 45pc stake as a crisis measure to save    it from crippling bad loans, had €37.5bn in exposure to the property sector    at the end of 2011.",210,217,bailout,3,8,11
38B7Q9C28G6F3JQ013CJBEQMZM769D,"Companies must raise £28 trillion Chinese sovereign wealth fund stops buying Euro debt Surprise weakening in China import and exports Spain nationalises Bankia as euro crisis escalates Germany warns Greece 'no bailout agreement, no aid' Bankia, in which the state is taking a 45pc stake as a crisis measure to save    it from crippling bad loans, had €37.5bn in exposure to the property sector    at the end of 2011.",210,227,bailout agreement,1,3,4
38B7Q9C28G6F3JQ013CJBEQMZM769D,"Companies must raise £28 trillion Chinese sovereign wealth fund stops buying Euro debt Surprise weakening in China import and exports Spain nationalises Bankia as euro crisis escalates Germany warns Greece 'no bailout agreement, no aid' Bankia, in which the state is taking a 45pc stake as a crisis measure to save    it from crippling bad loans, had €37.5bn in exposure to the property sector    at the end of 2011.",281,286,stake,2,3,5
38B7Q9C28G6F3JQ013CJBEQMZM769D,"Companies must raise £28 trillion Chinese sovereign wealth fund stops buying Euro debt Surprise weakening in China import and exports Spain nationalises Bankia as euro crisis escalates Germany warns Greece 'no bailout agreement, no aid' Bankia, in which the state is taking a 45pc stake as a crisis measure to save    it from crippling bad loans, had €37.5bn in exposure to the property sector    at the end of 2011.",292,298,crisis,1,4,5
38B7Q9C28G6F3JQ013CJBEQMZM769D,"Companies must raise £28 trillion Chinese sovereign wealth fund stops buying Euro debt Surprise weakening in China import and exports Spain nationalises Bankia as euro crisis escalates Germany warns Greece 'no bailout agreement, no aid' Bankia, in which the state is taking a 45pc stake as a crisis measure to save    it from crippling bad loans, had €37.5bn in exposure to the property sector    at the end of 2011.",292,306,crisis measure,3,1,4
38B7Q9C28G6F3JQ013CJBEQMZM769D,"Companies must raise £28 trillion Chinese sovereign wealth fund stops buying Euro debt Surprise weakening in China import and exports Spain nationalises Bankia as euro crisis escalates Germany warns Greece 'no bailout agreement, no aid' Bankia, in which the state is taking a 45pc stake as a crisis measure to save    it from crippling bad loans, had €37.5bn in exposure to the property sector    at the end of 2011.",326,335,crippling,6,10,16
38B7Q9C28G6F3JQ013CJBEQMZM769D,"Companies must raise £28 trillion Chinese sovereign wealth fund stops buying Euro debt Surprise weakening in China import and exports Spain nationalises Bankia as euro crisis escalates Germany warns Greece 'no bailout agreement, no aid' Bankia, in which the state is taking a 45pc stake as a crisis measure to save    it from crippling bad loans, had €37.5bn in exposure to the property sector    at the end of 2011.",326,345,crippling bad loans,4,0,4
38B7Q9C28G6F3JQ013CJBEQMZM769D,"Companies must raise £28 trillion Chinese sovereign wealth fund stops buying Euro debt Surprise weakening in China import and exports Spain nationalises Bankia as euro crisis escalates Germany warns Greece 'no bailout agreement, no aid' Bankia, in which the state is taking a 45pc stake as a crisis measure to save    it from crippling bad loans, had €37.5bn in exposure to the property sector    at the end of 2011.",362,370,exposure,4,1,5
38B7Q9C28G6F3JQ013CJBEQMZM769D,Of that total €31.8bn were classed as problematic.,27,34,classed,1,1,2
38B7Q9C28G6F3JQ013CJBEQMZM769D,Of that total €31.8bn were classed as problematic.,38,49,problematic,6,4,10
38B7Q9C28G6F3JQ013CJBEQMZM769D,But the hangover from the property party extends across the financial sector.,8,16,hangover,5,3,8
38B7Q9C28G6F3JQ013CJBEQMZM769D,But the hangover from the property party extends across the financial sector.,8,40,hangover from the property party,1,0,1
38B7Q9C28G6F3JQ013CJBEQMZM769D,But the hangover from the property party extends across the financial sector.,41,48,extends,0,2,2
38B7Q9C28G6F3JQ013CJBEQMZM769D,But the hangover from the property party extends across the financial sector.,60,76,financial sector,3,1,4
38B7Q9C28G6F3JQ013CJBEQMZM769D,"Bank of Spain figures show commercial banks held problematic real estate    assets including loans and seized property of €184bn, 60pc of their property    portfolio at the end of 2011.",27,37,commercial,2,0,2
38B7Q9C28G6F3JQ013CJBEQMZM769D,"Bank of Spain figures show commercial banks held problematic real estate    assets including loans and seized property of €184bn, 60pc of their property    portfolio at the end of 2011.",49,60,problematic,3,0,3
38B7Q9C28G6F3JQ013CJBEQMZM769D,"Bank of Spain figures show commercial banks held problematic real estate    assets including loans and seized property of €184bn, 60pc of their property    portfolio at the end of 2011.",51,73,real estate     assets,2,1,3
38B7Q9C28G6F3JQ013CJBEQMZM769D,"Bank of Spain figures show commercial banks held problematic real estate    assets including loans and seized property of €184bn, 60pc of their property    portfolio at the end of 2011.",76,82,assets,1,2,3
38B7Q9C28G6F3JQ013CJBEQMZM769D,"Bank of Spain figures show commercial banks held problematic real estate    assets including loans and seized property of €184bn, 60pc of their property    portfolio at the end of 2011.",103,109,seized,4,2,6
38B7Q9C28G6F3JQ013CJBEQMZM769D,"Bank of Spain figures show commercial banks held problematic real estate    assets including loans and seized property of €184bn, 60pc of their property    portfolio at the end of 2011.",103,118,seized property,1,0,1
38B7Q9C28G6F3JQ013CJBEQMZM769D,"Bank of Spain figures show commercial banks held problematic real estate    assets including loans and seized property of €184bn, 60pc of their property    portfolio at the end of 2011.",133,155,property     portfolio,0,1,1
38B7Q9C28G6F3JQ013CJBEQMZM769D,"Bank of Spain figures show commercial banks held problematic real estate    assets including loans and seized property of €184bn, 60pc of their property    portfolio at the end of 2011.",135,157,property     portfolio,3,1,4
38B7Q9C28G6F3JQ013CJBEQMZM769D,"Bank of Spain figures show commercial banks held problematic real estate    assets including loans and seized property of €184bn, 60pc of their property    portfolio at the end of 2011.",156,165,portfolio,5,4,9
3NI0WFPPI9HX7P2N17TQI3PTXVG06P,"Regulators in the US and elsewhere have stressed that they will be watching to make sure that the Mountain View, California-based company does not use its acquisition of Motorola Mobility to obtain unfair advantage in the market.",0,10,Regulators,10,5,15
3NI0WFPPI9HX7P2N17TQI3PTXVG06P,"Regulators in the US and elsewhere have stressed that they will be watching to make sure that the Mountain View, California-based company does not use its acquisition of Motorola Mobility to obtain unfair advantage in the market.",25,34,elsewhere,0,2,2
3NI0WFPPI9HX7P2N17TQI3PTXVG06P,"Regulators in the US and elsewhere have stressed that they will be watching to make sure that the Mountain View, California-based company does not use its acquisition of Motorola Mobility to obtain unfair advantage in the market.",35,48,have stressed,0,1,1
3NI0WFPPI9HX7P2N17TQI3PTXVG06P,"Regulators in the US and elsewhere have stressed that they will be watching to make sure that the Mountain View, California-based company does not use its acquisition of Motorola Mobility to obtain unfair advantage in the market.",40,48,stressed,1,5,6
3NI0WFPPI9HX7P2N17TQI3PTXVG06P,"Regulators in the US and elsewhere have stressed that they will be watching to make sure that the Mountain View, California-based company does not use its acquisition of Motorola Mobility to obtain unfair advantage in the market.",155,166,acquisition,10,10,20
3NI0WFPPI9HX7P2N17TQI3PTXVG06P,"Regulators in the US and elsewhere have stressed that they will be watching to make sure that the Mountain View, California-based company does not use its acquisition of Motorola Mobility to obtain unfair advantage in the market.",191,197,obtain,3,0,3
3NI0WFPPI9HX7P2N17TQI3PTXVG06P,"Regulators in the US and elsewhere have stressed that they will be watching to make sure that the Mountain View, California-based company does not use its acquisition of Motorola Mobility to obtain unfair advantage in the market.",198,214,unfair advantage,3,2,5
3NI0WFPPI9HX7P2N17TQI3PTXVG06P,"Regulators in the US and elsewhere have stressed that they will be watching to make sure that the Mountain View, California-based company does not use its acquisition of Motorola Mobility to obtain unfair advantage in the market.",205,214,advantage,2,1,3
3NI0WFPPI9HX7P2N17TQI3PTXVG06P,"Police have arrested a man over the stabbing of a widower in Brighton Jeffrey Burrows was killed at his home in Norfolk Square in Brighton, East Sussex, on April 29.",36,44,stabbing,1,10,11
3NI0WFPPI9HX7P2N17TQI3PTXVG06P,"Police have arrested a man over the stabbing of a widower in Brighton Jeffrey Burrows was killed at his home in Norfolk Square in Brighton, East Sussex, on April 29.",50,57,widower,7,5,12
3NI0WFPPI9HX7P2N17TQI3PTXVG06P,A 22-year-old from Liverpool was arrested in the city on suspicion of murder on Saturday and he remains in custody.,57,66,suspicion,7,9,16
3NI0WFPPI9HX7P2N17TQI3PTXVG06P,A 22-year-old from Liverpool was arrested in the city on suspicion of murder on Saturday and he remains in custody.,57,76,suspicion of murder,3,1,4
3NI0WFPPI9HX7P2N17TQI3PTXVG06P,A 22-year-old from Liverpool was arrested in the city on suspicion of murder on Saturday and he remains in custody.,104,114,in custody,0,1,1
3NI0WFPPI9HX7P2N17TQI3PTXVG06P,A 22-year-old from Liverpool was arrested in the city on suspicion of murder on Saturday and he remains in custody.,107,114,custody,4,3,7
3NI0WFPPI9HX7P2N17TQI3PTXVG06P,"Joel Elliott, also 22, of North Road, Brighton, was charged on May 3 with murder.",52,59,charged,0,3,3
3NI0WFPPI9HX7P2N17TQI3PTXVG06P,He appeared at Lewes Crown Court on May 8 but did not enter a plea.,3,11,appeared,0,1,1
3NI0WFPPI9HX7P2N17TQI3PTXVG06P,He appeared at Lewes Crown Court on May 8 but did not enter a plea.,15,20,Lewes,0,1,1
3NI0WFPPI9HX7P2N17TQI3PTXVG06P,He appeared at Lewes Crown Court on May 8 but did not enter a plea.,54,66,enter a plea,1,0,1
3NI0WFPPI9HX7P2N17TQI3PTXVG06P,He appeared at Lewes Crown Court on May 8 but did not enter a plea.,62,66,plea,3,7,10
3NI0WFPPI9HX7P2N17TQI3PTXVG06P,Elliott was remanded in custody and will next appear at the same court for a plea and case management hearing on July 6.,12,20,remanded,9,8,17
3NI0WFPPI9HX7P2N17TQI3PTXVG06P,Elliott was remanded in custody and will next appear at the same court for a plea and case management hearing on July 6.,12,31,remanded in custody,1,1,2
3NI0WFPPI9HX7P2N17TQI3PTXVG06P,Elliott was remanded in custody and will next appear at the same court for a plea and case management hearing on July 6.,24,31,custody,0,1,1
3NI0WFPPI9HX7P2N17TQI3PTXVG06P,Elliott was remanded in custody and will next appear at the same court for a plea and case management hearing on July 6.,77,81,plea,3,6,9
3NI0WFPPI9HX7P2N17TQI3PTXVG06P,Elliott was remanded in custody and will next appear at the same court for a plea and case management hearing on July 6.,77,101,plea and case management,1,1,2
3NI0WFPPI9HX7P2N17TQI3PTXVG06P,Elliott was remanded in custody and will next appear at the same court for a plea and case management hearing on July 6.,86,101,case management,2,1,3
3NI0WFPPI9HX7P2N17TQI3PTXVG06P,Elliott was remanded in custody and will next appear at the same court for a plea and case management hearing on July 6.,86,109,case management hearing,2,1,3
3NI0WFPPI9HX7P2N17TQI3PTXVG06P,Elliott was remanded in custody and will next appear at the same court for a plea and case management hearing on July 6.,91,101,management,2,0,2
3T8DUCXY0N7L5H1CXGKCMOI0K7L9TL,"It appeared they had been shot, Goodyear said.",4,12,appeared,0,2,2
3T8DUCXY0N7L5H1CXGKCMOI0K7L9TL,"The mother of the children came out of the residence next door, called for the children to return home, at which time they left and went back to the house.",44,53,residence,10,4,14
3T8DUCXY0N7L5H1CXGKCMOI0K7L9TL,"The mother of the children came out of the residence next door, called for the children to return home, at which time they left and went back to the house.",92,98,return,0,1,1
3T8DUCXY0N7L5H1CXGKCMOI0K7L9TL,The neighbor then heard gunshots and called 911.,4,12,neighbor,0,3,3
3T8DUCXY0N7L5H1CXGKCMOI0K7L9TL,The neighbor then heard gunshots and called 911.,18,23,heard,0,1,1
3T8DUCXY0N7L5H1CXGKCMOI0K7L9TL,The neighbor then heard gunshots and called 911.,24,32,gunshots,0,3,3
3T8DUCXY0N7L5H1CXGKCMOI0K7L9TL,"Another neighbor told deputies that Thomas sent a text message in the middle of the night saying she wanted to be cremated with her children, Goodyear said.",8,16,neighbor,0,2,2
3T8DUCXY0N7L5H1CXGKCMOI0K7L9TL,"Another neighbor told deputies that Thomas sent a text message in the middle of the night saying she wanted to be cremated with her children, Goodyear said.",22,30,deputies,4,4,8
3T8DUCXY0N7L5H1CXGKCMOI0K7L9TL,"Another neighbor told deputies that Thomas sent a text message in the middle of the night saying she wanted to be cremated with her children, Goodyear said.",50,62,text message,1,0,1
3T8DUCXY0N7L5H1CXGKCMOI0K7L9TL,"Another neighbor told deputies that Thomas sent a text message in the middle of the night saying she wanted to be cremated with her children, Goodyear said.",114,122,cremated,10,10,20
3T8DUCXY0N7L5H1CXGKCMOI0K7L9TL,"The shooting happened in Port St. John, about 15 miles west of Cape Canaveral in an area known as the ""Space Coast"" because it is the home of NASA's Kennedy Space Center, the location of numerous famed shuttle launches.",4,12,shooting,1,0,1
3T8DUCXY0N7L5H1CXGKCMOI0K7L9TL,"The shooting happened in Port St. John, about 15 miles west of Cape Canaveral in an area known as the ""Space Coast"" because it is the home of NASA's Kennedy Space Center, the location of numerous famed shuttle launches.",13,21,happened,0,1,1
3T8DUCXY0N7L5H1CXGKCMOI0K7L9TL,"The shooting happened in Port St. John, about 15 miles west of Cape Canaveral in an area known as the ""Space Coast"" because it is the home of NASA's Kennedy Space Center, the location of numerous famed shuttle launches.",103,114,Space Coast,3,0,3
3T8DUCXY0N7L5H1CXGKCMOI0K7L9TL,"The shooting happened in Port St. John, about 15 miles west of Cape Canaveral in an area known as the ""Space Coast"" because it is the home of NASA's Kennedy Space Center, the location of numerous famed shuttle launches.",142,146,NASA,1,0,1
3T8DUCXY0N7L5H1CXGKCMOI0K7L9TL,"The shooting happened in Port St. John, about 15 miles west of Cape Canaveral in an area known as the ""Space Coast"" because it is the home of NASA's Kennedy Space Center, the location of numerous famed shuttle launches.",187,195,numerous,4,3,7
3T8DUCXY0N7L5H1CXGKCMOI0K7L9TL,"The shooting happened in Port St. John, about 15 miles west of Cape Canaveral in an area known as the ""Space Coast"" because it is the home of NASA's Kennedy Space Center, the location of numerous famed shuttle launches.",187,201,numerous famed,1,0,1
3T8DUCXY0N7L5H1CXGKCMOI0K7L9TL,"The shooting happened in Port St. John, about 15 miles west of Cape Canaveral in an area known as the ""Space Coast"" because it is the home of NASA's Kennedy Space Center, the location of numerous famed shuttle launches.",187,209,numerous famed shuttle,1,0,1
3T8DUCXY0N7L5H1CXGKCMOI0K7L9TL,"The shooting happened in Port St. John, about 15 miles west of Cape Canaveral in an area known as the ""Space Coast"" because it is the home of NASA's Kennedy Space Center, the location of numerous famed shuttle launches.",187,218,numerous famed shuttle launches,2,1,3
3T8DUCXY0N7L5H1CXGKCMOI0K7L9TL,"The shooting happened in Port St. John, about 15 miles west of Cape Canaveral in an area known as the ""Space Coast"" because it is the home of NASA's Kennedy Space Center, the location of numerous famed shuttle launches.",196,201,famed,2,4,6
3T8DUCXY0N7L5H1CXGKCMOI0K7L9TL,"The shooting happened in Port St. John, about 15 miles west of Cape Canaveral in an area known as the ""Space Coast"" because it is the home of NASA's Kennedy Space Center, the location of numerous famed shuttle launches.",202,209,shuttle,2,3,5
3T8DUCXY0N7L5H1CXGKCMOI0K7L9TL,"The shooting happened in Port St. John, about 15 miles west of Cape Canaveral in an area known as the ""Space Coast"" because it is the home of NASA's Kennedy Space Center, the location of numerous famed shuttle launches.",202,218,shuttle launches,2,1,3
3T8DUCXY0N7L5H1CXGKCMOI0K7L9TL,"The shooting happened in Port St. John, about 15 miles west of Cape Canaveral in an area known as the ""Space Coast"" because it is the home of NASA's Kennedy Space Center, the location of numerous famed shuttle launches.",210,218,launches,2,1,3
3T8DUCXY0N7L5H1CXGKCMOI0K7L9TL,"A Florida mother who fatally shot her four children before killing herself Tuesday called three of the kids who had sought help from a neighbor back to the house before firing the fatal shots, authorities said.",21,28,fatally,7,6,13
3T8DUCXY0N7L5H1CXGKCMOI0K7L9TL,"A Florida mother who fatally shot her four children before killing herself Tuesday called three of the kids who had sought help from a neighbor back to the house before firing the fatal shots, authorities said.",116,122,sought,7,3,10
3T8DUCXY0N7L5H1CXGKCMOI0K7L9TL,"A Florida mother who fatally shot her four children before killing herself Tuesday called three of the kids who had sought help from a neighbor back to the house before firing the fatal shots, authorities said.",116,127,sought help,0,1,1
3T8DUCXY0N7L5H1CXGKCMOI0K7L9TL,"A Florida mother who fatally shot her four children before killing herself Tuesday called three of the kids who had sought help from a neighbor back to the house before firing the fatal shots, authorities said.",169,175,firing,0,1,1
3T8DUCXY0N7L5H1CXGKCMOI0K7L9TL,"A Florida mother who fatally shot her four children before killing herself Tuesday called three of the kids who had sought help from a neighbor back to the house before firing the fatal shots, authorities said.",180,185,fatal,8,2,10
3T8DUCXY0N7L5H1CXGKCMOI0K7L9TL,"A Florida mother who fatally shot her four children before killing herself Tuesday called three of the kids who had sought help from a neighbor back to the house before firing the fatal shots, authorities said.",180,191,fatal shots,1,1,2
3T8DUCXY0N7L5H1CXGKCMOI0K7L9TL,"A Florida mother who fatally shot her four children before killing herself Tuesday called three of the kids who had sought help from a neighbor back to the house before firing the fatal shots, authorities said.",193,204,authorities,6,1,7
33J5JKFMK6ZMYZK4Z3P7Q64RZV9Q3D,"If confirmed, the attack would be one of the deadliest suffered by security forces in the 14-month-long uprising against President Bashar al-Assad.",3,12,confirmed,0,3,3
33J5JKFMK6ZMYZK4Z3P7Q64RZV9Q3D,"If confirmed, the attack would be one of the deadliest suffered by security forces in the 14-month-long uprising against President Bashar al-Assad.",45,54,deadliest,4,5,9
33J5JKFMK6ZMYZK4Z3P7Q64RZV9Q3D,"If confirmed, the attack would be one of the deadliest suffered by security forces in the 14-month-long uprising against President Bashar al-Assad.",45,63,deadliest suffered,1,0,1
33J5JKFMK6ZMYZK4Z3P7Q64RZV9Q3D,"If confirmed, the attack would be one of the deadliest suffered by security forces in the 14-month-long uprising against President Bashar al-Assad.",55,63,suffered,1,1,2
33J5JKFMK6ZMYZK4Z3P7Q64RZV9Q3D,"If confirmed, the attack would be one of the deadliest suffered by security forces in the 14-month-long uprising against President Bashar al-Assad.",67,82,security forces,3,0,3
33J5JKFMK6ZMYZK4Z3P7Q64RZV9Q3D,"If confirmed, the attack would be one of the deadliest suffered by security forces in the 14-month-long uprising against President Bashar al-Assad.",104,112,uprising,8,5,13
33J5JKFMK6ZMYZK4Z3P7Q64RZV9Q3D,"It comes after government forces launched a fresh assault on Rastan at the weekend, despite a UN-backed nominal ceasefire that was supposed to come into effect just over a month ago.",15,25,government,2,0,2
33J5JKFMK6ZMYZK4Z3P7Q64RZV9Q3D,"It comes after government forces launched a fresh assault on Rastan at the weekend, despite a UN-backed nominal ceasefire that was supposed to come into effect just over a month ago.",33,41,launched,3,2,5
33J5JKFMK6ZMYZK4Z3P7Q64RZV9Q3D,"It comes after government forces launched a fresh assault on Rastan at the weekend, despite a UN-backed nominal ceasefire that was supposed to come into effect just over a month ago.",44,49,fresh,0,1,1
33J5JKFMK6ZMYZK4Z3P7Q64RZV9Q3D,"It comes after government forces launched a fresh assault on Rastan at the weekend, despite a UN-backed nominal ceasefire that was supposed to come into effect just over a month ago.",44,57,fresh assault,4,1,5
33J5JKFMK6ZMYZK4Z3P7Q64RZV9Q3D,"It comes after government forces launched a fresh assault on Rastan at the weekend, despite a UN-backed nominal ceasefire that was supposed to come into effect just over a month ago.",50,57,assault,4,5,9
33J5JKFMK6ZMYZK4Z3P7Q64RZV9Q3D,"It comes after government forces launched a fresh assault on Rastan at the weekend, despite a UN-backed nominal ceasefire that was supposed to come into effect just over a month ago.",84,91,despite,1,1,2
33J5JKFMK6ZMYZK4Z3P7Q64RZV9Q3D,"It comes after government forces launched a fresh assault on Rastan at the weekend, despite a UN-backed nominal ceasefire that was supposed to come into effect just over a month ago.",94,103,UN-backed,1,0,1
33J5JKFMK6ZMYZK4Z3P7Q64RZV9Q3D,"It comes after government forces launched a fresh assault on Rastan at the weekend, despite a UN-backed nominal ceasefire that was supposed to come into effect just over a month ago.",94,121,UN-backed nominal ceasefire,0,2,2
33J5JKFMK6ZMYZK4Z3P7Q64RZV9Q3D,"It comes after government forces launched a fresh assault on Rastan at the weekend, despite a UN-backed nominal ceasefire that was supposed to come into effect just over a month ago.",104,111,nominal,2,1,3
33J5JKFMK6ZMYZK4Z3P7Q64RZV9Q3D,"It comes after government forces launched a fresh assault on Rastan at the weekend, despite a UN-backed nominal ceasefire that was supposed to come into effect just over a month ago.",104,121,nominal ceasefire,10,2,12
33J5JKFMK6ZMYZK4Z3P7Q64RZV9Q3D,"It comes after government forces launched a fresh assault on Rastan at the weekend, despite a UN-backed nominal ceasefire that was supposed to come into effect just over a month ago.",112,121,ceasefire,1,4,5
33J5JKFMK6ZMYZK4Z3P7Q64RZV9Q3D,"It comes after government forces launched a fresh assault on Rastan at the weekend, despite a UN-backed nominal ceasefire that was supposed to come into effect just over a month ago.",131,139,supposed,0,1,1
33J5JKFMK6ZMYZK4Z3P7Q64RZV9Q3D,"Meanwhile, the EU has imposed another round of sanctions on Syria - the 15th so far - in an effort to increase pressure on the government.",22,29,imposed,6,6,12
33J5JKFMK6ZMYZK4Z3P7Q64RZV9Q3D,"Meanwhile, the EU has imposed another round of sanctions on Syria - the 15th so far - in an effort to increase pressure on the government.",38,56,round of sanctions,1,1,2
33J5JKFMK6ZMYZK4Z3P7Q64RZV9Q3D,"Meanwhile, the EU has imposed another round of sanctions on Syria - the 15th so far - in an effort to increase pressure on the government.",47,56,sanctions,10,1,11
33J5JKFMK6ZMYZK4Z3P7Q64RZV9Q3D,"Meanwhile, the EU has imposed another round of sanctions on Syria - the 15th so far - in an effort to increase pressure on the government.",127,137,government,1,0,1
33J5JKFMK6ZMYZK4Z3P7Q64RZV9Q3D,"The Observatory said Rastan, which lies 180km (120 miles) north of Damascus, was subjected to sustained shelling overnight, leaving dozens of people injured.",4,15,Observatory,3,1,4
33J5JKFMK6ZMYZK4Z3P7Q64RZV9Q3D,"The Observatory said Rastan, which lies 180km (120 miles) north of Damascus, was subjected to sustained shelling overnight, leaving dozens of people injured.",67,75,Damascus,0,1,1
33J5JKFMK6ZMYZK4Z3P7Q64RZV9Q3D,"The Observatory said Rastan, which lies 180km (120 miles) north of Damascus, was subjected to sustained shelling overnight, leaving dozens of people injured.",81,90,subjected,1,2,3
33J5JKFMK6ZMYZK4Z3P7Q64RZV9Q3D,"The Observatory said Rastan, which lies 180km (120 miles) north of Damascus, was subjected to sustained shelling overnight, leaving dozens of people injured.",94,103,sustained,6,4,10
33J5JKFMK6ZMYZK4Z3P7Q64RZV9Q3D,"The Observatory said Rastan, which lies 180km (120 miles) north of Damascus, was subjected to sustained shelling overnight, leaving dozens of people injured.",94,112,sustained shelling,4,2,6
33J5JKFMK6ZMYZK4Z3P7Q64RZV9Q3D,"The Observatory said Rastan, which lies 180km (120 miles) north of Damascus, was subjected to sustained shelling overnight, leaving dozens of people injured.",104,112,shelling,7,4,11
33J5JKFMK6ZMYZK4Z3P7Q64RZV9Q3D,"The Observatory said Rastan, which lies 180km (120 miles) north of Damascus, was subjected to sustained shelling overnight, leaving dozens of people injured.",104,122,shelling overnight,0,1,1
33J5JKFMK6ZMYZK4Z3P7Q64RZV9Q3D,"The Observatory said Rastan, which lies 180km (120 miles) north of Damascus, was subjected to sustained shelling overnight, leaving dozens of people injured.",113,122,overnight,0,2,2
33J5JKFMK6ZMYZK4Z3P7Q64RZV9Q3D,"The city, currently an opposition stronghold, has been fiercely contested during the Syrian uprising and control of the town has changed several times.",23,33,opposition,4,0,4
33J5JKFMK6ZMYZK4Z3P7Q64RZV9Q3D,"The city, currently an opposition stronghold, has been fiercely contested during the Syrian uprising and control of the town has changed several times.",23,44,opposition stronghold,6,1,7
33J5JKFMK6ZMYZK4Z3P7Q64RZV9Q3D,"The city, currently an opposition stronghold, has been fiercely contested during the Syrian uprising and control of the town has changed several times.",34,44,stronghold,4,7,11
33J5JKFMK6ZMYZK4Z3P7Q64RZV9Q3D,"The city, currently an opposition stronghold, has been fiercely contested during the Syrian uprising and control of the town has changed several times.",55,63,fiercely,4,7,11
33J5JKFMK6ZMYZK4Z3P7Q64RZV9Q3D,"The city, currently an opposition stronghold, has been fiercely contested during the Syrian uprising and control of the town has changed several times.",55,73,fiercely contested,1,1,2
33J5JKFMK6ZMYZK4Z3P7Q64RZV9Q3D,"The city, currently an opposition stronghold, has been fiercely contested during the Syrian uprising and control of the town has changed several times.",64,73,contested,2,3,5
33J5JKFMK6ZMYZK4Z3P7Q64RZV9Q3D,"The city, currently an opposition stronghold, has been fiercely contested during the Syrian uprising and control of the town has changed several times.",92,100,uprising,4,3,7
3U18MJKL1UNP823VC48RFFDG1A2NCF,"Thomas's husband, the father of all of the children, moved out of the house a few months ago, he added.",53,62,moved out,0,1,1
3U18MJKL1UNP823VC48RFFDG1A2NCF,"It's hard to take in.	6	21	hard to take in	0	2	2
3U18MJKL1UNP823VC48RFFDG1A2NCF	It's hard to take in.",11,21,to take in,1,0,1
3U18MJKL1UNP823VC48RFFDG1A2NCF,"This is a pretty peaceful place, normally,"" he said.",10,25,pretty peaceful,0,1,1
3U18MJKL1UNP823VC48RFFDG1A2NCF,"This is a pretty peaceful place, normally,"" he said.",17,25,peaceful,6,1,7
3U18MJKL1UNP823VC48RFFDG1A2NCF,"This is a pretty peaceful place, normally,"" he said.",17,31,peaceful place,1,0,1
3U18MJKL1UNP823VC48RFFDG1A2NCF,"This is a pretty peaceful place, normally,"" he said.",33,41,normally,1,1,2
3U18MJKL1UNP823VC48RFFDG1A2NCF,Tuesday's incident was the second deadly shooting in Port St. John in the past week.,10,18,incident,9,6,15
3U18MJKL1UNP823VC48RFFDG1A2NCF,Tuesday's incident was the second deadly shooting in Port St. John in the past week.,34,40,deadly,0,1,1
3U18MJKL1UNP823VC48RFFDG1A2NCF,Tuesday's incident was the second deadly shooting in Port St. John in the past week.,34,49,deadly shooting,0,3,3
3U18MJKL1UNP823VC48RFFDG1A2NCF,Tuesday's incident was the second deadly shooting in Port St. John in the past week.,41,49,shooting,0,1,1
3U18MJKL1UNP823VC48RFFDG1A2NCF,"Brevard County was the scene of six homicides in 2011, Goodyear said.",23,28,scene,0,1,1
3U18MJKL1UNP823VC48RFFDG1A2NCF,"Brevard County was the scene of six homicides in 2011, Goodyear said.",36,45,homicides,10,10,20
3U18MJKL1UNP823VC48RFFDG1A2NCF,"Brevard County was the scene of six homicides in 2011, Goodyear said.",55,63,Goodyear,0,1,1
3U18MJKL1UNP823VC48RFFDG1A2NCF,Police said three of the four children ran to their next-door neighbour's house before their mother - identified as 33-year-old Tanya Thomas - called them back home and killed them.,39,42,ran,0,1,1
3U18MJKL1UNP823VC48RFFDG1A2NCF,Police said three of the four children ran to their next-door neighbour's house before their mother - identified as 33-year-old Tanya Thomas - called them back home and killed them.,52,61,next-door,0,1,1
3U18MJKL1UNP823VC48RFFDG1A2NCF,Police said three of the four children ran to their next-door neighbour's house before their mother - identified as 33-year-old Tanya Thomas - called them back home and killed them.,52,71,next-door neighbour,0,1,1
3U18MJKL1UNP823VC48RFFDG1A2NCF,Police said three of the four children ran to their next-door neighbour's house before their mother - identified as 33-year-old Tanya Thomas - called them back home and killed them.,52,72,next-door neighbours,0,1,1
3U18MJKL1UNP823VC48RFFDG1A2NCF,Police said three of the four children ran to their next-door neighbour's house before their mother - identified as 33-year-old Tanya Thomas - called them back home and killed them.,62,72,neighbours,1,4,5
3U18MJKL1UNP823VC48RFFDG1A2NCF,Police said three of the four children ran to their next-door neighbour's house before their mother - identified as 33-year-old Tanya Thomas - called them back home and killed them.,102,112,identified,4,5,9
3U18MJKL1UNP823VC48RFFDG1A2NCF,"Brevard County Sheriff's Lt Tod Goodyear said the neighbour called 911 after being awoken by gunshots coming from a home in Port St John, east of Orlando, at 4.50am local time.",8,14,County,0,2,2
3U18MJKL1UNP823VC48RFFDG1A2NCF,"Brevard County Sheriff's Lt Tod Goodyear said the neighbour called 911 after being awoken by gunshots coming from a home in Port St John, east of Orlando, at 4.50am local time.",15,22,Sheriff,1,0,1
3U18MJKL1UNP823VC48RFFDG1A2NCF,"Brevard County Sheriff's Lt Tod Goodyear said the neighbour called 911 after being awoken by gunshots coming from a home in Port St John, east of Orlando, at 4.50am local time.",50,59,neighbour,1,1,2
3U18MJKL1UNP823VC48RFFDG1A2NCF,"Brevard County Sheriff's Lt Tod Goodyear said the neighbour called 911 after being awoken by gunshots coming from a home in Port St John, east of Orlando, at 4.50am local time.",77,89,being awoken,1,1,2
3U18MJKL1UNP823VC48RFFDG1A2NCF,"Brevard County Sheriff's Lt Tod Goodyear said the neighbour called 911 after being awoken by gunshots coming from a home in Port St John, east of Orlando, at 4.50am local time.",83,89,awoken,9,6,15
3U18MJKL1UNP823VC48RFFDG1A2NCF,"Brevard County Sheriff's Lt Tod Goodyear said the neighbour called 911 after being awoken by gunshots coming from a home in Port St John, east of Orlando, at 4.50am local time.",93,101,gunshots,1,4,5
3U18MJKL1UNP823VC48RFFDG1A2NCF,"Brevard County Sheriff's Lt Tod Goodyear said the neighbour called 911 after being awoken by gunshots coming from a home in Port St John, east of Orlando, at 4.50am local time.",102,108,coming,0,1,1
3U18MJKL1UNP823VC48RFFDG1A2NCF,"Brevard County Sheriff's Lt Tod Goodyear said the neighbour called 911 after being awoken by gunshots coming from a home in Port St John, east of Orlando, at 4.50am local time.",165,175,local time,0,1,1
3NQUW096N69XM4T7O7IL0X8JQUZ9LI,"Two ""Chinese maritime surveillance ships"" then sailed to the shoal on Tuesday, the statement said.",5,40,Chinese maritime surveillance ships,1,0,1
3NQUW096N69XM4T7O7IL0X8JQUZ9LI,"Two ""Chinese maritime surveillance ships"" then sailed to the shoal on Tuesday, the statement said.",13,21,maritime,3,5,8
3NQUW096N69XM4T7O7IL0X8JQUZ9LI,"Two ""Chinese maritime surveillance ships"" then sailed to the shoal on Tuesday, the statement said.",13,34,maritime surveillance,7,1,8
3NQUW096N69XM4T7O7IL0X8JQUZ9LI,"Two ""Chinese maritime surveillance ships"" then sailed to the shoal on Tuesday, the statement said.",13,40,maritime surveillance ships,2,1,3
3NQUW096N69XM4T7O7IL0X8JQUZ9LI,"Two ""Chinese maritime surveillance ships"" then sailed to the shoal on Tuesday, the statement said.",22,34,surveillance,3,6,9
3NQUW096N69XM4T7O7IL0X8JQUZ9LI,"Two ""Chinese maritime surveillance ships"" then sailed to the shoal on Tuesday, the statement said.",22,40,surveillance ships,0,1,1
3NQUW096N69XM4T7O7IL0X8JQUZ9LI,"Two ""Chinese maritime surveillance ships"" then sailed to the shoal on Tuesday, the statement said.",61,66,shoal,7,5,12
3NQUW096N69XM4T7O7IL0X8JQUZ9LI,"The ships placed themselves between the Gregorio del Pilar and the fishing vessels, ""thus preventing the arrest of the erring Chinese fishermen"", the statement said.",40,58,Gregorio del Pilar,1,0,1
3NQUW096N69XM4T7O7IL0X8JQUZ9LI,"The ships placed themselves between the Gregorio del Pilar and the fishing vessels, ""thus preventing the arrest of the erring Chinese fishermen"", the statement said.",67,82,fishing vessels,1,2,3
3NQUW096N69XM4T7O7IL0X8JQUZ9LI,"The ships placed themselves between the Gregorio del Pilar and the fishing vessels, ""thus preventing the arrest of the erring Chinese fishermen"", the statement said.",75,82,vessels,4,1,5
3NQUW096N69XM4T7O7IL0X8JQUZ9LI,"The ships placed themselves between the Gregorio del Pilar and the fishing vessels, ""thus preventing the arrest of the erring Chinese fishermen"", the statement said.",90,100,preventing,1,1,2
3NQUW096N69XM4T7O7IL0X8JQUZ9LI,"The ships placed themselves between the Gregorio del Pilar and the fishing vessels, ""thus preventing the arrest of the erring Chinese fishermen"", the statement said.",119,125,erring,10,10,20
3NQUW096N69XM4T7O7IL0X8JQUZ9LI,"The ships placed themselves between the Gregorio del Pilar and the fishing vessels, ""thus preventing the arrest of the erring Chinese fishermen"", the statement said.",119,143,erring Chinese fishermen,1,0,1
3NQUW096N69XM4T7O7IL0X8JQUZ9LI,"The situation has remained unchanged as of this morning, it added.",5,14,situation,0,1,1
3NQUW096N69XM4T7O7IL0X8JQUZ9LI,"The situation has remained unchanged as of this morning, it added.",19,37,remained unchanged,0,1,1
3NQUW096N69XM4T7O7IL0X8JQUZ9LI,"The situation has remained unchanged as of this morning, it added.",28,37,unchanged,1,0,1
3NQUW096N69XM4T7O7IL0X8JQUZ9LI,"Del Rosario had contacted Ma to emphasise that the area was ""an integral part of Philippine territory"" and invite him for talks aimed at finding a diplomatic solution, according to the statement.",26,28,Ma,1,0,1
3NQUW096N69XM4T7O7IL0X8JQUZ9LI,"Del Rosario had contacted Ma to emphasise that the area was ""an integral part of Philippine territory"" and invite him for talks aimed at finding a diplomatic solution, according to the statement.",32,41,emphasise,10,8,18
3NQUW096N69XM4T7O7IL0X8JQUZ9LI,"Del Rosario had contacted Ma to emphasise that the area was ""an integral part of Philippine territory"" and invite him for talks aimed at finding a diplomatic solution, according to the statement.",61,77,an integral part,1,0,1
3NQUW096N69XM4T7O7IL0X8JQUZ9LI,"Del Rosario had contacted Ma to emphasise that the area was ""an integral part of Philippine territory"" and invite him for talks aimed at finding a diplomatic solution, according to the statement.",64,72,integral,9,1,10
3NQUW096N69XM4T7O7IL0X8JQUZ9LI,"Del Rosario had contacted Ma to emphasise that the area was ""an integral part of Philippine territory"" and invite him for talks aimed at finding a diplomatic solution, according to the statement.",64,77,integral part,1,4,5
3NQUW096N69XM4T7O7IL0X8JQUZ9LI,"Del Rosario had contacted Ma to emphasise that the area was ""an integral part of Philippine territory"" and invite him for talks aimed at finding a diplomatic solution, according to the statement.",92,101,territory,1,1,2
3NQUW096N69XM4T7O7IL0X8JQUZ9LI,"Del Rosario had contacted Ma to emphasise that the area was ""an integral part of Philippine territory"" and invite him for talks aimed at finding a diplomatic solution, according to the statement.",128,133,aimed,0,2,2
3NQUW096N69XM4T7O7IL0X8JQUZ9LI,"Del Rosario had contacted Ma to emphasise that the area was ""an integral part of Philippine territory"" and invite him for talks aimed at finding a diplomatic solution, according to the statement.",147,157,diplomatic,6,3,9
3NQUW096N69XM4T7O7IL0X8JQUZ9LI,"Del Rosario had contacted Ma to emphasise that the area was ""an integral part of Philippine territory"" and invite him for talks aimed at finding a diplomatic solution, according to the statement.",147,166,diplomatic solution,4,3,7
3NQUW096N69XM4T7O7IL0X8JQUZ9LI,"Zhang Hua, a spokesman for China's embassy in Manila, told AFP on Wednesday he had no comment on the latest standoff.",13,22,spokesman,1,3,4
3NQUW096N69XM4T7O7IL0X8JQUZ9LI,"Zhang Hua, a spokesman for China's embassy in Manila, told AFP on Wednesday he had no comment on the latest standoff.",35,42,embassy,3,1,4
3NQUW096N69XM4T7O7IL0X8JQUZ9LI,"Zhang Hua, a spokesman for China's embassy in Manila, told AFP on Wednesday he had no comment on the latest standoff.",59,62,AFP,1,0,1
3NQUW096N69XM4T7O7IL0X8JQUZ9LI,"Zhang Hua, a spokesman for China's embassy in Manila, told AFP on Wednesday he had no comment on the latest standoff.",108,116,standoff,5,10,15
3NQUW096N69XM4T7O7IL0X8JQUZ9LI,"The incident is the latest flare-up in tensions between the two countries over competing territorial claims to parts of the South China Sea, which is believed to sit atop vast oil and gas deposits.",4,12,incident,0,1,1
3NQUW096N69XM4T7O7IL0X8JQUZ9LI,"The incident is the latest flare-up in tensions between the two countries over competing territorial claims to parts of the South China Sea, which is believed to sit atop vast oil and gas deposits.",27,35,flare-up,5,9,14
3NQUW096N69XM4T7O7IL0X8JQUZ9LI,"The incident is the latest flare-up in tensions between the two countries over competing territorial claims to parts of the South China Sea, which is believed to sit atop vast oil and gas deposits.",39,47,tensions,2,1,3
3NQUW096N69XM4T7O7IL0X8JQUZ9LI,"The incident is the latest flare-up in tensions between the two countries over competing territorial claims to parts of the South China Sea, which is believed to sit atop vast oil and gas deposits.",79,88,competing,1,2,3
3NQUW096N69XM4T7O7IL0X8JQUZ9LI,"The incident is the latest flare-up in tensions between the two countries over competing territorial claims to parts of the South China Sea, which is believed to sit atop vast oil and gas deposits.",79,107,competing territorial claims,3,0,3
3NQUW096N69XM4T7O7IL0X8JQUZ9LI,"The incident is the latest flare-up in tensions between the two countries over competing territorial claims to parts of the South China Sea, which is believed to sit atop vast oil and gas deposits.",89,100,territorial,7,0,7
3NQUW096N69XM4T7O7IL0X8JQUZ9LI,"The incident is the latest flare-up in tensions between the two countries over competing territorial claims to parts of the South China Sea, which is believed to sit atop vast oil and gas deposits.",89,107,territorial claims,1,4,5
3NQUW096N69XM4T7O7IL0X8JQUZ9LI,"The incident is the latest flare-up in tensions between the two countries over competing territorial claims to parts of the South China Sea, which is believed to sit atop vast oil and gas deposits.",166,170,atop,2,5,7
3NQUW096N69XM4T7O7IL0X8JQUZ9LI,"The incident is the latest flare-up in tensions between the two countries over competing territorial claims to parts of the South China Sea, which is believed to sit atop vast oil and gas deposits.",171,175,vast,3,0,3
3NQUW096N69XM4T7O7IL0X8JQUZ9LI,"The incident is the latest flare-up in tensions between the two countries over competing territorial claims to parts of the South China Sea, which is believed to sit atop vast oil and gas deposits.",171,196,vast oil and gas deposits,1,0,1
33P2GD6NRNTFH4T81JUCYETSK72KHG,"This situation has remained unchanged as of Wednesday morning, the DFA said.",5,14,situation,1,1,2
33P2GD6NRNTFH4T81JUCYETSK72KHG,"This situation has remained unchanged as of Wednesday morning, the DFA said.",19,37,remained unchanged,0,1,1
33P2GD6NRNTFH4T81JUCYETSK72KHG,"This situation has remained unchanged as of Wednesday morning, the DFA said.",28,37,unchanged,1,2,3
33P2GD6NRNTFH4T81JUCYETSK72KHG,"This situation has remained unchanged as of Wednesday morning, the DFA said.",67,70,DFA,0,1,1
33P2GD6NRNTFH4T81JUCYETSK72KHG,"PHL soldiers harassed Chinese fishermen In a statement on Wednesday, the Chinese Embassy said the two Chinese Marine Surveillance ships were sent in the area to safeguard China's maritime rights and interests after Philippine soldiers harassed the Chinese fishermen.",0,3,PHL,0,1,1
33P2GD6NRNTFH4T81JUCYETSK72KHG,"PHL soldiers harassed Chinese fishermen In a statement on Wednesday, the Chinese Embassy said the two Chinese Marine Surveillance ships were sent in the area to safeguard China's maritime rights and interests after Philippine soldiers harassed the Chinese fishermen.",13,21,harassed,10,10,20
33P2GD6NRNTFH4T81JUCYETSK72KHG,"PHL soldiers harassed Chinese fishermen In a statement on Wednesday, the Chinese Embassy said the two Chinese Marine Surveillance ships were sent in the area to safeguard China's maritime rights and interests after Philippine soldiers harassed the Chinese fishermen.",81,88,Embassy,0,1,1
33P2GD6NRNTFH4T81JUCYETSK72KHG,"PHL soldiers harassed Chinese fishermen In a statement on Wednesday, the Chinese Embassy said the two Chinese Marine Surveillance ships were sent in the area to safeguard China's maritime rights and interests after Philippine soldiers harassed the Chinese fishermen.",110,116,Marine,1,0,1
33P2GD6NRNTFH4T81JUCYETSK72KHG,"PHL soldiers harassed Chinese fishermen In a statement on Wednesday, the Chinese Embassy said the two Chinese Marine Surveillance ships were sent in the area to safeguard China's maritime rights and interests after Philippine soldiers harassed the Chinese fishermen.",110,129,Marine Surveillance,0,1,1
33P2GD6NRNTFH4T81JUCYETSK72KHG,"PHL soldiers harassed Chinese fishermen In a statement on Wednesday, the Chinese Embassy said the two Chinese Marine Surveillance ships were sent in the area to safeguard China's maritime rights and interests after Philippine soldiers harassed the Chinese fishermen.",110,135,Marine Surveillance ships,1,1,2
33P2GD6NRNTFH4T81JUCYETSK72KHG,"PHL soldiers harassed Chinese fishermen In a statement on Wednesday, the Chinese Embassy said the two Chinese Marine Surveillance ships were sent in the area to safeguard China's maritime rights and interests after Philippine soldiers harassed the Chinese fishermen.",117,129,Surveillance,4,8,12
33P2GD6NRNTFH4T81JUCYETSK72KHG,"PHL soldiers harassed Chinese fishermen In a statement on Wednesday, the Chinese Embassy said the two Chinese Marine Surveillance ships were sent in the area to safeguard China's maritime rights and interests after Philippine soldiers harassed the Chinese fishermen.",117,135,Surveillance ships,0,1,1
33P2GD6NRNTFH4T81JUCYETSK72KHG,"PHL soldiers harassed Chinese fishermen In a statement on Wednesday, the Chinese Embassy said the two Chinese Marine Surveillance ships were sent in the area to safeguard China's maritime rights and interests after Philippine soldiers harassed the Chinese fishermen.",161,170,safeguard,5,7,12
33P2GD6NRNTFH4T81JUCYETSK72KHG,"PHL soldiers harassed Chinese fishermen In a statement on Wednesday, the Chinese Embassy said the two Chinese Marine Surveillance ships were sent in the area to safeguard China's maritime rights and interests after Philippine soldiers harassed the Chinese fishermen.",179,187,maritime,7,2,9
33P2GD6NRNTFH4T81JUCYETSK72KHG,"PHL soldiers harassed Chinese fishermen In a statement on Wednesday, the Chinese Embassy said the two Chinese Marine Surveillance ships were sent in the area to safeguard China's maritime rights and interests after Philippine soldiers harassed the Chinese fishermen.",179,194,maritime rights,2,2,4
33P2GD6NRNTFH4T81JUCYETSK72KHG,"PHL soldiers harassed Chinese fishermen In a statement on Wednesday, the Chinese Embassy said the two Chinese Marine Surveillance ships were sent in the area to safeguard China's maritime rights and interests after Philippine soldiers harassed the Chinese fishermen.",179,208,maritime rights and interests,1,1,2
33P2GD6NRNTFH4T81JUCYETSK72KHG,"PHL soldiers harassed Chinese fishermen In a statement on Wednesday, the Chinese Embassy said the two Chinese Marine Surveillance ships were sent in the area to safeguard China's maritime rights and interests after Philippine soldiers harassed the Chinese fishermen.",235,243,harassed,6,3,9
33P2GD6NRNTFH4T81JUCYETSK72KHG,"Also, the statement claims that the Huangyan Island (Panatag Shoal, its Philippine name) is an integral part of Chinese territory.",95,103,integral,10,2,12
33P2GD6NRNTFH4T81JUCYETSK72KHG,"Also, the statement claims that the Huangyan Island (Panatag Shoal, its Philippine name) is an integral part of Chinese territory.",95,108,integral part,1,3,4
33P2GD6NRNTFH4T81JUCYETSK72KHG,"Also, the statement claims that the Huangyan Island (Panatag Shoal, its Philippine name) is an integral part of Chinese territory.",120,129,territory,3,1,4
33P2GD6NRNTFH4T81JUCYETSK72KHG,"Moreover, it said that the Chinese fishermen were moving into the island when a Philippine Naval gunboat blocked the entrance of the Huangyan Island lagnoon, triggering the standoff.",0,8,Moreover,2,1,3
33P2GD6NRNTFH4T81JUCYETSK72KHG,"Moreover, it said that the Chinese fishermen were moving into the island when a Philippine Naval gunboat blocked the entrance of the Huangyan Island lagnoon, triggering the standoff.",66,72,island,0,1,1
33P2GD6NRNTFH4T81JUCYETSK72KHG,"Moreover, it said that the Chinese fishermen were moving into the island when a Philippine Naval gunboat blocked the entrance of the Huangyan Island lagnoon, triggering the standoff.",91,104,Naval gunboat,0,1,1
33P2GD6NRNTFH4T81JUCYETSK72KHG,"Moreover, it said that the Chinese fishermen were moving into the island when a Philippine Naval gunboat blocked the entrance of the Huangyan Island lagnoon, triggering the standoff.",97,104,gunboat,0,1,1
33P2GD6NRNTFH4T81JUCYETSK72KHG,"Moreover, it said that the Chinese fishermen were moving into the island when a Philippine Naval gunboat blocked the entrance of the Huangyan Island lagnoon, triggering the standoff.",105,112,blocked,0,1,1
33P2GD6NRNTFH4T81JUCYETSK72KHG,"Moreover, it said that the Chinese fishermen were moving into the island when a Philippine Naval gunboat blocked the entrance of the Huangyan Island lagnoon, triggering the standoff.",149,156,lagnoon,3,3,6
33P2GD6NRNTFH4T81JUCYETSK72KHG,"Moreover, it said that the Chinese fishermen were moving into the island when a Philippine Naval gunboat blocked the entrance of the Huangyan Island lagnoon, triggering the standoff.",158,168,triggering,8,3,11
33P2GD6NRNTFH4T81JUCYETSK72KHG,"Moreover, it said that the Chinese fishermen were moving into the island when a Philippine Naval gunboat blocked the entrance of the Huangyan Island lagnoon, triggering the standoff.",158,181,triggering the standoff,1,1,2
33P2GD6NRNTFH4T81JUCYETSK72KHG,"Moreover, it said that the Chinese fishermen were moving into the island when a Philippine Naval gunboat blocked the entrance of the Huangyan Island lagnoon, triggering the standoff.",173,181,standoff,7,10,17
33P2GD6NRNTFH4T81JUCYETSK72KHG,"A Florida mom went on a murderous rampage, killing her four children early today before turning the gun on herself.",24,33,murderous,3,1,4
33P2GD6NRNTFH4T81JUCYETSK72KHG,"A Florida mom went on a murderous rampage, killing her four children early today before turning the gun on herself.",24,41,murderous rampage,4,3,7
33P2GD6NRNTFH4T81JUCYETSK72KHG,"A Florida mom went on a murderous rampage, killing her four children early today before turning the gun on herself.",34,41,rampage,8,6,14
33P2GD6NRNTFH4T81JUCYETSK72KHG,"The murders happened around 4:30 a.m. in Port St. John, Fla.",12,20,happened,0,1,1
3NRZ1LDP7W72JGQIKX5RU2JW9UMPZI,"Prime Minister Mariano Rajoy's government took the sweeping action just two    days after it nationalised the fourth-biggest bank, Bankia, to salvage a    balance sheet dripping in red ink.",31,41,government,1,0,1
3NRZ1LDP7W72JGQIKX5RU2JW9UMPZI,"Prime Minister Mariano Rajoy's government took the sweeping action just two    days after it nationalised the fourth-biggest bank, Bankia, to salvage a    balance sheet dripping in red ink.",51,59,sweeping,4,8,12
3NRZ1LDP7W72JGQIKX5RU2JW9UMPZI,"Prime Minister Mariano Rajoy's government took the sweeping action just two    days after it nationalised the fourth-biggest bank, Bankia, to salvage a    balance sheet dripping in red ink.",51,66,sweeping action,5,3,8
3NRZ1LDP7W72JGQIKX5RU2JW9UMPZI,"Prime Minister Mariano Rajoy's government took the sweeping action just two    days after it nationalised the fourth-biggest bank, Bankia, to salvage a    balance sheet dripping in red ink.",93,105,nationalised,8,4,12
3NRZ1LDP7W72JGQIKX5RU2JW9UMPZI,"Prime Minister Mariano Rajoy's government took the sweeping action just two    days after it nationalised the fourth-biggest bank, Bankia, to salvage a    balance sheet dripping in red ink.",142,149,salvage,8,9,17
3NRZ1LDP7W72JGQIKX5RU2JW9UMPZI,"Prime Minister Mariano Rajoy's government took the sweeping action just two    days after it nationalised the fourth-biggest bank, Bankia, to salvage a    balance sheet dripping in red ink.",155,168,balance sheet,3,1,4
3NRZ1LDP7W72JGQIKX5RU2JW9UMPZI,"Prime Minister Mariano Rajoy's government took the sweeping action just two    days after it nationalised the fourth-biggest bank, Bankia, to salvage a    balance sheet dripping in red ink.",155,188,balance sheet dripping in red ink,2,0,2
3NRZ1LDP7W72JGQIKX5RU2JW9UMPZI,"Prime Minister Mariano Rajoy's government took the sweeping action just two    days after it nationalised the fourth-biggest bank, Bankia, to salvage a    balance sheet dripping in red ink.",169,177,dripping,3,10,13
3NRZ1LDP7W72JGQIKX5RU2JW9UMPZI,"Prime Minister Mariano Rajoy's government took the sweeping action just two    days after it nationalised the fourth-biggest bank, Bankia, to salvage a    balance sheet dripping in red ink.",169,188,dripping in red ink,1,1,2
3NRZ1LDP7W72JGQIKX5RU2JW9UMPZI,"Prime Minister Mariano Rajoy's government took the sweeping action just two    days after it nationalised the fourth-biggest bank, Bankia, to salvage a    balance sheet dripping in red ink.",181,188,red ink,1,0,1
3NRZ1LDP7W72JGQIKX5RU2JW9UMPZI,"Madrid will charge two independent auditing firms with valuing banks' exposure    to the collapsed property sector, ministers told a news conference after a    cabinet meeting.",23,34,independent,2,1,3
3NRZ1LDP7W72JGQIKX5RU2JW9UMPZI,"Madrid will charge two independent auditing firms with valuing banks' exposure    to the collapsed property sector, ministers told a news conference after a    cabinet meeting.",23,49,independent auditing firms,3,0,3
3NRZ1LDP7W72JGQIKX5RU2JW9UMPZI,"Madrid will charge two independent auditing firms with valuing banks' exposure    to the collapsed property sector, ministers told a news conference after a    cabinet meeting.",35,43,auditing,6,2,8
3NRZ1LDP7W72JGQIKX5RU2JW9UMPZI,"Madrid will charge two independent auditing firms with valuing banks' exposure    to the collapsed property sector, ministers told a news conference after a    cabinet meeting.",35,49,auditing firms,0,1,1
3NRZ1LDP7W72JGQIKX5RU2JW9UMPZI,"Madrid will charge two independent auditing firms with valuing banks' exposure    to the collapsed property sector, ministers told a news conference after a    cabinet meeting.",55,62,valuing,1,0,1
3NRZ1LDP7W72JGQIKX5RU2JW9UMPZI,"Madrid will charge two independent auditing firms with valuing banks' exposure    to the collapsed property sector, ministers told a news conference after a    cabinet meeting.",70,78,exposure,4,6,10
3NRZ1LDP7W72JGQIKX5RU2JW9UMPZI,"Madrid will charge two independent auditing firms with valuing banks' exposure    to the collapsed property sector, ministers told a news conference after a    cabinet meeting.",89,98,collapsed,4,6,10
3NRZ1LDP7W72JGQIKX5RU2JW9UMPZI,"Madrid will charge two independent auditing firms with valuing banks' exposure    to the collapsed property sector, ministers told a news conference after a    cabinet meeting.",89,114,collapsed property sector,3,0,3
3NRZ1LDP7W72JGQIKX5RU2JW9UMPZI,"Madrid will charge two independent auditing firms with valuing banks' exposure    to the collapsed property sector, ministers told a news conference after a    cabinet meeting.",99,114,property sector,2,0,2
3NRZ1LDP7W72JGQIKX5RU2JW9UMPZI,"Madrid will charge two independent auditing firms with valuing banks' exposure    to the collapsed property sector, ministers told a news conference after a    cabinet meeting.",160,167,cabinet,2,0,2
3NRZ1LDP7W72JGQIKX5RU2JW9UMPZI,"Madrid will charge two independent auditing firms with valuing banks' exposure    to the collapsed property sector, ministers told a news conference after a    cabinet meeting.",160,175,cabinet meeting,3,0,3
3NRZ1LDP7W72JGQIKX5RU2JW9UMPZI,"The government wants complete transparency, clarity is crucial to end    any doubt about Spain's solvency, Economy Minister Luis de Guindos    told the conference.",22,43,complete transparency,1,0,1
3NRZ1LDP7W72JGQIKX5RU2JW9UMPZI,"The government wants complete transparency, clarity is crucial to end    any doubt about Spain's solvency, Economy Minister Luis de Guindos    told the conference.",31,43,transparency,10,8,18
3NRZ1LDP7W72JGQIKX5RU2JW9UMPZI,"The government wants complete transparency, clarity is crucial to end    any doubt about Spain's solvency, Economy Minister Luis de Guindos    told the conference.",45,52,clarity,3,2,5
3NRZ1LDP7W72JGQIKX5RU2JW9UMPZI,"The government wants complete transparency, clarity is crucial to end    any doubt about Spain's solvency, Economy Minister Luis de Guindos    told the conference.",56,63,crucial,3,5,8
3NRZ1LDP7W72JGQIKX5RU2JW9UMPZI,"The government wants complete transparency, clarity is crucial to end    any doubt about Spain's solvency, Economy Minister Luis de Guindos    told the conference.",90,105,Spains solvency,1,0,1
3NRZ1LDP7W72JGQIKX5RU2JW9UMPZI,"The government wants complete transparency, clarity is crucial to end    any doubt about Spain's solvency, Economy Minister Luis de Guindos    told the conference.",98,106,solvency,7,6,13
3NRZ1LDP7W72JGQIKX5RU2JW9UMPZI,"As ministers spoke, however, Madrid's IBEX-35 index of leading shares plunged    3.32pc to 6,811.6 points, dragged down by plummeting values for even the    strongest banks.",46,69,index of leading shares,1,0,1
3NRZ1LDP7W72JGQIKX5RU2JW9UMPZI,"As ministers spoke, however, Madrid's IBEX-35 index of leading shares plunged    3.32pc to 6,811.6 points, dragged down by plummeting values for even the    strongest banks.",55,69,leading shares,0,1,1
3NRZ1LDP7W72JGQIKX5RU2JW9UMPZI,"As ministers spoke, however, Madrid's IBEX-35 index of leading shares plunged    3.32pc to 6,811.6 points, dragged down by plummeting values for even the    strongest banks.",55,77,leading shares plunged,1,0,1
3NRZ1LDP7W72JGQIKX5RU2JW9UMPZI,"As ministers spoke, however, Madrid's IBEX-35 index of leading shares plunged    3.32pc to 6,811.6 points, dragged down by plummeting values for even the    strongest banks.",70,77,plunged,4,8,12
3NRZ1LDP7W72JGQIKX5RU2JW9UMPZI,"As ministers spoke, however, Madrid's IBEX-35 index of leading shares plunged    3.32pc to 6,811.6 points, dragged down by plummeting values for even the    strongest banks.",107,114,dragged,1,1,2
3NRZ1LDP7W72JGQIKX5RU2JW9UMPZI,"As ministers spoke, however, Madrid's IBEX-35 index of leading shares plunged    3.32pc to 6,811.6 points, dragged down by plummeting values for even the    strongest banks.",107,119,dragged down,0,2,2
3NRZ1LDP7W72JGQIKX5RU2JW9UMPZI,"As ministers spoke, however, Madrid's IBEX-35 index of leading shares plunged    3.32pc to 6,811.6 points, dragged down by plummeting values for even the    strongest banks.",123,133,plummeting,7,10,17
3NRZ1LDP7W72JGQIKX5RU2JW9UMPZI,"As ministers spoke, however, Madrid's IBEX-35 index of leading shares plunged    3.32pc to 6,811.6 points, dragged down by plummeting values for even the    strongest banks.",123,140,plummeting values,3,1,4
3NRZ1LDP7W72JGQIKX5RU2JW9UMPZI,"Santander, the eurozone's biggest bank by assets, slumped 5.18pc to €4.665;    Spanish number-two BBVA dropped 5.84pc to €5; and Bankia skidded 3.37pc to    €2.034.",15,24,eurozones,2,0,2
3NRZ1LDP7W72JGQIKX5RU2JW9UMPZI,"Santander, the eurozone's biggest bank by assets, slumped 5.18pc to €4.665;    Spanish number-two BBVA dropped 5.84pc to €5; and Bankia skidded 3.37pc to    €2.034.",50,57,slumped,3,7,10
3NRZ1LDP7W72JGQIKX5RU2JW9UMPZI,"Santander, the eurozone's biggest bank by assets, slumped 5.18pc to €4.665;    Spanish number-two BBVA dropped 5.84pc to €5; and Bankia skidded 3.37pc to    €2.034.",103,110,dropped,0,1,1
3NRZ1LDP7W72JGQIKX5RU2JW9UMPZI,"Santander, the eurozone's biggest bank by assets, slumped 5.18pc to €4.665;    Spanish number-two BBVA dropped 5.84pc to €5; and Bankia skidded 3.37pc to    €2.034.",136,143,skidded,1,1,2
3QD8LUVX4XZ9LB8KZ08SZBY4B7Q5X9,Tensions stemming from the 14-month-old uprising against President Bashar Assad also touched off clashes across the border in Lebanon as the revolt threatened to morph into a broader conflict.,0,8,Tensions,5,0,5
3QD8LUVX4XZ9LB8KZ08SZBY4B7Q5X9,Tensions stemming from the 14-month-old uprising against President Bashar Assad also touched off clashes across the border in Lebanon as the revolt threatened to morph into a broader conflict.,0,17,Tensions stemming,1,0,1
3QD8LUVX4XZ9LB8KZ08SZBY4B7Q5X9,Tensions stemming from the 14-month-old uprising against President Bashar Assad also touched off clashes across the border in Lebanon as the revolt threatened to morph into a broader conflict.,9,17,stemming,9,10,19
3QD8LUVX4XZ9LB8KZ08SZBY4B7Q5X9,Tensions stemming from the 14-month-old uprising against President Bashar Assad also touched off clashes across the border in Lebanon as the revolt threatened to morph into a broader conflict.,40,48,uprising,5,6,11
3QD8LUVX4XZ9LB8KZ08SZBY4B7Q5X9,Tensions stemming from the 14-month-old uprising against President Bashar Assad also touched off clashes across the border in Lebanon as the revolt threatened to morph into a broader conflict.,85,96,touched off,1,2,3
3QD8LUVX4XZ9LB8KZ08SZBY4B7Q5X9,Tensions stemming from the 14-month-old uprising against President Bashar Assad also touched off clashes across the border in Lebanon as the revolt threatened to morph into a broader conflict.,85,104,touched off clashes,1,2,3
3QD8LUVX4XZ9LB8KZ08SZBY4B7Q5X9,Tensions stemming from the 14-month-old uprising against President Bashar Assad also touched off clashes across the border in Lebanon as the revolt threatened to morph into a broader conflict.,97,104,clashes,1,3,4
3QD8LUVX4XZ9LB8KZ08SZBY4B7Q5X9,Tensions stemming from the 14-month-old uprising against President Bashar Assad also touched off clashes across the border in Lebanon as the revolt threatened to morph into a broader conflict.,141,147,revolt,4,3,7
3QD8LUVX4XZ9LB8KZ08SZBY4B7Q5X9,Tensions stemming from the 14-month-old uprising against President Bashar Assad also touched off clashes across the border in Lebanon as the revolt threatened to morph into a broader conflict.,141,158,revolt threatened,1,1,2
3QD8LUVX4XZ9LB8KZ08SZBY4B7Q5X9,Tensions stemming from the 14-month-old uprising against President Bashar Assad also touched off clashes across the border in Lebanon as the revolt threatened to morph into a broader conflict.,148,158,threatened,1,2,3
3QD8LUVX4XZ9LB8KZ08SZBY4B7Q5X9,Tensions stemming from the 14-month-old uprising against President Bashar Assad also touched off clashes across the border in Lebanon as the revolt threatened to morph into a broader conflict.,162,167,morph,10,8,18
3QD8LUVX4XZ9LB8KZ08SZBY4B7Q5X9,Tensions stemming from the 14-month-old uprising against President Bashar Assad also touched off clashes across the border in Lebanon as the revolt threatened to morph into a broader conflict.,162,172,morph into,0,2,2
3QD8LUVX4XZ9LB8KZ08SZBY4B7Q5X9,Tensions stemming from the 14-month-old uprising against President Bashar Assad also touched off clashes across the border in Lebanon as the revolt threatened to morph into a broader conflict.,175,182,broader,2,1,3
3QD8LUVX4XZ9LB8KZ08SZBY4B7Q5X9,Tensions stemming from the 14-month-old uprising against President Bashar Assad also touched off clashes across the border in Lebanon as the revolt threatened to morph into a broader conflict.,175,191,broader conflict,1,2,3
3QD8LUVX4XZ9LB8KZ08SZBY4B7Q5X9,Tensions stemming from the 14-month-old uprising against President Bashar Assad also touched off clashes across the border in Lebanon as the revolt threatened to morph into a broader conflict.,183,191,conflict,3,2,5
3QD8LUVX4XZ9LB8KZ08SZBY4B7Q5X9,The relentless violence further undermines a U.N.-backed peace plan that is supposed to bring an end to Syria's deadly crisis.,4,14,relentless,6,10,16
3QD8LUVX4XZ9LB8KZ08SZBY4B7Q5X9,The relentless violence further undermines a U.N.-backed peace plan that is supposed to bring an end to Syria's deadly crisis.,4,23,relentless violence,1,2,3
3QD8LUVX4XZ9LB8KZ08SZBY4B7Q5X9,The relentless violence further undermines a U.N.-backed peace plan that is supposed to bring an end to Syria's deadly crisis.,15,23,violence,1,0,1
3QD8LUVX4XZ9LB8KZ08SZBY4B7Q5X9,The relentless violence further undermines a U.N.-backed peace plan that is supposed to bring an end to Syria's deadly crisis.,32,42,undermines,8,6,14
3QD8LUVX4XZ9LB8KZ08SZBY4B7Q5X9,The relentless violence further undermines a U.N.-backed peace plan that is supposed to bring an end to Syria's deadly crisis.,76,84,supposed,1,0,1
3QD8LUVX4XZ9LB8KZ08SZBY4B7Q5X9,The relentless violence further undermines a U.N.-backed peace plan that is supposed to bring an end to Syria's deadly crisis.,112,125,deadly crisis,0,1,1
3QD8LUVX4XZ9LB8KZ08SZBY4B7Q5X9,The relentless violence further undermines a U.N.-backed peace plan that is supposed to bring an end to Syria's deadly crisis.,119,125,crisis,2,2,4
3QD8LUVX4XZ9LB8KZ08SZBY4B7Q5X9,"A cease-fire that was supposed to begin on April 12 has had only a limited effect, throwing into doubt the rest of the plan that calls for talks between Assad's regime and those seeking to end his rule.",2,12,cease-fire,8,5,13
3QD8LUVX4XZ9LB8KZ08SZBY4B7Q5X9,"A cease-fire that was supposed to begin on April 12 has had only a limited effect, throwing into doubt the rest of the plan that calls for talks between Assad's regime and those seeking to end his rule.",22,30,supposed,1,0,1
3QD8LUVX4XZ9LB8KZ08SZBY4B7Q5X9,"A cease-fire that was supposed to begin on April 12 has had only a limited effect, throwing into doubt the rest of the plan that calls for talks between Assad's regime and those seeking to end his rule.",83,102,throwing into doubt,1,1,2
3QD8LUVX4XZ9LB8KZ08SZBY4B7Q5X9,"A cease-fire that was supposed to begin on April 12 has had only a limited effect, throwing into doubt the rest of the plan that calls for talks between Assad's regime and those seeking to end his rule.",161,167,regime,6,2,8
3QD8LUVX4XZ9LB8KZ08SZBY4B7Q5X9,"The raid against the impoverished village of al-Tamana, about 55 kilometers (35 miles) northwest of the city of Hama, began late Saturday and continued through the early hours on Sunday.",4,8,raid,1,2,3
3QD8LUVX4XZ9LB8KZ08SZBY4B7Q5X9,"The raid against the impoverished village of al-Tamana, about 55 kilometers (35 miles) northwest of the city of Hama, began late Saturday and continued through the early hours on Sunday.",21,33,impoverished,10,10,20
3QD8LUVX4XZ9LB8KZ08SZBY4B7Q5X9,"The raid against the impoverished village of al-Tamana, about 55 kilometers (35 miles) northwest of the city of Hama, began late Saturday and continued through the early hours on Sunday.",21,41,impoverished village,1,1,2
3QD8LUVX4XZ9LB8KZ08SZBY4B7Q5X9,"The raid against the impoverished village of al-Tamana, about 55 kilometers (35 miles) northwest of the city of Hama, began late Saturday and continued through the early hours on Sunday.",65,75,kilometers,2,0,2
3QD8LUVX4XZ9LB8KZ08SZBY4B7Q5X9,The Britain-based Syrian Observatory for Human Rights said five people were killed in the raid and government troops were setting fire to homes.,25,36,Observatory,0,2,2
3QD8LUVX4XZ9LB8KZ08SZBY4B7Q5X9,The Britain-based Syrian Observatory for Human Rights said five people were killed in the raid and government troops were setting fire to homes.,90,94,raid,0,1,1
3QD8LUVX4XZ9LB8KZ08SZBY4B7Q5X9,The Britain-based Syrian Observatory for Human Rights said five people were killed in the raid and government troops were setting fire to homes.,99,109,government,2,0,2
3QD8LUVX4XZ9LB8KZ08SZBY4B7Q5X9,The Britain-based Syrian Observatory for Human Rights said five people were killed in the raid and government troops were setting fire to homes.,122,129,setting,0,1,1
3GL25Y6843V7TITQRZPEGD9QX2GMXG,The incident occurred barely a week after President Benigno Aquino III pushed anew for a rules-based solution to the Spratlys row.,4,12,incident,7,4,11
3GL25Y6843V7TITQRZPEGD9QX2GMXG,The incident occurred barely a week after President Benigno Aquino III pushed anew for a rules-based solution to the Spratlys row.,4,21,incident occurred,0,1,1
3GL25Y6843V7TITQRZPEGD9QX2GMXG,The incident occurred barely a week after President Benigno Aquino III pushed anew for a rules-based solution to the Spratlys row.,13,21,occurred,2,0,2
3GL25Y6843V7TITQRZPEGD9QX2GMXG,The incident occurred barely a week after President Benigno Aquino III pushed anew for a rules-based solution to the Spratlys row.,22,28,barely,2,5,7
3GL25Y6843V7TITQRZPEGD9QX2GMXG,The incident occurred barely a week after President Benigno Aquino III pushed anew for a rules-based solution to the Spratlys row.,71,82,pushed anew,1,0,1
3GL25Y6843V7TITQRZPEGD9QX2GMXG,The incident occurred barely a week after President Benigno Aquino III pushed anew for a rules-based solution to the Spratlys row.,78,82,anew,4,3,7
3GL25Y6843V7TITQRZPEGD9QX2GMXG,The incident occurred barely a week after President Benigno Aquino III pushed anew for a rules-based solution to the Spratlys row.,89,100,rules-based,3,3,6
3GL25Y6843V7TITQRZPEGD9QX2GMXG,The incident occurred barely a week after President Benigno Aquino III pushed anew for a rules-based solution to the Spratlys row.,89,109,rules-based solution,1,0,1
3GL25Y6843V7TITQRZPEGD9QX2GMXG,The incident occurred barely a week after President Benigno Aquino III pushed anew for a rules-based solution to the Spratlys row.,101,109,solution,1,0,1
3GL25Y6843V7TITQRZPEGD9QX2GMXG,The incident occurred barely a week after President Benigno Aquino III pushed anew for a rules-based solution to the Spratlys row.,117,125,Spratlys,0,2,2
3GL25Y6843V7TITQRZPEGD9QX2GMXG,The incident occurred barely a week after President Benigno Aquino III pushed anew for a rules-based solution to the Spratlys row.,117,129,Spratlys row,2,1,3
3GL25Y6843V7TITQRZPEGD9QX2GMXG,The incident occurred barely a week after President Benigno Aquino III pushed anew for a rules-based solution to the Spratlys row.,126,129,row,1,1,2
3GL25Y6843V7TITQRZPEGD9QX2GMXG,"Earlier this month, Aquino urged the Association of Southeast Asian Nations to arrive at a common stand, even as he said the Philippines is willing to host a meeting on the matter.",20,26,Aquino,0,2,2
3GL25Y6843V7TITQRZPEGD9QX2GMXG,"Earlier this month, Aquino urged the Association of Southeast Asian Nations to arrive at a common stand, even as he said the Philippines is willing to host a meeting on the matter.",27,32,urged,4,5,9
3GL25Y6843V7TITQRZPEGD9QX2GMXG,"Earlier this month, Aquino urged the Association of Southeast Asian Nations to arrive at a common stand, even as he said the Philippines is willing to host a meeting on the matter.",37,48,Association,2,0,2
3GL25Y6843V7TITQRZPEGD9QX2GMXG,"Earlier this month, Aquino urged the Association of Southeast Asian Nations to arrive at a common stand, even as he said the Philippines is willing to host a meeting on the matter.",91,97,common,1,0,1
3GL25Y6843V7TITQRZPEGD9QX2GMXG,"Earlier this month, Aquino urged the Association of Southeast Asian Nations to arrive at a common stand, even as he said the Philippines is willing to host a meeting on the matter.",91,103,common stand,2,2,4
3GL25Y6843V7TITQRZPEGD9QX2GMXG,"Earlier this month, Aquino urged the Association of Southeast Asian Nations to arrive at a common stand, even as he said the Philippines is willing to host a meeting on the matter.",140,147,willing,1,0,1
3GL25Y6843V7TITQRZPEGD9QX2GMXG,"Earlier this month, Aquino urged the Association of Southeast Asian Nations to arrive at a common stand, even as he said the Philippines is willing to host a meeting on the matter.",151,155,host,0,2,2
3GL25Y6843V7TITQRZPEGD9QX2GMXG,"Earlier this month, Aquino urged the Association of Southeast Asian Nations to arrive at a common stand, even as he said the Philippines is willing to host a meeting on the matter.",151,165,host a meeting,0,1,1
3GL25Y6843V7TITQRZPEGD9QX2GMXG,"Aside from the Philippines and China, there are four other claimants to the Spratlys: Malaysia, Vietnam, Taiwan, and Brunei.",15,26,Philippines,1,0,1
3GL25Y6843V7TITQRZPEGD9QX2GMXG,"Aside from the Philippines and China, there are four other claimants to the Spratlys: Malaysia, Vietnam, Taiwan, and Brunei.",59,68,claimants,8,10,18
3GL25Y6843V7TITQRZPEGD9QX2GMXG,"Aside from the Philippines and China, there are four other claimants to the Spratlys: Malaysia, Vietnam, Taiwan, and Brunei.",76,84,Spratlys,2,0,2
3GL25Y6843V7TITQRZPEGD9QX2GMXG,"The DFA said a Philippine Navy surveillance aircraft monitored eight Chinese fishing vessels anchored inside the Panatag (Scarborough) Shoal in the West Philippine Sea on Sunday, April 8.",4,7,DFA,2,1,3
3GL25Y6843V7TITQRZPEGD9QX2GMXG,"The DFA said a Philippine Navy surveillance aircraft monitored eight Chinese fishing vessels anchored inside the Panatag (Scarborough) Shoal in the West Philippine Sea on Sunday, April 8.",15,43,Philippine Navy surveillance,1,0,1
3GL25Y6843V7TITQRZPEGD9QX2GMXG,"The DFA said a Philippine Navy surveillance aircraft monitored eight Chinese fishing vessels anchored inside the Panatag (Scarborough) Shoal in the West Philippine Sea on Sunday, April 8.",15,52,Philippine Navy surveillance aircraft,0,1,1
3GL25Y6843V7TITQRZPEGD9QX2GMXG,"The DFA said a Philippine Navy surveillance aircraft monitored eight Chinese fishing vessels anchored inside the Panatag (Scarborough) Shoal in the West Philippine Sea on Sunday, April 8.",31,43,surveillance,9,8,17
3GL25Y6843V7TITQRZPEGD9QX2GMXG,"The DFA said a Philippine Navy surveillance aircraft monitored eight Chinese fishing vessels anchored inside the Panatag (Scarborough) Shoal in the West Philippine Sea on Sunday, April 8.",31,52,surveillance aircraft,0,1,1
3GL25Y6843V7TITQRZPEGD9QX2GMXG,"The DFA said a Philippine Navy surveillance aircraft monitored eight Chinese fishing vessels anchored inside the Panatag (Scarborough) Shoal in the West Philippine Sea on Sunday, April 8.",53,62,monitored,5,2,7
3GL25Y6843V7TITQRZPEGD9QX2GMXG,"The DFA said a Philippine Navy surveillance aircraft monitored eight Chinese fishing vessels anchored inside the Panatag (Scarborough) Shoal in the West Philippine Sea on Sunday, April 8.",77,92,fishing vessels,0,1,1
3GL25Y6843V7TITQRZPEGD9QX2GMXG,"The DFA said a Philippine Navy surveillance aircraft monitored eight Chinese fishing vessels anchored inside the Panatag (Scarborough) Shoal in the West Philippine Sea on Sunday, April 8.",85,92,vessels,0,2,2
3GL25Y6843V7TITQRZPEGD9QX2GMXG,"The DFA said a Philippine Navy surveillance aircraft monitored eight Chinese fishing vessels anchored inside the Panatag (Scarborough) Shoal in the West Philippine Sea on Sunday, April 8.",85,101,vessels anchored,2,0,2
3GL25Y6843V7TITQRZPEGD9QX2GMXG,"The DFA said a Philippine Navy surveillance aircraft monitored eight Chinese fishing vessels anchored inside the Panatag (Scarborough) Shoal in the West Philippine Sea on Sunday, April 8.",93,101,anchored,4,7,11
3GL25Y6843V7TITQRZPEGD9QX2GMXG,"The DFA said a Philippine Navy surveillance aircraft monitored eight Chinese fishing vessels anchored inside the Panatag (Scarborough) Shoal in the West Philippine Sea on Sunday, April 8.",109,133,the Panatag (Scarborough,1,0,1
3GL25Y6843V7TITQRZPEGD9QX2GMXG,"The DFA said a Philippine Navy surveillance aircraft monitored eight Chinese fishing vessels anchored inside the Panatag (Scarborough) Shoal in the West Philippine Sea on Sunday, April 8.",135,140,Shoal,1,1,2
3GL25Y6843V7TITQRZPEGD9QX2GMXG,"It said Panatag Shoal is an integral part of Philippine territory, 124 nautical miles from the nearest base-point in Zambales.",28,36,integral,10,4,14
3GL25Y6843V7TITQRZPEGD9QX2GMXG,"It said Panatag Shoal is an integral part of Philippine territory, 124 nautical miles from the nearest base-point in Zambales.",28,41,integral part,1,1,2
3GL25Y6843V7TITQRZPEGD9QX2GMXG,"It said Panatag Shoal is an integral part of Philippine territory, 124 nautical miles from the nearest base-point in Zambales.",56,65,territory,2,1,3
3GL25Y6843V7TITQRZPEGD9QX2GMXG,"It said Panatag Shoal is an integral part of Philippine territory, 124 nautical miles from the nearest base-point in Zambales.",71,79,nautical,3,2,5
3GL25Y6843V7TITQRZPEGD9QX2GMXG,"It said Panatag Shoal is an integral part of Philippine territory, 124 nautical miles from the nearest base-point in Zambales.",71,85,nautical miles,1,3,4
3GL25Y6843V7TITQRZPEGD9QX2GMXG,"It said Panatag Shoal is an integral part of Philippine territory, 124 nautical miles from the nearest base-point in Zambales.",103,113,base-point,5,4,9
3GL25Y6843V7TITQRZPEGD9QX2GMXG,"It said Panatag Shoal is an integral part of Philippine territory, 124 nautical miles from the nearest base-point in Zambales.",117,125,Zambales,1,0,1
3G9UA71JVVVNDVHE6P8O6M4LQEI7JB,"A suicide attacker detonated a bomb at the gates of a compound used by foreigners in Kabul, Afghanistan, Wednesday, killing seven Afghans, officials said.",2,9,suicide,1,2,3
3G9UA71JVVVNDVHE6P8O6M4LQEI7JB,"A suicide attacker detonated a bomb at the gates of a compound used by foreigners in Kabul, Afghanistan, Wednesday, killing seven Afghans, officials said.",2,18,suicide attacker,3,1,4
3G9UA71JVVVNDVHE6P8O6M4LQEI7JB,"A suicide attacker detonated a bomb at the gates of a compound used by foreigners in Kabul, Afghanistan, Wednesday, killing seven Afghans, officials said.",19,28,detonated,9,9,18
3G9UA71JVVVNDVHE6P8O6M4LQEI7JB,"A suicide attacker detonated a bomb at the gates of a compound used by foreigners in Kabul, Afghanistan, Wednesday, killing seven Afghans, officials said.",19,35,detonated a bomb,0,1,1
3G9UA71JVVVNDVHE6P8O6M4LQEI7JB,"A suicide attacker detonated a bomb at the gates of a compound used by foreigners in Kabul, Afghanistan, Wednesday, killing seven Afghans, officials said.",54,62,compound,6,6,12
3G9UA71JVVVNDVHE6P8O6M4LQEI7JB,"A suicide attacker detonated a bomb at the gates of a compound used by foreigners in Kabul, Afghanistan, Wednesday, killing seven Afghans, officials said.",71,81,foreigners,1,1,2
3G9UA71JVVVNDVHE6P8O6M4LQEI7JB,"A suicide attacker detonated a bomb at the gates of a compound used by foreigners in Kabul, Afghanistan, Wednesday, killing seven Afghans, officials said.",130,137,Afghans,1,0,1
3G9UA71JVVVNDVHE6P8O6M4LQEI7JB,"A suicide attacker detonated a bomb at the gates of a compound used by foreigners in Kabul, Afghanistan, Wednesday, killing seven Afghans, officials said.",139,148,officials,1,0,1
3G9UA71JVVVNDVHE6P8O6M4LQEI7JB,"The Taliban claimed responsibility for the attack, saying it was a warning to U.S. President Obama, who had cleared Afghan airspace less than two hours before the incident, The New York Times reported.",4,11,Taliban,1,0,1
3G9UA71JVVVNDVHE6P8O6M4LQEI7JB,"The Taliban claimed responsibility for the attack, saying it was a warning to U.S. President Obama, who had cleared Afghan airspace less than two hours before the incident, The New York Times reported.",12,19,claimed,2,1,3
3G9UA71JVVVNDVHE6P8O6M4LQEI7JB,"The Taliban claimed responsibility for the attack, saying it was a warning to U.S. President Obama, who had cleared Afghan airspace less than two hours before the incident, The New York Times reported.",12,34,claimed responsibility,1,3,4
3G9UA71JVVVNDVHE6P8O6M4LQEI7JB,"The Taliban claimed responsibility for the attack, saying it was a warning to U.S. President Obama, who had cleared Afghan airspace less than two hours before the incident, The New York Times reported.",20,34,responsibility,2,0,2
3G9UA71JVVVNDVHE6P8O6M4LQEI7JB,"The Taliban claimed responsibility for the attack, saying it was a warning to U.S. President Obama, who had cleared Afghan airspace less than two hours before the incident, The New York Times reported.",108,115,cleared,2,0,2
3G9UA71JVVVNDVHE6P8O6M4LQEI7JB,"The Taliban claimed responsibility for the attack, saying it was a warning to U.S. President Obama, who had cleared Afghan airspace less than two hours before the incident, The New York Times reported.",116,131,Afghan airspace,3,0,3
3G9UA71JVVVNDVHE6P8O6M4LQEI7JB,"The Taliban claimed responsibility for the attack, saying it was a warning to U.S. President Obama, who had cleared Afghan airspace less than two hours before the incident, The New York Times reported.",123,131,airspace,5,4,9
3G9UA71JVVVNDVHE6P8O6M4LQEI7JB,"The Taliban claimed responsibility for the attack, saying it was a warning to U.S. President Obama, who had cleared Afghan airspace less than two hours before the incident, The New York Times reported.",163,171,incident,5,2,7
3G9UA71JVVVNDVHE6P8O6M4LQEI7JB,"At least one Taliban fighter died in the ensuing fighting with Afghan special police and Norwegian military officers, The Wall Street Journal reported.",13,20,Taliban,1,0,1
3G9UA71JVVVNDVHE6P8O6M4LQEI7JB,"At least one Taliban fighter died in the ensuing fighting with Afghan special police and Norwegian military officers, The Wall Street Journal reported.",41,48,ensuing,9,10,19
3G9UA71JVVVNDVHE6P8O6M4LQEI7JB,"At least one Taliban fighter died in the ensuing fighting with Afghan special police and Norwegian military officers, The Wall Street Journal reported.",41,57,ensuing fighting,1,1,2
3G9UA71JVVVNDVHE6P8O6M4LQEI7JB,"At least one Taliban fighter died in the ensuing fighting with Afghan special police and Norwegian military officers, The Wall Street Journal reported.",70,77,special,1,0,1
3G9UA71JVVVNDVHE6P8O6M4LQEI7JB,"At least one Taliban fighter died in the ensuing fighting with Afghan special police and Norwegian military officers, The Wall Street Journal reported.",70,84,special police,1,0,1
3G9UA71JVVVNDVHE6P8O6M4LQEI7JB,"At least one Taliban fighter died in the ensuing fighting with Afghan special police and Norwegian military officers, The Wall Street Journal reported.",122,141,Wall Street Journal,0,1,1
3G9UA71JVVVNDVHE6P8O6M4LQEI7JB,"At least one Taliban fighter died in the ensuing fighting with Afghan special police and Norwegian military officers, The Wall Street Journal reported.",134,141,Journal,1,0,1
3G9UA71JVVVNDVHE6P8O6M4LQEI7JB,"Hospital officials said 18 other people were hospitalized, including seven schoolchildren at a nearby school, and one person was in a critical condition.",45,57,hospitalized,0,2,2
3G9UA71JVVVNDVHE6P8O6M4LQEI7JB,"Hospital officials said 18 other people were hospitalized, including seven schoolchildren at a nearby school, and one person was in a critical condition.",95,101,nearby,0,1,1
3G9UA71JVVVNDVHE6P8O6M4LQEI7JB,"Hospital officials said 18 other people were hospitalized, including seven schoolchildren at a nearby school, and one person was in a critical condition.",134,142,critical,3,3,6
3G9UA71JVVVNDVHE6P8O6M4LQEI7JB,"Hospital officials said 18 other people were hospitalized, including seven schoolchildren at a nearby school, and one person was in a critical condition.",134,152,critical condition,5,3,8
3G9UA71JVVVNDVHE6P8O6M4LQEI7JB,Obama made an unannounced visit to Afghanistan Tuesday and met with Afghan President Hamid Karzai to sign a strategic partnership agreement.,14,25,unannounced,7,5,12
3G9UA71JVVVNDVHE6P8O6M4LQEI7JB,Obama made an unannounced visit to Afghanistan Tuesday and met with Afghan President Hamid Karzai to sign a strategic partnership agreement.,108,117,strategic,2,4,6
3G9UA71JVVVNDVHE6P8O6M4LQEI7JB,Obama made an unannounced visit to Afghanistan Tuesday and met with Afghan President Hamid Karzai to sign a strategic partnership agreement.,108,129,strategic partnership,2,1,3
3G9UA71JVVVNDVHE6P8O6M4LQEI7JB,Obama made an unannounced visit to Afghanistan Tuesday and met with Afghan President Hamid Karzai to sign a strategic partnership agreement.,108,139,strategic partnership agreement,6,2,8
3G9UA71JVVVNDVHE6P8O6M4LQEI7JB,Obama made an unannounced visit to Afghanistan Tuesday and met with Afghan President Hamid Karzai to sign a strategic partnership agreement.,118,129,partnership,1,1,2
30UZJB2POHDX5D16FB14SV903B153I,The Taliban claimed responsibility for attacks that rocked Kabul a few hours later.,12,34,claimed responsibility,1,0,1
30UZJB2POHDX5D16FB14SV903B153I,The Taliban claimed responsibility for attacks that rocked Kabul a few hours later.,20,34,responsibility,2,6,8
30UZJB2POHDX5D16FB14SV903B153I,The Taliban claimed responsibility for attacks that rocked Kabul a few hours later.,52,58,rocked,0,5,5
30UZJB2POHDX5D16FB14SV903B153I,"Officials and witnesses said a suicide car bomber and Taliban militants disguised in burqas attacked a compound housing hundreds of foreigners in the Afghan capital, killing seven.",14,23,witnesses,1,3,4
30UZJB2POHDX5D16FB14SV903B153I,"Officials and witnesses said a suicide car bomber and Taliban militants disguised in burqas attacked a compound housing hundreds of foreigners in the Afghan capital, killing seven.",31,38,suicide,2,0,2
30UZJB2POHDX5D16FB14SV903B153I,"Officials and witnesses said a suicide car bomber and Taliban militants disguised in burqas attacked a compound housing hundreds of foreigners in the Afghan capital, killing seven.",31,49,suicide car bomber,1,0,1
30UZJB2POHDX5D16FB14SV903B153I,"Officials and witnesses said a suicide car bomber and Taliban militants disguised in burqas attacked a compound housing hundreds of foreigners in the Afghan capital, killing seven.",62,71,militants,5,3,8
30UZJB2POHDX5D16FB14SV903B153I,"Officials and witnesses said a suicide car bomber and Taliban militants disguised in burqas attacked a compound housing hundreds of foreigners in the Afghan capital, killing seven.",72,81,disguised,6,10,16
30UZJB2POHDX5D16FB14SV903B153I,"Officials and witnesses said a suicide car bomber and Taliban militants disguised in burqas attacked a compound housing hundreds of foreigners in the Afghan capital, killing seven.",85,91,burqas,7,4,11
30UZJB2POHDX5D16FB14SV903B153I,"Officials and witnesses said a suicide car bomber and Taliban militants disguised in burqas attacked a compound housing hundreds of foreigners in the Afghan capital, killing seven.",101,111,a compound,1,0,1
30UZJB2POHDX5D16FB14SV903B153I,"Officials and witnesses said a suicide car bomber and Taliban militants disguised in burqas attacked a compound housing hundreds of foreigners in the Afghan capital, killing seven.",103,111,compound,2,2,4
30UZJB2POHDX5D16FB14SV903B153I,"Officials and witnesses said a suicide car bomber and Taliban militants disguised in burqas attacked a compound housing hundreds of foreigners in the Afghan capital, killing seven.",103,119,compound housing,0,1,1
30UZJB2POHDX5D16FB14SV903B153I,"Officials and witnesses said a suicide car bomber and Taliban militants disguised in burqas attacked a compound housing hundreds of foreigners in the Afghan capital, killing seven.",112,119,housing,0,1,1
30UZJB2POHDX5D16FB14SV903B153I,"Officials and witnesses said a suicide car bomber and Taliban militants disguised in burqas attacked a compound housing hundreds of foreigners in the Afghan capital, killing seven.",132,142,foreigners,1,0,1
30UZJB2POHDX5D16FB14SV903B153I,"With the agreement signed Wednesday in Afghanistan, the U.S. also has in mind the strategic significance of preserving a military partnership on Iran's eastern frontier, even if it does not include permanent U.S. bases.",9,18,agreement,0,1,1
30UZJB2POHDX5D16FB14SV903B153I,"With the agreement signed Wednesday in Afghanistan, the U.S. also has in mind the strategic significance of preserving a military partnership on Iran's eastern frontier, even if it does not include permanent U.S. bases.",82,91,strategic,3,4,7
30UZJB2POHDX5D16FB14SV903B153I,"With the agreement signed Wednesday in Afghanistan, the U.S. also has in mind the strategic significance of preserving a military partnership on Iran's eastern frontier, even if it does not include permanent U.S. bases.",82,104,strategic significance,4,5,9
30UZJB2POHDX5D16FB14SV903B153I,"With the agreement signed Wednesday in Afghanistan, the U.S. also has in mind the strategic significance of preserving a military partnership on Iran's eastern frontier, even if it does not include permanent U.S. bases.",92,104,significance,4,3,7
30UZJB2POHDX5D16FB14SV903B153I,"With the agreement signed Wednesday in Afghanistan, the U.S. also has in mind the strategic significance of preserving a military partnership on Iran's eastern frontier, even if it does not include permanent U.S. bases.",108,118,preserving,3,6,9
30UZJB2POHDX5D16FB14SV903B153I,"With the agreement signed Wednesday in Afghanistan, the U.S. also has in mind the strategic significance of preserving a military partnership on Iran's eastern frontier, even if it does not include permanent U.S. bases.",121,141,military partnership,2,0,2
30UZJB2POHDX5D16FB14SV903B153I,"With the agreement signed Wednesday in Afghanistan, the U.S. also has in mind the strategic significance of preserving a military partnership on Iran's eastern frontier, even if it does not include permanent U.S. bases.",152,168,eastern frontier,2,0,2
30UZJB2POHDX5D16FB14SV903B153I,"With the agreement signed Wednesday in Afghanistan, the U.S. also has in mind the strategic significance of preserving a military partnership on Iran's eastern frontier, even if it does not include permanent U.S. bases.",160,168,frontier,2,5,7
30UZJB2POHDX5D16FB14SV903B153I,"With the agreement signed Wednesday in Afghanistan, the U.S. also has in mind the strategic significance of preserving a military partnership on Iran's eastern frontier, even if it does not include permanent U.S. bases.",198,207,permanent,4,0,4
30UZJB2POHDX5D16FB14SV903B153I,"With the agreement signed Wednesday in Afghanistan, the U.S. also has in mind the strategic significance of preserving a military partnership on Iran's eastern frontier, even if it does not include permanent U.S. bases.",208,218,U.S. bases,1,0,1
30UZJB2POHDX5D16FB14SV903B153I,"Even after the U.S. combat mission is concluded in 2014, it is likely that thousands of U.S. troops will remain for some years to conduct counterterrorism strikes and otherwise train and advise Afghan forces, and help the Afghans collect and exploit intelligence on insurgents and other military targets.",15,34,U.S. combat mission,0,1,1
30UZJB2POHDX5D16FB14SV903B153I,"Even after the U.S. combat mission is concluded in 2014, it is likely that thousands of U.S. troops will remain for some years to conduct counterterrorism strikes and otherwise train and advise Afghan forces, and help the Afghans collect and exploit intelligence on insurgents and other military targets.",20,26,combat,0,2,2
30UZJB2POHDX5D16FB14SV903B153I,"Even after the U.S. combat mission is concluded in 2014, it is likely that thousands of U.S. troops will remain for some years to conduct counterterrorism strikes and otherwise train and advise Afghan forces, and help the Afghans collect and exploit intelligence on insurgents and other military targets.",20,34,combat mission,1,0,1
30UZJB2POHDX5D16FB14SV903B153I,"Even after the U.S. combat mission is concluded in 2014, it is likely that thousands of U.S. troops will remain for some years to conduct counterterrorism strikes and otherwise train and advise Afghan forces, and help the Afghans collect and exploit intelligence on insurgents and other military targets.",38,47,concluded,1,2,3
30UZJB2POHDX5D16FB14SV903B153I,"Even after the U.S. combat mission is concluded in 2014, it is likely that thousands of U.S. troops will remain for some years to conduct counterterrorism strikes and otherwise train and advise Afghan forces, and help the Afghans collect and exploit intelligence on insurgents and other military targets.",130,137,conduct,2,1,3
30UZJB2POHDX5D16FB14SV903B153I,"Even after the U.S. combat mission is concluded in 2014, it is likely that thousands of U.S. troops will remain for some years to conduct counterterrorism strikes and otherwise train and advise Afghan forces, and help the Afghans collect and exploit intelligence on insurgents and other military targets.",130,154,conduct counterterrorism,1,1,2
30UZJB2POHDX5D16FB14SV903B153I,"Even after the U.S. combat mission is concluded in 2014, it is likely that thousands of U.S. troops will remain for some years to conduct counterterrorism strikes and otherwise train and advise Afghan forces, and help the Afghans collect and exploit intelligence on insurgents and other military targets.",138,154,counterterrorism,10,9,19
30UZJB2POHDX5D16FB14SV903B153I,"Even after the U.S. combat mission is concluded in 2014, it is likely that thousands of U.S. troops will remain for some years to conduct counterterrorism strikes and otherwise train and advise Afghan forces, and help the Afghans collect and exploit intelligence on insurgents and other military targets.",138,162,counterterrorism strikes,2,0,2
30UZJB2POHDX5D16FB14SV903B153I,"Even after the U.S. combat mission is concluded in 2014, it is likely that thousands of U.S. troops will remain for some years to conduct counterterrorism strikes and otherwise train and advise Afghan forces, and help the Afghans collect and exploit intelligence on insurgents and other military targets.",155,162,strikes,0,1,1
30UZJB2POHDX5D16FB14SV903B153I,"Even after the U.S. combat mission is concluded in 2014, it is likely that thousands of U.S. troops will remain for some years to conduct counterterrorism strikes and otherwise train and advise Afghan forces, and help the Afghans collect and exploit intelligence on insurgents and other military targets.",167,176,otherwise,0,2,2
30UZJB2POHDX5D16FB14SV903B153I,"Even after the U.S. combat mission is concluded in 2014, it is likely that thousands of U.S. troops will remain for some years to conduct counterterrorism strikes and otherwise train and advise Afghan forces, and help the Afghans collect and exploit intelligence on insurgents and other military targets.",187,193,advise,1,0,1
30UZJB2POHDX5D16FB14SV903B153I,"Even after the U.S. combat mission is concluded in 2014, it is likely that thousands of U.S. troops will remain for some years to conduct counterterrorism strikes and otherwise train and advise Afghan forces, and help the Afghans collect and exploit intelligence on insurgents and other military targets.",242,249,exploit,7,9,16
30UZJB2POHDX5D16FB14SV903B153I,"Even after the U.S. combat mission is concluded in 2014, it is likely that thousands of U.S. troops will remain for some years to conduct counterterrorism strikes and otherwise train and advise Afghan forces, and help the Afghans collect and exploit intelligence on insurgents and other military targets.",242,262,exploit intelligence,3,1,4
30UZJB2POHDX5D16FB14SV903B153I,"Even after the U.S. combat mission is concluded in 2014, it is likely that thousands of U.S. troops will remain for some years to conduct counterterrorism strikes and otherwise train and advise Afghan forces, and help the Afghans collect and exploit intelligence on insurgents and other military targets.",250,262,intelligence,2,1,3
30UZJB2POHDX5D16FB14SV903B153I,"Even after the U.S. combat mission is concluded in 2014, it is likely that thousands of U.S. troops will remain for some years to conduct counterterrorism strikes and otherwise train and advise Afghan forces, and help the Afghans collect and exploit intelligence on insurgents and other military targets.",266,276,insurgents,10,10,20
30UZJB2POHDX5D16FB14SV903B153I,"Even after the U.S. combat mission is concluded in 2014, it is likely that thousands of U.S. troops will remain for some years to conduct counterterrorism strikes and otherwise train and advise Afghan forces, and help the Afghans collect and exploit intelligence on insurgents and other military targets.",287,303,military targets,2,0,2
30UZJB2POHDX5D16FB14SV903B153I,"Even after the U.S. combat mission is concluded in 2014, it is likely that thousands of U.S. troops will remain for some years to conduct counterterrorism strikes and otherwise train and advise Afghan forces, and help the Afghans collect and exploit intelligence on insurgents and other military targets.",296,303,targets,0,1,1
3YO4AH2FPDLQH7L7GG7OO86KWJPQ0I,Part of the plan includes the deployment in flashpoint areas of around 300 UN military observers.,30,40,deployment,10,9,19
3YO4AH2FPDLQH7L7GG7OO86KWJPQ0I,Part of the plan includes the deployment in flashpoint areas of around 300 UN military observers.,30,60,deployment in flashpoint areas,1,0,1
3YO4AH2FPDLQH7L7GG7OO86KWJPQ0I,Part of the plan includes the deployment in flashpoint areas of around 300 UN military observers.,44,54,flashpoint,10,8,18
3YO4AH2FPDLQH7L7GG7OO86KWJPQ0I,Part of the plan includes the deployment in flashpoint areas of around 300 UN military observers.,44,60,flashpoint areas,3,2,5
3YO4AH2FPDLQH7L7GG7OO86KWJPQ0I,Part of the plan includes the deployment in flashpoint areas of around 300 UN military observers.,75,86,UN military,1,0,1
3YO4AH2FPDLQH7L7GG7OO86KWJPQ0I,Part of the plan includes the deployment in flashpoint areas of around 300 UN military observers.,78,96,military observers,0,1,1
3YO4AH2FPDLQH7L7GG7OO86KWJPQ0I,Part of the plan includes the deployment in flashpoint areas of around 300 UN military observers.,87,96,observers,1,2,3
3YO4AH2FPDLQH7L7GG7OO86KWJPQ0I,"By Sunday, 189 observers were on the ground, the UN mission in Syria said.",15,24,observers,1,1,2
3YO4AH2FPDLQH7L7GG7OO86KWJPQ0I,"By Sunday, 189 observers were on the ground, the UN mission in Syria said.",15,43,observers were on the ground,1,0,1
3YO4AH2FPDLQH7L7GG7OO86KWJPQ0I,"By Sunday, 189 observers were on the ground, the UN mission in Syria said.",49,59,UN mission,1,0,1
3YO4AH2FPDLQH7L7GG7OO86KWJPQ0I,"By Sunday, 189 observers were on the ground, the UN mission in Syria said.",63,68,Syria,1,0,1
3YO4AH2FPDLQH7L7GG7OO86KWJPQ0I,"Despite the presence of the observers, more than 50 people were killed across Syria at the weekend in raids and shelling attacks by regime forces on rebel strongholds, and in clashes between soldiers and armed rebels, the Observatory said.",0,7,Despite,1,5,6
3YO4AH2FPDLQH7L7GG7OO86KWJPQ0I,"Despite the presence of the observers, more than 50 people were killed across Syria at the weekend in raids and shelling attacks by regime forces on rebel strongholds, and in clashes between soldiers and armed rebels, the Observatory said.",12,20,presence,0,1,1
3YO4AH2FPDLQH7L7GG7OO86KWJPQ0I,"Despite the presence of the observers, more than 50 people were killed across Syria at the weekend in raids and shelling attacks by regime forces on rebel strongholds, and in clashes between soldiers and armed rebels, the Observatory said.",102,107,raids,1,2,3
3YO4AH2FPDLQH7L7GG7OO86KWJPQ0I,"Despite the presence of the observers, more than 50 people were killed across Syria at the weekend in raids and shelling attacks by regime forces on rebel strongholds, and in clashes between soldiers and armed rebels, the Observatory said.",112,120,shelling,3,5,8
3YO4AH2FPDLQH7L7GG7OO86KWJPQ0I,"Despite the presence of the observers, more than 50 people were killed across Syria at the weekend in raids and shelling attacks by regime forces on rebel strongholds, and in clashes between soldiers and armed rebels, the Observatory said.",112,128,shelling attacks,5,2,7
3YO4AH2FPDLQH7L7GG7OO86KWJPQ0I,"Despite the presence of the observers, more than 50 people were killed across Syria at the weekend in raids and shelling attacks by regime forces on rebel strongholds, and in clashes between soldiers and armed rebels, the Observatory said.",132,138,regime,7,1,8
3YO4AH2FPDLQH7L7GG7OO86KWJPQ0I,"Despite the presence of the observers, more than 50 people were killed across Syria at the weekend in raids and shelling attacks by regime forces on rebel strongholds, and in clashes between soldiers and armed rebels, the Observatory said.",132,145,regime forces,3,2,5
3YO4AH2FPDLQH7L7GG7OO86KWJPQ0I,"Despite the presence of the observers, more than 50 people were killed across Syria at the weekend in raids and shelling attacks by regime forces on rebel strongholds, and in clashes between soldiers and armed rebels, the Observatory said.",149,154,rebel,1,1,2
3YO4AH2FPDLQH7L7GG7OO86KWJPQ0I,"Despite the presence of the observers, more than 50 people were killed across Syria at the weekend in raids and shelling attacks by regime forces on rebel strongholds, and in clashes between soldiers and armed rebels, the Observatory said.",149,166,rebel strongholds,5,0,5
3YO4AH2FPDLQH7L7GG7OO86KWJPQ0I,"Despite the presence of the observers, more than 50 people were killed across Syria at the weekend in raids and shelling attacks by regime forces on rebel strongholds, and in clashes between soldiers and armed rebels, the Observatory said.",155,166,strongholds,4,10,14
3YO4AH2FPDLQH7L7GG7OO86KWJPQ0I,"Despite the presence of the observers, more than 50 people were killed across Syria at the weekend in raids and shelling attacks by regime forces on rebel strongholds, and in clashes between soldiers and armed rebels, the Observatory said.",175,182,clashes,1,2,3
3YO4AH2FPDLQH7L7GG7OO86KWJPQ0I,"Despite the presence of the observers, more than 50 people were killed across Syria at the weekend in raids and shelling attacks by regime forces on rebel strongholds, and in clashes between soldiers and armed rebels, the Observatory said.",204,216,armed rebels,0,1,1
3YO4AH2FPDLQH7L7GG7OO86KWJPQ0I,"Despite the presence of the observers, more than 50 people were killed across Syria at the weekend in raids and shelling attacks by regime forces on rebel strongholds, and in clashes between soldiers and armed rebels, the Observatory said.",210,216,rebels,0,3,3
3YO4AH2FPDLQH7L7GG7OO86KWJPQ0I,"Despite the presence of the observers, more than 50 people were killed across Syria at the weekend in raids and shelling attacks by regime forces on rebel strongholds, and in clashes between soldiers and armed rebels, the Observatory said.",222,233,Observatory,3,0,3
3YO4AH2FPDLQH7L7GG7OO86KWJPQ0I,"More than 12,000 people, the majority of them civilians, have died since the Syrian uprising began in March 2011, according to the watchdog, including more than 900 killed since the April 12 truce.",46,55,civilians,2,2,4
3YO4AH2FPDLQH7L7GG7OO86KWJPQ0I,"More than 12,000 people, the majority of them civilians, have died since the Syrian uprising began in March 2011, according to the watchdog, including more than 900 killed since the April 12 truce.",84,92,uprising,3,9,12
3YO4AH2FPDLQH7L7GG7OO86KWJPQ0I,"More than 12,000 people, the majority of them civilians, have died since the Syrian uprising began in March 2011, according to the watchdog, including more than 900 killed since the April 12 truce.",131,139,watchdog,6,7,13
3YO4AH2FPDLQH7L7GG7OO86KWJPQ0I,"More than 12,000 people, the majority of them civilians, have died since the Syrian uprising began in March 2011, according to the watchdog, including more than 900 killed since the April 12 truce.",191,196,truce,2,3,5
3YO4AH2FPDLQH7L7GG7OO86KWJPQ0I,"Syria-linked violence has also spilled across the border into Lebanon, with four people killed since Saturday during sectarian clashes in the northern port city of Tripoli, according to officials.",0,12,Syria-linked,1,0,1
3YO4AH2FPDLQH7L7GG7OO86KWJPQ0I,"Syria-linked violence has also spilled across the border into Lebanon, with four people killed since Saturday during sectarian clashes in the northern port city of Tripoli, according to officials.",0,21,Syria-linked violence,1,1,2
3YO4AH2FPDLQH7L7GG7OO86KWJPQ0I,"Syria-linked violence has also spilled across the border into Lebanon, with four people killed since Saturday during sectarian clashes in the northern port city of Tripoli, according to officials.",13,21,violence,0,2,2
3YO4AH2FPDLQH7L7GG7OO86KWJPQ0I,"Syria-linked violence has also spilled across the border into Lebanon, with four people killed since Saturday during sectarian clashes in the northern port city of Tripoli, according to officials.",31,38,spilled,3,6,9
3YO4AH2FPDLQH7L7GG7OO86KWJPQ0I,"Syria-linked violence has also spilled across the border into Lebanon, with four people killed since Saturday during sectarian clashes in the northern port city of Tripoli, according to officials.",31,45,spilled across,0,1,1
3YO4AH2FPDLQH7L7GG7OO86KWJPQ0I,"Syria-linked violence has also spilled across the border into Lebanon, with four people killed since Saturday during sectarian clashes in the northern port city of Tripoli, according to officials.",62,69,Lebanon,1,0,1
3YO4AH2FPDLQH7L7GG7OO86KWJPQ0I,"Syria-linked violence has also spilled across the border into Lebanon, with four people killed since Saturday during sectarian clashes in the northern port city of Tripoli, according to officials.",117,126,sectarian,7,1,8
3YO4AH2FPDLQH7L7GG7OO86KWJPQ0I,"Syria-linked violence has also spilled across the border into Lebanon, with four people killed since Saturday during sectarian clashes in the northern port city of Tripoli, according to officials.",117,134,sectarian clashes,8,6,14
3YO4AH2FPDLQH7L7GG7OO86KWJPQ0I,"Syria-linked violence has also spilled across the border into Lebanon, with four people killed since Saturday during sectarian clashes in the northern port city of Tripoli, according to officials.",127,134,clashes,0,1,1
3NSCTNUR2ZOXPY0ROQGEF3N6AMHA5A,"He added: At around 11.10am, a 26-year-old man was arrested on suspicion of murder and a 28-year-old male and 28-year-old female were arrested on suspicion of assisting an offender.",63,72,suspicion,10,10,20
3NSCTNUR2ZOXPY0ROQGEF3N6AMHA5A,"He added: At around 11.10am, a 26-year-old man was arrested on suspicion of murder and a 28-year-old male and 28-year-old female were arrested on suspicion of assisting an offender.",63,82,suspicion of murder,2,2,4
3NSCTNUR2ZOXPY0ROQGEF3N6AMHA5A,"He added: At around 11.10am, a 26-year-old man was arrested on suspicion of murder and a 28-year-old male and 28-year-old female were arrested on suspicion of assisting an offender.",76,82,murder,0,1,1
3NSCTNUR2ZOXPY0ROQGEF3N6AMHA5A,"He added: At around 11.10am, a 26-year-old man was arrested on suspicion of murder and a 28-year-old male and 28-year-old female were arrested on suspicion of assisting an offender.",134,142,arrested,1,1,2
3NSCTNUR2ZOXPY0ROQGEF3N6AMHA5A,"He added: At around 11.10am, a 26-year-old man was arrested on suspicion of murder and a 28-year-old male and 28-year-old female were arrested on suspicion of assisting an offender.",134,155,arrested on suspicion,1,0,1
3NSCTNUR2ZOXPY0ROQGEF3N6AMHA5A,"He added: At around 11.10am, a 26-year-old man was arrested on suspicion of murder and a 28-year-old male and 28-year-old female were arrested on suspicion of assisting an offender.",146,155,suspicion,6,2,8
3NSCTNUR2ZOXPY0ROQGEF3N6AMHA5A,"He added: At around 11.10am, a 26-year-old man was arrested on suspicion of murder and a 28-year-old male and 28-year-old female were arrested on suspicion of assisting an offender.",146,180,suspicion of assisting an offender,3,0,3
3NSCTNUR2ZOXPY0ROQGEF3N6AMHA5A,"He added: At around 11.10am, a 26-year-old man was arrested on suspicion of murder and a 28-year-old male and 28-year-old female were arrested on suspicion of assisting an offender.",159,168,assisting,2,2,4
3NSCTNUR2ZOXPY0ROQGEF3N6AMHA5A,"He added: At around 11.10am, a 26-year-old man was arrested on suspicion of murder and a 28-year-old male and 28-year-old female were arrested on suspicion of assisting an offender.",159,180,assisting an offender,2,1,3
3NSCTNUR2ZOXPY0ROQGEF3N6AMHA5A,"He added: At around 11.10am, a 26-year-old man was arrested on suspicion of murder and a 28-year-old male and 28-year-old female were arrested on suspicion of assisting an offender.",172,180,offender,2,9,11
3NSCTNUR2ZOXPY0ROQGEF3N6AMHA5A,All three were arrested in the Toome area and have been taken to the Serious Crime Suite at Antrim police station.,31,36,Toome,0,1,1
3NSCTNUR2ZOXPY0ROQGEF3N6AMHA5A,All three were arrested in the Toome area and have been taken to the Serious Crime Suite at Antrim police station.,69,82,Serious Crime,1,1,2
3NSCTNUR2ZOXPY0ROQGEF3N6AMHA5A,All three were arrested in the Toome area and have been taken to the Serious Crime Suite at Antrim police station.,69,88,Serious Crime Suite,1,0,1
3NSCTNUR2ZOXPY0ROQGEF3N6AMHA5A,All three were arrested in the Toome area and have been taken to the Serious Crime Suite at Antrim police station.,92,98,Antrim,0,1,1
3NSCTNUR2ZOXPY0ROQGEF3N6AMHA5A,Investigating officers have appealed for anyone with information about the incident to contact them.,0,13,Investigating,5,3,8
3NSCTNUR2ZOXPY0ROQGEF3N6AMHA5A,Investigating officers have appealed for anyone with information about the incident to contact them.,0,22,Investigating officers,2,0,2
3NSCTNUR2ZOXPY0ROQGEF3N6AMHA5A,Investigating officers have appealed for anyone with information about the incident to contact them.,28,36,appealed,6,7,13
3NSCTNUR2ZOXPY0ROQGEF3N6AMHA5A,Investigating officers have appealed for anyone with information about the incident to contact them.,53,64,information,2,1,3
3NSCTNUR2ZOXPY0ROQGEF3N6AMHA5A,Investigating officers have appealed for anyone with information about the incident to contact them.,75,83,incident,7,5,12
3NSCTNUR2ZOXPY0ROQGEF3N6AMHA5A,"The Embassy is still engaged in discussions with the Philippine DFA to seek a solution of this issue, so that China-Philippine friendly relations and peace, stability in South China Sea are well preserved in the best interest of the two countries.",4,11,Embassy,3,2,5
3NSCTNUR2ZOXPY0ROQGEF3N6AMHA5A,"The Embassy is still engaged in discussions with the Philippine DFA to seek a solution of this issue, so that China-Philippine friendly relations and peace, stability in South China Sea are well preserved in the best interest of the two countries.",21,28,engaged,6,7,13
3NSCTNUR2ZOXPY0ROQGEF3N6AMHA5A,"The Embassy is still engaged in discussions with the Philippine DFA to seek a solution of this issue, so that China-Philippine friendly relations and peace, stability in South China Sea are well preserved in the best interest of the two countries.",32,43,discussions,3,2,5
3NSCTNUR2ZOXPY0ROQGEF3N6AMHA5A,"The Embassy is still engaged in discussions with the Philippine DFA to seek a solution of this issue, so that China-Philippine friendly relations and peace, stability in South China Sea are well preserved in the best interest of the two countries.",53,67,Philippine DFA,1,0,1
3NSCTNUR2ZOXPY0ROQGEF3N6AMHA5A,"The Embassy is still engaged in discussions with the Philippine DFA to seek a solution of this issue, so that China-Philippine friendly relations and peace, stability in South China Sea are well preserved in the best interest of the two countries.",64,67,DFA,0,1,1
3NSCTNUR2ZOXPY0ROQGEF3N6AMHA5A,"The Embassy is still engaged in discussions with the Philippine DFA to seek a solution of this issue, so that China-Philippine friendly relations and peace, stability in South China Sea are well preserved in the best interest of the two countries.",71,75,seek,0,1,1
3NSCTNUR2ZOXPY0ROQGEF3N6AMHA5A,"The Embassy is still engaged in discussions with the Philippine DFA to seek a solution of this issue, so that China-Philippine friendly relations and peace, stability in South China Sea are well preserved in the best interest of the two countries.",78,86,solution,1,1,2
3NSCTNUR2ZOXPY0ROQGEF3N6AMHA5A,"The Embassy is still engaged in discussions with the Philippine DFA to seek a solution of this issue, so that China-Philippine friendly relations and peace, stability in South China Sea are well preserved in the best interest of the two countries.",95,100,issue,0,1,1
3NSCTNUR2ZOXPY0ROQGEF3N6AMHA5A,"The Embassy is still engaged in discussions with the Philippine DFA to seek a solution of this issue, so that China-Philippine friendly relations and peace, stability in South China Sea are well preserved in the best interest of the two countries.",127,145,friendly relations,1,0,1
3NSCTNUR2ZOXPY0ROQGEF3N6AMHA5A,"The Embassy is still engaged in discussions with the Philippine DFA to seek a solution of this issue, so that China-Philippine friendly relations and peace, stability in South China Sea are well preserved in the best interest of the two countries.",136,145,relations,3,0,3
3NSCTNUR2ZOXPY0ROQGEF3N6AMHA5A,"The Embassy is still engaged in discussions with the Philippine DFA to seek a solution of this issue, so that China-Philippine friendly relations and peace, stability in South China Sea are well preserved in the best interest of the two countries.",157,166,stability,6,5,11
3NSCTNUR2ZOXPY0ROQGEF3N6AMHA5A,"The Embassy is still engaged in discussions with the Philippine DFA to seek a solution of this issue, so that China-Philippine friendly relations and peace, stability in South China Sea are well preserved in the best interest of the two countries.",190,204,well preserved,1,1,2
3NSCTNUR2ZOXPY0ROQGEF3N6AMHA5A,"The Embassy is still engaged in discussions with the Philippine DFA to seek a solution of this issue, so that China-Philippine friendly relations and peace, stability in South China Sea are well preserved in the best interest of the two countries.",195,204,preserved,3,4,7
3NSCTNUR2ZOXPY0ROQGEF3N6AMHA5A,"Del Rosario invited Ma to the DFA Wednesday morning for further discussion of the issue, the DFA added.",12,19,invited,0,1,1
3NSCTNUR2ZOXPY0ROQGEF3N6AMHA5A,"Del Rosario invited Ma to the DFA Wednesday morning for further discussion of the issue, the DFA added.",30,33,DFA,0,1,1
3NSCTNUR2ZOXPY0ROQGEF3N6AMHA5A,"Del Rosario invited Ma to the DFA Wednesday morning for further discussion of the issue, the DFA added.",64,74,discussion,2,0,2
3NSCTNUR2ZOXPY0ROQGEF3N6AMHA5A,"Del Rosario invited Ma to the DFA Wednesday morning for further discussion of the issue, the DFA added.",82,87,issue,0,1,1
3NSCTNUR2ZOXPY0ROQGEF3N6AMHA5A,"Del Rosario invited Ma to the DFA Wednesday morning for further discussion of the issue, the DFA added.",93,96,DFA,1,1,2
3GKAWYFRAPUZGFLMSFGU3A0TLCCDP7,The announcement came as Spanish bank stocks tumbled Friday.,4,16,announcement,3,1,4
3GKAWYFRAPUZGFLMSFGU3A0TLCCDP7,The announcement came as Spanish bank stocks tumbled Friday.,33,44,bank stocks,1,0,1
3GKAWYFRAPUZGFLMSFGU3A0TLCCDP7,The announcement came as Spanish bank stocks tumbled Friday.,38,44,stocks,1,1,2
3GKAWYFRAPUZGFLMSFGU3A0TLCCDP7,The announcement came as Spanish bank stocks tumbled Friday.,45,52,tumbled,9,10,19
3GKAWYFRAPUZGFLMSFGU3A0TLCCDP7,"Spain is expected to present new reforms to complete the clean-up of its banks on Friday, May 11, after difficult last-minute talks between the government and lenders.",9,17,expected,0,1,1
3GKAWYFRAPUZGFLMSFGU3A0TLCCDP7,"Spain is expected to present new reforms to complete the clean-up of its banks on Friday, May 11, after difficult last-minute talks between the government and lenders.",29,40,new reforms,2,0,2
3GKAWYFRAPUZGFLMSFGU3A0TLCCDP7,"Spain is expected to present new reforms to complete the clean-up of its banks on Friday, May 11, after difficult last-minute talks between the government and lenders.",33,40,reforms,4,5,9
3GKAWYFRAPUZGFLMSFGU3A0TLCCDP7,"Spain is expected to present new reforms to complete the clean-up of its banks on Friday, May 11, after difficult last-minute talks between the government and lenders.",57,65,clean-up,2,3,5
3GKAWYFRAPUZGFLMSFGU3A0TLCCDP7,"Spain is expected to present new reforms to complete the clean-up of its banks on Friday, May 11, after difficult last-minute talks between the government and lenders.",57,78,clean-up of its banks,1,1,2
3GKAWYFRAPUZGFLMSFGU3A0TLCCDP7,"Spain is expected to present new reforms to complete the clean-up of its banks on Friday, May 11, after difficult last-minute talks between the government and lenders.",114,131,last-minute talks,1,1,2
3GKAWYFRAPUZGFLMSFGU3A0TLCCDP7,"Spain is expected to present new reforms to complete the clean-up of its banks on Friday, May 11, after difficult last-minute talks between the government and lenders.",144,154,government,1,0,1
3GKAWYFRAPUZGFLMSFGU3A0TLCCDP7,"Spain is expected to present new reforms to complete the clean-up of its banks on Friday, May 11, after difficult last-minute talks between the government and lenders.",159,166,lenders,2,5,7
3GKAWYFRAPUZGFLMSFGU3A0TLCCDP7,"Reuters reported that at its weekly cabinet meeting, the government will approve a plan to force banks to park their toxic real estate assets in holding companies that would later sell them off.",0,7,Reuters,5,2,7
3GKAWYFRAPUZGFLMSFGU3A0TLCCDP7,"Reuters reported that at its weekly cabinet meeting, the government will approve a plan to force banks to park their toxic real estate assets in holding companies that would later sell them off.",36,43,cabinet,1,1,2
3GKAWYFRAPUZGFLMSFGU3A0TLCCDP7,"Reuters reported that at its weekly cabinet meeting, the government will approve a plan to force banks to park their toxic real estate assets in holding companies that would later sell them off.",57,67,government,1,0,1
3GKAWYFRAPUZGFLMSFGU3A0TLCCDP7,"Reuters reported that at its weekly cabinet meeting, the government will approve a plan to force banks to park their toxic real estate assets in holding companies that would later sell them off.",103,110,to park,1,0,1
3GKAWYFRAPUZGFLMSFGU3A0TLCCDP7,"Reuters reported that at its weekly cabinet meeting, the government will approve a plan to force banks to park their toxic real estate assets in holding companies that would later sell them off.",106,110,park,0,1,1
3GKAWYFRAPUZGFLMSFGU3A0TLCCDP7,"Reuters reported that at its weekly cabinet meeting, the government will approve a plan to force banks to park their toxic real estate assets in holding companies that would later sell them off.",117,122,toxic,3,5,8
3GKAWYFRAPUZGFLMSFGU3A0TLCCDP7,"Reuters reported that at its weekly cabinet meeting, the government will approve a plan to force banks to park their toxic real estate assets in holding companies that would later sell them off.",117,141,toxic real estate assets,6,1,7
3GKAWYFRAPUZGFLMSFGU3A0TLCCDP7,"Reuters reported that at its weekly cabinet meeting, the government will approve a plan to force banks to park their toxic real estate assets in holding companies that would later sell them off.",135,141,assets,1,0,1
3GKAWYFRAPUZGFLMSFGU3A0TLCCDP7,"Reuters reported that at its weekly cabinet meeting, the government will approve a plan to force banks to park their toxic real estate assets in holding companies that would later sell them off.",145,152,holding,0,2,2
3GKAWYFRAPUZGFLMSFGU3A0TLCCDP7,"Reuters reported that at its weekly cabinet meeting, the government will approve a plan to force banks to park their toxic real estate assets in holding companies that would later sell them off.",145,162,holding companies,4,2,6
3GKAWYFRAPUZGFLMSFGU3A0TLCCDP7,The cabinet is also expected to announce demands for the banks to set aside a further 35 billion euros ($45 billion) to cover sound loans in their real estate portfolios.,4,11,cabinet,4,0,4
3GKAWYFRAPUZGFLMSFGU3A0TLCCDP7,The cabinet is also expected to announce demands for the banks to set aside a further 35 billion euros ($45 billion) to cover sound loans in their real estate portfolios.,20,28,expected,0,1,1
3GKAWYFRAPUZGFLMSFGU3A0TLCCDP7,The cabinet is also expected to announce demands for the banks to set aside a further 35 billion euros ($45 billion) to cover sound loans in their real estate portfolios.,32,40,announce,1,1,2
3GKAWYFRAPUZGFLMSFGU3A0TLCCDP7,The cabinet is also expected to announce demands for the banks to set aside a further 35 billion euros ($45 billion) to cover sound loans in their real estate portfolios.,41,48,demands,0,2,2
3GKAWYFRAPUZGFLMSFGU3A0TLCCDP7,The cabinet is also expected to announce demands for the banks to set aside a further 35 billion euros ($45 billion) to cover sound loans in their real estate portfolios.,66,75,set aside,0,1,1
3GKAWYFRAPUZGFLMSFGU3A0TLCCDP7,The cabinet is also expected to announce demands for the banks to set aside a further 35 billion euros ($45 billion) to cover sound loans in their real estate portfolios.,70,75,aside,0,2,2
3GKAWYFRAPUZGFLMSFGU3A0TLCCDP7,The cabinet is also expected to announce demands for the banks to set aside a further 35 billion euros ($45 billion) to cover sound loans in their real estate portfolios.,120,137,cover sound loans,0,1,1
3GKAWYFRAPUZGFLMSFGU3A0TLCCDP7,The cabinet is also expected to announce demands for the banks to set aside a further 35 billion euros ($45 billion) to cover sound loans in their real estate portfolios.,126,137,sound loans,4,1,5
3GKAWYFRAPUZGFLMSFGU3A0TLCCDP7,The cabinet is also expected to announce demands for the banks to set aside a further 35 billion euros ($45 billion) to cover sound loans in their real estate portfolios.,132,137,loans,0,1,1
3GKAWYFRAPUZGFLMSFGU3A0TLCCDP7,The cabinet is also expected to announce demands for the banks to set aside a further 35 billion euros ($45 billion) to cover sound loans in their real estate portfolios.,147,169,real estate portfolios,3,1,4
3GKAWYFRAPUZGFLMSFGU3A0TLCCDP7,The cabinet is also expected to announce demands for the banks to set aside a further 35 billion euros ($45 billion) to cover sound loans in their real estate portfolios.,159,169,portfolios,9,7,16
3GKAWYFRAPUZGFLMSFGU3A0TLCCDP7,The government has already forced banks to make provisions of 54 billion euros to cover bad assets.,48,58,provisions,6,6,12
3GKAWYFRAPUZGFLMSFGU3A0TLCCDP7,The government has already forced banks to make provisions of 54 billion euros to cover bad assets.,88,98,bad assets,6,2,8
3GKAWYFRAPUZGFLMSFGU3A0TLCCDP7,The government has already forced banks to make provisions of 54 billion euros to cover bad assets.,92,98,assets,2,0,2
3GKAWYFRAPUZGFLMSFGU3A0TLCCDP7,"The text is being finalized after talks with the banks, a government source told Reuters, adding that both the new provisions and the ""bad bank"" scheme would be approved on Friday.",19,28,finalized,2,2,4
3GKAWYFRAPUZGFLMSFGU3A0TLCCDP7,"The text is being finalized after talks with the banks, a government source told Reuters, adding that both the new provisions and the ""bad bank"" scheme would be approved on Friday.",60,70,government,1,0,1
3GKAWYFRAPUZGFLMSFGU3A0TLCCDP7,"The text is being finalized after talks with the banks, a government source told Reuters, adding that both the new provisions and the ""bad bank"" scheme would be approved on Friday.",83,90,Reuters,3,0,3
3GKAWYFRAPUZGFLMSFGU3A0TLCCDP7,"The text is being finalized after talks with the banks, a government source told Reuters, adding that both the new provisions and the ""bad bank"" scheme would be approved on Friday.",113,127,new provisions,1,0,1
3GKAWYFRAPUZGFLMSFGU3A0TLCCDP7,"The text is being finalized after talks with the banks, a government source told Reuters, adding that both the new provisions and the ""bad bank"" scheme would be approved on Friday.",117,127,provisions,3,3,6
3GKAWYFRAPUZGFLMSFGU3A0TLCCDP7,"The text is being finalized after talks with the banks, a government source told Reuters, adding that both the new provisions and the ""bad bank"" scheme would be approved on Friday.",136,151,bad bank scheme,1,1,2
3GKAWYFRAPUZGFLMSFGU3A0TLCCDP7,"The text is being finalized after talks with the banks, a government source told Reuters, adding that both the new provisions and the ""bad bank"" scheme would be approved on Friday.",137,145,bad bank,1,1,2
3GKAWYFRAPUZGFLMSFGU3A0TLCCDP7,"The text is being finalized after talks with the banks, a government source told Reuters, adding that both the new provisions and the ""bad bank"" scheme would be approved on Friday.",147,153,scheme,3,0,3
3GKAWYFRAPUZGFLMSFGU3A0TLCCDP7,"The text is being finalized after talks with the banks, a government source told Reuters, adding that both the new provisions and the ""bad bank"" scheme would be approved on Friday.",163,171,approved,1,0,1
3PEG1BH7AES5QRQM1RKGC3QUPUXKB0,"Thirty-three-year-old Tonya Thomas fatally shot her four children, who ranged in age from 12 to 17, said Lt. Tod Goodyear, a spokesman for the Brevard County Sheriff's Office.",0,21,Thirty-three-year-old,1,0,1
3PEG1BH7AES5QRQM1RKGC3QUPUXKB0,"Thirty-three-year-old Tonya Thomas fatally shot her four children, who ranged in age from 12 to 17, said Lt. Tod Goodyear, a spokesman for the Brevard County Sheriff's Office.",35,42,fatally,7,8,15
3PEG1BH7AES5QRQM1RKGC3QUPUXKB0,"Thirty-three-year-old Tonya Thomas fatally shot her four children, who ranged in age from 12 to 17, said Lt. Tod Goodyear, a spokesman for the Brevard County Sheriff's Office.",35,47,fatally shot,1,1,2
3PEG1BH7AES5QRQM1RKGC3QUPUXKB0,"Thirty-three-year-old Tonya Thomas fatally shot her four children, who ranged in age from 12 to 17, said Lt. Tod Goodyear, a spokesman for the Brevard County Sheriff's Office.",43,47,shot,1,0,1
3PEG1BH7AES5QRQM1RKGC3QUPUXKB0,"Thirty-three-year-old Tonya Thomas fatally shot her four children, who ranged in age from 12 to 17, said Lt. Tod Goodyear, a spokesman for the Brevard County Sheriff's Office.",71,77,ranged,4,2,6
3PEG1BH7AES5QRQM1RKGC3QUPUXKB0,"Thirty-three-year-old Tonya Thomas fatally shot her four children, who ranged in age from 12 to 17, said Lt. Tod Goodyear, a spokesman for the Brevard County Sheriff's Office.",123,134,a spokesman,1,0,1
3PEG1BH7AES5QRQM1RKGC3QUPUXKB0,"Thirty-three-year-old Tonya Thomas fatally shot her four children, who ranged in age from 12 to 17, said Lt. Tod Goodyear, a spokesman for the Brevard County Sheriff's Office.",125,134,spokesman,3,5,8
3PEG1BH7AES5QRQM1RKGC3QUPUXKB0,"Thirty-three-year-old Tonya Thomas fatally shot her four children, who ranged in age from 12 to 17, said Lt. Tod Goodyear, a spokesman for the Brevard County Sheriff's Office.",158,165,Sheriff,1,0,1
3PEG1BH7AES5QRQM1RKGC3QUPUXKB0,"Thirty-three-year-old Tonya Thomas fatally shot her four children, who ranged in age from 12 to 17, said Lt. Tod Goodyear, a spokesman for the Brevard County Sheriff's Office.",158,166,Sheriffs,1,0,1
3PEG1BH7AES5QRQM1RKGC3QUPUXKB0,"Thirty-three-year-old Tonya Thomas fatally shot her four children, who ranged in age from 12 to 17, said Lt. Tod Goodyear, a spokesman for the Brevard County Sheriff's Office.",158,173,Sheriffs Office,1,0,1
3PEG1BH7AES5QRQM1RKGC3QUPUXKB0,Three of the children had gone to a neighbor's front door before dawn to say their mother had shot them.,36,44,neighbor,1,0,1
3PEG1BH7AES5QRQM1RKGC3QUPUXKB0,Three of the children had gone to a neighbor's front door before dawn to say their mother had shot them.,36,45,neighbors,0,3,3
3PEG1BH7AES5QRQM1RKGC3QUPUXKB0,Three of the children had gone to a neighbor's front door before dawn to say their mother had shot them.,36,56,neighbors front door,1,0,1
3PEG1BH7AES5QRQM1RKGC3QUPUXKB0,Three of the children had gone to a neighbor's front door before dawn to say their mother had shot them.,65,69,dawn,3,5,8
3PEG1BH7AES5QRQM1RKGC3QUPUXKB0,"From what the neighbors said, she was very calm.	15	24	neighbors	0	2	2
3PEG1BH7AES5QRQM1RKGC3QUPUXKB0	From what the neighbors said, she was very calm.",44,48,calm,1,2,3
3PEG1BH7AES5QRQM1RKGC3QUPUXKB0,She walked out and called them back.,4,14,walked out,1,0,1
3PEG1BH7AES5QRQM1RKGC3QUPUXKB0,"They turned around and walked back to the house,"" Goodyear said.",23,34,walked back,1,0,1
3PEG1BH7AES5QRQM1RKGC3QUPUXKB0,The neighbor then heard gunshots and called 911.,4,12,neighbor,1,1,2
3PEG1BH7AES5QRQM1RKGC3QUPUXKB0,The neighbor then heard gunshots and called 911.,24,32,gunshots,3,2,5
3PEG1BH7AES5QRQM1RKGC3QUPUXKB0,Another neighbor told deputies that Thomas sent a text message in the middle of the night saying she wanted to be cremated with her children.,8,16,neighbor,1,1,2
3PEG1BH7AES5QRQM1RKGC3QUPUXKB0,Another neighbor told deputies that Thomas sent a text message in the middle of the night saying she wanted to be cremated with her children.,22,30,deputies,7,5,12
3PEG1BH7AES5QRQM1RKGC3QUPUXKB0,Another neighbor told deputies that Thomas sent a text message in the middle of the night saying she wanted to be cremated with her children.,50,54,text,1,0,1
3PEG1BH7AES5QRQM1RKGC3QUPUXKB0,Another neighbor told deputies that Thomas sent a text message in the middle of the night saying she wanted to be cremated with her children.,50,62,text message,0,1,1
3PEG1BH7AES5QRQM1RKGC3QUPUXKB0,Another neighbor told deputies that Thomas sent a text message in the middle of the night saying she wanted to be cremated with her children.,55,62,message,0,1,1
3PEG1BH7AES5QRQM1RKGC3QUPUXKB0,Another neighbor told deputies that Thomas sent a text message in the middle of the night saying she wanted to be cremated with her children.,114,122,cremated,10,10,20
3DGDV62G7OACD5N6VQWD7R9PPYQ2PH,The demonstrations on Monday and Tuesday were an unusually sustained show of support for the Russian opposition.,4,18,demonstrations,10,7,17
3DGDV62G7OACD5N6VQWD7R9PPYQ2PH,The demonstrations on Monday and Tuesday were an unusually sustained show of support for the Russian opposition.,49,58,unusually,0,1,1
3DGDV62G7OACD5N6VQWD7R9PPYQ2PH,The demonstrations on Monday and Tuesday were an unusually sustained show of support for the Russian opposition.,49,68,unusually sustained,4,0,4
3DGDV62G7OACD5N6VQWD7R9PPYQ2PH,The demonstrations on Monday and Tuesday were an unusually sustained show of support for the Russian opposition.,49,84,unusually sustained show of support,1,0,1
3DGDV62G7OACD5N6VQWD7R9PPYQ2PH,The demonstrations on Monday and Tuesday were an unusually sustained show of support for the Russian opposition.,59,68,sustained,7,10,17
3DGDV62G7OACD5N6VQWD7R9PPYQ2PH,The demonstrations on Monday and Tuesday were an unusually sustained show of support for the Russian opposition.,101,111,opposition,4,1,5
3DGDV62G7OACD5N6VQWD7R9PPYQ2PH,"The thousands who rallied in the capital and St Petersburg clashed with police and interior ministry troops, who later detained hundreds of protesters.",18,25,rallied,3,7,10
3DGDV62G7OACD5N6VQWD7R9PPYQ2PH,"The thousands who rallied in the capital and St Petersburg clashed with police and interior ministry troops, who later detained hundreds of protesters.",59,66,clashed,1,0,1
3DGDV62G7OACD5N6VQWD7R9PPYQ2PH,"The thousands who rallied in the capital and St Petersburg clashed with police and interior ministry troops, who later detained hundreds of protesters.",83,91,interior,1,2,3
3DGDV62G7OACD5N6VQWD7R9PPYQ2PH,"The thousands who rallied in the capital and St Petersburg clashed with police and interior ministry troops, who later detained hundreds of protesters.",83,100,interior ministry,0,1,1
3DGDV62G7OACD5N6VQWD7R9PPYQ2PH,"The thousands who rallied in the capital and St Petersburg clashed with police and interior ministry troops, who later detained hundreds of protesters.",83,107,interior ministry troops,3,0,3
3DGDV62G7OACD5N6VQWD7R9PPYQ2PH,"The thousands who rallied in the capital and St Petersburg clashed with police and interior ministry troops, who later detained hundreds of protesters.",92,100,ministry,1,0,1
3DGDV62G7OACD5N6VQWD7R9PPYQ2PH,"The thousands who rallied in the capital and St Petersburg clashed with police and interior ministry troops, who later detained hundreds of protesters.",119,127,detained,6,8,14
3DGDV62G7OACD5N6VQWD7R9PPYQ2PH,"The thousands who rallied in the capital and St Petersburg clashed with police and interior ministry troops, who later detained hundreds of protesters.",140,150,protesters,1,4,5
3DGDV62G7OACD5N6VQWD7R9PPYQ2PH,"More opposition rallies were expected on Wednesday, along with pro-Putin gatherings.",5,15,opposition,3,0,3
3DGDV62G7OACD5N6VQWD7R9PPYQ2PH,"More opposition rallies were expected on Wednesday, along with pro-Putin gatherings.",5,23,opposition rallies,3,0,3
3DGDV62G7OACD5N6VQWD7R9PPYQ2PH,"More opposition rallies were expected on Wednesday, along with pro-Putin gatherings.",16,23,rallies,0,2,2
3DGDV62G7OACD5N6VQWD7R9PPYQ2PH,"More opposition rallies were expected on Wednesday, along with pro-Putin gatherings.",63,72,pro-Putin,1,0,1
3DGDV62G7OACD5N6VQWD7R9PPYQ2PH,"More opposition rallies were expected on Wednesday, along with pro-Putin gatherings.",63,83,pro-Putin gatherings,1,2,3
3DGDV62G7OACD5N6VQWD7R9PPYQ2PH,"More opposition rallies were expected on Wednesday, along with pro-Putin gatherings.",73,83,gatherings,0,6,6
3DGDV62G7OACD5N6VQWD7R9PPYQ2PH,"Putin was expected to formally register on Wednesday to run for president, a position he held from 2000-2008, a period in which he grew more authoritarian.",22,39,formally register,2,0,2
3DGDV62G7OACD5N6VQWD7R9PPYQ2PH,"Putin was expected to formally register on Wednesday to run for president, a position he held from 2000-2008, a period in which he grew more authoritarian.",131,135,grew,0,1,1
3DGDV62G7OACD5N6VQWD7R9PPYQ2PH,"Putin was expected to formally register on Wednesday to run for president, a position he held from 2000-2008, a period in which he grew more authoritarian.",131,154,grew more authoritarian,1,0,1
3DGDV62G7OACD5N6VQWD7R9PPYQ2PH,"Putin was expected to formally register on Wednesday to run for president, a position he held from 2000-2008, a period in which he grew more authoritarian.",141,154,authoritarian,10,10,20
3DGDV62G7OACD5N6VQWD7R9PPYQ2PH,Sunday's parliamentary vote suggests Russians are tiring of Putin and his United Russia party.,9,22,parliamentary,8,2,10
3DGDV62G7OACD5N6VQWD7R9PPYQ2PH,Sunday's parliamentary vote suggests Russians are tiring of Putin and his United Russia party.,9,27,parliamentary vote,2,0,2
3DGDV62G7OACD5N6VQWD7R9PPYQ2PH,Sunday's parliamentary vote suggests Russians are tiring of Putin and his United Russia party.,50,56,tiring,0,3,3
3DGDV62G7OACD5N6VQWD7R9PPYQ2PH,Sunday's parliamentary vote suggests Russians are tiring of Putin and his United Russia party.,50,59,tiring of,0,1,1
3DGDV62G7OACD5N6VQWD7R9PPYQ2PH,Sunday's parliamentary vote suggests Russians are tiring of Putin and his United Russia party.,60,65,Putin,0,1,1
3DGDV62G7OACD5N6VQWD7R9PPYQ2PH,"Preliminary results indicate the party won less than 50% of votes, a steep fall from its earlier majority.",0,11,Preliminary,7,3,10
3DGDV62G7OACD5N6VQWD7R9PPYQ2PH,"Preliminary results indicate the party won less than 50% of votes, a steep fall from its earlier majority.",0,19,Preliminary results,2,0,2
3DGDV62G7OACD5N6VQWD7R9PPYQ2PH,"Preliminary results indicate the party won less than 50% of votes, a steep fall from its earlier majority.",69,74,steep,2,4,6
3DGDV62G7OACD5N6VQWD7R9PPYQ2PH,"Preliminary results indicate the party won less than 50% of votes, a steep fall from its earlier majority.",69,79,steep fall,0,1,1
3DGDV62G7OACD5N6VQWD7R9PPYQ2PH,"Preliminary results indicate the party won less than 50% of votes, a steep fall from its earlier majority.",75,79,fall,0,1,1
3DGDV62G7OACD5N6VQWD7R9PPYQ2PH,"Preliminary results indicate the party won less than 50% of votes, a steep fall from its earlier majority.",89,105,earlier majority,2,0,2
3DGDV62G7OACD5N6VQWD7R9PPYQ2PH,The poll has been marred by widespread allegations of vote-rigging.,18,24,marred,4,7,11
3DGDV62G7OACD5N6VQWD7R9PPYQ2PH,The poll has been marred by widespread allegations of vote-rigging.,28,38,widespread,0,2,2
3DGDV62G7OACD5N6VQWD7R9PPYQ2PH,The poll has been marred by widespread allegations of vote-rigging.,28,50,widespread allegations,3,0,3
3DGDV62G7OACD5N6VQWD7R9PPYQ2PH,The poll has been marred by widespread allegations of vote-rigging.,28,66,widespread allegations of vote-rigging,1,0,1
3DGDV62G7OACD5N6VQWD7R9PPYQ2PH,The poll has been marred by widespread allegations of vote-rigging.,39,50,allegations,5,8,13
3DGDV62G7OACD5N6VQWD7R9PPYQ2PH,The poll has been marred by widespread allegations of vote-rigging.,54,66,vote-rigging,4,10,14
3DGDV62G7OACD5N6VQWD7R9PPYQ2PH,"The allegations have fired up the opposition, which has long seen its protests crushed and its pleas ignored by the Kremlin-dominated media.",4,15,allegations,3,3,6
3DGDV62G7OACD5N6VQWD7R9PPYQ2PH,"The allegations have fired up the opposition, which has long seen its protests crushed and its pleas ignored by the Kremlin-dominated media.",34,44,opposition,4,0,4
3DGDV62G7OACD5N6VQWD7R9PPYQ2PH,"The allegations have fired up the opposition, which has long seen its protests crushed and its pleas ignored by the Kremlin-dominated media.",79,86,crushed,0,1,1
3DGDV62G7OACD5N6VQWD7R9PPYQ2PH,"The allegations have fired up the opposition, which has long seen its protests crushed and its pleas ignored by the Kremlin-dominated media.",95,100,pleas,1,7,8
3DGDV62G7OACD5N6VQWD7R9PPYQ2PH,"The allegations have fired up the opposition, which has long seen its protests crushed and its pleas ignored by the Kremlin-dominated media.",101,108,ignored,0,2,2
3DGDV62G7OACD5N6VQWD7R9PPYQ2PH,"The allegations have fired up the opposition, which has long seen its protests crushed and its pleas ignored by the Kremlin-dominated media.",116,133,Kremlin-dominated,2,0,2
3DGDV62G7OACD5N6VQWD7R9PPYQ2PH,"The allegations have fired up the opposition, which has long seen its protests crushed and its pleas ignored by the Kremlin-dominated media.",116,139,Kremlin-dominated media,3,1,4
3T6SSHJUZFBO74E47YRLLAFUR3PII2,"Let us honor the memory of the fallen, not only by keeping them in our daily thoughts but also by staying true to their commitment,"" Romney said.",7,12,honor,2,5,7
3T6SSHJUZFBO74E47YRLLAFUR3PII2,"Let us honor the memory of the fallen, not only by keeping them in our daily thoughts but also by staying true to their commitment,"" Romney said.",17,23,memory,1,1,2
3T6SSHJUZFBO74E47YRLLAFUR3PII2,"Let us honor the memory of the fallen, not only by keeping them in our daily thoughts but also by staying true to their commitment,"" Romney said.",27,37,the fallen,1,1,2
3T6SSHJUZFBO74E47YRLLAFUR3PII2,"Let us honor the memory of the fallen, not only by keeping them in our daily thoughts but also by staying true to their commitment,"" Romney said.",31,37,fallen,1,2,3
3T6SSHJUZFBO74E47YRLLAFUR3PII2,"Let us honor the memory of the fallen, not only by keeping them in our daily thoughts but also by staying true to their commitment,"" Romney said.",71,85,daily thoughts,1,0,1
3T6SSHJUZFBO74E47YRLLAFUR3PII2,"Let us honor the memory of the fallen, not only by keeping them in our daily thoughts but also by staying true to their commitment,"" Romney said.",120,130,commitment,8,10,18
3T6SSHJUZFBO74E47YRLLAFUR3PII2,"Before the trip, former President Bill Clinton touted Mr. Obama's bold decision to go after bin Laden in a campaign ad that also suggested Romney might not have made the same call.",17,23,former,0,1,1
3T6SSHJUZFBO74E47YRLLAFUR3PII2,"Before the trip, former President Bill Clinton touted Mr. Obama's bold decision to go after bin Laden in a campaign ad that also suggested Romney might not have made the same call.",47,53,touted,7,8,15
3T6SSHJUZFBO74E47YRLLAFUR3PII2,"Before the trip, former President Bill Clinton touted Mr. Obama's bold decision to go after bin Laden in a campaign ad that also suggested Romney might not have made the same call.",66,70,bold,1,0,1
3T6SSHJUZFBO74E47YRLLAFUR3PII2,"Before the trip, former President Bill Clinton touted Mr. Obama's bold decision to go after bin Laden in a campaign ad that also suggested Romney might not have made the same call.",71,79,decision,0,1,1
3T6SSHJUZFBO74E47YRLLAFUR3PII2,"Before the trip, former President Bill Clinton touted Mr. Obama's bold decision to go after bin Laden in a campaign ad that also suggested Romney might not have made the same call.",107,115,campaign,7,8,15
3T6SSHJUZFBO74E47YRLLAFUR3PII2,"Before the trip, former President Bill Clinton touted Mr. Obama's bold decision to go after bin Laden in a campaign ad that also suggested Romney might not have made the same call.",107,118,campaign ad,1,1,2
3T6SSHJUZFBO74E47YRLLAFUR3PII2,"Before the trip, former President Bill Clinton touted Mr. Obama's bold decision to go after bin Laden in a campaign ad that also suggested Romney might not have made the same call.",129,138,suggested,0,4,4
3T6SSHJUZFBO74E47YRLLAFUR3PII2,"Romney fired back Tuesday, appearing with former New York City Mayor Rudy Giuliani in front of a New York City firehouse and saying Obama should not be politicizing the issue.",7,17,fired back,2,3,5
3T6SSHJUZFBO74E47YRLLAFUR3PII2,"Romney fired back Tuesday, appearing with former New York City Mayor Rudy Giuliani in front of a New York City firehouse and saying Obama should not be politicizing the issue.",27,36,appearing,1,3,4
3T6SSHJUZFBO74E47YRLLAFUR3PII2,"Romney fired back Tuesday, appearing with former New York City Mayor Rudy Giuliani in front of a New York City firehouse and saying Obama should not be politicizing the issue.",111,120,firehouse,2,4,6
3T6SSHJUZFBO74E47YRLLAFUR3PII2,"Romney fired back Tuesday, appearing with former New York City Mayor Rudy Giuliani in front of a New York City firehouse and saying Obama should not be politicizing the issue.",152,164,politicizing,10,10,20
3T6SSHJUZFBO74E47YRLLAFUR3PII2,"Romney fired back Tuesday, appearing with former New York City Mayor Rudy Giuliani in front of a New York City firehouse and saying Obama should not be politicizing the issue.",152,174,politicizing the issue,1,0,1
3T6SSHJUZFBO74E47YRLLAFUR3PII2,"Romney fired back Tuesday, appearing with former New York City Mayor Rudy Giuliani in front of a New York City firehouse and saying Obama should not be politicizing the issue.",169,174,issue,1,1,2
3T6SSHJUZFBO74E47YRLLAFUR3PII2,"Military personnel watch on a screen as President Barack Obama makes a live address at Bagram Air Field, Afghanistan, Wednesday, May 2, 2012.",0,18,Military personnel,1,1,2
3T6SSHJUZFBO74E47YRLLAFUR3PII2,"Military personnel watch on a screen as President Barack Obama makes a live address at Bagram Air Field, Afghanistan, Wednesday, May 2, 2012.",9,18,personnel,2,0,2
3T6SSHJUZFBO74E47YRLLAFUR3PII2,"Military personnel watch on a screen as President Barack Obama makes a live address at Bagram Air Field, Afghanistan, Wednesday, May 2, 2012.",71,83,live address,2,0,2
3T6SSHJUZFBO74E47YRLLAFUR3PII2,"Military personnel watch on a screen as President Barack Obama makes a live address at Bagram Air Field, Afghanistan, Wednesday, May 2, 2012.",76,83,address,1,0,1
3T6SSHJUZFBO74E47YRLLAFUR3PII2,"Military personnel watch on a screen as President Barack Obama makes a live address at Bagram Air Field, Afghanistan, Wednesday, May 2, 2012.",87,93,Bagram,1,0,1
3T6SSHJUZFBO74E47YRLLAFUR3PII2,"Fierce clashes between Syrian government forces and opposition fighters have left at least 23 soldiers killed in the central Syrian city of Rastan, activists say.",0,6,Fierce,7,7,14
3T6SSHJUZFBO74E47YRLLAFUR3PII2,"Fierce clashes between Syrian government forces and opposition fighters have left at least 23 soldiers killed in the central Syrian city of Rastan, activists say.",0,14,Fierce clashes,0,3,3
3T6SSHJUZFBO74E47YRLLAFUR3PII2,"Fierce clashes between Syrian government forces and opposition fighters have left at least 23 soldiers killed in the central Syrian city of Rastan, activists say.",7,14,clashes,1,4,5
3T6SSHJUZFBO74E47YRLLAFUR3PII2,"Fierce clashes between Syrian government forces and opposition fighters have left at least 23 soldiers killed in the central Syrian city of Rastan, activists say.",30,40,government,1,0,1
3T6SSHJUZFBO74E47YRLLAFUR3PII2,"Fierce clashes between Syrian government forces and opposition fighters have left at least 23 soldiers killed in the central Syrian city of Rastan, activists say.",30,47,government forces,1,0,1
3T6SSHJUZFBO74E47YRLLAFUR3PII2,"Fierce clashes between Syrian government forces and opposition fighters have left at least 23 soldiers killed in the central Syrian city of Rastan, activists say.",52,62,opposition,3,1,4
3T6SSHJUZFBO74E47YRLLAFUR3PII2,"Fierce clashes between Syrian government forces and opposition fighters have left at least 23 soldiers killed in the central Syrian city of Rastan, activists say.",52,71,opposition fighters,1,0,1
3T6SSHJUZFBO74E47YRLLAFUR3PII2,"Fierce clashes between Syrian government forces and opposition fighters have left at least 23 soldiers killed in the central Syrian city of Rastan, activists say.",117,124,central,1,0,1
3T6SSHJUZFBO74E47YRLLAFUR3PII2,"Fierce clashes between Syrian government forces and opposition fighters have left at least 23 soldiers killed in the central Syrian city of Rastan, activists say.",148,157,activists,2,6,8
30Y6N4AHYPXKSS1157KJ8508MU0DRZ,"Earlier in the week, the Spanish government took a 45% stake in Bankia.",33,43,government,2,0,2
30Y6N4AHYPXKSS1157KJ8508MU0DRZ,"Earlier in the week, the Spanish government took a 45% stake in Bankia.",55,60,stake,4,10,14
30Y6N4AHYPXKSS1157KJ8508MU0DRZ,"Earlier in the week, the Spanish government took a 45% stake in Bankia.",64,70,Bankia,1,0,1
30Y6N4AHYPXKSS1157KJ8508MU0DRZ,It had already forced banks to make provisions of 54bn euros to cover bad loans.,15,21,forced,0,1,1
30Y6N4AHYPXKSS1157KJ8508MU0DRZ,It had already forced banks to make provisions of 54bn euros to cover bad loans.,15,46,forced banks to make provisions,1,0,1
30Y6N4AHYPXKSS1157KJ8508MU0DRZ,It had already forced banks to make provisions of 54bn euros to cover bad loans.,36,46,provisions,10,9,19
30Y6N4AHYPXKSS1157KJ8508MU0DRZ,It had already forced banks to make provisions of 54bn euros to cover bad loans.,55,60,euros,1,0,1
30Y6N4AHYPXKSS1157KJ8508MU0DRZ,It had already forced banks to make provisions of 54bn euros to cover bad loans.,70,79,bad loans,1,2,3
30Y6N4AHYPXKSS1157KJ8508MU0DRZ,It had already forced banks to make provisions of 54bn euros to cover bad loans.,74,79,loans,0,1,1
30Y6N4AHYPXKSS1157KJ8508MU0DRZ,"The big question is whether the Spanish state can afford on its own to put into these banks the sort of capital that is necessary or whether they will have to go for emergency help from the eurozone bailout fund or the IMF, said BBC business editor Robert Peston.",1,17,The big question,1,0,1
30Y6N4AHYPXKSS1157KJ8508MU0DRZ,"The big question is whether the Spanish state can afford on its own to put into these banks the sort of capital that is necessary or whether they will have to go for emergency help from the eurozone bailout fund or the IMF, said BBC business editor Robert Peston.",51,57,afford,2,3,5
30Y6N4AHYPXKSS1157KJ8508MU0DRZ,"The big question is whether the Spanish state can afford on its own to put into these banks the sort of capital that is necessary or whether they will have to go for emergency help from the eurozone bailout fund or the IMF, said BBC business editor Robert Peston.",97,112,sort of capital,1,0,1
30Y6N4AHYPXKSS1157KJ8508MU0DRZ,"The big question is whether the Spanish state can afford on its own to put into these banks the sort of capital that is necessary or whether they will have to go for emergency help from the eurozone bailout fund or the IMF, said BBC business editor Robert Peston.",105,112,capital,3,1,4
30Y6N4AHYPXKSS1157KJ8508MU0DRZ,"The big question is whether the Spanish state can afford on its own to put into these banks the sort of capital that is necessary or whether they will have to go for emergency help from the eurozone bailout fund or the IMF, said BBC business editor Robert Peston.",167,176,emergency,2,1,3
30Y6N4AHYPXKSS1157KJ8508MU0DRZ,"The big question is whether the Spanish state can afford on its own to put into these banks the sort of capital that is necessary or whether they will have to go for emergency help from the eurozone bailout fund or the IMF, said BBC business editor Robert Peston.",191,199,eurozone,3,1,4
30Y6N4AHYPXKSS1157KJ8508MU0DRZ,"The big question is whether the Spanish state can afford on its own to put into these banks the sort of capital that is necessary or whether they will have to go for emergency help from the eurozone bailout fund or the IMF, said BBC business editor Robert Peston.",191,207,eurozone bailout,1,0,1
30Y6N4AHYPXKSS1157KJ8508MU0DRZ,"The big question is whether the Spanish state can afford on its own to put into these banks the sort of capital that is necessary or whether they will have to go for emergency help from the eurozone bailout fund or the IMF, said BBC business editor Robert Peston.",191,212,eurozone bailout fund,4,0,4
30Y6N4AHYPXKSS1157KJ8508MU0DRZ,"The big question is whether the Spanish state can afford on its own to put into these banks the sort of capital that is necessary or whether they will have to go for emergency help from the eurozone bailout fund or the IMF, said BBC business editor Robert Peston.",200,207,bailout,6,8,14
30Y6N4AHYPXKSS1157KJ8508MU0DRZ,"The big question is whether the Spanish state can afford on its own to put into these banks the sort of capital that is necessary or whether they will have to go for emergency help from the eurozone bailout fund or the IMF, said BBC business editor Robert Peston.",200,212,bailout fund,1,5,6
30Y6N4AHYPXKSS1157KJ8508MU0DRZ,"The big question is whether the Spanish state can afford on its own to put into these banks the sort of capital that is necessary or whether they will have to go for emergency help from the eurozone bailout fund or the IMF, said BBC business editor Robert Peston.",220,223,IMF,1,0,1
30Y6N4AHYPXKSS1157KJ8508MU0DRZ,"The big question is whether the Spanish state can afford on its own to put into these banks the sort of capital that is necessary or whether they will have to go for emergency help from the eurozone bailout fund or the IMF, said BBC business editor Robert Peston.",244,250,editor,0,1,1
30Y6N4AHYPXKSS1157KJ8508MU0DRZ,"JPMorgan Chase, the biggest US bank, reveals a surprise trading loss of $2bn (£1.2bn) on complex investments made by its traders.",37,44,reveals,2,4,6
30Y6N4AHYPXKSS1157KJ8508MU0DRZ,"JPMorgan Chase, the biggest US bank, reveals a surprise trading loss of $2bn (£1.2bn) on complex investments made by its traders.",47,68,surprise trading loss,1,0,1
30Y6N4AHYPXKSS1157KJ8508MU0DRZ,"JPMorgan Chase, the biggest US bank, reveals a surprise trading loss of $2bn (£1.2bn) on complex investments made by its traders.",56,68,trading loss,1,1,2
30Y6N4AHYPXKSS1157KJ8508MU0DRZ,"JPMorgan Chase, the biggest US bank, reveals a surprise trading loss of $2bn (£1.2bn) on complex investments made by its traders.",89,96,complex,1,0,1
30Y6N4AHYPXKSS1157KJ8508MU0DRZ,"JPMorgan Chase, the biggest US bank, reveals a surprise trading loss of $2bn (£1.2bn) on complex investments made by its traders.",89,108,complex investments,8,3,11
30Y6N4AHYPXKSS1157KJ8508MU0DRZ,"JPMorgan Chase, the biggest US bank, reveals a surprise trading loss of $2bn (£1.2bn) on complex investments made by its traders.",97,108,investments,2,1,3
30Y6N4AHYPXKSS1157KJ8508MU0DRZ,"JPMorgan Chase, the biggest US bank, reveals a surprise trading loss of $2bn (£1.2bn) on complex investments made by its traders.",121,128,traders,1,1,2
30Y6N4AHYPXKSS1157KJ8508MU0DRZ,The Spanish government on Friday announced measures to protect the country's banks against the risks caused by loans going bad.,33,42,announced,0,2,2
30Y6N4AHYPXKSS1157KJ8508MU0DRZ,The Spanish government on Friday announced measures to protect the country's banks against the risks caused by loans going bad.,43,51,measures,1,3,4
30Y6N4AHYPXKSS1157KJ8508MU0DRZ,The Spanish government on Friday announced measures to protect the country's banks against the risks caused by loans going bad.,55,99,protect the countrys banks against the risks,1,0,1
30Y6N4AHYPXKSS1157KJ8508MU0DRZ,The Spanish government on Friday announced measures to protect the country's banks against the risks caused by loans going bad.,95,100,risks,2,1,3
30Y6N4AHYPXKSS1157KJ8508MU0DRZ,The Spanish government on Friday announced measures to protect the country's banks against the risks caused by loans going bad.,111,116,loans,0,1,1
30Y6N4AHYPXKSS1157KJ8508MU0DRZ,The Spanish government on Friday announced measures to protect the country's banks against the risks caused by loans going bad.,111,126,loans going bad,0,1,1
30Y6N4AHYPXKSS1157KJ8508MU0DRZ,"According to the new measures announced by vice prime minister Soraya Saenz de Santamaria and Economy Minister Luis de Guindos, Spain's banks will have to find an extra 30 billion euros (39 billion U.S. dollars) of capital.",17,29,new measures,1,1,2
30Y6N4AHYPXKSS1157KJ8508MU0DRZ,"According to the new measures announced by vice prime minister Soraya Saenz de Santamaria and Economy Minister Luis de Guindos, Spain's banks will have to find an extra 30 billion euros (39 billion U.S. dollars) of capital.",21,29,measures,1,2,3
30Y6N4AHYPXKSS1157KJ8508MU0DRZ,"According to the new measures announced by vice prime minister Soraya Saenz de Santamaria and Economy Minister Luis de Guindos, Spain's banks will have to find an extra 30 billion euros (39 billion U.S. dollars) of capital.",30,39,announced,1,0,1
30Y6N4AHYPXKSS1157KJ8508MU0DRZ,"According to the new measures announced by vice prime minister Soraya Saenz de Santamaria and Economy Minister Luis de Guindos, Spain's banks will have to find an extra 30 billion euros (39 billion U.S. dollars) of capital.",43,62,vice prime minister,1,0,1
30Y6N4AHYPXKSS1157KJ8508MU0DRZ,"According to the new measures announced by vice prime minister Soraya Saenz de Santamaria and Economy Minister Luis de Guindos, Spain's banks will have to find an extra 30 billion euros (39 billion U.S. dollars) of capital.",63,89,Soraya Saenz de Santamaria,1,0,1
30Y6N4AHYPXKSS1157KJ8508MU0DRZ,"According to the new measures announced by vice prime minister Soraya Saenz de Santamaria and Economy Minister Luis de Guindos, Spain's banks will have to find an extra 30 billion euros (39 billion U.S. dollars) of capital.",102,110,Minister,1,0,1
30Y6N4AHYPXKSS1157KJ8508MU0DRZ,"According to the new measures announced by vice prime minister Soraya Saenz de Santamaria and Economy Minister Luis de Guindos, Spain's banks will have to find an extra 30 billion euros (39 billion U.S. dollars) of capital.",111,126,Luis de Guindos,1,0,1
30Y6N4AHYPXKSS1157KJ8508MU0DRZ,"According to the new measures announced by vice prime minister Soraya Saenz de Santamaria and Economy Minister Luis de Guindos, Spain's banks will have to find an extra 30 billion euros (39 billion U.S. dollars) of capital.",215,222,capital,2,1,3
362E9TQF2HRABD89HARI0Y2ECQXGI8,"The move will provide an extra 30bn euros (24.1bn) financial cushion, taking total provisions against real estate assets to 137bn euros (110bn), worth 45% of the banks' portfolios.",51,68,financial cushion,6,6,12
362E9TQF2HRABD89HARI0Y2ECQXGI8,"The move will provide an extra 30bn euros (24.1bn) financial cushion, taking total provisions against real estate assets to 137bn euros (110bn), worth 45% of the banks' portfolios.",61,68,cushion,1,1,2
362E9TQF2HRABD89HARI0Y2ECQXGI8,"The move will provide an extra 30bn euros (24.1bn) financial cushion, taking total provisions against real estate assets to 137bn euros (110bn), worth 45% of the banks' portfolios.",77,93,total provisions,1,0,1
362E9TQF2HRABD89HARI0Y2ECQXGI8,"The move will provide an extra 30bn euros (24.1bn) financial cushion, taking total provisions against real estate assets to 137bn euros (110bn), worth 45% of the banks' portfolios.",83,93,provisions,6,3,9
362E9TQF2HRABD89HARI0Y2ECQXGI8,"The move will provide an extra 30bn euros (24.1bn) financial cushion, taking total provisions against real estate assets to 137bn euros (110bn), worth 45% of the banks' portfolios.",102,120,real estate assets,3,1,4
362E9TQF2HRABD89HARI0Y2ECQXGI8,"The move will provide an extra 30bn euros (24.1bn) financial cushion, taking total provisions against real estate assets to 137bn euros (110bn), worth 45% of the banks' portfolios.",114,120,assets,1,0,1
362E9TQF2HRABD89HARI0Y2ECQXGI8,"The move will provide an extra 30bn euros (24.1bn) financial cushion, taking total provisions against real estate assets to 137bn euros (110bn), worth 45% of the banks' portfolios.",169,179,portfolios,6,9,15
362E9TQF2HRABD89HARI0Y2ECQXGI8,Economy minister Luis de Guindos said public funds available for the banks would be less than 15bn euros (12bn) and would not have any effect on the country's deficit.,0,7,Economy,1,0,1
362E9TQF2HRABD89HARI0Y2ECQXGI8,Economy minister Luis de Guindos said public funds available for the banks would be less than 15bn euros (12bn) and would not have any effect on the country's deficit.,17,32,Luis de Guindos,1,0,1
362E9TQF2HRABD89HARI0Y2ECQXGI8,Economy minister Luis de Guindos said public funds available for the banks would be less than 15bn euros (12bn) and would not have any effect on the country's deficit.,38,50,public funds,1,0,1
362E9TQF2HRABD89HARI0Y2ECQXGI8,Economy minister Luis de Guindos said public funds available for the banks would be less than 15bn euros (12bn) and would not have any effect on the country's deficit.,159,166,deficit,10,10,20
362E9TQF2HRABD89HARI0Y2ECQXGI8,"Two independent auditing firms will be responsible for valuing banks' exposure to the nation's collapsed property sector, ministers told a news conference after a cabinet meeting.",4,30,independent auditing firms,1,0,1
362E9TQF2HRABD89HARI0Y2ECQXGI8,"Two independent auditing firms will be responsible for valuing banks' exposure to the nation's collapsed property sector, ministers told a news conference after a cabinet meeting.",16,24,auditing,5,5,10
362E9TQF2HRABD89HARI0Y2ECQXGI8,"Two independent auditing firms will be responsible for valuing banks' exposure to the nation's collapsed property sector, ministers told a news conference after a cabinet meeting.",16,30,auditing firms,3,1,4
362E9TQF2HRABD89HARI0Y2ECQXGI8,"Two independent auditing firms will be responsible for valuing banks' exposure to the nation's collapsed property sector, ministers told a news conference after a cabinet meeting.",55,62,valuing,3,0,3
362E9TQF2HRABD89HARI0Y2ECQXGI8,"Two independent auditing firms will be responsible for valuing banks' exposure to the nation's collapsed property sector, ministers told a news conference after a cabinet meeting.",70,78,exposure,3,5,8
362E9TQF2HRABD89HARI0Y2ECQXGI8,"Two independent auditing firms will be responsible for valuing banks' exposure to the nation's collapsed property sector, ministers told a news conference after a cabinet meeting.",95,104,collapsed,4,4,8
362E9TQF2HRABD89HARI0Y2ECQXGI8,"Two independent auditing firms will be responsible for valuing banks' exposure to the nation's collapsed property sector, ministers told a news conference after a cabinet meeting.",95,120,collapsed property sector,4,0,4
362E9TQF2HRABD89HARI0Y2ECQXGI8,"Two independent auditing firms will be responsible for valuing banks' exposure to the nation's collapsed property sector, ministers told a news conference after a cabinet meeting.",105,120,property sector,1,0,1
362E9TQF2HRABD89HARI0Y2ECQXGI8,"Two independent auditing firms will be responsible for valuing banks' exposure to the nation's collapsed property sector, ministers told a news conference after a cabinet meeting.",114,120,sector,1,0,1
362E9TQF2HRABD89HARI0Y2ECQXGI8,"Two independent auditing firms will be responsible for valuing banks' exposure to the nation's collapsed property sector, ministers told a news conference after a cabinet meeting.",122,131,ministers,1,0,1
362E9TQF2HRABD89HARI0Y2ECQXGI8,"Two independent auditing firms will be responsible for valuing banks' exposure to the nation's collapsed property sector, ministers told a news conference after a cabinet meeting.",144,154,conference,2,1,3
362E9TQF2HRABD89HARI0Y2ECQXGI8,"Two independent auditing firms will be responsible for valuing banks' exposure to the nation's collapsed property sector, ministers told a news conference after a cabinet meeting.",163,170,cabinet,1,1,2
362E9TQF2HRABD89HARI0Y2ECQXGI8,"Two independent auditing firms will be responsible for valuing banks' exposure to the nation's collapsed property sector, ministers told a news conference after a cabinet meeting.",163,178,cabinet meeting,3,0,3
362E9TQF2HRABD89HARI0Y2ECQXGI8,"Banks which are unable to raise the extra capital will have access to a five-year loan, via a convertible bond, from the state at an interest rate of 10%, they added.",36,49,extra capital,0,1,1
362E9TQF2HRABD89HARI0Y2ECQXGI8,"Banks which are unable to raise the extra capital will have access to a five-year loan, via a convertible bond, from the state at an interest rate of 10%, they added.",42,49,capital,2,0,2
362E9TQF2HRABD89HARI0Y2ECQXGI8,"Banks which are unable to raise the extra capital will have access to a five-year loan, via a convertible bond, from the state at an interest rate of 10%, they added.",60,66,access,1,2,3
362E9TQF2HRABD89HARI0Y2ECQXGI8,"Banks which are unable to raise the extra capital will have access to a five-year loan, via a convertible bond, from the state at an interest rate of 10%, they added.",72,86,five-year loan,0,1,1
362E9TQF2HRABD89HARI0Y2ECQXGI8,"Banks which are unable to raise the extra capital will have access to a five-year loan, via a convertible bond, from the state at an interest rate of 10%, they added.",92,110,a convertible bond,0,1,1
362E9TQF2HRABD89HARI0Y2ECQXGI8,"Banks which are unable to raise the extra capital will have access to a five-year loan, via a convertible bond, from the state at an interest rate of 10%, they added.",94,105,convertible,2,5,7
362E9TQF2HRABD89HARI0Y2ECQXGI8,"Banks which are unable to raise the extra capital will have access to a five-year loan, via a convertible bond, from the state at an interest rate of 10%, they added.",94,110,convertible bond,7,5,12
362E9TQF2HRABD89HARI0Y2ECQXGI8,"Banks which are unable to raise the extra capital will have access to a five-year loan, via a convertible bond, from the state at an interest rate of 10%, they added.",133,146,interest rate,1,0,1
362E9TQF2HRABD89HARI0Y2ECQXGI8,The country will also make its rental market more flexible in order to incentivise banks to offload their real estate assets.,31,44,rental market,0,1,1
362E9TQF2HRABD89HARI0Y2ECQXGI8,The country will also make its rental market more flexible in order to incentivise banks to offload their real estate assets.,50,58,flexible,1,2,3
362E9TQF2HRABD89HARI0Y2ECQXGI8,The country will also make its rental market more flexible in order to incentivise banks to offload their real estate assets.,71,82,incentivise,10,10,20
362E9TQF2HRABD89HARI0Y2ECQXGI8,The country will also make its rental market more flexible in order to incentivise banks to offload their real estate assets.,71,88,incentivise banks,1,0,1
362E9TQF2HRABD89HARI0Y2ECQXGI8,The country will also make its rental market more flexible in order to incentivise banks to offload their real estate assets.,71,99,incentivise banks to offload,0,1,1
362E9TQF2HRABD89HARI0Y2ECQXGI8,The country will also make its rental market more flexible in order to incentivise banks to offload their real estate assets.,92,99,offload,4,7,11
362E9TQF2HRABD89HARI0Y2ECQXGI8,The country will also make its rental market more flexible in order to incentivise banks to offload their real estate assets.,118,124,assets,1,1,2
3SCKNODZ0XHJWL8ZLN0GZTL20ZB7N6,Chinese antitrust and competition authorities have approved Google to acquire Motorolla.,0,17,Chinese antitrust,1,0,1
3SCKNODZ0XHJWL8ZLN0GZTL20ZB7N6,Chinese antitrust and competition authorities have approved Google to acquire Motorolla.,8,17,antitrust,8,9,17
3SCKNODZ0XHJWL8ZLN0GZTL20ZB7N6,Chinese antitrust and competition authorities have approved Google to acquire Motorolla.,8,33,antitrust and competition,1,0,1
3SCKNODZ0XHJWL8ZLN0GZTL20ZB7N6,Chinese antitrust and competition authorities have approved Google to acquire Motorolla.,8,45,antitrust and competition authorities,2,0,2
3SCKNODZ0XHJWL8ZLN0GZTL20ZB7N6,Chinese antitrust and competition authorities have approved Google to acquire Motorolla.,22,33,competition,1,4,5
3SCKNODZ0XHJWL8ZLN0GZTL20ZB7N6,Chinese antitrust and competition authorities have approved Google to acquire Motorolla.,22,45,competition authorities,3,0,3
3SCKNODZ0XHJWL8ZLN0GZTL20ZB7N6,Chinese antitrust and competition authorities have approved Google to acquire Motorolla.,34,45,authorities,0,2,2
3SCKNODZ0XHJWL8ZLN0GZTL20ZB7N6,Chinese antitrust and competition authorities have approved Google to acquire Motorolla.,70,77,acquire,5,6,11
3SCKNODZ0XHJWL8ZLN0GZTL20ZB7N6,"VentureBeat reports that according to The Wall Street Journal, Google's deal to purchase Motorola Mobility for $12.5 billion dollars will likely close next week.",0,19,VentureBeat reports,1,0,1
3SCKNODZ0XHJWL8ZLN0GZTL20ZB7N6,"VentureBeat reports that according to The Wall Street Journal, Google's deal to purchase Motorola Mobility for $12.5 billion dollars will likely close next week.",25,34,according,0,1,1
3SCKNODZ0XHJWL8ZLN0GZTL20ZB7N6,"VentureBeat reports that according to The Wall Street Journal, Google's deal to purchase Motorola Mobility for $12.5 billion dollars will likely close next week.",54,61,Journal,0,1,1
3SCKNODZ0XHJWL8ZLN0GZTL20ZB7N6,"VentureBeat reports that according to The Wall Street Journal, Google's deal to purchase Motorola Mobility for $12.5 billion dollars will likely close next week.",80,88,purchase,0,3,3
3SCKNODZ0XHJWL8ZLN0GZTL20ZB7N6,"VentureBeat reports that according to The Wall Street Journal, Google's deal to purchase Motorola Mobility for $12.5 billion dollars will likely close next week.",145,150,close,1,0,1
3SCKNODZ0XHJWL8ZLN0GZTL20ZB7N6,"The deal is said to give Google 17,000 patents and 6,800 pending patent applications owned by Motorola.",39,46,patents,5,3,8
3SCKNODZ0XHJWL8ZLN0GZTL20ZB7N6,"The deal is said to give Google 17,000 patents and 6,800 pending patent applications owned by Motorola.",57,64,pending,1,3,4
3SCKNODZ0XHJWL8ZLN0GZTL20ZB7N6,"The deal is said to give Google 17,000 patents and 6,800 pending patent applications owned by Motorola.",57,71,pending patent,2,0,2
3SCKNODZ0XHJWL8ZLN0GZTL20ZB7N6,"The deal is said to give Google 17,000 patents and 6,800 pending patent applications owned by Motorola.",57,84,pending patent applications,3,1,4
3SCKNODZ0XHJWL8ZLN0GZTL20ZB7N6,"The deal is said to give Google 17,000 patents and 6,800 pending patent applications owned by Motorola.",65,71,patent,3,1,4
3SCKNODZ0XHJWL8ZLN0GZTL20ZB7N6,"The deal is said to give Google 17,000 patents and 6,800 pending patent applications owned by Motorola.",65,84,patent applications,2,1,3
3SCKNODZ0XHJWL8ZLN0GZTL20ZB7N6,"The deal is said to give Google 17,000 patents and 6,800 pending patent applications owned by Motorola.",72,84,applications,1,1,2
3SCKNODZ0XHJWL8ZLN0GZTL20ZB7N6,"The deal is said to give Google 17,000 patents and 6,800 pending patent applications owned by Motorola.",85,90,owned,0,1,1
3SCKNODZ0XHJWL8ZLN0GZTL20ZB7N6,"China was the last regulatory hold-out to approve the merger, which was approved by the United States Department of Justice and European Union regulators in February.",14,38,last regulatory hold-out,1,0,1
3SCKNODZ0XHJWL8ZLN0GZTL20ZB7N6,"China was the last regulatory hold-out to approve the merger, which was approved by the United States Department of Justice and European Union regulators in February.",19,29,regulatory,6,3,9
3SCKNODZ0XHJWL8ZLN0GZTL20ZB7N6,"China was the last regulatory hold-out to approve the merger, which was approved by the United States Department of Justice and European Union regulators in February.",19,38,regulatory hold-out,4,1,5
3SCKNODZ0XHJWL8ZLN0GZTL20ZB7N6,"China was the last regulatory hold-out to approve the merger, which was approved by the United States Department of Justice and European Union regulators in February.",30,38,hold-out,2,4,6
3SCKNODZ0XHJWL8ZLN0GZTL20ZB7N6,"China was the last regulatory hold-out to approve the merger, which was approved by the United States Department of Justice and European Union regulators in February.",54,60,merger,8,6,14
3SCKNODZ0XHJWL8ZLN0GZTL20ZB7N6,"China was the last regulatory hold-out to approve the merger, which was approved by the United States Department of Justice and European Union regulators in February.",72,80,approved,0,1,1
3SCKNODZ0XHJWL8ZLN0GZTL20ZB7N6,"China was the last regulatory hold-out to approve the merger, which was approved by the United States Department of Justice and European Union regulators in February.",143,153,regulators,3,3,6
3SCKNODZ0XHJWL8ZLN0GZTL20ZB7N6,"Now that China has given the go-ahead, the deal can be finalized.",19,37,given the go-ahead,1,0,1
3SCKNODZ0XHJWL8ZLN0GZTL20ZB7N6,"Now that China has given the go-ahead, the deal can be finalized.",29,37,go-ahead,3,5,8
3SCKNODZ0XHJWL8ZLN0GZTL20ZB7N6,"Now that China has given the go-ahead, the deal can be finalized.",55,64,finalized,4,1,5
3SCKNODZ0XHJWL8ZLN0GZTL20ZB7N6,Antitrust issues were a major reason that regulatory boards had to mull over before approving the deal.,0,9,Antitrust,3,2,5
3SCKNODZ0XHJWL8ZLN0GZTL20ZB7N6,Antitrust issues were a major reason that regulatory boards had to mull over before approving the deal.,0,16,Antitrust issues,3,1,4
3SCKNODZ0XHJWL8ZLN0GZTL20ZB7N6,Antitrust issues were a major reason that regulatory boards had to mull over before approving the deal.,10,16,issues,0,1,1
3SCKNODZ0XHJWL8ZLN0GZTL20ZB7N6,Antitrust issues were a major reason that regulatory boards had to mull over before approving the deal.,42,52,regulatory,1,0,1
3SCKNODZ0XHJWL8ZLN0GZTL20ZB7N6,Antitrust issues were a major reason that regulatory boards had to mull over before approving the deal.,42,59,regulatory boards,3,2,5
3SCKNODZ0XHJWL8ZLN0GZTL20ZB7N6,Antitrust issues were a major reason that regulatory boards had to mull over before approving the deal.,53,59,boards,0,1,1
3SCKNODZ0XHJWL8ZLN0GZTL20ZB7N6,Antitrust issues were a major reason that regulatory boards had to mull over before approving the deal.,64,76,to mull over,0,1,1
3SCKNODZ0XHJWL8ZLN0GZTL20ZB7N6,Antitrust issues were a major reason that regulatory boards had to mull over before approving the deal.,67,71,mull,2,4,6
3SCKNODZ0XHJWL8ZLN0GZTL20ZB7N6,Antitrust issues were a major reason that regulatory boards had to mull over before approving the deal.,67,76,mull over,4,5,9
3SCKNODZ0XHJWL8ZLN0GZTL20ZB7N6,"Mainly, there were concerns that Motorola would be given preferential treatment for the Android operating system, which runs on Motorola devices.",19,27,concerns,0,1,1
3SCKNODZ0XHJWL8ZLN0GZTL20ZB7N6,"Mainly, there were concerns that Motorola would be given preferential treatment for the Android operating system, which runs on Motorola devices.",57,69,preferential,7,5,12
3SCKNODZ0XHJWL8ZLN0GZTL20ZB7N6,"Mainly, there were concerns that Motorola would be given preferential treatment for the Android operating system, which runs on Motorola devices.",57,79,preferential treatment,7,4,11
3SCKNODZ0XHJWL8ZLN0GZTL20ZB7N6,"Mainly, there were concerns that Motorola would be given preferential treatment for the Android operating system, which runs on Motorola devices.",70,79,treatment,1,0,1
3SCKNODZ0XHJWL8ZLN0GZTL20ZB7N6,"Mainly, there were concerns that Motorola would be given preferential treatment for the Android operating system, which runs on Motorola devices.",88,112,Android operating system,0,1,1
3SCKNODZ0XHJWL8ZLN0GZTL20ZB7N6,"Mainly, there were concerns that Motorola would be given preferential treatment for the Android operating system, which runs on Motorola devices.",96,105,operating,1,0,1
3SCKNODZ0XHJWL8ZLN0GZTL20ZB7N6,"Mainly, there were concerns that Motorola would be given preferential treatment for the Android operating system, which runs on Motorola devices.",96,112,operating system,3,0,3
3SCKNODZ0XHJWL8ZLN0GZTL20ZB7N6,"Mainly, there were concerns that Motorola would be given preferential treatment for the Android operating system, which runs on Motorola devices.",128,144,Motorola devices,0,1,1
3SCKNODZ0XHJWL8ZLN0GZTL20ZB7N6,"Mainly, there were concerns that Motorola would be given preferential treatment for the Android operating system, which runs on Motorola devices.",137,144,devices,0,1,1
338GLSUI43CTRRFAB2FEMF8PLM2SF7,"The next day, Thomas called to report that her son had kicked and punched her when she tried to wake him up for school.",66,73,punched,0,3,3
338GLSUI43CTRRFAB2FEMF8PLM2SF7,"The following day, child welfare investigators visited the house to look into allegations of inadequate supervision of the children.",19,46,child welfare investigators,4,1,5
338GLSUI43CTRRFAB2FEMF8PLM2SF7,"The following day, child welfare investigators visited the house to look into allegations of inadequate supervision of the children.",25,32,welfare,4,3,7
338GLSUI43CTRRFAB2FEMF8PLM2SF7,"The following day, child welfare investigators visited the house to look into allegations of inadequate supervision of the children.",25,46,welfare investigators,2,0,2
338GLSUI43CTRRFAB2FEMF8PLM2SF7,"The following day, child welfare investigators visited the house to look into allegations of inadequate supervision of the children.",33,46,investigators,2,3,5
338GLSUI43CTRRFAB2FEMF8PLM2SF7,"The following day, child welfare investigators visited the house to look into allegations of inadequate supervision of the children.",78,89,allegations,10,10,20
338GLSUI43CTRRFAB2FEMF8PLM2SF7,"The following day, child welfare investigators visited the house to look into allegations of inadequate supervision of the children.",78,115,allegations of inadequate supervision,2,0,2
338GLSUI43CTRRFAB2FEMF8PLM2SF7,"The following day, child welfare investigators visited the house to look into allegations of inadequate supervision of the children.",93,103,inadequate,5,8,13
338GLSUI43CTRRFAB2FEMF8PLM2SF7,"The following day, child welfare investigators visited the house to look into allegations of inadequate supervision of the children.",93,115,inadequate supervision,6,3,9
338GLSUI43CTRRFAB2FEMF8PLM2SF7,Records also showed that Thomas was arrested in 2002 on a misdemeanor battery charge for striking the father of her children.,58,69,misdemeanor,8,10,18
338GLSUI43CTRRFAB2FEMF8PLM2SF7,Records also showed that Thomas was arrested in 2002 on a misdemeanor battery charge for striking the father of her children.,58,84,misdemeanor battery charge,4,1,5
338GLSUI43CTRRFAB2FEMF8PLM2SF7,Records also showed that Thomas was arrested in 2002 on a misdemeanor battery charge for striking the father of her children.,70,77,battery,2,2,4
338GLSUI43CTRRFAB2FEMF8PLM2SF7,Records also showed that Thomas was arrested in 2002 on a misdemeanor battery charge for striking the father of her children.,70,84,battery charge,1,1,2
338GLSUI43CTRRFAB2FEMF8PLM2SF7,Records also showed that Thomas was arrested in 2002 on a misdemeanor battery charge for striking the father of her children.,89,97,striking,3,1,4
338GLSUI43CTRRFAB2FEMF8PLM2SF7,The charge was later dropped.,21,28,dropped,1,2,3
338GLSUI43CTRRFAB2FEMF8PLM2SF7,"Two years earlier, she filed a domestic violence complaint against Joe Johnson, but that was dismissed after a hearing.",23,28,filed,0,1,1
338GLSUI43CTRRFAB2FEMF8PLM2SF7,"Two years earlier, she filed a domestic violence complaint against Joe Johnson, but that was dismissed after a hearing.",31,39,domestic,1,0,1
338GLSUI43CTRRFAB2FEMF8PLM2SF7,"Two years earlier, she filed a domestic violence complaint against Joe Johnson, but that was dismissed after a hearing.",31,48,domestic violence,3,1,4
338GLSUI43CTRRFAB2FEMF8PLM2SF7,"Two years earlier, she filed a domestic violence complaint against Joe Johnson, but that was dismissed after a hearing.",31,58,domestic violence complaint,3,1,4
338GLSUI43CTRRFAB2FEMF8PLM2SF7,"Two years earlier, she filed a domestic violence complaint against Joe Johnson, but that was dismissed after a hearing.",40,48,violence,0,3,3
338GLSUI43CTRRFAB2FEMF8PLM2SF7,"Two years earlier, she filed a domestic violence complaint against Joe Johnson, but that was dismissed after a hearing.",49,58,complaint,4,3,7
338GLSUI43CTRRFAB2FEMF8PLM2SF7,"Two years earlier, she filed a domestic violence complaint against Joe Johnson, but that was dismissed after a hearing.",93,102,dismissed,8,2,10
338GLSUI43CTRRFAB2FEMF8PLM2SF7,"Two years earlier, she filed a domestic violence complaint against Joe Johnson, but that was dismissed after a hearing.",111,118,hearing,2,0,2
338GLSUI43CTRRFAB2FEMF8PLM2SF7,"Jamie Hudson, whose mother lives two doors down from the family, said the boys in the family were known to shoot BBs at a home across the street and had threatened to set it on fire.",113,116,BBs,2,2,4
338GLSUI43CTRRFAB2FEMF8PLM2SF7,"Jamie Hudson, whose mother lives two doors down from the family, said the boys in the family were known to shoot BBs at a home across the street and had threatened to set it on fire.",153,163,threatened,4,7,11
338GLSUI43CTRRFAB2FEMF8PLM2SF7,"Jamie Hudson, whose mother lives two doors down from the family, said the boys in the family were known to shoot BBs at a home across the street and had threatened to set it on fire.",167,181,set it on fire,0,1,1
3O0M2G5VC631OWMMIFJ4EG683V194V,It comes after the Bank of Spain effectively nationalized one of the nation's largest banks earlier this week.,33,44,effectively,0,1,1
3O0M2G5VC631OWMMIFJ4EG683V194V,It comes after the Bank of Spain effectively nationalized one of the nation's largest banks earlier this week.,33,57,effectively nationalized,1,0,1
3O0M2G5VC631OWMMIFJ4EG683V194V,It comes after the Bank of Spain effectively nationalized one of the nation's largest banks earlier this week.,45,57,nationalized,8,3,11
3O0M2G5VC631OWMMIFJ4EG683V194V,"Spanish banks have been struggling for years with the fallout from the nation's property bust, which saddled them with billions of euro worth of bad property loans.",24,34,struggling,0,4,4
3O0M2G5VC631OWMMIFJ4EG683V194V,"Spanish banks have been struggling for years with the fallout from the nation's property bust, which saddled them with billions of euro worth of bad property loans.",54,61,fallout,5,3,8
3O0M2G5VC631OWMMIFJ4EG683V194V,"Spanish banks have been struggling for years with the fallout from the nation's property bust, which saddled them with billions of euro worth of bad property loans.",71,92,nations property bust,1,0,1
3O0M2G5VC631OWMMIFJ4EG683V194V,"Spanish banks have been struggling for years with the fallout from the nation's property bust, which saddled them with billions of euro worth of bad property loans.",80,93,property bust,4,1,5
3O0M2G5VC631OWMMIFJ4EG683V194V,"Spanish banks have been struggling for years with the fallout from the nation's property bust, which saddled them with billions of euro worth of bad property loans.",89,93,bust,1,1,2
3O0M2G5VC631OWMMIFJ4EG683V194V,"Spanish banks have been struggling for years with the fallout from the nation's property bust, which saddled them with billions of euro worth of bad property loans.",101,108,saddled,6,4,10
3O0M2G5VC631OWMMIFJ4EG683V194V,"Spanish banks have been struggling for years with the fallout from the nation's property bust, which saddled them with billions of euro worth of bad property loans.",136,141,worth,0,1,1
3O0M2G5VC631OWMMIFJ4EG683V194V,"Spanish banks have been struggling for years with the fallout from the nation's property bust, which saddled them with billions of euro worth of bad property loans.",145,163,bad property loans,1,0,1
3O0M2G5VC631OWMMIFJ4EG683V194V,"Spanish banks have been struggling for years with the fallout from the nation's property bust, which saddled them with billions of euro worth of bad property loans.",149,163,property loans,1,0,1
3O0M2G5VC631OWMMIFJ4EG683V194V,"While the government has taken steps to support banks, analysts say more needs to be done to fix the problem once and for all.",55,63,analysts,10,4,14
3O0M2G5VC631OWMMIFJ4EG683V194V,11/05/2012 - 08:05:17 The Spanish government is expected to announce a new round of financial sector reforms later today.,34,44,government,1,0,1
3O0M2G5VC631OWMMIFJ4EG683V194V,11/05/2012 - 08:05:17 The Spanish government is expected to announce a new round of financial sector reforms later today.,48,56,expected,1,1,2
3O0M2G5VC631OWMMIFJ4EG683V194V,11/05/2012 - 08:05:17 The Spanish government is expected to announce a new round of financial sector reforms later today.,60,68,announce,0,1,1
3O0M2G5VC631OWMMIFJ4EG683V194V,11/05/2012 - 08:05:17 The Spanish government is expected to announce a new round of financial sector reforms later today.,84,93,financial,1,0,1
3O0M2G5VC631OWMMIFJ4EG683V194V,11/05/2012 - 08:05:17 The Spanish government is expected to announce a new round of financial sector reforms later today.,84,108,financial sector reforms,7,2,9
3O0M2G5VC631OWMMIFJ4EG683V194V,11/05/2012 - 08:05:17 The Spanish government is expected to announce a new round of financial sector reforms later today.,94,100,sector,4,0,4
3O0M2G5VC631OWMMIFJ4EG683V194V,11/05/2012 - 08:05:17 The Spanish government is expected to announce a new round of financial sector reforms later today.,94,108,sector reforms,0,1,1
3O0M2G5VC631OWMMIFJ4EG683V194V,11/05/2012 - 08:05:17 The Spanish government is expected to announce a new round of financial sector reforms later today.,101,108,reforms,1,4,5
3X4Q1O9UBHN1E68BM20TEIL7P8S7OU,"The trouble is, he is talking to audiences that have a very strong belief that the United States is going to abandon them, Biddle said in a phone interview.",5,12,trouble,0,2,2
3X4Q1O9UBHN1E68BM20TEIL7P8S7OU,"The trouble is, he is talking to audiences that have a very strong belief that the United States is going to abandon them, Biddle said in a phone interview.",34,43,audiences,6,2,8
3X4Q1O9UBHN1E68BM20TEIL7P8S7OU,"The trouble is, he is talking to audiences that have a very strong belief that the United States is going to abandon them, Biddle said in a phone interview.",68,74,belief,0,1,1
3X4Q1O9UBHN1E68BM20TEIL7P8S7OU,"The trouble is, he is talking to audiences that have a very strong belief that the United States is going to abandon them, Biddle said in a phone interview.",110,117,abandon,8,5,13
3X4Q1O9UBHN1E68BM20TEIL7P8S7OU,"The trouble is, he is talking to audiences that have a very strong belief that the United States is going to abandon them, Biddle said in a phone interview.",125,131,Biddle,0,1,1
3X4Q1O9UBHN1E68BM20TEIL7P8S7OU,"The trouble is, he is talking to audiences that have a very strong belief that the United States is going to abandon them, Biddle said in a phone interview.",148,157,interview,1,1,2
3X4Q1O9UBHN1E68BM20TEIL7P8S7OU,"The U.S. embassy, which neighbors the AFP bureau in Kabul, said its embassy was “under lockdown” and warned staff to “take cover, move away from the windows.”",9,16,embassy,3,1,4
3X4Q1O9UBHN1E68BM20TEIL7P8S7OU,"The U.S. embassy, which neighbors the AFP bureau in Kabul, said its embassy was “under lockdown” and warned staff to “take cover, move away from the windows.”",24,33,neighbors,0,2,2
3X4Q1O9UBHN1E68BM20TEIL7P8S7OU,"The U.S. embassy, which neighbors the AFP bureau in Kabul, said its embassy was “under lockdown” and warned staff to “take cover, move away from the windows.”",38,48,AFP bureau,1,0,1
3X4Q1O9UBHN1E68BM20TEIL7P8S7OU,"The U.S. embassy, which neighbors the AFP bureau in Kabul, said its embassy was “under lockdown” and warned staff to “take cover, move away from the windows.”",42,48,bureau,3,1,4
3X4Q1O9UBHN1E68BM20TEIL7P8S7OU,"The U.S. embassy, which neighbors the AFP bureau in Kabul, said its embassy was “under lockdown” and warned staff to “take cover, move away from the windows.”",68,75,embassy,3,0,3
3X4Q1O9UBHN1E68BM20TEIL7P8S7OU,"The U.S. embassy, which neighbors the AFP bureau in Kabul, said its embassy was “under lockdown” and warned staff to “take cover, move away from the windows.”",80,96,“under lockdown”,1,5,6
3X4Q1O9UBHN1E68BM20TEIL7P8S7OU,"The U.S. embassy, which neighbors the AFP bureau in Kabul, said its embassy was “under lockdown” and warned staff to “take cover, move away from the windows.”",87,96,lockdown”,1,1,2
3X4Q1O9UBHN1E68BM20TEIL7P8S7OU,"The U.S. embassy, which neighbors the AFP bureau in Kabul, said its embassy was “under lockdown” and warned staff to “take cover, move away from the windows.”",101,107,warned,1,1,2
3X4Q1O9UBHN1E68BM20TEIL7P8S7OU,"The U.S. embassy, which neighbors the AFP bureau in Kabul, said its embassy was “under lockdown” and warned staff to “take cover, move away from the windows.”",117,128,“take cover,1,0,1
3X4Q1O9UBHN1E68BM20TEIL7P8S7OU,"Obama earlier dropped from night skies into Kabul on a brief visit amid secrecy and tight security and signed a deal with President Hamid Karzai, cementing 10 years of U.S. aid for Afghanistan after NATO combat troops leave in 2014.",14,21,dropped,0,3,3
3X4Q1O9UBHN1E68BM20TEIL7P8S7OU,"Obama earlier dropped from night skies into Kabul on a brief visit amid secrecy and tight security and signed a deal with President Hamid Karzai, cementing 10 years of U.S. aid for Afghanistan after NATO combat troops leave in 2014.",27,38,night skies,0,3,3
3X4Q1O9UBHN1E68BM20TEIL7P8S7OU,"Obama earlier dropped from night skies into Kabul on a brief visit amid secrecy and tight security and signed a deal with President Hamid Karzai, cementing 10 years of U.S. aid for Afghanistan after NATO combat troops leave in 2014.",67,71,amid,5,7,12
3X4Q1O9UBHN1E68BM20TEIL7P8S7OU,"Obama earlier dropped from night skies into Kabul on a brief visit amid secrecy and tight security and signed a deal with President Hamid Karzai, cementing 10 years of U.S. aid for Afghanistan after NATO combat troops leave in 2014.",67,79,amid secrecy,3,3,6
3X4Q1O9UBHN1E68BM20TEIL7P8S7OU,"Obama earlier dropped from night skies into Kabul on a brief visit amid secrecy and tight security and signed a deal with President Hamid Karzai, cementing 10 years of U.S. aid for Afghanistan after NATO combat troops leave in 2014.",72,79,secrecy,2,2,4
3X4Q1O9UBHN1E68BM20TEIL7P8S7OU,"Obama earlier dropped from night skies into Kabul on a brief visit amid secrecy and tight security and signed a deal with President Hamid Karzai, cementing 10 years of U.S. aid for Afghanistan after NATO combat troops leave in 2014.",112,116,deal,0,1,1
3X4Q1O9UBHN1E68BM20TEIL7P8S7OU,"Obama earlier dropped from night skies into Kabul on a brief visit amid secrecy and tight security and signed a deal with President Hamid Karzai, cementing 10 years of U.S. aid for Afghanistan after NATO combat troops leave in 2014.",146,155,cementing,8,7,15
3X4Q1O9UBHN1E68BM20TEIL7P8S7OU,"Obama earlier dropped from night skies into Kabul on a brief visit amid secrecy and tight security and signed a deal with President Hamid Karzai, cementing 10 years of U.S. aid for Afghanistan after NATO combat troops leave in 2014.",204,210,combat,2,3,5
3X4Q1O9UBHN1E68BM20TEIL7P8S7OU,"The attack was a reminder of the extremist threat that stalks Afghanistan, with the Taliban resurgent a decade after they were driven from power for refusing to hand over Bin Laden following the 9/11 attacks.",33,42,extremist,5,5,10
3X4Q1O9UBHN1E68BM20TEIL7P8S7OU,"The attack was a reminder of the extremist threat that stalks Afghanistan, with the Taliban resurgent a decade after they were driven from power for refusing to hand over Bin Laden following the 9/11 attacks.",33,49,extremist threat,2,1,3
3X4Q1O9UBHN1E68BM20TEIL7P8S7OU,"The attack was a reminder of the extremist threat that stalks Afghanistan, with the Taliban resurgent a decade after they were driven from power for refusing to hand over Bin Laden following the 9/11 attacks.",55,61,stalks,4,7,11
3X4Q1O9UBHN1E68BM20TEIL7P8S7OU,"The attack was a reminder of the extremist threat that stalks Afghanistan, with the Taliban resurgent a decade after they were driven from power for refusing to hand over Bin Laden following the 9/11 attacks.",92,101,resurgent,10,10,20
3X4Q1O9UBHN1E68BM20TEIL7P8S7OU,"The attack was a reminder of the extremist threat that stalks Afghanistan, with the Taliban resurgent a decade after they were driven from power for refusing to hand over Bin Laden following the 9/11 attacks.",104,110,decade,0,2,2
3X4Q1O9UBHN1E68BM20TEIL7P8S7OU,"The attack was a reminder of the extremist threat that stalks Afghanistan, with the Taliban resurgent a decade after they were driven from power for refusing to hand over Bin Laden following the 9/11 attacks.",127,133,driven,1,0,1
3X4Q1O9UBHN1E68BM20TEIL7P8S7OU,"The attack was a reminder of the extremist threat that stalks Afghanistan, with the Taliban resurgent a decade after they were driven from power for refusing to hand over Bin Laden following the 9/11 attacks.",149,157,refusing,1,1,2
3G5RUKN2EC4NA4WS0KY0DPC8VPZN9Y,A 26-year-old man is still being questioned by police on suspicion of murder.,33,43,questioned,1,1,2
3G5RUKN2EC4NA4WS0KY0DPC8VPZN9Y,A 26-year-old man is still being questioned by police on suspicion of murder.,57,66,suspicion,10,10,20
3G5RUKN2EC4NA4WS0KY0DPC8VPZN9Y,A 26-year-old man is still being questioned by police on suspicion of murder.,57,76,suspicion of murder,0,1,1
3G5RUKN2EC4NA4WS0KY0DPC8VPZN9Y,"A man and woman, both aged 28, arrested on suspicion of assisting an offender were released, without charge, on Saturday evening.",31,39,arrested,1,1,2
3G5RUKN2EC4NA4WS0KY0DPC8VPZN9Y,"A man and woman, both aged 28, arrested on suspicion of assisting an offender were released, without charge, on Saturday evening.",43,52,suspicion,2,1,3
3G5RUKN2EC4NA4WS0KY0DPC8VPZN9Y,"A man and woman, both aged 28, arrested on suspicion of assisting an offender were released, without charge, on Saturday evening.",43,77,suspicion of assisting an offender,1,0,1
3G5RUKN2EC4NA4WS0KY0DPC8VPZN9Y,"A man and woman, both aged 28, arrested on suspicion of assisting an offender were released, without charge, on Saturday evening.",56,65,assisting,3,3,6
3G5RUKN2EC4NA4WS0KY0DPC8VPZN9Y,"A man and woman, both aged 28, arrested on suspicion of assisting an offender were released, without charge, on Saturday evening.",56,77,assisting an offender,1,0,1
3G5RUKN2EC4NA4WS0KY0DPC8VPZN9Y,"A man and woman, both aged 28, arrested on suspicion of assisting an offender were released, without charge, on Saturday evening.",69,77,offender,2,9,11
3G5RUKN2EC4NA4WS0KY0DPC8VPZN9Y,"A man and woman, both aged 28, arrested on suspicion of assisting an offender were released, without charge, on Saturday evening.",83,91,released,1,2,3
3G5RUKN2EC4NA4WS0KY0DPC8VPZN9Y,"A man and woman, both aged 28, arrested on suspicion of assisting an offender were released, without charge, on Saturday evening.",93,107,without charge,2,0,2
3G5RUKN2EC4NA4WS0KY0DPC8VPZN9Y,"A man and woman, both aged 28, arrested on suspicion of assisting an offender were released, without charge, on Saturday evening.",101,107,charge,1,2,3
3G5RUKN2EC4NA4WS0KY0DPC8VPZN9Y,They were all arrested in the Toome area within an hour on the shooting.,30,35,Toome,1,2,3
3G5RUKN2EC4NA4WS0KY0DPC8VPZN9Y,They were all arrested in the Toome area within an hour on the shooting.,63,71,shooting,0,1,1
3G5RUKN2EC4NA4WS0KY0DPC8VPZN9Y,Deputy First Minister Martin McGuinness has visited the victims' family and said they are in deep shock.,0,6,Deputy,0,1,1
3G5RUKN2EC4NA4WS0KY0DPC8VPZN9Y,Deputy First Minister Martin McGuinness has visited the victims' family and said they are in deep shock.,0,21,Deputy First Minister,1,0,1
3G5RUKN2EC4NA4WS0KY0DPC8VPZN9Y,Deputy First Minister Martin McGuinness has visited the victims' family and said they are in deep shock.,29,39,McGuinness,0,1,1
3G5RUKN2EC4NA4WS0KY0DPC8VPZN9Y,Deputy First Minister Martin McGuinness has visited the victims' family and said they are in deep shock.,44,51,visited,0,1,1
3G5RUKN2EC4NA4WS0KY0DPC8VPZN9Y,Deputy First Minister Martin McGuinness has visited the victims' family and said they are in deep shock.,56,63,victims,1,5,6
3G5RUKN2EC4NA4WS0KY0DPC8VPZN9Y,Deputy First Minister Martin McGuinness has visited the victims' family and said they are in deep shock.,93,103,deep shock,3,0,3
3G5RUKN2EC4NA4WS0KY0DPC8VPZN9Y,Deputy First Minister Martin McGuinness has visited the victims' family and said they are in deep shock.,98,103,shock,0,1,1
3G5RUKN2EC4NA4WS0KY0DPC8VPZN9Y,"He said: ""This family is clearly deeply shocked and traumatised by what has happened over the weekend.",25,39,clearly deeply,0,1,1
3G5RUKN2EC4NA4WS0KY0DPC8VPZN9Y,"He said: ""This family is clearly deeply shocked and traumatised by what has happened over the weekend.",52,63,traumatised,10,10,20
3G5RUKN2EC4NA4WS0KY0DPC8VPZN9Y,"Their daughter has been murdered and another daughter seriously injured.	25	33	murdered	1	1	2
3G5RUKN2EC4NA4WS0KY0DPC8VPZN9Y	Their daughter has been murdered and another daughter seriously injured.",55,72,seriously injured,0,1,1
3G5RUKN2EC4NA4WS0KY0DPC8VPZN9Y,"Their daughter has been murdered and another daughter seriously injured.	65	72	injured	0	1	1
3G5RUKN2EC4NA4WS0KY0DPC8VPZN9Y	I spent some time with the family and offered our support and that of the wider community at this time.",74,89,wider community,2,4,6
3G5RUKN2EC4NA4WS0KY0DPC8VPZN9Y,"I spent some time with the family and offered our support and that of the wider community at this time.""",80,89,community,1,0,1
3G5RUKN2EC4NA4WS0KY0DPC8VPZN9Y,SDLP Mid-Ulster MLA Patsy McGlone has said there is an overwhelming sense of shock in the county over the shooting.,0,15,SDLP Mid-Ulster,0,1,1
3G5RUKN2EC4NA4WS0KY0DPC8VPZN9Y,SDLP Mid-Ulster MLA Patsy McGlone has said there is an overwhelming sense of shock in the county over the shooting.,55,67,overwhelming,10,10,20
3G5RUKN2EC4NA4WS0KY0DPC8VPZN9Y,SDLP Mid-Ulster MLA Patsy McGlone has said there is an overwhelming sense of shock in the county over the shooting.,55,82,overwhelming sense of shock,1,0,1
3UV0D2KX1MKAP6DZL1JWOCSJ76ZF4N,"Israel's ambassador to Egypt, Yitzhak Levanon, returned to Cairo on Sunday after he was evacuated in September following an attack on the embassy, an airport official told AFP.",9,19,ambassador,6,2,8
3UV0D2KX1MKAP6DZL1JWOCSJ76ZF4N,"Israel's ambassador to Egypt, Yitzhak Levanon, returned to Cairo on Sunday after he was evacuated in September following an attack on the embassy, an airport official told AFP.",88,97,evacuated,10,10,20
3UV0D2KX1MKAP6DZL1JWOCSJ76ZF4N,"Israel's ambassador to Egypt, Yitzhak Levanon, returned to Cairo on Sunday after he was evacuated in September following an attack on the embassy, an airport official told AFP.",138,145,embassy,5,2,7
3UV0D2KX1MKAP6DZL1JWOCSJ76ZF4N,"Israel's ambassador to Egypt, Yitzhak Levanon, returned to Cairo on Sunday after he was evacuated in September following an attack on the embassy, an airport official told AFP.",172,175,AFP,1,0,1
3UV0D2KX1MKAP6DZL1JWOCSJ76ZF4N,"Levanon arrived in the early hours of Sunday on a Turkish Airlines flight from Istanbul, the official said.",9,16,arrived,0,1,1
3UV0D2KX1MKAP6DZL1JWOCSJ76ZF4N,"The ambassador's arrival had not been announced and he flew in in complete secrecy, the official said.",5,16,ambassadors,1,0,1
3UV0D2KX1MKAP6DZL1JWOCSJ76ZF4N,"The ambassador's arrival had not been announced and he flew in in complete secrecy, the official said.",39,48,announced,0,2,2
3UV0D2KX1MKAP6DZL1JWOCSJ76ZF4N,"The ambassador's arrival had not been announced and he flew in in complete secrecy, the official said.",56,60,flew,0,1,1
3UV0D2KX1MKAP6DZL1JWOCSJ76ZF4N,"The ambassador's arrival had not been announced and he flew in in complete secrecy, the official said.",56,63,flew in,0,1,1
3UV0D2KX1MKAP6DZL1JWOCSJ76ZF4N,"The ambassador's arrival had not been announced and he flew in in complete secrecy, the official said.",67,83,complete secrecy,3,2,5
3UV0D2KX1MKAP6DZL1JWOCSJ76ZF4N,"The ambassador's arrival had not been announced and he flew in in complete secrecy, the official said.",76,83,secrecy,8,3,11
3UV0D2KX1MKAP6DZL1JWOCSJ76ZF4N,"On September 9, protesters attacked the Israeli embassy headquarters in a residential building in central Cairo, forcing the evacuation of all embassy staff.",16,26,protesters,2,6,8
3UV0D2KX1MKAP6DZL1JWOCSJ76ZF4N,"On September 9, protesters attacked the Israeli embassy headquarters in a residential building in central Cairo, forcing the evacuation of all embassy staff.",48,55,embassy,0,2,2
3UV0D2KX1MKAP6DZL1JWOCSJ76ZF4N,"On September 9, protesters attacked the Israeli embassy headquarters in a residential building in central Cairo, forcing the evacuation of all embassy staff.",48,68,embassy headquarters,1,0,1
3UV0D2KX1MKAP6DZL1JWOCSJ76ZF4N,"On September 9, protesters attacked the Israeli embassy headquarters in a residential building in central Cairo, forcing the evacuation of all embassy staff.",56,68,headquarters,1,2,3
3UV0D2KX1MKAP6DZL1JWOCSJ76ZF4N,"On September 9, protesters attacked the Israeli embassy headquarters in a residential building in central Cairo, forcing the evacuation of all embassy staff.",74,85,residential,1,1,2
3UV0D2KX1MKAP6DZL1JWOCSJ76ZF4N,"On September 9, protesters attacked the Israeli embassy headquarters in a residential building in central Cairo, forcing the evacuation of all embassy staff.",74,94,residential building,0,1,1
3UV0D2KX1MKAP6DZL1JWOCSJ76ZF4N,"On September 9, protesters attacked the Israeli embassy headquarters in a residential building in central Cairo, forcing the evacuation of all embassy staff.",113,120,forcing,1,1,2
3UV0D2KX1MKAP6DZL1JWOCSJ76ZF4N,"On September 9, protesters attacked the Israeli embassy headquarters in a residential building in central Cairo, forcing the evacuation of all embassy staff.",113,135,forcing the evacuation,0,1,1
3UV0D2KX1MKAP6DZL1JWOCSJ76ZF4N,"On September 9, protesters attacked the Israeli embassy headquarters in a residential building in central Cairo, forcing the evacuation of all embassy staff.",125,135,evacuation,8,5,13
3UV0D2KX1MKAP6DZL1JWOCSJ76ZF4N,"On September 9, protesters attacked the Israeli embassy headquarters in a residential building in central Cairo, forcing the evacuation of all embassy staff.",143,150,embassy,1,2,3
3UV0D2KX1MKAP6DZL1JWOCSJ76ZF4N,"On September 9, protesters attacked the Israeli embassy headquarters in a residential building in central Cairo, forcing the evacuation of all embassy staff.",143,156,embassy staff,1,0,1
3UV0D2KX1MKAP6DZL1JWOCSJ76ZF4N,"On September 9, protesters attacked the Israeli embassy headquarters in a residential building in central Cairo, forcing the evacuation of all embassy staff.",151,156,staff,0,2,2
3UV0D2KX1MKAP6DZL1JWOCSJ76ZF4N,"Crowds had smashed through an external security wall, tossed embassy papers from balconies and tore down the Israeli flag.",0,6,Crowds,0,2,2
3UV0D2KX1MKAP6DZL1JWOCSJ76ZF4N,"Crowds had smashed through an external security wall, tossed embassy papers from balconies and tore down the Israeli flag.",11,18,smashed,2,2,4
3UV0D2KX1MKAP6DZL1JWOCSJ76ZF4N,"Crowds had smashed through an external security wall, tossed embassy papers from balconies and tore down the Israeli flag.",11,26,smashed through,0,2,2
3UV0D2KX1MKAP6DZL1JWOCSJ76ZF4N,"Crowds had smashed through an external security wall, tossed embassy papers from balconies and tore down the Israeli flag.",30,38,external,2,1,3
3UV0D2KX1MKAP6DZL1JWOCSJ76ZF4N,"Crowds had smashed through an external security wall, tossed embassy papers from balconies and tore down the Israeli flag.",30,47,external security,1,0,1
3UV0D2KX1MKAP6DZL1JWOCSJ76ZF4N,"Crowds had smashed through an external security wall, tossed embassy papers from balconies and tore down the Israeli flag.",30,52,external security wall,3,0,3
3UV0D2KX1MKAP6DZL1JWOCSJ76ZF4N,"Crowds had smashed through an external security wall, tossed embassy papers from balconies and tore down the Israeli flag.",39,52,security wall,1,0,1
3UV0D2KX1MKAP6DZL1JWOCSJ76ZF4N,"Crowds had smashed through an external security wall, tossed embassy papers from balconies and tore down the Israeli flag.",54,60,tossed,1,8,9
3UV0D2KX1MKAP6DZL1JWOCSJ76ZF4N,"Crowds had smashed through an external security wall, tossed embassy papers from balconies and tore down the Israeli flag.",54,68,tossed embassy,0,1,1
3UV0D2KX1MKAP6DZL1JWOCSJ76ZF4N,"Crowds had smashed through an external security wall, tossed embassy papers from balconies and tore down the Israeli flag.",61,68,embassy,2,0,2
3UV0D2KX1MKAP6DZL1JWOCSJ76ZF4N,"Crowds had smashed through an external security wall, tossed embassy papers from balconies and tore down the Israeli flag.",61,75,embassy papers,1,0,1
3UV0D2KX1MKAP6DZL1JWOCSJ76ZF4N,"Crowds had smashed through an external security wall, tossed embassy papers from balconies and tore down the Israeli flag.",81,90,balconies,3,1,4
3UV0D2KX1MKAP6DZL1JWOCSJ76ZF4N,"Crowds had smashed through an external security wall, tossed embassy papers from balconies and tore down the Israeli flag.",95,99,tore,0,1,1
3UV0D2KX1MKAP6DZL1JWOCSJ76ZF4N,"Crowds had smashed through an external security wall, tossed embassy papers from balconies and tore down the Israeli flag.",95,104,tore down,0,2,2
3UV0D2KX1MKAP6DZL1JWOCSJ76ZF4N,"It was the worst incident since Israel set up its mission in Egypt, the first Arab country to sign a peace treaty with the Jewish state in 1979.",11,16,worst,1,0,1
3UV0D2KX1MKAP6DZL1JWOCSJ76ZF4N,"It was the worst incident since Israel set up its mission in Egypt, the first Arab country to sign a peace treaty with the Jewish state in 1979.",11,25,worst incident,0,2,2
3UV0D2KX1MKAP6DZL1JWOCSJ76ZF4N,"It was the worst incident since Israel set up its mission in Egypt, the first Arab country to sign a peace treaty with the Jewish state in 1979.",17,25,incident,2,2,4
3UV0D2KX1MKAP6DZL1JWOCSJ76ZF4N,"It was the worst incident since Israel set up its mission in Egypt, the first Arab country to sign a peace treaty with the Jewish state in 1979.",50,57,mission,0,1,1
3UV0D2KX1MKAP6DZL1JWOCSJ76ZF4N,"It was the worst incident since Israel set up its mission in Egypt, the first Arab country to sign a peace treaty with the Jewish state in 1979.",101,113,peace treaty,4,4,8
3UV0D2KX1MKAP6DZL1JWOCSJ76ZF4N,"It was the worst incident since Israel set up its mission in Egypt, the first Arab country to sign a peace treaty with the Jewish state in 1979.",107,113,treaty,2,2,4
311HQEI8RSHDDAMIOBBAUGSBADJ7ZN,"More and more people are starting to believe that the election results are not fair, he told Interfax.",38,45,believe,0,1,1
311HQEI8RSHDDAMIOBBAUGSBADJ7ZN,"More and more people are starting to believe that the election results are not fair, he told Interfax.",55,63,election,1,0,1
311HQEI8RSHDDAMIOBBAUGSBADJ7ZN,"More and more people are starting to believe that the election results are not fair, he told Interfax.",80,84,fair,1,0,1
311HQEI8RSHDDAMIOBBAUGSBADJ7ZN,"More and more people are starting to believe that the election results are not fair, he told Interfax.",95,103,Interfax,0,1,1
311HQEI8RSHDDAMIOBBAUGSBADJ7ZN,I believe that ignoring public opinion discredits the authorities and destabilizes the situation.,16,24,ignoring,1,2,3
311HQEI8RSHDDAMIOBBAUGSBADJ7ZN,I believe that ignoring public opinion discredits the authorities and destabilizes the situation.,25,39,public opinion,1,0,1
311HQEI8RSHDDAMIOBBAUGSBADJ7ZN,I believe that ignoring public opinion discredits the authorities and destabilizes the situation.,32,39,opinion,0,1,1
311HQEI8RSHDDAMIOBBAUGSBADJ7ZN,I believe that ignoring public opinion discredits the authorities and destabilizes the situation.,40,50,discredits,10,10,20
311HQEI8RSHDDAMIOBBAUGSBADJ7ZN,I believe that ignoring public opinion discredits the authorities and destabilizes the situation.,55,66,authorities,3,2,5
311HQEI8RSHDDAMIOBBAUGSBADJ7ZN,I believe that ignoring public opinion discredits the authorities and destabilizes the situation.,71,83,destabilizes,10,10,20
311HQEI8RSHDDAMIOBBAUGSBADJ7ZN,I believe that ignoring public opinion discredits the authorities and destabilizes the situation.,71,97,destabilizes the situation,1,0,1
311HQEI8RSHDDAMIOBBAUGSBADJ7ZN,"Gorbachev added that authorities ""must admit that there have been numerous falsifications and ballot stuffing.""",66,74,numerous,0,1,1
311HQEI8RSHDDAMIOBBAUGSBADJ7ZN,"Gorbachev added that authorities ""must admit that there have been numerous falsifications and ballot stuffing.""",66,89,numerous falsifications,3,2,5
311HQEI8RSHDDAMIOBBAUGSBADJ7ZN,"Gorbachev added that authorities ""must admit that there have been numerous falsifications and ballot stuffing.""",66,109,numerous falsifications and ballot stuffing,1,0,1
311HQEI8RSHDDAMIOBBAUGSBADJ7ZN,"Gorbachev added that authorities ""must admit that there have been numerous falsifications and ballot stuffing.""",75,89,falsifications,10,9,19
311HQEI8RSHDDAMIOBBAUGSBADJ7ZN,"Gorbachev added that authorities ""must admit that there have been numerous falsifications and ballot stuffing.""",94,100,ballot,2,1,3
311HQEI8RSHDDAMIOBBAUGSBADJ7ZN,"Gorbachev added that authorities ""must admit that there have been numerous falsifications and ballot stuffing.""",94,109,ballot stuffing,7,8,15
311HQEI8RSHDDAMIOBBAUGSBADJ7ZN,"Gorbachev added that authorities ""must admit that there have been numerous falsifications and ballot stuffing.""",101,109,stuffing,0,4,4
311HQEI8RSHDDAMIOBBAUGSBADJ7ZN,"Sunday's parliamentary vote suggested Russians are tiring of Putin and his United Russia party, which has dominated all other political forces in Russia for the past dozen years and earned a reputation for corruption.",9,22,parliamentary,6,3,9
311HQEI8RSHDDAMIOBBAUGSBADJ7ZN,"Sunday's parliamentary vote suggested Russians are tiring of Putin and his United Russia party, which has dominated all other political forces in Russia for the past dozen years and earned a reputation for corruption.",9,27,parliamentary vote,1,0,1
311HQEI8RSHDDAMIOBBAUGSBADJ7ZN,"Sunday's parliamentary vote suggested Russians are tiring of Putin and his United Russia party, which has dominated all other political forces in Russia for the past dozen years and earned a reputation for corruption.",51,57,tiring,1,1,2
311HQEI8RSHDDAMIOBBAUGSBADJ7ZN,"Sunday's parliamentary vote suggested Russians are tiring of Putin and his United Russia party, which has dominated all other political forces in Russia for the past dozen years and earned a reputation for corruption.",106,115,dominated,8,5,13
311HQEI8RSHDDAMIOBBAUGSBADJ7ZN,"Sunday's parliamentary vote suggested Russians are tiring of Putin and his United Russia party, which has dominated all other political forces in Russia for the past dozen years and earned a reputation for corruption.",126,142,political forces,1,0,1
311HQEI8RSHDDAMIOBBAUGSBADJ7ZN,"Sunday's parliamentary vote suggested Russians are tiring of Putin and his United Russia party, which has dominated all other political forces in Russia for the past dozen years and earned a reputation for corruption.",191,201,reputation,6,4,10
311HQEI8RSHDDAMIOBBAUGSBADJ7ZN,"Sunday's parliamentary vote suggested Russians are tiring of Putin and his United Russia party, which has dominated all other political forces in Russia for the past dozen years and earned a reputation for corruption.",191,216,reputation for corruption,1,1,2
311HQEI8RSHDDAMIOBBAUGSBADJ7ZN,"Sunday's parliamentary vote suggested Russians are tiring of Putin and his United Russia party, which has dominated all other political forces in Russia for the past dozen years and earned a reputation for corruption.",206,216,corruption,9,4,13
311HQEI8RSHDDAMIOBBAUGSBADJ7ZN,"Putin, meanwhile, officially registered Wednesday to run for the presidency in March, but the unusually sustained protests of the past two days suggested his drive to retake the job he held from 2000-2008 may not go as smoothly as he had expected.",18,39,officially registered,1,0,1
311HQEI8RSHDDAMIOBBAUGSBADJ7ZN,"Putin, meanwhile, officially registered Wednesday to run for the presidency in March, but the unusually sustained protests of the past two days suggested his drive to retake the job he held from 2000-2008 may not go as smoothly as he had expected.",65,75,presidency,2,1,3
311HQEI8RSHDDAMIOBBAUGSBADJ7ZN,"Putin, meanwhile, officially registered Wednesday to run for the presidency in March, but the unusually sustained protests of the past two days suggested his drive to retake the job he held from 2000-2008 may not go as smoothly as he had expected.",94,103,unusually,1,1,2
311HQEI8RSHDDAMIOBBAUGSBADJ7ZN,"Putin, meanwhile, officially registered Wednesday to run for the presidency in March, but the unusually sustained protests of the past two days suggested his drive to retake the job he held from 2000-2008 may not go as smoothly as he had expected.",94,122,unusually sustained protests,2,0,2
311HQEI8RSHDDAMIOBBAUGSBADJ7ZN,"Putin, meanwhile, officially registered Wednesday to run for the presidency in March, but the unusually sustained protests of the past two days suggested his drive to retake the job he held from 2000-2008 may not go as smoothly as he had expected.",104,113,sustained,7,6,13
311HQEI8RSHDDAMIOBBAUGSBADJ7ZN,"Putin, meanwhile, officially registered Wednesday to run for the presidency in March, but the unusually sustained protests of the past two days suggested his drive to retake the job he held from 2000-2008 may not go as smoothly as he had expected.",104,122,sustained protests,1,0,1
311HQEI8RSHDDAMIOBBAUGSBADJ7ZN,"Putin, meanwhile, officially registered Wednesday to run for the presidency in March, but the unusually sustained protests of the past two days suggested his drive to retake the job he held from 2000-2008 may not go as smoothly as he had expected.",144,153,suggested,1,0,1
311HQEI8RSHDDAMIOBBAUGSBADJ7ZN,"Putin, meanwhile, officially registered Wednesday to run for the presidency in March, but the unusually sustained protests of the past two days suggested his drive to retake the job he held from 2000-2008 may not go as smoothly as he had expected.",154,163,his drive,1,0,1
311HQEI8RSHDDAMIOBBAUGSBADJ7ZN,"Putin, meanwhile, officially registered Wednesday to run for the presidency in March, but the unusually sustained protests of the past two days suggested his drive to retake the job he held from 2000-2008 may not go as smoothly as he had expected.",167,173,retake,0,1,1
311HQEI8RSHDDAMIOBBAUGSBADJ7ZN,"Putin, meanwhile, officially registered Wednesday to run for the presidency in March, but the unusually sustained protests of the past two days suggested his drive to retake the job he held from 2000-2008 may not go as smoothly as he had expected.",219,227,smoothly,0,2,2
3UEDKCTP9VRIOFNWOA80714Y646K7E,"But pro-Kremlin supporters also staged two large protests in Moscow that attracted thousands, highlighting political divisions in Russian society.",4,15,pro-Kremlin,5,0,5
3UEDKCTP9VRIOFNWOA80714Y646K7E,"But pro-Kremlin supporters also staged two large protests in Moscow that attracted thousands, highlighting political divisions in Russian society.",4,26,pro-Kremlin supporters,2,0,2
3UEDKCTP9VRIOFNWOA80714Y646K7E,"But pro-Kremlin supporters also staged two large protests in Moscow that attracted thousands, highlighting political divisions in Russian society.",16,26,supporters,2,1,3
3UEDKCTP9VRIOFNWOA80714Y646K7E,"But pro-Kremlin supporters also staged two large protests in Moscow that attracted thousands, highlighting political divisions in Russian society.",32,38,staged,2,5,7
3UEDKCTP9VRIOFNWOA80714Y646K7E,"But pro-Kremlin supporters also staged two large protests in Moscow that attracted thousands, highlighting political divisions in Russian society.",73,82,attracted,0,1,1
3UEDKCTP9VRIOFNWOA80714Y646K7E,"But pro-Kremlin supporters also staged two large protests in Moscow that attracted thousands, highlighting political divisions in Russian society.",94,106,highlighting,6,3,9
3UEDKCTP9VRIOFNWOA80714Y646K7E,"But pro-Kremlin supporters also staged two large protests in Moscow that attracted thousands, highlighting political divisions in Russian society.",94,116,highlighting political,1,0,1
3UEDKCTP9VRIOFNWOA80714Y646K7E,"But pro-Kremlin supporters also staged two large protests in Moscow that attracted thousands, highlighting political divisions in Russian society.",94,126,highlighting political divisions,1,0,1
3UEDKCTP9VRIOFNWOA80714Y646K7E,"But pro-Kremlin supporters also staged two large protests in Moscow that attracted thousands, highlighting political divisions in Russian society.",107,126,political divisions,3,1,4
3UEDKCTP9VRIOFNWOA80714Y646K7E,"But pro-Kremlin supporters also staged two large protests in Moscow that attracted thousands, highlighting political divisions in Russian society.",117,126,divisions,2,0,2
3UEDKCTP9VRIOFNWOA80714Y646K7E,"Although Sunday's election results signal Putin's return to the presidency in next March's poll may not be as easy as he expected, he has downplayed the reduced majority.",35,41,signal,1,0,1
3UEDKCTP9VRIOFNWOA80714Y646K7E,"Although Sunday's election results signal Putin's return to the presidency in next March's poll may not be as easy as he expected, he has downplayed the reduced majority.",64,74,presidency,0,1,1
3UEDKCTP9VRIOFNWOA80714Y646K7E,"Although Sunday's election results signal Putin's return to the presidency in next March's poll may not be as easy as he expected, he has downplayed the reduced majority.",121,129,expected,1,2,3
3UEDKCTP9VRIOFNWOA80714Y646K7E,"Although Sunday's election results signal Putin's return to the presidency in next March's poll may not be as easy as he expected, he has downplayed the reduced majority.",138,148,downplayed,9,10,19
3UEDKCTP9VRIOFNWOA80714Y646K7E,"Although Sunday's election results signal Putin's return to the presidency in next March's poll may not be as easy as he expected, he has downplayed the reduced majority.",138,169,downplayed the reduced majority,2,0,2
3UEDKCTP9VRIOFNWOA80714Y646K7E,"Although Sunday's election results signal Putin's return to the presidency in next March's poll may not be as easy as he expected, he has downplayed the reduced majority.",153,169,reduced majority,1,0,1
3UEDKCTP9VRIOFNWOA80714Y646K7E,"Although Sunday's election results signal Putin's return to the presidency in next March's poll may not be as easy as he expected, he has downplayed the reduced majority.",161,169,majority,0,1,1
3UEDKCTP9VRIOFNWOA80714Y646K7E,"He said it was ""inevitable"" because voters always are unhappy with the party in power.",16,26,inevitable,10,9,19
3UEDKCTP9VRIOFNWOA80714Y646K7E,He also dismissed allegations of corruption among his United Russia party members.,8,17,dismissed,5,3,8
3UEDKCTP9VRIOFNWOA80714Y646K7E,He also dismissed allegations of corruption among his United Russia party members.,8,29,dismissed allegations,4,1,5
3UEDKCTP9VRIOFNWOA80714Y646K7E,He also dismissed allegations of corruption among his United Russia party members.,8,43,dismissed allegations of corruption,1,0,1
3UEDKCTP9VRIOFNWOA80714Y646K7E,He also dismissed allegations of corruption among his United Russia party members.,18,29,allegations,9,10,19
3UEDKCTP9VRIOFNWOA80714Y646K7E,He also dismissed allegations of corruption among his United Russia party members.,33,43,corruption,10,4,14
3UEDKCTP9VRIOFNWOA80714Y646K7E,He also dismissed allegations of corruption among his United Russia party members.,54,73,United Russia party,1,0,1
3UEDKCTP9VRIOFNWOA80714Y646K7E,He also dismissed allegations of corruption among his United Russia party members.,54,81,United Russia party members,1,0,1
3UEDKCTP9VRIOFNWOA80714Y646K7E,"It is understood the dead girl had been living at her family home, in a neighbouring housing estate, and was visiting her older sister at the time of the shooting.",72,84,neighbouring,1,0,1
3UEDKCTP9VRIOFNWOA80714Y646K7E,"It is understood the dead girl had been living at her family home, in a neighbouring housing estate, and was visiting her older sister at the time of the shooting.",72,99,neighbouring housing estate,2,1,3
3UEDKCTP9VRIOFNWOA80714Y646K7E,"It is understood the dead girl had been living at her family home, in a neighbouring housing estate, and was visiting her older sister at the time of the shooting.",85,99,housing estate,2,2,4
3UEDKCTP9VRIOFNWOA80714Y646K7E,"It is understood the dead girl had been living at her family home, in a neighbouring housing estate, and was visiting her older sister at the time of the shooting.",93,99,estate,1,0,1
3UEDKCTP9VRIOFNWOA80714Y646K7E,"Locals reported seeing and speaking with her in the village during the morning, before police were called to the scene at around 10.40am.",7,15,reported,0,1,1
3I7KR83SNAEM2YBP376KLXV41UU9KF,He said authorities have not yet determined the owner of then gun but they are pretty certain Thomas was the killer.,8,19,authorities,5,0,5
3I7KR83SNAEM2YBP376KLXV41UU9KF,He said authorities have not yet determined the owner of then gun but they are pretty certain Thomas was the killer.,33,43,determined,7,4,11
3I7KR83SNAEM2YBP376KLXV41UU9KF,He said authorities have not yet determined the owner of then gun but they are pretty certain Thomas was the killer.,79,85,pretty,0,1,1
3I7KR83SNAEM2YBP376KLXV41UU9KF,He said authorities have not yet determined the owner of then gun but they are pretty certain Thomas was the killer.,79,93,pretty certain,0,1,1
3I7KR83SNAEM2YBP376KLXV41UU9KF,The Philippines has summoned China's ambassador in Manila after two Chinese ships blocked a Philippine Navy vessel from arresting Chinese fishermen in the South China Sea.,20,28,summoned,10,10,20
3I7KR83SNAEM2YBP376KLXV41UU9KF,The Philippines has summoned China's ambassador in Manila after two Chinese ships blocked a Philippine Navy vessel from arresting Chinese fishermen in the South China Sea.,37,47,ambassador,4,0,4
3I7KR83SNAEM2YBP376KLXV41UU9KF,The Philippines has summoned China's ambassador in Manila after two Chinese ships blocked a Philippine Navy vessel from arresting Chinese fishermen in the South China Sea.,82,89,blocked,0,2,2
3I7KR83SNAEM2YBP376KLXV41UU9KF,The Philippines has summoned China's ambassador in Manila after two Chinese ships blocked a Philippine Navy vessel from arresting Chinese fishermen in the South China Sea.,92,102,Philippine,1,0,1
3I7KR83SNAEM2YBP376KLXV41UU9KF,The Philippines has summoned China's ambassador in Manila after two Chinese ships blocked a Philippine Navy vessel from arresting Chinese fishermen in the South China Sea.,103,114,Navy vessel,0,1,1
3I7KR83SNAEM2YBP376KLXV41UU9KF,The Philippines has summoned China's ambassador in Manila after two Chinese ships blocked a Philippine Navy vessel from arresting Chinese fishermen in the South China Sea.,108,114,vessel,6,3,9
3I7KR83SNAEM2YBP376KLXV41UU9KF,The Philippines has summoned China's ambassador in Manila after two Chinese ships blocked a Philippine Navy vessel from arresting Chinese fishermen in the South China Sea.,120,129,arresting,2,1,3
3I7KR83SNAEM2YBP376KLXV41UU9KF,"Eight Chinese fishing vessels were anchored off Scarborough Shoal, the Philippine government said on Wednesday, as Albert del Rosario, the country's foreign affairs secretary, called in Ma Keqing, the ambassador, for talks.",14,29,fishing vessels,1,0,1
3I7KR83SNAEM2YBP376KLXV41UU9KF,"Eight Chinese fishing vessels were anchored off Scarborough Shoal, the Philippine government said on Wednesday, as Albert del Rosario, the country's foreign affairs secretary, called in Ma Keqing, the ambassador, for talks.",22,29,vessels,0,2,2
3I7KR83SNAEM2YBP376KLXV41UU9KF,"Eight Chinese fishing vessels were anchored off Scarborough Shoal, the Philippine government said on Wednesday, as Albert del Rosario, the country's foreign affairs secretary, called in Ma Keqing, the ambassador, for talks.",35,43,anchored,7,7,14
3I7KR83SNAEM2YBP376KLXV41UU9KF,"Eight Chinese fishing vessels were anchored off Scarborough Shoal, the Philippine government said on Wednesday, as Albert del Rosario, the country's foreign affairs secretary, called in Ma Keqing, the ambassador, for talks.",35,47,anchored off,0,3,3
3I7KR83SNAEM2YBP376KLXV41UU9KF,"Eight Chinese fishing vessels were anchored off Scarborough Shoal, the Philippine government said on Wednesday, as Albert del Rosario, the country's foreign affairs secretary, called in Ma Keqing, the ambassador, for talks.",48,59,Scarborough,1,0,1
3I7KR83SNAEM2YBP376KLXV41UU9KF,"Eight Chinese fishing vessels were anchored off Scarborough Shoal, the Philippine government said on Wednesday, as Albert del Rosario, the country's foreign affairs secretary, called in Ma Keqing, the ambassador, for talks.",48,65,Scarborough Shoal,1,0,1
3I7KR83SNAEM2YBP376KLXV41UU9KF,"Eight Chinese fishing vessels were anchored off Scarborough Shoal, the Philippine government said on Wednesday, as Albert del Rosario, the country's foreign affairs secretary, called in Ma Keqing, the ambassador, for talks.",60,65,Shoal,0,1,1
3I7KR83SNAEM2YBP376KLXV41UU9KF,"Eight Chinese fishing vessels were anchored off Scarborough Shoal, the Philippine government said on Wednesday, as Albert del Rosario, the country's foreign affairs secretary, called in Ma Keqing, the ambassador, for talks.",71,81,Philippine,1,0,1
3I7KR83SNAEM2YBP376KLXV41UU9KF,"Eight Chinese fishing vessels were anchored off Scarborough Shoal, the Philippine government said on Wednesday, as Albert del Rosario, the country's foreign affairs secretary, called in Ma Keqing, the ambassador, for talks.",126,133,Rosario,1,0,1
3I7KR83SNAEM2YBP376KLXV41UU9KF,"Eight Chinese fishing vessels were anchored off Scarborough Shoal, the Philippine government said on Wednesday, as Albert del Rosario, the country's foreign affairs secretary, called in Ma Keqing, the ambassador, for talks.",149,156,foreign,1,0,1
3I7KR83SNAEM2YBP376KLXV41UU9KF,"Eight Chinese fishing vessels were anchored off Scarborough Shoal, the Philippine government said on Wednesday, as Albert del Rosario, the country's foreign affairs secretary, called in Ma Keqing, the ambassador, for talks.",149,174,foreign affairs secretary,2,0,2
3I7KR83SNAEM2YBP376KLXV41UU9KF,"Eight Chinese fishing vessels were anchored off Scarborough Shoal, the Philippine government said on Wednesday, as Albert del Rosario, the country's foreign affairs secretary, called in Ma Keqing, the ambassador, for talks.",201,211,ambassador,3,1,4
3I7KR83SNAEM2YBP376KLXV41UU9KF,"Manila and Beijing contest sovereignty over the small group of islands and reefs, which lie about 124 nautical miles from the western coast of the Philippines' main island of Luzon.",19,26,contest,2,2,4
3I7KR83SNAEM2YBP376KLXV41UU9KF,"Manila and Beijing contest sovereignty over the small group of islands and reefs, which lie about 124 nautical miles from the western coast of the Philippines' main island of Luzon.",19,38,contest sovereignty,3,1,4
3I7KR83SNAEM2YBP376KLXV41UU9KF,"Manila and Beijing contest sovereignty over the small group of islands and reefs, which lie about 124 nautical miles from the western coast of the Philippines' main island of Luzon.",27,38,sovereignty,9,10,19
3I7KR83SNAEM2YBP376KLXV41UU9KF,"Manila and Beijing contest sovereignty over the small group of islands and reefs, which lie about 124 nautical miles from the western coast of the Philippines' main island of Luzon.",75,80,reefs,3,3,6
3I7KR83SNAEM2YBP376KLXV41UU9KF,"Manila and Beijing contest sovereignty over the small group of islands and reefs, which lie about 124 nautical miles from the western coast of the Philippines' main island of Luzon.",102,110,nautical,6,1,7
3I7KR83SNAEM2YBP376KLXV41UU9KF,"Manila and Beijing contest sovereignty over the small group of islands and reefs, which lie about 124 nautical miles from the western coast of the Philippines' main island of Luzon.",102,116,nautical miles,2,3,5
3I7KR83SNAEM2YBP376KLXV41UU9KF,"The foreign affairs department statement said the Philippines' flagship warship, the Gregorio Del Pilar, found the eight vessels there on Sunday while patrolling the area.",4,30,foreign affairs department,2,1,3
3I7KR83SNAEM2YBP376KLXV41UU9KF,"The foreign affairs department statement said the Philippines' flagship warship, the Gregorio Del Pilar, found the eight vessels there on Sunday while patrolling the area.",20,30,department,1,1,2
3I7KR83SNAEM2YBP376KLXV41UU9KF,"The foreign affairs department statement said the Philippines' flagship warship, the Gregorio Del Pilar, found the eight vessels there on Sunday while patrolling the area.",31,40,statement,0,1,1
3I7KR83SNAEM2YBP376KLXV41UU9KF,"The foreign affairs department statement said the Philippines' flagship warship, the Gregorio Del Pilar, found the eight vessels there on Sunday while patrolling the area.",50,61,Philippines,1,0,1
3I7KR83SNAEM2YBP376KLXV41UU9KF,"The foreign affairs department statement said the Philippines' flagship warship, the Gregorio Del Pilar, found the eight vessels there on Sunday while patrolling the area.",63,71,flagship,4,3,7
3I7KR83SNAEM2YBP376KLXV41UU9KF,"The foreign affairs department statement said the Philippines' flagship warship, the Gregorio Del Pilar, found the eight vessels there on Sunday while patrolling the area.",63,79,flagship warship,3,1,4
3I7KR83SNAEM2YBP376KLXV41UU9KF,"The foreign affairs department statement said the Philippines' flagship warship, the Gregorio Del Pilar, found the eight vessels there on Sunday while patrolling the area.",72,79,warship,1,0,1
3I7KR83SNAEM2YBP376KLXV41UU9KF,"The foreign affairs department statement said the Philippines' flagship warship, the Gregorio Del Pilar, found the eight vessels there on Sunday while patrolling the area.",121,128,vessels,4,2,6
3I7KR83SNAEM2YBP376KLXV41UU9KF,"The foreign affairs department statement said the Philippines' flagship warship, the Gregorio Del Pilar, found the eight vessels there on Sunday while patrolling the area.",151,161,patrolling,6,6,12
3MJ28H2Y1E9MR2USY9LWGY7BZ3L5O4,"A 21-year-old man was arrested on April 30, on suspicion of murder and was released on bail until May 29 pending further enquiries.",47,56,suspicion,5,5,10
3MJ28H2Y1E9MR2USY9LWGY7BZ3L5O4,"A 21-year-old man was arrested on April 30, on suspicion of murder and was released on bail until May 29 pending further enquiries.",47,66,suspicion of murder,2,2,4
3MJ28H2Y1E9MR2USY9LWGY7BZ3L5O4,"A 21-year-old man was arrested on April 30, on suspicion of murder and was released on bail until May 29 pending further enquiries.",87,91,bail,4,3,7
3MJ28H2Y1E9MR2USY9LWGY7BZ3L5O4,"A 21-year-old man was arrested on April 30, on suspicion of murder and was released on bail until May 29 pending further enquiries.",105,112,pending,2,3,5
3MJ28H2Y1E9MR2USY9LWGY7BZ3L5O4,"A 21-year-old man was arrested on April 30, on suspicion of murder and was released on bail until May 29 pending further enquiries.",105,130,pending further enquiries,2,1,3
3MJ28H2Y1E9MR2USY9LWGY7BZ3L5O4,"A 21-year-old man was arrested on April 30, on suspicion of murder and was released on bail until May 29 pending further enquiries.",121,130,enquiries,7,6,13
3MJ28H2Y1E9MR2USY9LWGY7BZ3L5O4,"Google Inc. (GOOG) won approval from Chinese regulators for its $12.5 billion purchase of Motorola Mobility Holdings Inc. (MMI), clearing a final hurdle for a deal that boosts its patents portfolio and steps up competition with Apple Inc. (AAPL) “We are pleased the deal has received approval in all jurisdictions,” Motorola Mobility said in an e-mailed statement, confirming that the deal has been approved in China.",23,31,approval,0,3,3
3MJ28H2Y1E9MR2USY9LWGY7BZ3L5O4,"Google Inc. (GOOG) won approval from Chinese regulators for its $12.5 billion purchase of Motorola Mobility Holdings Inc. (MMI), clearing a final hurdle for a deal that boosts its patents portfolio and steps up competition with Apple Inc. (AAPL) “We are pleased the deal has received approval in all jurisdictions,” Motorola Mobility said in an e-mailed statement, confirming that the deal has been approved in China.",45,55,regulators,6,2,8
3MJ28H2Y1E9MR2USY9LWGY7BZ3L5O4,"Google Inc. (GOOG) won approval from Chinese regulators for its $12.5 billion purchase of Motorola Mobility Holdings Inc. (MMI), clearing a final hurdle for a deal that boosts its patents portfolio and steps up competition with Apple Inc. (AAPL) “We are pleased the deal has received approval in all jurisdictions,” Motorola Mobility said in an e-mailed statement, confirming that the deal has been approved in China.",129,152,clearing a final hurdle,1,0,1
3MJ28H2Y1E9MR2USY9LWGY7BZ3L5O4,"Google Inc. (GOOG) won approval from Chinese regulators for its $12.5 billion purchase of Motorola Mobility Holdings Inc. (MMI), clearing a final hurdle for a deal that boosts its patents portfolio and steps up competition with Apple Inc. (AAPL) “We are pleased the deal has received approval in all jurisdictions,” Motorola Mobility said in an e-mailed statement, confirming that the deal has been approved in China.",140,152,final hurdle,0,2,2
3MJ28H2Y1E9MR2USY9LWGY7BZ3L5O4,"Google Inc. (GOOG) won approval from Chinese regulators for its $12.5 billion purchase of Motorola Mobility Holdings Inc. (MMI), clearing a final hurdle for a deal that boosts its patents portfolio and steps up competition with Apple Inc. (AAPL) “We are pleased the deal has received approval in all jurisdictions,” Motorola Mobility said in an e-mailed statement, confirming that the deal has been approved in China.",146,152,hurdle,7,6,13
3MJ28H2Y1E9MR2USY9LWGY7BZ3L5O4,"Google Inc. (GOOG) won approval from Chinese regulators for its $12.5 billion purchase of Motorola Mobility Holdings Inc. (MMI), clearing a final hurdle for a deal that boosts its patents portfolio and steps up competition with Apple Inc. (AAPL) “We are pleased the deal has received approval in all jurisdictions,” Motorola Mobility said in an e-mailed statement, confirming that the deal has been approved in China.",169,175,boosts,1,2,3
3MJ28H2Y1E9MR2USY9LWGY7BZ3L5O4,"Google Inc. (GOOG) won approval from Chinese regulators for its $12.5 billion purchase of Motorola Mobility Holdings Inc. (MMI), clearing a final hurdle for a deal that boosts its patents portfolio and steps up competition with Apple Inc. (AAPL) “We are pleased the deal has received approval in all jurisdictions,” Motorola Mobility said in an e-mailed statement, confirming that the deal has been approved in China.",180,187,patents,3,0,3
3MJ28H2Y1E9MR2USY9LWGY7BZ3L5O4,"Google Inc. (GOOG) won approval from Chinese regulators for its $12.5 billion purchase of Motorola Mobility Holdings Inc. (MMI), clearing a final hurdle for a deal that boosts its patents portfolio and steps up competition with Apple Inc. (AAPL) “We are pleased the deal has received approval in all jurisdictions,” Motorola Mobility said in an e-mailed statement, confirming that the deal has been approved in China.",180,197,patents portfolio,7,2,9
3MJ28H2Y1E9MR2USY9LWGY7BZ3L5O4,"Google Inc. (GOOG) won approval from Chinese regulators for its $12.5 billion purchase of Motorola Mobility Holdings Inc. (MMI), clearing a final hurdle for a deal that boosts its patents portfolio and steps up competition with Apple Inc. (AAPL) “We are pleased the deal has received approval in all jurisdictions,” Motorola Mobility said in an e-mailed statement, confirming that the deal has been approved in China.",188,197,portfolio,5,6,11
3MJ28H2Y1E9MR2USY9LWGY7BZ3L5O4,"Google Inc. (GOOG) won approval from Chinese regulators for its $12.5 billion purchase of Motorola Mobility Holdings Inc. (MMI), clearing a final hurdle for a deal that boosts its patents portfolio and steps up competition with Apple Inc. (AAPL) “We are pleased the deal has received approval in all jurisdictions,” Motorola Mobility said in an e-mailed statement, confirming that the deal has been approved in China.",211,222,competition,4,1,5
3MJ28H2Y1E9MR2USY9LWGY7BZ3L5O4,"Google Inc. (GOOG) won approval from Chinese regulators for its $12.5 billion purchase of Motorola Mobility Holdings Inc. (MMI), clearing a final hurdle for a deal that boosts its patents portfolio and steps up competition with Apple Inc. (AAPL) “We are pleased the deal has received approval in all jurisdictions,” Motorola Mobility said in an e-mailed statement, confirming that the deal has been approved in China.",284,292,approval,1,0,1
3MJ28H2Y1E9MR2USY9LWGY7BZ3L5O4,"Google Inc. (GOOG) won approval from Chinese regulators for its $12.5 billion purchase of Motorola Mobility Holdings Inc. (MMI), clearing a final hurdle for a deal that boosts its patents portfolio and steps up competition with Apple Inc. (AAPL) “We are pleased the deal has received approval in all jurisdictions,” Motorola Mobility said in an e-mailed statement, confirming that the deal has been approved in China.",300,313,jurisdictions,10,9,19
3MJ28H2Y1E9MR2USY9LWGY7BZ3L5O4,"Google Inc. (GOOG) won approval from Chinese regulators for its $12.5 billion purchase of Motorola Mobility Holdings Inc. (MMI), clearing a final hurdle for a deal that boosts its patents portfolio and steps up competition with Apple Inc. (AAPL) “We are pleased the deal has received approval in all jurisdictions,” Motorola Mobility said in an e-mailed statement, confirming that the deal has been approved in China.",300,315,"jurisdictions,”",1,0,1
3MJ28H2Y1E9MR2USY9LWGY7BZ3L5O4,"Google Inc. (GOOG) won approval from Chinese regulators for its $12.5 billion purchase of Motorola Mobility Holdings Inc. (MMI), clearing a final hurdle for a deal that boosts its patents portfolio and steps up competition with Apple Inc. (AAPL) “We are pleased the deal has received approval in all jurisdictions,” Motorola Mobility said in an e-mailed statement, confirming that the deal has been approved in China.",365,375,confirming,0,2,2
3MJ28H2Y1E9MR2USY9LWGY7BZ3L5O4,“We expect to close imminently.”,14,30,close imminently,1,0,1
3MJ28H2Y1E9MR2USY9LWGY7BZ3L5O4,“We expect to close imminently.”,20,30,imminently,10,10,20
3MJ28H2Y1E9MR2USY9LWGY7BZ3L5O4,"The acquisition, announced last year, has already received approvals in Europe, the U.S. and other jurisdictions worldwide.",4,15,acquisition,10,8,18
3MJ28H2Y1E9MR2USY9LWGY7BZ3L5O4,"The acquisition, announced last year, has already received approvals in Europe, the U.S. and other jurisdictions worldwide.",17,26,announced,1,0,1
3MJ28H2Y1E9MR2USY9LWGY7BZ3L5O4,"The acquisition, announced last year, has already received approvals in Europe, the U.S. and other jurisdictions worldwide.",59,68,approvals,1,0,1
3MJ28H2Y1E9MR2USY9LWGY7BZ3L5O4,"The acquisition, announced last year, has already received approvals in Europe, the U.S. and other jurisdictions worldwide.",99,112,jurisdictions,6,3,9
3MJ28H2Y1E9MR2USY9LWGY7BZ3L5O4,Motorola Mobility had said in a regulatory filing in February that it needed approval in China.,32,42,regulatory,3,1,4
3MJ28H2Y1E9MR2USY9LWGY7BZ3L5O4,Motorola Mobility had said in a regulatory filing in February that it needed approval in China.,32,49,regulatory filing,6,1,7
3MJ28H2Y1E9MR2USY9LWGY7BZ3L5O4,Motorola Mobility had said in a regulatory filing in February that it needed approval in China.,43,49,filing,0,2,2
3MJ28H2Y1E9MR2USY9LWGY7BZ3L5O4,"Google, facing legal disputes over its Android smartphone software, will be able to draw on more than 17,000 patents from Libertyville, Illinois-based Motorola Mobility.",15,29,legal disputes,3,4,7
3MJ28H2Y1E9MR2USY9LWGY7BZ3L5O4,"Google, facing legal disputes over its Android smartphone software, will be able to draw on more than 17,000 patents from Libertyville, Illinois-based Motorola Mobility.",21,29,disputes,0,3,3
3MJ28H2Y1E9MR2USY9LWGY7BZ3L5O4,"Google, facing legal disputes over its Android smartphone software, will be able to draw on more than 17,000 patents from Libertyville, Illinois-based Motorola Mobility.",47,57,smartphone,1,0,1
3MJ28H2Y1E9MR2USY9LWGY7BZ3L5O4,"Google, facing legal disputes over its Android smartphone software, will be able to draw on more than 17,000 patents from Libertyville, Illinois-based Motorola Mobility.",47,67,smartphone  software,1,0,1
3MJ28H2Y1E9MR2USY9LWGY7BZ3L5O4,"Google, facing legal disputes over its Android smartphone software, will be able to draw on more than 17,000 patents from Libertyville, Illinois-based Motorola Mobility.",58,66,software,0,2,2
3MJ28H2Y1E9MR2USY9LWGY7BZ3L5O4,"Google, facing legal disputes over its Android smartphone software, will be able to draw on more than 17,000 patents from Libertyville, Illinois-based Motorola Mobility.",109,116,patents,4,0,4
3MJ28H2Y1E9MR2USY9LWGY7BZ3L5O4,"Google, facing legal disputes over its Android smartphone software, will be able to draw on more than 17,000 patents from Libertyville, Illinois-based Motorola Mobility.",122,134,Libertyville,0,1,1
3IHWR4LC7DEVIY2RYCFU8LLGPKN8IE,"The Israeli official said the new ambassador to Cairo, Yaakov Amitai, was expected to travel to the Egyptian capital in December to present his credentials, but the embassy would not be staffed or resume normal activity until acceptable security arrangements were in place.",34,44,ambassador,4,1,5
3IHWR4LC7DEVIY2RYCFU8LLGPKN8IE,"The Israeli official said the new ambassador to Cairo, Yaakov Amitai, was expected to travel to the Egyptian capital in December to present his credentials, but the embassy would not be staffed or resume normal activity until acceptable security arrangements were in place.",74,82,expected,0,1,1
3IHWR4LC7DEVIY2RYCFU8LLGPKN8IE,"The Israeli official said the new ambassador to Cairo, Yaakov Amitai, was expected to travel to the Egyptian capital in December to present his credentials, but the embassy would not be staffed or resume normal activity until acceptable security arrangements were in place.",74,92,expected to travel,0,1,1
3IHWR4LC7DEVIY2RYCFU8LLGPKN8IE,"The Israeli official said the new ambassador to Cairo, Yaakov Amitai, was expected to travel to the Egyptian capital in December to present his credentials, but the embassy would not be staffed or resume normal activity until acceptable security arrangements were in place.",132,155,present his credentials,1,0,1
3IHWR4LC7DEVIY2RYCFU8LLGPKN8IE,"The Israeli official said the new ambassador to Cairo, Yaakov Amitai, was expected to travel to the Egyptian capital in December to present his credentials, but the embassy would not be staffed or resume normal activity until acceptable security arrangements were in place.",144,155,credentials,10,9,19
3IHWR4LC7DEVIY2RYCFU8LLGPKN8IE,"The Israeli official said the new ambassador to Cairo, Yaakov Amitai, was expected to travel to the Egyptian capital in December to present his credentials, but the embassy would not be staffed or resume normal activity until acceptable security arrangements were in place.",165,172,embassy,3,2,5
3IHWR4LC7DEVIY2RYCFU8LLGPKN8IE,"The Israeli official said the new ambassador to Cairo, Yaakov Amitai, was expected to travel to the Egyptian capital in December to present his credentials, but the embassy would not be staffed or resume normal activity until acceptable security arrangements were in place.",186,193,staffed,6,10,16
3IHWR4LC7DEVIY2RYCFU8LLGPKN8IE,"The Israeli official said the new ambassador to Cairo, Yaakov Amitai, was expected to travel to the Egyptian capital in December to present his credentials, but the embassy would not be staffed or resume normal activity until acceptable security arrangements were in place.",197,203,resume,0,2,2
3IHWR4LC7DEVIY2RYCFU8LLGPKN8IE,"The Israeli official said the new ambassador to Cairo, Yaakov Amitai, was expected to travel to the Egyptian capital in December to present his credentials, but the embassy would not be staffed or resume normal activity until acceptable security arrangements were in place.",197,219,resume normal activity,2,0,2
3IHWR4LC7DEVIY2RYCFU8LLGPKN8IE,"The Israeli official said the new ambassador to Cairo, Yaakov Amitai, was expected to travel to the Egyptian capital in December to present his credentials, but the embassy would not be staffed or resume normal activity until acceptable security arrangements were in place.",226,236,acceptable,0,1,1
3IHWR4LC7DEVIY2RYCFU8LLGPKN8IE,"The Israeli official said the new ambassador to Cairo, Yaakov Amitai, was expected to travel to the Egyptian capital in December to present his credentials, but the embassy would not be staffed or resume normal activity until acceptable security arrangements were in place.",237,245,security,1,0,1
3IHWR4LC7DEVIY2RYCFU8LLGPKN8IE,"The Israeli official said the new ambassador to Cairo, Yaakov Amitai, was expected to travel to the Egyptian capital in December to present his credentials, but the embassy would not be staffed or resume normal activity until acceptable security arrangements were in place.",237,258,security arrangements,3,2,5
3IHWR4LC7DEVIY2RYCFU8LLGPKN8IE,"The Israeli official said the new ambassador to Cairo, Yaakov Amitai, was expected to travel to the Egyptian capital in December to present his credentials, but the embassy would not be staffed or resume normal activity until acceptable security arrangements were in place.",246,258,arrangements,1,4,5
3IHWR4LC7DEVIY2RYCFU8LLGPKN8IE,"Many Egyptians view Israel, which signed a peace treaty with Egypt in 1979 after four wars between the two countries, with hostility.",43,55,peace treaty,2,4,6
3IHWR4LC7DEVIY2RYCFU8LLGPKN8IE,"Many Egyptians view Israel, which signed a peace treaty with Egypt in 1979 after four wars between the two countries, with hostility.",49,55,treaty,0,1,1
3IHWR4LC7DEVIY2RYCFU8LLGPKN8IE,"Many Egyptians view Israel, which signed a peace treaty with Egypt in 1979 after four wars between the two countries, with hostility.",123,132,hostility,10,9,19
3IHWR4LC7DEVIY2RYCFU8LLGPKN8IE,"Anti-Israeli sentiment, muted before President Hosni Mubarak was overthrown in February, has become more vocal.",0,22,Anti-Israeli sentiment,1,0,1
3IHWR4LC7DEVIY2RYCFU8LLGPKN8IE,"Anti-Israeli sentiment, muted before President Hosni Mubarak was overthrown in February, has become more vocal.",13,22,sentiment,7,2,9
3IHWR4LC7DEVIY2RYCFU8LLGPKN8IE,"Anti-Israeli sentiment, muted before President Hosni Mubarak was overthrown in February, has become more vocal.",24,29,muted,4,6,10
3IHWR4LC7DEVIY2RYCFU8LLGPKN8IE,"Anti-Israeli sentiment, muted before President Hosni Mubarak was overthrown in February, has become more vocal.",65,75,overthrown,4,8,12
3IHWR4LC7DEVIY2RYCFU8LLGPKN8IE,"Anti-Israeli sentiment, muted before President Hosni Mubarak was overthrown in February, has become more vocal.",100,110,more vocal,0,1,1
3IHWR4LC7DEVIY2RYCFU8LLGPKN8IE,"Anti-Israeli sentiment, muted before President Hosni Mubarak was overthrown in February, has become more vocal.",105,110,vocal,5,5,10
3IHWR4LC7DEVIY2RYCFU8LLGPKN8IE,A postmortem is due to be carried out today on the body of a teenager who was shot dead in Co Derry yesterday.,2,12,postmortem,10,6,16
3IHWR4LC7DEVIY2RYCFU8LLGPKN8IE,A postmortem is due to be carried out today on the body of a teenager who was shot dead in Co Derry yesterday.,61,69,teenager,0,1,1
3IHWR4LC7DEVIY2RYCFU8LLGPKN8IE,A 26-year-old man is being questioned by detectives about the murder of the 18-year-old and the serious wounding of her sister in a gun attack in a small village of Bellaghy.,41,51,detectives,1,1,2
3IHWR4LC7DEVIY2RYCFU8LLGPKN8IE,A 26-year-old man is being questioned by detectives about the murder of the 18-year-old and the serious wounding of her sister in a gun attack in a small village of Bellaghy.,62,68,murder,1,0,1
3IHWR4LC7DEVIY2RYCFU8LLGPKN8IE,A 26-year-old man is being questioned by detectives about the murder of the 18-year-old and the serious wounding of her sister in a gun attack in a small village of Bellaghy.,96,112,serious wounding,1,0,1
3IHWR4LC7DEVIY2RYCFU8LLGPKN8IE,A 26-year-old man is being questioned by detectives about the murder of the 18-year-old and the serious wounding of her sister in a gun attack in a small village of Bellaghy.,104,112,wounding,3,5,8
3OEWW2KGQJCHVF9LDF3FEAV3B7GDOQ,"An EU statement issued at a meeting of ministers from the 27-nation bloc said they adopted ""sanctions against the Syrian regime"" but gave no details.",3,5,EU,1,0,1
3OEWW2KGQJCHVF9LDF3FEAV3B7GDOQ,"An EU statement issued at a meeting of ministers from the 27-nation bloc said they adopted ""sanctions against the Syrian regime"" but gave no details.",16,22,issued,0,2,2
3OEWW2KGQJCHVF9LDF3FEAV3B7GDOQ,"An EU statement issued at a meeting of ministers from the 27-nation bloc said they adopted ""sanctions against the Syrian regime"" but gave no details.",39,48,ministers,1,0,1
3OEWW2KGQJCHVF9LDF3FEAV3B7GDOQ,"An EU statement issued at a meeting of ministers from the 27-nation bloc said they adopted ""sanctions against the Syrian regime"" but gave no details.",68,72,bloc,7,4,11
3OEWW2KGQJCHVF9LDF3FEAV3B7GDOQ,"An EU statement issued at a meeting of ministers from the 27-nation bloc said they adopted ""sanctions against the Syrian regime"" but gave no details.",83,90,adopted,1,2,3
3OEWW2KGQJCHVF9LDF3FEAV3B7GDOQ,"An EU statement issued at a meeting of ministers from the 27-nation bloc said they adopted ""sanctions against the Syrian regime"" but gave no details.",92,101,sanctions,10,5,15
3OEWW2KGQJCHVF9LDF3FEAV3B7GDOQ,"An EU statement issued at a meeting of ministers from the 27-nation bloc said they adopted ""sanctions against the Syrian regime"" but gave no details.",92,127,sanctions against the Syrian regime,1,0,1
3OEWW2KGQJCHVF9LDF3FEAV3B7GDOQ,"An EU statement issued at a meeting of ministers from the 27-nation bloc said they adopted ""sanctions against the Syrian regime"" but gave no details.",121,127,regime,7,7,14
3OEWW2KGQJCHVF9LDF3FEAV3B7GDOQ,"Rebels killed 23 Syrian soldiers on Monday, according to a rights group opposed to President Bashar Assad, in battles around the town of Rastan that further undermined a sagging U.N.-backed ceasefire.",0,6,Rebels,2,1,3
3OEWW2KGQJCHVF9LDF3FEAV3B7GDOQ,"Rebels killed 23 Syrian soldiers on Monday, according to a rights group opposed to President Bashar Assad, in battles around the town of Rastan that further undermined a sagging U.N.-backed ceasefire.",59,71,rights group,0,1,1
3OEWW2KGQJCHVF9LDF3FEAV3B7GDOQ,"Rebels killed 23 Syrian soldiers on Monday, according to a rights group opposed to President Bashar Assad, in battles around the town of Rastan that further undermined a sagging U.N.-backed ceasefire.",72,79,opposed,1,0,1
3OEWW2KGQJCHVF9LDF3FEAV3B7GDOQ,"Rebels killed 23 Syrian soldiers on Monday, according to a rights group opposed to President Bashar Assad, in battles around the town of Rastan that further undermined a sagging U.N.-backed ceasefire.",110,117,battles,0,1,1
3OEWW2KGQJCHVF9LDF3FEAV3B7GDOQ,"Rebels killed 23 Syrian soldiers on Monday, according to a rights group opposed to President Bashar Assad, in battles around the town of Rastan that further undermined a sagging U.N.-backed ceasefire.",157,167,undermined,10,5,15
3OEWW2KGQJCHVF9LDF3FEAV3B7GDOQ,"Rebels killed 23 Syrian soldiers on Monday, according to a rights group opposed to President Bashar Assad, in battles around the town of Rastan that further undermined a sagging U.N.-backed ceasefire.",157,177,undermined a sagging,1,0,1
3OEWW2KGQJCHVF9LDF3FEAV3B7GDOQ,"Rebels killed 23 Syrian soldiers on Monday, according to a rights group opposed to President Bashar Assad, in battles around the town of Rastan that further undermined a sagging U.N.-backed ceasefire.",170,177,sagging,5,8,13
3OEWW2KGQJCHVF9LDF3FEAV3B7GDOQ,"Rebels killed 23 Syrian soldiers on Monday, according to a rights group opposed to President Bashar Assad, in battles around the town of Rastan that further undermined a sagging U.N.-backed ceasefire.",170,199,sagging U.N.-backed ceasefire,1,0,1
3OEWW2KGQJCHVF9LDF3FEAV3B7GDOQ,"Rebels killed 23 Syrian soldiers on Monday, according to a rights group opposed to President Bashar Assad, in battles around the town of Rastan that further undermined a sagging U.N.-backed ceasefire.",190,199,ceasefire,8,9,17
3OEWW2KGQJCHVF9LDF3FEAV3B7GDOQ,"The fighting on the outskirts of Rastan followed heavy army shelling of the town in which opposition sources said at least nine people were killed, including a local rebel commander.",20,29,outskirts,8,6,14
3OEWW2KGQJCHVF9LDF3FEAV3B7GDOQ,"The fighting on the outskirts of Rastan followed heavy army shelling of the town in which opposition sources said at least nine people were killed, including a local rebel commander.",49,68,heavy army shelling,1,0,1
3OEWW2KGQJCHVF9LDF3FEAV3B7GDOQ,"The fighting on the outskirts of Rastan followed heavy army shelling of the town in which opposition sources said at least nine people were killed, including a local rebel commander.",60,68,shelling,6,4,10
3OEWW2KGQJCHVF9LDF3FEAV3B7GDOQ,"The fighting on the outskirts of Rastan followed heavy army shelling of the town in which opposition sources said at least nine people were killed, including a local rebel commander.",90,100,opposition,3,0,3
3OEWW2KGQJCHVF9LDF3FEAV3B7GDOQ,"The fighting on the outskirts of Rastan followed heavy army shelling of the town in which opposition sources said at least nine people were killed, including a local rebel commander.",90,108,opposition sources,2,0,2
3OEWW2KGQJCHVF9LDF3FEAV3B7GDOQ,"The fighting on the outskirts of Rastan followed heavy army shelling of the town in which opposition sources said at least nine people were killed, including a local rebel commander.",166,181,rebel commander,1,0,1
3OEWW2KGQJCHVF9LDF3FEAV3B7GDOQ,"Rastan, 25 km (15 miles) north of Homs city, has slipped in and out of government control several times since the uprising against Assad erupted in March 2011.",49,56,slipped,2,1,3
3OEWW2KGQJCHVF9LDF3FEAV3B7GDOQ,"Rastan, 25 km (15 miles) north of Homs city, has slipped in and out of government control several times since the uprising against Assad erupted in March 2011.",49,59,slipped in,0,2,2
3OEWW2KGQJCHVF9LDF3FEAV3B7GDOQ,"Rastan, 25 km (15 miles) north of Homs city, has slipped in and out of government control several times since the uprising against Assad erupted in March 2011.",71,81,government,1,0,1
3OEWW2KGQJCHVF9LDF3FEAV3B7GDOQ,"Rastan, 25 km (15 miles) north of Homs city, has slipped in and out of government control several times since the uprising against Assad erupted in March 2011.",114,122,uprising,6,8,14
3OEWW2KGQJCHVF9LDF3FEAV3B7GDOQ,"Rastan, 25 km (15 miles) north of Homs city, has slipped in and out of government control several times since the uprising against Assad erupted in March 2011.",137,144,erupted,5,4,9
3OEWW2KGQJCHVF9LDF3FEAV3B7GDOQ,"Shelling began on Sunday and intensified overnight, activists said, a new blow to a ceasefire declared by peace envoy Kofi Annan a month ago and which U.N. monitoring mission on the ground are observing.",0,8,Shelling,3,0,3
3OEWW2KGQJCHVF9LDF3FEAV3B7GDOQ,"Shelling began on Sunday and intensified overnight, activists said, a new blow to a ceasefire declared by peace envoy Kofi Annan a month ago and which U.N. monitoring mission on the ground are observing.",29,40,intensified,9,7,16
3OEWW2KGQJCHVF9LDF3FEAV3B7GDOQ,"Shelling began on Sunday and intensified overnight, activists said, a new blow to a ceasefire declared by peace envoy Kofi Annan a month ago and which U.N. monitoring mission on the ground are observing.",52,61,activists,2,1,3
3OEWW2KGQJCHVF9LDF3FEAV3B7GDOQ,"Shelling began on Sunday and intensified overnight, activists said, a new blow to a ceasefire declared by peace envoy Kofi Annan a month ago and which U.N. monitoring mission on the ground are observing.",74,78,blow,2,1,3
3OEWW2KGQJCHVF9LDF3FEAV3B7GDOQ,"Shelling began on Sunday and intensified overnight, activists said, a new blow to a ceasefire declared by peace envoy Kofi Annan a month ago and which U.N. monitoring mission on the ground are observing.",74,81,blow to,0,1,1
3OEWW2KGQJCHVF9LDF3FEAV3B7GDOQ,"Shelling began on Sunday and intensified overnight, activists said, a new blow to a ceasefire declared by peace envoy Kofi Annan a month ago and which U.N. monitoring mission on the ground are observing.",84,93,ceasefire,2,2,4
3OEWW2KGQJCHVF9LDF3FEAV3B7GDOQ,"Shelling began on Sunday and intensified overnight, activists said, a new blow to a ceasefire declared by peace envoy Kofi Annan a month ago and which U.N. monitoring mission on the ground are observing.",94,102,declared,1,0,1
3OEWW2KGQJCHVF9LDF3FEAV3B7GDOQ,"Shelling began on Sunday and intensified overnight, activists said, a new blow to a ceasefire declared by peace envoy Kofi Annan a month ago and which U.N. monitoring mission on the ground are observing.",106,117,peace envoy,0,1,1
3OEWW2KGQJCHVF9LDF3FEAV3B7GDOQ,"Shelling began on Sunday and intensified overnight, activists said, a new blow to a ceasefire declared by peace envoy Kofi Annan a month ago and which U.N. monitoring mission on the ground are observing.",112,117,envoy,9,1,10
3OEWW2KGQJCHVF9LDF3FEAV3B7GDOQ,"Shelling began on Sunday and intensified overnight, activists said, a new blow to a ceasefire declared by peace envoy Kofi Annan a month ago and which U.N. monitoring mission on the ground are observing.",151,174,U.N. monitoring mission,1,0,1
3OEWW2KGQJCHVF9LDF3FEAV3B7GDOQ,"Shelling began on Sunday and intensified overnight, activists said, a new blow to a ceasefire declared by peace envoy Kofi Annan a month ago and which U.N. monitoring mission on the ground are observing.",156,166,monitoring,4,1,5
3OEWW2KGQJCHVF9LDF3FEAV3B7GDOQ,"Shelling began on Sunday and intensified overnight, activists said, a new blow to a ceasefire declared by peace envoy Kofi Annan a month ago and which U.N. monitoring mission on the ground are observing.",156,174,monitoring mission,0,1,1
3OEWW2KGQJCHVF9LDF3FEAV3B7GDOQ,"Shelling began on Sunday and intensified overnight, activists said, a new blow to a ceasefire declared by peace envoy Kofi Annan a month ago and which U.N. monitoring mission on the ground are observing.",182,188,ground,1,0,1
3OEWW2KGQJCHVF9LDF3FEAV3B7GDOQ,"Shelling began on Sunday and intensified overnight, activists said, a new blow to a ceasefire declared by peace envoy Kofi Annan a month ago and which U.N. monitoring mission on the ground are observing.",193,202,observing,1,0,1
32L724R85LLGOQ18KTH5U7G6EUNIP8,"The children's father was separated from Thomas but still lives in Brevard County, according to Lt Goodyear.",26,35,separated,9,3,12
32L724R85LLGOQ18KTH5U7G6EUNIP8,"The children's father was separated from Thomas but still lives in Brevard County, according to Lt Goodyear.",26,47,separated from Thomas,0,1,1
32L724R85LLGOQ18KTH5U7G6EUNIP8,"The children's father was separated from Thomas but still lives in Brevard County, according to Lt Goodyear.",83,92,according,1,0,1
32L724R85LLGOQ18KTH5U7G6EUNIP8,"Police have found the body of a young woman near to an observatory in Merseyside Police made the discovery at Bidston Hill observatory near Birkenhead, Merseyside, at about 5.30pm on Saturday following a call from a concerned member of the public.",49,66,to an observatory,0,1,1
32L724R85LLGOQ18KTH5U7G6EUNIP8,"Police have found the body of a young woman near to an observatory in Merseyside Police made the discovery at Bidston Hill observatory near Birkenhead, Merseyside, at about 5.30pm on Saturday following a call from a concerned member of the public.",55,66,observatory,10,9,19
32L724R85LLGOQ18KTH5U7G6EUNIP8,"Police have found the body of a young woman near to an observatory in Merseyside Police made the discovery at Bidston Hill observatory near Birkenhead, Merseyside, at about 5.30pm on Saturday following a call from a concerned member of the public.",88,106,made the discovery,0,1,1
32L724R85LLGOQ18KTH5U7G6EUNIP8,"Police have found the body of a young woman near to an observatory in Merseyside Police made the discovery at Bidston Hill observatory near Birkenhead, Merseyside, at about 5.30pm on Saturday following a call from a concerned member of the public.",97,106,discovery,2,3,5
32L724R85LLGOQ18KTH5U7G6EUNIP8,"Police have found the body of a young woman near to an observatory in Merseyside Police made the discovery at Bidston Hill observatory near Birkenhead, Merseyside, at about 5.30pm on Saturday following a call from a concerned member of the public.",97,122,discovery at Bidston Hill,0,1,1
32L724R85LLGOQ18KTH5U7G6EUNIP8,"Police have found the body of a young woman near to an observatory in Merseyside Police made the discovery at Bidston Hill observatory near Birkenhead, Merseyside, at about 5.30pm on Saturday following a call from a concerned member of the public.",123,134,observatory,2,1,3
32L724R85LLGOQ18KTH5U7G6EUNIP8,"Police have found the body of a young woman near to an observatory in Merseyside Police made the discovery at Bidston Hill observatory near Birkenhead, Merseyside, at about 5.30pm on Saturday following a call from a concerned member of the public.",192,208,following a call,0,1,1
32L724R85LLGOQ18KTH5U7G6EUNIP8,"Police have found the body of a young woman near to an observatory in Merseyside Police made the discovery at Bidston Hill observatory near Birkenhead, Merseyside, at about 5.30pm on Saturday following a call from a concerned member of the public.",216,225,concerned,4,10,14
32L724R85LLGOQ18KTH5U7G6EUNIP8,"Police have found the body of a young woman near to an observatory in Merseyside Police made the discovery at Bidston Hill observatory near Birkenhead, Merseyside, at about 5.30pm on Saturday following a call from a concerned member of the public.",216,246,concerned member of the public,2,0,2
32L724R85LLGOQ18KTH5U7G6EUNIP8,"An 18-year-old man from Moreton, Wirral, has been arrested on suspicion of murder.",50,58,arrested,0,1,1
32L724R85LLGOQ18KTH5U7G6EUNIP8,"An 18-year-old man from Moreton, Wirral, has been arrested on suspicion of murder.",62,71,suspicion,10,9,19
32L724R85LLGOQ18KTH5U7G6EUNIP8,"An 18-year-old man from Moreton, Wirral, has been arrested on suspicion of murder.",62,81,suspicion of murder,1,3,4
32L724R85LLGOQ18KTH5U7G6EUNIP8,"An 18-year-old man from Moreton, Wirral, has been arrested on suspicion of murder.",75,81,murder,1,0,1
32L724R85LLGOQ18KTH5U7G6EUNIP8,"The victim, believed to be in her late teens, has yet to be formally identified, Merseyside Police said.",4,10,victim,2,5,7
32L724R85LLGOQ18KTH5U7G6EUNIP8,"The victim, believed to be in her late teens, has yet to be formally identified, Merseyside Police said.",12,44,believed to be in her late teens,0,1,1
32L724R85LLGOQ18KTH5U7G6EUNIP8,"The victim, believed to be in her late teens, has yet to be formally identified, Merseyside Police said.",30,44,her late teens,0,1,1
32L724R85LLGOQ18KTH5U7G6EUNIP8,"The victim, believed to be in her late teens, has yet to be formally identified, Merseyside Police said.",34,44,late teens,1,0,1
32L724R85LLGOQ18KTH5U7G6EUNIP8,"The victim, believed to be in her late teens, has yet to be formally identified, Merseyside Police said.",39,44,teens,0,1,1
32L724R85LLGOQ18KTH5U7G6EUNIP8,"The victim, believed to be in her late teens, has yet to be formally identified, Merseyside Police said.",60,68,formally,1,0,1
32L724R85LLGOQ18KTH5U7G6EUNIP8,"The victim, believed to be in her late teens, has yet to be formally identified, Merseyside Police said.",60,79,formally identified,4,3,7
32L724R85LLGOQ18KTH5U7G6EUNIP8,"The victim, believed to be in her late teens, has yet to be formally identified, Merseyside Police said.",69,79,identified,2,5,7
32L724R85LLGOQ18KTH5U7G6EUNIP8,A post-mortem examination to establish the cause of death is expected to take place.,2,13,post-mortem,6,7,13
32L724R85LLGOQ18KTH5U7G6EUNIP8,A post-mortem examination to establish the cause of death is expected to take place.,2,25,post-mortem examination,5,1,6
32L724R85LLGOQ18KTH5U7G6EUNIP8,A post-mortem examination to establish the cause of death is expected to take place.,14,25,examination,1,0,1
32L724R85LLGOQ18KTH5U7G6EUNIP8,A post-mortem examination to establish the cause of death is expected to take place.,29,38,establish,1,4,5
32L724R85LLGOQ18KTH5U7G6EUNIP8,A post-mortem examination to establish the cause of death is expected to take place.,29,57,establish the cause of death,0,1,1
32L724R85LLGOQ18KTH5U7G6EUNIP8,A post-mortem examination to establish the cause of death is expected to take place.,61,69,expected,0,2,2
32L724R85LLGOQ18KTH5U7G6EUNIP8,"Police are appealing for information about anyone seen acting suspiciously lately at Bidston Hill, Bidston, to come forward.",11,20,appealing,7,7,14
32L724R85LLGOQ18KTH5U7G6EUNIP8,"Police are appealing for information about anyone seen acting suspiciously lately at Bidston Hill, Bidston, to come forward.",11,36,appealing for information,0,1,1
32L724R85LLGOQ18KTH5U7G6EUNIP8,"Police are appealing for information about anyone seen acting suspiciously lately at Bidston Hill, Bidston, to come forward.",25,36,information,2,1,3
32L724R85LLGOQ18KTH5U7G6EUNIP8,"Police are appealing for information about anyone seen acting suspiciously lately at Bidston Hill, Bidston, to come forward.",55,74,acting suspiciously,1,1,2
32L724R85LLGOQ18KTH5U7G6EUNIP8,"Police are appealing for information about anyone seen acting suspiciously lately at Bidston Hill, Bidston, to come forward.",62,74,suspiciously,10,5,15
32L724R85LLGOQ18KTH5U7G6EUNIP8,"Police are appealing for information about anyone seen acting suspiciously lately at Bidston Hill, Bidston, to come forward.",116,123,forward,0,1,1
30P8I9JKOIMHHM3PZL7ABQ1JVWI5V6,Goodyear said that this was not the first time police were called to the house.,0,8,Goodyear,1,1,2
30P8I9JKOIMHHM3PZL7ABQ1JVWI5V6,Deupities said a neighbor had previously called 911 due to a domestic abuse.,0,9,Deupities,6,7,13
30P8I9JKOIMHHM3PZL7ABQ1JVWI5V6,Deupities said a neighbor had previously called 911 due to a domestic abuse.,17,25,neighbor,1,2,3
30P8I9JKOIMHHM3PZL7ABQ1JVWI5V6,Deupities said a neighbor had previously called 911 due to a domestic abuse.,30,40,previously,3,2,5
30P8I9JKOIMHHM3PZL7ABQ1JVWI5V6,Deupities said a neighbor had previously called 911 due to a domestic abuse.,61,69,domestic,4,1,5
30P8I9JKOIMHHM3PZL7ABQ1JVWI5V6,Deupities said a neighbor had previously called 911 due to a domestic abuse.,61,75,domestic abuse,6,5,11
30P8I9JKOIMHHM3PZL7ABQ1JVWI5V6,Deupities said a neighbor had previously called 911 due to a domestic abuse.,70,75,abuse,0,4,4
30P8I9JKOIMHHM3PZL7ABQ1JVWI5V6,Travis St. Peter lived on the same block as Thomas and her children.,35,40,block,1,1,2
30P8I9JKOIMHHM3PZL7ABQ1JVWI5V6,He said they were trouble makers who would shoot BB guns and lighting fireworks.,18,32,trouble makers,1,1,2
30P8I9JKOIMHHM3PZL7ABQ1JVWI5V6,He said they were trouble makers who would shoot BB guns and lighting fireworks.,49,56,BB guns,0,2,2
30P8I9JKOIMHHM3PZL7ABQ1JVWI5V6,He said they were trouble makers who would shoot BB guns and lighting fireworks.,61,69,lighting,0,1,1
30P8I9JKOIMHHM3PZL7ABQ1JVWI5V6,He said they were trouble makers who would shoot BB guns and lighting fireworks.,61,79,lighting fireworks,0,1,1
30P8I9JKOIMHHM3PZL7ABQ1JVWI5V6,He said they were trouble makers who would shoot BB guns and lighting fireworks.,70,79,fireworks,0,5,5
30P8I9JKOIMHHM3PZL7ABQ1JVWI5V6,"The guy had to board up his windows because they always, basically destroyed his house, said St. Travis, reported WFTV.",5,8,guy,0,1,1
30P8I9JKOIMHHM3PZL7ABQ1JVWI5V6,"The guy had to board up his windows because they always, basically destroyed his house, said St. Travis, reported WFTV.",13,36,to board up his windows,0,1,1
30P8I9JKOIMHHM3PZL7ABQ1JVWI5V6,"The guy had to board up his windows because they always, basically destroyed his house, said St. Travis, reported WFTV.",16,21,board,1,2,3
30P8I9JKOIMHHM3PZL7ABQ1JVWI5V6,"The guy had to board up his windows because they always, basically destroyed his house, said St. Travis, reported WFTV.",16,24,board up,1,3,4
30P8I9JKOIMHHM3PZL7ABQ1JVWI5V6,"The guy had to board up his windows because they always, basically destroyed his house, said St. Travis, reported WFTV.",58,67,basically,1,1,2
30P8I9JKOIMHHM3PZL7ABQ1JVWI5V6,"The guy had to board up his windows because they always, basically destroyed his house, said St. Travis, reported WFTV.",68,77,destroyed,2,1,3
30P8I9JKOIMHHM3PZL7ABQ1JVWI5V6,"You always hear the mom's yelling at midnight and stuff.""",26,33,yelling,3,5,8
30P8I9JKOIMHHM3PZL7ABQ1JVWI5V6,"You always hear the mom's yelling at midnight and stuff.""",37,55,midnight and stuff,0,1,1
30P8I9JKOIMHHM3PZL7ABQ1JVWI5V6,"You always hear the mom's yelling at midnight and stuff.""",50,55,stuff,1,4,5
30P8I9JKOIMHHM3PZL7ABQ1JVWI5V6,"Deputies said that the father of the children, who does not live with the family, was notified of the incident.",0,8,Deputies,2,0,2
30P8I9JKOIMHHM3PZL7ABQ1JVWI5V6,"Deputies said that the father of the children, who does not live with the family, was notified of the incident.",86,94,notified,7,5,12
30P8I9JKOIMHHM3PZL7ABQ1JVWI5V6,"Deputies said that the father of the children, who does not live with the family, was notified of the incident.",86,110,notified of the incident,2,0,2
30P8I9JKOIMHHM3PZL7ABQ1JVWI5V6,"Deputies said that the father of the children, who does not live with the family, was notified of the incident.",102,110,incident,4,3,7
30P8I9JKOIMHHM3PZL7ABQ1JVWI5V6,Reports indicate that he had a difficult time composing himself as investigators interviewed him.,8,16,indicate,6,2,8
30P8I9JKOIMHHM3PZL7ABQ1JVWI5V6,Reports indicate that he had a difficult time composing himself as investigators interviewed him.,31,40,difficult,0,1,1
30P8I9JKOIMHHM3PZL7ABQ1JVWI5V6,Reports indicate that he had a difficult time composing himself as investigators interviewed him.,31,45,difficult time,1,0,1
30P8I9JKOIMHHM3PZL7ABQ1JVWI5V6,Reports indicate that he had a difficult time composing himself as investigators interviewed him.,46,55,composing,10,9,19
30P8I9JKOIMHHM3PZL7ABQ1JVWI5V6,Reports indicate that he had a difficult time composing himself as investigators interviewed him.,46,63,composing himself,2,0,2
30P8I9JKOIMHHM3PZL7ABQ1JVWI5V6,Reports indicate that he had a difficult time composing himself as investigators interviewed him.,67,80,investigators,6,3,9
30P8I9JKOIMHHM3PZL7ABQ1JVWI5V6,Reports indicate that he had a difficult time composing himself as investigators interviewed him.,67,92,investigators interviewed,1,1,2
30P8I9JKOIMHHM3PZL7ABQ1JVWI5V6,Reports indicate that he had a difficult time composing himself as investigators interviewed him.,81,92,interviewed,1,1,2
3X0EMNLXEPQLAWL8J0GO9W60MWJPVC,"It has been an ongoing problem on our street with them, Hudson said.",16,23,ongoing,6,7,13
3X0EMNLXEPQLAWL8J0GO9W60MWJPVC,"It has been an ongoing problem on our street with them, Hudson said.",16,31,ongoing problem,1,1,2
3X0EMNLXEPQLAWL8J0GO9W60MWJPVC,Goodyear said Jaxs Johnson had recently been arrested on a domestic violence charge.,0,8,Goodyear,1,0,1
3X0EMNLXEPQLAWL8J0GO9W60MWJPVC,Goodyear said Jaxs Johnson had recently been arrested on a domestic violence charge.,45,53,arrested,1,1,2
3X0EMNLXEPQLAWL8J0GO9W60MWJPVC,Goodyear said Jaxs Johnson had recently been arrested on a domestic violence charge.,59,67,domestic,7,2,9
3X0EMNLXEPQLAWL8J0GO9W60MWJPVC,Goodyear said Jaxs Johnson had recently been arrested on a domestic violence charge.,59,76,domestic violence,3,4,7
3X0EMNLXEPQLAWL8J0GO9W60MWJPVC,Goodyear said Jaxs Johnson had recently been arrested on a domestic violence charge.,59,83,domestic violence charge,3,1,4
3X0EMNLXEPQLAWL8J0GO9W60MWJPVC,Goodyear said Jaxs Johnson had recently been arrested on a domestic violence charge.,68,76,violence,1,0,1
3X0EMNLXEPQLAWL8J0GO9W60MWJPVC,Goodyear said Jaxs Johnson had recently been arrested on a domestic violence charge.,77,83,charge,0,1,1
3X0EMNLXEPQLAWL8J0GO9W60MWJPVC,He said he didn't know if the boy had been accused of hitting his mother or causing damage at the house.,43,50,accused,7,6,13
3X0EMNLXEPQLAWL8J0GO9W60MWJPVC,He said he didn't know if the boy had been accused of hitting his mother or causing damage at the house.,43,53,accused of,0,1,1
3X0EMNLXEPQLAWL8J0GO9W60MWJPVC,He said he didn't know if the boy had been accused of hitting his mother or causing damage at the house.,43,61,accused of hitting,0,1,1
3X0EMNLXEPQLAWL8J0GO9W60MWJPVC,He said he didn't know if the boy had been accused of hitting his mother or causing damage at the house.,54,61,hitting,0,1,1
3X0EMNLXEPQLAWL8J0GO9W60MWJPVC,He said he didn't know if the boy had been accused of hitting his mother or causing damage at the house.,84,90,damage,0,1,1
3X0EMNLXEPQLAWL8J0GO9W60MWJPVC,"Austin Lewis, a 16-year-old classmate of Pebbles Johnson, said the family ""had problems like everybody else but nothing that drastic.""",28,37,classmate,0,1,1
3X0EMNLXEPQLAWL8J0GO9W60MWJPVC,"Austin Lewis, a 16-year-old classmate of Pebbles Johnson, said the family ""had problems like everybody else but nothing that drastic.""",125,132,drastic,10,10,20
3X0EMNLXEPQLAWL8J0GO9W60MWJPVC,"He described Pebbles Johnson as ""very loving and caring.""",3,12,described,1,2,3
3X0EMNLXEPQLAWL8J0GO9W60MWJPVC,"He described Pebbles Johnson as ""very loving and caring.""",13,20,Pebbles,0,1,1
3X0EMNLXEPQLAWL8J0GO9W60MWJPVC,"He described Pebbles Johnson as ""very loving and caring.""",49,55,caring,0,1,1
3X0EMNLXEPQLAWL8J0GO9W60MWJPVC,"Didn't let anything affect her.	21	27	affect	3	1	4
3X0EMNLXEPQLAWL8J0GO9W60MWJPVC	She was always in a good mood.",25,29,mood,0,1,1
3X0EMNLXEPQLAWL8J0GO9W60MWJPVC,"A pastor at the church the family attended described it as ""normal stuff.""",2,8,pastor,4,0,4
3X0EMNLXEPQLAWL8J0GO9W60MWJPVC,"A pastor at the church the family attended described it as ""normal stuff.""",34,42,attended,0,1,1
3X0EMNLXEPQLAWL8J0GO9W60MWJPVC,"A pastor at the church the family attended described it as ""normal stuff.""",34,52,attended described,1,0,1
3X0EMNLXEPQLAWL8J0GO9W60MWJPVC,"A pastor at the church the family attended described it as ""normal stuff.""",43,52,described,1,0,1
3X0EMNLXEPQLAWL8J0GO9W60MWJPVC,"A pastor at the church the family attended described it as ""normal stuff.""",60,72,normal stuff,0,2,2
3X0EMNLXEPQLAWL8J0GO9W60MWJPVC,"A pastor at the church the family attended described it as ""normal stuff.""",67,72,stuff,0,1,1
3X0EMNLXEPQLAWL8J0GO9W60MWJPVC,"I think he was punching some walls or something, said Jarvis Wash, pastor of the Real Church in Rockledge, Fla.",16,24,punching,4,6,10
3X0EMNLXEPQLAWL8J0GO9W60MWJPVC,"I think he was punching some walls or something, said Jarvis Wash, pastor of the Real Church in Rockledge, Fla.",16,35,punching some walls,0,1,1
3X0EMNLXEPQLAWL8J0GO9W60MWJPVC,"I think he was punching some walls or something, said Jarvis Wash, pastor of the Real Church in Rockledge, Fla.",98,107,Rockledge,0,1,1
3X0EMNLXEPQLAWL8J0GO9W60MWJPVC,"I think he was punching some walls or something, said Jarvis Wash, pastor of the Real Church in Rockledge, Fla.",109,112,Fla,1,0,1
3PMR2DOWOO2IN9KAFP6N2016HBX543,"The goal I set - to defeat al-Qaeda, and deny it a chance to rebuild - is now within our reach.''",4,8,goal,0,1,1
3PMR2DOWOO2IN9KAFP6N2016HBX543,"The goal I set - to defeat al-Qaeda, and deny it a chance to rebuild - is now within our reach.''",20,26,defeat,0,3,3
3PMR2DOWOO2IN9KAFP6N2016HBX543,"The goal I set - to defeat al-Qaeda, and deny it a chance to rebuild - is now within our reach.''",41,45,deny,0,3,3
3PMR2DOWOO2IN9KAFP6N2016HBX543,"The goal I set - to defeat al-Qaeda, and deny it a chance to rebuild - is now within our reach.''",61,68,rebuild,1,1,2
3PMR2DOWOO2IN9KAFP6N2016HBX543,"The goal I set - to defeat al-Qaeda, and deny it a chance to rebuild - is now within our reach.''",89,94,reach,0,2,2
3PMR2DOWOO2IN9KAFP6N2016HBX543,"Asserting that the US had largely achieved its military goals, Mr Obama said Afghans were ready to take responsibility for their own security, a transition that will start in earnest next year when US and NATO troops step back from a combat role to training and counter-terrorism operations.",0,9,Asserting,10,10,20
3PMR2DOWOO2IN9KAFP6N2016HBX543,"Asserting that the US had largely achieved its military goals, Mr Obama said Afghans were ready to take responsibility for their own security, a transition that will start in earnest next year when US and NATO troops step back from a combat role to training and counter-terrorism operations.",34,42,achieved,2,1,3
3PMR2DOWOO2IN9KAFP6N2016HBX543,"Asserting that the US had largely achieved its military goals, Mr Obama said Afghans were ready to take responsibility for their own security, a transition that will start in earnest next year when US and NATO troops step back from a combat role to training and counter-terrorism operations.",133,141,security,1,0,1
3PMR2DOWOO2IN9KAFP6N2016HBX543,"Asserting that the US had largely achieved its military goals, Mr Obama said Afghans were ready to take responsibility for their own security, a transition that will start in earnest next year when US and NATO troops step back from a combat role to training and counter-terrorism operations.",145,155,transition,10,7,17
3PMR2DOWOO2IN9KAFP6N2016HBX543,"Asserting that the US had largely achieved its military goals, Mr Obama said Afghans were ready to take responsibility for their own security, a transition that will start in earnest next year when US and NATO troops step back from a combat role to training and counter-terrorism operations.",172,182,in earnest,2,0,2
3PMR2DOWOO2IN9KAFP6N2016HBX543,"Asserting that the US had largely achieved its military goals, Mr Obama said Afghans were ready to take responsibility for their own security, a transition that will start in earnest next year when US and NATO troops step back from a combat role to training and counter-terrorism operations.",175,182,earnest,8,6,14
3PMR2DOWOO2IN9KAFP6N2016HBX543,"Asserting that the US had largely achieved its military goals, Mr Obama said Afghans were ready to take responsibility for their own security, a transition that will start in earnest next year when US and NATO troops step back from a combat role to training and counter-terrorism operations.",210,216,troops,0,1,1
3PMR2DOWOO2IN9KAFP6N2016HBX543,"Asserting that the US had largely achieved its military goals, Mr Obama said Afghans were ready to take responsibility for their own security, a transition that will start in earnest next year when US and NATO troops step back from a combat role to training and counter-terrorism operations.",217,226,step back,0,1,1
3PMR2DOWOO2IN9KAFP6N2016HBX543,"Asserting that the US had largely achieved its military goals, Mr Obama said Afghans were ready to take responsibility for their own security, a transition that will start in earnest next year when US and NATO troops step back from a combat role to training and counter-terrorism operations.",234,240,combat,1,3,4
3PMR2DOWOO2IN9KAFP6N2016HBX543,"Asserting that the US had largely achieved its military goals, Mr Obama said Afghans were ready to take responsibility for their own security, a transition that will start in earnest next year when US and NATO troops step back from a combat role to training and counter-terrorism operations.",234,245,combat role,1,2,3
3PMR2DOWOO2IN9KAFP6N2016HBX543,"Asserting that the US had largely achieved its military goals, Mr Obama said Afghans were ready to take responsibility for their own security, a transition that will start in earnest next year when US and NATO troops step back from a combat role to training and counter-terrorism operations.",262,279,counter-terrorism,6,8,14
3PMR2DOWOO2IN9KAFP6N2016HBX543,"Asserting that the US had largely achieved its military goals, Mr Obama said Afghans were ready to take responsibility for their own security, a transition that will start in earnest next year when US and NATO troops step back from a combat role to training and counter-terrorism operations.",262,290,counter-terrorism operations,6,1,7
3PMR2DOWOO2IN9KAFP6N2016HBX543,"Asserting that the US had largely achieved its military goals, Mr Obama said Afghans were ready to take responsibility for their own security, a transition that will start in earnest next year when US and NATO troops step back from a combat role to training and counter-terrorism operations.",280,290,operations,2,0,2
3PMR2DOWOO2IN9KAFP6N2016HBX543,"Insurgents killed at least seven people in an attack targeting  foreigners in Kabul Wednesday, just two hours after U.S. President  Barack Obama left Afghanistan following a brief unannounced visit.",0,10,Insurgents,10,9,19
3PMR2DOWOO2IN9KAFP6N2016HBX543,"Insurgents killed at least seven people in an attack targeting  foreigners in Kabul Wednesday, just two hours after U.S. President  Barack Obama left Afghanistan following a brief unannounced visit.",53,62,targeting,0,4,4
3PMR2DOWOO2IN9KAFP6N2016HBX543,"Insurgents killed at least seven people in an attack targeting  foreigners in Kabul Wednesday, just two hours after U.S. President  Barack Obama left Afghanistan following a brief unannounced visit.",64,74,foreigners,1,0,1
3PMR2DOWOO2IN9KAFP6N2016HBX543,"Insurgents killed at least seven people in an attack targeting  foreigners in Kabul Wednesday, just two hours after U.S. President  Barack Obama left Afghanistan following a brief unannounced visit.",174,191,brief unannounced,1,0,1
3PMR2DOWOO2IN9KAFP6N2016HBX543,"Insurgents killed at least seven people in an attack targeting  foreigners in Kabul Wednesday, just two hours after U.S. President  Barack Obama left Afghanistan following a brief unannounced visit.",180,191,unannounced,6,3,9
3PMR2DOWOO2IN9KAFP6N2016HBX543,The Taliban claimed responsibility for the assault on the heavily  secured compound housing hundreds of international workers on the  eastern outskirts of the capital.,12,19,claimed,0,1,1
3PMR2DOWOO2IN9KAFP6N2016HBX543,The Taliban claimed responsibility for the assault on the heavily  secured compound housing hundreds of international workers on the  eastern outskirts of the capital.,20,34,responsibility,2,0,2
3PMR2DOWOO2IN9KAFP6N2016HBX543,The Taliban claimed responsibility for the assault on the heavily  secured compound housing hundreds of international workers on the  eastern outskirts of the capital.,43,50,assault,1,7,8
3PMR2DOWOO2IN9KAFP6N2016HBX543,The Taliban claimed responsibility for the assault on the heavily  secured compound housing hundreds of international workers on the  eastern outskirts of the capital.,58,74,heavily  secured,1,0,1
3PMR2DOWOO2IN9KAFP6N2016HBX543,The Taliban claimed responsibility for the assault on the heavily  secured compound housing hundreds of international workers on the  eastern outskirts of the capital.,58,83,heavily  secured compound,1,0,1
3PMR2DOWOO2IN9KAFP6N2016HBX543,The Taliban claimed responsibility for the assault on the heavily  secured compound housing hundreds of international workers on the  eastern outskirts of the capital.,67,74,secured,0,1,1
3PMR2DOWOO2IN9KAFP6N2016HBX543,The Taliban claimed responsibility for the assault on the heavily  secured compound housing hundreds of international workers on the  eastern outskirts of the capital.,75,83,compound,6,1,7
3PMR2DOWOO2IN9KAFP6N2016HBX543,The Taliban claimed responsibility for the assault on the heavily  secured compound housing hundreds of international workers on the  eastern outskirts of the capital.,75,91,compound housing,0,1,1
3PMR2DOWOO2IN9KAFP6N2016HBX543,The Taliban claimed responsibility for the assault on the heavily  secured compound housing hundreds of international workers on the  eastern outskirts of the capital.,84,91,housing,0,1,1
3PMR2DOWOO2IN9KAFP6N2016HBX543,The Taliban claimed responsibility for the assault on the heavily  secured compound housing hundreds of international workers on the  eastern outskirts of the capital.,104,117,international,2,0,2
3PMR2DOWOO2IN9KAFP6N2016HBX543,The Taliban claimed responsibility for the assault on the heavily  secured compound housing hundreds of international workers on the  eastern outskirts of the capital.,134,151,eastern outskirts,0,1,1
3PMR2DOWOO2IN9KAFP6N2016HBX543,The Taliban claimed responsibility for the assault on the heavily  secured compound housing hundreds of international workers on the  eastern outskirts of the capital.,142,151,outskirts,10,7,17
3PMR2DOWOO2IN9KAFP6N2016HBX543,The Taliban claimed responsibility for the assault on the heavily  secured compound housing hundreds of international workers on the  eastern outskirts of the capital.,159,166,capital,1,0,1
39HYCOOPKOMTVCO90ZO2M66YG71DMB,"Rami Abdul-Rahman, who heads the Observatory, said the rebels were able to destroy several army vehicles during the clashes and kill soldiers.",33,44,Observatory,9,5,14
39HYCOOPKOMTVCO90ZO2M66YG71DMB,"Rami Abdul-Rahman, who heads the Observatory, said the rebels were able to destroy several army vehicles during the clashes and kill soldiers.",55,61,rebels,0,1,1
39HYCOOPKOMTVCO90ZO2M66YG71DMB,"Rami Abdul-Rahman, who heads the Observatory, said the rebels were able to destroy several army vehicles during the clashes and kill soldiers.",96,104,vehicles,0,1,1
39HYCOOPKOMTVCO90ZO2M66YG71DMB,"Rami Abdul-Rahman, who heads the Observatory, said the rebels were able to destroy several army vehicles during the clashes and kill soldiers.",116,123,clashes,4,3,7
39HYCOOPKOMTVCO90ZO2M66YG71DMB,The accounts could not be independently confirmed.,4,12,accounts,1,0,1
39HYCOOPKOMTVCO90ZO2M66YG71DMB,The accounts could not be independently confirmed.,26,39,independently,5,1,6
39HYCOOPKOMTVCO90ZO2M66YG71DMB,The accounts could not be independently confirmed.,26,49,independently confirmed,5,2,7
39HYCOOPKOMTVCO90ZO2M66YG71DMB,"The attack on Rastan came after Syrian forces killed at least five people when they raided a Sunni farming village in Hama province, torching homes and looting shops in what appeared to be a sign of worsening relations among the country's religious groups.",84,90,raided,3,3,6
39HYCOOPKOMTVCO90ZO2M66YG71DMB,"The attack on Rastan came after Syrian forces killed at least five people when they raided a Sunni farming village in Hama province, torching homes and looting shops in what appeared to be a sign of worsening relations among the country's religious groups.",93,98,Sunni,0,1,1
39HYCOOPKOMTVCO90ZO2M66YG71DMB,"The attack on Rastan came after Syrian forces killed at least five people when they raided a Sunni farming village in Hama province, torching homes and looting shops in what appeared to be a sign of worsening relations among the country's religious groups.",123,131,province,2,1,3
39HYCOOPKOMTVCO90ZO2M66YG71DMB,"The attack on Rastan came after Syrian forces killed at least five people when they raided a Sunni farming village in Hama province, torching homes and looting shops in what appeared to be a sign of worsening relations among the country's religious groups.",133,141,torching,5,7,12
39HYCOOPKOMTVCO90ZO2M66YG71DMB,"The attack on Rastan came after Syrian forces killed at least five people when they raided a Sunni farming village in Hama province, torching homes and looting shops in what appeared to be a sign of worsening relations among the country's religious groups.",133,147,torching homes,2,1,3
39HYCOOPKOMTVCO90ZO2M66YG71DMB,"The attack on Rastan came after Syrian forces killed at least five people when they raided a Sunni farming village in Hama province, torching homes and looting shops in what appeared to be a sign of worsening relations among the country's religious groups.",152,159,looting,6,9,15
39HYCOOPKOMTVCO90ZO2M66YG71DMB,"The attack on Rastan came after Syrian forces killed at least five people when they raided a Sunni farming village in Hama province, torching homes and looting shops in what appeared to be a sign of worsening relations among the country's religious groups.",152,165,looting shops,3,1,4
39HYCOOPKOMTVCO90ZO2M66YG71DMB,"The attack on Rastan came after Syrian forces killed at least five people when they raided a Sunni farming village in Hama province, torching homes and looting shops in what appeared to be a sign of worsening relations among the country's religious groups.",199,208,worsening,5,4,9
39HYCOOPKOMTVCO90ZO2M66YG71DMB,"The attack on Rastan came after Syrian forces killed at least five people when they raided a Sunni farming village in Hama province, torching homes and looting shops in what appeared to be a sign of worsening relations among the country's religious groups.",199,218,worsening relations,3,1,4
39HYCOOPKOMTVCO90ZO2M66YG71DMB,"The attack on Rastan came after Syrian forces killed at least five people when they raided a Sunni farming village in Hama province, torching homes and looting shops in what appeared to be a sign of worsening relations among the country's religious groups.",209,218,relations,1,0,1
39HYCOOPKOMTVCO90ZO2M66YG71DMB,"Syria is overwhelmingly Sunni, but President Bashar Assad and the ruling elite belong to the minatory Alawite sect.",9,23,overwhelmingly,9,8,17
39HYCOOPKOMTVCO90ZO2M66YG71DMB,"Syria is overwhelmingly Sunni, but President Bashar Assad and the ruling elite belong to the minatory Alawite sect.",24,29,Sunni,0,1,1
39HYCOOPKOMTVCO90ZO2M66YG71DMB,"Syria is overwhelmingly Sunni, but President Bashar Assad and the ruling elite belong to the minatory Alawite sect.",66,72,ruling,0,1,1
39HYCOOPKOMTVCO90ZO2M66YG71DMB,"Syria is overwhelmingly Sunni, but President Bashar Assad and the ruling elite belong to the minatory Alawite sect.",66,78,ruling elite,2,2,4
39HYCOOPKOMTVCO90ZO2M66YG71DMB,"Syria is overwhelmingly Sunni, but President Bashar Assad and the ruling elite belong to the minatory Alawite sect.",73,78,elite,5,3,8
39HYCOOPKOMTVCO90ZO2M66YG71DMB,"Syria is overwhelmingly Sunni, but President Bashar Assad and the ruling elite belong to the minatory Alawite sect.",93,101,minatory,10,4,14
39HYCOOPKOMTVCO90ZO2M66YG71DMB,"Syria is overwhelmingly Sunni, but President Bashar Assad and the ruling elite belong to the minatory Alawite sect.",93,114,minatory Alawite sect,2,0,2
39HYCOOPKOMTVCO90ZO2M66YG71DMB,"Syria is overwhelmingly Sunni, but President Bashar Assad and the ruling elite belong to the minatory Alawite sect.",102,109,Alawite,0,1,1
39HYCOOPKOMTVCO90ZO2M66YG71DMB,"Syria is overwhelmingly Sunni, but President Bashar Assad and the ruling elite belong to the minatory Alawite sect.",102,114,Alawite sect,1,1,2
39HYCOOPKOMTVCO90ZO2M66YG71DMB,"Syria is overwhelmingly Sunni, but President Bashar Assad and the ruling elite belong to the minatory Alawite sect.",110,114,sect,5,0,5
39HYCOOPKOMTVCO90ZO2M66YG71DMB,"Sectarian tensions appear to be growing in some areas, adding a dangerous new element to the violence.",0,9,Sectarian,6,0,6
39HYCOOPKOMTVCO90ZO2M66YG71DMB,"Sectarian tensions appear to be growing in some areas, adding a dangerous new element to the violence.",0,18,Sectarian tensions,2,3,5
39HYCOOPKOMTVCO90ZO2M66YG71DMB,"Sectarian tensions appear to be growing in some areas, adding a dangerous new element to the violence.",10,18,tensions,1,0,1
39HYCOOPKOMTVCO90ZO2M66YG71DMB,"Sectarian tensions appear to be growing in some areas, adding a dangerous new element to the violence.",74,85,new element,0,1,1
39HYCOOPKOMTVCO90ZO2M66YG71DMB,"Sectarian tensions appear to be growing in some areas, adding a dangerous new element to the violence.",78,85,element,2,0,2
39HYCOOPKOMTVCO90ZO2M66YG71DMB,"Many Syrians accuse Assad of exploiting that divide by unleashing Alawite gunmen known as ""shabiha"" who operate as hired muscle for the regime.",13,19,accuse,1,1,2
39HYCOOPKOMTVCO90ZO2M66YG71DMB,"Many Syrians accuse Assad of exploiting that divide by unleashing Alawite gunmen known as ""shabiha"" who operate as hired muscle for the regime.",29,39,exploiting,8,3,11
39HYCOOPKOMTVCO90ZO2M66YG71DMB,"Many Syrians accuse Assad of exploiting that divide by unleashing Alawite gunmen known as ""shabiha"" who operate as hired muscle for the regime.",55,65,unleashing,6,8,14
39HYCOOPKOMTVCO90ZO2M66YG71DMB,"Many Syrians accuse Assad of exploiting that divide by unleashing Alawite gunmen known as ""shabiha"" who operate as hired muscle for the regime.",55,80,unleashing Alawite gunmen,1,0,1
39HYCOOPKOMTVCO90ZO2M66YG71DMB,"Many Syrians accuse Assad of exploiting that divide by unleashing Alawite gunmen known as ""shabiha"" who operate as hired muscle for the regime.",91,98,shabiha,5,1,6
39HYCOOPKOMTVCO90ZO2M66YG71DMB,"Many Syrians accuse Assad of exploiting that divide by unleashing Alawite gunmen known as ""shabiha"" who operate as hired muscle for the regime.",115,120,hired,0,2,2
39HYCOOPKOMTVCO90ZO2M66YG71DMB,"Many Syrians accuse Assad of exploiting that divide by unleashing Alawite gunmen known as ""shabiha"" who operate as hired muscle for the regime.",115,127,hired muscle,3,3,6
39HYCOOPKOMTVCO90ZO2M66YG71DMB,"Many Syrians accuse Assad of exploiting that divide by unleashing Alawite gunmen known as ""shabiha"" who operate as hired muscle for the regime.",121,127,muscle,1,0,1
39HYCOOPKOMTVCO90ZO2M66YG71DMB,"Many Syrians accuse Assad of exploiting that divide by unleashing Alawite gunmen known as ""shabiha"" who operate as hired muscle for the regime.",136,142,regime,2,0,2
3MA5N0ATTCCXEUOXWIGCZH3FYICKWM,"While the government has taken steps to support banks, analysts say more needs to be done to fix the problem once and for all.",10,20,government,1,0,1
3MA5N0ATTCCXEUOXWIGCZH3FYICKWM,"While the government has taken steps to support banks, analysts say more needs to be done to fix the problem once and for all.",21,36,has taken steps,0,1,1
3MA5N0ATTCCXEUOXWIGCZH3FYICKWM,"While the government has taken steps to support banks, analysts say more needs to be done to fix the problem once and for all.",40,53,support banks,1,0,1
3MA5N0ATTCCXEUOXWIGCZH3FYICKWM,"While the government has taken steps to support banks, analysts say more needs to be done to fix the problem once and for all.",55,63,analysts,10,8,18
3MA5N0ATTCCXEUOXWIGCZH3FYICKWM,"While the government has taken steps to support banks, analysts say more needs to be done to fix the problem once and for all.",93,108,fix the problem,0,1,1
3MA5N0ATTCCXEUOXWIGCZH3FYICKWM,"President Barack Obama made a surprise visit on Tuesday to Afghanistan, where he will sign an agreement outlining the U.S.' role in the country as the decade-long war there winds down.",30,38,surprise,0,1,1
3MA5N0ATTCCXEUOXWIGCZH3FYICKWM,"President Barack Obama made a surprise visit on Tuesday to Afghanistan, where he will sign an agreement outlining the U.S.' role in the country as the decade-long war there winds down.",94,103,agreement,0,4,4
3MA5N0ATTCCXEUOXWIGCZH3FYICKWM,"President Barack Obama made a surprise visit on Tuesday to Afghanistan, where he will sign an agreement outlining the U.S.' role in the country as the decade-long war there winds down.",94,113,agreement outlining,1,0,1
3MA5N0ATTCCXEUOXWIGCZH3FYICKWM,"President Barack Obama made a surprise visit on Tuesday to Afghanistan, where he will sign an agreement outlining the U.S.' role in the country as the decade-long war there winds down.",104,113,outlining,5,4,9
3MA5N0ATTCCXEUOXWIGCZH3FYICKWM,"President Barack Obama made a surprise visit on Tuesday to Afghanistan, where he will sign an agreement outlining the U.S.' role in the country as the decade-long war there winds down.",104,127,outlining the U.S. role,1,1,2
3MA5N0ATTCCXEUOXWIGCZH3FYICKWM,"President Barack Obama made a surprise visit on Tuesday to Afghanistan, where he will sign an agreement outlining the U.S.' role in the country as the decade-long war there winds down.",151,162,decade-long,3,5,8
3MA5N0ATTCCXEUOXWIGCZH3FYICKWM,"President Barack Obama made a surprise visit on Tuesday to Afghanistan, where he will sign an agreement outlining the U.S.' role in the country as the decade-long war there winds down.",151,166,decade-long war,0,1,1
3MA5N0ATTCCXEUOXWIGCZH3FYICKWM,"President Barack Obama made a surprise visit on Tuesday to Afghanistan, where he will sign an agreement outlining the U.S.' role in the country as the decade-long war there winds down.",173,178,winds,0,1,1
3MA5N0ATTCCXEUOXWIGCZH3FYICKWM,"President Barack Obama made a surprise visit on Tuesday to Afghanistan, where he will sign an agreement outlining the U.S.' role in the country as the decade-long war there winds down.",173,183,winds down,3,4,7
3MA5N0ATTCCXEUOXWIGCZH3FYICKWM,"Obama will meet with Afghan President Hamid Karzai to sign a ""strategic partnership"" agreement that will govern the U.S.' involvement in the country until American combat troops are withdrawn by the end of 2014, according to the New York Times.",38,50,Hamid Karzai,1,0,1
3MA5N0ATTCCXEUOXWIGCZH3FYICKWM,"Obama will meet with Afghan President Hamid Karzai to sign a ""strategic partnership"" agreement that will govern the U.S.' involvement in the country until American combat troops are withdrawn by the end of 2014, according to the New York Times.",62,71,strategic,1,1,2
3MA5N0ATTCCXEUOXWIGCZH3FYICKWM,"Obama will meet with Afghan President Hamid Karzai to sign a ""strategic partnership"" agreement that will govern the U.S.' involvement in the country until American combat troops are withdrawn by the end of 2014, according to the New York Times.",62,83,strategic partnership,10,6,16
3MA5N0ATTCCXEUOXWIGCZH3FYICKWM,"Obama will meet with Afghan President Hamid Karzai to sign a ""strategic partnership"" agreement that will govern the U.S.' involvement in the country until American combat troops are withdrawn by the end of 2014, according to the New York Times.",56,87,strategic partnership agreement,0,1,1
3MA5N0ATTCCXEUOXWIGCZH3FYICKWM,"Obama will meet with Afghan President Hamid Karzai to sign a ""strategic partnership"" agreement that will govern the U.S.' involvement in the country until American combat troops are withdrawn by the end of 2014, according to the New York Times.",72,83,partnership,0,1,1
3MA5N0ATTCCXEUOXWIGCZH3FYICKWM,"Obama will meet with Afghan President Hamid Karzai to sign a ""strategic partnership"" agreement that will govern the U.S.' involvement in the country until American combat troops are withdrawn by the end of 2014, according to the New York Times.",105,111,govern,2,0,2
3MA5N0ATTCCXEUOXWIGCZH3FYICKWM,"Obama will meet with Afghan President Hamid Karzai to sign a ""strategic partnership"" agreement that will govern the U.S.' involvement in the country until American combat troops are withdrawn by the end of 2014, according to the New York Times.",122,133,involvement,2,1,3
3MA5N0ATTCCXEUOXWIGCZH3FYICKWM,"Obama will meet with Afghan President Hamid Karzai to sign a ""strategic partnership"" agreement that will govern the U.S.' involvement in the country until American combat troops are withdrawn by the end of 2014, according to the New York Times.",164,170,combat,0,1,1
3MA5N0ATTCCXEUOXWIGCZH3FYICKWM,"Obama will meet with Afghan President Hamid Karzai to sign a ""strategic partnership"" agreement that will govern the U.S.' involvement in the country until American combat troops are withdrawn by the end of 2014, according to the New York Times.",164,177,combat troops,4,1,5
3MA5N0ATTCCXEUOXWIGCZH3FYICKWM,"Obama will meet with Afghan President Hamid Karzai to sign a ""strategic partnership"" agreement that will govern the U.S.' involvement in the country until American combat troops are withdrawn by the end of 2014, according to the New York Times.",171,177,troops,0,1,1
3MA5N0ATTCCXEUOXWIGCZH3FYICKWM,"Obama will meet with Afghan President Hamid Karzai to sign a ""strategic partnership"" agreement that will govern the U.S.' involvement in the country until American combat troops are withdrawn by the end of 2014, according to the New York Times.",182,191,withdrawn,4,6,10
3MA5N0ATTCCXEUOXWIGCZH3FYICKWM,"Obama left the U.S. around 12 a.m. early Tuesday morning and landed at Bagram Air Field at 10:30 p.m. local time, according to a pool report.",61,67,landed,0,1,1
3MA5N0ATTCCXEUOXWIGCZH3FYICKWM,"Obama left the U.S. around 12 a.m. early Tuesday morning and landed at Bagram Air Field at 10:30 p.m. local time, according to a pool report.",71,77,Bagram,1,0,1
3MA5N0ATTCCXEUOXWIGCZH3FYICKWM,"Obama left the U.S. around 12 a.m. early Tuesday morning and landed at Bagram Air Field at 10:30 p.m. local time, according to a pool report.",114,123,according,0,1,1
3MA5N0ATTCCXEUOXWIGCZH3FYICKWM,"Obama left the U.S. around 12 a.m. early Tuesday morning and landed at Bagram Air Field at 10:30 p.m. local time, according to a pool report.",114,126,according to,1,0,1
3MA5N0ATTCCXEUOXWIGCZH3FYICKWM,"Obama left the U.S. around 12 a.m. early Tuesday morning and landed at Bagram Air Field at 10:30 p.m. local time, according to a pool report.",129,133,pool,0,1,1
3MA5N0ATTCCXEUOXWIGCZH3FYICKWM,"Obama left the U.S. around 12 a.m. early Tuesday morning and landed at Bagram Air Field at 10:30 p.m. local time, according to a pool report.",129,140,pool report,10,4,14
3AC6MFV69KJA6ZSU1KXMLTH5NFRHZ8,"This attack was to make clear our reaction to Obama's trip to Afghanistan.	17	30	to make clear	1	0	1
3AC6MFV69KJA6ZSU1KXMLTH5NFRHZ8	This attack was to make clear our reaction to Obama's trip to Afghanistan.",20,30,make clear,2,0,2
3AC6MFV69KJA6ZSU1KXMLTH5NFRHZ8,"This attack was to make clear our reaction to Obama's trip to Afghanistan.	35	43	reaction	2	2	4
3AC6MFV69KJA6ZSU1KXMLTH5NFRHZ8	The message was that instead of signing a strategic partnership deal with Afghanistan, he should think about taking his troops out from Afghanistan and leave it to Afghans to rebuild their country, Taliban spokesman Zabihullah Mujahid told Reuters by telephone from an undisclosed location.",21,28,instead,0,1,1
3AC6MFV69KJA6ZSU1KXMLTH5NFRHZ8,"The message was that instead of signing a strategic partnership deal with Afghanistan, he should think about taking his troops out from Afghanistan and leave it to Afghans to rebuild their country,"" Taliban spokesman Zabihullah Mujahid told Reuters by telephone from an undisclosed location.",42,51,strategic,5,3,8
3AC6MFV69KJA6ZSU1KXMLTH5NFRHZ8,"The message was that instead of signing a strategic partnership deal with Afghanistan, he should think about taking his troops out from Afghanistan and leave it to Afghans to rebuild their country,"" Taliban spokesman Zabihullah Mujahid told Reuters by telephone from an undisclosed location.",42,63,strategic partnership,4,2,6
3AC6MFV69KJA6ZSU1KXMLTH5NFRHZ8,"The message was that instead of signing a strategic partnership deal with Afghanistan, he should think about taking his troops out from Afghanistan and leave it to Afghans to rebuild their country,"" Taliban spokesman Zabihullah Mujahid told Reuters by telephone from an undisclosed location.",42,68,strategic partnership deal,5,3,8
3AC6MFV69KJA6ZSU1KXMLTH5NFRHZ8,"The message was that instead of signing a strategic partnership deal with Afghanistan, he should think about taking his troops out from Afghanistan and leave it to Afghans to rebuild their country,"" Taliban spokesman Zabihullah Mujahid told Reuters by telephone from an undisclosed location.",120,126,troops,0,1,1
3AC6MFV69KJA6ZSU1KXMLTH5NFRHZ8,"The message was that instead of signing a strategic partnership deal with Afghanistan, he should think about taking his troops out from Afghanistan and leave it to Afghans to rebuild their country,"" Taliban spokesman Zabihullah Mujahid told Reuters by telephone from an undisclosed location.",175,182,rebuild,1,4,5
3AC6MFV69KJA6ZSU1KXMLTH5NFRHZ8,"The message was that instead of signing a strategic partnership deal with Afghanistan, he should think about taking his troops out from Afghanistan and leave it to Afghans to rebuild their country,"" Taliban spokesman Zabihullah Mujahid told Reuters by telephone from an undisclosed location.",175,196,rebuild their country,1,0,1
3AC6MFV69KJA6ZSU1KXMLTH5NFRHZ8,"The message was that instead of signing a strategic partnership deal with Afghanistan, he should think about taking his troops out from Afghanistan and leave it to Afghans to rebuild their country,"" Taliban spokesman Zabihullah Mujahid told Reuters by telephone from an undisclosed location.",199,206,Taliban,1,0,1
3AC6MFV69KJA6ZSU1KXMLTH5NFRHZ8,"The message was that instead of signing a strategic partnership deal with Afghanistan, he should think about taking his troops out from Afghanistan and leave it to Afghans to rebuild their country,"" Taliban spokesman Zabihullah Mujahid told Reuters by telephone from an undisclosed location.",207,216,spokesman,3,3,6
3AC6MFV69KJA6ZSU1KXMLTH5NFRHZ8,"The message was that instead of signing a strategic partnership deal with Afghanistan, he should think about taking his troops out from Afghanistan and leave it to Afghans to rebuild their country,"" Taliban spokesman Zabihullah Mujahid told Reuters by telephone from an undisclosed location.",241,248,Reuters,1,1,2
3AC6MFV69KJA6ZSU1KXMLTH5NFRHZ8,"The message was that instead of signing a strategic partnership deal with Afghanistan, he should think about taking his troops out from Afghanistan and leave it to Afghans to rebuild their country,"" Taliban spokesman Zabihullah Mujahid told Reuters by telephone from an undisclosed location.",252,261,telephone,1,0,1
3AC6MFV69KJA6ZSU1KXMLTH5NFRHZ8,"The message was that instead of signing a strategic partnership deal with Afghanistan, he should think about taking his troops out from Afghanistan and leave it to Afghans to rebuild their country,"" Taliban spokesman Zabihullah Mujahid told Reuters by telephone from an undisclosed location.",270,281,undisclosed,9,6,15
3AC6MFV69KJA6ZSU1KXMLTH5NFRHZ8,"The message was that instead of signing a strategic partnership deal with Afghanistan, he should think about taking his troops out from Afghanistan and leave it to Afghans to rebuild their country,"" Taliban spokesman Zabihullah Mujahid told Reuters by telephone from an undisclosed location.",270,290,undisclosed location,5,3,8
3AC6MFV69KJA6ZSU1KXMLTH5NFRHZ8,"But America's Kabul ambassador, Ryan Crocker, said involvement of the Haqqani network - which Washington believes is based in Pakistan's North Waziristan region and which it blames for high-profile attacks in Kabul in April - could not be ruled out.",20,30,ambassador,6,1,7
3AC6MFV69KJA6ZSU1KXMLTH5NFRHZ8,"But America's Kabul ambassador, Ryan Crocker, said involvement of the Haqqani network - which Washington believes is based in Pakistan's North Waziristan region and which it blames for high-profile attacks in Kabul in April - could not be ruled out.",51,62,involvement,1,3,4
3AC6MFV69KJA6ZSU1KXMLTH5NFRHZ8,"But America's Kabul ambassador, Ryan Crocker, said involvement of the Haqqani network - which Washington believes is based in Pakistan's North Waziristan region and which it blames for high-profile attacks in Kabul in April - could not be ruled out.",70,85,Haqqani network,2,1,3
3AC6MFV69KJA6ZSU1KXMLTH5NFRHZ8,"But America's Kabul ambassador, Ryan Crocker, said involvement of the Haqqani network - which Washington believes is based in Pakistan's North Waziristan region and which it blames for high-profile attacks in Kabul in April - could not be ruled out.",78,85,network,2,0,2
3AC6MFV69KJA6ZSU1KXMLTH5NFRHZ8,"But America's Kabul ambassador, Ryan Crocker, said involvement of the Haqqani network - which Washington believes is based in Pakistan's North Waziristan region and which it blames for high-profile attacks in Kabul in April - could not be ruled out.",174,180,blames,0,3,3
3AC6MFV69KJA6ZSU1KXMLTH5NFRHZ8,"But America's Kabul ambassador, Ryan Crocker, said involvement of the Haqqani network - which Washington believes is based in Pakistan's North Waziristan region and which it blames for high-profile attacks in Kabul in April - could not be ruled out.",185,197,high-profile,7,4,11
3AC6MFV69KJA6ZSU1KXMLTH5NFRHZ8,"But America's Kabul ambassador, Ryan Crocker, said involvement of the Haqqani network - which Washington believes is based in Pakistan's North Waziristan region and which it blames for high-profile attacks in Kabul in April - could not be ruled out.",185,205,high-profile attacks,2,4,6
3AC6MFV69KJA6ZSU1KXMLTH5NFRHZ8,"But America's Kabul ambassador, Ryan Crocker, said involvement of the Haqqani network - which Washington believes is based in Pakistan's North Waziristan region and which it blames for high-profile attacks in Kabul in April - could not be ruled out.",239,244,ruled,0,1,1
3AC6MFV69KJA6ZSU1KXMLTH5NFRHZ8,"But America's Kabul ambassador, Ryan Crocker, said involvement of the Haqqani network - which Washington believes is based in Pakistan's North Waziristan region and which it blames for high-profile attacks in Kabul in April - could not be ruled out.",239,248,ruled out,2,2,4
3AC6MFV69KJA6ZSU1KXMLTH5NFRHZ8,"On the anniversary of bin Laden's killing, Crocker said he did not believe there would be a sole turning point in the war.",7,18,anniversary,1,2,3
3AC6MFV69KJA6ZSU1KXMLTH5NFRHZ8,"On the anniversary of bin Laden's killing, Crocker said he did not believe there would be a sole turning point in the war.",43,50,Crocker,0,1,1
3AC6MFV69KJA6ZSU1KXMLTH5NFRHZ8,"On the anniversary of bin Laden's killing, Crocker said he did not believe there would be a sole turning point in the war.",67,74,believe,0,1,1
3AC6MFV69KJA6ZSU1KXMLTH5NFRHZ8,"On the anniversary of bin Laden's killing, Crocker said he did not believe there would be a sole turning point in the war.",92,96,sole,8,2,10
3AC6MFV69KJA6ZSU1KXMLTH5NFRHZ8,"On the anniversary of bin Laden's killing, Crocker said he did not believe there would be a sole turning point in the war.",92,110,sole turning point,5,2,7
3AC6MFV69KJA6ZSU1KXMLTH5NFRHZ8,"On the anniversary of bin Laden's killing, Crocker said he did not believe there would be a sole turning point in the war.",97,110,turning point,2,3,5
3GONHBMNHVZWYDT5SHDZDYP152EMZD,Opposition parties and international observers said the poll was marred by widespread reports and allegations of vote-rigging.,0,10,Opposition,4,0,4
3GONHBMNHVZWYDT5SHDZDYP152EMZD,Opposition parties and international observers said the poll was marred by widespread reports and allegations of vote-rigging.,0,18,Opposition parties,1,1,2
3GONHBMNHVZWYDT5SHDZDYP152EMZD,Opposition parties and international observers said the poll was marred by widespread reports and allegations of vote-rigging.,23,36,international,2,0,2
3GONHBMNHVZWYDT5SHDZDYP152EMZD,Opposition parties and international observers said the poll was marred by widespread reports and allegations of vote-rigging.,23,46,international observers,2,1,3
3GONHBMNHVZWYDT5SHDZDYP152EMZD,Opposition parties and international observers said the poll was marred by widespread reports and allegations of vote-rigging.,37,46,observers,1,1,2
3GONHBMNHVZWYDT5SHDZDYP152EMZD,Opposition parties and international observers said the poll was marred by widespread reports and allegations of vote-rigging.,56,60,poll,1,1,2
3GONHBMNHVZWYDT5SHDZDYP152EMZD,Opposition parties and international observers said the poll was marred by widespread reports and allegations of vote-rigging.,56,71,poll was marred,0,1,1
3GONHBMNHVZWYDT5SHDZDYP152EMZD,Opposition parties and international observers said the poll was marred by widespread reports and allegations of vote-rigging.,61,71,was marred,0,1,1
3GONHBMNHVZWYDT5SHDZDYP152EMZD,Opposition parties and international observers said the poll was marred by widespread reports and allegations of vote-rigging.,65,71,marred,7,10,17
3GONHBMNHVZWYDT5SHDZDYP152EMZD,Opposition parties and international observers said the poll was marred by widespread reports and allegations of vote-rigging.,75,85,widespread,5,4,9
3GONHBMNHVZWYDT5SHDZDYP152EMZD,Opposition parties and international observers said the poll was marred by widespread reports and allegations of vote-rigging.,98,109,allegations,7,8,15
3GONHBMNHVZWYDT5SHDZDYP152EMZD,Opposition parties and international observers said the poll was marred by widespread reports and allegations of vote-rigging.,98,125,allegations of vote-rigging,1,0,1
3GONHBMNHVZWYDT5SHDZDYP152EMZD,Opposition parties and international observers said the poll was marred by widespread reports and allegations of vote-rigging.,113,125,vote-rigging,8,10,18
3GONHBMNHVZWYDT5SHDZDYP152EMZD,"The allegations have fired up the opposition, which has long seen its protests crushed and its pleas ignored by the Kremlin-dominated media.",4,15,allegations,6,4,10
3GONHBMNHVZWYDT5SHDZDYP152EMZD,"The allegations have fired up the opposition, which has long seen its protests crushed and its pleas ignored by the Kremlin-dominated media.",21,29,fired up,0,1,1
3GONHBMNHVZWYDT5SHDZDYP152EMZD,"The allegations have fired up the opposition, which has long seen its protests crushed and its pleas ignored by the Kremlin-dominated media.",34,44,opposition,2,0,2
3GONHBMNHVZWYDT5SHDZDYP152EMZD,"The allegations have fired up the opposition, which has long seen its protests crushed and its pleas ignored by the Kremlin-dominated media.",70,78,protests,0,1,1
3GONHBMNHVZWYDT5SHDZDYP152EMZD,"The allegations have fired up the opposition, which has long seen its protests crushed and its pleas ignored by the Kremlin-dominated media.",70,86,protests crushed,0,2,2
3GONHBMNHVZWYDT5SHDZDYP152EMZD,"The allegations have fired up the opposition, which has long seen its protests crushed and its pleas ignored by the Kremlin-dominated media.",79,86,crushed,0,1,1
3GONHBMNHVZWYDT5SHDZDYP152EMZD,"The allegations have fired up the opposition, which has long seen its protests crushed and its pleas ignored by the Kremlin-dominated media.",95,100,pleas,3,9,12
3GONHBMNHVZWYDT5SHDZDYP152EMZD,"The allegations have fired up the opposition, which has long seen its protests crushed and its pleas ignored by the Kremlin-dominated media.",101,108,ignored,1,0,1
3GONHBMNHVZWYDT5SHDZDYP152EMZD,"The allegations have fired up the opposition, which has long seen its protests crushed and its pleas ignored by the Kremlin-dominated media.",116,133,Kremlin-dominated,5,1,6
3GONHBMNHVZWYDT5SHDZDYP152EMZD,"The allegations have fired up the opposition, which has long seen its protests crushed and its pleas ignored by the Kremlin-dominated media.",116,139,Kremlin-dominated media,3,1,4
3GONHBMNHVZWYDT5SHDZDYP152EMZD,"On Facebook, more than 10,000 people signed up to a page announcing an opposition rally for Saturday.",57,67,announcing,2,1,3
3GONHBMNHVZWYDT5SHDZDYP152EMZD,"On Facebook, more than 10,000 people signed up to a page announcing an opposition rally for Saturday.",71,81,opposition,3,0,3
3GONHBMNHVZWYDT5SHDZDYP152EMZD,"On Facebook, more than 10,000 people signed up to a page announcing an opposition rally for Saturday.",71,87,opposition rally,0,1,1
3GONHBMNHVZWYDT5SHDZDYP152EMZD,"On Facebook, more than 10,000 people signed up to a page announcing an opposition rally for Saturday.",82,87,rally,0,2,2
3GONHBMNHVZWYDT5SHDZDYP152EMZD,"Authorities said Tuesday that at least 51,500 police officers and 2,000 Interior Ministry troops have been deployed in Moscow since the election.",72,89,Interior Ministry,0,1,1
3GONHBMNHVZWYDT5SHDZDYP152EMZD,"Authorities said Tuesday that at least 51,500 police officers and 2,000 Interior Ministry troops have been deployed in Moscow since the election.",72,96,Interior Ministry troops,2,1,3
3GONHBMNHVZWYDT5SHDZDYP152EMZD,"Authorities said Tuesday that at least 51,500 police officers and 2,000 Interior Ministry troops have been deployed in Moscow since the election.",107,115,deployed,5,6,11
3GONHBMNHVZWYDT5SHDZDYP152EMZD,"Unlike the police, Interior Ministry troops are an armed force, largely manned by conscripts.",19,27,Interior,1,0,1
3GONHBMNHVZWYDT5SHDZDYP152EMZD,"Unlike the police, Interior Ministry troops are an armed force, largely manned by conscripts.",51,62,armed force,0,1,1
3GONHBMNHVZWYDT5SHDZDYP152EMZD,"Unlike the police, Interior Ministry troops are an armed force, largely manned by conscripts.",72,78,manned,5,7,12
3GONHBMNHVZWYDT5SHDZDYP152EMZD,"Unlike the police, Interior Ministry troops are an armed force, largely manned by conscripts.",72,92,manned by conscripts,1,1,2
3GONHBMNHVZWYDT5SHDZDYP152EMZD,"Unlike the police, Interior Ministry troops are an armed force, largely manned by conscripts.",82,92,conscripts,10,9,19
3GONHBMNHVZWYDT5SHDZDYP152EMZD,"On Wednesday, Muscovites spotted dozens of helicopters patrolling the city — a rare sight in the capital.",14,24,Muscovites,2,0,2
3GONHBMNHVZWYDT5SHDZDYP152EMZD,"On Wednesday, Muscovites spotted dozens of helicopters patrolling the city — a rare sight in the capital.",25,32,spotted,0,4,4
3GONHBMNHVZWYDT5SHDZDYP152EMZD,"On Wednesday, Muscovites spotted dozens of helicopters patrolling the city — a rare sight in the capital.",55,65,patrolling,4,3,7
3GONHBMNHVZWYDT5SHDZDYP152EMZD,"On Wednesday, Muscovites spotted dozens of helicopters patrolling the city — a rare sight in the capital.",79,83,rare,1,0,1
3GONHBMNHVZWYDT5SHDZDYP152EMZD,"On Wednesday, Muscovites spotted dozens of helicopters patrolling the city — a rare sight in the capital.",84,89,sight,0,2,2
3GONHBMNHVZWYDT5SHDZDYP152EMZD,The trial of the former Bosnia Serb army commander Ratko Mladic is due to begin today.Mladic stands accused of 11 counts of wars crimes and crimes against humanity.He is accused of leading a brutal campaign of ethnic cleansing during the Bosnian war between 1992 and 1995.,41,50,commander,2,0,2
3GONHBMNHVZWYDT5SHDZDYP152EMZD,The trial of the former Bosnia Serb army commander Ratko Mladic is due to begin today.Mladic stands accused of 11 counts of wars crimes and crimes against humanity.He is accused of leading a brutal campaign of ethnic cleansing during the Bosnian war between 1992 and 1995.,100,107,accused,3,1,4
3GONHBMNHVZWYDT5SHDZDYP152EMZD,The trial of the former Bosnia Serb army commander Ratko Mladic is due to begin today.Mladic stands accused of 11 counts of wars crimes and crimes against humanity.He is accused of leading a brutal campaign of ethnic cleansing during the Bosnian war between 1992 and 1995.,140,163,crimes against humanity,2,0,2
3GONHBMNHVZWYDT5SHDZDYP152EMZD,The trial of the former Bosnia Serb army commander Ratko Mladic is due to begin today.Mladic stands accused of 11 counts of wars crimes and crimes against humanity.He is accused of leading a brutal campaign of ethnic cleansing during the Bosnian war between 1992 and 1995.,155,163,humanity,4,0,4
3GONHBMNHVZWYDT5SHDZDYP152EMZD,The trial of the former Bosnia Serb army commander Ratko Mladic is due to begin today.Mladic stands accused of 11 counts of wars crimes and crimes against humanity.He is accused of leading a brutal campaign of ethnic cleansing during the Bosnian war between 1992 and 1995.,170,177,accused,1,0,1
3GONHBMNHVZWYDT5SHDZDYP152EMZD,The trial of the former Bosnia Serb army commander Ratko Mladic is due to begin today.Mladic stands accused of 11 counts of wars crimes and crimes against humanity.He is accused of leading a brutal campaign of ethnic cleansing during the Bosnian war between 1992 and 1995.,191,197,brutal,3,2,5
3GONHBMNHVZWYDT5SHDZDYP152EMZD,The trial of the former Bosnia Serb army commander Ratko Mladic is due to begin today.Mladic stands accused of 11 counts of wars crimes and crimes against humanity.He is accused of leading a brutal campaign of ethnic cleansing during the Bosnian war between 1992 and 1995.,191,206,brutal campaign,2,1,3
3GONHBMNHVZWYDT5SHDZDYP152EMZD,The trial of the former Bosnia Serb army commander Ratko Mladic is due to begin today.Mladic stands accused of 11 counts of wars crimes and crimes against humanity.He is accused of leading a brutal campaign of ethnic cleansing during the Bosnian war between 1992 and 1995.,191,226,brutal campaign of ethnic cleansing,0,1,1
3GONHBMNHVZWYDT5SHDZDYP152EMZD,The trial of the former Bosnia Serb army commander Ratko Mladic is due to begin today.Mladic stands accused of 11 counts of wars crimes and crimes against humanity.He is accused of leading a brutal campaign of ethnic cleansing during the Bosnian war between 1992 and 1995.,210,216,ethnic,1,1,2
3GONHBMNHVZWYDT5SHDZDYP152EMZD,The trial of the former Bosnia Serb army commander Ratko Mladic is due to begin today.Mladic stands accused of 11 counts of wars crimes and crimes against humanity.He is accused of leading a brutal campaign of ethnic cleansing during the Bosnian war between 1992 and 1995.,210,226,ethnic cleansing,6,5,11
3GONHBMNHVZWYDT5SHDZDYP152EMZD,The trial of the former Bosnia Serb army commander Ratko Mladic is due to begin today.Mladic stands accused of 11 counts of wars crimes and crimes against humanity.He is accused of leading a brutal campaign of ethnic cleansing during the Bosnian war between 1992 and 1995.,217,226,cleansing,1,1,2
32204AGAABDAFIXPBS9X0M1ZDQLHGA,That prompted the Chinese surveillance ships to insert themselves into the situation.,5,13,prompted,3,10,13
32204AGAABDAFIXPBS9X0M1ZDQLHGA,That prompted the Chinese surveillance ships to insert themselves into the situation.,26,38,surveillance,8,10,18
32204AGAABDAFIXPBS9X0M1ZDQLHGA,That prompted the Chinese surveillance ships to insert themselves into the situation.,26,44,surveillance ships,2,4,6
32204AGAABDAFIXPBS9X0M1ZDQLHGA,That prompted the Chinese surveillance ships to insert themselves into the situation.,48,54,insert,3,3,6
32204AGAABDAFIXPBS9X0M1ZDQLHGA,That prompted the Chinese surveillance ships to insert themselves into the situation.,48,65,insert themselves,0,1,1
32204AGAABDAFIXPBS9X0M1ZDQLHGA,That prompted the Chinese surveillance ships to insert themselves into the situation.,75,84,situation,1,1,2
32204AGAABDAFIXPBS9X0M1ZDQLHGA,"The Chinese Embassy said it got in touch with the Philippine Foreign Affairs Department and reiterated China's claim of sovereignty over Huangyan Island, urging the Philippine to leave the area, GMA said.",12,19,Embassy,0,2,2
32204AGAABDAFIXPBS9X0M1ZDQLHGA,"The Chinese Embassy said it got in touch with the Philippine Foreign Affairs Department and reiterated China's claim of sovereignty over Huangyan Island, urging the Philippine to leave the area, GMA said.",28,40,got in touch,0,1,1
32204AGAABDAFIXPBS9X0M1ZDQLHGA,"The Chinese Embassy said it got in touch with the Philippine Foreign Affairs Department and reiterated China's claim of sovereignty over Huangyan Island, urging the Philippine to leave the area, GMA said.",32,45,in touch with,0,1,1
32204AGAABDAFIXPBS9X0M1ZDQLHGA,"The Chinese Embassy said it got in touch with the Philippine Foreign Affairs Department and reiterated China's claim of sovereignty over Huangyan Island, urging the Philippine to leave the area, GMA said.",92,102,reiterated,10,10,20
32204AGAABDAFIXPBS9X0M1ZDQLHGA,"The Chinese Embassy said it got in touch with the Philippine Foreign Affairs Department and reiterated China's claim of sovereignty over Huangyan Island, urging the Philippine to leave the area, GMA said.",111,116,claim,0,1,1
32204AGAABDAFIXPBS9X0M1ZDQLHGA,"The Chinese Embassy said it got in touch with the Philippine Foreign Affairs Department and reiterated China's claim of sovereignty over Huangyan Island, urging the Philippine to leave the area, GMA said.",111,131,claim of sovereignty,2,0,2
32204AGAABDAFIXPBS9X0M1ZDQLHGA,"The Chinese Embassy said it got in touch with the Philippine Foreign Affairs Department and reiterated China's claim of sovereignty over Huangyan Island, urging the Philippine to leave the area, GMA said.",120,131,sovereignty,6,10,16
32204AGAABDAFIXPBS9X0M1ZDQLHGA,"The Chinese Embassy said it got in touch with the Philippine Foreign Affairs Department and reiterated China's claim of sovereignty over Huangyan Island, urging the Philippine to leave the area, GMA said.",120,136,sovereignty over,0,1,1
32204AGAABDAFIXPBS9X0M1ZDQLHGA,"The Chinese Embassy said it got in touch with the Philippine Foreign Affairs Department and reiterated China's claim of sovereignty over Huangyan Island, urging the Philippine to leave the area, GMA said.",154,160,urging,2,9,11
32204AGAABDAFIXPBS9X0M1ZDQLHGA,"Israeli ambassador to Egypt Yitzhak Levanon who is due to be replaced in the coming weeks has returned to Cairo, media reports said on Sunday.",8,18,ambassador,0,3,3
32204AGAABDAFIXPBS9X0M1ZDQLHGA,"Israeli ambassador to Egypt Yitzhak Levanon who is due to be replaced in the coming weeks has returned to Cairo, media reports said on Sunday.",61,69,replaced,0,1,1
32204AGAABDAFIXPBS9X0M1ZDQLHGA,"Israeli ambassador to Egypt Yitzhak Levanon who is due to be replaced in the coming weeks has returned to Cairo, media reports said on Sunday.",113,118,media,1,0,1
32204AGAABDAFIXPBS9X0M1ZDQLHGA,"Israeli ambassador to Egypt Yitzhak Levanon who is due to be replaced in the coming weeks has returned to Cairo, media reports said on Sunday.",113,126,media reports,1,0,1
32204AGAABDAFIXPBS9X0M1ZDQLHGA,"He was airlifted out of Egypt when thousands of angry protesters attacked the embassy in September in response to the killing of six Egyptian soldiers by Israeli forces in Sinai, in what Israel said was involuntary manslaughter.",7,16,airlifted,4,9,13
32204AGAABDAFIXPBS9X0M1ZDQLHGA,"He was airlifted out of Egypt when thousands of angry protesters attacked the embassy in September in response to the killing of six Egyptian soldiers by Israeli forces in Sinai, in what Israel said was involuntary manslaughter.",48,64,angry protesters,0,1,1
32204AGAABDAFIXPBS9X0M1ZDQLHGA,"He was airlifted out of Egypt when thousands of angry protesters attacked the embassy in September in response to the killing of six Egyptian soldiers by Israeli forces in Sinai, in what Israel said was involuntary manslaughter.",54,64,protesters,2,1,3
32204AGAABDAFIXPBS9X0M1ZDQLHGA,"He was airlifted out of Egypt when thousands of angry protesters attacked the embassy in September in response to the killing of six Egyptian soldiers by Israeli forces in Sinai, in what Israel said was involuntary manslaughter.",78,85,embassy,0,3,3
32204AGAABDAFIXPBS9X0M1ZDQLHGA,"He was airlifted out of Egypt when thousands of angry protesters attacked the embassy in September in response to the killing of six Egyptian soldiers by Israeli forces in Sinai, in what Israel said was involuntary manslaughter.",203,214,involuntary,1,4,5
32204AGAABDAFIXPBS9X0M1ZDQLHGA,"He was airlifted out of Egypt when thousands of angry protesters attacked the embassy in September in response to the killing of six Egyptian soldiers by Israeli forces in Sinai, in what Israel said was involuntary manslaughter.",203,227,involuntary manslaughter,8,5,13
32204AGAABDAFIXPBS9X0M1ZDQLHGA,"He was airlifted out of Egypt when thousands of angry protesters attacked the embassy in September in response to the killing of six Egyptian soldiers by Israeli forces in Sinai, in what Israel said was involuntary manslaughter.",215,227,manslaughter,3,9,12
32204AGAABDAFIXPBS9X0M1ZDQLHGA,Tel Aviv expressed its official apologies to Cairo on the incident.,9,18,expressed,2,2,4
32204AGAABDAFIXPBS9X0M1ZDQLHGA,Tel Aviv expressed its official apologies to Cairo on the incident.,23,41,official apologies,1,0,1
32204AGAABDAFIXPBS9X0M1ZDQLHGA,Tel Aviv expressed its official apologies to Cairo on the incident.,32,41,apologies,1,3,4
32204AGAABDAFIXPBS9X0M1ZDQLHGA,Tel Aviv expressed its official apologies to Cairo on the incident.,58,66,incident,2,2,4
32204AGAABDAFIXPBS9X0M1ZDQLHGA,Levanon is expected to stay in Cairo for two days to hold a series of farewell meetings with Egyptian officials.,50,57,to hold,0,1,1
32204AGAABDAFIXPBS9X0M1ZDQLHGA,Levanon is expected to stay in Cairo for two days to hold a series of farewell meetings with Egyptian officials.,60,66,series,1,0,1
32204AGAABDAFIXPBS9X0M1ZDQLHGA,Levanon is expected to stay in Cairo for two days to hold a series of farewell meetings with Egyptian officials.,70,78,farewell,3,5,8
32204AGAABDAFIXPBS9X0M1ZDQLHGA,Levanon is expected to stay in Cairo for two days to hold a series of farewell meetings with Egyptian officials.,70,87,farewell meetings,2,3,5
3SCKNODZ0XHJWL8ZLN0GZTL20ZBN7M,A huge security operation has covered Moscow in a show of force following protests over scandal-marred elections that saw Prime Minister Vladimir Putin's party struggle to keep a majority.,7,25,security operation,3,1,4
3SCKNODZ0XHJWL8ZLN0GZTL20ZBN7M,A huge security operation has covered Moscow in a show of force following protests over scandal-marred elections that saw Prime Minister Vladimir Putin's party struggle to keep a majority.,16,25,operation,0,1,1
3SCKNODZ0XHJWL8ZLN0GZTL20ZBN7M,A huge security operation has covered Moscow in a show of force following protests over scandal-marred elections that saw Prime Minister Vladimir Putin's party struggle to keep a majority.,38,44,Moscow,0,1,1
3SCKNODZ0XHJWL8ZLN0GZTL20ZBN7M,A huge security operation has covered Moscow in a show of force following protests over scandal-marred elections that saw Prime Minister Vladimir Putin's party struggle to keep a majority.,50,63,show of force,1,0,1
3SCKNODZ0XHJWL8ZLN0GZTL20ZBN7M,A huge security operation has covered Moscow in a show of force following protests over scandal-marred elections that saw Prime Minister Vladimir Putin's party struggle to keep a majority.,74,82,protests,0,1,1
3SCKNODZ0XHJWL8ZLN0GZTL20ZBN7M,A huge security operation has covered Moscow in a show of force following protests over scandal-marred elections that saw Prime Minister Vladimir Putin's party struggle to keep a majority.,88,102,scandal-marred,10,10,20
3SCKNODZ0XHJWL8ZLN0GZTL20ZBN7M,A huge security operation has covered Moscow in a show of force following protests over scandal-marred elections that saw Prime Minister Vladimir Putin's party struggle to keep a majority.,88,112,scandal-marred elections,0,1,1
3SCKNODZ0XHJWL8ZLN0GZTL20ZBN7M,A huge security operation has covered Moscow in a show of force following protests over scandal-marred elections that saw Prime Minister Vladimir Putin's party struggle to keep a majority.,160,168,struggle,0,4,4
3SCKNODZ0XHJWL8ZLN0GZTL20ZBN7M,A huge security operation has covered Moscow in a show of force following protests over scandal-marred elections that saw Prime Minister Vladimir Putin's party struggle to keep a majority.,179,187,majority,2,0,2
3SCKNODZ0XHJWL8ZLN0GZTL20ZBN7M,Demonstrations on Monday and Tuesday were an unusually sustained show of indignation for the Russian opposition.,0,14,Demonstrations,5,4,9
3SCKNODZ0XHJWL8ZLN0GZTL20ZBN7M,Demonstrations on Monday and Tuesday were an unusually sustained show of indignation for the Russian opposition.,45,54,unusually,1,1,2
3SCKNODZ0XHJWL8ZLN0GZTL20ZBN7M,Demonstrations on Monday and Tuesday were an unusually sustained show of indignation for the Russian opposition.,45,64,unusually sustained,0,1,1
3SCKNODZ0XHJWL8ZLN0GZTL20ZBN7M,Demonstrations on Monday and Tuesday were an unusually sustained show of indignation for the Russian opposition.,45,69,unusually sustained show,0,1,1
3SCKNODZ0XHJWL8ZLN0GZTL20ZBN7M,Demonstrations on Monday and Tuesday were an unusually sustained show of indignation for the Russian opposition.,55,64,sustained,9,6,15
3SCKNODZ0XHJWL8ZLN0GZTL20ZBN7M,Demonstrations on Monday and Tuesday were an unusually sustained show of indignation for the Russian opposition.,65,84,show of indignation,1,0,1
3SCKNODZ0XHJWL8ZLN0GZTL20ZBN7M,Demonstrations on Monday and Tuesday were an unusually sustained show of indignation for the Russian opposition.,73,84,indignation,10,10,20
3SCKNODZ0XHJWL8ZLN0GZTL20ZBN7M,Demonstrations on Monday and Tuesday were an unusually sustained show of indignation for the Russian opposition.,101,111,opposition,3,0,3
3SCKNODZ0XHJWL8ZLN0GZTL20ZBN7M,"The thousands of Russians who rallied in Moscow and St Petersburg faced police and Interior Ministry troops, who detained hundreds of protesters.",30,37,rallied,2,7,9
3SCKNODZ0XHJWL8ZLN0GZTL20ZBN7M,"The thousands of Russians who rallied in Moscow and St Petersburg faced police and Interior Ministry troops, who detained hundreds of protesters.",83,100,Interior Ministry,0,1,1
3SCKNODZ0XHJWL8ZLN0GZTL20ZBN7M,"The thousands of Russians who rallied in Moscow and St Petersburg faced police and Interior Ministry troops, who detained hundreds of protesters.",83,107,Interior Ministry troops,1,0,1
3SCKNODZ0XHJWL8ZLN0GZTL20ZBN7M,"The thousands of Russians who rallied in Moscow and St Petersburg faced police and Interior Ministry troops, who detained hundreds of protesters.",113,121,detained,4,7,11
3SCKNODZ0XHJWL8ZLN0GZTL20ZBN7M,"The thousands of Russians who rallied in Moscow and St Petersburg faced police and Interior Ministry troops, who detained hundreds of protesters.",134,144,protesters,2,2,4
3SCKNODZ0XHJWL8ZLN0GZTL20ZBN7M,"Sunday's parliamentary vote suggested Russians are tiring of Mr Putin and his United Russia party and allegations of vote-rigging have fired up the opposition, which has long seen its protests crushed and its pleas ignored by the Kremlin-dominated media.",9,22,parliamentary,6,1,7
3SCKNODZ0XHJWL8ZLN0GZTL20ZBN7M,"Sunday's parliamentary vote suggested Russians are tiring of Mr Putin and his United Russia party and allegations of vote-rigging have fired up the opposition, which has long seen its protests crushed and its pleas ignored by the Kremlin-dominated media.",28,37,suggested,1,1,2
3SCKNODZ0XHJWL8ZLN0GZTL20ZBN7M,"Sunday's parliamentary vote suggested Russians are tiring of Mr Putin and his United Russia party and allegations of vote-rigging have fired up the opposition, which has long seen its protests crushed and its pleas ignored by the Kremlin-dominated media.",51,57,tiring,0,3,3
3SCKNODZ0XHJWL8ZLN0GZTL20ZBN7M,"Sunday's parliamentary vote suggested Russians are tiring of Mr Putin and his United Russia party and allegations of vote-rigging have fired up the opposition, which has long seen its protests crushed and its pleas ignored by the Kremlin-dominated media.",102,113,allegations,5,10,15
3SCKNODZ0XHJWL8ZLN0GZTL20ZBN7M,"Sunday's parliamentary vote suggested Russians are tiring of Mr Putin and his United Russia party and allegations of vote-rigging have fired up the opposition, which has long seen its protests crushed and its pleas ignored by the Kremlin-dominated media.",117,129,vote-rigging,9,10,19
3SCKNODZ0XHJWL8ZLN0GZTL20ZBN7M,"Sunday's parliamentary vote suggested Russians are tiring of Mr Putin and his United Russia party and allegations of vote-rigging have fired up the opposition, which has long seen its protests crushed and its pleas ignored by the Kremlin-dominated media.",135,143,fired up,1,0,1
3SCKNODZ0XHJWL8ZLN0GZTL20ZBN7M,"Sunday's parliamentary vote suggested Russians are tiring of Mr Putin and his United Russia party and allegations of vote-rigging have fired up the opposition, which has long seen its protests crushed and its pleas ignored by the Kremlin-dominated media.",148,158,opposition,2,0,2
3SCKNODZ0XHJWL8ZLN0GZTL20ZBN7M,"Sunday's parliamentary vote suggested Russians are tiring of Mr Putin and his United Russia party and allegations of vote-rigging have fired up the opposition, which has long seen its protests crushed and its pleas ignored by the Kremlin-dominated media.",193,200,crushed,2,1,3
3SCKNODZ0XHJWL8ZLN0GZTL20ZBN7M,"Sunday's parliamentary vote suggested Russians are tiring of Mr Putin and his United Russia party and allegations of vote-rigging have fired up the opposition, which has long seen its protests crushed and its pleas ignored by the Kremlin-dominated media.",209,214,pleas,3,3,6
3SCKNODZ0XHJWL8ZLN0GZTL20ZBN7M,"Sunday's parliamentary vote suggested Russians are tiring of Mr Putin and his United Russia party and allegations of vote-rigging have fired up the opposition, which has long seen its protests crushed and its pleas ignored by the Kremlin-dominated media.",215,222,ignored,0,2,2
3SCKNODZ0XHJWL8ZLN0GZTL20ZBN7M,"Sunday's parliamentary vote suggested Russians are tiring of Mr Putin and his United Russia party and allegations of vote-rigging have fired up the opposition, which has long seen its protests crushed and its pleas ignored by the Kremlin-dominated media.",230,247,Kremlin-dominated,5,0,5
3SCKNODZ0XHJWL8ZLN0GZTL20ZBN7M,"Sunday's parliamentary vote suggested Russians are tiring of Mr Putin and his United Russia party and allegations of vote-rigging have fired up the opposition, which has long seen its protests crushed and its pleas ignored by the Kremlin-dominated media.",230,253,Kremlin-dominated media,1,1,2
3SCKNODZ0XHJWL8ZLN0GZTL20ZBN7M,At least 300 people were detained by police at a protest in central Moscow on Tuesday night.,25,33,detained,5,3,8
3YLTXLH3DF7GSVQOEBZKUVFREH8HPE,"China has regularly dismissed the protests, saying Beijing has indisputable sovereignty over those areas on historical grounds.",10,29,regularly dismissed,1,0,1
3YLTXLH3DF7GSVQOEBZKUVFREH8HPE,"China has regularly dismissed the protests, saying Beijing has indisputable sovereignty over those areas on historical grounds.",10,42,regularly dismissed the protests,1,0,1
3YLTXLH3DF7GSVQOEBZKUVFREH8HPE,"China has regularly dismissed the protests, saying Beijing has indisputable sovereignty over those areas on historical grounds.",20,29,dismissed,5,5,10
3YLTXLH3DF7GSVQOEBZKUVFREH8HPE,"China has regularly dismissed the protests, saying Beijing has indisputable sovereignty over those areas on historical grounds.",34,42,protests,0,3,3
3YLTXLH3DF7GSVQOEBZKUVFREH8HPE,"China has regularly dismissed the protests, saying Beijing has indisputable sovereignty over those areas on historical grounds.",63,75,indisputable,6,6,12
3YLTXLH3DF7GSVQOEBZKUVFREH8HPE,"China has regularly dismissed the protests, saying Beijing has indisputable sovereignty over those areas on historical grounds.",63,87,indisputable sovereignty,8,5,13
3YLTXLH3DF7GSVQOEBZKUVFREH8HPE,"China has regularly dismissed the protests, saying Beijing has indisputable sovereignty over those areas on historical grounds.",76,87,sovereignty,6,10,16
3YLTXLH3DF7GSVQOEBZKUVFREH8HPE,"China has regularly dismissed the protests, saying Beijing has indisputable sovereignty over those areas on historical grounds.",108,118,historical,2,0,2
3YLTXLH3DF7GSVQOEBZKUVFREH8HPE,"China has regularly dismissed the protests, saying Beijing has indisputable sovereignty over those areas on historical grounds.",108,126,historical grounds,2,2,4
3YLTXLH3DF7GSVQOEBZKUVFREH8HPE,"Israel's outgoing ambassador to Egypt arrived in Cairo on Sunday to bid farewell to former colleagues, after an attack on the Israeli mission in September forced its evacuation, according to a spokesman at Israel's Foreign Ministry in Jerusalem.",9,17,outgoing,1,2,3
3YLTXLH3DF7GSVQOEBZKUVFREH8HPE,"Israel's outgoing ambassador to Egypt arrived in Cairo on Sunday to bid farewell to former colleagues, after an attack on the Israeli mission in September forced its evacuation, according to a spokesman at Israel's Foreign Ministry in Jerusalem.",9,28,outgoing ambassador,1,1,2
3YLTXLH3DF7GSVQOEBZKUVFREH8HPE,"Israel's outgoing ambassador to Egypt arrived in Cairo on Sunday to bid farewell to former colleagues, after an attack on the Israeli mission in September forced its evacuation, according to a spokesman at Israel's Foreign Ministry in Jerusalem.",18,28,ambassador,7,3,10
3YLTXLH3DF7GSVQOEBZKUVFREH8HPE,"Israel's outgoing ambassador to Egypt arrived in Cairo on Sunday to bid farewell to former colleagues, after an attack on the Israeli mission in September forced its evacuation, according to a spokesman at Israel's Foreign Ministry in Jerusalem.",68,71,bid,0,1,1
3YLTXLH3DF7GSVQOEBZKUVFREH8HPE,"Israel's outgoing ambassador to Egypt arrived in Cairo on Sunday to bid farewell to former colleagues, after an attack on the Israeli mission in September forced its evacuation, according to a spokesman at Israel's Foreign Ministry in Jerusalem.",68,80,bid farewell,1,1,2
3YLTXLH3DF7GSVQOEBZKUVFREH8HPE,"Israel's outgoing ambassador to Egypt arrived in Cairo on Sunday to bid farewell to former colleagues, after an attack on the Israeli mission in September forced its evacuation, according to a spokesman at Israel's Foreign Ministry in Jerusalem.",72,80,farewell,1,8,9
3YLTXLH3DF7GSVQOEBZKUVFREH8HPE,"Israel's outgoing ambassador to Egypt arrived in Cairo on Sunday to bid farewell to former colleagues, after an attack on the Israeli mission in September forced its evacuation, according to a spokesman at Israel's Foreign Ministry in Jerusalem.",91,101,colleagues,2,1,3
3YLTXLH3DF7GSVQOEBZKUVFREH8HPE,"Israel's outgoing ambassador to Egypt arrived in Cairo on Sunday to bid farewell to former colleagues, after an attack on the Israeli mission in September forced its evacuation, according to a spokesman at Israel's Foreign Ministry in Jerusalem.",166,176,evacuation,10,10,20
3YLTXLH3DF7GSVQOEBZKUVFREH8HPE,"Israel's outgoing ambassador to Egypt arrived in Cairo on Sunday to bid farewell to former colleagues, after an attack on the Israeli mission in September forced its evacuation, according to a spokesman at Israel's Foreign Ministry in Jerusalem.",193,202,spokesman,3,3,6
3YLTXLH3DF7GSVQOEBZKUVFREH8HPE,"Yitzhak Levanon, who will be retiring at the end of the month, departed to Cairo for several days in order to bid farewell to friends and colleagues, Foreign Ministry deputy spokesman Lior Ben-Dor told Xinhua.",9,16,Levanon,0,1,1
3YLTXLH3DF7GSVQOEBZKUVFREH8HPE,"Yitzhak Levanon, who will be retiring at the end of the month, departed to Cairo for several days in order to bid farewell to friends and colleagues, Foreign Ministry deputy spokesman Lior Ben-Dor told Xinhua.",30,38,retiring,1,2,3
3YLTXLH3DF7GSVQOEBZKUVFREH8HPE,"Yitzhak Levanon, who will be retiring at the end of the month, departed to Cairo for several days in order to bid farewell to friends and colleagues, Foreign Ministry deputy spokesman Lior Ben-Dor told Xinhua.",64,72,departed,1,3,4
3YLTXLH3DF7GSVQOEBZKUVFREH8HPE,"Yitzhak Levanon, who will be retiring at the end of the month, departed to Cairo for several days in order to bid farewell to friends and colleagues, Foreign Ministry deputy spokesman Lior Ben-Dor told Xinhua.",111,123,bid farewell,2,0,2
3YLTXLH3DF7GSVQOEBZKUVFREH8HPE,"Yitzhak Levanon, who will be retiring at the end of the month, departed to Cairo for several days in order to bid farewell to friends and colleagues, Foreign Ministry deputy spokesman Lior Ben-Dor told Xinhua.",115,123,farewell,1,2,3
3YLTXLH3DF7GSVQOEBZKUVFREH8HPE,"Yitzhak Levanon, who will be retiring at the end of the month, departed to Cairo for several days in order to bid farewell to friends and colleagues, Foreign Ministry deputy spokesman Lior Ben-Dor told Xinhua.",139,149,colleagues,3,1,4
3YLTXLH3DF7GSVQOEBZKUVFREH8HPE,"Yitzhak Levanon, who will be retiring at the end of the month, departed to Cairo for several days in order to bid farewell to friends and colleagues, Foreign Ministry deputy spokesman Lior Ben-Dor told Xinhua.",152,185,Foreign Ministry deputy spokesman,1,0,1
3YLTXLH3DF7GSVQOEBZKUVFREH8HPE,"Yitzhak Levanon, who will be retiring at the end of the month, departed to Cairo for several days in order to bid farewell to friends and colleagues, Foreign Ministry deputy spokesman Lior Ben-Dor told Xinhua.",176,185,spokesman,1,0,1
3YLTXLH3DF7GSVQOEBZKUVFREH8HPE,"A general atmosphere of anti-Israel sentiments came to a head on Sept. 10, when hundreds of Egyptian protesters stormed the Israeli embassy and tore apart its security wall, forcing Prime Minister Benjamin Netanyahu to order the emergency evacuation of Levanon and some 80 of his staff and their families back to Israel.",2,20,general atmosphere,2,0,2
3YLTXLH3DF7GSVQOEBZKUVFREH8HPE,"A general atmosphere of anti-Israel sentiments came to a head on Sept. 10, when hundreds of Egyptian protesters stormed the Israeli embassy and tore apart its security wall, forcing Prime Minister Benjamin Netanyahu to order the emergency evacuation of Levanon and some 80 of his staff and their families back to Israel.",10,20,atmosphere,4,1,5
3YLTXLH3DF7GSVQOEBZKUVFREH8HPE,"A general atmosphere of anti-Israel sentiments came to a head on Sept. 10, when hundreds of Egyptian protesters stormed the Israeli embassy and tore apart its security wall, forcing Prime Minister Benjamin Netanyahu to order the emergency evacuation of Levanon and some 80 of his staff and their families back to Israel.",24,46,anti-Israel sentiments,1,2,3
3YLTXLH3DF7GSVQOEBZKUVFREH8HPE,"A general atmosphere of anti-Israel sentiments came to a head on Sept. 10, when hundreds of Egyptian protesters stormed the Israeli embassy and tore apart its security wall, forcing Prime Minister Benjamin Netanyahu to order the emergency evacuation of Levanon and some 80 of his staff and their families back to Israel.",36,46,sentiments,6,5,11
3YLTXLH3DF7GSVQOEBZKUVFREH8HPE,"A general atmosphere of anti-Israel sentiments came to a head on Sept. 10, when hundreds of Egyptian protesters stormed the Israeli embassy and tore apart its security wall, forcing Prime Minister Benjamin Netanyahu to order the emergency evacuation of Levanon and some 80 of his staff and their families back to Israel.",112,119,stormed,3,5,8
3YLTXLH3DF7GSVQOEBZKUVFREH8HPE,"A general atmosphere of anti-Israel sentiments came to a head on Sept. 10, when hundreds of Egyptian protesters stormed the Israeli embassy and tore apart its security wall, forcing Prime Minister Benjamin Netanyahu to order the emergency evacuation of Levanon and some 80 of his staff and their families back to Israel.",132,139,embassy,1,1,2
3YLTXLH3DF7GSVQOEBZKUVFREH8HPE,"A general atmosphere of anti-Israel sentiments came to a head on Sept. 10, when hundreds of Egyptian protesters stormed the Israeli embassy and tore apart its security wall, forcing Prime Minister Benjamin Netanyahu to order the emergency evacuation of Levanon and some 80 of his staff and their families back to Israel.",144,148,tore,1,1,2
3YLTXLH3DF7GSVQOEBZKUVFREH8HPE,"A general atmosphere of anti-Israel sentiments came to a head on Sept. 10, when hundreds of Egyptian protesters stormed the Israeli embassy and tore apart its security wall, forcing Prime Minister Benjamin Netanyahu to order the emergency evacuation of Levanon and some 80 of his staff and their families back to Israel.",144,154,tore apart,0,3,3
3YLTXLH3DF7GSVQOEBZKUVFREH8HPE,"A general atmosphere of anti-Israel sentiments came to a head on Sept. 10, when hundreds of Egyptian protesters stormed the Israeli embassy and tore apart its security wall, forcing Prime Minister Benjamin Netanyahu to order the emergency evacuation of Levanon and some 80 of his staff and their families back to Israel.",159,172,security wall,2,0,2
3YLTXLH3DF7GSVQOEBZKUVFREH8HPE,"A general atmosphere of anti-Israel sentiments came to a head on Sept. 10, when hundreds of Egyptian protesters stormed the Israeli embassy and tore apart its security wall, forcing Prime Minister Benjamin Netanyahu to order the emergency evacuation of Levanon and some 80 of his staff and their families back to Israel.",229,238,emergency,0,1,1
3YLTXLH3DF7GSVQOEBZKUVFREH8HPE,"A general atmosphere of anti-Israel sentiments came to a head on Sept. 10, when hundreds of Egyptian protesters stormed the Israeli embassy and tore apart its security wall, forcing Prime Minister Benjamin Netanyahu to order the emergency evacuation of Levanon and some 80 of his staff and their families back to Israel.",229,249,emergency evacuation,1,1,2
3YLTXLH3DF7GSVQOEBZKUVFREH8HPE,"A general atmosphere of anti-Israel sentiments came to a head on Sept. 10, when hundreds of Egyptian protesters stormed the Israeli embassy and tore apart its security wall, forcing Prime Minister Benjamin Netanyahu to order the emergency evacuation of Levanon and some 80 of his staff and their families back to Israel.",239,249,evacuation,4,1,5
3P6ENY9P79XOB93K1G90LYEFRQAIH9,"A definitive clean-up of troubled banks, as well as an accelerated 2014 budget, are among a package of reforms that could win centre-right Prime Minister Mariano Rajoy more time from the European Union to hit tough deficit targets, EU sources have told Reuters.",2,12,definitive,8,4,12
3P6ENY9P79XOB93K1G90LYEFRQAIH9,"A definitive clean-up of troubled banks, as well as an accelerated 2014 budget, are among a package of reforms that could win centre-right Prime Minister Mariano Rajoy more time from the European Union to hit tough deficit targets, EU sources have told Reuters.",2,21,definitive clean-up,3,2,5
3P6ENY9P79XOB93K1G90LYEFRQAIH9,"A definitive clean-up of troubled banks, as well as an accelerated 2014 budget, are among a package of reforms that could win centre-right Prime Minister Mariano Rajoy more time from the European Union to hit tough deficit targets, EU sources have told Reuters.",2,39,definitive clean-up of troubled banks,1,0,1
3P6ENY9P79XOB93K1G90LYEFRQAIH9,"A definitive clean-up of troubled banks, as well as an accelerated 2014 budget, are among a package of reforms that could win centre-right Prime Minister Mariano Rajoy more time from the European Union to hit tough deficit targets, EU sources have told Reuters.",13,39,clean-up of troubled banks,1,0,1
3P6ENY9P79XOB93K1G90LYEFRQAIH9,"A definitive clean-up of troubled banks, as well as an accelerated 2014 budget, are among a package of reforms that could win centre-right Prime Minister Mariano Rajoy more time from the European Union to hit tough deficit targets, EU sources have told Reuters.",25,33,troubled,0,2,2
3P6ENY9P79XOB93K1G90LYEFRQAIH9,"A definitive clean-up of troubled banks, as well as an accelerated 2014 budget, are among a package of reforms that could win centre-right Prime Minister Mariano Rajoy more time from the European Union to hit tough deficit targets, EU sources have told Reuters.",25,39,troubled banks,2,0,2
3P6ENY9P79XOB93K1G90LYEFRQAIH9,"A definitive clean-up of troubled banks, as well as an accelerated 2014 budget, are among a package of reforms that could win centre-right Prime Minister Mariano Rajoy more time from the European Union to hit tough deficit targets, EU sources have told Reuters.",55,66,accelerated,7,7,14
3P6ENY9P79XOB93K1G90LYEFRQAIH9,"A definitive clean-up of troubled banks, as well as an accelerated 2014 budget, are among a package of reforms that could win centre-right Prime Minister Mariano Rajoy more time from the European Union to hit tough deficit targets, EU sources have told Reuters.",92,99,package,0,1,1
3P6ENY9P79XOB93K1G90LYEFRQAIH9,"A definitive clean-up of troubled banks, as well as an accelerated 2014 budget, are among a package of reforms that could win centre-right Prime Minister Mariano Rajoy more time from the European Union to hit tough deficit targets, EU sources have told Reuters.",92,110,package of reforms,1,0,1
3P6ENY9P79XOB93K1G90LYEFRQAIH9,"A definitive clean-up of troubled banks, as well as an accelerated 2014 budget, are among a package of reforms that could win centre-right Prime Minister Mariano Rajoy more time from the European Union to hit tough deficit targets, EU sources have told Reuters.",103,110,reforms,1,1,2
3P6ENY9P79XOB93K1G90LYEFRQAIH9,"A definitive clean-up of troubled banks, as well as an accelerated 2014 budget, are among a package of reforms that could win centre-right Prime Minister Mariano Rajoy more time from the European Union to hit tough deficit targets, EU sources have told Reuters.",126,138,centre-right,7,2,9
3P6ENY9P79XOB93K1G90LYEFRQAIH9,"A definitive clean-up of troubled banks, as well as an accelerated 2014 budget, are among a package of reforms that could win centre-right Prime Minister Mariano Rajoy more time from the European Union to hit tough deficit targets, EU sources have told Reuters.",187,201,European Union,0,1,1
3P6ENY9P79XOB93K1G90LYEFRQAIH9,"A definitive clean-up of troubled banks, as well as an accelerated 2014 budget, are among a package of reforms that could win centre-right Prime Minister Mariano Rajoy more time from the European Union to hit tough deficit targets, EU sources have told Reuters.",209,214,tough,0,1,1
3P6ENY9P79XOB93K1G90LYEFRQAIH9,"A definitive clean-up of troubled banks, as well as an accelerated 2014 budget, are among a package of reforms that could win centre-right Prime Minister Mariano Rajoy more time from the European Union to hit tough deficit targets, EU sources have told Reuters.",209,230,tough deficit targets,2,1,3
3P6ENY9P79XOB93K1G90LYEFRQAIH9,"A definitive clean-up of troubled banks, as well as an accelerated 2014 budget, are among a package of reforms that could win centre-right Prime Minister Mariano Rajoy more time from the European Union to hit tough deficit targets, EU sources have told Reuters.",215,222,deficit,4,5,9
3P6ENY9P79XOB93K1G90LYEFRQAIH9,"A definitive clean-up of troubled banks, as well as an accelerated 2014 budget, are among a package of reforms that could win centre-right Prime Minister Mariano Rajoy more time from the European Union to hit tough deficit targets, EU sources have told Reuters.",215,230,deficit targets,3,3,6
3P6ENY9P79XOB93K1G90LYEFRQAIH9,"A definitive clean-up of troubled banks, as well as an accelerated 2014 budget, are among a package of reforms that could win centre-right Prime Minister Mariano Rajoy more time from the European Union to hit tough deficit targets, EU sources have told Reuters.",223,230,targets,1,0,1
3P6ENY9P79XOB93K1G90LYEFRQAIH9,"A definitive clean-up of troubled banks, as well as an accelerated 2014 budget, are among a package of reforms that could win centre-right Prime Minister Mariano Rajoy more time from the European Union to hit tough deficit targets, EU sources have told Reuters.",232,234,EU,1,0,1
3P6ENY9P79XOB93K1G90LYEFRQAIH9,"A definitive clean-up of troubled banks, as well as an accelerated 2014 budget, are among a package of reforms that could win centre-right Prime Minister Mariano Rajoy more time from the European Union to hit tough deficit targets, EU sources have told Reuters.",253,260,Reuters,1,2,3
3P6ENY9P79XOB93K1G90LYEFRQAIH9,"Spain is walking on the edge of a cliff.	10	40	walking on the edge of a cliff	1	0	1
3P6ENY9P79XOB93K1G90LYEFRQAIH9	Spain is walking on the edge of a cliff.",25,29,edge,0,1,1
3P6ENY9P79XOB93K1G90LYEFRQAIH9,"Spain is walking on the edge of a cliff.	25	40	edge of a cliff	1	2	3
3P6ENY9P79XOB93K1G90LYEFRQAIH9	Spain is walking on the edge of a cliff.",35,40,cliff,1,4,5
3P6ENY9P79XOB93K1G90LYEFRQAIH9,"If they fail to deliver, what has been so far a national crisis will degenerate into a systemic crisis for the EU,"" one senior source said.",16,23,deliver,0,1,1
3P6ENY9P79XOB93K1G90LYEFRQAIH9,"If they fail to deliver, what has been so far a national crisis will degenerate into a systemic crisis for the EU,"" one senior source said.",48,56,national,1,0,1
3P6ENY9P79XOB93K1G90LYEFRQAIH9,"If they fail to deliver, what has been so far a national crisis will degenerate into a systemic crisis for the EU,"" one senior source said.",48,63,national crisis,2,0,2
3P6ENY9P79XOB93K1G90LYEFRQAIH9,"If they fail to deliver, what has been so far a national crisis will degenerate into a systemic crisis for the EU,"" one senior source said.",57,63,crisis,1,2,3
3P6ENY9P79XOB93K1G90LYEFRQAIH9,"If they fail to deliver, what has been so far a national crisis will degenerate into a systemic crisis for the EU,"" one senior source said.",69,79,degenerate,10,10,20
3P6ENY9P79XOB93K1G90LYEFRQAIH9,"If they fail to deliver, what has been so far a national crisis will degenerate into a systemic crisis for the EU,"" one senior source said.",87,95,systemic,2,1,3
3P6ENY9P79XOB93K1G90LYEFRQAIH9,"If they fail to deliver, what has been so far a national crisis will degenerate into a systemic crisis for the EU,"" one senior source said.",87,102,systemic crisis,7,5,12
3P6ENY9P79XOB93K1G90LYEFRQAIH9,"Hoping to put an end to its four-year banking crisis, Spain effectively took over Bankia SA, one of the country's biggest banks, this week after days of market anxiety over the lender's viability.",60,71,effectively,0,1,1
3P6ENY9P79XOB93K1G90LYEFRQAIH9,"Hoping to put an end to its four-year banking crisis, Spain effectively took over Bankia SA, one of the country's biggest banks, this week after days of market anxiety over the lender's viability.",153,167,market anxiety,4,2,6
3P6ENY9P79XOB93K1G90LYEFRQAIH9,"Hoping to put an end to its four-year banking crisis, Spain effectively took over Bankia SA, one of the country's biggest banks, this week after days of market anxiety over the lender's viability.",160,167,anxiety,3,6,9
3P6ENY9P79XOB93K1G90LYEFRQAIH9,"Hoping to put an end to its four-year banking crisis, Spain effectively took over Bankia SA, one of the country's biggest banks, this week after days of market anxiety over the lender's viability.",177,184,lenders,1,4,5
3P6ENY9P79XOB93K1G90LYEFRQAIH9,"Hoping to put an end to its four-year banking crisis, Spain effectively took over Bankia SA, one of the country's biggest banks, this week after days of market anxiety over the lender's viability.",177,194,lenders viability,4,4,8
3P6ENY9P79XOB93K1G90LYEFRQAIH9,"Hoping to put an end to its four-year banking crisis, Spain effectively took over Bankia SA, one of the country's biggest banks, this week after days of market anxiety over the lender's viability.",186,195,viability,7,4,11
3P6ENY9P79XOB93K1G90LYEFRQAIH9,"Spanish stocks were down 2.1 percent on Friday morning, in line with other European markets, after getting a big boost on Thursday from the banking reform plans.",109,118,big boost,0,2,2
3P6ENY9P79XOB93K1G90LYEFRQAIH9,"Spanish stocks were down 2.1 percent on Friday morning, in line with other European markets, after getting a big boost on Thursday from the banking reform plans.",113,118,boost,2,3,5
3P6ENY9P79XOB93K1G90LYEFRQAIH9,"Spanish stocks were down 2.1 percent on Friday morning, in line with other European markets, after getting a big boost on Thursday from the banking reform plans.",140,160,banking reform plans,4,0,4
3P6ENY9P79XOB93K1G90LYEFRQAIH9,"Spanish stocks were down 2.1 percent on Friday morning, in line with other European markets, after getting a big boost on Thursday from the banking reform plans.",148,154,reform,2,1,3
3G4VVJO6PZH7ULRWKW2H7NVJ6YCPKQ,The car has been seized for a technical and forensic examination.,17,23,seized,10,8,18
3G4VVJO6PZH7ULRWKW2H7NVJ6YCPKQ,The car has been seized for a technical and forensic examination.,30,39,technical,4,0,4
3G4VVJO6PZH7ULRWKW2H7NVJ6YCPKQ,The car has been seized for a technical and forensic examination.,30,64,technical and forensic examination,3,0,3
3G4VVJO6PZH7ULRWKW2H7NVJ6YCPKQ,The car has been seized for a technical and forensic examination.,44,52,forensic,5,6,11
3G4VVJO6PZH7ULRWKW2H7NVJ6YCPKQ,The car has been seized for a technical and forensic examination.,44,64,forensic examination,7,2,9
3G4VVJO6PZH7ULRWKW2H7NVJ6YCPKQ,"Israel's ambassador to Cairo has travelled to Egypt for the first time since he and his staff were evacuated from the country in September after protesters stormed the Israeli embassy, a Foreign Ministry official said on Sunday.",9,19,ambassador,2,1,3
3G4VVJO6PZH7ULRWKW2H7NVJ6YCPKQ,"Israel's ambassador to Cairo has travelled to Egypt for the first time since he and his staff were evacuated from the country in September after protesters stormed the Israeli embassy, a Foreign Ministry official said on Sunday.",88,93,staff,0,1,1
3G4VVJO6PZH7ULRWKW2H7NVJ6YCPKQ,"Israel's ambassador to Cairo has travelled to Egypt for the first time since he and his staff were evacuated from the country in September after protesters stormed the Israeli embassy, a Foreign Ministry official said on Sunday.",99,108,evacuated,10,8,18
3G4VVJO6PZH7ULRWKW2H7NVJ6YCPKQ,"Israel's ambassador to Cairo has travelled to Egypt for the first time since he and his staff were evacuated from the country in September after protesters stormed the Israeli embassy, a Foreign Ministry official said on Sunday.",145,155,protesters,4,2,6
3G4VVJO6PZH7ULRWKW2H7NVJ6YCPKQ,"Israel's ambassador to Cairo has travelled to Egypt for the first time since he and his staff were evacuated from the country in September after protesters stormed the Israeli embassy, a Foreign Ministry official said on Sunday.",156,163,stormed,4,6,10
3G4VVJO6PZH7ULRWKW2H7NVJ6YCPKQ,"Israel's ambassador to Cairo has travelled to Egypt for the first time since he and his staff were evacuated from the country in September after protesters stormed the Israeli embassy, a Foreign Ministry official said on Sunday.",176,183,embassy,0,1,1
3G4VVJO6PZH7ULRWKW2H7NVJ6YCPKQ,"Playing down the significance of Yitzhak Levanon's trip, the official, who asked not to be identified, said the ambassador went to Egypt on Saturday for farewell meetings with foreign and Egyptian diplomats before his retirement.",0,12,Playing down,1,2,3
3G4VVJO6PZH7ULRWKW2H7NVJ6YCPKQ,"Playing down the significance of Yitzhak Levanon's trip, the official, who asked not to be identified, said the ambassador went to Egypt on Saturday for farewell meetings with foreign and Egyptian diplomats before his retirement.",0,29,Playing down the significance,1,0,1
3G4VVJO6PZH7ULRWKW2H7NVJ6YCPKQ,"Playing down the significance of Yitzhak Levanon's trip, the official, who asked not to be identified, said the ambassador went to Egypt on Saturday for farewell meetings with foreign and Egyptian diplomats before his retirement.",17,29,significance,5,4,9
3G4VVJO6PZH7ULRWKW2H7NVJ6YCPKQ,"Playing down the significance of Yitzhak Levanon's trip, the official, who asked not to be identified, said the ambassador went to Egypt on Saturday for farewell meetings with foreign and Egyptian diplomats before his retirement.",91,101,identified,0,1,1
3G4VVJO6PZH7ULRWKW2H7NVJ6YCPKQ,"Playing down the significance of Yitzhak Levanon's trip, the official, who asked not to be identified, said the ambassador went to Egypt on Saturday for farewell meetings with foreign and Egyptian diplomats before his retirement.",153,161,farewell,2,2,4
3G4VVJO6PZH7ULRWKW2H7NVJ6YCPKQ,"Playing down the significance of Yitzhak Levanon's trip, the official, who asked not to be identified, said the ambassador went to Egypt on Saturday for farewell meetings with foreign and Egyptian diplomats before his retirement.",153,170,farewell meetings,1,2,3
3G4VVJO6PZH7ULRWKW2H7NVJ6YCPKQ,"Playing down the significance of Yitzhak Levanon's trip, the official, who asked not to be identified, said the ambassador went to Egypt on Saturday for farewell meetings with foreign and Egyptian diplomats before his retirement.",197,206,diplomats,5,5,10
3G4VVJO6PZH7ULRWKW2H7NVJ6YCPKQ,"Playing down the significance of Yitzhak Levanon's trip, the official, who asked not to be identified, said the ambassador went to Egypt on Saturday for farewell meetings with foreign and Egyptian diplomats before his retirement.",218,228,retirement,3,2,5
3G4VVJO6PZH7ULRWKW2H7NVJ6YCPKQ,"Israel's embassy in a high-rise building in Cairo has remained unoccupied since protesters broke in two months ago, trapping Israeli security guards inside until they were rescued by Egyptian troops.",9,16,embassy,0,1,1
3G4VVJO6PZH7ULRWKW2H7NVJ6YCPKQ,"Israel's embassy in a high-rise building in Cairo has remained unoccupied since protesters broke in two months ago, trapping Israeli security guards inside until they were rescued by Egyptian troops.",22,31,high-rise,1,3,4
3G4VVJO6PZH7ULRWKW2H7NVJ6YCPKQ,"Israel's embassy in a high-rise building in Cairo has remained unoccupied since protesters broke in two months ago, trapping Israeli security guards inside until they were rescued by Egyptian troops.",22,40,high-rise building,2,1,3
3G4VVJO6PZH7ULRWKW2H7NVJ6YCPKQ,"Israel's embassy in a high-rise building in Cairo has remained unoccupied since protesters broke in two months ago, trapping Israeli security guards inside until they were rescued by Egyptian troops.",63,73,unoccupied,7,2,9
3G4VVJO6PZH7ULRWKW2H7NVJ6YCPKQ,"Israel's embassy in a high-rise building in Cairo has remained unoccupied since protesters broke in two months ago, trapping Israeli security guards inside until they were rescued by Egyptian troops.",80,90,protesters,3,0,3
3G4VVJO6PZH7ULRWKW2H7NVJ6YCPKQ,"Israel's embassy in a high-rise building in Cairo has remained unoccupied since protesters broke in two months ago, trapping Israeli security guards inside until they were rescued by Egyptian troops.",116,124,trapping,2,4,6
3G4VVJO6PZH7ULRWKW2H7NVJ6YCPKQ,"Israel's embassy in a high-rise building in Cairo has remained unoccupied since protesters broke in two months ago, trapping Israeli security guards inside until they were rescued by Egyptian troops.",172,179,rescued,0,6,6
3G4VVJO6PZH7ULRWKW2H7NVJ6YCPKQ,The incident followed the killing in August of five Egyptian security guards by Israeli soldiers pursuing militants who had ambushed and killed eight Israelis along the Israeli-Egyptian border.,4,12,incident,1,0,1
3G4VVJO6PZH7ULRWKW2H7NVJ6YCPKQ,The incident followed the killing in August of five Egyptian security guards by Israeli soldiers pursuing militants who had ambushed and killed eight Israelis along the Israeli-Egyptian border.,97,105,pursuing,3,4,7
3G4VVJO6PZH7ULRWKW2H7NVJ6YCPKQ,The incident followed the killing in August of five Egyptian security guards by Israeli soldiers pursuing militants who had ambushed and killed eight Israelis along the Israeli-Egyptian border.,97,115,pursuing militants,2,0,2
3G4VVJO6PZH7ULRWKW2H7NVJ6YCPKQ,The incident followed the killing in August of five Egyptian security guards by Israeli soldiers pursuing militants who had ambushed and killed eight Israelis along the Israeli-Egyptian border.,106,115,militants,7,3,10
3G4VVJO6PZH7ULRWKW2H7NVJ6YCPKQ,The incident followed the killing in August of five Egyptian security guards by Israeli soldiers pursuing militants who had ambushed and killed eight Israelis along the Israeli-Egyptian border.,124,132,ambushed,10,10,20
3SSN80MU8CPC3UTN6NCY10HM7KIKXF,The Observatory said dozens had been wounded in shelling of the city by Syrian troops.,4,15,Observatory,3,3,6
3SSN80MU8CPC3UTN6NCY10HM7KIKXF,The Observatory said dozens had been wounded in shelling of the city by Syrian troops.,21,27,dozens,0,2,2
3SSN80MU8CPC3UTN6NCY10HM7KIKXF,The Observatory said dozens had been wounded in shelling of the city by Syrian troops.,37,44,wounded,0,3,3
3SSN80MU8CPC3UTN6NCY10HM7KIKXF,The Observatory said dozens had been wounded in shelling of the city by Syrian troops.,37,56,wounded in shelling,1,0,1
3SSN80MU8CPC3UTN6NCY10HM7KIKXF,The Observatory said dozens had been wounded in shelling of the city by Syrian troops.,48,56,shelling,7,9,16
3SSN80MU8CPC3UTN6NCY10HM7KIKXF,The Observatory said dozens had been wounded in shelling of the city by Syrian troops.,48,68,shelling of the city,1,0,1
3SSN80MU8CPC3UTN6NCY10HM7KIKXF,"The bombardment by regime forces resumed following the deadly clashes, it added.",4,15,bombardment,10,8,18
3SSN80MU8CPC3UTN6NCY10HM7KIKXF,"The bombardment by regime forces resumed following the deadly clashes, it added.",4,32,bombardment by regime forces,2,0,2
3SSN80MU8CPC3UTN6NCY10HM7KIKXF,"The bombardment by regime forces resumed following the deadly clashes, it added.",19,25,regime,4,4,8
3SSN80MU8CPC3UTN6NCY10HM7KIKXF,"The bombardment by regime forces resumed following the deadly clashes, it added.",33,40,resumed,1,3,4
3SSN80MU8CPC3UTN6NCY10HM7KIKXF,"The bombardment by regime forces resumed following the deadly clashes, it added.",55,69,deadly clashes,0,1,1
3SSN80MU8CPC3UTN6NCY10HM7KIKXF,"The bombardment by regime forces resumed following the deadly clashes, it added.",62,69,clashes,0,1,1
3SSN80MU8CPC3UTN6NCY10HM7KIKXF,"In Quraya in the eastern province of Deir Ezzor, a 15-year-old boy was killed by machinegun fire as regime forces raided the town, the Observatory said, bringing the total number of people killed on Monday to 25.",25,33,province,1,3,4
3SSN80MU8CPC3UTN6NCY10HM7KIKXF,"In Quraya in the eastern province of Deir Ezzor, a 15-year-old boy was killed by machinegun fire as regime forces raided the town, the Observatory said, bringing the total number of people killed on Monday to 25.",37,47,Deir Ezzor,1,0,1
3SSN80MU8CPC3UTN6NCY10HM7KIKXF,"In Quraya in the eastern province of Deir Ezzor, a 15-year-old boy was killed by machinegun fire as regime forces raided the town, the Observatory said, bringing the total number of people killed on Monday to 25.",81,91,machinegun,3,2,5
3SSN80MU8CPC3UTN6NCY10HM7KIKXF,"In Quraya in the eastern province of Deir Ezzor, a 15-year-old boy was killed by machinegun fire as regime forces raided the town, the Observatory said, bringing the total number of people killed on Monday to 25.",81,96,machinegun fire,2,1,3
3SSN80MU8CPC3UTN6NCY10HM7KIKXF,"In Quraya in the eastern province of Deir Ezzor, a 15-year-old boy was killed by machinegun fire as regime forces raided the town, the Observatory said, bringing the total number of people killed on Monday to 25.",100,106,regime,1,1,2
3SSN80MU8CPC3UTN6NCY10HM7KIKXF,"In Quraya in the eastern province of Deir Ezzor, a 15-year-old boy was killed by machinegun fire as regime forces raided the town, the Observatory said, bringing the total number of people killed on Monday to 25.",100,113,regime forces,0,1,1
3SSN80MU8CPC3UTN6NCY10HM7KIKXF,"In Quraya in the eastern province of Deir Ezzor, a 15-year-old boy was killed by machinegun fire as regime forces raided the town, the Observatory said, bringing the total number of people killed on Monday to 25.",114,120,raided,1,3,4
3SSN80MU8CPC3UTN6NCY10HM7KIKXF,"In Quraya in the eastern province of Deir Ezzor, a 15-year-old boy was killed by machinegun fire as regime forces raided the town, the Observatory said, bringing the total number of people killed on Monday to 25.",135,146,Observatory,0,2,2
3SSN80MU8CPC3UTN6NCY10HM7KIKXF,The watchdog added that 15 residents of the city were arrested.,0,12,The watchdog,0,1,1
3SSN80MU8CPC3UTN6NCY10HM7KIKXF,The watchdog added that 15 residents of the city were arrested.,4,12,watchdog,8,10,18
3SSN80MU8CPC3UTN6NCY10HM7KIKXF,"And in the capital Damascus, regime forces raided the neighborhood of Qaboon, while snipers were stationed on the roofs of some buildings.",11,18,capital,1,0,1
3SSN80MU8CPC3UTN6NCY10HM7KIKXF,"And in the capital Damascus, regime forces raided the neighborhood of Qaboon, while snipers were stationed on the roofs of some buildings.",29,35,regime,1,2,3
3SSN80MU8CPC3UTN6NCY10HM7KIKXF,"And in the capital Damascus, regime forces raided the neighborhood of Qaboon, while snipers were stationed on the roofs of some buildings.",43,49,raided,1,3,4
3SSN80MU8CPC3UTN6NCY10HM7KIKXF,"And in the capital Damascus, regime forces raided the neighborhood of Qaboon, while snipers were stationed on the roofs of some buildings.",54,66,neighborhood,1,1,2
3SSN80MU8CPC3UTN6NCY10HM7KIKXF,"And in the capital Damascus, regime forces raided the neighborhood of Qaboon, while snipers were stationed on the roofs of some buildings.",84,91,snipers,8,10,18
3SSN80MU8CPC3UTN6NCY10HM7KIKXF,"And in the capital Damascus, regime forces raided the neighborhood of Qaboon, while snipers were stationed on the roofs of some buildings.",97,106,stationed,4,2,6
3SSN80MU8CPC3UTN6NCY10HM7KIKXF,"The watchdog said 45 people — 25 civilians, 15 soldiers and five rebels — were killed in a surge of violence in various flashpoints on Sunday, despite a ceasefire brokered by UN-Arab League peace envoy Kofi Annan that was supposed to take effect on April 12.",4,12,watchdog,2,2,4
3SSN80MU8CPC3UTN6NCY10HM7KIKXF,"The watchdog said 45 people — 25 civilians, 15 soldiers and five rebels — were killed in a surge of violence in various flashpoints on Sunday, despite a ceasefire brokered by UN-Arab League peace envoy Kofi Annan that was supposed to take effect on April 12.",33,42,civilians,1,0,1
3SSN80MU8CPC3UTN6NCY10HM7KIKXF,"The watchdog said 45 people — 25 civilians, 15 soldiers and five rebels — were killed in a surge of violence in various flashpoints on Sunday, despite a ceasefire brokered by UN-Arab League peace envoy Kofi Annan that was supposed to take effect on April 12.",65,71,rebels,0,3,3
3SSN80MU8CPC3UTN6NCY10HM7KIKXF,"The watchdog said 45 people — 25 civilians, 15 soldiers and five rebels — were killed in a surge of violence in various flashpoints on Sunday, despite a ceasefire brokered by UN-Arab League peace envoy Kofi Annan that was supposed to take effect on April 12.",89,108,a surge of violence,0,1,1
3SSN80MU8CPC3UTN6NCY10HM7KIKXF,"The watchdog said 45 people — 25 civilians, 15 soldiers and five rebels — were killed in a surge of violence in various flashpoints on Sunday, despite a ceasefire brokered by UN-Arab League peace envoy Kofi Annan that was supposed to take effect on April 12.",91,96,surge,5,4,9
3SSN80MU8CPC3UTN6NCY10HM7KIKXF,"The watchdog said 45 people — 25 civilians, 15 soldiers and five rebels — were killed in a surge of violence in various flashpoints on Sunday, despite a ceasefire brokered by UN-Arab League peace envoy Kofi Annan that was supposed to take effect on April 12.",91,108,surge of violence,0,2,2
3SSN80MU8CPC3UTN6NCY10HM7KIKXF,"The watchdog said 45 people — 25 civilians, 15 soldiers and five rebels — were killed in a surge of violence in various flashpoints on Sunday, despite a ceasefire brokered by UN-Arab League peace envoy Kofi Annan that was supposed to take effect on April 12.",100,108,violence,0,1,1
3SSN80MU8CPC3UTN6NCY10HM7KIKXF,"The watchdog said 45 people — 25 civilians, 15 soldiers and five rebels — were killed in a surge of violence in various flashpoints on Sunday, despite a ceasefire brokered by UN-Arab League peace envoy Kofi Annan that was supposed to take effect on April 12.",112,131,various flashpoints,2,0,2
3SSN80MU8CPC3UTN6NCY10HM7KIKXF,"The watchdog said 45 people — 25 civilians, 15 soldiers and five rebels — were killed in a surge of violence in various flashpoints on Sunday, despite a ceasefire brokered by UN-Arab League peace envoy Kofi Annan that was supposed to take effect on April 12.",120,131,flashpoints,10,10,20
3SSN80MU8CPC3UTN6NCY10HM7KIKXF,"The watchdog said 45 people — 25 civilians, 15 soldiers and five rebels — were killed in a surge of violence in various flashpoints on Sunday, despite a ceasefire brokered by UN-Arab League peace envoy Kofi Annan that was supposed to take effect on April 12.",143,150,despite,0,2,2
3SSN80MU8CPC3UTN6NCY10HM7KIKXF,"The watchdog said 45 people — 25 civilians, 15 soldiers and five rebels — were killed in a surge of violence in various flashpoints on Sunday, despite a ceasefire brokered by UN-Arab League peace envoy Kofi Annan that was supposed to take effect on April 12.",153,162,ceasefire,5,9,14
3SSN80MU8CPC3UTN6NCY10HM7KIKXF,"The watchdog said 45 people — 25 civilians, 15 soldiers and five rebels — were killed in a surge of violence in various flashpoints on Sunday, despite a ceasefire brokered by UN-Arab League peace envoy Kofi Annan that was supposed to take effect on April 12.",153,171,ceasefire brokered,4,1,5
3SSN80MU8CPC3UTN6NCY10HM7KIKXF,"The watchdog said 45 people — 25 civilians, 15 soldiers and five rebels — were killed in a surge of violence in various flashpoints on Sunday, despite a ceasefire brokered by UN-Arab League peace envoy Kofi Annan that was supposed to take effect on April 12.",163,171,brokered,1,6,7
3SSN80MU8CPC3UTN6NCY10HM7KIKXF,"The watchdog said 45 people — 25 civilians, 15 soldiers and five rebels — were killed in a surge of violence in various flashpoints on Sunday, despite a ceasefire brokered by UN-Arab League peace envoy Kofi Annan that was supposed to take effect on April 12.",190,201,peace envoy,0,1,1
3SSN80MU8CPC3UTN6NCY10HM7KIKXF,"The watchdog said 45 people — 25 civilians, 15 soldiers and five rebels — were killed in a surge of violence in various flashpoints on Sunday, despite a ceasefire brokered by UN-Arab League peace envoy Kofi Annan that was supposed to take effect on April 12.",196,201,envoy,4,3,7
3SSN80MU8CPC3UTN6NCY10HM7KIKXF,"The watchdog said 45 people — 25 civilians, 15 soldiers and five rebels — were killed in a surge of violence in various flashpoints on Sunday, despite a ceasefire brokered by UN-Arab League peace envoy Kofi Annan that was supposed to take effect on April 12.",202,212,Kofi Annan,1,0,1
3PEG1BH7AES5QRQM1RKGC3QUOHUBKX,"The government of Mariano Rajoy took the sweeping action just two days after it effectively took over the fourth-biggest bank, Bankia, to salvage its balance sheet, bulging with losses.",4,14,government,1,0,1
3PEG1BH7AES5QRQM1RKGC3QUOHUBKX,"The government of Mariano Rajoy took the sweeping action just two days after it effectively took over the fourth-biggest bank, Bankia, to salvage its balance sheet, bulging with losses.",41,49,sweeping,3,7,10
3PEG1BH7AES5QRQM1RKGC3QUOHUBKX,"The government of Mariano Rajoy took the sweeping action just two days after it effectively took over the fourth-biggest bank, Bankia, to salvage its balance sheet, bulging with losses.",41,56,sweeping action,5,2,7
3PEG1BH7AES5QRQM1RKGC3QUOHUBKX,"The government of Mariano Rajoy took the sweeping action just two days after it effectively took over the fourth-biggest bank, Bankia, to salvage its balance sheet, bulging with losses.",80,91,effectively,1,2,3
3PEG1BH7AES5QRQM1RKGC3QUOHUBKX,"The government of Mariano Rajoy took the sweeping action just two days after it effectively took over the fourth-biggest bank, Bankia, to salvage its balance sheet, bulging with losses.",138,145,salvage,10,8,18
3PEG1BH7AES5QRQM1RKGC3QUOHUBKX,"The government of Mariano Rajoy took the sweeping action just two days after it effectively took over the fourth-biggest bank, Bankia, to salvage its balance sheet, bulging with losses.",150,163,balance sheet,3,2,5
3PEG1BH7AES5QRQM1RKGC3QUOHUBKX,"The government of Mariano Rajoy took the sweeping action just two days after it effectively took over the fourth-biggest bank, Bankia, to salvage its balance sheet, bulging with losses.",165,172,bulging,9,8,17
3PEG1BH7AES5QRQM1RKGC3QUOHUBKX,"The government also ordered an independent audit on loans and property assets across the entire banking sector, as the European Union had asked.",31,42,independent,2,1,3
3PEG1BH7AES5QRQM1RKGC3QUOHUBKX,"The government also ordered an independent audit on loans and property assets across the entire banking sector, as the European Union had asked.",31,48,independent audit,3,1,4
3PEG1BH7AES5QRQM1RKGC3QUOHUBKX,"The government also ordered an independent audit on loans and property assets across the entire banking sector, as the European Union had asked.",43,48,audit,4,2,6
3PEG1BH7AES5QRQM1RKGC3QUOHUBKX,"The government also ordered an independent audit on loans and property assets across the entire banking sector, as the European Union had asked.",71,77,assets,1,0,1
3PEG1BH7AES5QRQM1RKGC3QUOHUBKX,"The government also ordered an independent audit on loans and property assets across the entire banking sector, as the European Union had asked.",96,110,banking sector,2,0,2
3PEG1BH7AES5QRQM1RKGC3QUOHUBKX,"The government also ordered an independent audit on loans and property assets across the entire banking sector, as the European Union had asked.",104,110,sector,1,0,1
3PEG1BH7AES5QRQM1RKGC3QUOHUBKX,"Luis de Guindos, Spain's economy minister, said: ""The government wants complete transparency, clarity is crucial to end any doubt about Spain's solvency.""",0,15,Luis de Guindos,1,0,1
3PEG1BH7AES5QRQM1RKGC3QUOHUBKX,"Luis de Guindos, Spain's economy minister, said: ""The government wants complete transparency, clarity is crucial to end any doubt about Spain's solvency.""",25,32,economy,1,0,1
3PEG1BH7AES5QRQM1RKGC3QUOHUBKX,"Luis de Guindos, Spain's economy minister, said: ""The government wants complete transparency, clarity is crucial to end any doubt about Spain's solvency.""",71,92,complete transparency,1,0,1
3PEG1BH7AES5QRQM1RKGC3QUOHUBKX,"Luis de Guindos, Spain's economy minister, said: ""The government wants complete transparency, clarity is crucial to end any doubt about Spain's solvency.""",80,92,transparency,7,9,16
3PEG1BH7AES5QRQM1RKGC3QUOHUBKX,"Luis de Guindos, Spain's economy minister, said: ""The government wants complete transparency, clarity is crucial to end any doubt about Spain's solvency.""",94,101,clarity,6,2,8
3PEG1BH7AES5QRQM1RKGC3QUOHUBKX,"Luis de Guindos, Spain's economy minister, said: ""The government wants complete transparency, clarity is crucial to end any doubt about Spain's solvency.""",105,112,crucial,2,3,5
3PEG1BH7AES5QRQM1RKGC3QUOHUBKX,"Luis de Guindos, Spain's economy minister, said: ""The government wants complete transparency, clarity is crucial to end any doubt about Spain's solvency.""",144,152,solvency,10,9,19
3PEG1BH7AES5QRQM1RKGC3QUOHUBKX,"Banks have until the end of the year to move their property holdings into asset-management firms for a fire-sale, Guindos said.",51,68,property holdings,1,0,1
3PEG1BH7AES5QRQM1RKGC3QUOHUBKX,"Banks have until the end of the year to move their property holdings into asset-management firms for a fire-sale, Guindos said.",74,90,asset-management,3,4,7
3PEG1BH7AES5QRQM1RKGC3QUOHUBKX,"Banks have until the end of the year to move their property holdings into asset-management firms for a fire-sale, Guindos said.",74,96,asset-management firms,2,0,2
3PEG1BH7AES5QRQM1RKGC3QUOHUBKX,"Banks have until the end of the year to move their property holdings into asset-management firms for a fire-sale, Guindos said.",103,112,fire-sale,5,7,12
3PEG1BH7AES5QRQM1RKGC3QUOHUBKX,Deficit-cutting targets Spain separately annnounced that it stood by its ambitious deficit-cutting targets for 2012 and 2013 despite European forecasts that it would fail to achieve them.,0,15,Deficit-cutting,4,9,13
3PEG1BH7AES5QRQM1RKGC3QUOHUBKX,Deficit-cutting targets Spain separately annnounced that it stood by its ambitious deficit-cutting targets for 2012 and 2013 despite European forecasts that it would fail to achieve them.,0,23,Deficit-cutting targets,2,0,2
3PEG1BH7AES5QRQM1RKGC3QUOHUBKX,Deficit-cutting targets Spain separately annnounced that it stood by its ambitious deficit-cutting targets for 2012 and 2013 despite European forecasts that it would fail to achieve them.,16,23,targets,0,1,1
3PEG1BH7AES5QRQM1RKGC3QUOHUBKX,Deficit-cutting targets Spain separately annnounced that it stood by its ambitious deficit-cutting targets for 2012 and 2013 despite European forecasts that it would fail to achieve them.,41,51,annnounced,1,2,3
3PEG1BH7AES5QRQM1RKGC3QUOHUBKX,Deficit-cutting targets Spain separately annnounced that it stood by its ambitious deficit-cutting targets for 2012 and 2013 despite European forecasts that it would fail to achieve them.,60,65,stood,0,1,1
3PEG1BH7AES5QRQM1RKGC3QUOHUBKX,Deficit-cutting targets Spain separately annnounced that it stood by its ambitious deficit-cutting targets for 2012 and 2013 despite European forecasts that it would fail to achieve them.,73,82,ambitious,3,8,11
3PEG1BH7AES5QRQM1RKGC3QUOHUBKX,Deficit-cutting targets Spain separately annnounced that it stood by its ambitious deficit-cutting targets for 2012 and 2013 despite European forecasts that it would fail to achieve them.,73,98,ambitious deficit-cutting,1,0,1
3PEG1BH7AES5QRQM1RKGC3QUOHUBKX,Deficit-cutting targets Spain separately annnounced that it stood by its ambitious deficit-cutting targets for 2012 and 2013 despite European forecasts that it would fail to achieve them.,83,98,deficit-cutting,4,2,6
3PEG1BH7AES5QRQM1RKGC3QUOHUBKX,Deficit-cutting targets Spain separately annnounced that it stood by its ambitious deficit-cutting targets for 2012 and 2013 despite European forecasts that it would fail to achieve them.,125,132,despite,0,1,1
3PEG1BH7AES5QRQM1RKGC3QUOHUBKX,Deficit-cutting targets Spain separately annnounced that it stood by its ambitious deficit-cutting targets for 2012 and 2013 despite European forecasts that it would fail to achieve them.,142,151,forecasts,4,8,12
3MJ9GGZYO375Q1H467EGHWKUQCQA29,A 32-year-old is recovering after he was shot in the chest and arm by a gunman in the Ballyfermot area of Dublin last night.,17,27,recovering,4,5,9
3MJ9GGZYO375Q1H467EGHWKUQCQA29,A 32-year-old is recovering after he was shot in the chest and arm by a gunman in the Ballyfermot area of Dublin last night.,53,58,chest,0,1,1
3MJ9GGZYO375Q1H467EGHWKUQCQA29,A 32-year-old is recovering after he was shot in the chest and arm by a gunman in the Ballyfermot area of Dublin last night.,86,97,Ballyfermot,0,1,1
3MJ9GGZYO375Q1H467EGHWKUQCQA29,A 32-year-old is recovering after he was shot in the chest and arm by a gunman in the Ballyfermot area of Dublin last night.,86,102,Ballyfermot area,1,0,1
3MJ9GGZYO375Q1H467EGHWKUQCQA29,"The gunman fired a number of shots at the victim, who was in his car outside the Ruby Finnegans pub on Sarsfield Road at around 11.10pm.",42,48,victim,0,5,5
3MJ9GGZYO375Q1H467EGHWKUQCQA29,"The gunman fired a number of shots at the victim, who was in his car outside the Ruby Finnegans pub on Sarsfield Road at around 11.10pm.",96,99,pub,2,0,2
3MJ9GGZYO375Q1H467EGHWKUQCQA29,"He made his getaway in a car that was later found burnt out in Inchicore, where a gun was also recovered.",12,19,getaway,8,8,16
3MJ9GGZYO375Q1H467EGHWKUQCQA29,"He made his getaway in a car that was later found burnt out in Inchicore, where a gun was also recovered.",50,55,burnt,2,2,4
3MJ9GGZYO375Q1H467EGHWKUQCQA29,"He made his getaway in a car that was later found burnt out in Inchicore, where a gun was also recovered.",50,59,burnt out,1,0,1
3MJ9GGZYO375Q1H467EGHWKUQCQA29,"He made his getaway in a car that was later found burnt out in Inchicore, where a gun was also recovered.",63,72,Inchicore,0,1,1
3MJ9GGZYO375Q1H467EGHWKUQCQA29,"He made his getaway in a car that was later found burnt out in Inchicore, where a gun was also recovered.",95,104,recovered,2,0,2
3MJ9GGZYO375Q1H467EGHWKUQCQA29,The victim was taken to Tallaght Hospital.,4,10,victim,3,0,3
3MJ9GGZYO375Q1H467EGHWKUQCQA29,His injuries are not believed to be life-threatening.,4,12,injuries,0,2,2
3MJ9GGZYO375Q1H467EGHWKUQCQA29,His injuries are not believed to be life-threatening.,36,52,life-threatening,10,9,19
3MJ9GGZYO375Q1H467EGHWKUQCQA29,Both cars have been taken away for technical and forensic examination.,35,44,technical,5,1,6
3MJ9GGZYO375Q1H467EGHWKUQCQA29,Both cars have been taken away for technical and forensic examination.,35,69,technical and forensic examination,3,1,4
3MJ9GGZYO375Q1H467EGHWKUQCQA29,Both cars have been taken away for technical and forensic examination.,49,57,forensic,5,4,9
3MJ9GGZYO375Q1H467EGHWKUQCQA29,Both cars have been taken away for technical and forensic examination.,49,69,forensic examination,8,4,12
3MJ9GGZYO375Q1H467EGHWKUQCQA29,Gardaí say witnesses at the scene describe a silver saloon car leaving the area.,0,6,Gardaí,0,1,1
3MJ9GGZYO375Q1H467EGHWKUQCQA29,Gardaí say witnesses at the scene describe a silver saloon car leaving the area.,11,20,witnesses,3,1,4
3MJ9GGZYO375Q1H467EGHWKUQCQA29,Gardaí say witnesses at the scene describe a silver saloon car leaving the area.,45,62,silver saloon car,1,0,1
3MJ9GGZYO375Q1H467EGHWKUQCQA29,Gardaí say witnesses at the scene describe a silver saloon car leaving the area.,52,58,saloon,2,1,3
3MJ9GGZYO375Q1H467EGHWKUQCQA29,Gardaí say witnesses at the scene describe a silver saloon car leaving the area.,52,62,saloon car,4,2,6
3MJ9GGZYO375Q1H467EGHWKUQCQA29,A silver car was subsequently discovered on fire at Goldenbridge Terrace in Inchicore at 11.30pm.,17,29,subsequently,10,6,16
3MJ9GGZYO375Q1H467EGHWKUQCQA29,A silver car was subsequently discovered on fire at Goldenbridge Terrace in Inchicore at 11.30pm.,17,40,subsequently discovered,1,0,1
3JTPR5MTZSD31B9D0HT39HQ2FYB5KK,"China insists it has sovereign rights to all of the South China Sea, even waters close to the coast of other countries and hundreds of miles from its own mainland.",6,13,insists,0,3,3
3JTPR5MTZSD31B9D0HT39HQ2FYB5KK,"China insists it has sovereign rights to all of the South China Sea, even waters close to the coast of other countries and hundreds of miles from its own mainland.",21,30,sovereign,8,8,16
3JTPR5MTZSD31B9D0HT39HQ2FYB5KK,"China insists it has sovereign rights to all of the South China Sea, even waters close to the coast of other countries and hundreds of miles from its own mainland.",21,37,sovereign rights,3,4,7
3JTPR5MTZSD31B9D0HT39HQ2FYB5KK,"China insists it has sovereign rights to all of the South China Sea, even waters close to the coast of other countries and hundreds of miles from its own mainland.",154,162,mainland,1,4,5
3JTPR5MTZSD31B9D0HT39HQ2FYB5KK,"The Philippines says it has sovereign rights over waters within its 200-nautical-mile exclusive economic zone, and that its position is supported by international law.",28,37,sovereign,6,3,9
3JTPR5MTZSD31B9D0HT39HQ2FYB5KK,"The Philippines says it has sovereign rights over waters within its 200-nautical-mile exclusive economic zone, and that its position is supported by international law.",28,44,sovereign rights,1,2,3
3JTPR5MTZSD31B9D0HT39HQ2FYB5KK,"The Philippines says it has sovereign rights over waters within its 200-nautical-mile exclusive economic zone, and that its position is supported by international law.",86,95,exclusive,4,3,7
3JTPR5MTZSD31B9D0HT39HQ2FYB5KK,"The Philippines says it has sovereign rights over waters within its 200-nautical-mile exclusive economic zone, and that its position is supported by international law.",86,104,exclusive economic,1,0,1
3JTPR5MTZSD31B9D0HT39HQ2FYB5KK,"The Philippines says it has sovereign rights over waters within its 200-nautical-mile exclusive economic zone, and that its position is supported by international law.",86,109,exclusive economic zone,2,2,4
3JTPR5MTZSD31B9D0HT39HQ2FYB5KK,"The Philippines says it has sovereign rights over waters within its 200-nautical-mile exclusive economic zone, and that its position is supported by international law.",96,104,economic,2,0,2
3JTPR5MTZSD31B9D0HT39HQ2FYB5KK,"The Philippines says it has sovereign rights over waters within its 200-nautical-mile exclusive economic zone, and that its position is supported by international law.",96,109,economic zone,1,0,1
3JTPR5MTZSD31B9D0HT39HQ2FYB5KK,"The Philippines says it has sovereign rights over waters within its 200-nautical-mile exclusive economic zone, and that its position is supported by international law.",124,132,position,1,1,2
3JTPR5MTZSD31B9D0HT39HQ2FYB5KK,"The Philippines says it has sovereign rights over waters within its 200-nautical-mile exclusive economic zone, and that its position is supported by international law.",136,145,supported,0,1,1
3JTPR5MTZSD31B9D0HT39HQ2FYB5KK,"The Philippines says it has sovereign rights over waters within its 200-nautical-mile exclusive economic zone, and that its position is supported by international law.",149,162,international,1,0,1
3JTPR5MTZSD31B9D0HT39HQ2FYB5KK,"The Philippines says it has sovereign rights over waters within its 200-nautical-mile exclusive economic zone, and that its position is supported by international law.",149,166,international law,0,1,1
3JTPR5MTZSD31B9D0HT39HQ2FYB5KK,"Apart from China and the Philippines, Taiwan, Malaysia, Brunei and Vietnam, also have overlapping claims to parts of the South China Sea, making the waters one of Asia's potential flashpoints for armed conflict.",86,97,overlapping,5,5,10
3JTPR5MTZSD31B9D0HT39HQ2FYB5KK,"Apart from China and the Philippines, Taiwan, Malaysia, Brunei and Vietnam, also have overlapping claims to parts of the South China Sea, making the waters one of Asia's potential flashpoints for armed conflict.",86,104,overlapping claims,2,5,7
3JTPR5MTZSD31B9D0HT39HQ2FYB5KK,"Apart from China and the Philippines, Taiwan, Malaysia, Brunei and Vietnam, also have overlapping claims to parts of the South China Sea, making the waters one of Asia's potential flashpoints for armed conflict.",98,104,claims,0,1,1
3JTPR5MTZSD31B9D0HT39HQ2FYB5KK,"Apart from China and the Philippines, Taiwan, Malaysia, Brunei and Vietnam, also have overlapping claims to parts of the South China Sea, making the waters one of Asia's potential flashpoints for armed conflict.",168,191,s potential flashpoints,1,0,1
3JTPR5MTZSD31B9D0HT39HQ2FYB5KK,"Apart from China and the Philippines, Taiwan, Malaysia, Brunei and Vietnam, also have overlapping claims to parts of the South China Sea, making the waters one of Asia's potential flashpoints for armed conflict.",170,179,potential,2,2,4
3JTPR5MTZSD31B9D0HT39HQ2FYB5KK,"Apart from China and the Philippines, Taiwan, Malaysia, Brunei and Vietnam, also have overlapping claims to parts of the South China Sea, making the waters one of Asia's potential flashpoints for armed conflict.",170,191,potential flashpoints,3,2,5
3JTPR5MTZSD31B9D0HT39HQ2FYB5KK,"Apart from China and the Philippines, Taiwan, Malaysia, Brunei and Vietnam, also have overlapping claims to parts of the South China Sea, making the waters one of Asia's potential flashpoints for armed conflict.",180,191,flashpoints,7,10,17
3JTPR5MTZSD31B9D0HT39HQ2FYB5KK,"Apart from China and the Philippines, Taiwan, Malaysia, Brunei and Vietnam, also have overlapping claims to parts of the South China Sea, making the waters one of Asia's potential flashpoints for armed conflict.",196,210,armed conflict,1,2,3
3JTPR5MTZSD31B9D0HT39HQ2FYB5KK,"Apart from China and the Philippines, Taiwan, Malaysia, Brunei and Vietnam, also have overlapping claims to parts of the South China Sea, making the waters one of Asia's potential flashpoints for armed conflict.",202,210,conflict,1,4,5
3JTPR5MTZSD31B9D0HT39HQ2FYB5KK,The Philippines and Vietnam complained last year of increasingly aggressive acts by China in staking its claim to the South China Sea.,28,38,complained,0,1,1
3JTPR5MTZSD31B9D0HT39HQ2FYB5KK,The Philippines and Vietnam complained last year of increasingly aggressive acts by China in staking its claim to the South China Sea.,52,64,increasingly,0,1,1
3JTPR5MTZSD31B9D0HT39HQ2FYB5KK,The Philippines and Vietnam complained last year of increasingly aggressive acts by China in staking its claim to the South China Sea.,52,75,increasingly aggressive,2,0,2
3JTPR5MTZSD31B9D0HT39HQ2FYB5KK,The Philippines and Vietnam complained last year of increasingly aggressive acts by China in staking its claim to the South China Sea.,52,80,increasingly aggressive acts,1,0,1
3JTPR5MTZSD31B9D0HT39HQ2FYB5KK,The Philippines and Vietnam complained last year of increasingly aggressive acts by China in staking its claim to the South China Sea.,65,75,aggressive,4,3,7
3JTPR5MTZSD31B9D0HT39HQ2FYB5KK,The Philippines and Vietnam complained last year of increasingly aggressive acts by China in staking its claim to the South China Sea.,65,80,aggressive acts,0,2,2
3JTPR5MTZSD31B9D0HT39HQ2FYB5KK,The Philippines and Vietnam complained last year of increasingly aggressive acts by China in staking its claim to the South China Sea.,93,100,staking,3,8,11
3JTPR5MTZSD31B9D0HT39HQ2FYB5KK,The Philippines and Vietnam complained last year of increasingly aggressive acts by China in staking its claim to the South China Sea.,93,110,staking its claim,1,0,1
3JTPR5MTZSD31B9D0HT39HQ2FYB5KK,"The Philippines accused Chinese vessels of firing warning shots at Filipino fishermen, as well as harassing an oil exploration vessel.",16,23,accused,1,3,4
3JTPR5MTZSD31B9D0HT39HQ2FYB5KK,"The Philippines accused Chinese vessels of firing warning shots at Filipino fishermen, as well as harassing an oil exploration vessel.",24,39,Chinese vessels,0,1,1
3JTPR5MTZSD31B9D0HT39HQ2FYB5KK,"The Philippines accused Chinese vessels of firing warning shots at Filipino fishermen, as well as harassing an oil exploration vessel.",32,39,vessels,3,1,4
3JTPR5MTZSD31B9D0HT39HQ2FYB5KK,"The Philippines accused Chinese vessels of firing warning shots at Filipino fishermen, as well as harassing an oil exploration vessel.",50,57,warning,1,0,1
3JTPR5MTZSD31B9D0HT39HQ2FYB5KK,"The Philippines accused Chinese vessels of firing warning shots at Filipino fishermen, as well as harassing an oil exploration vessel.",50,63,warning shots,0,2,2
3JTPR5MTZSD31B9D0HT39HQ2FYB5KK,"The Philippines accused Chinese vessels of firing warning shots at Filipino fishermen, as well as harassing an oil exploration vessel.",98,107,harassing,8,10,18
3JTPR5MTZSD31B9D0HT39HQ2FYB5KK,"The Philippines accused Chinese vessels of firing warning shots at Filipino fishermen, as well as harassing an oil exploration vessel.",98,133,harassing an oil exploration vessel,1,0,1
3JTPR5MTZSD31B9D0HT39HQ2FYB5KK,"The Philippines accused Chinese vessels of firing warning shots at Filipino fishermen, as well as harassing an oil exploration vessel.",111,126,oil exploration,1,0,1
3JTPR5MTZSD31B9D0HT39HQ2FYB5KK,"The Philippines accused Chinese vessels of firing warning shots at Filipino fishermen, as well as harassing an oil exploration vessel.",111,133,oil exploration vessel,2,1,3
3JTPR5MTZSD31B9D0HT39HQ2FYB5KK,"The Philippines accused Chinese vessels of firing warning shots at Filipino fishermen, as well as harassing an oil exploration vessel.",115,126,exploration,4,3,7
3JTPR5MTZSD31B9D0HT39HQ2FYB5KK,"The Philippines accused Chinese vessels of firing warning shots at Filipino fishermen, as well as harassing an oil exploration vessel.",115,133,exploration vessel,1,0,1
3JTPR5MTZSD31B9D0HT39HQ2FYB5KK,"The Philippines accused Chinese vessels of firing warning shots at Filipino fishermen, as well as harassing an oil exploration vessel.",127,133,vessel,0,2,2
3OPLMF3EU5OIB6X1PH1QIY33U6DNL1,"Thus far, however, the government action to clean up its banks seems to have failed to boost the sector's stocks.",0,8,Thus far,1,1,2
3OPLMF3EU5OIB6X1PH1QIY33U6DNL1,"Thus far, however, the government action to clean up its banks seems to have failed to boost the sector's stocks.",23,33,government,1,0,1
3OPLMF3EU5OIB6X1PH1QIY33U6DNL1,"Thus far, however, the government action to clean up its banks seems to have failed to boost the sector's stocks.",87,92,boost,6,4,10
3OPLMF3EU5OIB6X1PH1QIY33U6DNL1,"Thus far, however, the government action to clean up its banks seems to have failed to boost the sector's stocks.",97,103,sector,1,0,1
3OPLMF3EU5OIB6X1PH1QIY33U6DNL1,"Thus far, however, the government action to clean up its banks seems to have failed to boost the sector's stocks.",97,104,sectors,3,0,3
3OPLMF3EU5OIB6X1PH1QIY33U6DNL1,"Thus far, however, the government action to clean up its banks seems to have failed to boost the sector's stocks.",97,111,sectors stocks,3,3,6
3OPLMF3EU5OIB6X1PH1QIY33U6DNL1,"Thus far, however, the government action to clean up its banks seems to have failed to boost the sector's stocks.",106,112,stocks,1,1,2
3OPLMF3EU5OIB6X1PH1QIY33U6DNL1,"Madrid's IBEX-35 index of leading shares closed down 0.71 per cent, but at one point was off more than 3.0 per cent as even the healthiest banks suffered.",17,22,index,2,2,4
3OPLMF3EU5OIB6X1PH1QIY33U6DNL1,"Madrid's IBEX-35 index of leading shares closed down 0.71 per cent, but at one point was off more than 3.0 per cent as even the healthiest banks suffered.",17,40,index of leading shares,1,0,1
3OPLMF3EU5OIB6X1PH1QIY33U6DNL1,"Madrid's IBEX-35 index of leading shares closed down 0.71 per cent, but at one point was off more than 3.0 per cent as even the healthiest banks suffered.",26,33,leading,0,1,1
3OPLMF3EU5OIB6X1PH1QIY33U6DNL1,"Madrid's IBEX-35 index of leading shares closed down 0.71 per cent, but at one point was off more than 3.0 per cent as even the healthiest banks suffered.",26,40,leading shares,4,2,6
3OPLMF3EU5OIB6X1PH1QIY33U6DNL1,"Madrid's IBEX-35 index of leading shares closed down 0.71 per cent, but at one point was off more than 3.0 per cent as even the healthiest banks suffered.",128,138,healthiest,3,4,7
3OPLMF3EU5OIB6X1PH1QIY33U6DNL1,"Madrid's IBEX-35 index of leading shares closed down 0.71 per cent, but at one point was off more than 3.0 per cent as even the healthiest banks suffered.",128,144,healthiest banks,1,3,4
3OPLMF3EU5OIB6X1PH1QIY33U6DNL1,"Madrid's IBEX-35 index of leading shares closed down 0.71 per cent, but at one point was off more than 3.0 per cent as even the healthiest banks suffered.",145,153,suffered,1,3,4
3OPLMF3EU5OIB6X1PH1QIY33U6DNL1,"Santander, the eurozone's biggest bank by assets, fell 1.0 per cent to 4.871 euros, Spanish number-two BBVA dropped 1.26 per cent to 5.243 euros and Bankia skidded 3.37 per cent to 2.034 euros.",0,9,Santander,0,1,1
3OPLMF3EU5OIB6X1PH1QIY33U6DNL1,"Santander, the eurozone's biggest bank by assets, fell 1.0 per cent to 4.871 euros, Spanish number-two BBVA dropped 1.26 per cent to 5.243 euros and Bankia skidded 3.37 per cent to 2.034 euros.",15,23,eurozone,1,0,1
3OPLMF3EU5OIB6X1PH1QIY33U6DNL1,"Santander, the eurozone's biggest bank by assets, fell 1.0 per cent to 4.871 euros, Spanish number-two BBVA dropped 1.26 per cent to 5.243 euros and Bankia skidded 3.37 per cent to 2.034 euros.",15,24,eurozones,6,0,6
3OPLMF3EU5OIB6X1PH1QIY33U6DNL1,"Santander, the eurozone's biggest bank by assets, fell 1.0 per cent to 4.871 euros, Spanish number-two BBVA dropped 1.26 per cent to 5.243 euros and Bankia skidded 3.37 per cent to 2.034 euros.",42,48,assets,2,3,5
3OPLMF3EU5OIB6X1PH1QIY33U6DNL1,"Santander, the eurozone's biggest bank by assets, fell 1.0 per cent to 4.871 euros, Spanish number-two BBVA dropped 1.26 per cent to 5.243 euros and Bankia skidded 3.37 per cent to 2.034 euros.",103,107,BBVA,1,1,2
3OPLMF3EU5OIB6X1PH1QIY33U6DNL1,"Santander, the eurozone's biggest bank by assets, fell 1.0 per cent to 4.871 euros, Spanish number-two BBVA dropped 1.26 per cent to 5.243 euros and Bankia skidded 3.37 per cent to 2.034 euros.",149,155,Bankia,0,1,1
3OPLMF3EU5OIB6X1PH1QIY33U6DNL1,"Santander, the eurozone's biggest bank by assets, fell 1.0 per cent to 4.871 euros, Spanish number-two BBVA dropped 1.26 per cent to 5.243 euros and Bankia skidded 3.37 per cent to 2.034 euros.",156,163,skidded,7,10,17
3OPLMF3EU5OIB6X1PH1QIY33U6DNL1,"Bankia, in which the state is taking a 45-per cent stake as a crisis measure to save it from crippling bad loans, had 37.5bn euros in exposure to the property sector at the end of 2011.",0,6,Bankia,0,1,1
3OPLMF3EU5OIB6X1PH1QIY33U6DNL1,"Bankia, in which the state is taking a 45-per cent stake as a crisis measure to save it from crippling bad loans, had 37.5bn euros in exposure to the property sector at the end of 2011.",51,56,stake,1,5,6
3OPLMF3EU5OIB6X1PH1QIY33U6DNL1,"Bankia, in which the state is taking a 45-per cent stake as a crisis measure to save it from crippling bad loans, had 37.5bn euros in exposure to the property sector at the end of 2011.",62,68,crisis,3,4,7
3OPLMF3EU5OIB6X1PH1QIY33U6DNL1,"Bankia, in which the state is taking a 45-per cent stake as a crisis measure to save it from crippling bad loans, had 37.5bn euros in exposure to the property sector at the end of 2011.",62,76,crisis measure,3,2,5
3OPLMF3EU5OIB6X1PH1QIY33U6DNL1,"Bankia, in which the state is taking a 45-per cent stake as a crisis measure to save it from crippling bad loans, had 37.5bn euros in exposure to the property sector at the end of 2011.",93,102,crippling,6,10,16
3OPLMF3EU5OIB6X1PH1QIY33U6DNL1,"Bankia, in which the state is taking a 45-per cent stake as a crisis measure to save it from crippling bad loans, had 37.5bn euros in exposure to the property sector at the end of 2011.",93,112,crippling bad loans,4,1,5
3OPLMF3EU5OIB6X1PH1QIY33U6DNL1,"Bankia, in which the state is taking a 45-per cent stake as a crisis measure to save it from crippling bad loans, had 37.5bn euros in exposure to the property sector at the end of 2011.",131,142,in exposure,1,0,1
3OPLMF3EU5OIB6X1PH1QIY33U6DNL1,"Bankia, in which the state is taking a 45-per cent stake as a crisis measure to save it from crippling bad loans, had 37.5bn euros in exposure to the property sector at the end of 2011.",134,142,exposure,4,4,8
3OPLMF3EU5OIB6X1PH1QIY33U6DNL1,"Bankia, in which the state is taking a 45-per cent stake as a crisis measure to save it from crippling bad loans, had 37.5bn euros in exposure to the property sector at the end of 2011.",134,165,exposure to the property sector,0,1,1
3OPLMF3EU5OIB6X1PH1QIY33U6DNL1,"Bankia, in which the state is taking a 45-per cent stake as a crisis measure to save it from crippling bad loans, had 37.5bn euros in exposure to the property sector at the end of 2011.",150,165,property sector,3,0,3
3OPLMF3EU5OIB6X1PH1QIY33U6DNL1,"Sunni gunmen stand in the middle of Syria Street which divides the Sunni and Alawite areas, in the northern port city of Tripoli, Lebanon,.",0,5,Sunni,0,1,1
3OPLMF3EU5OIB6X1PH1QIY33U6DNL1,"Sunni gunmen stand in the middle of Syria Street which divides the Sunni and Alawite areas, in the northern port city of Tripoli, Lebanon,.",0,12,Sunni gunmen,2,0,2
3OPLMF3EU5OIB6X1PH1QIY33U6DNL1,"Sunni gunmen stand in the middle of Syria Street which divides the Sunni and Alawite areas, in the northern port city of Tripoli, Lebanon,.",6,12,gunmen,0,1,1
3OPLMF3EU5OIB6X1PH1QIY33U6DNL1,"Sunni gunmen stand in the middle of Syria Street which divides the Sunni and Alawite areas, in the northern port city of Tripoli, Lebanon,.",55,62,divides,2,2,4
3OPLMF3EU5OIB6X1PH1QIY33U6DNL1,"Sunni gunmen stand in the middle of Syria Street which divides the Sunni and Alawite areas, in the northern port city of Tripoli, Lebanon,.",67,84,Sunni and Alawite,1,0,1
3OPLMF3EU5OIB6X1PH1QIY33U6DNL1,"Sunni gunmen stand in the middle of Syria Street which divides the Sunni and Alawite areas, in the northern port city of Tripoli, Lebanon,.",77,84,Alawite,0,1,1
3OPLMF3EU5OIB6X1PH1QIY33U6DNL1,"Sunni gunmen stand in the middle of Syria Street which divides the Sunni and Alawite areas, in the northern port city of Tripoli, Lebanon,.",77,90,Alawite areas,1,0,1
3OPLMF3EU5OIB6X1PH1QIY33U6DNL1,"Sunni gunmen stand in the middle of Syria Street which divides the Sunni and Alawite areas, in the northern port city of Tripoli, Lebanon,.",99,107,northern,1,0,1
3GS542CVJVOJKFQMWK2EJ8CM3RW950,"Syria restricts media access, making it difficult to verify accounts of the unrest.",6,15,restricts,6,3,9
3GS542CVJVOJKFQMWK2EJ8CM3RW950,"Syria restricts media access, making it difficult to verify accounts of the unrest.",6,28,restricts media access,2,0,2
3GS542CVJVOJKFQMWK2EJ8CM3RW950,"Syria restricts media access, making it difficult to verify accounts of the unrest.",16,28,media access,1,1,2
3GS542CVJVOJKFQMWK2EJ8CM3RW950,"Syria restricts media access, making it difficult to verify accounts of the unrest.",22,28,access,1,1,2
3GS542CVJVOJKFQMWK2EJ8CM3RW950,"Syria restricts media access, making it difficult to verify accounts of the unrest.",40,68,difficult to verify accounts,1,0,1
3GS542CVJVOJKFQMWK2EJ8CM3RW950,"Syria restricts media access, making it difficult to verify accounts of the unrest.",53,59,verify,2,1,3
3GS542CVJVOJKFQMWK2EJ8CM3RW950,"Syria restricts media access, making it difficult to verify accounts of the unrest.",53,68,verify accounts,2,0,2
3GS542CVJVOJKFQMWK2EJ8CM3RW950,"Syria restricts media access, making it difficult to verify accounts of the unrest.",60,68,accounts,0,1,1
3GS542CVJVOJKFQMWK2EJ8CM3RW950,"Syria restricts media access, making it difficult to verify accounts of the unrest.",76,82,unrest,5,10,15
3GS542CVJVOJKFQMWK2EJ8CM3RW950,"Syria's Sunni majority is at the forefront of the uprising against Assad, whose minority Alawite sect is an offshoot of Shi'ite Islam.",8,13,Sunni,0,1,1
3GS542CVJVOJKFQMWK2EJ8CM3RW950,"Syria's Sunni majority is at the forefront of the uprising against Assad, whose minority Alawite sect is an offshoot of Shi'ite Islam.",14,22,majority,1,1,2
3GS542CVJVOJKFQMWK2EJ8CM3RW950,"Syria's Sunni majority is at the forefront of the uprising against Assad, whose minority Alawite sect is an offshoot of Shi'ite Islam.",33,42,forefront,6,10,16
3GS542CVJVOJKFQMWK2EJ8CM3RW950,"Syria's Sunni majority is at the forefront of the uprising against Assad, whose minority Alawite sect is an offshoot of Shi'ite Islam.",33,58,forefront of the uprising,1,0,1
3GS542CVJVOJKFQMWK2EJ8CM3RW950,"Syria's Sunni majority is at the forefront of the uprising against Assad, whose minority Alawite sect is an offshoot of Shi'ite Islam.",50,58,uprising,3,5,8
3GS542CVJVOJKFQMWK2EJ8CM3RW950,"Syria's Sunni majority is at the forefront of the uprising against Assad, whose minority Alawite sect is an offshoot of Shi'ite Islam.",80,88,minority,1,0,1
3GS542CVJVOJKFQMWK2EJ8CM3RW950,"Syria's Sunni majority is at the forefront of the uprising against Assad, whose minority Alawite sect is an offshoot of Shi'ite Islam.",80,116,minority Alawite sect is an offshoot,1,0,1
3GS542CVJVOJKFQMWK2EJ8CM3RW950,"Syria's Sunni majority is at the forefront of the uprising against Assad, whose minority Alawite sect is an offshoot of Shi'ite Islam.",89,96,Alawite,0,1,1
3GS542CVJVOJKFQMWK2EJ8CM3RW950,"Syria's Sunni majority is at the forefront of the uprising against Assad, whose minority Alawite sect is an offshoot of Shi'ite Islam.",89,101,Alawite sect,2,1,3
3GS542CVJVOJKFQMWK2EJ8CM3RW950,"Syria's Sunni majority is at the forefront of the uprising against Assad, whose minority Alawite sect is an offshoot of Shi'ite Islam.",97,101,sect,3,2,5
3GS542CVJVOJKFQMWK2EJ8CM3RW950,"Syria's Sunni majority is at the forefront of the uprising against Assad, whose minority Alawite sect is an offshoot of Shi'ite Islam.",108,116,offshoot,8,10,18
3GS542CVJVOJKFQMWK2EJ8CM3RW950,"Syria's Sunni majority is at the forefront of the uprising against Assad, whose minority Alawite sect is an offshoot of Shi'ite Islam.",120,126,Shiite,0,1,1
3GS542CVJVOJKFQMWK2EJ8CM3RW950,"Syria's Sunni majority is at the forefront of the uprising against Assad, whose minority Alawite sect is an offshoot of Shi'ite Islam.",120,132,Shiite Islam,1,0,1
3GS542CVJVOJKFQMWK2EJ8CM3RW950,Assad's government says it is fighting a terrorist attempt to divide Syria.,8,18,government,1,0,1
3GS542CVJVOJKFQMWK2EJ8CM3RW950,Assad's government says it is fighting a terrorist attempt to divide Syria.,62,68,divide,1,0,1
3GS542CVJVOJKFQMWK2EJ8CM3RW950,"Rastan has in the past been a major source of Sunni Muslim conscripts who provide most of manpower in the military, which is dominated by Alawite officers.",0,6,Rastan,0,1,1
3GS542CVJVOJKFQMWK2EJ8CM3RW950,"Rastan has in the past been a major source of Sunni Muslim conscripts who provide most of manpower in the military, which is dominated by Alawite officers.",46,51,Sunni,0,1,1
3GS542CVJVOJKFQMWK2EJ8CM3RW950,"Rastan has in the past been a major source of Sunni Muslim conscripts who provide most of manpower in the military, which is dominated by Alawite officers.",59,69,conscripts,8,10,18
3GS542CVJVOJKFQMWK2EJ8CM3RW950,"Rastan has in the past been a major source of Sunni Muslim conscripts who provide most of manpower in the military, which is dominated by Alawite officers.",74,81,provide,0,1,1
3GS542CVJVOJKFQMWK2EJ8CM3RW950,"Rastan has in the past been a major source of Sunni Muslim conscripts who provide most of manpower in the military, which is dominated by Alawite officers.",90,98,manpower,4,3,7
3GS542CVJVOJKFQMWK2EJ8CM3RW950,"Rastan has in the past been a major source of Sunni Muslim conscripts who provide most of manpower in the military, which is dominated by Alawite officers.",125,134,dominated,1,4,5
3GS542CVJVOJKFQMWK2EJ8CM3RW950,"Rastan has in the past been a major source of Sunni Muslim conscripts who provide most of manpower in the military, which is dominated by Alawite officers.",138,145,Alawite,0,1,1
3GS542CVJVOJKFQMWK2EJ8CM3RW950,Sunni officers from Rastan began defecting after security forces shot dead dozens of demonstrators in the town and arrested many of its notables.,20,26,Rastan,0,1,1
3GS542CVJVOJKFQMWK2EJ8CM3RW950,Sunni officers from Rastan began defecting after security forces shot dead dozens of demonstrators in the town and arrested many of its notables.,33,42,defecting,7,5,12
3GS542CVJVOJKFQMWK2EJ8CM3RW950,Sunni officers from Rastan began defecting after security forces shot dead dozens of demonstrators in the town and arrested many of its notables.,85,98,demonstrators,4,3,7
3GS542CVJVOJKFQMWK2EJ8CM3RW950,Sunni officers from Rastan began defecting after security forces shot dead dozens of demonstrators in the town and arrested many of its notables.,136,144,notables,8,5,13
3GS542CVJVOJKFQMWK2EJ8CM3RW950,The area was scene of the first serious armed confrontations between army defectors and loyalist forces last year.,32,60,serious armed confrontations,2,0,2
3GS542CVJVOJKFQMWK2EJ8CM3RW950,The area was scene of the first serious armed confrontations between army defectors and loyalist forces last year.,46,60,confrontations,7,9,16
3GS542CVJVOJKFQMWK2EJ8CM3RW950,The area was scene of the first serious armed confrontations between army defectors and loyalist forces last year.,69,83,army defectors,1,0,1
3GS542CVJVOJKFQMWK2EJ8CM3RW950,The area was scene of the first serious armed confrontations between army defectors and loyalist forces last year.,74,83,defectors,5,7,12
3GS542CVJVOJKFQMWK2EJ8CM3RW950,The area was scene of the first serious armed confrontations between army defectors and loyalist forces last year.,88,96,loyalist,3,3,6
3GS542CVJVOJKFQMWK2EJ8CM3RW950,The area was scene of the first serious armed confrontations between army defectors and loyalist forces last year.,88,103,loyalist forces,1,0,1
3GS542CVJVOJKFQMWK2EJ8CM3RW950,Assad's forces regained control of the city several times but it has kept falling back into rebel hands.,15,23,regained,2,3,5
3GS542CVJVOJKFQMWK2EJ8CM3RW950,Assad's forces regained control of the city several times but it has kept falling back into rebel hands.,74,86,falling back,0,1,1
3GS542CVJVOJKFQMWK2EJ8CM3RW950,Assad's forces regained control of the city several times but it has kept falling back into rebel hands.,92,97,rebel,1,4,5
3DQYSJDTYLC9HU1DA11V354HO0PEXJ,"The acquisition is the largest wireless-equipment deal in at least a decade, according to data compiled by Bloomberg.",4,15,acquisition,10,10,20
3DQYSJDTYLC9HU1DA11V354HO0PEXJ,"The acquisition is the largest wireless-equipment deal in at least a decade, according to data compiled by Bloomberg.",31,49,wireless-equipment,5,5,10
3DQYSJDTYLC9HU1DA11V354HO0PEXJ,"The acquisition is the largest wireless-equipment deal in at least a decade, according to data compiled by Bloomberg.",31,54,wireless-equipment deal,1,0,1
3DQYSJDTYLC9HU1DA11V354HO0PEXJ,"The acquisition is the largest wireless-equipment deal in at least a decade, according to data compiled by Bloomberg.",50,54,deal,0,1,1
3DQYSJDTYLC9HU1DA11V354HO0PEXJ,"The acquisition is the largest wireless-equipment deal in at least a decade, according to data compiled by Bloomberg.",69,75,decade,0,3,3
3DQYSJDTYLC9HU1DA11V354HO0PEXJ,"The acquisition is the largest wireless-equipment deal in at least a decade, according to data compiled by Bloomberg.",90,94,data,1,0,1
3DQYSJDTYLC9HU1DA11V354HO0PEXJ,"The acquisition is the largest wireless-equipment deal in at least a decade, according to data compiled by Bloomberg.",90,103,data compiled,1,0,1
3DQYSJDTYLC9HU1DA11V354HO0PEXJ,"The acquisition is the largest wireless-equipment deal in at least a decade, according to data compiled by Bloomberg.",95,103,compiled,8,7,15
3DQYSJDTYLC9HU1DA11V354HO0PEXJ,"“Our stance since we agreed to acquire Motorola has not changed and we look forward to closing the deal,” Mountain View, California-based Google said in an e-mailed statement.",5,11,stance,4,8,12
3DQYSJDTYLC9HU1DA11V354HO0PEXJ,"“Our stance since we agreed to acquire Motorola has not changed and we look forward to closing the deal,” Mountain View, California-based Google said in an e-mailed statement.",21,27,agreed,1,0,1
3DQYSJDTYLC9HU1DA11V354HO0PEXJ,"“Our stance since we agreed to acquire Motorola has not changed and we look forward to closing the deal,” Mountain View, California-based Google said in an e-mailed statement.",31,38,acquire,6,3,9
3DQYSJDTYLC9HU1DA11V354HO0PEXJ,"“Our stance since we agreed to acquire Motorola has not changed and we look forward to closing the deal,” Mountain View, California-based Google said in an e-mailed statement.",71,86,look forward to,0,1,1
3DQYSJDTYLC9HU1DA11V354HO0PEXJ,"“Our stance since we agreed to acquire Motorola has not changed and we look forward to closing the deal,” Mountain View, California-based Google said in an e-mailed statement.",87,103,closing the deal,2,0,2
3DQYSJDTYLC9HU1DA11V354HO0PEXJ,The company also confirmed it had received word from Chinese authorities of the purchase being approved.,17,26,confirmed,2,3,5
3DQYSJDTYLC9HU1DA11V354HO0PEXJ,The company also confirmed it had received word from Chinese authorities of the purchase being approved.,34,47,received word,1,0,1
3DQYSJDTYLC9HU1DA11V354HO0PEXJ,The company also confirmed it had received word from Chinese authorities of the purchase being approved.,61,72,authorities,1,3,4
3DQYSJDTYLC9HU1DA11V354HO0PEXJ,The company also confirmed it had received word from Chinese authorities of the purchase being approved.,80,88,purchase,1,0,1
3DQYSJDTYLC9HU1DA11V354HO0PEXJ,The company also confirmed it had received word from Chinese authorities of the purchase being approved.,95,103,approved,1,2,3
3DQYSJDTYLC9HU1DA11V354HO0PEXJ,Google fell 3.6 percent to $600.40 yesterday in New York trading.,7,11,fell,0,1,1
3DQYSJDTYLC9HU1DA11V354HO0PEXJ,Google fell 3.6 percent to $600.40 yesterday in New York trading.,48,65,New York  trading,1,0,1
3DQYSJDTYLC9HU1DA11V354HO0PEXJ,Google fell 3.6 percent to $600.40 yesterday in New York trading.,57,64,trading,1,0,1
3DQYSJDTYLC9HU1DA11V354HO0PEXJ,The shares have fallen 7 percent this year.,4,10,shares,2,2,4
3DQYSJDTYLC9HU1DA11V354HO0PEXJ,The shares have fallen 7 percent this year.,16,22,fallen,0,1,1
3DQYSJDTYLC9HU1DA11V354HO0PEXJ,Motorola Mobility closed unchanged at $39.20.,18,24,closed,1,0,1
3DQYSJDTYLC9HU1DA11V354HO0PEXJ,Motorola Mobility closed unchanged at $39.20.,25,34,unchanged,1,1,2
3DQYSJDTYLC9HU1DA11V354HO0PEXJ,The stock is up 1 percent year to date.,4,9,stock,2,1,3
3DQYSJDTYLC9HU1DA11V354HO0PEXJ,The stock is up 1 percent year to date.,26,38,year to date,0,1,1
3DQYSJDTYLC9HU1DA11V354HO0PEXJ,A teenager has been shot dead and her sister has been seriously injured in a gun attack in Bellaghy.,2,10,teenager,0,3,3
3DQYSJDTYLC9HU1DA11V354HO0PEXJ,A teenager has been shot dead and her sister has been seriously injured in a gun attack in Bellaghy.,54,71,seriously injured,1,2,3
3DQYSJDTYLC9HU1DA11V354HO0PEXJ,A teenager has been shot dead and her sister has been seriously injured in a gun attack in Bellaghy.,64,71,injured,0,1,1
3DQYSJDTYLC9HU1DA11V354HO0PEXJ,A teenager has been shot dead and her sister has been seriously injured in a gun attack in Bellaghy.,77,87,gun attack,0,1,1
3DQYSJDTYLC9HU1DA11V354HO0PEXJ,The fatal incident occurred at a house in the William Court area of the Co Londonderry village on Saturday morning.,4,9,fatal,3,6,9
3DQYSJDTYLC9HU1DA11V354HO0PEXJ,The fatal incident occurred at a house in the William Court area of the Co Londonderry village on Saturday morning.,4,18,fatal incident,4,3,7
3DQYSJDTYLC9HU1DA11V354HO0PEXJ,The fatal incident occurred at a house in the William Court area of the Co Londonderry village on Saturday morning.,10,18,incident,1,0,1
3DQYSJDTYLC9HU1DA11V354HO0PEXJ,The fatal incident occurred at a house in the William Court area of the Co Londonderry village on Saturday morning.,19,27,occurred,1,2,3
3Y3CZJSZ9KUPOFM8Q120ATCGAQ55RD,The children ranged in age from 12 to 17.,13,19,ranged,5,5,10
3Y3CZJSZ9KUPOFM8Q120ATCGAQ55RD,The children ranged in age from 12 to 17.,13,26,ranged in age,0,1,1
3Y3CZJSZ9KUPOFM8Q120ATCGAQ55RD,"It appeared they had been shot, Goodyear said.",4,12,appeared,3,4,7
3Y3CZJSZ9KUPOFM8Q120ATCGAQ55RD,"It appeared they had been shot, Goodyear said.",18,26,had been,0,1,1
3Y3CZJSZ9KUPOFM8Q120ATCGAQ55RD,"It appeared they had been shot, Goodyear said.",27,31,shot,1,1,2
3Y3CZJSZ9KUPOFM8Q120ATCGAQ55RD,"The mother of the children came out of the residence next door, called for the children to return home, at which time they left and went back to the house.",44,53,residence,9,2,11
3Y3CZJSZ9KUPOFM8Q120ATCGAQ55RD,"The mother of the children came out of the residence next door, called for the children to return home, at which time they left and went back to the house.",44,63,residence next door,1,0,1
3Y3CZJSZ9KUPOFM8Q120ATCGAQ55RD,The neighbor then heard gunshots and called police.,4,12,neighbor,0,4,4
3Y3CZJSZ9KUPOFM8Q120ATCGAQ55RD,The neighbor then heard gunshots and called police.,13,23,then heard,0,1,1
3Y3CZJSZ9KUPOFM8Q120ATCGAQ55RD,The neighbor then heard gunshots and called police.,18,23,heard,0,1,1
3Y3CZJSZ9KUPOFM8Q120ATCGAQ55RD,The neighbor then heard gunshots and called police.,24,32,gunshots,0,2,2
3Y3CZJSZ9KUPOFM8Q120ATCGAQ55RD,"Another neighbor told deputies that Thomas sent a text message in the middle of the night saying she wanted to be cremated with her children, Goodyear said.",8,16,neighbor,0,1,1
3Y3CZJSZ9KUPOFM8Q120ATCGAQ55RD,"Another neighbor told deputies that Thomas sent a text message in the middle of the night saying she wanted to be cremated with her children, Goodyear said.",22,30,deputies,7,5,12
3Y3CZJSZ9KUPOFM8Q120ATCGAQ55RD,"Another neighbor told deputies that Thomas sent a text message in the middle of the night saying she wanted to be cremated with her children, Goodyear said.",50,62,text message,1,1,2
3Y3CZJSZ9KUPOFM8Q120ATCGAQ55RD,"Another neighbor told deputies that Thomas sent a text message in the middle of the night saying she wanted to be cremated with her children, Goodyear said.",55,62,message,0,1,1
3Y3CZJSZ9KUPOFM8Q120ATCGAQ55RD,"Another neighbor told deputies that Thomas sent a text message in the middle of the night saying she wanted to be cremated with her children, Goodyear said.",108,122,to be cremated,0,1,1
3Y3CZJSZ9KUPOFM8Q120ATCGAQ55RD,"Another neighbor told deputies that Thomas sent a text message in the middle of the night saying she wanted to be cremated with her children, Goodyear said.",114,122,cremated,10,10,20
3Y3CZJSZ9KUPOFM8Q120ATCGAQ55RD,"The shooting happened in an area known as the ""Space Coast"" because it is the home of NASA's Kennedy Space Center, the location of numerous shuttle launches.",4,12,shooting,0,1,1
3Y3CZJSZ9KUPOFM8Q120ATCGAQ55RD,"The shooting happened in an area known as the ""Space Coast"" because it is the home of NASA's Kennedy Space Center, the location of numerous shuttle launches.",47,58,Space Coast,3,0,3
3Y3CZJSZ9KUPOFM8Q120ATCGAQ55RD,"The shooting happened in an area known as the ""Space Coast"" because it is the home of NASA's Kennedy Space Center, the location of numerous shuttle launches.",93,113,Kennedy Space Center,1,0,1
3Y3CZJSZ9KUPOFM8Q120ATCGAQ55RD,"The shooting happened in an area known as the ""Space Coast"" because it is the home of NASA's Kennedy Space Center, the location of numerous shuttle launches.",119,127,location,1,1,2
3Y3CZJSZ9KUPOFM8Q120ATCGAQ55RD,"The shooting happened in an area known as the ""Space Coast"" because it is the home of NASA's Kennedy Space Center, the location of numerous shuttle launches.",131,139,numerous,5,5,10
3Y3CZJSZ9KUPOFM8Q120ATCGAQ55RD,"The shooting happened in an area known as the ""Space Coast"" because it is the home of NASA's Kennedy Space Center, the location of numerous shuttle launches.",131,156,numerous shuttle launches,1,0,1
3Y3CZJSZ9KUPOFM8Q120ATCGAQ55RD,"The shooting happened in an area known as the ""Space Coast"" because it is the home of NASA's Kennedy Space Center, the location of numerous shuttle launches.",140,147,shuttle,3,3,6
3Y3CZJSZ9KUPOFM8Q120ATCGAQ55RD,"The shooting happened in an area known as the ""Space Coast"" because it is the home of NASA's Kennedy Space Center, the location of numerous shuttle launches.",140,156,shuttle launches,1,2,3
3Y3CZJSZ9KUPOFM8Q120ATCGAQ55RD,"The shooting happened in an area known as the ""Space Coast"" because it is the home of NASA's Kennedy Space Center, the location of numerous shuttle launches.",148,156,launches,1,3,4
3Y3CZJSZ9KUPOFM8Q120ATCGAQ55RD,Gardaí are to carry out a technical examination of the scene of a shooting in Dublin last night.,0,6,Gardaí,1,1,2
3Y3CZJSZ9KUPOFM8Q120ATCGAQ55RD,Gardaí are to carry out a technical examination of the scene of a shooting in Dublin last night.,26,35,technical,5,0,5
3Y3CZJSZ9KUPOFM8Q120ATCGAQ55RD,Gardaí are to carry out a technical examination of the scene of a shooting in Dublin last night.,26,47,technical examination,5,3,8
3Y3CZJSZ9KUPOFM8Q120ATCGAQ55RD,Gardaí are to carry out a technical examination of the scene of a shooting in Dublin last night.,36,47,examination,4,0,4
3Y3CZJSZ9KUPOFM8Q120ATCGAQ55RD,Gardaí are to carry out a technical examination of the scene of a shooting in Dublin last night.,66,74,shooting,0,1,1
36QZ6V1589EIA9C06RAD8F9SUWESUC,The deal signed with Karzai does not commit the United States to any specific troop presence or spending.,4,8,deal,0,2,2
36QZ6V1589EIA9C06RAD8F9SUWESUC,The deal signed with Karzai does not commit the United States to any specific troop presence or spending.,9,15,signed,1,0,1
36QZ6V1589EIA9C06RAD8F9SUWESUC,The deal signed with Karzai does not commit the United States to any specific troop presence or spending.,21,27,Karzai,2,0,2
36QZ6V1589EIA9C06RAD8F9SUWESUC,The deal signed with Karzai does not commit the United States to any specific troop presence or spending.,37,43,commit,5,4,9
36QZ6V1589EIA9C06RAD8F9SUWESUC,The deal signed with Karzai does not commit the United States to any specific troop presence or spending.,69,77,specific,1,2,3
36QZ6V1589EIA9C06RAD8F9SUWESUC,The deal signed with Karzai does not commit the United States to any specific troop presence or spending.,69,92,specific troop presence,1,0,1
36QZ6V1589EIA9C06RAD8F9SUWESUC,The deal signed with Karzai does not commit the United States to any specific troop presence or spending.,78,83,troop,0,1,1
36QZ6V1589EIA9C06RAD8F9SUWESUC,The deal signed with Karzai does not commit the United States to any specific troop presence or spending.,78,92,troop presence,2,0,2
36QZ6V1589EIA9C06RAD8F9SUWESUC,The deal signed with Karzai does not commit the United States to any specific troop presence or spending.,84,92,presence,1,0,1
36QZ6V1589EIA9C06RAD8F9SUWESUC,The deal signed with Karzai does not commit the United States to any specific troop presence or spending.,96,104,spending,1,0,1
36QZ6V1589EIA9C06RAD8F9SUWESUC,But it does allow the U.S. to potentially keep troops in Afghanistan through 2024 for two specific purposes: continued training of Afghan forces and targeted operations against al-Qaida.,30,41,potentially,5,4,9
36QZ6V1589EIA9C06RAD8F9SUWESUC,But it does allow the U.S. to potentially keep troops in Afghanistan through 2024 for two specific purposes: continued training of Afghan forces and targeted operations against al-Qaida.,30,53,potentially keep troops,0,1,1
36QZ6V1589EIA9C06RAD8F9SUWESUC,But it does allow the U.S. to potentially keep troops in Afghanistan through 2024 for two specific purposes: continued training of Afghan forces and targeted operations against al-Qaida.,47,53,troops,1,1,2
36QZ6V1589EIA9C06RAD8F9SUWESUC,But it does allow the U.S. to potentially keep troops in Afghanistan through 2024 for two specific purposes: continued training of Afghan forces and targeted operations against al-Qaida.,90,98,specific,1,1,2
36QZ6V1589EIA9C06RAD8F9SUWESUC,But it does allow the U.S. to potentially keep troops in Afghanistan through 2024 for two specific purposes: continued training of Afghan forces and targeted operations against al-Qaida.,90,107,specific purposes,1,0,1
36QZ6V1589EIA9C06RAD8F9SUWESUC,But it does allow the U.S. to potentially keep troops in Afghanistan through 2024 for two specific purposes: continued training of Afghan forces and targeted operations against al-Qaida.,99,107,purposes,0,1,1
36QZ6V1589EIA9C06RAD8F9SUWESUC,But it does allow the U.S. to potentially keep troops in Afghanistan through 2024 for two specific purposes: continued training of Afghan forces and targeted operations against al-Qaida.,109,118,continued,0,1,1
36QZ6V1589EIA9C06RAD8F9SUWESUC,But it does allow the U.S. to potentially keep troops in Afghanistan through 2024 for two specific purposes: continued training of Afghan forces and targeted operations against al-Qaida.,149,157,targeted,0,1,1
36QZ6V1589EIA9C06RAD8F9SUWESUC,But it does allow the U.S. to potentially keep troops in Afghanistan through 2024 for two specific purposes: continued training of Afghan forces and targeted operations against al-Qaida.,149,168,targeted operations,5,1,6
36QZ6V1589EIA9C06RAD8F9SUWESUC,But it does allow the U.S. to potentially keep troops in Afghanistan through 2024 for two specific purposes: continued training of Afghan forces and targeted operations against al-Qaida.,158,168,operations,1,0,1
36QZ6V1589EIA9C06RAD8F9SUWESUC,The United States also promises to seek money from Congress every year to support Afghanistan.,35,39,seek,2,1,3
36QZ6V1589EIA9C06RAD8F9SUWESUC,The United States also promises to seek money from Congress every year to support Afghanistan.,35,59,seek money from Congress,1,0,1
36QZ6V1589EIA9C06RAD8F9SUWESUC,The United States also promises to seek money from Congress every year to support Afghanistan.,51,59,Congress,2,0,2
36QZ6V1589EIA9C06RAD8F9SUWESUC,"The attack began with a suicide car bomb near the gate of the privately guarded compound, which sits off Jalalabad road — one of the main thoroughfares out of the city, Interior Ministry spokesman Sediq Sediqi said.",24,31,suicide,4,2,6
36QZ6V1589EIA9C06RAD8F9SUWESUC,"The attack began with a suicide car bomb near the gate of the privately guarded compound, which sits off Jalalabad road — one of the main thoroughfares out of the city, Interior Ministry spokesman Sediq Sediqi said.",24,40,suicide car bomb,3,0,3
36QZ6V1589EIA9C06RAD8F9SUWESUC,"The attack began with a suicide car bomb near the gate of the privately guarded compound, which sits off Jalalabad road — one of the main thoroughfares out of the city, Interior Ministry spokesman Sediq Sediqi said.",62,71,privately,0,1,1
36QZ6V1589EIA9C06RAD8F9SUWESUC,"The attack began with a suicide car bomb near the gate of the privately guarded compound, which sits off Jalalabad road — one of the main thoroughfares out of the city, Interior Ministry spokesman Sediq Sediqi said.",62,88,privately guarded compound,3,0,3
36QZ6V1589EIA9C06RAD8F9SUWESUC,"The attack began with a suicide car bomb near the gate of the privately guarded compound, which sits off Jalalabad road — one of the main thoroughfares out of the city, Interior Ministry spokesman Sediq Sediqi said.",72,79,guarded,0,1,1
36QZ6V1589EIA9C06RAD8F9SUWESUC,"The attack began with a suicide car bomb near the gate of the privately guarded compound, which sits off Jalalabad road — one of the main thoroughfares out of the city, Interior Ministry spokesman Sediq Sediqi said.",80,88,compound,6,2,8
36QZ6V1589EIA9C06RAD8F9SUWESUC,"The attack began with a suicide car bomb near the gate of the privately guarded compound, which sits off Jalalabad road — one of the main thoroughfares out of the city, Interior Ministry spokesman Sediq Sediqi said.",96,104,sits off,2,0,2
36QZ6V1589EIA9C06RAD8F9SUWESUC,"The attack began with a suicide car bomb near the gate of the privately guarded compound, which sits off Jalalabad road — one of the main thoroughfares out of the city, Interior Ministry spokesman Sediq Sediqi said.",138,151,thoroughfares,10,10,20
36QZ6V1589EIA9C06RAD8F9SUWESUC,"The attack began with a suicide car bomb near the gate of the privately guarded compound, which sits off Jalalabad road — one of the main thoroughfares out of the city, Interior Ministry spokesman Sediq Sediqi said.",169,186,Interior Ministry,1,0,1
36QZ6V1589EIA9C06RAD8F9SUWESUC,"The attack began with a suicide car bomb near the gate of the privately guarded compound, which sits off Jalalabad road — one of the main thoroughfares out of the city, Interior Ministry spokesman Sediq Sediqi said.",187,196,spokesman,1,3,4
36QZ6V1589EIA9C06RAD8F9SUWESUC,"Kabul Deputy Police Chief Daoud Amin said those killed in the blast included four people in a station wagon that was driving past the area, a passer-by and a Nepalese security guard.",62,67,blast,2,3,5
36QZ6V1589EIA9C06RAD8F9SUWESUC,"Kabul Deputy Police Chief Daoud Amin said those killed in the blast included four people in a station wagon that was driving past the area, a passer-by and a Nepalese security guard.",68,76,included,0,1,1
36QZ6V1589EIA9C06RAD8F9SUWESUC,"Kabul Deputy Police Chief Daoud Amin said those killed in the blast included four people in a station wagon that was driving past the area, a passer-by and a Nepalese security guard.",94,107,station wagon,2,4,6
36QZ6V1589EIA9C06RAD8F9SUWESUC,"Kabul Deputy Police Chief Daoud Amin said those killed in the blast included four people in a station wagon that was driving past the area, a passer-by and a Nepalese security guard.",102,107,wagon,1,1,2
36QZ6V1589EIA9C06RAD8F9SUWESUC,"Kabul Deputy Police Chief Daoud Amin said those killed in the blast included four people in a station wagon that was driving past the area, a passer-by and a Nepalese security guard.",142,151,passer-by,4,3,7
36QZ6V1589EIA9C06RAD8F9SUWESUC,"Kabul Deputy Police Chief Daoud Amin said those killed in the blast included four people in a station wagon that was driving past the area, a passer-by and a Nepalese security guard.",142,155,passer-by and,0,1,1
36QZ6V1589EIA9C06RAD8F9SUWESUC,"Kabul Deputy Police Chief Daoud Amin said those killed in the blast included four people in a station wagon that was driving past the area, a passer-by and a Nepalese security guard.",158,166,Nepalese,1,0,1
3PN6H8C9R4RSTBFK3WYXDFBYN3FADI,"For years he had evaded capture and was one of the world's most wanted men, but his time on the run finally ended last year when he was arrested near Belgrade.The 70 year old will be brought before the UN Yugoslav War Crimes tribunal in the Hague later this morning accused with some of the worst atrocities in Europe since World War Two.",17,23,evaded,8,10,18
3PN6H8C9R4RSTBFK3WYXDFBYN3FADI,"For years he had evaded capture and was one of the world's most wanted men, but his time on the run finally ended last year when he was arrested near Belgrade.The 70 year old will be brought before the UN Yugoslav War Crimes tribunal in the Hague later this morning accused with some of the worst atrocities in Europe since World War Two.",17,31,evaded capture,3,1,4
3PN6H8C9R4RSTBFK3WYXDFBYN3FADI,"For years he had evaded capture and was one of the world's most wanted men, but his time on the run finally ended last year when he was arrested near Belgrade.The 70 year old will be brought before the UN Yugoslav War Crimes tribunal in the Hague later this morning accused with some of the worst atrocities in Europe since World War Two.",24,31,capture,0,3,3
3PN6H8C9R4RSTBFK3WYXDFBYN3FADI,"For years he had evaded capture and was one of the world's most wanted men, but his time on the run finally ended last year when he was arrested near Belgrade.The 70 year old will be brought before the UN Yugoslav War Crimes tribunal in the Hague later this morning accused with some of the worst atrocities in Europe since World War Two.",59,74,most wanted men,0,1,1
3PN6H8C9R4RSTBFK3WYXDFBYN3FADI,"For years he had evaded capture and was one of the world's most wanted men, but his time on the run finally ended last year when he was arrested near Belgrade.The 70 year old will be brought before the UN Yugoslav War Crimes tribunal in the Hague later this morning accused with some of the worst atrocities in Europe since World War Two.",136,144,arrested,2,1,3
3PN6H8C9R4RSTBFK3WYXDFBYN3FADI,"For years he had evaded capture and was one of the world's most wanted men, but his time on the run finally ended last year when he was arrested near Belgrade.The 70 year old will be brought before the UN Yugoslav War Crimes tribunal in the Hague later this morning accused with some of the worst atrocities in Europe since World War Two.",205,213,Yugoslav,0,1,1
3PN6H8C9R4RSTBFK3WYXDFBYN3FADI,"For years he had evaded capture and was one of the world's most wanted men, but his time on the run finally ended last year when he was arrested near Belgrade.The 70 year old will be brought before the UN Yugoslav War Crimes tribunal in the Hague later this morning accused with some of the worst atrocities in Europe since World War Two.",214,224,War Crimes,1,0,1
3PN6H8C9R4RSTBFK3WYXDFBYN3FADI,"For years he had evaded capture and was one of the world's most wanted men, but his time on the run finally ended last year when he was arrested near Belgrade.The 70 year old will be brought before the UN Yugoslav War Crimes tribunal in the Hague later this morning accused with some of the worst atrocities in Europe since World War Two.",214,233,War Crimes tribunal,0,2,2
3PN6H8C9R4RSTBFK3WYXDFBYN3FADI,"For years he had evaded capture and was one of the world's most wanted men, but his time on the run finally ended last year when he was arrested near Belgrade.The 70 year old will be brought before the UN Yugoslav War Crimes tribunal in the Hague later this morning accused with some of the worst atrocities in Europe since World War Two.",225,233,tribunal,9,3,12
3PN6H8C9R4RSTBFK3WYXDFBYN3FADI,"For years he had evaded capture and was one of the world's most wanted men, but his time on the run finally ended last year when he was arrested near Belgrade.The 70 year old will be brought before the UN Yugoslav War Crimes tribunal in the Hague later this morning accused with some of the worst atrocities in Europe since World War Two.",241,246,Hague,1,1,2
3PN6H8C9R4RSTBFK3WYXDFBYN3FADI,"For years he had evaded capture and was one of the world's most wanted men, but his time on the run finally ended last year when he was arrested near Belgrade.The 70 year old will be brought before the UN Yugoslav War Crimes tribunal in the Hague later this morning accused with some of the worst atrocities in Europe since World War Two.",266,273,accused,1,3,4
3PN6H8C9R4RSTBFK3WYXDFBYN3FADI,"For years he had evaded capture and was one of the world's most wanted men, but his time on the run finally ended last year when he was arrested near Belgrade.The 70 year old will be brought before the UN Yugoslav War Crimes tribunal in the Hague later this morning accused with some of the worst atrocities in Europe since World War Two.",291,296,worst,0,2,2
3PN6H8C9R4RSTBFK3WYXDFBYN3FADI,"For years he had evaded capture and was one of the world's most wanted men, but his time on the run finally ended last year when he was arrested near Belgrade.The 70 year old will be brought before the UN Yugoslav War Crimes tribunal in the Hague later this morning accused with some of the worst atrocities in Europe since World War Two.",291,307,worst atrocities,2,1,3
3PN6H8C9R4RSTBFK3WYXDFBYN3FADI,"For years he had evaded capture and was one of the world's most wanted men, but his time on the run finally ended last year when he was arrested near Belgrade.The 70 year old will be brought before the UN Yugoslav War Crimes tribunal in the Hague later this morning accused with some of the worst atrocities in Europe since World War Two.",297,307,atrocities,9,10,19
3PN6H8C9R4RSTBFK3WYXDFBYN3FADI,"He has denied charges of genocide, murder acts of terror and other crimes against humanity.The most infamous of the charges accuses Mladic of overseeing the massacre  of 8 thousand Muslim boys and men in Srebrenica in Eastern Bosnia in 1995.",7,13,denied,0,3,3
3PN6H8C9R4RSTBFK3WYXDFBYN3FADI,"He has denied charges of genocide, murder acts of terror and other crimes against humanity.The most infamous of the charges accuses Mladic of overseeing the massacre  of 8 thousand Muslim boys and men in Srebrenica in Eastern Bosnia in 1995.",14,21,charges,0,1,1
3PN6H8C9R4RSTBFK3WYXDFBYN3FADI,"He has denied charges of genocide, murder acts of terror and other crimes against humanity.The most infamous of the charges accuses Mladic of overseeing the massacre  of 8 thousand Muslim boys and men in Srebrenica in Eastern Bosnia in 1995.",25,33,genocide,10,10,20
3PN6H8C9R4RSTBFK3WYXDFBYN3FADI,"He has denied charges of genocide, murder acts of terror and other crimes against humanity.The most infamous of the charges accuses Mladic of overseeing the massacre  of 8 thousand Muslim boys and men in Srebrenica in Eastern Bosnia in 1995.",35,56,murder acts of terror,2,0,2
3PN6H8C9R4RSTBFK3WYXDFBYN3FADI,"He has denied charges of genocide, murder acts of terror and other crimes against humanity.The most infamous of the charges accuses Mladic of overseeing the massacre  of 8 thousand Muslim boys and men in Srebrenica in Eastern Bosnia in 1995.",50,56,terror,0,2,2
3PN6H8C9R4RSTBFK3WYXDFBYN3FADI,"He has denied charges of genocide, murder acts of terror and other crimes against humanity.The most infamous of the charges accuses Mladic of overseeing the massacre  of 8 thousand Muslim boys and men in Srebrenica in Eastern Bosnia in 1995.",67,90,crimes against humanity,3,0,3
3PN6H8C9R4RSTBFK3WYXDFBYN3FADI,"He has denied charges of genocide, murder acts of terror and other crimes against humanity.The most infamous of the charges accuses Mladic of overseeing the massacre  of 8 thousand Muslim boys and men in Srebrenica in Eastern Bosnia in 1995.",82,90,humanity,4,1,5
3PN6H8C9R4RSTBFK3WYXDFBYN3FADI,"He has denied charges of genocide, murder acts of terror and other crimes against humanity.The most infamous of the charges accuses Mladic of overseeing the massacre  of 8 thousand Muslim boys and men in Srebrenica in Eastern Bosnia in 1995.",100,108,infamous,7,4,11
3PN6H8C9R4RSTBFK3WYXDFBYN3FADI,"He has denied charges of genocide, murder acts of terror and other crimes against humanity.The most infamous of the charges accuses Mladic of overseeing the massacre  of 8 thousand Muslim boys and men in Srebrenica in Eastern Bosnia in 1995.",124,131,accuses,1,1,2
3PN6H8C9R4RSTBFK3WYXDFBYN3FADI,"He has denied charges of genocide, murder acts of terror and other crimes against humanity.The most infamous of the charges accuses Mladic of overseeing the massacre  of 8 thousand Muslim boys and men in Srebrenica in Eastern Bosnia in 1995.",142,152,overseeing,3,4,7
3PN6H8C9R4RSTBFK3WYXDFBYN3FADI,"He has denied charges of genocide, murder acts of terror and other crimes against humanity.The most infamous of the charges accuses Mladic of overseeing the massacre  of 8 thousand Muslim boys and men in Srebrenica in Eastern Bosnia in 1995.",157,165,massacre,6,5,11
3PN6H8C9R4RSTBFK3WYXDFBYN3FADI,Mladic reportedly gave a thumbs-up and clapped to supporters in the court's public gallery as the trial got under way.,25,34,thumbs-up,4,4,8
3PN6H8C9R4RSTBFK3WYXDFBYN3FADI,Mladic reportedly gave a thumbs-up and clapped to supporters in the court's public gallery as the trial got under way.,25,46,thumbs-up and clapped,1,0,1
3PN6H8C9R4RSTBFK3WYXDFBYN3FADI,Mladic reportedly gave a thumbs-up and clapped to supporters in the court's public gallery as the trial got under way.,39,46,clapped,0,3,3
3PN6H8C9R4RSTBFK3WYXDFBYN3FADI,Mladic reportedly gave a thumbs-up and clapped to supporters in the court's public gallery as the trial got under way.,50,60,supporters,1,0,1
3PN6H8C9R4RSTBFK3WYXDFBYN3FADI,Mladic reportedly gave a thumbs-up and clapped to supporters in the court's public gallery as the trial got under way.,68,89,courts public gallery,2,0,2
3PN6H8C9R4RSTBFK3WYXDFBYN3FADI,Mladic reportedly gave a thumbs-up and clapped to supporters in the court's public gallery as the trial got under way.,83,90,gallery,2,0,2
3PN6H8C9R4RSTBFK3WYXDFBYN3FADI,Mladic reportedly gave a thumbs-up and clapped to supporters in the court's public gallery as the trial got under way.,98,103,trial,0,2,2
37PGLWGSJT7FDZ4S71CXYQU7KKHIK7,"Preliminary results indicate the party won less than 50 percent of votes, a steep fall from its earlier majority.",0,11,Preliminary,10,7,17
37PGLWGSJT7FDZ4S71CXYQU7KKHIK7,"Preliminary results indicate the party won less than 50 percent of votes, a steep fall from its earlier majority.",0,19,Preliminary results,2,0,2
37PGLWGSJT7FDZ4S71CXYQU7KKHIK7,"Preliminary results indicate the party won less than 50 percent of votes, a steep fall from its earlier majority.",20,28,indicate,1,3,4
37PGLWGSJT7FDZ4S71CXYQU7KKHIK7,"Preliminary results indicate the party won less than 50 percent of votes, a steep fall from its earlier majority.",76,81,steep,2,3,5
37PGLWGSJT7FDZ4S71CXYQU7KKHIK7,"Preliminary results indicate the party won less than 50 percent of votes, a steep fall from its earlier majority.",76,86,steep fall,1,4,5
37PGLWGSJT7FDZ4S71CXYQU7KKHIK7,"Preliminary results indicate the party won less than 50 percent of votes, a steep fall from its earlier majority.",96,112,earlier majority,1,0,1
37PGLWGSJT7FDZ4S71CXYQU7KKHIK7,"Preliminary results indicate the party won less than 50 percent of votes, a steep fall from its earlier majority.",104,112,majority,3,0,3
37PGLWGSJT7FDZ4S71CXYQU7KKHIK7,Opposition parties and international observers said the poll was marred by widespread reports and allegations of vote-rigging.,0,10,Opposition,5,0,5
37PGLWGSJT7FDZ4S71CXYQU7KKHIK7,Opposition parties and international observers said the poll was marred by widespread reports and allegations of vote-rigging.,0,18,Opposition parties,1,0,1
37PGLWGSJT7FDZ4S71CXYQU7KKHIK7,Opposition parties and international observers said the poll was marred by widespread reports and allegations of vote-rigging.,23,46,international observers,1,0,1
37PGLWGSJT7FDZ4S71CXYQU7KKHIK7,Opposition parties and international observers said the poll was marred by widespread reports and allegations of vote-rigging.,37,46,observers,1,2,3
37PGLWGSJT7FDZ4S71CXYQU7KKHIK7,Opposition parties and international observers said the poll was marred by widespread reports and allegations of vote-rigging.,56,60,poll,0,1,1
37PGLWGSJT7FDZ4S71CXYQU7KKHIK7,Opposition parties and international observers said the poll was marred by widespread reports and allegations of vote-rigging.,65,71,marred,7,10,17
37PGLWGSJT7FDZ4S71CXYQU7KKHIK7,Opposition parties and international observers said the poll was marred by widespread reports and allegations of vote-rigging.,75,85,widespread,2,3,5
37PGLWGSJT7FDZ4S71CXYQU7KKHIK7,Opposition parties and international observers said the poll was marred by widespread reports and allegations of vote-rigging.,98,109,allegations,10,8,18
37PGLWGSJT7FDZ4S71CXYQU7KKHIK7,Opposition parties and international observers said the poll was marred by widespread reports and allegations of vote-rigging.,98,125,allegations of vote-rigging,1,1,2
37PGLWGSJT7FDZ4S71CXYQU7KKHIK7,Opposition parties and international observers said the poll was marred by widespread reports and allegations of vote-rigging.,113,125,vote-rigging,7,10,17
37PGLWGSJT7FDZ4S71CXYQU7KKHIK7,"Kirill Kudryavtsev / AFP - Getty Images Police officers surround Russian opposition leader Boris Nemtsov, who was detained while taking part in an unauthorized rally at the Triumfalnaya Square in central Moscow late on Tuesday.",56,64,surround,0,1,1
37PGLWGSJT7FDZ4S71CXYQU7KKHIK7,"Kirill Kudryavtsev / AFP - Getty Images Police officers surround Russian opposition leader Boris Nemtsov, who was detained while taking part in an unauthorized rally at the Triumfalnaya Square in central Moscow late on Tuesday.",65,90,Russian opposition leader,1,0,1
37PGLWGSJT7FDZ4S71CXYQU7KKHIK7,"Kirill Kudryavtsev / AFP - Getty Images Police officers surround Russian opposition leader Boris Nemtsov, who was detained while taking part in an unauthorized rally at the Triumfalnaya Square in central Moscow late on Tuesday.",73,83,opposition,2,1,3
37PGLWGSJT7FDZ4S71CXYQU7KKHIK7,"Kirill Kudryavtsev / AFP - Getty Images Police officers surround Russian opposition leader Boris Nemtsov, who was detained while taking part in an unauthorized rally at the Triumfalnaya Square in central Moscow late on Tuesday.",114,122,detained,6,8,14
37PGLWGSJT7FDZ4S71CXYQU7KKHIK7,"Kirill Kudryavtsev / AFP - Getty Images Police officers surround Russian opposition leader Boris Nemtsov, who was detained while taking part in an unauthorized rally at the Triumfalnaya Square in central Moscow late on Tuesday.",147,159,unauthorized,10,7,17
37PGLWGSJT7FDZ4S71CXYQU7KKHIK7,"Kirill Kudryavtsev / AFP - Getty Images Police officers surround Russian opposition leader Boris Nemtsov, who was detained while taking part in an unauthorized rally at the Triumfalnaya Square in central Moscow late on Tuesday.",147,165,unauthorized rally,3,1,4
37PGLWGSJT7FDZ4S71CXYQU7KKHIK7,"Kirill Kudryavtsev / AFP - Getty Images Police officers surround Russian opposition leader Boris Nemtsov, who was detained while taking part in an unauthorized rally at the Triumfalnaya Square in central Moscow late on Tuesday.",160,165,rally,1,3,4
37PGLWGSJT7FDZ4S71CXYQU7KKHIK7,"Meanwhile, Russia's foreign minister took a swipe at Secretary of State Hillary Clinton Wednesday over her criticism of the election, saying it was ""not Hyde Park"" where speakers could just arrive, hold forth and leave without listening to others.",20,36,foreign minister,1,0,1
37PGLWGSJT7FDZ4S71CXYQU7KKHIK7,"Meanwhile, Russia's foreign minister took a swipe at Secretary of State Hillary Clinton Wednesday over her criticism of the election, saying it was ""not Hyde Park"" where speakers could just arrive, hold forth and leave without listening to others.",44,49,swipe,3,10,13
37PGLWGSJT7FDZ4S71CXYQU7KKHIK7,"Meanwhile, Russia's foreign minister took a swipe at Secretary of State Hillary Clinton Wednesday over her criticism of the election, saying it was ""not Hyde Park"" where speakers could just arrive, hold forth and leave without listening to others.",107,116,criticism,6,7,13
37PGLWGSJT7FDZ4S71CXYQU7KKHIK7,"Meanwhile, Russia's foreign minister took a swipe at Secretary of State Hillary Clinton Wednesday over her criticism of the election, saying it was ""not Hyde Park"" where speakers could just arrive, hold forth and leave without listening to others.",198,208,hold forth,1,1,2
37PGLWGSJT7FDZ4S71CXYQU7KKHIK7,"A Florida mother who fatally shot her four children before killing herself Tuesday called three of the kids who had sought help from a neighbor back to the house before firing the fatal shots, authorities said.",21,28,fatally,4,2,6
37PGLWGSJT7FDZ4S71CXYQU7KKHIK7,"A Florida mother who fatally shot her four children before killing herself Tuesday called three of the kids who had sought help from a neighbor back to the house before firing the fatal shots, authorities said.",21,33,fatally shot,0,2,2
37PGLWGSJT7FDZ4S71CXYQU7KKHIK7,"A Florida mother who fatally shot her four children before killing herself Tuesday called three of the kids who had sought help from a neighbor back to the house before firing the fatal shots, authorities said.",116,122,sought,2,3,5
37PGLWGSJT7FDZ4S71CXYQU7KKHIK7,"A Florida mother who fatally shot her four children before killing herself Tuesday called three of the kids who had sought help from a neighbor back to the house before firing the fatal shots, authorities said.",135,143,neighbor,0,1,1
37PGLWGSJT7FDZ4S71CXYQU7KKHIK7,"A Florida mother who fatally shot her four children before killing herself Tuesday called three of the kids who had sought help from a neighbor back to the house before firing the fatal shots, authorities said.",180,185,fatal,3,2,5
37PGLWGSJT7FDZ4S71CXYQU7KKHIK7,"A Florida mother who fatally shot her four children before killing herself Tuesday called three of the kids who had sought help from a neighbor back to the house before firing the fatal shots, authorities said.",180,191,fatal shots,1,0,1
32K26U12DNPCLZIIERPT92PB70DDVS,Analysts welcome the measures but accuse the government of reacting too late to a problem that was diagnosed years ago.,0,8,Analysts,7,4,11
32K26U12DNPCLZIIERPT92PB70DDVS,Analysts welcome the measures but accuse the government of reacting too late to a problem that was diagnosed years ago.,21,29,measures,3,1,4
32K26U12DNPCLZIIERPT92PB70DDVS,Analysts welcome the measures but accuse the government of reacting too late to a problem that was diagnosed years ago.,34,40,accuse,4,7,11
32K26U12DNPCLZIIERPT92PB70DDVS,Analysts welcome the measures but accuse the government of reacting too late to a problem that was diagnosed years ago.,45,55,government,1,0,1
32K26U12DNPCLZIIERPT92PB70DDVS,Analysts welcome the measures but accuse the government of reacting too late to a problem that was diagnosed years ago.,59,67,reacting,1,0,1
32K26U12DNPCLZIIERPT92PB70DDVS,Analysts welcome the measures but accuse the government of reacting too late to a problem that was diagnosed years ago.,99,108,diagnosed,9,8,17
32K26U12DNPCLZIIERPT92PB70DDVS,"Eduardo Martinez-Abascal, professor of Financial Management at IESE Business School said the Bankia move was a necessary step but one that should have been taken several years ago as other countries had done.",26,59,professor of Financial Management,1,0,1
32K26U12DNPCLZIIERPT92PB70DDVS,"Eduardo Martinez-Abascal, professor of Financial Management at IESE Business School said the Bankia move was a necessary step but one that should have been taken several years ago as other countries had done.",39,48,Financial,1,0,1
32K26U12DNPCLZIIERPT92PB70DDVS,"Eduardo Martinez-Abascal, professor of Financial Management at IESE Business School said the Bankia move was a necessary step but one that should have been taken several years ago as other countries had done.",49,59,Management,1,0,1
32K26U12DNPCLZIIERPT92PB70DDVS,"Eduardo Martinez-Abascal, professor of Financial Management at IESE Business School said the Bankia move was a necessary step but one that should have been taken several years ago as other countries had done.",63,67,IESE,1,1,2
32K26U12DNPCLZIIERPT92PB70DDVS,"Eduardo Martinez-Abascal, professor of Financial Management at IESE Business School said the Bankia move was a necessary step but one that should have been taken several years ago as other countries had done.",93,99,Bankia,0,1,1
32K26U12DNPCLZIIERPT92PB70DDVS,"Less money would have been needed and the confidence generated could have generated growth, he said.",43,53,confidence,1,2,3
32K26U12DNPCLZIIERPT92PB70DDVS,"Less money would have been needed and the confidence generated could have generated growth, he said.",43,63,confidence generated,1,1,2
32K26U12DNPCLZIIERPT92PB70DDVS,"Less money would have been needed and the confidence generated could have generated growth, he said.",54,63,generated,4,0,4
32K26U12DNPCLZIIERPT92PB70DDVS,"Less money would have been needed and the confidence generated could have generated growth, he said.",75,84,generated,2,1,3
32K26U12DNPCLZIIERPT92PB70DDVS,"Less money would have been needed and the confidence generated could have generated growth, he said.",75,91,generated growth,1,1,2
32K26U12DNPCLZIIERPT92PB70DDVS,"Less money would have been needed and the confidence generated could have generated growth, he said.",85,91,growth,0,2,2
32K26U12DNPCLZIIERPT92PB70DDVS,"Antonio Barros, Europe analyst for Eurasia Group, said that while the Bankia move and the reform will likely represent an important effort by the government to try dispelling doubts about the strength of Spanish banks, more needs to be done to regain market confidence.",23,30,analyst,1,0,1
32K26U12DNPCLZIIERPT92PB70DDVS,"Antonio Barros, Europe analyst for Eurasia Group, said that while the Bankia move and the reform will likely represent an important effort by the government to try dispelling doubts about the strength of Spanish banks, more needs to be done to regain market confidence.",90,96,reform,2,3,5
32K26U12DNPCLZIIERPT92PB70DDVS,"Antonio Barros, Europe analyst for Eurasia Group, said that while the Bankia move and the reform will likely represent an important effort by the government to try dispelling doubts about the strength of Spanish banks, more needs to be done to regain market confidence.",109,118,represent,1,1,2
32K26U12DNPCLZIIERPT92PB70DDVS,"Antonio Barros, Europe analyst for Eurasia Group, said that while the Bankia move and the reform will likely represent an important effort by the government to try dispelling doubts about the strength of Spanish banks, more needs to be done to regain market confidence.",164,174,dispelling,9,10,19
32K26U12DNPCLZIIERPT92PB70DDVS,"Antonio Barros, Europe analyst for Eurasia Group, said that while the Bankia move and the reform will likely represent an important effort by the government to try dispelling doubts about the strength of Spanish banks, more needs to be done to regain market confidence.",164,181,dispelling doubts,4,2,6
32K26U12DNPCLZIIERPT92PB70DDVS,"Antonio Barros, Europe analyst for Eurasia Group, said that while the Bankia move and the reform will likely represent an important effort by the government to try dispelling doubts about the strength of Spanish banks, more needs to be done to regain market confidence.",192,200,strength,0,1,1
32K26U12DNPCLZIIERPT92PB70DDVS,"Antonio Barros, Europe analyst for Eurasia Group, said that while the Bankia move and the reform will likely represent an important effort by the government to try dispelling doubts about the strength of Spanish banks, more needs to be done to regain market confidence.",244,250,regain,0,4,4
32K26U12DNPCLZIIERPT92PB70DDVS,"Antonio Barros, Europe analyst for Eurasia Group, said that while the Bankia move and the reform will likely represent an important effort by the government to try dispelling doubts about the strength of Spanish banks, more needs to be done to regain market confidence.",251,268,market confidence,3,1,4
32K26U12DNPCLZIIERPT92PB70DDVS,"The successive rounds of financial system reform have not helped to build the necessary credibility for the system, and short of a big bang solution that specifies where the money to recapitalize the banks is going to come from, today's (Friday's) reforms might disappoint markets, Barroso said in a note.",5,15,successive,4,3,7
32K26U12DNPCLZIIERPT92PB70DDVS,"The successive rounds of financial system reform have not helped to build the necessary credibility for the system, and short of a big bang solution that specifies where the money to recapitalize the banks is going to come from, today's (Friday's) reforms might disappoint markets, Barroso said in a note.",5,22,successive rounds,3,1,4
32K26U12DNPCLZIIERPT92PB70DDVS,"The successive rounds of financial system reform have not helped to build the necessary credibility for the system, and short of a big bang solution that specifies where the money to recapitalize the banks is going to come from, today's (Friday's) reforms might disappoint markets, Barroso said in a note.",16,22,rounds,0,1,1
32K26U12DNPCLZIIERPT92PB70DDVS,"The successive rounds of financial system reform have not helped to build the necessary credibility for the system, and short of a big bang solution that specifies where the money to recapitalize the banks is going to come from, today's (Friday's) reforms might disappoint markets, Barroso said in a note.",26,49,financial system reform,3,0,3
32K26U12DNPCLZIIERPT92PB70DDVS,"The successive rounds of financial system reform have not helped to build the necessary credibility for the system, and short of a big bang solution that specifies where the money to recapitalize the banks is going to come from, today's (Friday's) reforms might disappoint markets, Barroso said in a note.",43,49,reform,2,0,2
32K26U12DNPCLZIIERPT92PB70DDVS,"The successive rounds of financial system reform have not helped to build the necessary credibility for the system, and short of a big bang solution that specifies where the money to recapitalize the banks is going to come from, today's (Friday's) reforms might disappoint markets, Barroso said in a note.",79,100,necessary credibility,2,0,2
32K26U12DNPCLZIIERPT92PB70DDVS,"The successive rounds of financial system reform have not helped to build the necessary credibility for the system, and short of a big bang solution that specifies where the money to recapitalize the banks is going to come from, today's (Friday's) reforms might disappoint markets, Barroso said in a note.",89,100,credibility,8,9,17
32K26U12DNPCLZIIERPT92PB70DDVS,"The successive rounds of financial system reform have not helped to build the necessary credibility for the system, and short of a big bang solution that specifies where the money to recapitalize the banks is going to come from, today's (Friday's) reforms might disappoint markets, Barroso said in a note.",132,140,big bang,0,2,2
32K26U12DNPCLZIIERPT92PB70DDVS,"The successive rounds of financial system reform have not helped to build the necessary credibility for the system, and short of a big bang solution that specifies where the money to recapitalize the banks is going to come from, today's (Friday's) reforms might disappoint markets, Barroso said in a note.",132,149,big bang solution,8,2,10
32K26U12DNPCLZIIERPT92PB70DDVS,"The successive rounds of financial system reform have not helped to build the necessary credibility for the system, and short of a big bang solution that specifies where the money to recapitalize the banks is going to come from, today's (Friday's) reforms might disappoint markets, Barroso said in a note.",155,164,specifies,1,0,1
32K26U12DNPCLZIIERPT92PB70DDVS,"The successive rounds of financial system reform have not helped to build the necessary credibility for the system, and short of a big bang solution that specifies where the money to recapitalize the banks is going to come from, today's (Friday's) reforms might disappoint markets, Barroso said in a note.",184,196,recapitalize,10,9,19
32K26U12DNPCLZIIERPT92PB70DDVS,"The successive rounds of financial system reform have not helped to build the necessary credibility for the system, and short of a big bang solution that specifies where the money to recapitalize the banks is going to come from, today's (Friday's) reforms might disappoint markets, Barroso said in a note.",184,206,recapitalize the banks,1,0,1
32K26U12DNPCLZIIERPT92PB70DDVS,"The successive rounds of financial system reform have not helped to build the necessary credibility for the system, and short of a big bang solution that specifies where the money to recapitalize the banks is going to come from, today's (Friday's) reforms might disappoint markets, Barroso said in a note.",249,256,reforms,3,1,4
32K26U12DNPCLZIIERPT92PB70DDVS,"The successive rounds of financial system reform have not helped to build the necessary credibility for the system, and short of a big bang solution that specifies where the money to recapitalize the banks is going to come from, today's (Friday's) reforms might disappoint markets, Barroso said in a note.",263,273,disappoint,0,1,1
3LG268AV387PKYF112V3ENITNJ4ERN,"Unfortunately he did not see that text or read it on his phone until he woke up this morning ... well after the incident occurred, Goodyear said.",1,14,Unfortunately,6,3,9
3LG268AV387PKYF112V3ENITNJ4ERN,"Unfortunately he did not see that text or read it on his phone until he woke up this morning ... well after the incident occurred, Goodyear said.",35,39,text,1,1,2
3LG268AV387PKYF112V3ENITNJ4ERN,"Unfortunately he did not see that text or read it on his phone until he woke up this morning ... well after the incident occurred, Goodyear said.",113,121,incident,5,3,8
3LG268AV387PKYF112V3ENITNJ4ERN,"Unfortunately he did not see that text or read it on his phone until he woke up this morning ... well after the incident occurred, Goodyear said.",113,130,incident occurred,1,2,3
3LG268AV387PKYF112V3ENITNJ4ERN,"Unfortunately he did not see that text or read it on his phone until he woke up this morning ... well after the incident occurred, Goodyear said.",122,130,occurred,3,1,4
3LG268AV387PKYF112V3ENITNJ4ERN,The children's father does not live with the family and Goodyear said he was distraught.,77,87,distraught,10,10,20
3LG268AV387PKYF112V3ENITNJ4ERN,Goodyear said police do not have a motive.,35,41,motive,7,9,16
3LG268AV387PKYF112V3ENITNJ4ERN,He said authorities have received previous calls from Thomas' home pertaining to domestic violence.,8,19,authorities,5,4,9
3LG268AV387PKYF112V3ENITNJ4ERN,He said authorities have received previous calls from Thomas' home pertaining to domestic violence.,25,33,received,1,0,1
3LG268AV387PKYF112V3ENITNJ4ERN,He said authorities have received previous calls from Thomas' home pertaining to domestic violence.,34,42,previous,0,1,1
3LG268AV387PKYF112V3ENITNJ4ERN,He said authorities have received previous calls from Thomas' home pertaining to domestic violence.,67,77,pertaining,10,10,20
3LG268AV387PKYF112V3ENITNJ4ERN,He said authorities have received previous calls from Thomas' home pertaining to domestic violence.,81,89,domestic,1,2,3
3LG268AV387PKYF112V3ENITNJ4ERN,He said authorities have received previous calls from Thomas' home pertaining to domestic violence.,81,98,domestic violence,5,4,9
3LG268AV387PKYF112V3ENITNJ4ERN,He said authorities have received previous calls from Thomas' home pertaining to domestic violence.,90,98,violence,0,2,2
3LG268AV387PKYF112V3ENITNJ4ERN,Goodyear said he was having a hard time trying to understand how a mother could commit such a grisly act.,80,86,commit,1,1,2
3LG268AV387PKYF112V3ENITNJ4ERN,Goodyear said he was having a hard time trying to understand how a mother could commit such a grisly act.,94,100,grisly,10,10,20
3LG268AV387PKYF112V3ENITNJ4ERN,Goodyear said he was having a hard time trying to understand how a mother could commit such a grisly act.,94,104,grisly act,2,2,4
3LG268AV387PKYF112V3ENITNJ4ERN,He said she remained very calm when she called the children back to their house.,12,20,remained,0,1,1
3LG268AV387PKYF112V3ENITNJ4ERN,He said she remained very calm when she called the children back to their house.,26,30,calm,1,1,2
3LG268AV387PKYF112V3ENITNJ4ERN,"I cannot comprehend as a parent doing this to their children ... calling them back in and shooting them, he said.",10,20,comprehend,10,10,20
3P458N04Q1IHMEPXHH6U14VSRXZ2X5,"As the children were walking home, the neighbor called 911.",39,47,neighbor,1,1,2
3P458N04Q1IHMEPXHH6U14VSRXZ2X5,"Moments later, the neighbor told the authorities that she heard several more gunshots.",0,7,Moments,0,2,2
3P458N04Q1IHMEPXHH6U14VSRXZ2X5,"Moments later, the neighbor told the authorities that she heard several more gunshots.",0,13,Moments later,0,1,1
3P458N04Q1IHMEPXHH6U14VSRXZ2X5,"Moments later, the neighbor told the authorities that she heard several more gunshots.",19,27,neighbor,0,1,1
3P458N04Q1IHMEPXHH6U14VSRXZ2X5,"Moments later, the neighbor told the authorities that she heard several more gunshots.",37,48,authorities,10,5,15
3P458N04Q1IHMEPXHH6U14VSRXZ2X5,"Moments later, the neighbor told the authorities that she heard several more gunshots.",77,85,gunshots,1,1,2
3P458N04Q1IHMEPXHH6U14VSRXZ2X5,"Sheriff's deputies, who arrived within four minutes of the call, heard additional gunshots, Lieutenant Goodyear said.",0,7,Sheriff,1,0,1
3P458N04Q1IHMEPXHH6U14VSRXZ2X5,"Sheriff's deputies, who arrived within four minutes of the call, heard additional gunshots, Lieutenant Goodyear said.",0,17,Sheriffs deputies,1,0,1
3P458N04Q1IHMEPXHH6U14VSRXZ2X5,"Sheriff's deputies, who arrived within four minutes of the call, heard additional gunshots, Lieutenant Goodyear said.",10,18,deputies,2,7,9
3P458N04Q1IHMEPXHH6U14VSRXZ2X5,"Sheriff's deputies, who arrived within four minutes of the call, heard additional gunshots, Lieutenant Goodyear said.",24,31,arrived,0,1,1
3P458N04Q1IHMEPXHH6U14VSRXZ2X5,"Sheriff's deputies, who arrived within four minutes of the call, heard additional gunshots, Lieutenant Goodyear said.",71,81,additional,3,2,5
3P458N04Q1IHMEPXHH6U14VSRXZ2X5,"Sheriff's deputies, who arrived within four minutes of the call, heard additional gunshots, Lieutenant Goodyear said.",92,102,Lieutenant,2,3,5
3P458N04Q1IHMEPXHH6U14VSRXZ2X5,"A few minutes later, deputies saw someone who may have been armed with a gun open the front door before going back inside.",21,29,deputies,2,2,4
3P458N04Q1IHMEPXHH6U14VSRXZ2X5,"A few minutes later, deputies saw someone who may have been armed with a gun open the front door before going back inside.",60,65,armed,1,0,1
3P458N04Q1IHMEPXHH6U14VSRXZ2X5,"About 30 minutes later, there was a final shot, Lieutenant Goodyear said.",36,46,final shot,0,1,1
3P458N04Q1IHMEPXHH6U14VSRXZ2X5,"About 30 minutes later, there was a final shot, Lieutenant Goodyear said.",48,58,Lieutenant,3,0,3
3P458N04Q1IHMEPXHH6U14VSRXZ2X5,"Shortly after, a special weapons team entered the house and found three children and Ms. Thomas, who the authorities said had a self-inflicted gunshot wound.",0,13,Shortly after,0,1,1
3P458N04Q1IHMEPXHH6U14VSRXZ2X5,"Shortly after, a special weapons team entered the house and found three children and Ms. Thomas, who the authorities said had a self-inflicted gunshot wound.",17,37,special weapons team,4,1,5
3P458N04Q1IHMEPXHH6U14VSRXZ2X5,"Shortly after, a special weapons team entered the house and found three children and Ms. Thomas, who the authorities said had a self-inflicted gunshot wound.",25,32,weapons,1,1,2
3P458N04Q1IHMEPXHH6U14VSRXZ2X5,"Shortly after, a special weapons team entered the house and found three children and Ms. Thomas, who the authorities said had a self-inflicted gunshot wound.",38,45,entered,0,1,1
3P458N04Q1IHMEPXHH6U14VSRXZ2X5,"Shortly after, a special weapons team entered the house and found three children and Ms. Thomas, who the authorities said had a self-inflicted gunshot wound.",105,116,authorities,3,1,4
3P458N04Q1IHMEPXHH6U14VSRXZ2X5,"Shortly after, a special weapons team entered the house and found three children and Ms. Thomas, who the authorities said had a self-inflicted gunshot wound.",128,142,self-inflicted,10,10,20
3P458N04Q1IHMEPXHH6U14VSRXZ2X5,"Shortly after, a special weapons team entered the house and found three children and Ms. Thomas, who the authorities said had a self-inflicted gunshot wound.",128,156,self-inflicted gunshot wound,1,0,1
3P458N04Q1IHMEPXHH6U14VSRXZ2X5,"Shortly after, a special weapons team entered the house and found three children and Ms. Thomas, who the authorities said had a self-inflicted gunshot wound.",151,156,wound,1,1,2
3P458N04Q1IHMEPXHH6U14VSRXZ2X5,"The body of a fourth child, who had also been shot, was found in the front yard.",69,79,front yard,0,1,1
3P458N04Q1IHMEPXHH6U14VSRXZ2X5,"Lieutenant Goodyear said there had been other calls to 911 related to incidents at the house, the most recent on Easter.",0,10,Lieutenant,2,0,2
3P458N04Q1IHMEPXHH6U14VSRXZ2X5,"Lieutenant Goodyear said there had been other calls to 911 related to incidents at the house, the most recent on Easter.",59,66,related,1,0,1
3P458N04Q1IHMEPXHH6U14VSRXZ2X5,"Lieutenant Goodyear said there had been other calls to 911 related to incidents at the house, the most recent on Easter.",70,79,incidents,10,4,14
3P458N04Q1IHMEPXHH6U14VSRXZ2X5,"Lieutenant Goodyear said there had been other calls to 911 related to incidents at the house, the most recent on Easter.",98,109,most recent,0,1,1
3P458N04Q1IHMEPXHH6U14VSRXZ2X5,"Lieutenant Goodyear said there had been other calls to 911 related to incidents at the house, the most recent on Easter.",103,109,recent,1,1,2
3P458N04Q1IHMEPXHH6U14VSRXZ2X5,"Lieutenant Goodyear said there had been other calls to 911 related to incidents at the house, the most recent on Easter.",113,119,Easter,0,1,1
3OYHVNTV5TZP9LFV5WP2INQTVSSKOD,"It was an effort to say that progress has been made and that the end is coming, however slowly, while trying to assure the Afghans that the United States will not cut and run once the combat mission ends.",10,16,effort,0,3,3
3OYHVNTV5TZP9LFV5WP2INQTVSSKOD,"It was an effort to say that progress has been made and that the end is coming, however slowly, while trying to assure the Afghans that the United States will not cut and run once the combat mission ends.",29,37,progress,1,3,4
3OYHVNTV5TZP9LFV5WP2INQTVSSKOD,"It was an effort to say that progress has been made and that the end is coming, however slowly, while trying to assure the Afghans that the United States will not cut and run once the combat mission ends.",29,51,progress has been made,1,0,1
3OYHVNTV5TZP9LFV5WP2INQTVSSKOD,"It was an effort to say that progress has been made and that the end is coming, however slowly, while trying to assure the Afghans that the United States will not cut and run once the combat mission ends.",112,118,assure,4,3,7
3OYHVNTV5TZP9LFV5WP2INQTVSSKOD,"It was an effort to say that progress has been made and that the end is coming, however slowly, while trying to assure the Afghans that the United States will not cut and run once the combat mission ends.",163,174,cut and run,3,1,4
3OYHVNTV5TZP9LFV5WP2INQTVSSKOD,"It was an effort to say that progress has been made and that the end is coming, however slowly, while trying to assure the Afghans that the United States will not cut and run once the combat mission ends.",184,190,combat,1,3,4
3OYHVNTV5TZP9LFV5WP2INQTVSSKOD,"It was an effort to say that progress has been made and that the end is coming, however slowly, while trying to assure the Afghans that the United States will not cut and run once the combat mission ends.",184,198,combat mission,3,4,7
3OYHVNTV5TZP9LFV5WP2INQTVSSKOD,"It was an effort to say that progress has been made and that the end is coming, however slowly, while trying to assure the Afghans that the United States will not cut and run once the combat mission ends.",184,203,combat mission ends,0,1,1
3OYHVNTV5TZP9LFV5WP2INQTVSSKOD,"It was an effort to say that progress has been made and that the end is coming, however slowly, while trying to assure the Afghans that the United States will not cut and run once the combat mission ends.",191,198,mission,0,1,1
3OYHVNTV5TZP9LFV5WP2INQTVSSKOD,"It was an effort to say that progress has been made and that the end is coming, however slowly, while trying to assure the Afghans that the United States will not cut and run once the combat mission ends.",191,203,mission ends,1,0,1
3OYHVNTV5TZP9LFV5WP2INQTVSSKOD,"He said the United States must see this battle through to a successful conclusion, although not one that involves nation-building.",40,46,battle,0,1,1
3OYHVNTV5TZP9LFV5WP2INQTVSSKOD,"He said the United States must see this battle through to a successful conclusion, although not one that involves nation-building.",60,70,successful,1,0,1
3OYHVNTV5TZP9LFV5WP2INQTVSSKOD,"He said the United States must see this battle through to a successful conclusion, although not one that involves nation-building.",60,81,successful conclusion,2,2,4
3OYHVNTV5TZP9LFV5WP2INQTVSSKOD,"He said the United States must see this battle through to a successful conclusion, although not one that involves nation-building.",71,81,conclusion,5,5,10
3OYHVNTV5TZP9LFV5WP2INQTVSSKOD,"He said the United States must see this battle through to a successful conclusion, although not one that involves nation-building.",105,113,involves,0,2,2
3OYHVNTV5TZP9LFV5WP2INQTVSSKOD,"He said the United States must see this battle through to a successful conclusion, although not one that involves nation-building.",114,129,nation-building,8,5,13
3OYHVNTV5TZP9LFV5WP2INQTVSSKOD,"In President Barack Obama's twin narratives, the United States is both leaving Afghanistan and staying there.",28,32,twin,0,1,1
3OYHVNTV5TZP9LFV5WP2INQTVSSKOD,"In President Barack Obama's twin narratives, the United States is both leaving Afghanistan and staying there.",28,43,twin narratives,4,3,7
3OYHVNTV5TZP9LFV5WP2INQTVSSKOD,"In President Barack Obama's twin narratives, the United States is both leaving Afghanistan and staying there.",33,43,narratives,8,9,17
3OYHVNTV5TZP9LFV5WP2INQTVSSKOD,"The different messages are meant for different audiences, one at home and one away.",14,22,messages,0,1,1
3OYHVNTV5TZP9LFV5WP2INQTVSSKOD,"The different messages are meant for different audiences, one at home and one away.",27,32,meant,0,1,1
3OYHVNTV5TZP9LFV5WP2INQTVSSKOD,"The different messages are meant for different audiences, one at home and one away.",47,56,audiences,4,6,10
3OYHVNTV5TZP9LFV5WP2INQTVSSKOD,"As Obama's brief, symbolic visit to Afghanistan on Wednesday made clear, the more important audience is American voters fed up with a war that will be in its 12th year on Election Day in November.",11,16,brief,0,1,1
3OYHVNTV5TZP9LFV5WP2INQTVSSKOD,"As Obama's brief, symbolic visit to Afghanistan on Wednesday made clear, the more important audience is American voters fed up with a war that will be in its 12th year on Election Day in November.",18,26,symbolic,10,3,13
3OYHVNTV5TZP9LFV5WP2INQTVSSKOD,"As Obama's brief, symbolic visit to Afghanistan on Wednesday made clear, the more important audience is American voters fed up with a war that will be in its 12th year on Election Day in November.",18,32,symbolic visit,0,2,2
3OYHVNTV5TZP9LFV5WP2INQTVSSKOD,"As Obama's brief, symbolic visit to Afghanistan on Wednesday made clear, the more important audience is American voters fed up with a war that will be in its 12th year on Election Day in November.",73,100,the more important audience,1,0,1
3OYHVNTV5TZP9LFV5WP2INQTVSSKOD,"As Obama's brief, symbolic visit to Afghanistan on Wednesday made clear, the more important audience is American voters fed up with a war that will be in its 12th year on Election Day in November.",92,100,audience,3,0,3
3OYHVNTV5TZP9LFV5WP2INQTVSSKOD,"As Obama's brief, symbolic visit to Afghanistan on Wednesday made clear, the more important audience is American voters fed up with a war that will be in its 12th year on Election Day in November.",120,123,fed,0,1,1
3OYHVNTV5TZP9LFV5WP2INQTVSSKOD,"As Obama's brief, symbolic visit to Afghanistan on Wednesday made clear, the more important audience is American voters fed up with a war that will be in its 12th year on Election Day in November.",120,126,fed up,4,6,10
3O2Y2UIUCQVV38226T6CVTHF4SPKFI,"From broadband communications infrastructure, enterprise mobility and public safety solutions to mobile and wireline digital communication devices that provide compelling experiences, Motorola is leading the next wave of innovations that enable people, enterprises and governments to be more connected and more mobile.",5,14,broadband,1,1,2
3O2Y2UIUCQVV38226T6CVTHF4SPKFI,"From broadband communications infrastructure, enterprise mobility and public safety solutions to mobile and wireline digital communication devices that provide compelling experiences, Motorola is leading the next wave of innovations that enable people, enterprises and governments to be more connected and more mobile.",5,44,broadband communications infrastructure,6,3,9
3O2Y2UIUCQVV38226T6CVTHF4SPKFI,"From broadband communications infrastructure, enterprise mobility and public safety solutions to mobile and wireline digital communication devices that provide compelling experiences, Motorola is leading the next wave of innovations that enable people, enterprises and governments to be more connected and more mobile.",30,44,infrastructure,6,7,13
3O2Y2UIUCQVV38226T6CVTHF4SPKFI,"From broadband communications infrastructure, enterprise mobility and public safety solutions to mobile and wireline digital communication devices that provide compelling experiences, Motorola is leading the next wave of innovations that enable people, enterprises and governments to be more connected and more mobile.",46,56,enterprise,3,3,6
3O2Y2UIUCQVV38226T6CVTHF4SPKFI,"From broadband communications infrastructure, enterprise mobility and public safety solutions to mobile and wireline digital communication devices that provide compelling experiences, Motorola is leading the next wave of innovations that enable people, enterprises and governments to be more connected and more mobile.",46,65,enterprise mobility,6,1,7
3O2Y2UIUCQVV38226T6CVTHF4SPKFI,"From broadband communications infrastructure, enterprise mobility and public safety solutions to mobile and wireline digital communication devices that provide compelling experiences, Motorola is leading the next wave of innovations that enable people, enterprises and governments to be more connected and more mobile.",57,65,mobility,2,1,3
3O2Y2UIUCQVV38226T6CVTHF4SPKFI,"From broadband communications infrastructure, enterprise mobility and public safety solutions to mobile and wireline digital communication devices that provide compelling experiences, Motorola is leading the next wave of innovations that enable people, enterprises and governments to be more connected and more mobile.",70,93,public safety solutions,1,1,2
3O2Y2UIUCQVV38226T6CVTHF4SPKFI,"From broadband communications infrastructure, enterprise mobility and public safety solutions to mobile and wireline digital communication devices that provide compelling experiences, Motorola is leading the next wave of innovations that enable people, enterprises and governments to be more connected and more mobile.",84,93,solutions,1,0,1
3O2Y2UIUCQVV38226T6CVTHF4SPKFI,"From broadband communications infrastructure, enterprise mobility and public safety solutions to mobile and wireline digital communication devices that provide compelling experiences, Motorola is leading the next wave of innovations that enable people, enterprises and governments to be more connected and more mobile.",108,116,wireline,4,3,7
3O2Y2UIUCQVV38226T6CVTHF4SPKFI,"From broadband communications infrastructure, enterprise mobility and public safety solutions to mobile and wireline digital communication devices that provide compelling experiences, Motorola is leading the next wave of innovations that enable people, enterprises and governments to be more connected and more mobile.",108,146,wireline digital communication devices,1,0,1
3O2Y2UIUCQVV38226T6CVTHF4SPKFI,"From broadband communications infrastructure, enterprise mobility and public safety solutions to mobile and wireline digital communication devices that provide compelling experiences, Motorola is leading the next wave of innovations that enable people, enterprises and governments to be more connected and more mobile.",125,138,communication,1,0,1
3O2Y2UIUCQVV38226T6CVTHF4SPKFI,"From broadband communications infrastructure, enterprise mobility and public safety solutions to mobile and wireline digital communication devices that provide compelling experiences, Motorola is leading the next wave of innovations that enable people, enterprises and governments to be more connected and more mobile.",160,170,compelling,8,9,17
3O2Y2UIUCQVV38226T6CVTHF4SPKFI,"From broadband communications infrastructure, enterprise mobility and public safety solutions to mobile and wireline digital communication devices that provide compelling experiences, Motorola is leading the next wave of innovations that enable people, enterprises and governments to be more connected and more mobile.",160,182,compelling experiences,3,1,4
3O2Y2UIUCQVV38226T6CVTHF4SPKFI,"From broadband communications infrastructure, enterprise mobility and public safety solutions to mobile and wireline digital communication devices that provide compelling experiences, Motorola is leading the next wave of innovations that enable people, enterprises and governments to be more connected and more mobile.",208,217,next wave,0,1,1
3O2Y2UIUCQVV38226T6CVTHF4SPKFI,"From broadband communications infrastructure, enterprise mobility and public safety solutions to mobile and wireline digital communication devices that provide compelling experiences, Motorola is leading the next wave of innovations that enable people, enterprises and governments to be more connected and more mobile.",208,232,next wave of innovations,1,0,1
3O2Y2UIUCQVV38226T6CVTHF4SPKFI,"From broadband communications infrastructure, enterprise mobility and public safety solutions to mobile and wireline digital communication devices that provide compelling experiences, Motorola is leading the next wave of innovations that enable people, enterprises and governments to be more connected and more mobile.",213,217,wave,2,0,2
3O2Y2UIUCQVV38226T6CVTHF4SPKFI,"From broadband communications infrastructure, enterprise mobility and public safety solutions to mobile and wireline digital communication devices that provide compelling experiences, Motorola is leading the next wave of innovations that enable people, enterprises and governments to be more connected and more mobile.",213,232,wave of innovations,1,0,1
3O2Y2UIUCQVV38226T6CVTHF4SPKFI,"From broadband communications infrastructure, enterprise mobility and public safety solutions to mobile and wireline digital communication devices that provide compelling experiences, Motorola is leading the next wave of innovations that enable people, enterprises and governments to be more connected and more mobile.",221,232,innovations,8,9,17
3O2Y2UIUCQVV38226T6CVTHF4SPKFI,"From broadband communications infrastructure, enterprise mobility and public safety solutions to mobile and wireline digital communication devices that provide compelling experiences, Motorola is leading the next wave of innovations that enable people, enterprises and governments to be more connected and more mobile.",253,264,enterprises,1,2,3
3O2Y2UIUCQVV38226T6CVTHF4SPKFI,"Motorola (NYSE: MOT) had sales of US $22 billion in 2009 Google provides search and advertising services, which together aim to organize and monetize the world's information.",10,19,NYSE: MOT,1,0,1
3O2Y2UIUCQVV38226T6CVTHF4SPKFI,"Motorola (NYSE: MOT) had sales of US $22 billion in 2009 Google provides search and advertising services, which together aim to organize and monetize the world's information.",84,95,advertising,1,0,1
3O2Y2UIUCQVV38226T6CVTHF4SPKFI,"Motorola (NYSE: MOT) had sales of US $22 billion in 2009 Google provides search and advertising services, which together aim to organize and monetize the world's information.",121,124,aim,0,1,1
3O2Y2UIUCQVV38226T6CVTHF4SPKFI,"Motorola (NYSE: MOT) had sales of US $22 billion in 2009 Google provides search and advertising services, which together aim to organize and monetize the world's information.",128,136,organize,1,0,1
3O2Y2UIUCQVV38226T6CVTHF4SPKFI,"Motorola (NYSE: MOT) had sales of US $22 billion in 2009 Google provides search and advertising services, which together aim to organize and monetize the world's information.",141,149,monetize,10,9,19
3O2Y2UIUCQVV38226T6CVTHF4SPKFI,"Motorola (NYSE: MOT) had sales of US $22 billion in 2009 Google provides search and advertising services, which together aim to organize and monetize the world's information.",141,172,monetize the worlds information,1,0,1
3O2Y2UIUCQVV38226T6CVTHF4SPKFI,"Motorola (NYSE: MOT) had sales of US $22 billion in 2009 Google provides search and advertising services, which together aim to organize and monetize the world's information.",154,172,worlds information,0,1,1
3O2Y2UIUCQVV38226T6CVTHF4SPKFI,"In addition to its dominant search engine, it offers a plethora of online tools and platforms including: Gmail, Maps, YouTube, and Google+, the company's extension into the social space.",19,27,dominant,6,7,13
3O2Y2UIUCQVV38226T6CVTHF4SPKFI,"In addition to its dominant search engine, it offers a plethora of online tools and platforms including: Gmail, Maps, YouTube, and Google+, the company's extension into the social space.",19,41,dominant search engine,1,0,1
3O2Y2UIUCQVV38226T6CVTHF4SPKFI,"In addition to its dominant search engine, it offers a plethora of online tools and platforms including: Gmail, Maps, YouTube, and Google+, the company's extension into the social space.",55,63,plethora,9,10,19
3O2Y2UIUCQVV38226T6CVTHF4SPKFI,"In addition to its dominant search engine, it offers a plethora of online tools and platforms including: Gmail, Maps, YouTube, and Google+, the company's extension into the social space.",55,66,plethora of,0,2,2
3O2Y2UIUCQVV38226T6CVTHF4SPKFI,"In addition to its dominant search engine, it offers a plethora of online tools and platforms including: Gmail, Maps, YouTube, and Google+, the company's extension into the social space.",55,79,plethora of online tools,1,0,1
3O2Y2UIUCQVV38226T6CVTHF4SPKFI,"In addition to its dominant search engine, it offers a plethora of online tools and platforms including: Gmail, Maps, YouTube, and Google+, the company's extension into the social space.",154,163,extension,2,2,4
3O2Y2UIUCQVV38226T6CVTHF4SPKFI,"In addition to its dominant search engine, it offers a plethora of online tools and platforms including: Gmail, Maps, YouTube, and Google+, the company's extension into the social space.",173,185,social space,1,0,1
3O2Y2UIUCQVV38226T6CVTHF4SPKFI,"Most of its Web-based products are free, funded by Google's highly integrated online advertising platforms AdWords and AdSense.",12,21,Web-based,1,0,1
3O2Y2UIUCQVV38226T6CVTHF4SPKFI,"Most of its Web-based products are free, funded by Google's highly integrated online advertising platforms AdWords and AdSense.",41,47,funded,1,1,2
3O2Y2UIUCQVV38226T6CVTHF4SPKFI,"Most of its Web-based products are free, funded by Google's highly integrated online advertising platforms AdWords and AdSense.",60,77,highly integrated,1,0,1
3O2Y2UIUCQVV38226T6CVTHF4SPKFI,"Most of its Web-based products are free, funded by Google's highly integrated online advertising platforms AdWords and AdSense.",60,106,highly integrated online advertising platforms,2,0,2
3O2Y2UIUCQVV38226T6CVTHF4SPKFI,"Most of its Web-based products are free, funded by Google's highly integrated online advertising platforms AdWords and AdSense.",67,77,integrated,8,4,12
3O2Y2UIUCQVV38226T6CVTHF4SPKFI,"Most of its Web-based products are free, funded by Google's highly integrated online advertising platforms AdWords and AdSense.",78,84,online,0,1,1
3O2Y2UIUCQVV38226T6CVTHF4SPKFI,"Most of its Web-based products are free, funded by Google's highly integrated online advertising platforms AdWords and AdSense.",78,106,online advertising platforms,1,0,1
3O2Y2UIUCQVV38226T6CVTHF4SPKFI,"Most of its Web-based products are free, funded by Google's highly integrated online advertising platforms AdWords and AdSense.",85,96,advertising,1,0,1
3O2Y2UIUCQVV38226T6CVTHF4SPKFI,"Most of its Web-based products are free, funded by Google's highly integrated online advertising platforms AdWords and AdSense.",97,106,platforms,1,0,1
3O2Y2UIUCQVV38226T6CVTHF4SPKFI,"Syrian forces killed at least five people when they raided a Sunni farming village on Sunday, torching homes and looting shops in what activists said is a sign of worsening relations among the country's religious groups.",52,58,raided,2,2,4
3O2Y2UIUCQVV38226T6CVTHF4SPKFI,"Syrian forces killed at least five people when they raided a Sunni farming village on Sunday, torching homes and looting shops in what activists said is a sign of worsening relations among the country's religious groups.",61,66,Sunni,0,1,1
3O2Y2UIUCQVV38226T6CVTHF4SPKFI,"Syrian forces killed at least five people when they raided a Sunni farming village on Sunday, torching homes and looting shops in what activists said is a sign of worsening relations among the country's religious groups.",94,102,torching,3,4,7
3O2Y2UIUCQVV38226T6CVTHF4SPKFI,"Syrian forces killed at least five people when they raided a Sunni farming village on Sunday, torching homes and looting shops in what activists said is a sign of worsening relations among the country's religious groups.",94,108,torching homes,0,1,1
3O2Y2UIUCQVV38226T6CVTHF4SPKFI,"Syrian forces killed at least five people when they raided a Sunni farming village on Sunday, torching homes and looting shops in what activists said is a sign of worsening relations among the country's religious groups.",113,120,looting,3,6,9
3O2Y2UIUCQVV38226T6CVTHF4SPKFI,"Syrian forces killed at least five people when they raided a Sunni farming village on Sunday, torching homes and looting shops in what activists said is a sign of worsening relations among the country's religious groups.",113,126,looting shops,0,2,2
3O2Y2UIUCQVV38226T6CVTHF4SPKFI,"Syrian forces killed at least five people when they raided a Sunni farming village on Sunday, torching homes and looting shops in what activists said is a sign of worsening relations among the country's religious groups.",135,144,activists,2,6,8
3O2Y2UIUCQVV38226T6CVTHF4SPKFI,"Syrian forces killed at least five people when they raided a Sunni farming village on Sunday, torching homes and looting shops in what activists said is a sign of worsening relations among the country's religious groups.",163,172,worsening,2,8,10
3O2Y2UIUCQVV38226T6CVTHF4SPKFI,"Syrian forces killed at least five people when they raided a Sunni farming village on Sunday, torching homes and looting shops in what activists said is a sign of worsening relations among the country's religious groups.",163,182,worsening relations,1,0,1
3BO3NEOQM0I91MV6VAZ84CRBF8NIAS,Investigating officers have appealed to anyone who was in the Sarsfield Road or Goldenbridge Terrace areas last night to contact them on 01-6667200.,0,13,Investigating,6,4,10
3BO3NEOQM0I91MV6VAZ84CRBF8NIAS,Investigating officers have appealed to anyone who was in the Sarsfield Road or Goldenbridge Terrace areas last night to contact them on 01-6667200.,0,22,Investigating officers,2,1,3
3BO3NEOQM0I91MV6VAZ84CRBF8NIAS,Investigating officers have appealed to anyone who was in the Sarsfield Road or Goldenbridge Terrace areas last night to contact them on 01-6667200.,28,36,appealed,7,10,17
3BO3NEOQM0I91MV6VAZ84CRBF8NIAS,Investigating officers have appealed to anyone who was in the Sarsfield Road or Goldenbridge Terrace areas last night to contact them on 01-6667200.,28,46,appealed to anyone,1,0,1
3BO3NEOQM0I91MV6VAZ84CRBF8NIAS,16/05/2012 - 08:35:41 Gardaí are to carry out a technical examination at the scene of a shooting in Dublin last night.,22,28,Gardaí,0,2,2
3BO3NEOQM0I91MV6VAZ84CRBF8NIAS,16/05/2012 - 08:35:41 Gardaí are to carry out a technical examination at the scene of a shooting in Dublin last night.,48,57,technical,2,0,2
3BO3NEOQM0I91MV6VAZ84CRBF8NIAS,16/05/2012 - 08:35:41 Gardaí are to carry out a technical examination at the scene of a shooting in Dublin last night.,48,69,technical examination,7,4,11
3BO3NEOQM0I91MV6VAZ84CRBF8NIAS,16/05/2012 - 08:35:41 Gardaí are to carry out a technical examination at the scene of a shooting in Dublin last night.,58,69,examination,6,0,6
3BO3NEOQM0I91MV6VAZ84CRBF8NIAS,16/05/2012 - 08:35:41 Gardaí are to carry out a technical examination at the scene of a shooting in Dublin last night.,88,96,shooting,1,0,1
3BO3NEOQM0I91MV6VAZ84CRBF8NIAS,A man is being treated at Tallaght hospital after he drove himself to a prison for help after he was injured in the attack.,15,22,treated,1,0,1
3BO3NEOQM0I91MV6VAZ84CRBF8NIAS,A man is being treated at Tallaght hospital after he drove himself to a prison for help after he was injured in the attack.,101,108,injured,1,4,5
3BO3NEOQM0I91MV6VAZ84CRBF8NIAS,A man is being treated at Tallaght hospital after he drove himself to a prison for help after he was injured in the attack.,116,122,attack,1,0,1
3BO3NEOQM0I91MV6VAZ84CRBF8NIAS,"The victim, a 32-year-old, was hit in the side of his body as he sat in a car outside Finnegan’s pub.",4,10,victim,0,4,4
3BO3NEOQM0I91MV6VAZ84CRBF8NIAS,"The victim, a 32-year-old, was hit in the side of his body as he sat in a car outside Finnegan’s pub.",65,68,sat,0,1,1
3BO3NEOQM0I91MV6VAZ84CRBF8NIAS,"The victim, a 32-year-old, was hit in the side of his body as he sat in a car outside Finnegan’s pub.",86,100,Finnegan’s pub,0,1,1
3BO3NEOQM0I91MV6VAZ84CRBF8NIAS,"The victim, a 32-year-old, was hit in the side of his body as he sat in a car outside Finnegan’s pub.",97,100,pub,3,1,4
3BO3NEOQM0I91MV6VAZ84CRBF8NIAS,"He drove himself to nearby Cloverhill Prison, where he called for help.",3,8,drove,0,1,1
3BO3NEOQM0I91MV6VAZ84CRBF8NIAS,"He drove himself to nearby Cloverhill Prison, where he called for help.",20,26,nearby,1,0,1
3BO3NEOQM0I91MV6VAZ84CRBF8NIAS,"He drove himself to nearby Cloverhill Prison, where he called for help.",55,65,called for,0,1,1
3BO3NEOQM0I91MV6VAZ84CRBF8NIAS,His injuries are said to be non-life-threatening.,4,12,injuries,0,3,3
3BO3NEOQM0I91MV6VAZ84CRBF8NIAS,His injuries are said to be non-life-threatening.,28,48,non-life-threatening,10,10,20
3BO3NEOQM0I91MV6VAZ84CRBF8NIAS,"The gunman fled in a silver saloon car that was later found burnt out at Golden Bridge Terrace, Inchicore.",4,10,gunman,0,1,1
3BO3NEOQM0I91MV6VAZ84CRBF8NIAS,"The gunman fled in a silver saloon car that was later found burnt out at Golden Bridge Terrace, Inchicore.",4,15,gunman fled,0,1,1
3BO3NEOQM0I91MV6VAZ84CRBF8NIAS,"The gunman fled in a silver saloon car that was later found burnt out at Golden Bridge Terrace, Inchicore.",11,15,fled,1,5,6
3BO3NEOQM0I91MV6VAZ84CRBF8NIAS,"The gunman fled in a silver saloon car that was later found burnt out at Golden Bridge Terrace, Inchicore.",21,34,silver saloon,1,0,1
3BO3NEOQM0I91MV6VAZ84CRBF8NIAS,"The gunman fled in a silver saloon car that was later found burnt out at Golden Bridge Terrace, Inchicore.",21,38,silver saloon car,0,1,1
3BO3NEOQM0I91MV6VAZ84CRBF8NIAS,"The gunman fled in a silver saloon car that was later found burnt out at Golden Bridge Terrace, Inchicore.",28,34,saloon,5,1,6
3BO3NEOQM0I91MV6VAZ84CRBF8NIAS,"The gunman fled in a silver saloon car that was later found burnt out at Golden Bridge Terrace, Inchicore.",28,38,saloon car,4,0,4
3BO3NEOQM0I91MV6VAZ84CRBF8NIAS,"The gunman fled in a silver saloon car that was later found burnt out at Golden Bridge Terrace, Inchicore.",60,65,burnt,2,2,4
3BO3NEOQM0I91MV6VAZ84CRBF8NIAS,"The gunman fled in a silver saloon car that was later found burnt out at Golden Bridge Terrace, Inchicore.",60,69,burnt out,2,4,6
3UY4PIS8QRM5LZTXW7J7YJUPXDBN1P,"As a SWAT team arrived, officers heard gunshots inside.",5,9,SWAT,2,1,3
3UY4PIS8QRM5LZTXW7J7YJUPXDBN1P,"As a SWAT team arrived, officers heard gunshots inside.",5,14,SWAT team,4,2,6
3UY4PIS8QRM5LZTXW7J7YJUPXDBN1P,"As a SWAT team arrived, officers heard gunshots inside.",15,22,arrived,0,1,1
3UY4PIS8QRM5LZTXW7J7YJUPXDBN1P,"As a SWAT team arrived, officers heard gunshots inside.",33,38,heard,1,1,2
3UY4PIS8QRM5LZTXW7J7YJUPXDBN1P,"As a SWAT team arrived, officers heard gunshots inside.",39,47,gunshots,0,3,3
3UY4PIS8QRM5LZTXW7J7YJUPXDBN1P,"SWAT officers entered through a back sliding door just before 7 a.m., and found Thomas and three other children dead.",0,4,SWAT,1,1,2
3UY4PIS8QRM5LZTXW7J7YJUPXDBN1P,"SWAT officers entered through a back sliding door just before 7 a.m., and found Thomas and three other children dead.",0,13,SWAT officers,1,0,1
3UY4PIS8QRM5LZTXW7J7YJUPXDBN1P,"SWAT officers entered through a back sliding door just before 7 a.m., and found Thomas and three other children dead.",14,21,entered,0,1,1
3UY4PIS8QRM5LZTXW7J7YJUPXDBN1P,"SWAT officers entered through a back sliding door just before 7 a.m., and found Thomas and three other children dead.",32,49,back sliding door,1,1,2
3UY4PIS8QRM5LZTXW7J7YJUPXDBN1P,"SWAT officers entered through a back sliding door just before 7 a.m., and found Thomas and three other children dead.",37,44,sliding,1,1,2
3UY4PIS8QRM5LZTXW7J7YJUPXDBN1P,"SWAT officers entered through a back sliding door just before 7 a.m., and found Thomas and three other children dead.",37,49,sliding door,0,1,1
3UY4PIS8QRM5LZTXW7J7YJUPXDBN1P,"They were identified as Joel Johnson, 12, Jazlin Johnson, 13, and Jaxs Johnson, 15.",10,20,identified,4,4,8
3UY4PIS8QRM5LZTXW7J7YJUPXDBN1P,"Goodyear said the children's father, who was separated from the family, had been notified of the deaths.",45,54,separated,8,3,11
3UY4PIS8QRM5LZTXW7J7YJUPXDBN1P,"Goodyear said the children's father, who was separated from the family, had been notified of the deaths.",81,89,notified,5,6,11
3UY4PIS8QRM5LZTXW7J7YJUPXDBN1P,"Also, a friend of Thomas told police she texted him during the night that she wanted to be cremated with her four children, Goodyear said.",41,47,texted,0,6,6
3UY4PIS8QRM5LZTXW7J7YJUPXDBN1P,"Also, a friend of Thomas told police she texted him during the night that she wanted to be cremated with her four children, Goodyear said.",91,99,cremated,10,10,20
3UY4PIS8QRM5LZTXW7J7YJUPXDBN1P,"However, the friend did not see the text until after he woke up Tuesday morning and the incident was over.",56,60,woke,0,1,1
3UY4PIS8QRM5LZTXW7J7YJUPXDBN1P,"However, the friend did not see the text until after he woke up Tuesday morning and the incident was over.",88,96,incident,10,5,15
3UY4PIS8QRM5LZTXW7J7YJUPXDBN1P,"The friend, who was not identified, called police after seeing news of the deaths, he said.",24,34,identified,4,1,5
3UY4PIS8QRM5LZTXW7J7YJUPXDBN1P,"The friend, who was not identified, called police after seeing news of the deaths, he said.",56,62,seeing,0,1,1
3J9L0X0VDFNDXY56SLPN98PZN0F9WK,"The attack occurred at the gate of a compound known as Green Village, which houses private security guards, some foreign diplomats, U.N. employees and other foreign workers in the city, the ministry spokesman said.",11,19,occurred,1,7,8
3J9L0X0VDFNDXY56SLPN98PZN0F9WK,"The attack occurred at the gate of a compound known as Green Village, which houses private security guards, some foreign diplomats, U.N. employees and other foreign workers in the city, the ministry spokesman said.",37,45,compound,6,7,13
3J9L0X0VDFNDXY56SLPN98PZN0F9WK,"The attack occurred at the gate of a compound known as Green Village, which houses private security guards, some foreign diplomats, U.N. employees and other foreign workers in the city, the ministry spokesman said.",83,106,private security guards,2,0,2
3J9L0X0VDFNDXY56SLPN98PZN0F9WK,"The attack occurred at the gate of a compound known as Green Village, which houses private security guards, some foreign diplomats, U.N. employees and other foreign workers in the city, the ministry spokesman said.",113,130,foreign diplomats,1,0,1
3J9L0X0VDFNDXY56SLPN98PZN0F9WK,"The attack occurred at the gate of a compound known as Green Village, which houses private security guards, some foreign diplomats, U.N. employees and other foreign workers in the city, the ministry spokesman said.",121,130,diplomats,5,3,8
3J9L0X0VDFNDXY56SLPN98PZN0F9WK,"The attack occurred at the gate of a compound known as Green Village, which houses private security guards, some foreign diplomats, U.N. employees and other foreign workers in the city, the ministry spokesman said.",137,146,employees,1,1,2
3J9L0X0VDFNDXY56SLPN98PZN0F9WK,"The attack occurred at the gate of a compound known as Green Village, which houses private security guards, some foreign diplomats, U.N. employees and other foreign workers in the city, the ministry spokesman said.",190,208,ministry spokesman,1,0,1
3J9L0X0VDFNDXY56SLPN98PZN0F9WK,"The attack occurred at the gate of a compound known as Green Village, which houses private security guards, some foreign diplomats, U.N. employees and other foreign workers in the city, the ministry spokesman said.",199,208,spokesman,1,4,5
3J9L0X0VDFNDXY56SLPN98PZN0F9WK,"Residents living near the compound and people inside said they heard several blasts, mortar explosions and gunfire, the Times said.",0,9,Residents,1,1,2
3J9L0X0VDFNDXY56SLPN98PZN0F9WK,"Residents living near the compound and people inside said they heard several blasts, mortar explosions and gunfire, the Times said.",26,34,compound,5,3,8
3J9L0X0VDFNDXY56SLPN98PZN0F9WK,"Residents living near the compound and people inside said they heard several blasts, mortar explosions and gunfire, the Times said.",69,83,several blasts,0,1,1
3J9L0X0VDFNDXY56SLPN98PZN0F9WK,"Residents living near the compound and people inside said they heard several blasts, mortar explosions and gunfire, the Times said.",77,83,blasts,1,2,3
3J9L0X0VDFNDXY56SLPN98PZN0F9WK,"Residents living near the compound and people inside said they heard several blasts, mortar explosions and gunfire, the Times said.",85,91,mortar,5,4,9
3J9L0X0VDFNDXY56SLPN98PZN0F9WK,"Residents living near the compound and people inside said they heard several blasts, mortar explosions and gunfire, the Times said.",85,102,mortar explosions,3,0,3
3J9L0X0VDFNDXY56SLPN98PZN0F9WK,"Residents living near the compound and people inside said they heard several blasts, mortar explosions and gunfire, the Times said.",92,102,explosions,0,3,3
3J9L0X0VDFNDXY56SLPN98PZN0F9WK,"Residents living near the compound and people inside said they heard several blasts, mortar explosions and gunfire, the Times said.",107,114,gunfire,0,1,1
3J9L0X0VDFNDXY56SLPN98PZN0F9WK,"In a telephone interview with the Times, Taliban spokesman Zabiullah Mujahid said, ""As soon as the mujahedin learned about Obama's trip to Kabul we planned to conduct an operation at the heart of the city to send a message to Obama that instead of signing strategic partnerships and instead of imposing a corrupt and unpopular government over the people of Afghanistan, he should think of ways to withdraw his troops from Afghanistan.""",15,24,interview,1,2,3
3J9L0X0VDFNDXY56SLPN98PZN0F9WK,"In a telephone interview with the Times, Taliban spokesman Zabiullah Mujahid said, ""As soon as the mujahedin learned about Obama's trip to Kabul we planned to conduct an operation at the heart of the city to send a message to Obama that instead of signing strategic partnerships and instead of imposing a corrupt and unpopular government over the people of Afghanistan, he should think of ways to withdraw his troops from Afghanistan.""",41,48,Taliban,1,0,1
3J9L0X0VDFNDXY56SLPN98PZN0F9WK,"In a telephone interview with the Times, Taliban spokesman Zabiullah Mujahid said, ""As soon as the mujahedin learned about Obama's trip to Kabul we planned to conduct an operation at the heart of the city to send a message to Obama that instead of signing strategic partnerships and instead of imposing a corrupt and unpopular government over the people of Afghanistan, he should think of ways to withdraw his troops from Afghanistan.""",49,58,spokesman,1,1,2
3J9L0X0VDFNDXY56SLPN98PZN0F9WK,"In a telephone interview with the Times, Taliban spokesman Zabiullah Mujahid said, ""As soon as the mujahedin learned about Obama's trip to Kabul we planned to conduct an operation at the heart of the city to send a message to Obama that instead of signing strategic partnerships and instead of imposing a corrupt and unpopular government over the people of Afghanistan, he should think of ways to withdraw his troops from Afghanistan.""",59,76,Zabiullah Mujahid,1,0,1
3J9L0X0VDFNDXY56SLPN98PZN0F9WK,"In a telephone interview with the Times, Taliban spokesman Zabiullah Mujahid said, ""As soon as the mujahedin learned about Obama's trip to Kabul we planned to conduct an operation at the heart of the city to send a message to Obama that instead of signing strategic partnerships and instead of imposing a corrupt and unpopular government over the people of Afghanistan, he should think of ways to withdraw his troops from Afghanistan.""",99,108,mujahedin,7,4,11
3J9L0X0VDFNDXY56SLPN98PZN0F9WK,"In a telephone interview with the Times, Taliban spokesman Zabiullah Mujahid said, ""As soon as the mujahedin learned about Obama's trip to Kabul we planned to conduct an operation at the heart of the city to send a message to Obama that instead of signing strategic partnerships and instead of imposing a corrupt and unpopular government over the people of Afghanistan, he should think of ways to withdraw his troops from Afghanistan.""",139,144,Kabul,1,0,1
3J9L0X0VDFNDXY56SLPN98PZN0F9WK,"In a telephone interview with the Times, Taliban spokesman Zabiullah Mujahid said, ""As soon as the mujahedin learned about Obama's trip to Kabul we planned to conduct an operation at the heart of the city to send a message to Obama that instead of signing strategic partnerships and instead of imposing a corrupt and unpopular government over the people of Afghanistan, he should think of ways to withdraw his troops from Afghanistan.""",159,166,conduct,3,2,5
3J9L0X0VDFNDXY56SLPN98PZN0F9WK,"In a telephone interview with the Times, Taliban spokesman Zabiullah Mujahid said, ""As soon as the mujahedin learned about Obama's trip to Kabul we planned to conduct an operation at the heart of the city to send a message to Obama that instead of signing strategic partnerships and instead of imposing a corrupt and unpopular government over the people of Afghanistan, he should think of ways to withdraw his troops from Afghanistan.""",159,179,conduct an operation,2,0,2
3J9L0X0VDFNDXY56SLPN98PZN0F9WK,"In a telephone interview with the Times, Taliban spokesman Zabiullah Mujahid said, ""As soon as the mujahedin learned about Obama's trip to Kabul we planned to conduct an operation at the heart of the city to send a message to Obama that instead of signing strategic partnerships and instead of imposing a corrupt and unpopular government over the people of Afghanistan, he should think of ways to withdraw his troops from Afghanistan.""",170,179,operation,1,2,3
3J9L0X0VDFNDXY56SLPN98PZN0F9WK,"In a telephone interview with the Times, Taliban spokesman Zabiullah Mujahid said, ""As soon as the mujahedin learned about Obama's trip to Kabul we planned to conduct an operation at the heart of the city to send a message to Obama that instead of signing strategic partnerships and instead of imposing a corrupt and unpopular government over the people of Afghanistan, he should think of ways to withdraw his troops from Afghanistan.""",187,204,heart of the city,2,0,2
3J9L0X0VDFNDXY56SLPN98PZN0F9WK,"In a telephone interview with the Times, Taliban spokesman Zabiullah Mujahid said, ""As soon as the mujahedin learned about Obama's trip to Kabul we planned to conduct an operation at the heart of the city to send a message to Obama that instead of signing strategic partnerships and instead of imposing a corrupt and unpopular government over the people of Afghanistan, he should think of ways to withdraw his troops from Afghanistan.""",237,244,instead,0,1,1
3J9L0X0VDFNDXY56SLPN98PZN0F9WK,"In a telephone interview with the Times, Taliban spokesman Zabiullah Mujahid said, ""As soon as the mujahedin learned about Obama's trip to Kabul we planned to conduct an operation at the heart of the city to send a message to Obama that instead of signing strategic partnerships and instead of imposing a corrupt and unpopular government over the people of Afghanistan, he should think of ways to withdraw his troops from Afghanistan.""",256,265,strategic,2,4,6
3J9L0X0VDFNDXY56SLPN98PZN0F9WK,"In a telephone interview with the Times, Taliban spokesman Zabiullah Mujahid said, ""As soon as the mujahedin learned about Obama's trip to Kabul we planned to conduct an operation at the heart of the city to send a message to Obama that instead of signing strategic partnerships and instead of imposing a corrupt and unpopular government over the people of Afghanistan, he should think of ways to withdraw his troops from Afghanistan.""",256,278,strategic partnerships,7,4,11
3J9L0X0VDFNDXY56SLPN98PZN0F9WK,"In a telephone interview with the Times, Taliban spokesman Zabiullah Mujahid said, ""As soon as the mujahedin learned about Obama's trip to Kabul we planned to conduct an operation at the heart of the city to send a message to Obama that instead of signing strategic partnerships and instead of imposing a corrupt and unpopular government over the people of Afghanistan, he should think of ways to withdraw his troops from Afghanistan.""",266,278,partnerships,1,0,1
3J9L0X0VDFNDXY56SLPN98PZN0F9WK,"In a telephone interview with the Times, Taliban spokesman Zabiullah Mujahid said, ""As soon as the mujahedin learned about Obama's trip to Kabul we planned to conduct an operation at the heart of the city to send a message to Obama that instead of signing strategic partnerships and instead of imposing a corrupt and unpopular government over the people of Afghanistan, he should think of ways to withdraw his troops from Afghanistan.""",294,302,imposing,9,8,17
3J9L0X0VDFNDXY56SLPN98PZN0F9WK,"In a telephone interview with the Times, Taliban spokesman Zabiullah Mujahid said, ""As soon as the mujahedin learned about Obama's trip to Kabul we planned to conduct an operation at the heart of the city to send a message to Obama that instead of signing strategic partnerships and instead of imposing a corrupt and unpopular government over the people of Afghanistan, he should think of ways to withdraw his troops from Afghanistan.""",305,312,corrupt,4,6,10
3J9L0X0VDFNDXY56SLPN98PZN0F9WK,"In a telephone interview with the Times, Taliban spokesman Zabiullah Mujahid said, ""As soon as the mujahedin learned about Obama's trip to Kabul we planned to conduct an operation at the heart of the city to send a message to Obama that instead of signing strategic partnerships and instead of imposing a corrupt and unpopular government over the people of Afghanistan, he should think of ways to withdraw his troops from Afghanistan.""",305,326,corrupt and unpopular,0,1,1
3J9L0X0VDFNDXY56SLPN98PZN0F9WK,"In a telephone interview with the Times, Taliban spokesman Zabiullah Mujahid said, ""As soon as the mujahedin learned about Obama's trip to Kabul we planned to conduct an operation at the heart of the city to send a message to Obama that instead of signing strategic partnerships and instead of imposing a corrupt and unpopular government over the people of Afghanistan, he should think of ways to withdraw his troops from Afghanistan.""",317,326,unpopular,0,2,2
3J9L0X0VDFNDXY56SLPN98PZN0F9WK,"In a telephone interview with the Times, Taliban spokesman Zabiullah Mujahid said, ""As soon as the mujahedin learned about Obama's trip to Kabul we planned to conduct an operation at the heart of the city to send a message to Obama that instead of signing strategic partnerships and instead of imposing a corrupt and unpopular government over the people of Afghanistan, he should think of ways to withdraw his troops from Afghanistan.""",317,337,unpopular government,1,0,1
3J9L0X0VDFNDXY56SLPN98PZN0F9WK,"In a telephone interview with the Times, Taliban spokesman Zabiullah Mujahid said, ""As soon as the mujahedin learned about Obama's trip to Kabul we planned to conduct an operation at the heart of the city to send a message to Obama that instead of signing strategic partnerships and instead of imposing a corrupt and unpopular government over the people of Afghanistan, he should think of ways to withdraw his troops from Afghanistan.""",327,337,government,0,1,1
3J9L0X0VDFNDXY56SLPN98PZN0F9WK,"In a telephone interview with the Times, Taliban spokesman Zabiullah Mujahid said, ""As soon as the mujahedin learned about Obama's trip to Kabul we planned to conduct an operation at the heart of the city to send a message to Obama that instead of signing strategic partnerships and instead of imposing a corrupt and unpopular government over the people of Afghanistan, he should think of ways to withdraw his troops from Afghanistan.""",397,405,withdraw,2,5,7
3VADEH0UHCY5I444P5BJY9MTMFMSPG,"The government may also disclose details on its nationalisation this week of Bankia, the Spanish bank with the highest exposure to bad property loans following a crash in the construction sector that started in 2008.",4,14,government,2,1,3
3VADEH0UHCY5I444P5BJY9MTMFMSPG,"The government may also disclose details on its nationalisation this week of Bankia, the Spanish bank with the highest exposure to bad property loans following a crash in the construction sector that started in 2008.",24,32,disclose,8,3,11
3VADEH0UHCY5I444P5BJY9MTMFMSPG,"The government may also disclose details on its nationalisation this week of Bankia, the Spanish bank with the highest exposure to bad property loans following a crash in the construction sector that started in 2008.",24,40,disclose details,0,1,1
3VADEH0UHCY5I444P5BJY9MTMFMSPG,"The government may also disclose details on its nationalisation this week of Bankia, the Spanish bank with the highest exposure to bad property loans following a crash in the construction sector that started in 2008.",48,63,nationalisation,10,6,16
3VADEH0UHCY5I444P5BJY9MTMFMSPG,"The government may also disclose details on its nationalisation this week of Bankia, the Spanish bank with the highest exposure to bad property loans following a crash in the construction sector that started in 2008.",119,127,exposure,7,5,12
3VADEH0UHCY5I444P5BJY9MTMFMSPG,"The government may also disclose details on its nationalisation this week of Bankia, the Spanish bank with the highest exposure to bad property loans following a crash in the construction sector that started in 2008.",131,149,bad property loans,0,2,2
3VADEH0UHCY5I444P5BJY9MTMFMSPG,"The government may also disclose details on its nationalisation this week of Bankia, the Spanish bank with the highest exposure to bad property loans following a crash in the construction sector that started in 2008.",144,149,loans,0,1,1
3VADEH0UHCY5I444P5BJY9MTMFMSPG,"The government may also disclose details on its nationalisation this week of Bankia, the Spanish bank with the highest exposure to bad property loans following a crash in the construction sector that started in 2008.",162,167,crash,2,1,3
3VADEH0UHCY5I444P5BJY9MTMFMSPG,"The government may also disclose details on its nationalisation this week of Bankia, the Spanish bank with the highest exposure to bad property loans following a crash in the construction sector that started in 2008.",175,187,construction,2,1,3
3VADEH0UHCY5I444P5BJY9MTMFMSPG,"The government may also disclose details on its nationalisation this week of Bankia, the Spanish bank with the highest exposure to bad property loans following a crash in the construction sector that started in 2008.",175,194,construction sector,4,0,4
3VADEH0UHCY5I444P5BJY9MTMFMSPG,"The government may also disclose details on its nationalisation this week of Bankia, the Spanish bank with the highest exposure to bad property loans following a crash in the construction sector that started in 2008.",188,194,sector,3,0,3
3VADEH0UHCY5I444P5BJY9MTMFMSPG,Spain is in its second recession in three years and is battling to reduce a swollen deficit and 24.4% unemployment.,16,32,second recession,1,0,1
3VADEH0UHCY5I444P5BJY9MTMFMSPG,Spain is in its second recession in three years and is battling to reduce a swollen deficit and 24.4% unemployment.,23,32,recession,10,10,20
3VADEH0UHCY5I444P5BJY9MTMFMSPG,Spain is in its second recession in three years and is battling to reduce a swollen deficit and 24.4% unemployment.,55,63,battling,1,3,4
3VADEH0UHCY5I444P5BJY9MTMFMSPG,Spain is in its second recession in three years and is battling to reduce a swollen deficit and 24.4% unemployment.,76,83,swollen,1,6,7
3VADEH0UHCY5I444P5BJY9MTMFMSPG,Spain is in its second recession in three years and is battling to reduce a swollen deficit and 24.4% unemployment.,76,91,swollen deficit,9,5,14
3VADEH0UHCY5I444P5BJY9MTMFMSPG,Spain is in its second recession in three years and is battling to reduce a swollen deficit and 24.4% unemployment.,84,91,deficit,5,4,9
3VADEH0UHCY5I444P5BJY9MTMFMSPG,Spain is in its second recession in three years and is battling to reduce a swollen deficit and 24.4% unemployment.,102,114,unemployment,2,1,3
3VADEH0UHCY5I444P5BJY9MTMFMSPG,"Spanish bank stocks tumbled Friday as the government readied drastic reforms to save their balance sheets, two days after nationalising the fourth-biggest bank, Bankia.",13,27,stocks tumbled,0,1,1
3VADEH0UHCY5I444P5BJY9MTMFMSPG,"Spanish bank stocks tumbled Friday as the government readied drastic reforms to save their balance sheets, two days after nationalising the fourth-biggest bank, Bankia.",20,27,tumbled,3,10,13
3VADEH0UHCY5I444P5BJY9MTMFMSPG,"Spanish bank stocks tumbled Friday as the government readied drastic reforms to save their balance sheets, two days after nationalising the fourth-biggest bank, Bankia.",42,52,government,2,0,2
3VADEH0UHCY5I444P5BJY9MTMFMSPG,"Spanish bank stocks tumbled Friday as the government readied drastic reforms to save their balance sheets, two days after nationalising the fourth-biggest bank, Bankia.",53,60,readied,2,4,6
3VADEH0UHCY5I444P5BJY9MTMFMSPG,"Spanish bank stocks tumbled Friday as the government readied drastic reforms to save their balance sheets, two days after nationalising the fourth-biggest bank, Bankia.",53,76,readied drastic reforms,1,0,1
3VADEH0UHCY5I444P5BJY9MTMFMSPG,"Spanish bank stocks tumbled Friday as the government readied drastic reforms to save their balance sheets, two days after nationalising the fourth-biggest bank, Bankia.",61,68,drastic,4,4,8
3VADEH0UHCY5I444P5BJY9MTMFMSPG,"Spanish bank stocks tumbled Friday as the government readied drastic reforms to save their balance sheets, two days after nationalising the fourth-biggest bank, Bankia.",61,76,drastic reforms,4,3,7
3VADEH0UHCY5I444P5BJY9MTMFMSPG,"Spanish bank stocks tumbled Friday as the government readied drastic reforms to save their balance sheets, two days after nationalising the fourth-biggest bank, Bankia.",69,76,reforms,0,1,1
3VADEH0UHCY5I444P5BJY9MTMFMSPG,"Spanish bank stocks tumbled Friday as the government readied drastic reforms to save their balance sheets, two days after nationalising the fourth-biggest bank, Bankia.",80,105,save their balance sheets,0,1,1
3VADEH0UHCY5I444P5BJY9MTMFMSPG,"Spanish bank stocks tumbled Friday as the government readied drastic reforms to save their balance sheets, two days after nationalising the fourth-biggest bank, Bankia.",91,105,balance sheets,4,1,5
3VADEH0UHCY5I444P5BJY9MTMFMSPG,"Spanish bank stocks tumbled Friday as the government readied drastic reforms to save their balance sheets, two days after nationalising the fourth-biggest bank, Bankia.",99,105,sheets,0,1,1
3VADEH0UHCY5I444P5BJY9MTMFMSPG,"Spanish bank stocks tumbled Friday as the government readied drastic reforms to save their balance sheets, two days after nationalising the fourth-biggest bank, Bankia.",122,135,nationalising,9,1,10
3VADEH0UHCY5I444P5BJY9MTMFMSPG,"Prime Minister Mariano Rajoy met with his ministers to adopt the broad reforms, expected to bring to light the financial sector's massive exposure to the collapsed property sector.",23,28,Rajoy,1,0,1
3VADEH0UHCY5I444P5BJY9MTMFMSPG,"Prime Minister Mariano Rajoy met with his ministers to adopt the broad reforms, expected to bring to light the financial sector's massive exposure to the collapsed property sector.",55,60,adopt,1,0,1
3VADEH0UHCY5I444P5BJY9MTMFMSPG,"Prime Minister Mariano Rajoy met with his ministers to adopt the broad reforms, expected to bring to light the financial sector's massive exposure to the collapsed property sector.",65,70,broad,0,3,3
3VADEH0UHCY5I444P5BJY9MTMFMSPG,"Prime Minister Mariano Rajoy met with his ministers to adopt the broad reforms, expected to bring to light the financial sector's massive exposure to the collapsed property sector.",65,78,broad reforms,5,2,7
3VADEH0UHCY5I444P5BJY9MTMFMSPG,"Prime Minister Mariano Rajoy met with his ministers to adopt the broad reforms, expected to bring to light the financial sector's massive exposure to the collapsed property sector.",71,78,reforms,2,0,2
3VADEH0UHCY5I444P5BJY9MTMFMSPG,"Prime Minister Mariano Rajoy met with his ministers to adopt the broad reforms, expected to bring to light the financial sector's massive exposure to the collapsed property sector.",92,106,bring to light,1,0,1
3VADEH0UHCY5I444P5BJY9MTMFMSPG,"Prime Minister Mariano Rajoy met with his ministers to adopt the broad reforms, expected to bring to light the financial sector's massive exposure to the collapsed property sector.",111,128,financial sectors,1,0,1
3VADEH0UHCY5I444P5BJY9MTMFMSPG,"Prime Minister Mariano Rajoy met with his ministers to adopt the broad reforms, expected to bring to light the financial sector's massive exposure to the collapsed property sector.",121,128,sectors,1,0,1
3VADEH0UHCY5I444P5BJY9MTMFMSPG,"Prime Minister Mariano Rajoy met with his ministers to adopt the broad reforms, expected to bring to light the financial sector's massive exposure to the collapsed property sector.",130,137,massive,1,1,2
3VADEH0UHCY5I444P5BJY9MTMFMSPG,"Prime Minister Mariano Rajoy met with his ministers to adopt the broad reforms, expected to bring to light the financial sector's massive exposure to the collapsed property sector.",130,146,massive exposure,0,1,1
3VADEH0UHCY5I444P5BJY9MTMFMSPG,"Prime Minister Mariano Rajoy met with his ministers to adopt the broad reforms, expected to bring to light the financial sector's massive exposure to the collapsed property sector.",138,146,exposure,1,0,1
3VADEH0UHCY5I444P5BJY9MTMFMSPG,"Prime Minister Mariano Rajoy met with his ministers to adopt the broad reforms, expected to bring to light the financial sector's massive exposure to the collapsed property sector.",154,163,collapsed,0,9,9
3VADEH0UHCY5I444P5BJY9MTMFMSPG,"Prime Minister Mariano Rajoy met with his ministers to adopt the broad reforms, expected to bring to light the financial sector's massive exposure to the collapsed property sector.",154,179,collapsed property sector,3,0,3
3VADEH0UHCY5I444P5BJY9MTMFMSPG,"Prime Minister Mariano Rajoy met with his ministers to adopt the broad reforms, expected to bring to light the financial sector's massive exposure to the collapsed property sector.",164,172,property,0,1,1
3VADEH0UHCY5I444P5BJY9MTMFMSPG,"Market doubts about the full extent of the losses on bad loans in Spain's banks, which overextended themselves during a property boom that went bust in 2008, hurt the shares of even the strongest banks.",0,13,Market doubts,1,0,1
3VADEH0UHCY5I444P5BJY9MTMFMSPG,"Market doubts about the full extent of the losses on bad loans in Spain's banks, which overextended themselves during a property boom that went bust in 2008, hurt the shares of even the strongest banks.",87,99,overextended,8,5,13
3VADEH0UHCY5I444P5BJY9MTMFMSPG,"Market doubts about the full extent of the losses on bad loans in Spain's banks, which overextended themselves during a property boom that went bust in 2008, hurt the shares of even the strongest banks.",120,133,property boom,4,0,4
3VADEH0UHCY5I444P5BJY9MTMFMSPG,"Market doubts about the full extent of the losses on bad loans in Spain's banks, which overextended themselves during a property boom that went bust in 2008, hurt the shares of even the strongest banks.",129,133,boom,0,3,3
3VADEH0UHCY5I444P5BJY9MTMFMSPG,"Market doubts about the full extent of the losses on bad loans in Spain's banks, which overextended themselves during a property boom that went bust in 2008, hurt the shares of even the strongest banks.",144,148,bust,0,1,1
3421H3BM9AIRRE57LM68KIVRM5U9JG,A neighbor heard shots at 4:50 a.m. and then responded to a knock at the door to find three of the children.,2,10,neighbor,0,2,2
3421H3BM9AIRRE57LM68KIVRM5U9JG,A neighbor heard shots at 4:50 a.m. and then responded to a knock at the door to find three of the children.,11,16,heard,0,1,1
3421H3BM9AIRRE57LM68KIVRM5U9JG,A neighbor heard shots at 4:50 a.m. and then responded to a knock at the door to find three of the children.,45,54,responded,5,7,12
3421H3BM9AIRRE57LM68KIVRM5U9JG,A neighbor heard shots at 4:50 a.m. and then responded to a knock at the door to find three of the children.,45,65,responded to a knock,0,1,1
3421H3BM9AIRRE57LM68KIVRM5U9JG,A neighbor heard shots at 4:50 a.m. and then responded to a knock at the door to find three of the children.,60,65,knock,0,1,1
3421H3BM9AIRRE57LM68KIVRM5U9JG,A neighbor heard shots at 4:50 a.m. and then responded to a knock at the door to find three of the children.,60,77,knock at the door,1,0,1
3421H3BM9AIRRE57LM68KIVRM5U9JG,"The mother, Tanya Thomas, 33, called them back home, Brevard County Sheriff's Office Lt. Tod Goodyear told reporters.",68,83,Sheriffs Office,1,0,1
3421H3BM9AIRRE57LM68KIVRM5U9JG,"The mother, Tanya Thomas, 33, called them back home, Brevard County Sheriff's Office Lt. Tod Goodyear told reporters.",107,116,reporters,0,1,1
3421H3BM9AIRRE57LM68KIVRM5U9JG,Deputies arrived at the house several minutes later to hear more shots fired.,0,8,Deputies,7,4,11
3421H3BM9AIRRE57LM68KIVRM5U9JG,Deputies arrived at the house several minutes later to hear more shots fired.,9,16,arrived,0,2,2
3421H3BM9AIRRE57LM68KIVRM5U9JG,Deputies arrived at the house several minutes later to hear more shots fired.,30,45,several minutes,1,0,1
3421H3BM9AIRRE57LM68KIVRM5U9JG,"They discovered Thomas's eldest daughter, Pebbles Johnson, 17, wounded in the front yard.",5,15,discovered,4,2,6
3421H3BM9AIRRE57LM68KIVRM5U9JG,"They discovered Thomas's eldest daughter, Pebbles Johnson, 17, wounded in the front yard.",25,31,eldest,1,1,2
3421H3BM9AIRRE57LM68KIVRM5U9JG,"They discovered Thomas's eldest daughter, Pebbles Johnson, 17, wounded in the front yard.",42,49,Pebbles,0,1,1
3421H3BM9AIRRE57LM68KIVRM5U9JG,"They discovered Thomas's eldest daughter, Pebbles Johnson, 17, wounded in the front yard.",63,70,wounded,4,3,7
3421H3BM9AIRRE57LM68KIVRM5U9JG,"They discovered Thomas's eldest daughter, Pebbles Johnson, 17, wounded in the front yard.",78,88,front yard,0,1,1
3421H3BM9AIRRE57LM68KIVRM5U9JG,They drove a patrol car onto the lawn in an attempt to rescue her.,13,19,patrol,2,2,4
3421H3BM9AIRRE57LM68KIVRM5U9JG,They drove a patrol car onto the lawn in an attempt to rescue her.,13,23,patrol car,2,0,2
3421H3BM9AIRRE57LM68KIVRM5U9JG,They drove a patrol car onto the lawn in an attempt to rescue her.,33,37,lawn,0,3,3
3421H3BM9AIRRE57LM68KIVRM5U9JG,They drove a patrol car onto the lawn in an attempt to rescue her.,44,51,attempt,3,2,5
3421H3BM9AIRRE57LM68KIVRM5U9JG,They drove a patrol car onto the lawn in an attempt to rescue her.,55,61,rescue,1,7,8
3421H3BM9AIRRE57LM68KIVRM5U9JG,"Johnson was rushed to hospital but died from her wounds, Goodyear said.",12,18,rushed,0,4,4
3421H3BM9AIRRE57LM68KIVRM5U9JG,"Johnson was rushed to hospital but died from her wounds, Goodyear said.",49,55,wounds,3,2,5
3421H3BM9AIRRE57LM68KIVRM5U9JG,"No suicide note was found in the home, but Goodyear said a witness told police he received a text from Thomas at about 3 a.m. that said she wanted to be cremated with the children.",3,10,suicide,9,4,13
3421H3BM9AIRRE57LM68KIVRM5U9JG,"No suicide note was found in the home, but Goodyear said a witness told police he received a text from Thomas at about 3 a.m. that said she wanted to be cremated with the children.",3,15,suicide note,2,3,5
3421H3BM9AIRRE57LM68KIVRM5U9JG,"No suicide note was found in the home, but Goodyear said a witness told police he received a text from Thomas at about 3 a.m. that said she wanted to be cremated with the children.",59,66,witness,2,5,7
3421H3BM9AIRRE57LM68KIVRM5U9JG,"No suicide note was found in the home, but Goodyear said a witness told police he received a text from Thomas at about 3 a.m. that said she wanted to be cremated with the children.",82,90,received,0,1,1
3421H3BM9AIRRE57LM68KIVRM5U9JG,"No suicide note was found in the home, but Goodyear said a witness told police he received a text from Thomas at about 3 a.m. that said she wanted to be cremated with the children.",93,97,text,0,1,1
3421H3BM9AIRRE57LM68KIVRM5U9JG,"No suicide note was found in the home, but Goodyear said a witness told police he received a text from Thomas at about 3 a.m. that said she wanted to be cremated with the children.",153,161,cremated,10,10,20
3IZPORCT1FA14863R339ZQF6FZWHR6,"Russian authorities should annul the parliamentary vote results and hold a new election, ex-Soviet leader Mikhail Gorbachev urged Wednesday as popular indignation grew over widespread reports of alleged election fraud.",0,7,Russian,0,1,1
3IZPORCT1FA14863R339ZQF6FZWHR6,"Russian authorities should annul the parliamentary vote results and hold a new election, ex-Soviet leader Mikhail Gorbachev urged Wednesday as popular indignation grew over widespread reports of alleged election fraud.",8,19,authorities,4,3,7
3IZPORCT1FA14863R339ZQF6FZWHR6,"Russian authorities should annul the parliamentary vote results and hold a new election, ex-Soviet leader Mikhail Gorbachev urged Wednesday as popular indignation grew over widespread reports of alleged election fraud.",8,36,authorities should annul the,1,0,1
3IZPORCT1FA14863R339ZQF6FZWHR6,"Russian authorities should annul the parliamentary vote results and hold a new election, ex-Soviet leader Mikhail Gorbachev urged Wednesday as popular indignation grew over widespread reports of alleged election fraud.",27,32,annul,9,7,16
3IZPORCT1FA14863R339ZQF6FZWHR6,"Russian authorities should annul the parliamentary vote results and hold a new election, ex-Soviet leader Mikhail Gorbachev urged Wednesday as popular indignation grew over widespread reports of alleged election fraud.",37,50,parliamentary,9,3,12
3IZPORCT1FA14863R339ZQF6FZWHR6,"Russian authorities should annul the parliamentary vote results and hold a new election, ex-Soviet leader Mikhail Gorbachev urged Wednesday as popular indignation grew over widespread reports of alleged election fraud.",89,98,ex-Soviet,0,1,1
3IZPORCT1FA14863R339ZQF6FZWHR6,"Russian authorities should annul the parliamentary vote results and hold a new election, ex-Soviet leader Mikhail Gorbachev urged Wednesday as popular indignation grew over widespread reports of alleged election fraud.",106,113,Mikhail,0,1,1
3IZPORCT1FA14863R339ZQF6FZWHR6,"Russian authorities should annul the parliamentary vote results and hold a new election, ex-Soviet leader Mikhail Gorbachev urged Wednesday as popular indignation grew over widespread reports of alleged election fraud.",114,123,Gorbachev,0,1,1
3IZPORCT1FA14863R339ZQF6FZWHR6,"Russian authorities should annul the parliamentary vote results and hold a new election, ex-Soviet leader Mikhail Gorbachev urged Wednesday as popular indignation grew over widespread reports of alleged election fraud.",124,129,urged,0,6,6
3IZPORCT1FA14863R339ZQF6FZWHR6,"Russian authorities should annul the parliamentary vote results and hold a new election, ex-Soviet leader Mikhail Gorbachev urged Wednesday as popular indignation grew over widespread reports of alleged election fraud.",130,139,Wednesday,0,1,1
3IZPORCT1FA14863R339ZQF6FZWHR6,"Russian authorities should annul the parliamentary vote results and hold a new election, ex-Soviet leader Mikhail Gorbachev urged Wednesday as popular indignation grew over widespread reports of alleged election fraud.",143,162,popular indignation,2,0,2
3IZPORCT1FA14863R339ZQF6FZWHR6,"Russian authorities should annul the parliamentary vote results and hold a new election, ex-Soviet leader Mikhail Gorbachev urged Wednesday as popular indignation grew over widespread reports of alleged election fraud.",151,162,indignation,10,10,20
3IZPORCT1FA14863R339ZQF6FZWHR6,"Russian authorities should annul the parliamentary vote results and hold a new election, ex-Soviet leader Mikhail Gorbachev urged Wednesday as popular indignation grew over widespread reports of alleged election fraud.",173,183,widespread,2,3,5
3IZPORCT1FA14863R339ZQF6FZWHR6,"Russian authorities should annul the parliamentary vote results and hold a new election, ex-Soviet leader Mikhail Gorbachev urged Wednesday as popular indignation grew over widespread reports of alleged election fraud.",195,202,alleged,5,8,13
3IZPORCT1FA14863R339ZQF6FZWHR6,"Russian authorities should annul the parliamentary vote results and hold a new election, ex-Soviet leader Mikhail Gorbachev urged Wednesday as popular indignation grew over widespread reports of alleged election fraud.",195,217,alleged election fraud,2,0,2
3IZPORCT1FA14863R339ZQF6FZWHR6,"Russian authorities should annul the parliamentary vote results and hold a new election, ex-Soviet leader Mikhail Gorbachev urged Wednesday as popular indignation grew over widespread reports of alleged election fraud.",203,217,election fraud,1,0,1
3IZPORCT1FA14863R339ZQF6FZWHR6,"Russian authorities should annul the parliamentary vote results and hold a new election, ex-Soviet leader Mikhail Gorbachev urged Wednesday as popular indignation grew over widespread reports of alleged election fraud.",212,217,fraud,0,2,2
3IZPORCT1FA14863R339ZQF6FZWHR6,"Thousands of Russians have rallied in Moscow and St. Petersburg in the last two days, facing off against tens of thousands of police and Interior Ministry troops.",0,9,Thousands,0,1,1
3IZPORCT1FA14863R339ZQF6FZWHR6,"Thousands of Russians have rallied in Moscow and St. Petersburg in the last two days, facing off against tens of thousands of police and Interior Ministry troops.",27,34,rallied,2,5,7
3IZPORCT1FA14863R339ZQF6FZWHR6,"Thousands of Russians have rallied in Moscow and St. Petersburg in the last two days, facing off against tens of thousands of police and Interior Ministry troops.",86,96,facing off,1,0,1
3IZPORCT1FA14863R339ZQF6FZWHR6,"Thousands of Russians have rallied in Moscow and St. Petersburg in the last two days, facing off against tens of thousands of police and Interior Ministry troops.",137,154,Interior Ministry,0,1,1
3IZPORCT1FA14863R339ZQF6FZWHR6,"Thousands of Russians have rallied in Moscow and St. Petersburg in the last two days, facing off against tens of thousands of police and Interior Ministry troops.",137,161,Interior Ministry troops,1,1,2
3IZPORCT1FA14863R339ZQF6FZWHR6,Hundreds of protesters have been detained in both cities.,12,22,protesters,3,3,6
3IZPORCT1FA14863R339ZQF6FZWHR6,Hundreds of protesters have been detained in both cities.,23,41,have been detained,1,0,1
3IZPORCT1FA14863R339ZQF6FZWHR6,Hundreds of protesters have been detained in both cities.,33,41,detained,8,8,16
3IZPORCT1FA14863R339ZQF6FZWHR6,Gorbachev told the Interfax news agency that authorities must hold a fresh election or deal with a rising tide of discontent.,84,124,or deal with a rising tide of discontent,1,0,1
3IZPORCT1FA14863R339ZQF6FZWHR6,Gorbachev told the Interfax news agency that authorities must hold a fresh election or deal with a rising tide of discontent.,99,110,rising tide,3,1,4
3IZPORCT1FA14863R339ZQF6FZWHR6,Gorbachev told the Interfax news agency that authorities must hold a fresh election or deal with a rising tide of discontent.,99,124,rising tide of discontent,0,1,1
3IZPORCT1FA14863R339ZQF6FZWHR6,Gorbachev told the Interfax news agency that authorities must hold a fresh election or deal with a rising tide of discontent.,106,110,tide,0,2,2
3IZPORCT1FA14863R339ZQF6FZWHR6,Gorbachev told the Interfax news agency that authorities must hold a fresh election or deal with a rising tide of discontent.,106,124,tide of discontent,1,2,3
3IZPORCT1FA14863R339ZQF6FZWHR6,Gorbachev told the Interfax news agency that authorities must hold a fresh election or deal with a rising tide of discontent.,114,124,discontent,10,5,15
3IZPORCT1FA14863R339ZQF6FZWHR6,"Prime Minister Vladimir Putin's United Russia party won less than 50 percent of Sunday's vote, a steep fall from its earlier two-thirds majority, according to preliminary results.",15,23,Vladimir,0,1,1
3IZPORCT1FA14863R339ZQF6FZWHR6,"Prime Minister Vladimir Putin's United Russia party won less than 50 percent of Sunday's vote, a steep fall from its earlier two-thirds majority, according to preliminary results.",32,51,United Russia party,1,0,1
3IZPORCT1FA14863R339ZQF6FZWHR6,"Prime Minister Vladimir Putin's United Russia party won less than 50 percent of Sunday's vote, a steep fall from its earlier two-thirds majority, according to preliminary results.",97,102,steep,2,3,5
3IZPORCT1FA14863R339ZQF6FZWHR6,"Prime Minister Vladimir Putin's United Russia party won less than 50 percent of Sunday's vote, a steep fall from its earlier two-thirds majority, according to preliminary results.",136,144,majority,1,1,2
3IZPORCT1FA14863R339ZQF6FZWHR6,"Prime Minister Vladimir Putin's United Russia party won less than 50 percent of Sunday's vote, a steep fall from its earlier two-thirds majority, according to preliminary results.",159,170,preliminary,8,0,8
3IZPORCT1FA14863R339ZQF6FZWHR6,"Prime Minister Vladimir Putin's United Russia party won less than 50 percent of Sunday's vote, a steep fall from its earlier two-thirds majority, according to preliminary results.",159,178,preliminary results,2,2,4
3IZPORCT1FA14863R339ZQF6FZWHR6,"But opposition parties and international observers said the vote was marred by vote-rigging, including alleged ballot-box stuffing and false voter rolls.",4,14,opposition,3,1,4
3IZPORCT1FA14863R339ZQF6FZWHR6,"But opposition parties and international observers said the vote was marred by vote-rigging, including alleged ballot-box stuffing and false voter rolls.",4,22,opposition parties,1,0,1
3IZPORCT1FA14863R339ZQF6FZWHR6,"But opposition parties and international observers said the vote was marred by vote-rigging, including alleged ballot-box stuffing and false voter rolls.",27,40,international,2,0,2
3IZPORCT1FA14863R339ZQF6FZWHR6,"But opposition parties and international observers said the vote was marred by vote-rigging, including alleged ballot-box stuffing and false voter rolls.",27,50,international observers,1,0,1
3IZPORCT1FA14863R339ZQF6FZWHR6,"But opposition parties and international observers said the vote was marred by vote-rigging, including alleged ballot-box stuffing and false voter rolls.",41,50,observers,0,2,2
3IZPORCT1FA14863R339ZQF6FZWHR6,"But opposition parties and international observers said the vote was marred by vote-rigging, including alleged ballot-box stuffing and false voter rolls.",69,75,marred,4,9,13
3IZPORCT1FA14863R339ZQF6FZWHR6,"But opposition parties and international observers said the vote was marred by vote-rigging, including alleged ballot-box stuffing and false voter rolls.",79,91,vote-rigging,8,9,17
3IZPORCT1FA14863R339ZQF6FZWHR6,"But opposition parties and international observers said the vote was marred by vote-rigging, including alleged ballot-box stuffing and false voter rolls.",103,110,alleged,1,2,3
3IZPORCT1FA14863R339ZQF6FZWHR6,"But opposition parties and international observers said the vote was marred by vote-rigging, including alleged ballot-box stuffing and false voter rolls.",103,130,alleged ballot-box stuffing,0,1,1
3IZPORCT1FA14863R339ZQF6FZWHR6,"But opposition parties and international observers said the vote was marred by vote-rigging, including alleged ballot-box stuffing and false voter rolls.",111,121,ballot-box,1,2,3
3IZPORCT1FA14863R339ZQF6FZWHR6,"But opposition parties and international observers said the vote was marred by vote-rigging, including alleged ballot-box stuffing and false voter rolls.",111,130,ballot-box stuffing,3,2,5
3IZPORCT1FA14863R339ZQF6FZWHR6,"But opposition parties and international observers said the vote was marred by vote-rigging, including alleged ballot-box stuffing and false voter rolls.",122,130,stuffing,1,4,5
3IZPORCT1FA14863R339ZQF6FZWHR6,"But opposition parties and international observers said the vote was marred by vote-rigging, including alleged ballot-box stuffing and false voter rolls.",141,152,voter rolls,2,0,2
3IZPORCT1FA14863R339ZQF6FZWHR6,"But opposition parties and international observers said the vote was marred by vote-rigging, including alleged ballot-box stuffing and false voter rolls.",147,152,rolls,0,1,1
391JB9X4ZY919IUJSGAPQJ1O0SDKMY,“With this attack we want to send a message to Obama that the Afghans will welcome you with attacks.,11,17,attack,0,1,1
391JB9X4ZY919IUJSGAPQJ1O0SDKMY,“With this attack we want to send a message to Obama that the Afghans will welcome you with attacks.,29,43,send a message,1,0,1
391JB9X4ZY919IUJSGAPQJ1O0SDKMY,“With this attack we want to send a message to Obama that the Afghans will welcome you with attacks.,36,43,message,0,1,1
391JB9X4ZY919IUJSGAPQJ1O0SDKMY,“With this attack we want to send a message to Obama that the Afghans will welcome you with attacks.,92,99,attacks,1,1,2
391JB9X4ZY919IUJSGAPQJ1O0SDKMY,He needs to [remove US] forces from Afghanistan.,24,30,forces,2,0,2
391JB9X4ZY919IUJSGAPQJ1O0SDKMY,Not kill the innocent Afghans and destroy the Afghans country.,13,21,innocent,5,8,13
391JB9X4ZY919IUJSGAPQJ1O0SDKMY,Not kill the innocent Afghans and destroy the Afghans country.,34,41,destroy,0,1,1
391JB9X4ZY919IUJSGAPQJ1O0SDKMY,"You don’t need to sign agreements, you need to focus on how to get out of this country,” says Zabiullah Mujahid, a spokesman for the Taliban.",18,22,sign,0,1,1
391JB9X4ZY919IUJSGAPQJ1O0SDKMY,"You don’t need to sign agreements, you need to focus on how to get out of this country,” says Zabiullah Mujahid, a spokesman for the Taliban.",18,33,sign agreements,1,0,1
391JB9X4ZY919IUJSGAPQJ1O0SDKMY,"You don’t need to sign agreements, you need to focus on how to get out of this country,” says Zabiullah Mujahid, a spokesman for the Taliban.",23,33,agreements,6,4,10
391JB9X4ZY919IUJSGAPQJ1O0SDKMY,"You don’t need to sign agreements, you need to focus on how to get out of this country,” says Zabiullah Mujahid, a spokesman for the Taliban.",47,52,focus,0,1,1
391JB9X4ZY919IUJSGAPQJ1O0SDKMY,"You don’t need to sign agreements, you need to focus on how to get out of this country,” says Zabiullah Mujahid, a spokesman for the Taliban.",47,55,focus on,0,1,1
391JB9X4ZY919IUJSGAPQJ1O0SDKMY,"You don’t need to sign agreements, you need to focus on how to get out of this country,” says Zabiullah Mujahid, a spokesman for the Taliban.",94,111,Zabiullah Mujahid,0,1,1
391JB9X4ZY919IUJSGAPQJ1O0SDKMY,"You don’t need to sign agreements, you need to focus on how to get out of this country,” says Zabiullah Mujahid, a spokesman for the Taliban.",115,124,spokesman,0,7,7
391JB9X4ZY919IUJSGAPQJ1O0SDKMY,"“This attack was planned in a very short time, just after the mujahideen got the news of Obama’s arrival.”",62,72,mujahideen,10,2,12
391JB9X4ZY919IUJSGAPQJ1O0SDKMY,"“This attack was planned in a very short time, just after the mujahideen got the news of Obama’s arrival.”",97,104,arrival,0,1,1
391JB9X4ZY919IUJSGAPQJ1O0SDKMY,The attack comes just after the Taliban announced the start of their annual spring offensive in which they increase military activity during warm weather months.,28,39,the Taliban,1,0,1
391JB9X4ZY919IUJSGAPQJ1O0SDKMY,The attack comes just after the Taliban announced the start of their annual spring offensive in which they increase military activity during warm weather months.,40,49,announced,1,1,2
391JB9X4ZY919IUJSGAPQJ1O0SDKMY,The attack comes just after the Taliban announced the start of their annual spring offensive in which they increase military activity during warm weather months.,69,75,annual,2,1,3
391JB9X4ZY919IUJSGAPQJ1O0SDKMY,The attack comes just after the Taliban announced the start of their annual spring offensive in which they increase military activity during warm weather months.,69,92,annual spring offensive,1,2,3
391JB9X4ZY919IUJSGAPQJ1O0SDKMY,The attack comes just after the Taliban announced the start of their annual spring offensive in which they increase military activity during warm weather months.,76,82,spring,0,1,1
391JB9X4ZY919IUJSGAPQJ1O0SDKMY,The attack comes just after the Taliban announced the start of their annual spring offensive in which they increase military activity during warm weather months.,76,92,spring offensive,3,0,3
391JB9X4ZY919IUJSGAPQJ1O0SDKMY,The attack comes just after the Taliban announced the start of their annual spring offensive in which they increase military activity during warm weather months.,83,92,offensive,6,6,12
391JB9X4ZY919IUJSGAPQJ1O0SDKMY,The attack comes just after the Taliban announced the start of their annual spring offensive in which they increase military activity during warm weather months.,107,115,increase,0,1,1
391JB9X4ZY919IUJSGAPQJ1O0SDKMY,The attack comes just after the Taliban announced the start of their annual spring offensive in which they increase military activity during warm weather months.,116,133,military activity,0,1,1
391JB9X4ZY919IUJSGAPQJ1O0SDKMY,"Taliban officials have said they will target members of the Karzai government, parliamentarians, and international troops.",0,7,Taliban,1,0,1
391JB9X4ZY919IUJSGAPQJ1O0SDKMY,"Taliban officials have said they will target members of the Karzai government, parliamentarians, and international troops.",8,17,officials,1,0,1
391JB9X4ZY919IUJSGAPQJ1O0SDKMY,"Taliban officials have said they will target members of the Karzai government, parliamentarians, and international troops.",38,44,target,2,5,7
391JB9X4ZY919IUJSGAPQJ1O0SDKMY,"Taliban officials have said they will target members of the Karzai government, parliamentarians, and international troops.",60,66,Karzai,1,0,1
391JB9X4ZY919IUJSGAPQJ1O0SDKMY,"Taliban officials have said they will target members of the Karzai government, parliamentarians, and international troops.",60,77,Karzai government,2,0,2
391JB9X4ZY919IUJSGAPQJ1O0SDKMY,"Taliban officials have said they will target members of the Karzai government, parliamentarians, and international troops.",67,77,government,1,0,1
391JB9X4ZY919IUJSGAPQJ1O0SDKMY,"Taliban officials have said they will target members of the Karzai government, parliamentarians, and international troops.",79,95,parliamentarians,10,3,13
391JB9X4ZY919IUJSGAPQJ1O0SDKMY,"Taliban officials have said they will target members of the Karzai government, parliamentarians, and international troops.",101,114,international,3,0,3
391JB9X4ZY919IUJSGAPQJ1O0SDKMY,"Taliban officials have said they will target members of the Karzai government, parliamentarians, and international troops.",101,121,international troops,1,0,1
391JB9X4ZY919IUJSGAPQJ1O0SDKMY,"Taliban officials have said they will target members of the Karzai government, parliamentarians, and international troops.",115,121,troops,1,0,1
3RSBJ6YZECRETZNH4LY52AYOOXZFOX,"He didn't see the text until he woke up this morning, Goodyear said.",19,23,text,1,2,3
3RSBJ6YZECRETZNH4LY52AYOOXZFOX,"Deputies identified the children as Pebbles Johnson, 17; Jaxs Johnson, 15; Jazzlyn Johnson, 13; and Joel Johnson, 12.",0,8,Deputies,4,6,10
3RSBJ6YZECRETZNH4LY52AYOOXZFOX,"Deputies identified the children as Pebbles Johnson, 17; Jaxs Johnson, 15; Jazzlyn Johnson, 13; and Joel Johnson, 12.",9,19,identified,5,3,8
3RSBJ6YZECRETZNH4LY52AYOOXZFOX,"The shooting happened in Port St. John, about 15 miles west of Cape Canaveral in an area known as the ""Space Coast"" because it is the home of NASA's Kennedy Space Center, the location of numerous famed shuttle launches.",4,12,shooting,0,1,1
3RSBJ6YZECRETZNH4LY52AYOOXZFOX,"The shooting happened in Port St. John, about 15 miles west of Cape Canaveral in an area known as the ""Space Coast"" because it is the home of NASA's Kennedy Space Center, the location of numerous famed shuttle launches.",13,21,happened,0,1,1
3RSBJ6YZECRETZNH4LY52AYOOXZFOX,"The shooting happened in Port St. John, about 15 miles west of Cape Canaveral in an area known as the ""Space Coast"" because it is the home of NASA's Kennedy Space Center, the location of numerous famed shuttle launches.",68,77,Canaveral,0,1,1
3RSBJ6YZECRETZNH4LY52AYOOXZFOX,"The shooting happened in Port St. John, about 15 miles west of Cape Canaveral in an area known as the ""Space Coast"" because it is the home of NASA's Kennedy Space Center, the location of numerous famed shuttle launches.",103,114,Space Coast,1,0,1
3RSBJ6YZECRETZNH4LY52AYOOXZFOX,"The shooting happened in Port St. John, about 15 miles west of Cape Canaveral in an area known as the ""Space Coast"" because it is the home of NASA's Kennedy Space Center, the location of numerous famed shuttle launches.",175,183,location,0,1,1
3RSBJ6YZECRETZNH4LY52AYOOXZFOX,"The shooting happened in Port St. John, about 15 miles west of Cape Canaveral in an area known as the ""Space Coast"" because it is the home of NASA's Kennedy Space Center, the location of numerous famed shuttle launches.",187,195,numerous,7,4,11
3RSBJ6YZECRETZNH4LY52AYOOXZFOX,"The shooting happened in Port St. John, about 15 miles west of Cape Canaveral in an area known as the ""Space Coast"" because it is the home of NASA's Kennedy Space Center, the location of numerous famed shuttle launches.",187,209,numerous famed shuttle,1,0,1
3RSBJ6YZECRETZNH4LY52AYOOXZFOX,"The shooting happened in Port St. John, about 15 miles west of Cape Canaveral in an area known as the ""Space Coast"" because it is the home of NASA's Kennedy Space Center, the location of numerous famed shuttle launches.",196,201,famed,4,7,11
3RSBJ6YZECRETZNH4LY52AYOOXZFOX,"The shooting happened in Port St. John, about 15 miles west of Cape Canaveral in an area known as the ""Space Coast"" because it is the home of NASA's Kennedy Space Center, the location of numerous famed shuttle launches.",196,209,famed shuttle,0,1,1
3RSBJ6YZECRETZNH4LY52AYOOXZFOX,"The shooting happened in Port St. John, about 15 miles west of Cape Canaveral in an area known as the ""Space Coast"" because it is the home of NASA's Kennedy Space Center, the location of numerous famed shuttle launches.",202,209,shuttle,3,2,5
3RSBJ6YZECRETZNH4LY52AYOOXZFOX,"The shooting happened in Port St. John, about 15 miles west of Cape Canaveral in an area known as the ""Space Coast"" because it is the home of NASA's Kennedy Space Center, the location of numerous famed shuttle launches.",202,218,shuttle launches,3,1,4
3RSBJ6YZECRETZNH4LY52AYOOXZFOX,"The shooting happened in Port St. John, about 15 miles west of Cape Canaveral in an area known as the ""Space Coast"" because it is the home of NASA's Kennedy Space Center, the location of numerous famed shuttle launches.",210,218,launches,2,4,6
3RSBJ6YZECRETZNH4LY52AYOOXZFOX,A spokesman for the Department of Children and Families wouldn't immediately comment on whether the family had a history with the agency.,2,11,spokesman,2,5,7
3RSBJ6YZECRETZNH4LY52AYOOXZFOX,A spokesman for the Department of Children and Families wouldn't immediately comment on whether the family had a history with the agency.,65,76,immediately,3,2,5
3RSBJ6YZECRETZNH4LY52AYOOXZFOX,A spokesman for the Department of Children and Families wouldn't immediately comment on whether the family had a history with the agency.,113,120,history,0,1,1
3RSBJ6YZECRETZNH4LY52AYOOXZFOX,A spokesman for the Department of Children and Families wouldn't immediately comment on whether the family had a history with the agency.,130,136,agency,1,1,2
3RSBJ6YZECRETZNH4LY52AYOOXZFOX,Dispatch records released Tuesday show that authorities responded to Thomas' house on three successive days in April.,0,8,Dispatch,6,6,12
3RSBJ6YZECRETZNH4LY52AYOOXZFOX,Dispatch records released Tuesday show that authorities responded to Thomas' house on three successive days in April.,0,16,Dispatch records,3,2,5
3RSBJ6YZECRETZNH4LY52AYOOXZFOX,Dispatch records released Tuesday show that authorities responded to Thomas' house on three successive days in April.,17,25,released,0,2,2
3RSBJ6YZECRETZNH4LY52AYOOXZFOX,Dispatch records released Tuesday show that authorities responded to Thomas' house on three successive days in April.,44,55,authorities,2,4,6
3RSBJ6YZECRETZNH4LY52AYOOXZFOX,Dispatch records released Tuesday show that authorities responded to Thomas' house on three successive days in April.,44,65,authorities responded,1,0,1
3RSBJ6YZECRETZNH4LY52AYOOXZFOX,Dispatch records released Tuesday show that authorities responded to Thomas' house on three successive days in April.,56,65,responded,1,3,4
3RSBJ6YZECRETZNH4LY52AYOOXZFOX,Dispatch records released Tuesday show that authorities responded to Thomas' house on three successive days in April.,92,102,successive,10,7,17
3RSBJ6YZECRETZNH4LY52AYOOXZFOX,Dispatch records released Tuesday show that authorities responded to Thomas' house on three successive days in April.,92,107,successive days,1,0,1
3RSBJ6YZECRETZNH4LY52AYOOXZFOX,"In the first visit, on Easter Sunday, Thomas reported that her son had thrown a bicycle through a window at the house.",23,29,Easter,1,0,1
3RSBJ6YZECRETZNH4LY52AYOOXZFOX,"In the first visit, on Easter Sunday, Thomas reported that her son had thrown a bicycle through a window at the house.",71,77,thrown,1,1,2
3909MD9T2ZISH8ASA7V9XY4AKVTFET,"Panatag/Scarborough is within the Philippines' Exclusive Economic Zone and Continental Shelf, the DFA added.",34,69,Philippines Exclusive Economic Zone,2,0,2
3909MD9T2ZISH8ASA7V9XY4AKVTFET,"Panatag/Scarborough is within the Philippines' Exclusive Economic Zone and Continental Shelf, the DFA added.",47,56,Exclusive,2,1,3
3909MD9T2ZISH8ASA7V9XY4AKVTFET,"Panatag/Scarborough is within the Philippines' Exclusive Economic Zone and Continental Shelf, the DFA added.",47,70,Exclusive Economic Zone,2,3,5
3909MD9T2ZISH8ASA7V9XY4AKVTFET,"Panatag/Scarborough is within the Philippines' Exclusive Economic Zone and Continental Shelf, the DFA added.",47,92,Exclusive Economic Zone and Continental Shelf,1,0,1
3909MD9T2ZISH8ASA7V9XY4AKVTFET,"Panatag/Scarborough is within the Philippines' Exclusive Economic Zone and Continental Shelf, the DFA added.",57,65,Economic,2,0,2
3909MD9T2ZISH8ASA7V9XY4AKVTFET,"Panatag/Scarborough is within the Philippines' Exclusive Economic Zone and Continental Shelf, the DFA added.",75,86,Continental,1,1,2
3909MD9T2ZISH8ASA7V9XY4AKVTFET,"Panatag/Scarborough is within the Philippines' Exclusive Economic Zone and Continental Shelf, the DFA added.",75,92,Continental Shelf,6,3,9
3909MD9T2ZISH8ASA7V9XY4AKVTFET,"Panatag/Scarborough is within the Philippines' Exclusive Economic Zone and Continental Shelf, the DFA added.",87,92,Shelf,0,1,1
3909MD9T2ZISH8ASA7V9XY4AKVTFET,"Panatag/Scarborough is within the Philippines' Exclusive Economic Zone and Continental Shelf, the DFA added.",98,101,DFA,1,1,2
3909MD9T2ZISH8ASA7V9XY4AKVTFET,The Navy deployed the BRP Gregorio del Pilar (PF-15) from Palawan  on Sunday.,9,17,deployed,6,3,9
3909MD9T2ZISH8ASA7V9XY4AKVTFET,The Navy deployed the BRP Gregorio del Pilar (PF-15) from Palawan  on Sunday.,22,25,BRP,1,1,2
3909MD9T2ZISH8ASA7V9XY4AKVTFET,"But on Tuesday, when the Gregorio del Pilar dispatched a boarding team to inspect the fishing vessels and collect photos and other evidence of their catch, two Chinese vessels showed up, including the government surveillance ship.",44,54,dispatched,7,6,13
3909MD9T2ZISH8ASA7V9XY4AKVTFET,"But on Tuesday, when the Gregorio del Pilar dispatched a boarding team to inspect the fishing vessels and collect photos and other evidence of their catch, two Chinese vessels showed up, including the government surveillance ship.",57,65,boarding,2,0,2
3909MD9T2ZISH8ASA7V9XY4AKVTFET,"But on Tuesday, when the Gregorio del Pilar dispatched a boarding team to inspect the fishing vessels and collect photos and other evidence of their catch, two Chinese vessels showed up, including the government surveillance ship.",57,70,boarding team,4,1,5
3909MD9T2ZISH8ASA7V9XY4AKVTFET,"But on Tuesday, when the Gregorio del Pilar dispatched a boarding team to inspect the fishing vessels and collect photos and other evidence of their catch, two Chinese vessels showed up, including the government surveillance ship.",74,81,inspect,0,1,1
3909MD9T2ZISH8ASA7V9XY4AKVTFET,"But on Tuesday, when the Gregorio del Pilar dispatched a boarding team to inspect the fishing vessels and collect photos and other evidence of their catch, two Chinese vessels showed up, including the government surveillance ship.",86,101,fishing vessels,3,1,4
3909MD9T2ZISH8ASA7V9XY4AKVTFET,"But on Tuesday, when the Gregorio del Pilar dispatched a boarding team to inspect the fishing vessels and collect photos and other evidence of their catch, two Chinese vessels showed up, including the government surveillance ship.",94,101,vessels,3,1,4
3909MD9T2ZISH8ASA7V9XY4AKVTFET,"But on Tuesday, when the Gregorio del Pilar dispatched a boarding team to inspect the fishing vessels and collect photos and other evidence of their catch, two Chinese vessels showed up, including the government surveillance ship.",131,139,evidence,3,1,4
3909MD9T2ZISH8ASA7V9XY4AKVTFET,"But on Tuesday, when the Gregorio del Pilar dispatched a boarding team to inspect the fishing vessels and collect photos and other evidence of their catch, two Chinese vessels showed up, including the government surveillance ship.",149,154,catch,0,2,2
3909MD9T2ZISH8ASA7V9XY4AKVTFET,"But on Tuesday, when the Gregorio del Pilar dispatched a boarding team to inspect the fishing vessels and collect photos and other evidence of their catch, two Chinese vessels showed up, including the government surveillance ship.",168,175,vessels,2,2,4
3909MD9T2ZISH8ASA7V9XY4AKVTFET,"But on Tuesday, when the Gregorio del Pilar dispatched a boarding team to inspect the fishing vessels and collect photos and other evidence of their catch, two Chinese vessels showed up, including the government surveillance ship.",187,196,including,0,1,1
3909MD9T2ZISH8ASA7V9XY4AKVTFET,"But on Tuesday, when the Gregorio del Pilar dispatched a boarding team to inspect the fishing vessels and collect photos and other evidence of their catch, two Chinese vessels showed up, including the government surveillance ship.",201,224,government surveillance,1,0,1
3909MD9T2ZISH8ASA7V9XY4AKVTFET,"But on Tuesday, when the Gregorio del Pilar dispatched a boarding team to inspect the fishing vessels and collect photos and other evidence of their catch, two Chinese vessels showed up, including the government surveillance ship.",201,229,government surveillance ship,3,0,3
3909MD9T2ZISH8ASA7V9XY4AKVTFET,"But on Tuesday, when the Gregorio del Pilar dispatched a boarding team to inspect the fishing vessels and collect photos and other evidence of their catch, two Chinese vessels showed up, including the government surveillance ship.",212,224,surveillance,9,2,11
3909MD9T2ZISH8ASA7V9XY4AKVTFET,"But on Tuesday, when the Gregorio del Pilar dispatched a boarding team to inspect the fishing vessels and collect photos and other evidence of their catch, two Chinese vessels showed up, including the government surveillance ship.",212,229,surveillance ship,0,3,3
3909MD9T2ZISH8ASA7V9XY4AKVTFET,"Initially, it said the inspection team reported that large amounts of illegally collected corals, giant clams and live sharks were found inside the compartments of the first fishing vessel that was boarded by the Navy team.",0,9,Initially,0,1,1
3909MD9T2ZISH8ASA7V9XY4AKVTFET,"Initially, it said the inspection team reported that large amounts of illegally collected corals, giant clams and live sharks were found inside the compartments of the first fishing vessel that was boarded by the Navy team.",23,33,inspection,4,1,5
3909MD9T2ZISH8ASA7V9XY4AKVTFET,"Initially, it said the inspection team reported that large amounts of illegally collected corals, giant clams and live sharks were found inside the compartments of the first fishing vessel that was boarded by the Navy team.",23,38,inspection team,0,1,1
3909MD9T2ZISH8ASA7V9XY4AKVTFET,"Initially, it said the inspection team reported that large amounts of illegally collected corals, giant clams and live sharks were found inside the compartments of the first fishing vessel that was boarded by the Navy team.",70,79,illegally,0,1,1
3909MD9T2ZISH8ASA7V9XY4AKVTFET,"Initially, it said the inspection team reported that large amounts of illegally collected corals, giant clams and live sharks were found inside the compartments of the first fishing vessel that was boarded by the Navy team.",70,89,illegally collected,0,1,1
3909MD9T2ZISH8ASA7V9XY4AKVTFET,"Initially, it said the inspection team reported that large amounts of illegally collected corals, giant clams and live sharks were found inside the compartments of the first fishing vessel that was boarded by the Navy team.",70,96,illegally collected corals,3,0,3
3909MD9T2ZISH8ASA7V9XY4AKVTFET,"Initially, it said the inspection team reported that large amounts of illegally collected corals, giant clams and live sharks were found inside the compartments of the first fishing vessel that was boarded by the Navy team.",90,96,corals,1,2,3
3909MD9T2ZISH8ASA7V9XY4AKVTFET,"Initially, it said the inspection team reported that large amounts of illegally collected corals, giant clams and live sharks were found inside the compartments of the first fishing vessel that was boarded by the Navy team.",104,109,clams,1,1,2
3909MD9T2ZISH8ASA7V9XY4AKVTFET,"Initially, it said the inspection team reported that large amounts of illegally collected corals, giant clams and live sharks were found inside the compartments of the first fishing vessel that was boarded by the Navy team.",148,160,compartments,8,1,9
3909MD9T2ZISH8ASA7V9XY4AKVTFET,"Initially, it said the inspection team reported that large amounts of illegally collected corals, giant clams and live sharks were found inside the compartments of the first fishing vessel that was boarded by the Navy team.",168,188,first fishing vessel,1,0,1
3909MD9T2ZISH8ASA7V9XY4AKVTFET,"Initially, it said the inspection team reported that large amounts of illegally collected corals, giant clams and live sharks were found inside the compartments of the first fishing vessel that was boarded by the Navy team.",182,188,vessel,0,2,2
3909MD9T2ZISH8ASA7V9XY4AKVTFET,"Initially, it said the inspection team reported that large amounts of illegally collected corals, giant clams and live sharks were found inside the compartments of the first fishing vessel that was boarded by the Navy team.",198,205,boarded,1,1,2
3909MD9T2ZISH8ASA7V9XY4AKVTFET,"The Gregorio del Pilar reported two Chinese maritime surveillance ships identified as Zhonggou Haijian 75 and Zhonggou Haijian 84 sailed to the mouth of the Shoal, ""placing themselves between PF-15 and the eight Chinese fishing vessels, thus preventing the arrest of the erring  Chinese fishermen.""",36,71,Chinese maritime surveillance ships,1,0,1
3909MD9T2ZISH8ASA7V9XY4AKVTFET,"The Gregorio del Pilar reported two Chinese maritime surveillance ships identified as Zhonggou Haijian 75 and Zhonggou Haijian 84 sailed to the mouth of the Shoal, ""placing themselves between PF-15 and the eight Chinese fishing vessels, thus preventing the arrest of the erring  Chinese fishermen.""",44,52,maritime,5,1,6
3909MD9T2ZISH8ASA7V9XY4AKVTFET,"The Gregorio del Pilar reported two Chinese maritime surveillance ships identified as Zhonggou Haijian 75 and Zhonggou Haijian 84 sailed to the mouth of the Shoal, ""placing themselves between PF-15 and the eight Chinese fishing vessels, thus preventing the arrest of the erring  Chinese fishermen.""",44,71,maritime surveillance ships,3,0,3
3909MD9T2ZISH8ASA7V9XY4AKVTFET,"The Gregorio del Pilar reported two Chinese maritime surveillance ships identified as Zhonggou Haijian 75 and Zhonggou Haijian 84 sailed to the mouth of the Shoal, ""placing themselves between PF-15 and the eight Chinese fishing vessels, thus preventing the arrest of the erring  Chinese fishermen.""",44,65,maritime surveillance,2,0,2
3909MD9T2ZISH8ASA7V9XY4AKVTFET,"The Gregorio del Pilar reported two Chinese maritime surveillance ships identified as Zhonggou Haijian 75 and Zhonggou Haijian 84 sailed to the mouth of the Shoal, ""placing themselves between PF-15 and the eight Chinese fishing vessels, thus preventing the arrest of the erring  Chinese fishermen.""",53,65,surveillance,4,0,4
3909MD9T2ZISH8ASA7V9XY4AKVTFET,"The Gregorio del Pilar reported two Chinese maritime surveillance ships identified as Zhonggou Haijian 75 and Zhonggou Haijian 84 sailed to the mouth of the Shoal, ""placing themselves between PF-15 and the eight Chinese fishing vessels, thus preventing the arrest of the erring  Chinese fishermen.""",72,82,identified,1,2,3
3909MD9T2ZISH8ASA7V9XY4AKVTFET,"The Gregorio del Pilar reported two Chinese maritime surveillance ships identified as Zhonggou Haijian 75 and Zhonggou Haijian 84 sailed to the mouth of the Shoal, ""placing themselves between PF-15 and the eight Chinese fishing vessels, thus preventing the arrest of the erring  Chinese fishermen.""",86,94,Zhonggou,1,0,1
3909MD9T2ZISH8ASA7V9XY4AKVTFET,"The Gregorio del Pilar reported two Chinese maritime surveillance ships identified as Zhonggou Haijian 75 and Zhonggou Haijian 84 sailed to the mouth of the Shoal, ""placing themselves between PF-15 and the eight Chinese fishing vessels, thus preventing the arrest of the erring  Chinese fishermen.""",157,162,Shoal,4,1,5
3909MD9T2ZISH8ASA7V9XY4AKVTFET,"The Gregorio del Pilar reported two Chinese maritime surveillance ships identified as Zhonggou Haijian 75 and Zhonggou Haijian 84 sailed to the mouth of the Shoal, ""placing themselves between PF-15 and the eight Chinese fishing vessels, thus preventing the arrest of the erring  Chinese fishermen.""",228,235,vessels,0,1,1
3909MD9T2ZISH8ASA7V9XY4AKVTFET,"The Gregorio del Pilar reported two Chinese maritime surveillance ships identified as Zhonggou Haijian 75 and Zhonggou Haijian 84 sailed to the mouth of the Shoal, ""placing themselves between PF-15 and the eight Chinese fishing vessels, thus preventing the arrest of the erring  Chinese fishermen.""",242,252,preventing,1,1,2
3909MD9T2ZISH8ASA7V9XY4AKVTFET,"The Gregorio del Pilar reported two Chinese maritime surveillance ships identified as Zhonggou Haijian 75 and Zhonggou Haijian 84 sailed to the mouth of the Shoal, ""placing themselves between PF-15 and the eight Chinese fishing vessels, thus preventing the arrest of the erring  Chinese fishermen.""",271,277,erring,5,1,6
3RWB1RTQDJONZKPVB75EHIMSAXUP8G,"At the same time, it suggested that between now and November, the president will point to his management of the wars in Iraq and Afghanistan, and the administration's efforts to significantly degrade al-Qaeda, as major successes of his first term.",21,30,suggested,0,3,3
3RWB1RTQDJONZKPVB75EHIMSAXUP8G,"At the same time, it suggested that between now and November, the president will point to his management of the wars in Iraq and Afghanistan, and the administration's efforts to significantly degrade al-Qaeda, as major successes of his first term.",94,104,management,3,1,4
3RWB1RTQDJONZKPVB75EHIMSAXUP8G,"At the same time, it suggested that between now and November, the president will point to his management of the wars in Iraq and Afghanistan, and the administration's efforts to significantly degrade al-Qaeda, as major successes of his first term.",94,116,management of the wars,1,0,1
3RWB1RTQDJONZKPVB75EHIMSAXUP8G,"At the same time, it suggested that between now and November, the president will point to his management of the wars in Iraq and Afghanistan, and the administration's efforts to significantly degrade al-Qaeda, as major successes of his first term.",150,165,administrations,6,1,7
3RWB1RTQDJONZKPVB75EHIMSAXUP8G,"At the same time, it suggested that between now and November, the president will point to his management of the wars in Iraq and Afghanistan, and the administration's efforts to significantly degrade al-Qaeda, as major successes of his first term.",178,191,significantly,5,4,9
3RWB1RTQDJONZKPVB75EHIMSAXUP8G,"At the same time, it suggested that between now and November, the president will point to his management of the wars in Iraq and Afghanistan, and the administration's efforts to significantly degrade al-Qaeda, as major successes of his first term.",178,199,significantly degrade,3,4,7
3RWB1RTQDJONZKPVB75EHIMSAXUP8G,"At the same time, it suggested that between now and November, the president will point to his management of the wars in Iraq and Afghanistan, and the administration's efforts to significantly degrade al-Qaeda, as major successes of his first term.",192,199,degrade,8,2,10
3RWB1RTQDJONZKPVB75EHIMSAXUP8G,"At the same time, it suggested that between now and November, the president will point to his management of the wars in Iraq and Afghanistan, and the administration's efforts to significantly degrade al-Qaeda, as major successes of his first term.",213,218,major,0,1,1
3RWB1RTQDJONZKPVB75EHIMSAXUP8G,"At the same time, it suggested that between now and November, the president will point to his management of the wars in Iraq and Afghanistan, and the administration's efforts to significantly degrade al-Qaeda, as major successes of his first term.",219,228,successes,0,1,1
3RWB1RTQDJONZKPVB75EHIMSAXUP8G,"At the same time, it suggested that between now and November, the president will point to his management of the wars in Iraq and Afghanistan, and the administration's efforts to significantly degrade al-Qaeda, as major successes of his first term.",242,246,term,0,1,1
3RWB1RTQDJONZKPVB75EHIMSAXUP8G,Yet the visit was also a reminder that Obama is keenly aware that he is dealing with a war-weary nation when it comes to Afghanistan.,25,33,reminder,0,2,2
3RWB1RTQDJONZKPVB75EHIMSAXUP8G,Yet the visit was also a reminder that Obama is keenly aware that he is dealing with a war-weary nation when it comes to Afghanistan.,48,54,keenly,5,5,10
3RWB1RTQDJONZKPVB75EHIMSAXUP8G,Yet the visit was also a reminder that Obama is keenly aware that he is dealing with a war-weary nation when it comes to Afghanistan.,48,60,keenly aware,2,1,3
3RWB1RTQDJONZKPVB75EHIMSAXUP8G,Yet the visit was also a reminder that Obama is keenly aware that he is dealing with a war-weary nation when it comes to Afghanistan.,72,79,dealing,0,2,2
3RWB1RTQDJONZKPVB75EHIMSAXUP8G,Yet the visit was also a reminder that Obama is keenly aware that he is dealing with a war-weary nation when it comes to Afghanistan.,87,96,war-weary,10,6,16
3RWB1RTQDJONZKPVB75EHIMSAXUP8G,Yet the visit was also a reminder that Obama is keenly aware that he is dealing with a war-weary nation when it comes to Afghanistan.,87,103,war-weary nation,1,2,3
3RWB1RTQDJONZKPVB75EHIMSAXUP8G,"In the latest Washington Post-ABC News poll, two-thirds of Americans said they think the decade-long battle there has not been worth the costs it has incurred; nearly half the country feels strongly that way.",25,43,Post-ABC News poll,0,2,2
3RWB1RTQDJONZKPVB75EHIMSAXUP8G,"In the latest Washington Post-ABC News poll, two-thirds of Americans said they think the decade-long battle there has not been worth the costs it has incurred; nearly half the country feels strongly that way.",89,100,decade-long,2,4,6
3RWB1RTQDJONZKPVB75EHIMSAXUP8G,"In the latest Washington Post-ABC News poll, two-thirds of Americans said they think the decade-long battle there has not been worth the costs it has incurred; nearly half the country feels strongly that way.",89,107,decade-long battle,1,1,2
3RWB1RTQDJONZKPVB75EHIMSAXUP8G,"In the latest Washington Post-ABC News poll, two-thirds of Americans said they think the decade-long battle there has not been worth the costs it has incurred; nearly half the country feels strongly that way.",127,132,worth,0,2,2
3RWB1RTQDJONZKPVB75EHIMSAXUP8G,"In the latest Washington Post-ABC News poll, two-thirds of Americans said they think the decade-long battle there has not been worth the costs it has incurred; nearly half the country feels strongly that way.",150,158,incurred,10,9,19
3RWB1RTQDJONZKPVB75EHIMSAXUP8G,Even a majority of Republicans hold a negative view of the conflict.,7,15,majority,0,2,2
3RWB1RTQDJONZKPVB75EHIMSAXUP8G,Even a majority of Republicans hold a negative view of the conflict.,59,67,conflict,3,7,10
3RWB1RTQDJONZKPVB75EHIMSAXUP8G,Obama's message Tuesday night in his nationally televised speech was tailored to directly address that sentiment.,37,47,nationally,1,0,1
3RWB1RTQDJONZKPVB75EHIMSAXUP8G,Obama's message Tuesday night in his nationally televised speech was tailored to directly address that sentiment.,48,57,televised,3,1,4
3RWB1RTQDJONZKPVB75EHIMSAXUP8G,Obama's message Tuesday night in his nationally televised speech was tailored to directly address that sentiment.,48,64,televised speech,0,2,2
3RWB1RTQDJONZKPVB75EHIMSAXUP8G,Obama's message Tuesday night in his nationally televised speech was tailored to directly address that sentiment.,69,77,tailored,10,10,20
3RWB1RTQDJONZKPVB75EHIMSAXUP8G,Obama's message Tuesday night in his nationally televised speech was tailored to directly address that sentiment.,90,97,address,1,0,1
3RWB1RTQDJONZKPVB75EHIMSAXUP8G,Obama's message Tuesday night in his nationally televised speech was tailored to directly address that sentiment.,103,112,sentiment,10,5,15
3CIS7GGG65KH0Q7I5WQ8JY5DUI8EUR,Albert Del Rosario said he met ambassador Ma Keqing and both reaffirmed their governments' positions that the Scarborough Shoal where the ships are facing off was part of their own country's territory.,31,41,ambassador,5,2,7
3CIS7GGG65KH0Q7I5WQ8JY5DUI8EUR,Albert Del Rosario said he met ambassador Ma Keqing and both reaffirmed their governments' positions that the Scarborough Shoal where the ships are facing off was part of their own country's territory.,61,71,reaffirmed,10,7,17
3CIS7GGG65KH0Q7I5WQ8JY5DUI8EUR,Albert Del Rosario said he met ambassador Ma Keqing and both reaffirmed their governments' positions that the Scarborough Shoal where the ships are facing off was part of their own country's territory.,78,89,governments,1,0,1
3CIS7GGG65KH0Q7I5WQ8JY5DUI8EUR,Albert Del Rosario said he met ambassador Ma Keqing and both reaffirmed their governments' positions that the Scarborough Shoal where the ships are facing off was part of their own country's territory.,122,127,Shoal,1,0,1
3CIS7GGG65KH0Q7I5WQ8JY5DUI8EUR,Albert Del Rosario said he met ambassador Ma Keqing and both reaffirmed their governments' positions that the Scarborough Shoal where the ships are facing off was part of their own country's territory.,148,158,facing off,1,2,3
3CIS7GGG65KH0Q7I5WQ8JY5DUI8EUR,Albert Del Rosario said he met ambassador Ma Keqing and both reaffirmed their governments' positions that the Scarborough Shoal where the ships are facing off was part of their own country's territory.,191,200,territory,2,2,4
3CIS7GGG65KH0Q7I5WQ8JY5DUI8EUR,"Mr Del Rosario said that despite the impasse, ""we resolved to seek a diplomatic solution to the issue"".",25,32,despite,0,1,1
3CIS7GGG65KH0Q7I5WQ8JY5DUI8EUR,"Mr Del Rosario said that despite the impasse, ""we resolved to seek a diplomatic solution to the issue"".",25,44,despite the impasse,0,1,1
3CIS7GGG65KH0Q7I5WQ8JY5DUI8EUR,"Mr Del Rosario said that despite the impasse, ""we resolved to seek a diplomatic solution to the issue"".",37,44,impasse,10,8,18
3CIS7GGG65KH0Q7I5WQ8JY5DUI8EUR,"Mr Del Rosario said that despite the impasse, ""we resolved to seek a diplomatic solution to the issue"".",50,58,resolved,0,2,2
3CIS7GGG65KH0Q7I5WQ8JY5DUI8EUR,"Mr Del Rosario said that despite the impasse, ""we resolved to seek a diplomatic solution to the issue"".",69,79,diplomatic,6,2,8
3CIS7GGG65KH0Q7I5WQ8JY5DUI8EUR,"Mr Del Rosario said that despite the impasse, ""we resolved to seek a diplomatic solution to the issue"".",69,88,diplomatic solution,3,2,5
3CIS7GGG65KH0Q7I5WQ8JY5DUI8EUR,"Mr Del Rosario said that despite the impasse, ""we resolved to seek a diplomatic solution to the issue"".",96,101,issue,1,0,1
3CIS7GGG65KH0Q7I5WQ8JY5DUI8EUR,The Philippine government says its navy tried to detain Chinese fishermen but was prevented by the Chinese surveillance craft.,15,25,government,1,0,1
3CIS7GGG65KH0Q7I5WQ8JY5DUI8EUR,The Philippine government says its navy tried to detain Chinese fishermen but was prevented by the Chinese surveillance craft.,49,55,detain,4,3,7
3CIS7GGG65KH0Q7I5WQ8JY5DUI8EUR,The Philippine government says its navy tried to detain Chinese fishermen but was prevented by the Chinese surveillance craft.,64,73,fishermen,1,0,1
3CIS7GGG65KH0Q7I5WQ8JY5DUI8EUR,The Philippine government says its navy tried to detain Chinese fishermen but was prevented by the Chinese surveillance craft.,82,91,prevented,1,0,1
3CIS7GGG65KH0Q7I5WQ8JY5DUI8EUR,The Philippine government says its navy tried to detain Chinese fishermen but was prevented by the Chinese surveillance craft.,107,119,surveillance,7,5,12
3CIS7GGG65KH0Q7I5WQ8JY5DUI8EUR,The Philippine government says its navy tried to detain Chinese fishermen but was prevented by the Chinese surveillance craft.,107,125,surveillance craft,4,2,6
3CIS7GGG65KH0Q7I5WQ8JY5DUI8EUR,The Philippine government says its navy tried to detain Chinese fishermen but was prevented by the Chinese surveillance craft.,120,125,craft,0,2,2
3CIS7GGG65KH0Q7I5WQ8JY5DUI8EUR,Beijing called on the Philippine ship to leave the waters.,51,57,waters,0,1,1
3CIS7GGG65KH0Q7I5WQ8JY5DUI8EUR,The shoal lies off the north-western province of Zambales.,4,9,shoal,9,4,13
3CIS7GGG65KH0Q7I5WQ8JY5DUI8EUR,The shoal lies off the north-western province of Zambales.,23,36,north-western,0,1,1
3CIS7GGG65KH0Q7I5WQ8JY5DUI8EUR,The shoal lies off the north-western province of Zambales.,37,45,province,1,0,1
3CIS7GGG65KH0Q7I5WQ8JY5DUI8EUR,"China and the Philippines have been disputing ownership of the shoal, in addition to the Spratly Islands and other areas in the South China Sea.",36,45,disputing,9,5,14
3CIS7GGG65KH0Q7I5WQ8JY5DUI8EUR,"China and the Philippines have been disputing ownership of the shoal, in addition to the Spratly Islands and other areas in the South China Sea.",36,55,disputing ownership,1,0,1
3CIS7GGG65KH0Q7I5WQ8JY5DUI8EUR,"China and the Philippines have been disputing ownership of the shoal, in addition to the Spratly Islands and other areas in the South China Sea.",63,68,shoal,1,2,3
3CIS7GGG65KH0Q7I5WQ8JY5DUI8EUR,"The Philippine Department of Foreign Affairs said that on Sunday, a Philippine navy surveillance plane sighted eight Chinese fishing vessels anchored in a lagoon at Scarborough, prompting the military to deploy its largest warship, the BRP Gregorio del Pilar, which was recently acquired from the United States.",15,44,Department of Foreign Affairs,1,0,1
3CIS7GGG65KH0Q7I5WQ8JY5DUI8EUR,"The Philippine Department of Foreign Affairs said that on Sunday, a Philippine navy surveillance plane sighted eight Chinese fishing vessels anchored in a lagoon at Scarborough, prompting the military to deploy its largest warship, the BRP Gregorio del Pilar, which was recently acquired from the United States.",84,96,surveillance,8,1,9
3CIS7GGG65KH0Q7I5WQ8JY5DUI8EUR,"The Philippine Department of Foreign Affairs said that on Sunday, a Philippine navy surveillance plane sighted eight Chinese fishing vessels anchored in a lagoon at Scarborough, prompting the military to deploy its largest warship, the BRP Gregorio del Pilar, which was recently acquired from the United States.",84,102,surveillance plane,0,1,1
3CIS7GGG65KH0Q7I5WQ8JY5DUI8EUR,"The Philippine Department of Foreign Affairs said that on Sunday, a Philippine navy surveillance plane sighted eight Chinese fishing vessels anchored in a lagoon at Scarborough, prompting the military to deploy its largest warship, the BRP Gregorio del Pilar, which was recently acquired from the United States.",103,110,sighted,1,3,4
3CIS7GGG65KH0Q7I5WQ8JY5DUI8EUR,"The Philippine Department of Foreign Affairs said that on Sunday, a Philippine navy surveillance plane sighted eight Chinese fishing vessels anchored in a lagoon at Scarborough, prompting the military to deploy its largest warship, the BRP Gregorio del Pilar, which was recently acquired from the United States.",117,140,Chinese fishing vessels,1,0,1
3CIS7GGG65KH0Q7I5WQ8JY5DUI8EUR,"The Philippine Department of Foreign Affairs said that on Sunday, a Philippine navy surveillance plane sighted eight Chinese fishing vessels anchored in a lagoon at Scarborough, prompting the military to deploy its largest warship, the BRP Gregorio del Pilar, which was recently acquired from the United States.",125,140,fishing vessels,1,1,2
3CIS7GGG65KH0Q7I5WQ8JY5DUI8EUR,"The Philippine Department of Foreign Affairs said that on Sunday, a Philippine navy surveillance plane sighted eight Chinese fishing vessels anchored in a lagoon at Scarborough, prompting the military to deploy its largest warship, the BRP Gregorio del Pilar, which was recently acquired from the United States.",133,140,vessels,0,2,2
3CIS7GGG65KH0Q7I5WQ8JY5DUI8EUR,"The Philippine Department of Foreign Affairs said that on Sunday, a Philippine navy surveillance plane sighted eight Chinese fishing vessels anchored in a lagoon at Scarborough, prompting the military to deploy its largest warship, the BRP Gregorio del Pilar, which was recently acquired from the United States.",133,149,vessels anchored,1,0,1
3CIS7GGG65KH0Q7I5WQ8JY5DUI8EUR,"The Philippine Department of Foreign Affairs said that on Sunday, a Philippine navy surveillance plane sighted eight Chinese fishing vessels anchored in a lagoon at Scarborough, prompting the military to deploy its largest warship, the BRP Gregorio del Pilar, which was recently acquired from the United States.",141,149,anchored,5,4,9
3CIS7GGG65KH0Q7I5WQ8JY5DUI8EUR,"The Philippine Department of Foreign Affairs said that on Sunday, a Philippine navy surveillance plane sighted eight Chinese fishing vessels anchored in a lagoon at Scarborough, prompting the military to deploy its largest warship, the BRP Gregorio del Pilar, which was recently acquired from the United States.",155,161,lagoon,5,1,6
3CIS7GGG65KH0Q7I5WQ8JY5DUI8EUR,"The Philippine Department of Foreign Affairs said that on Sunday, a Philippine navy surveillance plane sighted eight Chinese fishing vessels anchored in a lagoon at Scarborough, prompting the military to deploy its largest warship, the BRP Gregorio del Pilar, which was recently acquired from the United States.",178,187,prompting,1,2,3
3CIS7GGG65KH0Q7I5WQ8JY5DUI8EUR,"The Philippine Department of Foreign Affairs said that on Sunday, a Philippine navy surveillance plane sighted eight Chinese fishing vessels anchored in a lagoon at Scarborough, prompting the military to deploy its largest warship, the BRP Gregorio del Pilar, which was recently acquired from the United States.",204,210,deploy,5,5,10
3CIS7GGG65KH0Q7I5WQ8JY5DUI8EUR,"The Philippine Department of Foreign Affairs said that on Sunday, a Philippine navy surveillance plane sighted eight Chinese fishing vessels anchored in a lagoon at Scarborough, prompting the military to deploy its largest warship, the BRP Gregorio del Pilar, which was recently acquired from the United States.",223,230,warship,2,1,3
3CIS7GGG65KH0Q7I5WQ8JY5DUI8EUR,"The Philippine Department of Foreign Affairs said that on Sunday, a Philippine navy surveillance plane sighted eight Chinese fishing vessels anchored in a lagoon at Scarborough, prompting the military to deploy its largest warship, the BRP Gregorio del Pilar, which was recently acquired from the United States.",270,287,recently acquired,1,0,1
3CIS7GGG65KH0Q7I5WQ8JY5DUI8EUR,"The Philippine Department of Foreign Affairs said that on Sunday, a Philippine navy surveillance plane sighted eight Chinese fishing vessels anchored in a lagoon at Scarborough, prompting the military to deploy its largest warship, the BRP Gregorio del Pilar, which was recently acquired from the United States.",279,287,acquired,10,1,11
3RDTX9JRTY2Y7J45KDHBHSQIUXR97F,"For banks unable to raise the funds, the government will provide five-year loans, convertible into shares with an interest rate double the rate on government bonds.",10,16,unable,0,1,1
3RDTX9JRTY2Y7J45KDHBHSQIUXR97F,"For banks unable to raise the funds, the government will provide five-year loans, convertible into shares with an interest rate double the rate on government bonds.",20,25,raise,0,2,2
3RDTX9JRTY2Y7J45KDHBHSQIUXR97F,"For banks unable to raise the funds, the government will provide five-year loans, convertible into shares with an interest rate double the rate on government bonds.",30,35,funds,1,0,1
3RDTX9JRTY2Y7J45KDHBHSQIUXR97F,"For banks unable to raise the funds, the government will provide five-year loans, convertible into shares with an interest rate double the rate on government bonds.",41,51,government,1,0,1
3RDTX9JRTY2Y7J45KDHBHSQIUXR97F,"For banks unable to raise the funds, the government will provide five-year loans, convertible into shares with an interest rate double the rate on government bonds.",82,93,convertible,10,7,17
3RDTX9JRTY2Y7J45KDHBHSQIUXR97F,"For banks unable to raise the funds, the government will provide five-year loans, convertible into shares with an interest rate double the rate on government bonds.",82,105,convertible into shares,1,0,1
3RDTX9JRTY2Y7J45KDHBHSQIUXR97F,"For banks unable to raise the funds, the government will provide five-year loans, convertible into shares with an interest rate double the rate on government bonds.",99,105,shares,0,2,2
3RDTX9JRTY2Y7J45KDHBHSQIUXR97F,"For banks unable to raise the funds, the government will provide five-year loans, convertible into shares with an interest rate double the rate on government bonds.",114,127,interest rate,1,2,3
3RDTX9JRTY2Y7J45KDHBHSQIUXR97F,"For banks unable to raise the funds, the government will provide five-year loans, convertible into shares with an interest rate double the rate on government bonds.",147,163,government bonds,1,0,1
3RDTX9JRTY2Y7J45KDHBHSQIUXR97F,"For banks unable to raise the funds, the government will provide five-year loans, convertible into shares with an interest rate double the rate on government bonds.",158,163,bonds,0,2,2
3RDTX9JRTY2Y7J45KDHBHSQIUXR97F,"The state will have to raise money on debt markets for the loans to the banks, which will be made through an instrument known as contingent convertibles, or CoCos, which carry the risk that the state ends up with ownership of still-troubled banks.",23,28,raise,0,1,1
3RDTX9JRTY2Y7J45KDHBHSQIUXR97F,"The state will have to raise money on debt markets for the loans to the banks, which will be made through an instrument known as contingent convertibles, or CoCos, which carry the risk that the state ends up with ownership of still-troubled banks.",38,42,debt,2,1,3
3RDTX9JRTY2Y7J45KDHBHSQIUXR97F,"The state will have to raise money on debt markets for the loans to the banks, which will be made through an instrument known as contingent convertibles, or CoCos, which carry the risk that the state ends up with ownership of still-troubled banks.",38,50,debt markets,3,2,5
3RDTX9JRTY2Y7J45KDHBHSQIUXR97F,"The state will have to raise money on debt markets for the loans to the banks, which will be made through an instrument known as contingent convertibles, or CoCos, which carry the risk that the state ends up with ownership of still-troubled banks.",109,119,instrument,6,2,8
3RDTX9JRTY2Y7J45KDHBHSQIUXR97F,"The state will have to raise money on debt markets for the loans to the banks, which will be made through an instrument known as contingent convertibles, or CoCos, which carry the risk that the state ends up with ownership of still-troubled banks.",129,139,contingent,3,7,10
3RDTX9JRTY2Y7J45KDHBHSQIUXR97F,"The state will have to raise money on debt markets for the loans to the banks, which will be made through an instrument known as contingent convertibles, or CoCos, which carry the risk that the state ends up with ownership of still-troubled banks.",129,152,contingent convertibles,9,5,14
3RDTX9JRTY2Y7J45KDHBHSQIUXR97F,"The state will have to raise money on debt markets for the loans to the banks, which will be made through an instrument known as contingent convertibles, or CoCos, which carry the risk that the state ends up with ownership of still-troubled banks.",140,152,convertibles,2,1,3
3RDTX9JRTY2Y7J45KDHBHSQIUXR97F,"The state will have to raise money on debt markets for the loans to the banks, which will be made through an instrument known as contingent convertibles, or CoCos, which carry the risk that the state ends up with ownership of still-troubled banks.",157,162,CoCos,3,3,6
3RDTX9JRTY2Y7J45KDHBHSQIUXR97F,"The state will have to raise money on debt markets for the loans to the banks, which will be made through an instrument known as contingent convertibles, or CoCos, which carry the risk that the state ends up with ownership of still-troubled banks.",213,222,ownership,1,0,1
3RDTX9JRTY2Y7J45KDHBHSQIUXR97F,"The state will have to raise money on debt markets for the loans to the banks, which will be made through an instrument known as contingent convertibles, or CoCos, which carry the risk that the state ends up with ownership of still-troubled banks.",226,240,still-troubled,1,0,1
3RDTX9JRTY2Y7J45KDHBHSQIUXR97F,"The state will have to raise money on debt markets for the loans to the banks, which will be made through an instrument known as contingent convertibles, or CoCos, which carry the risk that the state ends up with ownership of still-troubled banks.",226,246,still-troubled banks,0,1,1
3RDTX9JRTY2Y7J45KDHBHSQIUXR97F,Spain announced Friday a drastic reform forcing banks to set aside a new 30-billion-euro ($39 billion) financial cushion and to separate property assets from their balance sheets.,6,15,announced,0,1,1
3RDTX9JRTY2Y7J45KDHBHSQIUXR97F,Spain announced Friday a drastic reform forcing banks to set aside a new 30-billion-euro ($39 billion) financial cushion and to separate property assets from their balance sheets.,25,32,drastic,4,5,9
3RDTX9JRTY2Y7J45KDHBHSQIUXR97F,Spain announced Friday a drastic reform forcing banks to set aside a new 30-billion-euro ($39 billion) financial cushion and to separate property assets from their balance sheets.,25,39,drastic reform,6,2,8
3RDTX9JRTY2Y7J45KDHBHSQIUXR97F,Spain announced Friday a drastic reform forcing banks to set aside a new 30-billion-euro ($39 billion) financial cushion and to separate property assets from their balance sheets.,33,39,reform,1,2,3
3RDTX9JRTY2Y7J45KDHBHSQIUXR97F,Spain announced Friday a drastic reform forcing banks to set aside a new 30-billion-euro ($39 billion) financial cushion and to separate property assets from their balance sheets.,61,66,aside,1,1,2
3RDTX9JRTY2Y7J45KDHBHSQIUXR97F,Spain announced Friday a drastic reform forcing banks to set aside a new 30-billion-euro ($39 billion) financial cushion and to separate property assets from their balance sheets.,103,120,financial cushion,7,3,10
3RDTX9JRTY2Y7J45KDHBHSQIUXR97F,Spain announced Friday a drastic reform forcing banks to set aside a new 30-billion-euro ($39 billion) financial cushion and to separate property assets from their balance sheets.,113,120,cushion,2,4,6
3RDTX9JRTY2Y7J45KDHBHSQIUXR97F,Spain announced Friday a drastic reform forcing banks to set aside a new 30-billion-euro ($39 billion) financial cushion and to separate property assets from their balance sheets.,146,152,assets,3,1,4
3RDTX9JRTY2Y7J45KDHBHSQIUXR97F,Spain announced Friday a drastic reform forcing banks to set aside a new 30-billion-euro ($39 billion) financial cushion and to separate property assets from their balance sheets.,164,178,balance sheets,2,1,3
3RDTX9JRTY2Y7J45KDHBHSQIUXR97F,"The government will also charge two independent auditing firms with valuing banks' exposure to the collapsed property sector, ministers told a news conference after a cabinet meeting.",36,47,independent,1,0,1
3RDTX9JRTY2Y7J45KDHBHSQIUXR97F,"The government will also charge two independent auditing firms with valuing banks' exposure to the collapsed property sector, ministers told a news conference after a cabinet meeting.",36,62,independent auditing firms,2,0,2
3RDTX9JRTY2Y7J45KDHBHSQIUXR97F,"The government will also charge two independent auditing firms with valuing banks' exposure to the collapsed property sector, ministers told a news conference after a cabinet meeting.",48,56,auditing,8,7,15
3RDTX9JRTY2Y7J45KDHBHSQIUXR97F,"The government will also charge two independent auditing firms with valuing banks' exposure to the collapsed property sector, ministers told a news conference after a cabinet meeting.",48,62,auditing firms,1,0,1
3RDTX9JRTY2Y7J45KDHBHSQIUXR97F,"The government will also charge two independent auditing firms with valuing banks' exposure to the collapsed property sector, ministers told a news conference after a cabinet meeting.",68,75,valuing,2,1,3
3RDTX9JRTY2Y7J45KDHBHSQIUXR97F,"The government will also charge two independent auditing firms with valuing banks' exposure to the collapsed property sector, ministers told a news conference after a cabinet meeting.",68,90,valuing banks exposure,0,1,1
3RDTX9JRTY2Y7J45KDHBHSQIUXR97F,"The government will also charge two independent auditing firms with valuing banks' exposure to the collapsed property sector, ministers told a news conference after a cabinet meeting.",83,91,exposure,3,5,8
3RDTX9JRTY2Y7J45KDHBHSQIUXR97F,"The government will also charge two independent auditing firms with valuing banks' exposure to the collapsed property sector, ministers told a news conference after a cabinet meeting.",99,108,collapsed,1,5,6
3RDTX9JRTY2Y7J45KDHBHSQIUXR97F,"The government will also charge two independent auditing firms with valuing banks' exposure to the collapsed property sector, ministers told a news conference after a cabinet meeting.",99,124,collapsed property sector,4,1,5
3RDTX9JRTY2Y7J45KDHBHSQIUXR97F,"The government will also charge two independent auditing firms with valuing banks' exposure to the collapsed property sector, ministers told a news conference after a cabinet meeting.",118,124,sector,1,0,1
3RDTX9JRTY2Y7J45KDHBHSQIUXR97F,"The government will also charge two independent auditing firms with valuing banks' exposure to the collapsed property sector, ministers told a news conference after a cabinet meeting.",148,158,conference,1,2,3
3RDTX9JRTY2Y7J45KDHBHSQIUXR97F,"The government will also charge two independent auditing firms with valuing banks' exposure to the collapsed property sector, ministers told a news conference after a cabinet meeting.",167,174,cabinet,0,1,1
3RDTX9JRTY2Y7J45KDHBHSQIUXR97F,"The government will also charge two independent auditing firms with valuing banks' exposure to the collapsed property sector, ministers told a news conference after a cabinet meeting.",167,182,cabinet meeting,2,0,2
3TZ0XG8CBUL27X9OUI9HVSMD5HX982,"Earlier, financial sources had suggested the reform could be partly delayed to allow more time for negotiations between the government and major banks.",0,7,Earlier,0,1,1
3TZ0XG8CBUL27X9OUI9HVSMD5HX982,"Earlier, financial sources had suggested the reform could be partly delayed to allow more time for negotiations between the government and major banks.",9,18,financial,1,1,2
3TZ0XG8CBUL27X9OUI9HVSMD5HX982,"Earlier, financial sources had suggested the reform could be partly delayed to allow more time for negotiations between the government and major banks.",9,26,financial sources,2,1,3
3TZ0XG8CBUL27X9OUI9HVSMD5HX982,"Earlier, financial sources had suggested the reform could be partly delayed to allow more time for negotiations between the government and major banks.",31,40,suggested,1,1,2
3TZ0XG8CBUL27X9OUI9HVSMD5HX982,"Earlier, financial sources had suggested the reform could be partly delayed to allow more time for negotiations between the government and major banks.",45,51,reform,4,4,8
3TZ0XG8CBUL27X9OUI9HVSMD5HX982,"Earlier, financial sources had suggested the reform could be partly delayed to allow more time for negotiations between the government and major banks.",61,75,partly delayed,0,1,1
3TZ0XG8CBUL27X9OUI9HVSMD5HX982,"Earlier, financial sources had suggested the reform could be partly delayed to allow more time for negotiations between the government and major banks.",68,75,delayed,1,3,4
3TZ0XG8CBUL27X9OUI9HVSMD5HX982,"Earlier, financial sources had suggested the reform could be partly delayed to allow more time for negotiations between the government and major banks.",99,111,negotiations,10,6,16
3TZ0XG8CBUL27X9OUI9HVSMD5HX982,Spain is set to intensify the clean-up of its banks on Friday after difficult last-minute talks between the government and lenders on details of planned financial system reforms.,16,25,intensify,9,8,17
3TZ0XG8CBUL27X9OUI9HVSMD5HX982,Spain is set to intensify the clean-up of its banks on Friday after difficult last-minute talks between the government and lenders on details of planned financial system reforms.,16,38,intensify the clean-up,0,1,1
3TZ0XG8CBUL27X9OUI9HVSMD5HX982,Spain is set to intensify the clean-up of its banks on Friday after difficult last-minute talks between the government and lenders on details of planned financial system reforms.,30,38,clean-up,1,1,2
3TZ0XG8CBUL27X9OUI9HVSMD5HX982,Spain is set to intensify the clean-up of its banks on Friday after difficult last-minute talks between the government and lenders on details of planned financial system reforms.,30,51,clean-up of its banks,1,0,1
3TZ0XG8CBUL27X9OUI9HVSMD5HX982,Spain is set to intensify the clean-up of its banks on Friday after difficult last-minute talks between the government and lenders on details of planned financial system reforms.,78,89,last-minute,1,0,1
3TZ0XG8CBUL27X9OUI9HVSMD5HX982,Spain is set to intensify the clean-up of its banks on Friday after difficult last-minute talks between the government and lenders on details of planned financial system reforms.,123,130,lenders,1,4,5
3TZ0XG8CBUL27X9OUI9HVSMD5HX982,Spain is set to intensify the clean-up of its banks on Friday after difficult last-minute talks between the government and lenders on details of planned financial system reforms.,153,162,financial,1,0,1
3TZ0XG8CBUL27X9OUI9HVSMD5HX982,Spain is set to intensify the clean-up of its banks on Friday after difficult last-minute talks between the government and lenders on details of planned financial system reforms.,153,169,financial system,0,1,1
3TZ0XG8CBUL27X9OUI9HVSMD5HX982,Spain is set to intensify the clean-up of its banks on Friday after difficult last-minute talks between the government and lenders on details of planned financial system reforms.,153,177,financial system reforms,3,0,3
3TZ0XG8CBUL27X9OUI9HVSMD5HX982,Spain is set to intensify the clean-up of its banks on Friday after difficult last-minute talks between the government and lenders on details of planned financial system reforms.,170,177,reforms,1,0,1
3TZ0XG8CBUL27X9OUI9HVSMD5HX982,"At its weekly cabinet meeting, the government will approve a plan to force banks to park their toxic real estate assets in holding companies that would later sell them off, a move that could deepen losses for the lenders.",14,21,cabinet,3,0,3
3TZ0XG8CBUL27X9OUI9HVSMD5HX982,"At its weekly cabinet meeting, the government will approve a plan to force banks to park their toxic real estate assets in holding companies that would later sell them off, a move that could deepen losses for the lenders.",14,29,cabinet meeting,2,0,2
3TZ0XG8CBUL27X9OUI9HVSMD5HX982,"At its weekly cabinet meeting, the government will approve a plan to force banks to park their toxic real estate assets in holding companies that would later sell them off, a move that could deepen losses for the lenders.",81,88,to park,0,1,1
3TZ0XG8CBUL27X9OUI9HVSMD5HX982,"At its weekly cabinet meeting, the government will approve a plan to force banks to park their toxic real estate assets in holding companies that would later sell them off, a move that could deepen losses for the lenders.",95,100,toxic,3,4,7
3TZ0XG8CBUL27X9OUI9HVSMD5HX982,"At its weekly cabinet meeting, the government will approve a plan to force banks to park their toxic real estate assets in holding companies that would later sell them off, a move that could deepen losses for the lenders.",95,119,toxic real estate assets,3,3,6
3TZ0XG8CBUL27X9OUI9HVSMD5HX982,"At its weekly cabinet meeting, the government will approve a plan to force banks to park their toxic real estate assets in holding companies that would later sell them off, a move that could deepen losses for the lenders.",101,119,real estate assets,1,0,1
3TZ0XG8CBUL27X9OUI9HVSMD5HX982,"At its weekly cabinet meeting, the government will approve a plan to force banks to park their toxic real estate assets in holding companies that would later sell them off, a move that could deepen losses for the lenders.",106,112,estate,0,2,2
3TZ0XG8CBUL27X9OUI9HVSMD5HX982,"At its weekly cabinet meeting, the government will approve a plan to force banks to park their toxic real estate assets in holding companies that would later sell them off, a move that could deepen losses for the lenders.",113,119,assets,3,1,4
3TZ0XG8CBUL27X9OUI9HVSMD5HX982,"At its weekly cabinet meeting, the government will approve a plan to force banks to park their toxic real estate assets in holding companies that would later sell them off, a move that could deepen losses for the lenders.",123,140,holding companies,1,0,1
3TZ0XG8CBUL27X9OUI9HVSMD5HX982,"At its weekly cabinet meeting, the government will approve a plan to force banks to park their toxic real estate assets in holding companies that would later sell them off, a move that could deepen losses for the lenders.",191,197,deepen,1,3,4
3TZ0XG8CBUL27X9OUI9HVSMD5HX982,"At its weekly cabinet meeting, the government will approve a plan to force banks to park their toxic real estate assets in holding companies that would later sell them off, a move that could deepen losses for the lenders.",191,204,deepen losses,2,1,3
3TZ0XG8CBUL27X9OUI9HVSMD5HX982,"At its weekly cabinet meeting, the government will approve a plan to force banks to park their toxic real estate assets in holding companies that would later sell them off, a move that could deepen losses for the lenders.",213,220,lenders,0,2,2
3TZ0XG8CBUL27X9OUI9HVSMD5HX982,The cabinet is also expected to demand banks to set aside a further 35 billion euros (27.9 billion pounds) to cover sound loans in their real estate portfolios.,4,11,cabinet,3,1,4
3TZ0XG8CBUL27X9OUI9HVSMD5HX982,The cabinet is also expected to demand banks to set aside a further 35 billion euros (27.9 billion pounds) to cover sound loans in their real estate portfolios.,20,38,expected to demand,0,1,1
3TZ0XG8CBUL27X9OUI9HVSMD5HX982,The cabinet is also expected to demand banks to set aside a further 35 billion euros (27.9 billion pounds) to cover sound loans in their real estate portfolios.,32,38,demand,0,1,1
3TZ0XG8CBUL27X9OUI9HVSMD5HX982,The cabinet is also expected to demand banks to set aside a further 35 billion euros (27.9 billion pounds) to cover sound loans in their real estate portfolios.,48,57,set aside,0,1,1
3TZ0XG8CBUL27X9OUI9HVSMD5HX982,The cabinet is also expected to demand banks to set aside a further 35 billion euros (27.9 billion pounds) to cover sound loans in their real estate portfolios.,116,127,sound loans,4,3,7
3TZ0XG8CBUL27X9OUI9HVSMD5HX982,The cabinet is also expected to demand banks to set aside a further 35 billion euros (27.9 billion pounds) to cover sound loans in their real estate portfolios.,137,159,real estate portfolios,5,1,6
3TZ0XG8CBUL27X9OUI9HVSMD5HX982,The cabinet is also expected to demand banks to set aside a further 35 billion euros (27.9 billion pounds) to cover sound loans in their real estate portfolios.,142,159,estate portfolios,0,1,1
3TZ0XG8CBUL27X9OUI9HVSMD5HX982,The cabinet is also expected to demand banks to set aside a further 35 billion euros (27.9 billion pounds) to cover sound loans in their real estate portfolios.,149,159,portfolios,6,7,13
3TZ0XG8CBUL27X9OUI9HVSMD5HX982,The government has already obliged banks to make provisions of 54 billion euros to cover bad assets.,27,34,obliged,7,7,14
3TZ0XG8CBUL27X9OUI9HVSMD5HX982,The government has already obliged banks to make provisions of 54 billion euros to cover bad assets.,49,59,provisions,9,4,13
3TZ0XG8CBUL27X9OUI9HVSMD5HX982,The government has already obliged banks to make provisions of 54 billion euros to cover bad assets.,89,99,bad assets,1,4,5
3TZ0XG8CBUL27X9OUI9HVSMD5HX982,The government has already obliged banks to make provisions of 54 billion euros to cover bad assets.,93,99,assets,2,0,2
30UZJB2POHDX5D16FB14SV904CP357,"Two Chinese maritime surveillance ships, identified as Zhonggou Haijian 75 and Zhonggou Haijian 84, later approached and positioned themselves between the Philippine warship and the Chinese fishing vessels ""thus preventing the arrests of the erring Chinese fishermen"", the statement said.",12,20,maritime,3,3,6
30UZJB2POHDX5D16FB14SV904CP357,"Two Chinese maritime surveillance ships, identified as Zhonggou Haijian 75 and Zhonggou Haijian 84, later approached and positioned themselves between the Philippine warship and the Chinese fishing vessels ""thus preventing the arrests of the erring Chinese fishermen"", the statement said.",12,33,maritime surveillance,6,1,7
30UZJB2POHDX5D16FB14SV904CP357,"Two Chinese maritime surveillance ships, identified as Zhonggou Haijian 75 and Zhonggou Haijian 84, later approached and positioned themselves between the Philippine warship and the Chinese fishing vessels ""thus preventing the arrests of the erring Chinese fishermen"", the statement said.",12,39,maritime surveillance ships,5,1,6
30UZJB2POHDX5D16FB14SV904CP357,"Two Chinese maritime surveillance ships, identified as Zhonggou Haijian 75 and Zhonggou Haijian 84, later approached and positioned themselves between the Philippine warship and the Chinese fishing vessels ""thus preventing the arrests of the erring Chinese fishermen"", the statement said.",21,33,surveillance,5,4,9
30UZJB2POHDX5D16FB14SV904CP357,"Two Chinese maritime surveillance ships, identified as Zhonggou Haijian 75 and Zhonggou Haijian 84, later approached and positioned themselves between the Philippine warship and the Chinese fishing vessels ""thus preventing the arrests of the erring Chinese fishermen"", the statement said.",41,51,identified,0,1,1
30UZJB2POHDX5D16FB14SV904CP357,"Two Chinese maritime surveillance ships, identified as Zhonggou Haijian 75 and Zhonggou Haijian 84, later approached and positioned themselves between the Philippine warship and the Chinese fishing vessels ""thus preventing the arrests of the erring Chinese fishermen"", the statement said.",106,116,approached,2,2,4
30UZJB2POHDX5D16FB14SV904CP357,"Two Chinese maritime surveillance ships, identified as Zhonggou Haijian 75 and Zhonggou Haijian 84, later approached and positioned themselves between the Philippine warship and the Chinese fishing vessels ""thus preventing the arrests of the erring Chinese fishermen"", the statement said.",106,131,approached and positioned,1,0,1
30UZJB2POHDX5D16FB14SV904CP357,"Two Chinese maritime surveillance ships, identified as Zhonggou Haijian 75 and Zhonggou Haijian 84, later approached and positioned themselves between the Philippine warship and the Chinese fishing vessels ""thus preventing the arrests of the erring Chinese fishermen"", the statement said.",121,131,positioned,3,1,4
30UZJB2POHDX5D16FB14SV904CP357,"Two Chinese maritime surveillance ships, identified as Zhonggou Haijian 75 and Zhonggou Haijian 84, later approached and positioned themselves between the Philippine warship and the Chinese fishing vessels ""thus preventing the arrests of the erring Chinese fishermen"", the statement said.",190,205,fishing vessels,2,1,3
30UZJB2POHDX5D16FB14SV904CP357,"Two Chinese maritime surveillance ships, identified as Zhonggou Haijian 75 and Zhonggou Haijian 84, later approached and positioned themselves between the Philippine warship and the Chinese fishing vessels ""thus preventing the arrests of the erring Chinese fishermen"", the statement said.",198,205,vessels,1,2,3
30UZJB2POHDX5D16FB14SV904CP357,"Two Chinese maritime surveillance ships, identified as Zhonggou Haijian 75 and Zhonggou Haijian 84, later approached and positioned themselves between the Philippine warship and the Chinese fishing vessels ""thus preventing the arrests of the erring Chinese fishermen"", the statement said.",212,222,preventing,3,1,4
30UZJB2POHDX5D16FB14SV904CP357,"Two Chinese maritime surveillance ships, identified as Zhonggou Haijian 75 and Zhonggou Haijian 84, later approached and positioned themselves between the Philippine warship and the Chinese fishing vessels ""thus preventing the arrests of the erring Chinese fishermen"", the statement said.",242,248,erring,8,7,15
30UZJB2POHDX5D16FB14SV904CP357,"Chinese officials, who refer to Scarborough Shoal as Huangyan Island, have in the past asserted Chinese sovereignty over the area.",32,43,Scarborough,0,1,1
30UZJB2POHDX5D16FB14SV904CP357,"Chinese officials, who refer to Scarborough Shoal as Huangyan Island, have in the past asserted Chinese sovereignty over the area.",87,95,asserted,10,5,15
30UZJB2POHDX5D16FB14SV904CP357,"Chinese officials, who refer to Scarborough Shoal as Huangyan Island, have in the past asserted Chinese sovereignty over the area.",87,115,asserted Chinese sovereignty,1,0,1
30UZJB2POHDX5D16FB14SV904CP357,"Chinese officials, who refer to Scarborough Shoal as Huangyan Island, have in the past asserted Chinese sovereignty over the area.",96,115,Chinese sovereignty,2,0,2
30UZJB2POHDX5D16FB14SV904CP357,"Chinese officials, who refer to Scarborough Shoal as Huangyan Island, have in the past asserted Chinese sovereignty over the area.",104,115,sovereignty,10,10,20
30UZJB2POHDX5D16FB14SV904CP357,"The Philippines refers to the shoal, a rich fishing ground, as Panatag.",30,35,shoal,9,2,11
30UZJB2POHDX5D16FB14SV904CP357,"The Philippines refers to the shoal, a rich fishing ground, as Panatag.",37,58,a rich fishing ground,1,0,1
30UZJB2POHDX5D16FB14SV904CP357,"Last year the Philippines accused Chinese vessels of intruding into other parts of what it considers Philippine territory near the South China Sea, including the Spratlys.",26,33,accused,1,2,3
30UZJB2POHDX5D16FB14SV904CP357,"Last year the Philippines accused Chinese vessels of intruding into other parts of what it considers Philippine territory near the South China Sea, including the Spratlys.",42,49,vessels,1,1,2
30UZJB2POHDX5D16FB14SV904CP357,"Last year the Philippines accused Chinese vessels of intruding into other parts of what it considers Philippine territory near the South China Sea, including the Spratlys.",53,62,intruding,9,6,15
30UZJB2POHDX5D16FB14SV904CP357,"Last year the Philippines accused Chinese vessels of intruding into other parts of what it considers Philippine territory near the South China Sea, including the Spratlys.",112,121,territory,3,0,3
30UZJB2POHDX5D16FB14SV904CP357,"Last year the Philippines accused Chinese vessels of intruding into other parts of what it considers Philippine territory near the South China Sea, including the Spratlys.",162,170,Spratlys,1,0,1
30UZJB2POHDX5D16FB14SV904CP357,"China has regularly dismissed the protests, saying Beijing has indisputable sovereignty over those areas on historical grounds.",10,29,regularly dismissed,2,0,2
30UZJB2POHDX5D16FB14SV904CP357,"China has regularly dismissed the protests, saying Beijing has indisputable sovereignty over those areas on historical grounds.",20,29,dismissed,1,3,4
30UZJB2POHDX5D16FB14SV904CP357,"China has regularly dismissed the protests, saying Beijing has indisputable sovereignty over those areas on historical grounds.",34,42,protests,0,1,1
30UZJB2POHDX5D16FB14SV904CP357,"China has regularly dismissed the protests, saying Beijing has indisputable sovereignty over those areas on historical grounds.",63,75,indisputable,4,5,9
30UZJB2POHDX5D16FB14SV904CP357,"China has regularly dismissed the protests, saying Beijing has indisputable sovereignty over those areas on historical grounds.",63,87,indisputable sovereignty,8,1,9
30UZJB2POHDX5D16FB14SV904CP357,"China has regularly dismissed the protests, saying Beijing has indisputable sovereignty over those areas on historical grounds.",76,87,sovereignty,3,2,5
30UZJB2POHDX5D16FB14SV904CP357,"China has regularly dismissed the protests, saying Beijing has indisputable sovereignty over those areas on historical grounds.",108,118,historical,1,0,1
30UZJB2POHDX5D16FB14SV904CP357,"China has regularly dismissed the protests, saying Beijing has indisputable sovereignty over those areas on historical grounds.",108,126,historical grounds,1,1,2
30UZJB2POHDX5D16FB14SV904CP357,"Google said on Saturday that Chinese authorities have approved its $12.5 billion (7.9 billion pounds) purchase of Motorola Mobility Holdings, the last regulatory hurdle to a deal that would allow the world's No. 1 Internet search engine to develop its own line of smart phones.",151,161,regulatory,5,0,5
30UZJB2POHDX5D16FB14SV904CP357,"Google said on Saturday that Chinese authorities have approved its $12.5 billion (7.9 billion pounds) purchase of Motorola Mobility Holdings, the last regulatory hurdle to a deal that would allow the world's No. 1 Internet search engine to develop its own line of smart phones.",151,168,regulatory hurdle,8,5,13
30UZJB2POHDX5D16FB14SV904CP357,"Google said on Saturday that Chinese authorities have approved its $12.5 billion (7.9 billion pounds) purchase of Motorola Mobility Holdings, the last regulatory hurdle to a deal that would allow the world's No. 1 Internet search engine to develop its own line of smart phones.",162,168,hurdle,0,3,3
30UZJB2POHDX5D16FB14SV904CP357,"Google said on Saturday that Chinese authorities have approved its $12.5 billion (7.9 billion pounds) purchase of Motorola Mobility Holdings, the last regulatory hurdle to a deal that would allow the world's No. 1 Internet search engine to develop its own line of smart phones.",223,236,search engine,1,0,1
37MQ8Z1JQEX6MJF7MDSWKI21T3T2YB,"It is understood the dead girl had been living at her family home, in a neighbouring housing estate, and was visiting her older sister at the time of the shooting.",6,16,understood,2,1,3
37MQ8Z1JQEX6MJF7MDSWKI21T3T2YB,"It is understood the dead girl had been living at her family home, in a neighbouring housing estate, and was visiting her older sister at the time of the shooting.",72,84,neighbouring,3,3,6
37MQ8Z1JQEX6MJF7MDSWKI21T3T2YB,"It is understood the dead girl had been living at her family home, in a neighbouring housing estate, and was visiting her older sister at the time of the shooting.",72,99,neighbouring housing estate,1,2,3
37MQ8Z1JQEX6MJF7MDSWKI21T3T2YB,"It is understood the dead girl had been living at her family home, in a neighbouring housing estate, and was visiting her older sister at the time of the shooting.",85,99,housing estate,2,3,5
37MQ8Z1JQEX6MJF7MDSWKI21T3T2YB,"It is understood the dead girl had been living at her family home, in a neighbouring housing estate, and was visiting her older sister at the time of the shooting.",93,99,estate,3,2,5
37MQ8Z1JQEX6MJF7MDSWKI21T3T2YB,"Locals reported seeing and speaking with her in the village during the morning, before police were called to the scene at around 10.40am.",7,15,reported,0,2,2
37MQ8Z1JQEX6MJF7MDSWKI21T3T2YB,"Locals reported seeing and speaking with her in the village during the morning, before police were called to the scene at around 10.40am.",113,118,scene,0,3,3
37MQ8Z1JQEX6MJF7MDSWKI21T3T2YB,"Northern Ireland's deputy first minister and Mid-Ulster MP, Martin McGuinness, said his heart went out to the family of the girl tragically killed.",19,25,deputy,0,1,1
37MQ8Z1JQEX6MJF7MDSWKI21T3T2YB,"Northern Ireland's deputy first minister and Mid-Ulster MP, Martin McGuinness, said his heart went out to the family of the girl tragically killed.",19,40,deputy first minister,2,1,3
37MQ8Z1JQEX6MJF7MDSWKI21T3T2YB,"Northern Ireland's deputy first minister and Mid-Ulster MP, Martin McGuinness, said his heart went out to the family of the girl tragically killed.",32,40,minister,1,0,1
37MQ8Z1JQEX6MJF7MDSWKI21T3T2YB,"Northern Ireland's deputy first minister and Mid-Ulster MP, Martin McGuinness, said his heart went out to the family of the girl tragically killed.",45,58,Mid-Ulster MP,1,0,1
37MQ8Z1JQEX6MJF7MDSWKI21T3T2YB,"Northern Ireland's deputy first minister and Mid-Ulster MP, Martin McGuinness, said his heart went out to the family of the girl tragically killed.",88,102,heart went out,1,1,2
37MQ8Z1JQEX6MJF7MDSWKI21T3T2YB,"Northern Ireland's deputy first minister and Mid-Ulster MP, Martin McGuinness, said his heart went out to the family of the girl tragically killed.",129,139,tragically,8,7,15
37MQ8Z1JQEX6MJF7MDSWKI21T3T2YB,"Northern Ireland's deputy first minister and Mid-Ulster MP, Martin McGuinness, said his heart went out to the family of the girl tragically killed.",129,146,tragically killed,0,2,2
37MQ8Z1JQEX6MJF7MDSWKI21T3T2YB,"People I have spoken to in the area this morning are in a state of shock, he said.",14,20,spoken,0,1,1
37MQ8Z1JQEX6MJF7MDSWKI21T3T2YB,"People I have spoken to in the area this morning are in a state of shock, he said.",58,72,state of shock,4,4,8
37MQ8Z1JQEX6MJF7MDSWKI21T3T2YB,I would wish to extend my thoughts and prayers to the family and friends of the victim at this terrible time.,16,22,extend,6,6,12
37MQ8Z1JQEX6MJF7MDSWKI21T3T2YB,I would wish to extend my thoughts and prayers to the family and friends of the victim at this terrible time.,80,86,victim,2,4,6
37MQ8Z1JQEX6MJF7MDSWKI21T3T2YB,I would wish to extend my thoughts and prayers to the family and friends of the victim at this terrible time.,95,103,terrible,1,5,6
37MQ8Z1JQEX6MJF7MDSWKI21T3T2YB,I would wish to extend my thoughts and prayers to the family and friends of the victim at this terrible time.,95,108,terrible time,0,2,2
37MQ8Z1JQEX6MJF7MDSWKI21T3T2YB,A PSNI spokesman said they were alerted to the shooting shortly before 10.40am today.,2,6,PSNI,0,3,3
37MQ8Z1JQEX6MJF7MDSWKI21T3T2YB,A PSNI spokesman said they were alerted to the shooting shortly before 10.40am today.,7,16,spokesman,5,6,11
37MQ8Z1JQEX6MJF7MDSWKI21T3T2YB,A PSNI spokesman said they were alerted to the shooting shortly before 10.40am today.,32,39,alerted,6,6,12
37MQ8Z1JQEX6MJF7MDSWKI21T3T2YB,A PSNI spokesman said they were alerted to the shooting shortly before 10.40am today.,56,63,shortly,0,1,1
3J6BHNX0U9T7R0FJ4HPP3YQO568NKY,"Spain, the eurozone's fourth-largest economy, is in its second recession in three years and is battling to reduce a swollen deficit and 24.4 per cent unemployment.",11,20,eurozones,7,1,8
3J6BHNX0U9T7R0FJ4HPP3YQO568NKY,"Spain, the eurozone's fourth-largest economy, is in its second recession in three years and is battling to reduce a swollen deficit and 24.4 per cent unemployment.",11,43,eurozones fourth-largest economy,1,0,1
3J6BHNX0U9T7R0FJ4HPP3YQO568NKY,"Spain, the eurozone's fourth-largest economy, is in its second recession in three years and is battling to reduce a swollen deficit and 24.4 per cent unemployment.",22,36,fourth-largest,0,1,1
3J6BHNX0U9T7R0FJ4HPP3YQO568NKY,"Spain, the eurozone's fourth-largest economy, is in its second recession in three years and is battling to reduce a swollen deficit and 24.4 per cent unemployment.",63,72,recession,10,10,20
3J6BHNX0U9T7R0FJ4HPP3YQO568NKY,"Spain, the eurozone's fourth-largest economy, is in its second recession in three years and is battling to reduce a swollen deficit and 24.4 per cent unemployment.",95,103,battling,1,3,4
3J6BHNX0U9T7R0FJ4HPP3YQO568NKY,"Spain, the eurozone's fourth-largest economy, is in its second recession in three years and is battling to reduce a swollen deficit and 24.4 per cent unemployment.",107,113,reduce,0,1,1
3J6BHNX0U9T7R0FJ4HPP3YQO568NKY,"Spain, the eurozone's fourth-largest economy, is in its second recession in three years and is battling to reduce a swollen deficit and 24.4 per cent unemployment.",116,123,swollen,3,4,7
3J6BHNX0U9T7R0FJ4HPP3YQO568NKY,"Spain, the eurozone's fourth-largest economy, is in its second recession in three years and is battling to reduce a swollen deficit and 24.4 per cent unemployment.",116,131,swollen deficit,7,8,15
3J6BHNX0U9T7R0FJ4HPP3YQO568NKY,"Spain, the eurozone's fourth-largest economy, is in its second recession in three years and is battling to reduce a swollen deficit and 24.4 per cent unemployment.",124,131,deficit,3,6,9
3J6BHNX0U9T7R0FJ4HPP3YQO568NKY,"Spain, the eurozone's fourth-largest economy, is in its second recession in three years and is battling to reduce a swollen deficit and 24.4 per cent unemployment.",150,162,unemployment,4,3,7
3J6BHNX0U9T7R0FJ4HPP3YQO568NKY,The government is under intense pressure to reduce the deficit from 8.5 of GDP in 2011 to 5.3 per cent this year and to Europe Union limit of three percent in 2013.,4,14,government,1,0,1
3J6BHNX0U9T7R0FJ4HPP3YQO568NKY,The government is under intense pressure to reduce the deficit from 8.5 of GDP in 2011 to 5.3 per cent this year and to Europe Union limit of three percent in 2013.,18,40,under intense pressure,1,0,1
3J6BHNX0U9T7R0FJ4HPP3YQO568NKY,The government is under intense pressure to reduce the deficit from 8.5 of GDP in 2011 to 5.3 per cent this year and to Europe Union limit of three percent in 2013.,24,31,intense,3,8,11
3J6BHNX0U9T7R0FJ4HPP3YQO568NKY,The government is under intense pressure to reduce the deficit from 8.5 of GDP in 2011 to 5.3 per cent this year and to Europe Union limit of three percent in 2013.,24,40,intense pressure,1,1,2
3J6BHNX0U9T7R0FJ4HPP3YQO568NKY,The government is under intense pressure to reduce the deficit from 8.5 of GDP in 2011 to 5.3 per cent this year and to Europe Union limit of three percent in 2013.,55,62,deficit,6,0,6
3J6BHNX0U9T7R0FJ4HPP3YQO568NKY,The government is under intense pressure to reduce the deficit from 8.5 of GDP in 2011 to 5.3 per cent this year and to Europe Union limit of three percent in 2013.,75,78,GDP,2,0,2
3J6BHNX0U9T7R0FJ4HPP3YQO568NKY,The government is under intense pressure to reduce the deficit from 8.5 of GDP in 2011 to 5.3 per cent this year and to Europe Union limit of three percent in 2013.,120,132,Europe Union,1,0,1
3J6BHNX0U9T7R0FJ4HPP3YQO568NKY,"But the European Union painted a grim picture of Spain's economy hours ahead of the reform, saying the country's GDP will shrink 1.8 per cent this year — compared with the 1.7 per cent drop predicted by Madrid — and that the deficit will come in at 6.4 per cent of output, not 5.3 per cent, because of overspending by regional governments.",23,30,painted,1,2,3
3J6BHNX0U9T7R0FJ4HPP3YQO568NKY,"But the European Union painted a grim picture of Spain's economy hours ahead of the reform, saying the country's GDP will shrink 1.8 per cent this year — compared with the 1.7 per cent drop predicted by Madrid — and that the deficit will come in at 6.4 per cent of output, not 5.3 per cent, because of overspending by regional governments.",23,45,painted a grim picture,3,0,3
3J6BHNX0U9T7R0FJ4HPP3YQO568NKY,"But the European Union painted a grim picture of Spain's economy hours ahead of the reform, saying the country's GDP will shrink 1.8 per cent this year — compared with the 1.7 per cent drop predicted by Madrid — and that the deficit will come in at 6.4 per cent of output, not 5.3 per cent, because of overspending by regional governments.",33,37,grim,3,8,11
3J6BHNX0U9T7R0FJ4HPP3YQO568NKY,"But the European Union painted a grim picture of Spain's economy hours ahead of the reform, saying the country's GDP will shrink 1.8 per cent this year — compared with the 1.7 per cent drop predicted by Madrid — and that the deficit will come in at 6.4 per cent of output, not 5.3 per cent, because of overspending by regional governments.",33,45,grim picture,1,3,4
3J6BHNX0U9T7R0FJ4HPP3YQO568NKY,"But the European Union painted a grim picture of Spain's economy hours ahead of the reform, saying the country's GDP will shrink 1.8 per cent this year — compared with the 1.7 per cent drop predicted by Madrid — and that the deficit will come in at 6.4 per cent of output, not 5.3 per cent, because of overspending by regional governments.",84,90,reform,2,5,7
3J6BHNX0U9T7R0FJ4HPP3YQO568NKY,"But the European Union painted a grim picture of Spain's economy hours ahead of the reform, saying the country's GDP will shrink 1.8 per cent this year — compared with the 1.7 per cent drop predicted by Madrid — and that the deficit will come in at 6.4 per cent of output, not 5.3 per cent, because of overspending by regional governments.",113,116,GDP,2,0,2
3J6BHNX0U9T7R0FJ4HPP3YQO568NKY,"But the European Union painted a grim picture of Spain's economy hours ahead of the reform, saying the country's GDP will shrink 1.8 per cent this year — compared with the 1.7 per cent drop predicted by Madrid — and that the deficit will come in at 6.4 per cent of output, not 5.3 per cent, because of overspending by regional governments.",122,128,shrink,2,8,10
3J6BHNX0U9T7R0FJ4HPP3YQO568NKY,"But the European Union painted a grim picture of Spain's economy hours ahead of the reform, saying the country's GDP will shrink 1.8 per cent this year — compared with the 1.7 per cent drop predicted by Madrid — and that the deficit will come in at 6.4 per cent of output, not 5.3 per cent, because of overspending by regional governments.",185,189,drop,0,1,1
3J6BHNX0U9T7R0FJ4HPP3YQO568NKY,"But the European Union painted a grim picture of Spain's economy hours ahead of the reform, saying the country's GDP will shrink 1.8 per cent this year — compared with the 1.7 per cent drop predicted by Madrid — and that the deficit will come in at 6.4 per cent of output, not 5.3 per cent, because of overspending by regional governments.",190,199,predicted,4,6,10
3J6BHNX0U9T7R0FJ4HPP3YQO568NKY,"But the European Union painted a grim picture of Spain's economy hours ahead of the reform, saying the country's GDP will shrink 1.8 per cent this year — compared with the 1.7 per cent drop predicted by Madrid — and that the deficit will come in at 6.4 per cent of output, not 5.3 per cent, because of overspending by regional governments.",203,209,Madrid,0,1,1
3J6BHNX0U9T7R0FJ4HPP3YQO568NKY,"But the European Union painted a grim picture of Spain's economy hours ahead of the reform, saying the country's GDP will shrink 1.8 per cent this year — compared with the 1.7 per cent drop predicted by Madrid — and that the deficit will come in at 6.4 per cent of output, not 5.3 per cent, because of overspending by regional governments.",225,232,deficit,4,1,5
3J6BHNX0U9T7R0FJ4HPP3YQO568NKY,"But the European Union painted a grim picture of Spain's economy hours ahead of the reform, saying the country's GDP will shrink 1.8 per cent this year — compared with the 1.7 per cent drop predicted by Madrid — and that the deficit will come in at 6.4 per cent of output, not 5.3 per cent, because of overspending by regional governments.",265,271,output,2,1,3
3J6BHNX0U9T7R0FJ4HPP3YQO568NKY,"But the European Union painted a grim picture of Spain's economy hours ahead of the reform, saying the country's GDP will shrink 1.8 per cent this year — compared with the 1.7 per cent drop predicted by Madrid — and that the deficit will come in at 6.4 per cent of output, not 5.3 per cent, because of overspending by regional governments.",302,314,overspending,1,10,11
3J6BHNX0U9T7R0FJ4HPP3YQO568NKY,"But the European Union painted a grim picture of Spain's economy hours ahead of the reform, saying the country's GDP will shrink 1.8 per cent this year — compared with the 1.7 per cent drop predicted by Madrid — and that the deficit will come in at 6.4 per cent of output, not 5.3 per cent, because of overspending by regional governments.",302,338,overspending by regional governments,1,0,1
3J6BHNX0U9T7R0FJ4HPP3YQO568NKY,"But the European Union painted a grim picture of Spain's economy hours ahead of the reform, saying the country's GDP will shrink 1.8 per cent this year — compared with the 1.7 per cent drop predicted by Madrid — and that the deficit will come in at 6.4 per cent of output, not 5.3 per cent, because of overspending by regional governments.",318,338,regional governments,1,0,1
3FBEFUUYRK6T8205T9QJ791654P6AS,"Also Monday, the Observatory and the LCC said government troops stormed the Damascus suburb of Qaboun where they conducted raids and deployed snipers on roofs of buildings.",17,28,Observatory,3,3,6
3FBEFUUYRK6T8205T9QJ791654P6AS,"Also Monday, the Observatory and the LCC said government troops stormed the Damascus suburb of Qaboun where they conducted raids and deployed snipers on roofs of buildings.",37,40,LCC,1,1,2
3FBEFUUYRK6T8205T9QJ791654P6AS,"Also Monday, the Observatory and the LCC said government troops stormed the Damascus suburb of Qaboun where they conducted raids and deployed snipers on roofs of buildings.",46,56,government,1,0,1
3FBEFUUYRK6T8205T9QJ791654P6AS,"Also Monday, the Observatory and the LCC said government troops stormed the Damascus suburb of Qaboun where they conducted raids and deployed snipers on roofs of buildings.",64,71,stormed,4,10,14
3FBEFUUYRK6T8205T9QJ791654P6AS,"Also Monday, the Observatory and the LCC said government troops stormed the Damascus suburb of Qaboun where they conducted raids and deployed snipers on roofs of buildings.",76,84,Damascus,1,0,1
3FBEFUUYRK6T8205T9QJ791654P6AS,"Also Monday, the Observatory and the LCC said government troops stormed the Damascus suburb of Qaboun where they conducted raids and deployed snipers on roofs of buildings.",85,91,suburb,6,3,9
3FBEFUUYRK6T8205T9QJ791654P6AS,"Also Monday, the Observatory and the LCC said government troops stormed the Damascus suburb of Qaboun where they conducted raids and deployed snipers on roofs of buildings.",95,101,Qaboun,2,0,2
3FBEFUUYRK6T8205T9QJ791654P6AS,"Also Monday, the Observatory and the LCC said government troops stormed the Damascus suburb of Qaboun where they conducted raids and deployed snipers on roofs of buildings.",113,122,conducted,3,0,3
3FBEFUUYRK6T8205T9QJ791654P6AS,"Also Monday, the Observatory and the LCC said government troops stormed the Damascus suburb of Qaboun where they conducted raids and deployed snipers on roofs of buildings.",123,128,raids,2,0,2
3FBEFUUYRK6T8205T9QJ791654P6AS,"Also Monday, the Observatory and the LCC said government troops stormed the Damascus suburb of Qaboun where they conducted raids and deployed snipers on roofs of buildings.",133,141,deployed,5,7,12
3FBEFUUYRK6T8205T9QJ791654P6AS,"Also Monday, the Observatory and the LCC said government troops stormed the Damascus suburb of Qaboun where they conducted raids and deployed snipers on roofs of buildings.",133,149,deployed snipers,3,4,7
3FBEFUUYRK6T8205T9QJ791654P6AS,"Also Monday, the Observatory and the LCC said government troops stormed the Damascus suburb of Qaboun where they conducted raids and deployed snipers on roofs of buildings.",142,149,snipers,4,6,10
3FBEFUUYRK6T8205T9QJ791654P6AS,"In Damascus, state-run TV said the results of last week's parliamentary elections will be made public Tuesday.",13,22,state-run,2,0,2
3FBEFUUYRK6T8205T9QJ791654P6AS,"In Damascus, state-run TV said the results of last week's parliamentary elections will be made public Tuesday.",13,25,state-run TV,2,0,2
3FBEFUUYRK6T8205T9QJ791654P6AS,"In Damascus, state-run TV said the results of last week's parliamentary elections will be made public Tuesday.",58,71,parliamentary,6,1,7
3FBEFUUYRK6T8205T9QJ791654P6AS,"In Damascus, state-run TV said the results of last week's parliamentary elections will be made public Tuesday.",58,81,parliamentary elections,1,0,1
3FBEFUUYRK6T8205T9QJ791654P6AS,"The government has praised the vote as a milestone in promised political reforms, but the opposition boycotted the polls and said they were designed to strengthen Assad's grip on power.",4,14,government,1,0,1
3FBEFUUYRK6T8205T9QJ791654P6AS,"The government has praised the vote as a milestone in promised political reforms, but the opposition boycotted the polls and said they were designed to strengthen Assad's grip on power.",19,26,praised,1,1,2
3FBEFUUYRK6T8205T9QJ791654P6AS,"The government has praised the vote as a milestone in promised political reforms, but the opposition boycotted the polls and said they were designed to strengthen Assad's grip on power.",27,50,the vote as a milestone,0,1,1
3FBEFUUYRK6T8205T9QJ791654P6AS,"The government has praised the vote as a milestone in promised political reforms, but the opposition boycotted the polls and said they were designed to strengthen Assad's grip on power.",41,50,milestone,7,4,11
3FBEFUUYRK6T8205T9QJ791654P6AS,"The government has praised the vote as a milestone in promised political reforms, but the opposition boycotted the polls and said they were designed to strengthen Assad's grip on power.",41,80,milestone in promised political reforms,1,0,1
3FBEFUUYRK6T8205T9QJ791654P6AS,"The government has praised the vote as a milestone in promised political reforms, but the opposition boycotted the polls and said they were designed to strengthen Assad's grip on power.",63,80,political reforms,3,1,4
3FBEFUUYRK6T8205T9QJ791654P6AS,"The government has praised the vote as a milestone in promised political reforms, but the opposition boycotted the polls and said they were designed to strengthen Assad's grip on power.",73,80,reforms,1,2,3
3FBEFUUYRK6T8205T9QJ791654P6AS,"The government has praised the vote as a milestone in promised political reforms, but the opposition boycotted the polls and said they were designed to strengthen Assad's grip on power.",90,100,opposition,2,0,2
3FBEFUUYRK6T8205T9QJ791654P6AS,"The government has praised the vote as a milestone in promised political reforms, but the opposition boycotted the polls and said they were designed to strengthen Assad's grip on power.",101,110,boycotted,10,10,20
3FBEFUUYRK6T8205T9QJ791654P6AS,"The government has praised the vote as a milestone in promised political reforms, but the opposition boycotted the polls and said they were designed to strengthen Assad's grip on power.",101,120,boycotted the polls,1,0,1
3FBEFUUYRK6T8205T9QJ791654P6AS,"The government has praised the vote as a milestone in promised political reforms, but the opposition boycotted the polls and said they were designed to strengthen Assad's grip on power.",115,120,polls,1,0,1
3FBEFUUYRK6T8205T9QJ791654P6AS,"The government has praised the vote as a milestone in promised political reforms, but the opposition boycotted the polls and said they were designed to strengthen Assad's grip on power.",140,148,designed,1,1,2
3FBEFUUYRK6T8205T9QJ791654P6AS,"The government has praised the vote as a milestone in promised political reforms, but the opposition boycotted the polls and said they were designed to strengthen Assad's grip on power.",152,162,strengthen,0,1,1
3FBEFUUYRK6T8205T9QJ791654P6AS,"The government has praised the vote as a milestone in promised political reforms, but the opposition boycotted the polls and said they were designed to strengthen Assad's grip on power.",163,169,Assads,1,0,1
3FBEFUUYRK6T8205T9QJ791654P6AS,"The government has praised the vote as a milestone in promised political reforms, but the opposition boycotted the polls and said they were designed to strengthen Assad's grip on power.",171,175,grip,1,1,2
3FBEFUUYRK6T8205T9QJ791654P6AS,Syria's uprising started in March 2011 with protests calling for political reform.,8,16,uprising,1,4,5
3FBEFUUYRK6T8205T9QJ791654P6AS,Syria's uprising started in March 2011 with protests calling for political reform.,44,52,protests,0,1,1
3FBEFUUYRK6T8205T9QJ791654P6AS,Syria's uprising started in March 2011 with protests calling for political reform.,65,74,political,1,0,1
3FBEFUUYRK6T8205T9QJ791654P6AS,Syria's uprising started in March 2011 with protests calling for political reform.,65,81,political reform,3,0,3
3FBEFUUYRK6T8205T9QJ791654P6AS,Syria's uprising started in March 2011 with protests calling for political reform.,75,81,reform,0,2,2
3FBEFUUYRK6T8205T9QJ791654P6AS,"The government brutally cracked down on dissent, and many in the opposition have since taken up arms to defend themselves and attack government troops.",15,23,brutally,5,4,9
3FBEFUUYRK6T8205T9QJ791654P6AS,"The government brutally cracked down on dissent, and many in the opposition have since taken up arms to defend themselves and attack government troops.",15,36,brutally cracked down,1,0,1
3FBEFUUYRK6T8205T9QJ791654P6AS,"The government brutally cracked down on dissent, and many in the opposition have since taken up arms to defend themselves and attack government troops.",24,31,cracked,0,1,1
3FBEFUUYRK6T8205T9QJ791654P6AS,"The government brutally cracked down on dissent, and many in the opposition have since taken up arms to defend themselves and attack government troops.",24,36,cracked down,0,4,4
3FBEFUUYRK6T8205T9QJ791654P6AS,"The government brutally cracked down on dissent, and many in the opposition have since taken up arms to defend themselves and attack government troops.",40,47,dissent,6,7,13
3FBEFUUYRK6T8205T9QJ791654P6AS,"The government brutally cracked down on dissent, and many in the opposition have since taken up arms to defend themselves and attack government troops.",65,75,opposition,1,0,1
3FBEFUUYRK6T8205T9QJ791654P6AS,Some soldiers also have switched sides and joined forces with the rebels.,24,38,switched sides,1,3,4
3FBEFUUYRK6T8205T9QJ791654P6AS,Some soldiers also have switched sides and joined forces with the rebels.,66,72,rebels,2,3,5
3ZG552ORAM5PIPK2H25CDJY7BMRV2V,"A mother shot and killed her four children before turning a gun on herself in a small town in Florida on Tuesday, authorities said.",50,74,turning a gun on herself,0,1,1
3ZG552ORAM5PIPK2H25CDJY7BMRV2V,"A mother shot and killed her four children before turning a gun on herself in a small town in Florida on Tuesday, authorities said.",114,125,authorities,7,5,12
3ZG552ORAM5PIPK2H25CDJY7BMRV2V,"The shooting happened at a house in Port St. John, in Brevard County, about 15 miles from NASA's Kennedy Space Center.",4,21,shooting happened,1,0,1
3ZG552ORAM5PIPK2H25CDJY7BMRV2V,"The shooting happened at a house in Port St. John, in Brevard County, about 15 miles from NASA's Kennedy Space Center.",13,21,happened,0,1,1
3ZG552ORAM5PIPK2H25CDJY7BMRV2V,"The shooting happened at a house in Port St. John, in Brevard County, about 15 miles from NASA's Kennedy Space Center.",97,117,Kennedy Space Center,1,0,1
3ZG552ORAM5PIPK2H25CDJY7BMRV2V,"A spokesman for the Brevard County Sheriff's office identified the victims as four children aged 12, 13, 15 and 17.",2,11,spokesman,5,7,12
3ZG552ORAM5PIPK2H25CDJY7BMRV2V,"A spokesman for the Brevard County Sheriff's office identified the victims as four children aged 12, 13, 15 and 17.",20,34,Brevard County,0,1,1
3ZG552ORAM5PIPK2H25CDJY7BMRV2V,"A spokesman for the Brevard County Sheriff's office identified the victims as four children aged 12, 13, 15 and 17.",35,42,Sheriff,1,0,1
3ZG552ORAM5PIPK2H25CDJY7BMRV2V,"A spokesman for the Brevard County Sheriff's office identified the victims as four children aged 12, 13, 15 and 17.",35,50,Sheriffs office,1,0,1
3ZG552ORAM5PIPK2H25CDJY7BMRV2V,"A spokesman for the Brevard County Sheriff's office identified the victims as four children aged 12, 13, 15 and 17.",52,62,identified,6,3,9
3ZG552ORAM5PIPK2H25CDJY7BMRV2V,"A spokesman for the Brevard County Sheriff's office identified the victims as four children aged 12, 13, 15 and 17.",67,74,victims,2,8,10
3ZG552ORAM5PIPK2H25CDJY7BMRV2V,"They were shot by their 33-year-old mother, Tonya Thomas, who then turned the gun on herself, Tod Goodyear said.",67,81,turned the gun,1,0,1
3ZG552ORAM5PIPK2H25CDJY7BMRV2V,"All were shot with what appeared to be a handgun, he said.",24,32,appeared,2,3,5
3ZG552ORAM5PIPK2H25CDJY7BMRV2V,"All were shot with what appeared to be a handgun, he said.",41,48,handgun,0,3,3
3ZG552ORAM5PIPK2H25CDJY7BMRV2V,Goodyear said a neighbor called police before dawn on Tuesday to report gunfire.,16,24,neighbor,2,2,4
3ZG552ORAM5PIPK2H25CDJY7BMRV2V,Goodyear said a neighbor called police before dawn on Tuesday to report gunfire.,46,50,dawn,3,7,10
3ZG552ORAM5PIPK2H25CDJY7BMRV2V,Goodyear said a neighbor called police before dawn on Tuesday to report gunfire.,65,71,report,1,0,1
3ZG552ORAM5PIPK2H25CDJY7BMRV2V,Goodyear said a neighbor called police before dawn on Tuesday to report gunfire.,72,79,gunfire,0,1,1
3ZG552ORAM5PIPK2H25CDJY7BMRV2V,"When police arrived they found a fatally injured 17-year-old girl in the front yard of the house, which is in a quiet neighborhood of single family residences.",33,40,fatally,6,5,11
3ZG552ORAM5PIPK2H25CDJY7BMRV2V,"When police arrived they found a fatally injured 17-year-old girl in the front yard of the house, which is in a quiet neighborhood of single family residences.",33,48,fatally injured,4,5,9
3ZG552ORAM5PIPK2H25CDJY7BMRV2V,"When police arrived they found a fatally injured 17-year-old girl in the front yard of the house, which is in a quiet neighborhood of single family residences.",118,130,neighborhood,2,3,5
3ZG552ORAM5PIPK2H25CDJY7BMRV2V,"When police arrived they found a fatally injured 17-year-old girl in the front yard of the house, which is in a quiet neighborhood of single family residences.",134,158,single family residences,4,0,4
3ZG552ORAM5PIPK2H25CDJY7BMRV2V,"When police arrived they found a fatally injured 17-year-old girl in the front yard of the house, which is in a quiet neighborhood of single family residences.",148,158,residences,6,4,10
31N9JPQXIPJGPAEBYWMSQ6AWDP4NHU,"Spain's government tried to plug a gaping hole in the country's banking system on Friday, but the fourth such attempt to tackle the fallout of a property crash fell short of expectations.",28,32,plug,0,2,2
31N9JPQXIPJGPAEBYWMSQ6AWDP4NHU,"Spain's government tried to plug a gaping hole in the country's banking system on Friday, but the fourth such attempt to tackle the fallout of a property crash fell short of expectations.",28,46,plug a gaping hole,1,1,2
31N9JPQXIPJGPAEBYWMSQ6AWDP4NHU,"Spain's government tried to plug a gaping hole in the country's banking system on Friday, but the fourth such attempt to tackle the fallout of a property crash fell short of expectations.",35,41,gaping,7,5,12
31N9JPQXIPJGPAEBYWMSQ6AWDP4NHU,"Spain's government tried to plug a gaping hole in the country's banking system on Friday, but the fourth such attempt to tackle the fallout of a property crash fell short of expectations.",35,46,gaping hole,2,3,5
31N9JPQXIPJGPAEBYWMSQ6AWDP4NHU,"Spain's government tried to plug a gaping hole in the country's banking system on Friday, but the fourth such attempt to tackle the fallout of a property crash fell short of expectations.",121,127,tackle,4,5,9
31N9JPQXIPJGPAEBYWMSQ6AWDP4NHU,"Spain's government tried to plug a gaping hole in the country's banking system on Friday, but the fourth such attempt to tackle the fallout of a property crash fell short of expectations.",121,139,tackle the fallout,0,1,1
31N9JPQXIPJGPAEBYWMSQ6AWDP4NHU,"Spain's government tried to plug a gaping hole in the country's banking system on Friday, but the fourth such attempt to tackle the fallout of a property crash fell short of expectations.",132,139,fallout,8,4,12
31N9JPQXIPJGPAEBYWMSQ6AWDP4NHU,"Spain's government tried to plug a gaping hole in the country's banking system on Friday, but the fourth such attempt to tackle the fallout of a property crash fell short of expectations.",132,159,fallout of a property crash,0,1,1
31N9JPQXIPJGPAEBYWMSQ6AWDP4NHU,"Spain's government tried to plug a gaping hole in the country's banking system on Friday, but the fourth such attempt to tackle the fallout of a property crash fell short of expectations.",145,153,property,1,0,1
31N9JPQXIPJGPAEBYWMSQ6AWDP4NHU,"Spain's government tried to plug a gaping hole in the country's banking system on Friday, but the fourth such attempt to tackle the fallout of a property crash fell short of expectations.",145,159,property crash,3,0,3
31N9JPQXIPJGPAEBYWMSQ6AWDP4NHU,"Spain's government tried to plug a gaping hole in the country's banking system on Friday, but the fourth such attempt to tackle the fallout of a property crash fell short of expectations.",154,159,crash,0,1,1
31N9JPQXIPJGPAEBYWMSQ6AWDP4NHU,"Spain's government tried to plug a gaping hole in the country's banking system on Friday, but the fourth such attempt to tackle the fallout of a property crash fell short of expectations.",160,164,fell,0,1,1
31N9JPQXIPJGPAEBYWMSQ6AWDP4NHU,"Spain's government tried to plug a gaping hole in the country's banking system on Friday, but the fourth such attempt to tackle the fallout of a property crash fell short of expectations.",160,170,fell short,0,2,2
31N9JPQXIPJGPAEBYWMSQ6AWDP4NHU,"Spain's government tried to plug a gaping hole in the country's banking system on Friday, but the fourth such attempt to tackle the fallout of a property crash fell short of expectations.",174,186,expectations,4,2,6
31N9JPQXIPJGPAEBYWMSQ6AWDP4NHU,"The centre-right government offered high-interest loans to banks on the brink in a crisis which is shaking the euro zone, and ordered an independent audit of lending across the entire banking sector, as the European Union had asked.",4,16,centre-right,3,1,4
31N9JPQXIPJGPAEBYWMSQ6AWDP4NHU,"The centre-right government offered high-interest loans to banks on the brink in a crisis which is shaking the euro zone, and ordered an independent audit of lending across the entire banking sector, as the European Union had asked.",4,27,centre-right government,1,1,2
31N9JPQXIPJGPAEBYWMSQ6AWDP4NHU,"The centre-right government offered high-interest loans to banks on the brink in a crisis which is shaking the euro zone, and ordered an independent audit of lending across the entire banking sector, as the European Union had asked.",28,35,offered,0,1,1
31N9JPQXIPJGPAEBYWMSQ6AWDP4NHU,"The centre-right government offered high-interest loans to banks on the brink in a crisis which is shaking the euro zone, and ordered an independent audit of lending across the entire banking sector, as the European Union had asked.",36,49,high-interest,1,1,2
31N9JPQXIPJGPAEBYWMSQ6AWDP4NHU,"The centre-right government offered high-interest loans to banks on the brink in a crisis which is shaking the euro zone, and ordered an independent audit of lending across the entire banking sector, as the European Union had asked.",36,55,high-interest loans,2,1,3
31N9JPQXIPJGPAEBYWMSQ6AWDP4NHU,"The centre-right government offered high-interest loans to banks on the brink in a crisis which is shaking the euro zone, and ordered an independent audit of lending across the entire banking sector, as the European Union had asked.",72,77,brink,5,4,9
31N9JPQXIPJGPAEBYWMSQ6AWDP4NHU,"The centre-right government offered high-interest loans to banks on the brink in a crisis which is shaking the euro zone, and ordered an independent audit of lending across the entire banking sector, as the European Union had asked.",72,89,brink in a crisis,0,1,1
31N9JPQXIPJGPAEBYWMSQ6AWDP4NHU,"The centre-right government offered high-interest loans to banks on the brink in a crisis which is shaking the euro zone, and ordered an independent audit of lending across the entire banking sector, as the European Union had asked.",83,89,crisis,3,3,6
31N9JPQXIPJGPAEBYWMSQ6AWDP4NHU,"The centre-right government offered high-interest loans to banks on the brink in a crisis which is shaking the euro zone, and ordered an independent audit of lending across the entire banking sector, as the European Union had asked.",99,106,shaking,0,1,1
31N9JPQXIPJGPAEBYWMSQ6AWDP4NHU,"The centre-right government offered high-interest loans to banks on the brink in a crisis which is shaking the euro zone, and ordered an independent audit of lending across the entire banking sector, as the European Union had asked.",111,120,euro zone,1,0,1
31N9JPQXIPJGPAEBYWMSQ6AWDP4NHU,"The centre-right government offered high-interest loans to banks on the brink in a crisis which is shaking the euro zone, and ordered an independent audit of lending across the entire banking sector, as the European Union had asked.",137,148,independent,2,1,3
31N9JPQXIPJGPAEBYWMSQ6AWDP4NHU,"The centre-right government offered high-interest loans to banks on the brink in a crisis which is shaking the euro zone, and ordered an independent audit of lending across the entire banking sector, as the European Union had asked.",137,154,independent audit,2,0,2
31N9JPQXIPJGPAEBYWMSQ6AWDP4NHU,"The centre-right government offered high-interest loans to banks on the brink in a crisis which is shaking the euro zone, and ordered an independent audit of lending across the entire banking sector, as the European Union had asked.",137,165,independent audit of lending,0,1,1
31N9JPQXIPJGPAEBYWMSQ6AWDP4NHU,"The centre-right government offered high-interest loans to banks on the brink in a crisis which is shaking the euro zone, and ordered an independent audit of lending across the entire banking sector, as the European Union had asked.",149,154,audit,5,1,6
31N9JPQXIPJGPAEBYWMSQ6AWDP4NHU,"The centre-right government offered high-interest loans to banks on the brink in a crisis which is shaking the euro zone, and ordered an independent audit of lending across the entire banking sector, as the European Union had asked.",158,165,lending,0,1,1
31N9JPQXIPJGPAEBYWMSQ6AWDP4NHU,"The centre-right government offered high-interest loans to banks on the brink in a crisis which is shaking the euro zone, and ordered an independent audit of lending across the entire banking sector, as the European Union had asked.",184,198,banking sector,1,0,1
31N9JPQXIPJGPAEBYWMSQ6AWDP4NHU,"This is not the definitive clean-up framework that the market is clamoring for, said Nicholas Spiro from Spiro Sovereign Strategy.",17,27,definitive,6,3,9
31N9JPQXIPJGPAEBYWMSQ6AWDP4NHU,"This is not the definitive clean-up framework that the market is clamoring for, said Nicholas Spiro from Spiro Sovereign Strategy.",17,46,definitive clean-up framework,0,2,2
31N9JPQXIPJGPAEBYWMSQ6AWDP4NHU,"This is not the definitive clean-up framework that the market is clamoring for, said Nicholas Spiro from Spiro Sovereign Strategy.",28,46,clean-up framework,1,1,2
31N9JPQXIPJGPAEBYWMSQ6AWDP4NHU,"This is not the definitive clean-up framework that the market is clamoring for, said Nicholas Spiro from Spiro Sovereign Strategy.",37,46,framework,2,5,7
31N9JPQXIPJGPAEBYWMSQ6AWDP4NHU,"This is not the definitive clean-up framework that the market is clamoring for, said Nicholas Spiro from Spiro Sovereign Strategy.",66,75,clamoring,10,7,17
31N9JPQXIPJGPAEBYWMSQ6AWDP4NHU,"This is not the definitive clean-up framework that the market is clamoring for, said Nicholas Spiro from Spiro Sovereign Strategy.",66,79,clamoring for,0,1,1
31N9JPQXIPJGPAEBYWMSQ6AWDP4NHU,"This is not the definitive clean-up framework that the market is clamoring for, said Nicholas Spiro from Spiro Sovereign Strategy.",107,131,Spiro Sovereign Strategy,2,0,2
31N9JPQXIPJGPAEBYWMSQ6AWDP4NHU,"This is not the definitive clean-up framework that the market is clamoring for, said Nicholas Spiro from Spiro Sovereign Strategy.",113,122,Sovereign,1,1,2
31N9JPQXIPJGPAEBYWMSQ6AWDP4NHU,"This is not the definitive clean-up framework that the market is clamoring for, said Nicholas Spiro from Spiro Sovereign Strategy.",113,131,Sovereign Strategy,0,1,1
31N9JPQXIPJGPAEBYWMSQ6AWDP4NHU,"This is not the definitive clean-up framework that the market is clamoring for, said Nicholas Spiro from Spiro Sovereign Strategy.",123,131,Strategy,0,2,2
31N9JPQXIPJGPAEBYWMSQ6AWDP4NHU,"Spanish bank restructuring is a moving target: the deeper the economic downturn, the greater the uncertainty about the size of the sector's provisioning needs.",14,27,restructuring,9,5,14
31N9JPQXIPJGPAEBYWMSQ6AWDP4NHU,"Spanish bank restructuring is a moving target: the deeper the economic downturn, the greater the uncertainty about the size of the sector's provisioning needs.",33,46,moving target,1,0,1
31N9JPQXIPJGPAEBYWMSQ6AWDP4NHU,"Spanish bank restructuring is a moving target: the deeper the economic downturn, the greater the uncertainty about the size of the sector's provisioning needs.",63,71,economic,1,0,1
31N9JPQXIPJGPAEBYWMSQ6AWDP4NHU,"Spanish bank restructuring is a moving target: the deeper the economic downturn, the greater the uncertainty about the size of the sector's provisioning needs.",63,80,economic downturn,5,1,6
31N9JPQXIPJGPAEBYWMSQ6AWDP4NHU,"Spanish bank restructuring is a moving target: the deeper the economic downturn, the greater the uncertainty about the size of the sector's provisioning needs.",72,80,downturn,3,5,8
31N9JPQXIPJGPAEBYWMSQ6AWDP4NHU,"Spanish bank restructuring is a moving target: the deeper the economic downturn, the greater the uncertainty about the size of the sector's provisioning needs.",98,109,uncertainty,2,2,4
31N9JPQXIPJGPAEBYWMSQ6AWDP4NHU,"Spanish bank restructuring is a moving target: the deeper the economic downturn, the greater the uncertainty about the size of the sector's provisioning needs.",132,139,sectors,2,0,2
31N9JPQXIPJGPAEBYWMSQ6AWDP4NHU,"Spanish bank restructuring is a moving target: the deeper the economic downturn, the greater the uncertainty about the size of the sector's provisioning needs.",132,158,sectors provisioning needs,1,0,1
31N9JPQXIPJGPAEBYWMSQ6AWDP4NHU,"Spanish bank restructuring is a moving target: the deeper the economic downturn, the greater the uncertainty about the size of the sector's provisioning needs.",141,153,provisioning,6,4,10
31N9JPQXIPJGPAEBYWMSQ6AWDP4NHU,"Spanish bank restructuring is a moving target: the deeper the economic downturn, the greater the uncertainty about the size of the sector's provisioning needs.",141,159,provisioning needs,1,3,4
31N9JPQXIPJGPAEBYWMSQ6AWDP4NHU,"Spain's troubled banks, with more than 184 billion euros ($238 billion) in problem loans and assets after the property bubble burst four years ago, lie at the core of the euro zone debt crisis due to fears that a massive rescue could push Spanish public finances to breaking point.",75,99,problem loans and assets,1,0,1
31N9JPQXIPJGPAEBYWMSQ6AWDP4NHU,"Spain's troubled banks, with more than 184 billion euros ($238 billion) in problem loans and assets after the property bubble burst four years ago, lie at the core of the euro zone debt crisis due to fears that a massive rescue could push Spanish public finances to breaking point.",93,99,assets,1,1,2
31N9JPQXIPJGPAEBYWMSQ6AWDP4NHU,"Spain's troubled banks, with more than 184 billion euros ($238 billion) in problem loans and assets after the property bubble burst four years ago, lie at the core of the euro zone debt crisis due to fears that a massive rescue could push Spanish public finances to breaking point.",110,125,property bubble,3,1,4
31N9JPQXIPJGPAEBYWMSQ6AWDP4NHU,"Spain's troubled banks, with more than 184 billion euros ($238 billion) in problem loans and assets after the property bubble burst four years ago, lie at the core of the euro zone debt crisis due to fears that a massive rescue could push Spanish public finances to breaking point.",110,131,property bubble burst,2,0,2
31N9JPQXIPJGPAEBYWMSQ6AWDP4NHU,"Spain's troubled banks, with more than 184 billion euros ($238 billion) in problem loans and assets after the property bubble burst four years ago, lie at the core of the euro zone debt crisis due to fears that a massive rescue could push Spanish public finances to breaking point.",119,125,bubble,0,2,2
31N9JPQXIPJGPAEBYWMSQ6AWDP4NHU,"Spain's troubled banks, with more than 184 billion euros ($238 billion) in problem loans and assets after the property bubble burst four years ago, lie at the core of the euro zone debt crisis due to fears that a massive rescue could push Spanish public finances to breaking point.",119,131,bubble burst,2,1,3
31N9JPQXIPJGPAEBYWMSQ6AWDP4NHU,"Spain's troubled banks, with more than 184 billion euros ($238 billion) in problem loans and assets after the property bubble burst four years ago, lie at the core of the euro zone debt crisis due to fears that a massive rescue could push Spanish public finances to breaking point.",126,131,burst,0,2,2
31N9JPQXIPJGPAEBYWMSQ6AWDP4NHU,"Spain's troubled banks, with more than 184 billion euros ($238 billion) in problem loans and assets after the property bubble burst four years ago, lie at the core of the euro zone debt crisis due to fears that a massive rescue could push Spanish public finances to breaking point.",159,163,core,1,0,1
31N9JPQXIPJGPAEBYWMSQ6AWDP4NHU,"Spain's troubled banks, with more than 184 billion euros ($238 billion) in problem loans and assets after the property bubble burst four years ago, lie at the core of the euro zone debt crisis due to fears that a massive rescue could push Spanish public finances to breaking point.",171,185,euro zone debt,1,0,1
31N9JPQXIPJGPAEBYWMSQ6AWDP4NHU,"Spain's troubled banks, with more than 184 billion euros ($238 billion) in problem loans and assets after the property bubble burst four years ago, lie at the core of the euro zone debt crisis due to fears that a massive rescue could push Spanish public finances to breaking point.",171,192,euro zone debt crisis,1,1,2
31N9JPQXIPJGPAEBYWMSQ6AWDP4NHU,"Spain's troubled banks, with more than 184 billion euros ($238 billion) in problem loans and assets after the property bubble burst four years ago, lie at the core of the euro zone debt crisis due to fears that a massive rescue could push Spanish public finances to breaking point.",176,180,zone,0,1,1
31N9JPQXIPJGPAEBYWMSQ6AWDP4NHU,"Spain's troubled banks, with more than 184 billion euros ($238 billion) in problem loans and assets after the property bubble burst four years ago, lie at the core of the euro zone debt crisis due to fears that a massive rescue could push Spanish public finances to breaking point.",181,192,debt crisis,3,0,3
31N9JPQXIPJGPAEBYWMSQ6AWDP4NHU,"Spain's troubled banks, with more than 184 billion euros ($238 billion) in problem loans and assets after the property bubble burst four years ago, lie at the core of the euro zone debt crisis due to fears that a massive rescue could push Spanish public finances to breaking point.",186,192,crisis,1,0,1
31N9JPQXIPJGPAEBYWMSQ6AWDP4NHU,"Spain's troubled banks, with more than 184 billion euros ($238 billion) in problem loans and assets after the property bubble burst four years ago, lie at the core of the euro zone debt crisis due to fears that a massive rescue could push Spanish public finances to breaking point.",213,220,massive,1,0,1
31N9JPQXIPJGPAEBYWMSQ6AWDP4NHU,"Spain's troubled banks, with more than 184 billion euros ($238 billion) in problem loans and assets after the property bubble burst four years ago, lie at the core of the euro zone debt crisis due to fears that a massive rescue could push Spanish public finances to breaking point.",213,227,massive rescue,0,1,1
31N9JPQXIPJGPAEBYWMSQ6AWDP4NHU,"Spain's troubled banks, with more than 184 billion euros ($238 billion) in problem loans and assets after the property bubble burst four years ago, lie at the core of the euro zone debt crisis due to fears that a massive rescue could push Spanish public finances to breaking point.",221,227,rescue,0,2,2
31N9JPQXIPJGPAEBYWMSQ6AWDP4NHU,"Spain's troubled banks, with more than 184 billion euros ($238 billion) in problem loans and assets after the property bubble burst four years ago, lie at the core of the euro zone debt crisis due to fears that a massive rescue could push Spanish public finances to breaking point.",254,262,finances,1,0,1
31N9JPQXIPJGPAEBYWMSQ6AWDP4NHU,"Spain's troubled banks, with more than 184 billion euros ($238 billion) in problem loans and assets after the property bubble burst four years ago, lie at the core of the euro zone debt crisis due to fears that a massive rescue could push Spanish public finances to breaking point.",266,280,breaking point,0,1,1
31ODACBENUGQIG5JPIQ8YEC3RB8SQ7,"Meanwhile, the army has raided a Sunni village north of Hama, killing five people, the Observatory said.",0,9,Meanwhile,0,1,1
31ODACBENUGQIG5JPIQ8YEC3RB8SQ7,"Meanwhile, the army has raided a Sunni village north of Hama, killing five people, the Observatory said.",24,30,raided,4,6,10
31ODACBENUGQIG5JPIQ8YEC3RB8SQ7,"Meanwhile, the army has raided a Sunni village north of Hama, killing five people, the Observatory said.",33,38,Sunni,1,1,2
31ODACBENUGQIG5JPIQ8YEC3RB8SQ7,"Meanwhile, the army has raided a Sunni village north of Hama, killing five people, the Observatory said.",87,98,Observatory,2,7,9
31ODACBENUGQIG5JPIQ8YEC3RB8SQ7,Activists said at least 30 people died on Sunday - mainly civilians - as violence surged at flashpoints across the country despite an increase of UN observers.,0,9,Activists,7,6,13
31ODACBENUGQIG5JPIQ8YEC3RB8SQ7,Activists said at least 30 people died on Sunday - mainly civilians - as violence surged at flashpoints across the country despite an increase of UN observers.,58,67,civilians,3,2,5
31ODACBENUGQIG5JPIQ8YEC3RB8SQ7,Activists said at least 30 people died on Sunday - mainly civilians - as violence surged at flashpoints across the country despite an increase of UN observers.,73,88,violence surged,0,3,3
31ODACBENUGQIG5JPIQ8YEC3RB8SQ7,Activists said at least 30 people died on Sunday - mainly civilians - as violence surged at flashpoints across the country despite an increase of UN observers.,73,103,violence surged at flashpoints,1,0,1
31ODACBENUGQIG5JPIQ8YEC3RB8SQ7,Activists said at least 30 people died on Sunday - mainly civilians - as violence surged at flashpoints across the country despite an increase of UN observers.,82,88,surged,6,9,15
31ODACBENUGQIG5JPIQ8YEC3RB8SQ7,Activists said at least 30 people died on Sunday - mainly civilians - as violence surged at flashpoints across the country despite an increase of UN observers.,92,103,flashpoints,10,10,20
31ODACBENUGQIG5JPIQ8YEC3RB8SQ7,Activists said at least 30 people died on Sunday - mainly civilians - as violence surged at flashpoints across the country despite an increase of UN observers.,123,130,despite,1,4,5
31ODACBENUGQIG5JPIQ8YEC3RB8SQ7,Activists said at least 30 people died on Sunday - mainly civilians - as violence surged at flashpoints across the country despite an increase of UN observers.,146,158,UN observers,1,1,2
31ODACBENUGQIG5JPIQ8YEC3RB8SQ7,Activists said at least 30 people died on Sunday - mainly civilians - as violence surged at flashpoints across the country despite an increase of UN observers.,149,158,observers,0,1,1
31ODACBENUGQIG5JPIQ8YEC3RB8SQ7,"The figures cannot be verified independently, as journalists' movements are severely restricted in Syria.",22,30,verified,4,1,5
31ODACBENUGQIG5JPIQ8YEC3RB8SQ7,"The figures cannot be verified independently, as journalists' movements are severely restricted in Syria.",22,44,verified independently,2,3,5
31ODACBENUGQIG5JPIQ8YEC3RB8SQ7,"The figures cannot be verified independently, as journalists' movements are severely restricted in Syria.",31,44,independently,3,0,3
31ODACBENUGQIG5JPIQ8YEC3RB8SQ7,"The figures cannot be verified independently, as journalists' movements are severely restricted in Syria.",49,60,journalists,2,0,2
31ODACBENUGQIG5JPIQ8YEC3RB8SQ7,"The figures cannot be verified independently, as journalists' movements are severely restricted in Syria.",62,71,movements,1,0,1
31ODACBENUGQIG5JPIQ8YEC3RB8SQ7,"The figures cannot be verified independently, as journalists' movements are severely restricted in Syria.",76,84,severely,2,1,3
31ODACBENUGQIG5JPIQ8YEC3RB8SQ7,"The figures cannot be verified independently, as journalists' movements are severely restricted in Syria.",76,95,severely restricted,3,2,5
31ODACBENUGQIG5JPIQ8YEC3RB8SQ7,"The figures cannot be verified independently, as journalists' movements are severely restricted in Syria.",85,95,restricted,4,2,6
31ODACBENUGQIG5JPIQ8YEC3RB8SQ7,The Spanish government is expected to announce plans to clean up its banking system on Friday.,26,34,expected,0,2,2
31ODACBENUGQIG5JPIQ8YEC3RB8SQ7,The Spanish government is expected to announce plans to clean up its banking system on Friday.,38,46,announce,0,3,3
31ODACBENUGQIG5JPIQ8YEC3RB8SQ7,The Spanish government is expected to announce plans to clean up its banking system on Friday.,56,64,clean up,0,1,1
31ODACBENUGQIG5JPIQ8YEC3RB8SQ7,The Spanish government is expected to announce plans to clean up its banking system on Friday.,69,83,banking system,1,0,1
31ODACBENUGQIG5JPIQ8YEC3RB8SQ7,"It is likely to force the banks to set aside extra money, in the region of 30bn euros ($39bn; £24bn), to cover the cost of loans going bad.",35,44,set aside,0,3,3
31ODACBENUGQIG5JPIQ8YEC3RB8SQ7,"It is likely to force the banks to set aside extra money, in the region of 30bn euros ($39bn; £24bn), to cover the cost of loans going bad.",39,44,aside,0,3,3
31ODACBENUGQIG5JPIQ8YEC3RB8SQ7,"It is likely to force the banks to set aside extra money, in the region of 30bn euros ($39bn; £24bn), to cover the cost of loans going bad.",65,71,region,1,0,1
31ODACBENUGQIG5JPIQ8YEC3RB8SQ7,"It is likely to force the banks to set aside extra money, in the region of 30bn euros ($39bn; £24bn), to cover the cost of loans going bad.",123,138,loans going bad,2,0,2
31ODACBENUGQIG5JPIQ8YEC3RB8SQ7,The weekly cabinet meeting is also expected to approve a plan to force banks to put bad property loans into separate companies.,11,18,cabinet,5,1,6
31ODACBENUGQIG5JPIQ8YEC3RB8SQ7,The weekly cabinet meeting is also expected to approve a plan to force banks to put bad property loans into separate companies.,11,26,cabinet meeting,1,5,6
31ODACBENUGQIG5JPIQ8YEC3RB8SQ7,The weekly cabinet meeting is also expected to approve a plan to force banks to put bad property loans into separate companies.,35,43,expected,0,2,2
31ODACBENUGQIG5JPIQ8YEC3RB8SQ7,The weekly cabinet meeting is also expected to approve a plan to force banks to put bad property loans into separate companies.,47,54,approve,1,0,1
31ODACBENUGQIG5JPIQ8YEC3RB8SQ7,The weekly cabinet meeting is also expected to approve a plan to force banks to put bad property loans into separate companies.,84,102,bad property loans,3,2,5
31ODACBENUGQIG5JPIQ8YEC3RB8SQ7,The weekly cabinet meeting is also expected to approve a plan to force banks to put bad property loans into separate companies.,88,96,property,0,1,1
31ODACBENUGQIG5JPIQ8YEC3RB8SQ7,The weekly cabinet meeting is also expected to approve a plan to force banks to put bad property loans into separate companies.,88,102,property loans,1,0,1
31ODACBENUGQIG5JPIQ8YEC3RB8SQ7,The weekly cabinet meeting is also expected to approve a plan to force banks to put bad property loans into separate companies.,108,116,separate,1,0,1
3LOJFQ4BOXGY5OO6FNBM7TEUSF9KD7,"The acquisition, announced last year, had already received approvals in Europe, the U.S. and other jurisdictions worldwide.",4,15,acquisition,10,10,20
3LOJFQ4BOXGY5OO6FNBM7TEUSF9KD7,"The acquisition, announced last year, had already received approvals in Europe, the U.S. and other jurisdictions worldwide.",17,26,announced,2,1,3
3LOJFQ4BOXGY5OO6FNBM7TEUSF9KD7,"The acquisition, announced last year, had already received approvals in Europe, the U.S. and other jurisdictions worldwide.",50,69,received  approvals,1,0,1
3LOJFQ4BOXGY5OO6FNBM7TEUSF9KD7,"The acquisition, announced last year, had already received approvals in Europe, the U.S. and other jurisdictions worldwide.",59,68,approvals,0,1,1
3LOJFQ4BOXGY5OO6FNBM7TEUSF9KD7,"The acquisition, announced last year, had already received approvals in Europe, the U.S. and other jurisdictions worldwide.",93,122,other jurisdictions worldwide,1,0,1
3LOJFQ4BOXGY5OO6FNBM7TEUSF9KD7,"The acquisition, announced last year, had already received approvals in Europe, the U.S. and other jurisdictions worldwide.",99,112,jurisdictions,10,10,20
3LOJFQ4BOXGY5OO6FNBM7TEUSF9KD7,"The acquisition, announced last year, had already received approvals in Europe, the U.S. and other jurisdictions worldwide.",99,122,jurisdictions worldwide,1,1,2
3LOJFQ4BOXGY5OO6FNBM7TEUSF9KD7,"Libertyville, Illinois-based Motorola Mobility had said in a regulatory filing in February that only Chinese clearance was still required.",0,12,Libertyville,0,2,2
3LOJFQ4BOXGY5OO6FNBM7TEUSF9KD7,"Libertyville, Illinois-based Motorola Mobility had said in a regulatory filing in February that only Chinese clearance was still required.",14,28,Illinois-based,0,2,2
3LOJFQ4BOXGY5OO6FNBM7TEUSF9KD7,"Libertyville, Illinois-based Motorola Mobility had said in a regulatory filing in February that only Chinese clearance was still required.",38,46,Mobility,1,0,1
3LOJFQ4BOXGY5OO6FNBM7TEUSF9KD7,"Libertyville, Illinois-based Motorola Mobility had said in a regulatory filing in February that only Chinese clearance was still required.",59,79,a  regulatory filing,1,0,1
3LOJFQ4BOXGY5OO6FNBM7TEUSF9KD7,"Libertyville, Illinois-based Motorola Mobility had said in a regulatory filing in February that only Chinese clearance was still required.",61,71,regulatory,3,1,4
3LOJFQ4BOXGY5OO6FNBM7TEUSF9KD7,"Libertyville, Illinois-based Motorola Mobility had said in a regulatory filing in February that only Chinese clearance was still required.",61,78,regulatory filing,5,3,8
3LOJFQ4BOXGY5OO6FNBM7TEUSF9KD7,"Libertyville, Illinois-based Motorola Mobility had said in a regulatory filing in February that only Chinese clearance was still required.",72,78,filing,0,3,3
3LOJFQ4BOXGY5OO6FNBM7TEUSF9KD7,"Libertyville, Illinois-based Motorola Mobility had said in a regulatory filing in February that only Chinese clearance was still required.",109,118,clearance,5,5,10
3LOJFQ4BOXGY5OO6FNBM7TEUSF9KD7,"Libertyville, Illinois-based Motorola Mobility had said in a regulatory filing in February that only Chinese clearance was still required.",129,137,required,0,1,1
3LOJFQ4BOXGY5OO6FNBM7TEUSF9KD7,"“Our stance since we agreed to acquire Motorola has not changed and we look forward to closing the deal,” Mountain View, California-based Google said in an e-mailed statement yesterday.",5,11,stance,6,6,12
3LOJFQ4BOXGY5OO6FNBM7TEUSF9KD7,"“Our stance since we agreed to acquire Motorola has not changed and we look forward to closing the deal,” Mountain View, California-based Google said in an e-mailed statement yesterday.",31,38,acquire,3,5,8
3LOJFQ4BOXGY5OO6FNBM7TEUSF9KD7,"“Our stance since we agreed to acquire Motorola has not changed and we look forward to closing the deal,” Mountain View, California-based Google said in an e-mailed statement yesterday.",87,103,closing the deal,1,0,1
3LOJFQ4BOXGY5OO6FNBM7TEUSF9KD7,"“Our stance since we agreed to acquire Motorola has not changed and we look forward to closing the deal,” Mountain View, California-based Google said in an e-mailed statement yesterday.",121,137,California-based,0,1,1
3LOJFQ4BOXGY5OO6FNBM7TEUSF9KD7,The company also confirmed it had received word from Chinese authorities of the purchase being approved.,17,26,confirmed,0,3,3
3LOJFQ4BOXGY5OO6FNBM7TEUSF9KD7,The company also confirmed it had received word from Chinese authorities of the purchase being approved.,61,72,authorities,2,0,2
3LOJFQ4BOXGY5OO6FNBM7TEUSF9KD7,The company also confirmed it had received word from Chinese authorities of the purchase being approved.,80,88,purchase,0,2,2
3LOJFQ4BOXGY5OO6FNBM7TEUSF9KD7,"With the acquisition -- the largest wireless-equipment deal in at least a decade, according to data compiled by Bloomberg -- Google becomes a competitor to the other handset makers that make Android devices.",9,20,acquisition,7,3,10
3LOJFQ4BOXGY5OO6FNBM7TEUSF9KD7,"With the acquisition -- the largest wireless-equipment deal in at least a decade, according to data compiled by Bloomberg -- Google becomes a competitor to the other handset makers that make Android devices.",36,54,wireless-equipment,5,3,8
3LOJFQ4BOXGY5OO6FNBM7TEUSF9KD7,"With the acquisition -- the largest wireless-equipment deal in at least a decade, according to data compiled by Bloomberg -- Google becomes a competitor to the other handset makers that make Android devices.",36,59,wireless-equipment deal,1,0,1
3LOJFQ4BOXGY5OO6FNBM7TEUSF9KD7,"With the acquisition -- the largest wireless-equipment deal in at least a decade, according to data compiled by Bloomberg -- Google becomes a competitor to the other handset makers that make Android devices.",74,80,decade,2,3,5
3LOJFQ4BOXGY5OO6FNBM7TEUSF9KD7,"With the acquisition -- the largest wireless-equipment deal in at least a decade, according to data compiled by Bloomberg -- Google becomes a competitor to the other handset makers that make Android devices.",95,99,data,1,0,1
3LOJFQ4BOXGY5OO6FNBM7TEUSF9KD7,"With the acquisition -- the largest wireless-equipment deal in at least a decade, according to data compiled by Bloomberg -- Google becomes a competitor to the other handset makers that make Android devices.",100,108,compiled,6,10,16
3LOJFQ4BOXGY5OO6FNBM7TEUSF9KD7,"With the acquisition -- the largest wireless-equipment deal in at least a decade, according to data compiled by Bloomberg -- Google becomes a competitor to the other handset makers that make Android devices.",142,152,competitor,1,2,3
3LOJFQ4BOXGY5OO6FNBM7TEUSF9KD7,"With the acquisition -- the largest wireless-equipment deal in at least a decade, according to data compiled by Bloomberg -- Google becomes a competitor to the other handset makers that make Android devices.",166,173,handset,2,3,5
3LOJFQ4BOXGY5OO6FNBM7TEUSF9KD7,"With the acquisition -- the largest wireless-equipment deal in at least a decade, according to data compiled by Bloomberg -- Google becomes a competitor to the other handset makers that make Android devices.",166,180,handset makers,1,0,1
3LOJFQ4BOXGY5OO6FNBM7TEUSF9KD7,"With the acquisition -- the largest wireless-equipment deal in at least a decade, according to data compiled by Bloomberg -- Google becomes a competitor to the other handset makers that make Android devices.",199,206,devices,0,1,1
3LOJFQ4BOXGY5OO6FNBM7TEUSF9KD7,"In addition to Motorola Mobility phones, the software runs handsets made by companies such as Samsung Electronics Co. (005930) and HTC Corp. (2498) As part of the approval, Google needs to ensure that Android software versions are free and open over the next five years, China’s Ministry of Commerce said in a statement on its website.",24,32,Mobility,1,0,1
3LOJFQ4BOXGY5OO6FNBM7TEUSF9KD7,"In addition to Motorola Mobility phones, the software runs handsets made by companies such as Samsung Electronics Co. (005930) and HTC Corp. (2498) As part of the approval, Google needs to ensure that Android software versions are free and open over the next five years, China’s Ministry of Commerce said in a statement on its website.",45,53,software,0,1,1
3LOJFQ4BOXGY5OO6FNBM7TEUSF9KD7,"In addition to Motorola Mobility phones, the software runs handsets made by companies such as Samsung Electronics Co. (005930) and HTC Corp. (2498) As part of the approval, Google needs to ensure that Android software versions are free and open over the next five years, China’s Ministry of Commerce said in a statement on its website.",59,67,handsets,1,2,3
3LOJFQ4BOXGY5OO6FNBM7TEUSF9KD7,"In addition to Motorola Mobility phones, the software runs handsets made by companies such as Samsung Electronics Co. (005930) and HTC Corp. (2498) As part of the approval, Google needs to ensure that Android software versions are free and open over the next five years, China’s Ministry of Commerce said in a statement on its website.",163,171,approval,0,1,1
3LOJFQ4BOXGY5OO6FNBM7TEUSF9KD7,"In addition to Motorola Mobility phones, the software runs handsets made by companies such as Samsung Electronics Co. (005930) and HTC Corp. (2498) As part of the approval, Google needs to ensure that Android software versions are free and open over the next five years, China’s Ministry of Commerce said in a statement on its website.",189,195,ensure,3,2,5
3LOJFQ4BOXGY5OO6FNBM7TEUSF9KD7,"In addition to Motorola Mobility phones, the software runs handsets made by companies such as Samsung Electronics Co. (005930) and HTC Corp. (2498) As part of the approval, Google needs to ensure that Android software versions are free and open over the next five years, China’s Ministry of Commerce said in a statement on its website.",201,208,Android,0,1,1
3LOJFQ4BOXGY5OO6FNBM7TEUSF9KD7,"In addition to Motorola Mobility phones, the software runs handsets made by companies such as Samsung Electronics Co. (005930) and HTC Corp. (2498) As part of the approval, Google needs to ensure that Android software versions are free and open over the next five years, China’s Ministry of Commerce said in a statement on its website.",209,235,software versions are free,1,0,1
3LOJFQ4BOXGY5OO6FNBM7TEUSF9KD7,"In addition to Motorola Mobility phones, the software runs handsets made by companies such as Samsung Electronics Co. (005930) and HTC Corp. (2498) As part of the approval, Google needs to ensure that Android software versions are free and open over the next five years, China’s Ministry of Commerce said in a statement on its website.",218,226,versions,1,3,4
3LOJFQ4BOXGY5OO6FNBM7TEUSF9KD7,"In addition to Motorola Mobility phones, the software runs handsets made by companies such as Samsung Electronics Co. (005930) and HTC Corp. (2498) As part of the approval, Google needs to ensure that Android software versions are free and open over the next five years, China’s Ministry of Commerce said in a statement on its website.",231,244,free and open,2,0,2
3LOJFQ4BOXGY5OO6FNBM7TEUSF9KD7,"In addition to Motorola Mobility phones, the software runs handsets made by companies such as Samsung Electronics Co. (005930) and HTC Corp. (2498) As part of the approval, Google needs to ensure that Android software versions are free and open over the next five years, China’s Ministry of Commerce said in a statement on its website.",279,299,Ministry of Commerce,1,0,1
3LOJFQ4BOXGY5OO6FNBM7TEUSF9KD7,"In addition to Motorola Mobility phones, the software runs handsets made by companies such as Samsung Electronics Co. (005930) and HTC Corp. (2498) As part of the approval, Google needs to ensure that Android software versions are free and open over the next five years, China’s Ministry of Commerce said in a statement on its website.",291,299,Commerce,2,0,2
3LOJFQ4BOXGY5OO6FNBM7TEUSF9KD7,"In addition to Motorola Mobility phones, the software runs handsets made by companies such as Samsung Electronics Co. (005930) and HTC Corp. (2498) As part of the approval, Google needs to ensure that Android software versions are free and open over the next five years, China’s Ministry of Commerce said in a statement on its website.",310,319,statement,0,1,1
3X878VYTIEJ78TVINZH3ROCTX71F7G,"Mr Obama's address, during an unannounced visit to sign a strategic partnership agreement with President Hamid Karzai that sets the terms for relations after the departure of US troops in 2014, was a chance for him to make an election-year case that he is winding down a costly and increasingly unpopular war.''",30,41,unannounced,5,2,7
3X878VYTIEJ78TVINZH3ROCTX71F7G,"Mr Obama's address, during an unannounced visit to sign a strategic partnership agreement with President Hamid Karzai that sets the terms for relations after the departure of US troops in 2014, was a chance for him to make an election-year case that he is winding down a costly and increasingly unpopular war.''",30,47,unannounced visit,0,1,1
3X878VYTIEJ78TVINZH3ROCTX71F7G,"Mr Obama's address, during an unannounced visit to sign a strategic partnership agreement with President Hamid Karzai that sets the terms for relations after the departure of US troops in 2014, was a chance for him to make an election-year case that he is winding down a costly and increasingly unpopular war.''",58,67,strategic,3,2,5
3X878VYTIEJ78TVINZH3ROCTX71F7G,"Mr Obama's address, during an unannounced visit to sign a strategic partnership agreement with President Hamid Karzai that sets the terms for relations after the departure of US troops in 2014, was a chance for him to make an election-year case that he is winding down a costly and increasingly unpopular war.''",58,79,strategic partnership,1,1,2
3X878VYTIEJ78TVINZH3ROCTX71F7G,"Mr Obama's address, during an unannounced visit to sign a strategic partnership agreement with President Hamid Karzai that sets the terms for relations after the departure of US troops in 2014, was a chance for him to make an election-year case that he is winding down a costly and increasingly unpopular war.''",58,89,strategic partnership agreement,6,2,8
3X878VYTIEJ78TVINZH3ROCTX71F7G,"Mr Obama's address, during an unannounced visit to sign a strategic partnership agreement with President Hamid Karzai that sets the terms for relations after the departure of US troops in 2014, was a chance for him to make an election-year case that he is winding down a costly and increasingly unpopular war.''",132,137,terms,1,0,1
3X878VYTIEJ78TVINZH3ROCTX71F7G,"Mr Obama's address, during an unannounced visit to sign a strategic partnership agreement with President Hamid Karzai that sets the terms for relations after the departure of US troops in 2014, was a chance for him to make an election-year case that he is winding down a costly and increasingly unpopular war.''",132,151,terms for relations,0,1,1
3X878VYTIEJ78TVINZH3ROCTX71F7G,"Mr Obama's address, during an unannounced visit to sign a strategic partnership agreement with President Hamid Karzai that sets the terms for relations after the departure of US troops in 2014, was a chance for him to make an election-year case that he is winding down a costly and increasingly unpopular war.''",142,151,relations,1,1,2
3X878VYTIEJ78TVINZH3ROCTX71F7G,"Mr Obama's address, during an unannounced visit to sign a strategic partnership agreement with President Hamid Karzai that sets the terms for relations after the departure of US troops in 2014, was a chance for him to make an election-year case that he is winding down a costly and increasingly unpopular war.''",162,171,departure,4,5,9
3X878VYTIEJ78TVINZH3ROCTX71F7G,"Mr Obama's address, during an unannounced visit to sign a strategic partnership agreement with President Hamid Karzai that sets the terms for relations after the departure of US troops in 2014, was a chance for him to make an election-year case that he is winding down a costly and increasingly unpopular war.''",226,239,election-year,1,0,1
3X878VYTIEJ78TVINZH3ROCTX71F7G,"Mr Obama's address, during an unannounced visit to sign a strategic partnership agreement with President Hamid Karzai that sets the terms for relations after the departure of US troops in 2014, was a chance for him to make an election-year case that he is winding down a costly and increasingly unpopular war.''",256,263,winding,1,2,3
3X878VYTIEJ78TVINZH3ROCTX71F7G,"Mr Obama's address, during an unannounced visit to sign a strategic partnership agreement with President Hamid Karzai that sets the terms for relations after the departure of US troops in 2014, was a chance for him to make an election-year case that he is winding down a costly and increasingly unpopular war.''",256,268,winding down,6,6,12
3X878VYTIEJ78TVINZH3ROCTX71F7G,"Mr Obama's address, during an unannounced visit to sign a strategic partnership agreement with President Hamid Karzai that sets the terms for relations after the departure of US troops in 2014, was a chance for him to make an election-year case that he is winding down a costly and increasingly unpopular war.''",271,277,costly,1,1,2
3X878VYTIEJ78TVINZH3ROCTX71F7G,"Mr Obama's address, during an unannounced visit to sign a strategic partnership agreement with President Hamid Karzai that sets the terms for relations after the departure of US troops in 2014, was a chance for him to make an election-year case that he is winding down a costly and increasingly unpopular war.''",282,294,increasingly,1,0,1
3X878VYTIEJ78TVINZH3ROCTX71F7G,"Mr Obama's address, during an unannounced visit to sign a strategic partnership agreement with President Hamid Karzai that sets the terms for relations after the departure of US troops in 2014, was a chance for him to make an election-year case that he is winding down a costly and increasingly unpopular war.''",295,304,unpopular,2,0,2
3X878VYTIEJ78TVINZH3ROCTX71F7G,"Mr Obama's address, during an unannounced visit to sign a strategic partnership agreement with President Hamid Karzai that sets the terms for relations after the departure of US troops in 2014, was a chance for him to make an election-year case that he is winding down a costly and increasingly unpopular war.''",295,308,unpopular war,0,1,1
3X878VYTIEJ78TVINZH3ROCTX71F7G,"My fellow Americans,'' he said, speaking against a backdrop of armoured military vehicles and a US flag, ''we've travelled through more than a decade under the dark cloud of war.",3,9,fellow,0,1,1
3X878VYTIEJ78TVINZH3ROCTX71F7G,"My fellow Americans,'' he said, speaking against a backdrop of armoured military vehicles and a US flag, ''we've travelled through more than a decade under the dark cloud of war.",51,59,backdrop,6,1,7
3X878VYTIEJ78TVINZH3ROCTX71F7G,"My fellow Americans,'' he said, speaking against a backdrop of armoured military vehicles and a US flag, ''we've travelled through more than a decade under the dark cloud of war.",63,71,armoured,10,2,12
3X878VYTIEJ78TVINZH3ROCTX71F7G,"My fellow Americans,'' he said, speaking against a backdrop of armoured military vehicles and a US flag, ''we've travelled through more than a decade under the dark cloud of war.",63,89,armoured military vehicles,2,0,2
3X878VYTIEJ78TVINZH3ROCTX71F7G,"My fellow Americans,'' he said, speaking against a backdrop of armoured military vehicles and a US flag, ''we've travelled through more than a decade under the dark cloud of war.",72,89,military vehicles,1,0,1
3X878VYTIEJ78TVINZH3ROCTX71F7G,"My fellow Americans,'' he said, speaking against a backdrop of armoured military vehicles and a US flag, ''we've travelled through more than a decade under the dark cloud of war.",113,122,travelled,1,0,1
3X878VYTIEJ78TVINZH3ROCTX71F7G,"My fellow Americans,'' he said, speaking against a backdrop of armoured military vehicles and a US flag, ''we've travelled through more than a decade under the dark cloud of war.",143,149,decade,1,4,5
3X878VYTIEJ78TVINZH3ROCTX71F7G,"My fellow Americans,'' he said, speaking against a backdrop of armoured military vehicles and a US flag, ''we've travelled through more than a decade under the dark cloud of war.",160,177,dark cloud of war,3,0,3
3X878VYTIEJ78TVINZH3ROCTX71F7G,"My fellow Americans,'' he said, speaking against a backdrop of armoured military vehicles and a US flag, ''we've travelled through more than a decade under the dark cloud of war.",160,170,dark cloud,0,1,1
3X878VYTIEJ78TVINZH3ROCTX71F7G,"Yet here, in the pre-dawn darkness of Afghanistan, we can see the light of new day on the horizon.''",17,25,pre-dawn,5,3,8
3X878VYTIEJ78TVINZH3ROCTX71F7G,"Yet here, in the pre-dawn darkness of Afghanistan, we can see the light of new day on the horizon.''",17,34,pre-dawn darkness,2,1,3
3X878VYTIEJ78TVINZH3ROCTX71F7G,"Yet here, in the pre-dawn darkness of Afghanistan, we can see the light of new day on the horizon.''",26,34,darkness,0,1,1
3X878VYTIEJ78TVINZH3ROCTX71F7G,"Yet here, in the pre-dawn darkness of Afghanistan, we can see the light of new day on the horizon.''",90,97,horizon,3,4,7
3X878VYTIEJ78TVINZH3ROCTX71F7G,"His speech came as an already difficult relationship with Mr Karzai has been strained by recent events, including the release of photos showing US soldiers posing with the remains of Taliban insurgents and a US staff sergeant who has been charged in the killing of 16 Afghan civilians.",40,52,relationship,1,0,1
3X878VYTIEJ78TVINZH3ROCTX71F7G,"His speech came as an already difficult relationship with Mr Karzai has been strained by recent events, including the release of photos showing US soldiers posing with the remains of Taliban insurgents and a US staff sergeant who has been charged in the killing of 16 Afghan civilians.",77,85,strained,9,1,10
3X878VYTIEJ78TVINZH3ROCTX71F7G,"His speech came as an already difficult relationship with Mr Karzai has been strained by recent events, including the release of photos showing US soldiers posing with the remains of Taliban insurgents and a US staff sergeant who has been charged in the killing of 16 Afghan civilians.",77,102,strained by recent events,1,0,1
3X878VYTIEJ78TVINZH3ROCTX71F7G,"His speech came as an already difficult relationship with Mr Karzai has been strained by recent events, including the release of photos showing US soldiers posing with the remains of Taliban insurgents and a US staff sergeant who has been charged in the killing of 16 Afghan civilians.",156,162,posing,0,2,2
3X878VYTIEJ78TVINZH3ROCTX71F7G,"His speech came as an already difficult relationship with Mr Karzai has been strained by recent events, including the release of photos showing US soldiers posing with the remains of Taliban insurgents and a US staff sergeant who has been charged in the killing of 16 Afghan civilians.",172,179,remains,1,1,2
3X878VYTIEJ78TVINZH3ROCTX71F7G,"His speech came as an already difficult relationship with Mr Karzai has been strained by recent events, including the release of photos showing US soldiers posing with the remains of Taliban insurgents and a US staff sergeant who has been charged in the killing of 16 Afghan civilians.",183,201,Taliban insurgents,1,0,1
3X878VYTIEJ78TVINZH3ROCTX71F7G,"His speech came as an already difficult relationship with Mr Karzai has been strained by recent events, including the release of photos showing US soldiers posing with the remains of Taliban insurgents and a US staff sergeant who has been charged in the killing of 16 Afghan civilians.",183,190,Taliban,1,0,1
3X878VYTIEJ78TVINZH3ROCTX71F7G,"His speech came as an already difficult relationship with Mr Karzai has been strained by recent events, including the release of photos showing US soldiers posing with the remains of Taliban insurgents and a US staff sergeant who has been charged in the killing of 16 Afghan civilians.",191,201,insurgents,10,1,11
3X878VYTIEJ78TVINZH3ROCTX71F7G,"His speech came as an already difficult relationship with Mr Karzai has been strained by recent events, including the release of photos showing US soldiers posing with the remains of Taliban insurgents and a US staff sergeant who has been charged in the killing of 16 Afghan civilians.",211,225,staff sergeant,1,1,2
3X878VYTIEJ78TVINZH3ROCTX71F7G,"His speech came as an already difficult relationship with Mr Karzai has been strained by recent events, including the release of photos showing US soldiers posing with the remains of Taliban insurgents and a US staff sergeant who has been charged in the killing of 16 Afghan civilians.",217,225,sergeant,3,0,3
3X878VYTIEJ78TVINZH3ROCTX71F7G,"His speech came as an already difficult relationship with Mr Karzai has been strained by recent events, including the release of photos showing US soldiers posing with the remains of Taliban insurgents and a US staff sergeant who has been charged in the killing of 16 Afghan civilians.",268,284,Afghan civilians,1,0,1
3X878VYTIEJ78TVINZH3ROCTX71F7G,"His speech came as an already difficult relationship with Mr Karzai has been strained by recent events, including the release of photos showing US soldiers posing with the remains of Taliban insurgents and a US staff sergeant who has been charged in the killing of 16 Afghan civilians.",275,284,civilians,1,1,2
3OREP8RUT2C0O5U3B0Z1EBY1H0DBGU,"Rajoy said this week the banking intervention would not affect the annual public deficit, which has vowed to slash from 8.5 percent of economic output last year to 5.3 percent this year and 3.0 percent in 2013.",25,45,banking intervention,6,2,8
3OREP8RUT2C0O5U3B0Z1EBY1H0DBGU,"Rajoy said this week the banking intervention would not affect the annual public deficit, which has vowed to slash from 8.5 percent of economic output last year to 5.3 percent this year and 3.0 percent in 2013.",33,45,intervention,6,10,16
3OREP8RUT2C0O5U3B0Z1EBY1H0DBGU,"Rajoy said this week the banking intervention would not affect the annual public deficit, which has vowed to slash from 8.5 percent of economic output last year to 5.3 percent this year and 3.0 percent in 2013.",67,88,annual public deficit,4,2,6
3OREP8RUT2C0O5U3B0Z1EBY1H0DBGU,"Rajoy said this week the banking intervention would not affect the annual public deficit, which has vowed to slash from 8.5 percent of economic output last year to 5.3 percent this year and 3.0 percent in 2013.",74,88,public deficit,2,1,3
3OREP8RUT2C0O5U3B0Z1EBY1H0DBGU,"Rajoy said this week the banking intervention would not affect the annual public deficit, which has vowed to slash from 8.5 percent of economic output last year to 5.3 percent this year and 3.0 percent in 2013.",81,88,deficit,4,6,10
3OREP8RUT2C0O5U3B0Z1EBY1H0DBGU,"Rajoy said this week the banking intervention would not affect the annual public deficit, which has vowed to slash from 8.5 percent of economic output last year to 5.3 percent this year and 3.0 percent in 2013.",96,105,has vowed,0,1,1
3OREP8RUT2C0O5U3B0Z1EBY1H0DBGU,"Rajoy said this week the banking intervention would not affect the annual public deficit, which has vowed to slash from 8.5 percent of economic output last year to 5.3 percent this year and 3.0 percent in 2013.",100,105,vowed,2,8,10
3OREP8RUT2C0O5U3B0Z1EBY1H0DBGU,"Rajoy said this week the banking intervention would not affect the annual public deficit, which has vowed to slash from 8.5 percent of economic output last year to 5.3 percent this year and 3.0 percent in 2013.",100,114,vowed to slash,1,1,2
3OREP8RUT2C0O5U3B0Z1EBY1H0DBGU,"Rajoy said this week the banking intervention would not affect the annual public deficit, which has vowed to slash from 8.5 percent of economic output last year to 5.3 percent this year and 3.0 percent in 2013.",106,114,to slash,0,1,1
3OREP8RUT2C0O5U3B0Z1EBY1H0DBGU,"Rajoy said this week the banking intervention would not affect the annual public deficit, which has vowed to slash from 8.5 percent of economic output last year to 5.3 percent this year and 3.0 percent in 2013.",109,114,slash,1,6,7
3OREP8RUT2C0O5U3B0Z1EBY1H0DBGU,"Rajoy said this week the banking intervention would not affect the annual public deficit, which has vowed to slash from 8.5 percent of economic output last year to 5.3 percent this year and 3.0 percent in 2013.",135,143,economic,1,1,2
3OREP8RUT2C0O5U3B0Z1EBY1H0DBGU,"Rajoy said this week the banking intervention would not affect the annual public deficit, which has vowed to slash from 8.5 percent of economic output last year to 5.3 percent this year and 3.0 percent in 2013.",135,150,economic output,3,2,5
3OREP8RUT2C0O5U3B0Z1EBY1H0DBGU,"Rajoy said this week the banking intervention would not affect the annual public deficit, which has vowed to slash from 8.5 percent of economic output last year to 5.3 percent this year and 3.0 percent in 2013.",144,150,output,0,1,1
3OREP8RUT2C0O5U3B0Z1EBY1H0DBGU,The European Union has already discounted Spain's promise to trim the deficit in a time of recession and with an unemployment rate in the first quarter of 24.4 percent.,31,41,discounted,5,8,13
3OREP8RUT2C0O5U3B0Z1EBY1H0DBGU,The European Union has already discounted Spain's promise to trim the deficit in a time of recession and with an unemployment rate in the first quarter of 24.4 percent.,50,65,promise to trim,0,1,1
3OREP8RUT2C0O5U3B0Z1EBY1H0DBGU,The European Union has already discounted Spain's promise to trim the deficit in a time of recession and with an unemployment rate in the first quarter of 24.4 percent.,61,65,trim,1,4,5
3OREP8RUT2C0O5U3B0Z1EBY1H0DBGU,The European Union has already discounted Spain's promise to trim the deficit in a time of recession and with an unemployment rate in the first quarter of 24.4 percent.,61,77,trim the deficit,4,1,5
3OREP8RUT2C0O5U3B0Z1EBY1H0DBGU,The European Union has already discounted Spain's promise to trim the deficit in a time of recession and with an unemployment rate in the first quarter of 24.4 percent.,70,77,deficit,3,2,5
3OREP8RUT2C0O5U3B0Z1EBY1H0DBGU,The European Union has already discounted Spain's promise to trim the deficit in a time of recession and with an unemployment rate in the first quarter of 24.4 percent.,91,100,recession,10,9,19
3OREP8RUT2C0O5U3B0Z1EBY1H0DBGU,The European Union has already discounted Spain's promise to trim the deficit in a time of recession and with an unemployment rate in the first quarter of 24.4 percent.,113,125,unemployment,1,1,2
3OREP8RUT2C0O5U3B0Z1EBY1H0DBGU,The European Union has already discounted Spain's promise to trim the deficit in a time of recession and with an unemployment rate in the first quarter of 24.4 percent.,113,130,unemployment rate,1,0,1
3OREP8RUT2C0O5U3B0Z1EBY1H0DBGU,The European Union has already discounted Spain's promise to trim the deficit in a time of recession and with an unemployment rate in the first quarter of 24.4 percent.,138,151,first quarter,1,0,1
3OREP8RUT2C0O5U3B0Z1EBY1H0DBGU,"At least 30 people - including 23 soldiers - have died in heavy overnight clashes in the central Syrian city of Rastan, according to activists.",58,81,heavy overnight clashes,2,0,2
3OREP8RUT2C0O5U3B0Z1EBY1H0DBGU,"At least 30 people - including 23 soldiers - have died in heavy overnight clashes in the central Syrian city of Rastan, according to activists.",64,73,overnight,1,3,4
3OREP8RUT2C0O5U3B0Z1EBY1H0DBGU,"At least 30 people - including 23 soldiers - have died in heavy overnight clashes in the central Syrian city of Rastan, according to activists.",64,81,overnight clashes,0,3,3
3OREP8RUT2C0O5U3B0Z1EBY1H0DBGU,"At least 30 people - including 23 soldiers - have died in heavy overnight clashes in the central Syrian city of Rastan, according to activists.",74,81,clashes,1,0,1
3OREP8RUT2C0O5U3B0Z1EBY1H0DBGU,"At least 30 people - including 23 soldiers - have died in heavy overnight clashes in the central Syrian city of Rastan, according to activists.",133,142,activists,4,5,9
3OREP8RUT2C0O5U3B0Z1EBY1H0DBGU,"The Syrian Observatory for Human Rights said dozens of others were wounded in the city, in the restive Homs province.",4,22,Syrian Observatory,1,0,1
3OREP8RUT2C0O5U3B0Z1EBY1H0DBGU,"The Syrian Observatory for Human Rights said dozens of others were wounded in the city, in the restive Homs province.",11,22,Observatory,1,1,2
3OREP8RUT2C0O5U3B0Z1EBY1H0DBGU,"The Syrian Observatory for Human Rights said dozens of others were wounded in the city, in the restive Homs province.",67,74,wounded,0,3,3
3OREP8RUT2C0O5U3B0Z1EBY1H0DBGU,"The Syrian Observatory for Human Rights said dozens of others were wounded in the city, in the restive Homs province.",95,102,restive,6,5,11
3OREP8RUT2C0O5U3B0Z1EBY1H0DBGU,"The Syrian Observatory for Human Rights said dozens of others were wounded in the city, in the restive Homs province.",95,116,restive Homs province,3,1,4
3OREP8RUT2C0O5U3B0Z1EBY1H0DBGU,"The Syrian Observatory for Human Rights said dozens of others were wounded in the city, in the restive Homs province.",108,116,province,2,1,3
3OREP8RUT2C0O5U3B0Z1EBY1H0DBGU,"Three troop carriers were destroyed in fighting, the UK-based group said.",6,11,troop,1,1,2
3OREP8RUT2C0O5U3B0Z1EBY1H0DBGU,"Three troop carriers were destroyed in fighting, the UK-based group said.",6,20,troop carriers,4,2,6
3OREP8RUT2C0O5U3B0Z1EBY1H0DBGU,"Three troop carriers were destroyed in fighting, the UK-based group said.",12,20,carriers,1,0,1
3OREP8RUT2C0O5U3B0Z1EBY1H0DBGU,"Three troop carriers were destroyed in fighting, the UK-based group said.",26,35,destroyed,0,2,2
3OREP8RUT2C0O5U3B0Z1EBY1H0DBGU,"Three troop carriers were destroyed in fighting, the UK-based group said.",53,61,UK-based,1,0,1
3RHLQY6EDT5DRMZ3UVO60CPYVTJD4A,"The neighbors say that they called out to the children, begging them not to go back to the house.",4,13,neighbors,1,2,3
3RHLQY6EDT5DRMZ3UVO60CPYVTJD4A,"The neighbors say that they called out to the children, begging them not to go back to the house.",56,63,begging,2,4,6
3RHLQY6EDT5DRMZ3UVO60CPYVTJD4A,"The neighbors say that they called out to the children, begging them not to go back to the house.",56,68,begging them,0,1,1
3RHLQY6EDT5DRMZ3UVO60CPYVTJD4A,The neighbors called police immediately who heard gunshots upon arrival.,4,13,neighbors,1,0,1
3RHLQY6EDT5DRMZ3UVO60CPYVTJD4A,The neighbors called police immediately who heard gunshots upon arrival.,28,39,immediately,4,1,5
3RHLQY6EDT5DRMZ3UVO60CPYVTJD4A,The neighbors called police immediately who heard gunshots upon arrival.,50,58,gunshots,1,2,3
3RHLQY6EDT5DRMZ3UVO60CPYVTJD4A,The neighbors called police immediately who heard gunshots upon arrival.,59,71,upon arrival,0,1,1
3RHLQY6EDT5DRMZ3UVO60CPYVTJD4A,"We set up a perimeter, found the oldest girl lying in the yard and took her out to ambulance, Goodyear said.",13,22,perimeter,10,10,20
3RHLQY6EDT5DRMZ3UVO60CPYVTJD4A,"We set up a perimeter, found the oldest girl lying in the yard and took her out to ambulance, Goodyear said.",46,51,lying,0,1,1
3RHLQY6EDT5DRMZ3UVO60CPYVTJD4A,"We set up a perimeter, found the oldest girl lying in the yard and took her out to ambulance, Goodyear said.",84,93,ambulance,6,1,7
3RHLQY6EDT5DRMZ3UVO60CPYVTJD4A,EMTs pronounced Pebbles dead in the ambulance and a SWAT team was called for further investigation.,0,4,EMTs,0,2,2
3RHLQY6EDT5DRMZ3UVO60CPYVTJD4A,EMTs pronounced Pebbles dead in the ambulance and a SWAT team was called for further investigation.,5,15,pronounced,10,6,16
3RHLQY6EDT5DRMZ3UVO60CPYVTJD4A,EMTs pronounced Pebbles dead in the ambulance and a SWAT team was called for further investigation.,16,23,Pebbles,0,2,2
3RHLQY6EDT5DRMZ3UVO60CPYVTJD4A,EMTs pronounced Pebbles dead in the ambulance and a SWAT team was called for further investigation.,52,56,SWAT,1,2,3
3RHLQY6EDT5DRMZ3UVO60CPYVTJD4A,EMTs pronounced Pebbles dead in the ambulance and a SWAT team was called for further investigation.,52,61,SWAT team,3,1,4
3RHLQY6EDT5DRMZ3UVO60CPYVTJD4A,EMTs pronounced Pebbles dead in the ambulance and a SWAT team was called for further investigation.,77,98,further investigation,1,1,2
3RHLQY6EDT5DRMZ3UVO60CPYVTJD4A,EMTs pronounced Pebbles dead in the ambulance and a SWAT team was called for further investigation.,85,98,investigation,4,4,8
3RHLQY6EDT5DRMZ3UVO60CPYVTJD4A,Police say they heard another gun shot.,16,21,heard,0,1,1
3RHLQY6EDT5DRMZ3UVO60CPYVTJD4A,Police say they heard another gun shot.,34,38,shot,0,1,1
3RHLQY6EDT5DRMZ3UVO60CPYVTJD4A,"Goodyear says the father of the family lives in Titusville, Fla., and hadn't been home in a few months.",60,63,Fla,1,0,1
3RHLQY6EDT5DRMZ3UVO60CPYVTJD4A,"Goodyear says the father of the family lives in Titusville, Fla., and hadn't been home in a few months.",70,75,hadnt,0,1,1
3RHLQY6EDT5DRMZ3UVO60CPYVTJD4A,The family has a history of domestic violence.,28,36,domestic,2,2,4
3RHLQY6EDT5DRMZ3UVO60CPYVTJD4A,The family has a history of domestic violence.,28,45,domestic violence,8,4,12
3RHLQY6EDT5DRMZ3UVO60CPYVTJD4A,The family has a history of domestic violence.,37,45,violence,0,2,2
3EFNPKWBMSPYA6F5I5VSB0D9N4E30M,"In April, Jaxs threw a bicycle through a window in the house and threatened Thomas, according to a police report.",15,20,threw,0,2,2
3EFNPKWBMSPYA6F5I5VSB0D9N4E30M,"In April, Jaxs threw a bicycle through a window in the house and threatened Thomas, according to a police report.",65,75,threatened,7,8,15
3EFNPKWBMSPYA6F5I5VSB0D9N4E30M,"In April, Jaxs threw a bicycle through a window in the house and threatened Thomas, according to a police report.",84,93,according,0,1,1
3EFNPKWBMSPYA6F5I5VSB0D9N4E30M,"In April, Jaxs threw a bicycle through a window in the house and threatened Thomas, according to a police report.",99,112,police report,1,0,1
3EFNPKWBMSPYA6F5I5VSB0D9N4E30M,"That next day, when she woke him up for school, he kicked and punched her repeatedly, the report said.",51,57,kicked,0,1,1
3EFNPKWBMSPYA6F5I5VSB0D9N4E30M,"That next day, when she woke him up for school, he kicked and punched her repeatedly, the report said.",51,69,kicked and punched,0,1,1
3EFNPKWBMSPYA6F5I5VSB0D9N4E30M,"That next day, when she woke him up for school, he kicked and punched her repeatedly, the report said.",62,69,punched,1,2,3
3EFNPKWBMSPYA6F5I5VSB0D9N4E30M,"That next day, when she woke him up for school, he kicked and punched her repeatedly, the report said.",74,84,repeatedly,1,1,2
3EFNPKWBMSPYA6F5I5VSB0D9N4E30M,She pushed back and they began to scuffle.,4,15,pushed back,0,1,1
3EFNPKWBMSPYA6F5I5VSB0D9N4E30M,She pushed back and they began to scuffle.,34,41,scuffle,9,10,19
3EFNPKWBMSPYA6F5I5VSB0D9N4E30M,Police were called later that day and police say neighbors often complained of hearing shouts and yells emanating from the house.,49,58,neighbors,1,0,1
3EFNPKWBMSPYA6F5I5VSB0D9N4E30M,Police were called later that day and police say neighbors often complained of hearing shouts and yells emanating from the house.,65,75,complained,3,2,5
3EFNPKWBMSPYA6F5I5VSB0D9N4E30M,Police were called later that day and police say neighbors often complained of hearing shouts and yells emanating from the house.,87,93,shouts,2,0,2
3EFNPKWBMSPYA6F5I5VSB0D9N4E30M,Police were called later that day and police say neighbors often complained of hearing shouts and yells emanating from the house.,87,113,shouts and yells emanating,0,1,1
3EFNPKWBMSPYA6F5I5VSB0D9N4E30M,Police were called later that day and police say neighbors often complained of hearing shouts and yells emanating from the house.,98,103,yells,0,1,1
3EFNPKWBMSPYA6F5I5VSB0D9N4E30M,Police were called later that day and police say neighbors often complained of hearing shouts and yells emanating from the house.,98,113,yells emanating,1,1,2
3EFNPKWBMSPYA6F5I5VSB0D9N4E30M,Police were called later that day and police say neighbors often complained of hearing shouts and yells emanating from the house.,104,113,emanating,10,10,20
3EFNPKWBMSPYA6F5I5VSB0D9N4E30M,"It's sad, even if they were troublemakers.	29	42	troublemakers	8	6	14
3EFNPKWBMSPYA6F5I5VSB0D9N4E30M	It's very distressing, Goodyear said.",10,21,distressing,8,10,18
3EFNPKWBMSPYA6F5I5VSB0D9N4E30M,"As a parent, I could never fathom doing this to my kids.",28,34,fathom,8,9,17
3EFNPKWBMSPYA6F5I5VSB0D9N4E30M,A 32 year old man was sitting his car when he was approached by a lone male who fire a number of shots hitting the man at least once in the side.,50,60,approached,2,2,4
3EFNPKWBMSPYA6F5I5VSB0D9N4E30M,A 32 year old man was sitting his car when he was approached by a lone male who fire a number of shots hitting the man at least once in the side.,66,70,lone,2,1,3
3EFNPKWBMSPYA6F5I5VSB0D9N4E30M,A 32 year old man was sitting his car when he was approached by a lone male who fire a number of shots hitting the man at least once in the side.,66,75,lone male,2,1,3
3126F2F5F8448LZMOARE9SIEM1GEPV,She was killed in a gun attack at William Court.,20,30,gun attack,0,1,1
3126F2F5F8448LZMOARE9SIEM1GEPV,She was killed in a gun attack at William Court.,34,47,William Court,1,0,1
3126F2F5F8448LZMOARE9SIEM1GEPV,Her 21-year-old sister was seriously injured and remains in a critical condition at Belfast's Royal Victoria Hospital.,27,36,seriously,0,1,1
3126F2F5F8448LZMOARE9SIEM1GEPV,Her 21-year-old sister was seriously injured and remains in a critical condition at Belfast's Royal Victoria Hospital.,27,44,seriously injured,0,3,3
3126F2F5F8448LZMOARE9SIEM1GEPV,Her 21-year-old sister was seriously injured and remains in a critical condition at Belfast's Royal Victoria Hospital.,62,70,critical,3,4,7
3126F2F5F8448LZMOARE9SIEM1GEPV,Her 21-year-old sister was seriously injured and remains in a critical condition at Belfast's Royal Victoria Hospital.,62,80,critical condition,8,2,10
3126F2F5F8448LZMOARE9SIEM1GEPV,Her 21-year-old sister was seriously injured and remains in a critical condition at Belfast's Royal Victoria Hospital.,71,80,condition,0,1,1
3126F2F5F8448LZMOARE9SIEM1GEPV,Her 21-year-old sister was seriously injured and remains in a critical condition at Belfast's Royal Victoria Hospital.,84,116,Belfasts Royal Victoria Hospital,1,0,1
3126F2F5F8448LZMOARE9SIEM1GEPV,A Belfast Trust spokesperson confirmed that she had undergone surgery on Saturday afternoon.,2,9,Belfast,0,2,2
3126F2F5F8448LZMOARE9SIEM1GEPV,A Belfast Trust spokesperson confirmed that she had undergone surgery on Saturday afternoon.,16,28,spokesperson,5,8,13
3126F2F5F8448LZMOARE9SIEM1GEPV,A Belfast Trust spokesperson confirmed that she had undergone surgery on Saturday afternoon.,29,38,confirmed,1,2,3
3126F2F5F8448LZMOARE9SIEM1GEPV,A Belfast Trust spokesperson confirmed that she had undergone surgery on Saturday afternoon.,52,61,undergone,9,3,12
3126F2F5F8448LZMOARE9SIEM1GEPV,A Belfast Trust spokesperson confirmed that she had undergone surgery on Saturday afternoon.,52,69,undergone surgery,2,2,4
3126F2F5F8448LZMOARE9SIEM1GEPV,A Belfast Trust spokesperson confirmed that she had undergone surgery on Saturday afternoon.,62,69,surgery,1,2,3
3126F2F5F8448LZMOARE9SIEM1GEPV,She is believed to be a mother of two young children.,7,15,believed,0,1,1
3126F2F5F8448LZMOARE9SIEM1GEPV,A 26-year-old man is still being questioned by police on suspicion of murder.,33,43,questioned,2,0,2
3126F2F5F8448LZMOARE9SIEM1GEPV,A 26-year-old man is still being questioned by police on suspicion of murder.,57,66,suspicion,6,9,15
3126F2F5F8448LZMOARE9SIEM1GEPV,A 26-year-old man is still being questioned by police on suspicion of murder.,57,76,suspicion of murder,3,2,5
3126F2F5F8448LZMOARE9SIEM1GEPV,A 26-year-old man is still being questioned by police on suspicion of murder.,70,76,murder,1,0,1
3126F2F5F8448LZMOARE9SIEM1GEPV,"A man and woman, both aged 28, arrested on suspicion of assisting an offender were released, without charge, on Saturday evening.",43,52,suspicion,4,2,6
3126F2F5F8448LZMOARE9SIEM1GEPV,"A man and woman, both aged 28, arrested on suspicion of assisting an offender were released, without charge, on Saturday evening.",43,77,suspicion of assisting an offender,4,0,4
3126F2F5F8448LZMOARE9SIEM1GEPV,"A man and woman, both aged 28, arrested on suspicion of assisting an offender were released, without charge, on Saturday evening.",56,65,assisting,0,4,4
3126F2F5F8448LZMOARE9SIEM1GEPV,"A man and woman, both aged 28, arrested on suspicion of assisting an offender were released, without charge, on Saturday evening.",56,77,assisting an offender,1,1,2
3126F2F5F8448LZMOARE9SIEM1GEPV,"A man and woman, both aged 28, arrested on suspicion of assisting an offender were released, without charge, on Saturday evening.",69,77,offender,4,9,13
3126F2F5F8448LZMOARE9SIEM1GEPV,"A man and woman, both aged 28, arrested on suspicion of assisting an offender were released, without charge, on Saturday evening.",83,91,released,0,2,2
3126F2F5F8448LZMOARE9SIEM1GEPV,"A man and woman, both aged 28, arrested on suspicion of assisting an offender were released, without charge, on Saturday evening.",93,107,without charge,3,0,3
3126F2F5F8448LZMOARE9SIEM1GEPV,"A man and woman, both aged 28, arrested on suspicion of assisting an offender were released, without charge, on Saturday evening.",101,107,charge,0,2,2
3126F2F5F8448LZMOARE9SIEM1GEPV,They were all arrested in the Toome area within an hour on the shooting.,14,22,arrested,0,1,1
3126F2F5F8448LZMOARE9SIEM1GEPV,They were all arrested in the Toome area within an hour on the shooting.,30,35,Toome,0,2,2
3126F2F5F8448LZMOARE9SIEM1GEPV,"Parish priest Fr Andy Dolan told UTV the feeling in the area is one of ""shock and horror.""",0,6,Parish,1,0,1
3126F2F5F8448LZMOARE9SIEM1GEPV,"Parish priest Fr Andy Dolan told UTV the feeling in the area is one of ""shock and horror.""",0,13,Parish priest,2,1,3
3126F2F5F8448LZMOARE9SIEM1GEPV,"Parish priest Fr Andy Dolan told UTV the feeling in the area is one of ""shock and horror.""",14,27,Fr Andy Dolan,1,0,1
3126F2F5F8448LZMOARE9SIEM1GEPV,"Parish priest Fr Andy Dolan told UTV the feeling in the area is one of ""shock and horror.""",33,36,UTV,1,0,1
3126F2F5F8448LZMOARE9SIEM1GEPV,"Parish priest Fr Andy Dolan told UTV the feeling in the area is one of ""shock and horror.""",72,88,shock and horror,1,3,4
3126F2F5F8448LZMOARE9SIEM1GEPV,"Parish priest Fr Andy Dolan told UTV the feeling in the area is one of ""shock and horror.""",82,88,horror,1,1,2
3126F2F5F8448LZMOARE9SIEM1GEPV,"He said that the siblings were always together - if you ""saw one you saw the other.""",17,25,siblings,5,10,15
3JMQI2OLFZ6ZDU99C032ZLVYLXBDNB,Successive waves of bank sector clean-ups have failed to convince investors.,0,10,Successive,4,5,9
3JMQI2OLFZ6ZDU99C032ZLVYLXBDNB,Successive waves of bank sector clean-ups have failed to convince investors.,0,16,Successive waves,3,4,7
3JMQI2OLFZ6ZDU99C032ZLVYLXBDNB,Successive waves of bank sector clean-ups have failed to convince investors.,0,41,Successive waves of bank sector clean-ups,1,0,1
3JMQI2OLFZ6ZDU99C032ZLVYLXBDNB,Successive waves of bank sector clean-ups have failed to convince investors.,11,16,waves,1,1,2
3JMQI2OLFZ6ZDU99C032ZLVYLXBDNB,Successive waves of bank sector clean-ups have failed to convince investors.,20,31,bank sector,1,0,1
3JMQI2OLFZ6ZDU99C032ZLVYLXBDNB,Successive waves of bank sector clean-ups have failed to convince investors.,20,41,bank sector clean-ups,3,0,3
3JMQI2OLFZ6ZDU99C032ZLVYLXBDNB,Successive waves of bank sector clean-ups have failed to convince investors.,25,31,sector,1,0,1
3JMQI2OLFZ6ZDU99C032ZLVYLXBDNB,Successive waves of bank sector clean-ups have failed to convince investors.,32,41,clean-ups,1,4,5
3JMQI2OLFZ6ZDU99C032ZLVYLXBDNB,Successive waves of bank sector clean-ups have failed to convince investors.,57,65,convince,1,5,6
3JMQI2OLFZ6ZDU99C032ZLVYLXBDNB,Successive waves of bank sector clean-ups have failed to convince investors.,57,75,convince investors,0,1,1
3JMQI2OLFZ6ZDU99C032ZLVYLXBDNB,Successive waves of bank sector clean-ups have failed to convince investors.,66,75,investors,0,1,1
3JMQI2OLFZ6ZDU99C032ZLVYLXBDNB,"According to our correspondent, the toxic assets are a result of a property bubble experienced in Spain before the recession.",17,30,correspondent,4,5,9
3JMQI2OLFZ6ZDU99C032ZLVYLXBDNB,"According to our correspondent, the toxic assets are a result of a property bubble experienced in Spain before the recession.",36,41,toxic,0,2,2
3JMQI2OLFZ6ZDU99C032ZLVYLXBDNB,"According to our correspondent, the toxic assets are a result of a property bubble experienced in Spain before the recession.",36,48,toxic assets,6,6,12
3JMQI2OLFZ6ZDU99C032ZLVYLXBDNB,"According to our correspondent, the toxic assets are a result of a property bubble experienced in Spain before the recession.",42,48,assets,1,1,2
3JMQI2OLFZ6ZDU99C032ZLVYLXBDNB,"According to our correspondent, the toxic assets are a result of a property bubble experienced in Spain before the recession.",67,82,property bubble,9,5,14
3JMQI2OLFZ6ZDU99C032ZLVYLXBDNB,"According to our correspondent, the toxic assets are a result of a property bubble experienced in Spain before the recession.",76,82,bubble,0,2,2
3JMQI2OLFZ6ZDU99C032ZLVYLXBDNB,"According to our correspondent, the toxic assets are a result of a property bubble experienced in Spain before the recession.",115,124,recession,8,7,15
3JMQI2OLFZ6ZDU99C032ZLVYLXBDNB,"As a result, with the recession, so many people were left unable to pay for their mortgages, and the banks are left to deal with the after-effects.",23,32,recession,5,2,7
3JMQI2OLFZ6ZDU99C032ZLVYLXBDNB,"As a result, with the recession, so many people were left unable to pay for their mortgages, and the banks are left to deal with the after-effects.",83,92,mortgages,8,10,18
3JMQI2OLFZ6ZDU99C032ZLVYLXBDNB,"As a result, with the recession, so many people were left unable to pay for their mortgages, and the banks are left to deal with the after-effects.",134,147,after-effects,6,4,10
3JMQI2OLFZ6ZDU99C032ZLVYLXBDNB,"Banking reform is seen as urgent by many analysts, with yields on benchmark Spanish bonds currently close to six percent, meaning the country faces very high borrowing costs.",0,14,Banking reform,1,1,2
3JMQI2OLFZ6ZDU99C032ZLVYLXBDNB,"Banking reform is seen as urgent by many analysts, with yields on benchmark Spanish bonds currently close to six percent, meaning the country faces very high borrowing costs.",8,14,reform,0,1,1
3JMQI2OLFZ6ZDU99C032ZLVYLXBDNB,"Banking reform is seen as urgent by many analysts, with yields on benchmark Spanish bonds currently close to six percent, meaning the country faces very high borrowing costs.",26,32,urgent,1,0,1
3JMQI2OLFZ6ZDU99C032ZLVYLXBDNB,"Banking reform is seen as urgent by many analysts, with yields on benchmark Spanish bonds currently close to six percent, meaning the country faces very high borrowing costs.",41,49,analysts,6,2,8
3JMQI2OLFZ6ZDU99C032ZLVYLXBDNB,"Banking reform is seen as urgent by many analysts, with yields on benchmark Spanish bonds currently close to six percent, meaning the country faces very high borrowing costs.",56,62,yields,5,4,9
3JMQI2OLFZ6ZDU99C032ZLVYLXBDNB,"Banking reform is seen as urgent by many analysts, with yields on benchmark Spanish bonds currently close to six percent, meaning the country faces very high borrowing costs.",56,75,yields on benchmark,1,1,2
3JMQI2OLFZ6ZDU99C032ZLVYLXBDNB,"Banking reform is seen as urgent by many analysts, with yields on benchmark Spanish bonds currently close to six percent, meaning the country faces very high borrowing costs.",56,89,yields on benchmark Spanish bonds,2,0,2
3JMQI2OLFZ6ZDU99C032ZLVYLXBDNB,"Banking reform is seen as urgent by many analysts, with yields on benchmark Spanish bonds currently close to six percent, meaning the country faces very high borrowing costs.",66,75,benchmark,7,4,11
3JMQI2OLFZ6ZDU99C032ZLVYLXBDNB,"Banking reform is seen as urgent by many analysts, with yields on benchmark Spanish bonds currently close to six percent, meaning the country faces very high borrowing costs.",66,89,benchmark Spanish bonds,1,2,3
3JMQI2OLFZ6ZDU99C032ZLVYLXBDNB,"Banking reform is seen as urgent by many analysts, with yields on benchmark Spanish bonds currently close to six percent, meaning the country faces very high borrowing costs.",153,173,high borrowing costs,1,1,2
3JMQI2OLFZ6ZDU99C032ZLVYLXBDNB,"Banking reform is seen as urgent by many analysts, with yields on benchmark Spanish bonds currently close to six percent, meaning the country faces very high borrowing costs.",158,167,borrowing,1,2,3
3JMQI2OLFZ6ZDU99C032ZLVYLXBDNB,"Banking reform is seen as urgent by many analysts, with yields on benchmark Spanish bonds currently close to six percent, meaning the country faces very high borrowing costs.",158,173,borrowing costs,1,2,3
3JMQI2OLFZ6ZDU99C032ZLVYLXBDNB,"The pressure right now is very high and the discredit would be huge if the reform was not to be approved this Friday, a banking source told",45,54,discredit,10,9,19
3JMQI2OLFZ6ZDU99C032ZLVYLXBDNB,The Spanish Government is expected to announce a new round of financial sector reforms later today.,26,34,expected,0,1,1
3JMQI2OLFZ6ZDU99C032ZLVYLXBDNB,The Spanish Government is expected to announce a new round of financial sector reforms later today.,38,46,announce,1,1,2
3JMQI2OLFZ6ZDU99C032ZLVYLXBDNB,The Spanish Government is expected to announce a new round of financial sector reforms later today.,62,71,financial,0,1,1
3JMQI2OLFZ6ZDU99C032ZLVYLXBDNB,The Spanish Government is expected to announce a new round of financial sector reforms later today.,62,86,financial sector reforms,5,1,6
3JMQI2OLFZ6ZDU99C032ZLVYLXBDNB,The Spanish Government is expected to announce a new round of financial sector reforms later today.,79,86,reforms,1,1,2
33Q5P9PUSPNJPRHEFSJLA2KPBOACZL,"With the long process of purchasing Motorola Mobility finally drawing to a close, Google seems to be shifting their attention to the process of selling hardware on their own.",14,21,process,0,2,2
33Q5P9PUSPNJPRHEFSJLA2KPBOACZL,"With the long process of purchasing Motorola Mobility finally drawing to a close, Google seems to be shifting their attention to the process of selling hardware on their own.",25,35,purchasing,2,2,4
33Q5P9PUSPNJPRHEFSJLA2KPBOACZL,"With the long process of purchasing Motorola Mobility finally drawing to a close, Google seems to be shifting their attention to the process of selling hardware on their own.",62,69,drawing,1,2,3
33Q5P9PUSPNJPRHEFSJLA2KPBOACZL,"With the long process of purchasing Motorola Mobility finally drawing to a close, Google seems to be shifting their attention to the process of selling hardware on their own.",62,72,drawing to,1,0,1
33Q5P9PUSPNJPRHEFSJLA2KPBOACZL,"With the long process of purchasing Motorola Mobility finally drawing to a close, Google seems to be shifting their attention to the process of selling hardware on their own.",62,80,drawing to a close,3,0,3
33Q5P9PUSPNJPRHEFSJLA2KPBOACZL,"With the long process of purchasing Motorola Mobility finally drawing to a close, Google seems to be shifting their attention to the process of selling hardware on their own.",101,109,shifting,2,3,5
33Q5P9PUSPNJPRHEFSJLA2KPBOACZL,"With the long process of purchasing Motorola Mobility finally drawing to a close, Google seems to be shifting their attention to the process of selling hardware on their own.",101,125,shifting their attention,1,0,1
33Q5P9PUSPNJPRHEFSJLA2KPBOACZL,"With the long process of purchasing Motorola Mobility finally drawing to a close, Google seems to be shifting their attention to the process of selling hardware on their own.",116,125,attention,1,1,2
33Q5P9PUSPNJPRHEFSJLA2KPBOACZL,"With the long process of purchasing Motorola Mobility finally drawing to a close, Google seems to be shifting their attention to the process of selling hardware on their own.",152,160,hardware,1,2,3
33Q5P9PUSPNJPRHEFSJLA2KPBOACZL,The Wall Street Journal reported earlier this week that Google was looking at fleshing out the Devices section of the Google Play Store with unlocked smartphones and tablets - all of them lead devices -  from up to five major hardware manufacturers.,78,86,fleshing,6,8,14
33Q5P9PUSPNJPRHEFSJLA2KPBOACZL,The Wall Street Journal reported earlier this week that Google was looking at fleshing out the Devices section of the Google Play Store with unlocked smartphones and tablets - all of them lead devices -  from up to five major hardware manufacturers.,78,90,fleshing out,6,3,9
33Q5P9PUSPNJPRHEFSJLA2KPBOACZL,The Wall Street Journal reported earlier this week that Google was looking at fleshing out the Devices section of the Google Play Store with unlocked smartphones and tablets - all of them lead devices -  from up to five major hardware manufacturers.,141,149,unlocked,3,3,6
33Q5P9PUSPNJPRHEFSJLA2KPBOACZL,The Wall Street Journal reported earlier this week that Google was looking at fleshing out the Devices section of the Google Play Store with unlocked smartphones and tablets - all of them lead devices -  from up to five major hardware manufacturers.,150,161,smartphones,2,0,2
33Q5P9PUSPNJPRHEFSJLA2KPBOACZL,The Wall Street Journal reported earlier this week that Google was looking at fleshing out the Devices section of the Google Play Store with unlocked smartphones and tablets - all of them lead devices -  from up to five major hardware manufacturers.,188,192,lead,0,1,1
33Q5P9PUSPNJPRHEFSJLA2KPBOACZL,The Wall Street Journal reported earlier this week that Google was looking at fleshing out the Devices section of the Google Play Store with unlocked smartphones and tablets - all of them lead devices -  from up to five major hardware manufacturers.,188,200,lead devices,2,3,5
33Q5P9PUSPNJPRHEFSJLA2KPBOACZL,The Wall Street Journal reported earlier this week that Google was looking at fleshing out the Devices section of the Google Play Store with unlocked smartphones and tablets - all of them lead devices -  from up to five major hardware manufacturers.,193,200,devices,1,0,1
33Q5P9PUSPNJPRHEFSJLA2KPBOACZL,The Wall Street Journal reported earlier this week that Google was looking at fleshing out the Devices section of the Google Play Store with unlocked smartphones and tablets - all of them lead devices -  from up to five major hardware manufacturers.,226,234,hardware,1,1,2
33Q5P9PUSPNJPRHEFSJLA2KPBOACZL,The Wall Street Journal reported earlier this week that Google was looking at fleshing out the Devices section of the Google Play Store with unlocked smartphones and tablets - all of them lead devices -  from up to five major hardware manufacturers.,226,248,hardware manufacturers,1,0,1
33Q5P9PUSPNJPRHEFSJLA2KPBOACZL,The Wall Street Journal reported earlier this week that Google was looking at fleshing out the Devices section of the Google Play Store with unlocked smartphones and tablets - all of them lead devices -  from up to five major hardware manufacturers.,235,248,manufacturers,4,1,5
33Q5P9PUSPNJPRHEFSJLA2KPBOACZL,"Now that Google will have their own in-house hardware team, it stands to reason that they might soon offer their own devices alongside those from hardware partners like Samsung and HTC.",36,44,in-house,5,5,10
33Q5P9PUSPNJPRHEFSJLA2KPBOACZL,"Now that Google will have their own in-house hardware team, it stands to reason that they might soon offer their own devices alongside those from hardware partners like Samsung and HTC.",73,79,reason,0,1,1
33Q5P9PUSPNJPRHEFSJLA2KPBOACZL,"Now that Google will have their own in-house hardware team, it stands to reason that they might soon offer their own devices alongside those from hardware partners like Samsung and HTC.",117,134,devices alongside,1,1,2
33Q5P9PUSPNJPRHEFSJLA2KPBOACZL,"Now that Google will have their own in-house hardware team, it stands to reason that they might soon offer their own devices alongside those from hardware partners like Samsung and HTC.",125,134,alongside,2,5,7
33Q5P9PUSPNJPRHEFSJLA2KPBOACZL,"Now that Google will have their own in-house hardware team, it stands to reason that they might soon offer their own devices alongside those from hardware partners like Samsung and HTC.",146,154,hardware,1,0,1
33Q5P9PUSPNJPRHEFSJLA2KPBOACZL,"Now that Google will have their own in-house hardware team, it stands to reason that they might soon offer their own devices alongside those from hardware partners like Samsung and HTC.",146,163,hardware partners,1,0,1
33Q5P9PUSPNJPRHEFSJLA2KPBOACZL,Motorola is known around the world for innovation in communications and is focused on advancing the way the world connects.,39,49,innovation,10,10,20
33Q5P9PUSPNJPRHEFSJLA2KPBOACZL,Motorola is known around the world for innovation in communications and is focused on advancing the way the world connects.,53,67,communications,2,1,3
33Q5P9PUSPNJPRHEFSJLA2KPBOACZL,Motorola is known around the world for innovation in communications and is focused on advancing the way the world connects.,75,82,focused,1,3,4
33Q5P9PUSPNJPRHEFSJLA2KPBOACZL,Motorola is known around the world for innovation in communications and is focused on advancing the way the world connects.,86,95,advancing,4,1,5
33Q5P9PUSPNJPRHEFSJLA2KPBOACZL,Motorola is known around the world for innovation in communications and is focused on advancing the way the world connects.,114,122,connects,1,0,1
3IKMEYR0LWWB2EQQIYR5BANQVOKK2Y,Gardai investigating a shooting in west Dublin last night have recovered a gun.,0,6,Gardai,1,0,1
3IKMEYR0LWWB2EQQIYR5BANQVOKK2Y,Gardai investigating a shooting in west Dublin last night have recovered a gun.,7,20,investigating,9,5,14
3IKMEYR0LWWB2EQQIYR5BANQVOKK2Y,Gardai investigating a shooting in west Dublin last night have recovered a gun.,23,31,shooting,0,1,1
3IKMEYR0LWWB2EQQIYR5BANQVOKK2Y,Gardai investigating a shooting in west Dublin last night have recovered a gun.,63,72,recovered,4,2,6
3IKMEYR0LWWB2EQQIYR5BANQVOKK2Y,A man (32) was wounded while sitting in a car outside Finnegan's pub on Sarsfield Road in Ballyfermot at about 11.10pm.,15,22,wounded,2,3,5
3IKMEYR0LWWB2EQQIYR5BANQVOKK2Y,A man (32) was wounded while sitting in a car outside Finnegan's pub on Sarsfield Road in Ballyfermot at about 11.10pm.,65,68,pub,0,2,2
3IKMEYR0LWWB2EQQIYR5BANQVOKK2Y,He was targetted by a lone gunman who discharged a number of shots.,7,16,targetted,5,9,14
3IKMEYR0LWWB2EQQIYR5BANQVOKK2Y,He was targetted by a lone gunman who discharged a number of shots.,22,26,lone,2,3,5
3IKMEYR0LWWB2EQQIYR5BANQVOKK2Y,He was targetted by a lone gunman who discharged a number of shots.,22,33,lone gunman,1,0,1
3IKMEYR0LWWB2EQQIYR5BANQVOKK2Y,He was targetted by a lone gunman who discharged a number of shots.,27,33,gunman,0,1,1
3IKMEYR0LWWB2EQQIYR5BANQVOKK2Y,He was targetted by a lone gunman who discharged a number of shots.,38,48,discharged,10,6,16
3IKMEYR0LWWB2EQQIYR5BANQVOKK2Y,The victim was taken to Tallaght Hospital for treatment but his injuries were not said to be serious.,4,10,victim,1,3,4
3IKMEYR0LWWB2EQQIYR5BANQVOKK2Y,The victim was taken to Tallaght Hospital for treatment but his injuries were not said to be serious.,46,55,treatment,2,0,2
3IKMEYR0LWWB2EQQIYR5BANQVOKK2Y,The victim was taken to Tallaght Hospital for treatment but his injuries were not said to be serious.,64,72,injuries,0,3,3
3IKMEYR0LWWB2EQQIYR5BANQVOKK2Y,"The gunman left the scene in a getaway car which was found burned out at Goldenbridge Terrace, Inchicore last night.",31,38,getaway,1,4,5
3IKMEYR0LWWB2EQQIYR5BANQVOKK2Y,"The gunman left the scene in a getaway car which was found burned out at Goldenbridge Terrace, Inchicore last night.",31,42,getaway car,3,3,6
3IKMEYR0LWWB2EQQIYR5BANQVOKK2Y,"The gunman left the scene in a getaway car which was found burned out at Goldenbridge Terrace, Inchicore last night.",59,65,burned,2,0,2
3IKMEYR0LWWB2EQQIYR5BANQVOKK2Y,"The gunman left the scene in a getaway car which was found burned out at Goldenbridge Terrace, Inchicore last night.",95,104,Inchicore,0,1,1
3IKMEYR0LWWB2EQQIYR5BANQVOKK2Y,A gun was recovered close to the burned out car.,10,19,recovered,1,0,1
3IKMEYR0LWWB2EQQIYR5BANQVOKK2Y,A gun was recovered close to the burned out car.,33,47,burned out car,1,0,1
3IKMEYR0LWWB2EQQIYR5BANQVOKK2Y,The scenes of the shooting and fire are being preserved by gardai for a technical examination.,46,55,preserved,4,4,8
3IKMEYR0LWWB2EQQIYR5BANQVOKK2Y,The scenes of the shooting and fire are being preserved by gardai for a technical examination.,59,65,gardai,2,3,5
3IKMEYR0LWWB2EQQIYR5BANQVOKK2Y,The scenes of the shooting and fire are being preserved by gardai for a technical examination.,72,81,technical,3,0,3
3IKMEYR0LWWB2EQQIYR5BANQVOKK2Y,The scenes of the shooting and fire are being preserved by gardai for a technical examination.,72,93,technical examination,6,3,9
3IKMEYR0LWWB2EQQIYR5BANQVOKK2Y,The scenes of the shooting and fire are being preserved by gardai for a technical examination.,82,93,examination,2,0,2
3IKMEYR0LWWB2EQQIYR5BANQVOKK2Y,The Philippines foreign secretary has said he and the Chinese ambassador have agreed to resolve diplomatically a stand-off involving a Philippine warship and two Chinese surveillance vessels in a disputed area of the South China Sea.,16,33,foreign secretary,2,0,2
3IKMEYR0LWWB2EQQIYR5BANQVOKK2Y,The Philippines foreign secretary has said he and the Chinese ambassador have agreed to resolve diplomatically a stand-off involving a Philippine warship and two Chinese surveillance vessels in a disputed area of the South China Sea.,24,33,secretary,1,0,1
3IKMEYR0LWWB2EQQIYR5BANQVOKK2Y,The Philippines foreign secretary has said he and the Chinese ambassador have agreed to resolve diplomatically a stand-off involving a Philippine warship and two Chinese surveillance vessels in a disputed area of the South China Sea.,62,72,ambassador,4,2,6
3IKMEYR0LWWB2EQQIYR5BANQVOKK2Y,The Philippines foreign secretary has said he and the Chinese ambassador have agreed to resolve diplomatically a stand-off involving a Philippine warship and two Chinese surveillance vessels in a disputed area of the South China Sea.,88,95,resolve,1,3,4
3IKMEYR0LWWB2EQQIYR5BANQVOKK2Y,The Philippines foreign secretary has said he and the Chinese ambassador have agreed to resolve diplomatically a stand-off involving a Philippine warship and two Chinese surveillance vessels in a disputed area of the South China Sea.,88,110,resolve diplomatically,3,2,5
3IKMEYR0LWWB2EQQIYR5BANQVOKK2Y,The Philippines foreign secretary has said he and the Chinese ambassador have agreed to resolve diplomatically a stand-off involving a Philippine warship and two Chinese surveillance vessels in a disputed area of the South China Sea.,96,110,diplomatically,7,5,12
3IKMEYR0LWWB2EQQIYR5BANQVOKK2Y,The Philippines foreign secretary has said he and the Chinese ambassador have agreed to resolve diplomatically a stand-off involving a Philippine warship and two Chinese surveillance vessels in a disputed area of the South China Sea.,113,122,stand-off,5,6,11
3IKMEYR0LWWB2EQQIYR5BANQVOKK2Y,The Philippines foreign secretary has said he and the Chinese ambassador have agreed to resolve diplomatically a stand-off involving a Philippine warship and two Chinese surveillance vessels in a disputed area of the South China Sea.,113,132,stand-off involving,0,1,1
3IKMEYR0LWWB2EQQIYR5BANQVOKK2Y,The Philippines foreign secretary has said he and the Chinese ambassador have agreed to resolve diplomatically a stand-off involving a Philippine warship and two Chinese surveillance vessels in a disputed area of the South China Sea.,146,153,warship,3,0,3
3IKMEYR0LWWB2EQQIYR5BANQVOKK2Y,The Philippines foreign secretary has said he and the Chinese ambassador have agreed to resolve diplomatically a stand-off involving a Philippine warship and two Chinese surveillance vessels in a disputed area of the South China Sea.,170,182,surveillance,4,5,9
3IKMEYR0LWWB2EQQIYR5BANQVOKK2Y,The Philippines foreign secretary has said he and the Chinese ambassador have agreed to resolve diplomatically a stand-off involving a Philippine warship and two Chinese surveillance vessels in a disputed area of the South China Sea.,170,190,surveillance vessels,5,4,9
3IKMEYR0LWWB2EQQIYR5BANQVOKK2Y,The Philippines foreign secretary has said he and the Chinese ambassador have agreed to resolve diplomatically a stand-off involving a Philippine warship and two Chinese surveillance vessels in a disputed area of the South China Sea.,183,190,vessels,1,1,2
3IKMEYR0LWWB2EQQIYR5BANQVOKK2Y,The Philippines foreign secretary has said he and the Chinese ambassador have agreed to resolve diplomatically a stand-off involving a Philippine warship and two Chinese surveillance vessels in a disputed area of the South China Sea.,196,204,disputed,4,2,6
3IKMEYR0LWWB2EQQIYR5BANQVOKK2Y,The Philippines foreign secretary has said he and the Chinese ambassador have agreed to resolve diplomatically a stand-off involving a Philippine warship and two Chinese surveillance vessels in a disputed area of the South China Sea.,196,209,disputed area,0,2,2
329E6HTMSW30NWM9MY5AUKSI12KK39,"On Tuesday, Filipino sailors from the warship boarded the Chinese vessels for an inspection, discovering large amounts of illegally collected coral, giant clams and live sharks inside the first boat, the department said.",12,20,Filipino,0,1,1
329E6HTMSW30NWM9MY5AUKSI12KK39,"On Tuesday, Filipino sailors from the warship boarded the Chinese vessels for an inspection, discovering large amounts of illegally collected coral, giant clams and live sharks inside the first boat, the department said.",12,28,Filipino sailors,0,1,1
329E6HTMSW30NWM9MY5AUKSI12KK39,"On Tuesday, Filipino sailors from the warship boarded the Chinese vessels for an inspection, discovering large amounts of illegally collected coral, giant clams and live sharks inside the first boat, the department said.",38,45,warship,3,3,6
329E6HTMSW30NWM9MY5AUKSI12KK39,"On Tuesday, Filipino sailors from the warship boarded the Chinese vessels for an inspection, discovering large amounts of illegally collected coral, giant clams and live sharks inside the first boat, the department said.",46,53,boarded,2,3,5
329E6HTMSW30NWM9MY5AUKSI12KK39,"On Tuesday, Filipino sailors from the warship boarded the Chinese vessels for an inspection, discovering large amounts of illegally collected coral, giant clams and live sharks inside the first boat, the department said.",66,73,vessels,5,2,7
329E6HTMSW30NWM9MY5AUKSI12KK39,"On Tuesday, Filipino sailors from the warship boarded the Chinese vessels for an inspection, discovering large amounts of illegally collected coral, giant clams and live sharks inside the first boat, the department said.",81,91,inspection,6,1,7
329E6HTMSW30NWM9MY5AUKSI12KK39,"On Tuesday, Filipino sailors from the warship boarded the Chinese vessels for an inspection, discovering large amounts of illegally collected coral, giant clams and live sharks inside the first boat, the department said.",93,104,discovering,1,0,1
329E6HTMSW30NWM9MY5AUKSI12KK39,"On Tuesday, Filipino sailors from the warship boarded the Chinese vessels for an inspection, discovering large amounts of illegally collected coral, giant clams and live sharks inside the first boat, the department said.",122,131,illegally,2,3,5
329E6HTMSW30NWM9MY5AUKSI12KK39,"On Tuesday, Filipino sailors from the warship boarded the Chinese vessels for an inspection, discovering large amounts of illegally collected coral, giant clams and live sharks inside the first boat, the department said.",122,141,illegally collected,3,1,4
329E6HTMSW30NWM9MY5AUKSI12KK39,"On Tuesday, Filipino sailors from the warship boarded the Chinese vessels for an inspection, discovering large amounts of illegally collected coral, giant clams and live sharks inside the first boat, the department said.",142,147,coral,2,1,3
329E6HTMSW30NWM9MY5AUKSI12KK39,"On Tuesday, Filipino sailors from the warship boarded the Chinese vessels for an inspection, discovering large amounts of illegally collected coral, giant clams and live sharks inside the first boat, the department said.",149,160,giant clams,1,0,1
329E6HTMSW30NWM9MY5AUKSI12KK39,"On Tuesday, Filipino sailors from the warship boarded the Chinese vessels for an inspection, discovering large amounts of illegally collected coral, giant clams and live sharks inside the first boat, the department said.",155,160,clams,1,2,3
329E6HTMSW30NWM9MY5AUKSI12KK39,"On Tuesday, Filipino sailors from the warship boarded the Chinese vessels for an inspection, discovering large amounts of illegally collected coral, giant clams and live sharks inside the first boat, the department said.",204,214,department,1,0,1
329E6HTMSW30NWM9MY5AUKSI12KK39,"Two Chinese maritime surveillance ships, identified as Zhonggou Haijian 75 and Zhonggou Haijian 84, later approached and positioned themselves between the Philippine warship and the Chinese fishing vessels ""thus preventing the arrests of the erring Chinese fishermen"", the statement said.",12,20,maritime,5,1,6
329E6HTMSW30NWM9MY5AUKSI12KK39,"Two Chinese maritime surveillance ships, identified as Zhonggou Haijian 75 and Zhonggou Haijian 84, later approached and positioned themselves between the Philippine warship and the Chinese fishing vessels ""thus preventing the arrests of the erring Chinese fishermen"", the statement said.",12,33,maritime surveillance,5,2,7
329E6HTMSW30NWM9MY5AUKSI12KK39,"Two Chinese maritime surveillance ships, identified as Zhonggou Haijian 75 and Zhonggou Haijian 84, later approached and positioned themselves between the Philippine warship and the Chinese fishing vessels ""thus preventing the arrests of the erring Chinese fishermen"", the statement said.",12,39,maritime surveillance ships,4,0,4
329E6HTMSW30NWM9MY5AUKSI12KK39,"Two Chinese maritime surveillance ships, identified as Zhonggou Haijian 75 and Zhonggou Haijian 84, later approached and positioned themselves between the Philippine warship and the Chinese fishing vessels ""thus preventing the arrests of the erring Chinese fishermen"", the statement said.",21,33,surveillance,6,3,9
329E6HTMSW30NWM9MY5AUKSI12KK39,"Two Chinese maritime surveillance ships, identified as Zhonggou Haijian 75 and Zhonggou Haijian 84, later approached and positioned themselves between the Philippine warship and the Chinese fishing vessels ""thus preventing the arrests of the erring Chinese fishermen"", the statement said.",21,39,surveillance ships,0,1,1
329E6HTMSW30NWM9MY5AUKSI12KK39,"Two Chinese maritime surveillance ships, identified as Zhonggou Haijian 75 and Zhonggou Haijian 84, later approached and positioned themselves between the Philippine warship and the Chinese fishing vessels ""thus preventing the arrests of the erring Chinese fishermen"", the statement said.",106,116,approached,2,1,3
329E6HTMSW30NWM9MY5AUKSI12KK39,"Two Chinese maritime surveillance ships, identified as Zhonggou Haijian 75 and Zhonggou Haijian 84, later approached and positioned themselves between the Philippine warship and the Chinese fishing vessels ""thus preventing the arrests of the erring Chinese fishermen"", the statement said.",121,131,positioned,3,0,3
329E6HTMSW30NWM9MY5AUKSI12KK39,"Two Chinese maritime surveillance ships, identified as Zhonggou Haijian 75 and Zhonggou Haijian 84, later approached and positioned themselves between the Philippine warship and the Chinese fishing vessels ""thus preventing the arrests of the erring Chinese fishermen"", the statement said.",166,173,warship,0,2,2
329E6HTMSW30NWM9MY5AUKSI12KK39,"Two Chinese maritime surveillance ships, identified as Zhonggou Haijian 75 and Zhonggou Haijian 84, later approached and positioned themselves between the Philippine warship and the Chinese fishing vessels ""thus preventing the arrests of the erring Chinese fishermen"", the statement said.",190,205,fishing vessels,1,1,2
329E6HTMSW30NWM9MY5AUKSI12KK39,"Two Chinese maritime surveillance ships, identified as Zhonggou Haijian 75 and Zhonggou Haijian 84, later approached and positioned themselves between the Philippine warship and the Chinese fishing vessels ""thus preventing the arrests of the erring Chinese fishermen"", the statement said.",198,205,vessels,0,2,2
329E6HTMSW30NWM9MY5AUKSI12KK39,"Two Chinese maritime surveillance ships, identified as Zhonggou Haijian 75 and Zhonggou Haijian 84, later approached and positioned themselves between the Philippine warship and the Chinese fishing vessels ""thus preventing the arrests of the erring Chinese fishermen"", the statement said.",212,222,preventing,1,0,1
329E6HTMSW30NWM9MY5AUKSI12KK39,"Two Chinese maritime surveillance ships, identified as Zhonggou Haijian 75 and Zhonggou Haijian 84, later approached and positioned themselves between the Philippine warship and the Chinese fishing vessels ""thus preventing the arrests of the erring Chinese fishermen"", the statement said.",242,248,erring,10,9,19
329E6HTMSW30NWM9MY5AUKSI12KK39,"Chinese officials, who refer to Scarborough Shoal as Huangyan Island, have in the past asserted Chinese sovereignty over the area.",32,43,Scarborough,1,0,1
329E6HTMSW30NWM9MY5AUKSI12KK39,"Chinese officials, who refer to Scarborough Shoal as Huangyan Island, have in the past asserted Chinese sovereignty over the area.",32,49,Scarborough Shoal,1,0,1
329E6HTMSW30NWM9MY5AUKSI12KK39,"Chinese officials, who refer to Scarborough Shoal as Huangyan Island, have in the past asserted Chinese sovereignty over the area.",53,61,Huangyan,1,0,1
329E6HTMSW30NWM9MY5AUKSI12KK39,"Chinese officials, who refer to Scarborough Shoal as Huangyan Island, have in the past asserted Chinese sovereignty over the area.",87,95,asserted,9,5,14
329E6HTMSW30NWM9MY5AUKSI12KK39,"Chinese officials, who refer to Scarborough Shoal as Huangyan Island, have in the past asserted Chinese sovereignty over the area.",104,115,sovereignty,10,10,20
329E6HTMSW30NWM9MY5AUKSI12KK39,"The Philippines refers to the shoal, a rich fishing ground, as Panatag.",16,22,refers,0,2,2
329E6HTMSW30NWM9MY5AUKSI12KK39,"The Philippines refers to the shoal, a rich fishing ground, as Panatag.",30,35,shoal,9,3,12
329E6HTMSW30NWM9MY5AUKSI12KK39,"Last year the Philippines accused Chinese vessels of intruding into other parts of what it considers Philippine territory near the South China Sea, including the Spratlys.",26,33,accused,0,5,5
329E6HTMSW30NWM9MY5AUKSI12KK39,"Last year the Philippines accused Chinese vessels of intruding into other parts of what it considers Philippine territory near the South China Sea, including the Spratlys.",42,49,vessels,1,1,2
329E6HTMSW30NWM9MY5AUKSI12KK39,"Last year the Philippines accused Chinese vessels of intruding into other parts of what it considers Philippine territory near the South China Sea, including the Spratlys.",53,62,intruding,5,6,11
329E6HTMSW30NWM9MY5AUKSI12KK39,"Last year the Philippines accused Chinese vessels of intruding into other parts of what it considers Philippine territory near the South China Sea, including the Spratlys.",53,67,intruding into,0,1,1
329E6HTMSW30NWM9MY5AUKSI12KK39,"Last year the Philippines accused Chinese vessels of intruding into other parts of what it considers Philippine territory near the South China Sea, including the Spratlys.",112,121,territory,2,2,4
329E6HTMSW30NWM9MY5AUKSI12KK39,"Last year the Philippines accused Chinese vessels of intruding into other parts of what it considers Philippine territory near the South China Sea, including the Spratlys.",162,170,Spratlys,2,0,2
3XD2A6FGFNVKQHOX8GFMCJMEIO7S9F,"Thousands of Russians have rallied in Moscow and St Petersburg in the past two days, facing off against tens of thousands of police and interior ministry troops.",0,9,Thousands,1,0,1
3XD2A6FGFNVKQHOX8GFMCJMEIO7S9F,"Thousands of Russians have rallied in Moscow and St Petersburg in the past two days, facing off against tens of thousands of police and interior ministry troops.",22,34,have rallied,0,1,1
3XD2A6FGFNVKQHOX8GFMCJMEIO7S9F,"Thousands of Russians have rallied in Moscow and St Petersburg in the past two days, facing off against tens of thousands of police and interior ministry troops.",27,34,rallied,3,9,12
3XD2A6FGFNVKQHOX8GFMCJMEIO7S9F,"Thousands of Russians have rallied in Moscow and St Petersburg in the past two days, facing off against tens of thousands of police and interior ministry troops.",52,62,Petersburg,1,0,1
3XD2A6FGFNVKQHOX8GFMCJMEIO7S9F,"Thousands of Russians have rallied in Moscow and St Petersburg in the past two days, facing off against tens of thousands of police and interior ministry troops.",85,95,facing off,1,5,6
3XD2A6FGFNVKQHOX8GFMCJMEIO7S9F,"Thousands of Russians have rallied in Moscow and St Petersburg in the past two days, facing off against tens of thousands of police and interior ministry troops.",112,121,thousands,1,0,1
3XD2A6FGFNVKQHOX8GFMCJMEIO7S9F,"Thousands of Russians have rallied in Moscow and St Petersburg in the past two days, facing off against tens of thousands of police and interior ministry troops.",136,144,interior,1,3,4
3XD2A6FGFNVKQHOX8GFMCJMEIO7S9F,"Thousands of Russians have rallied in Moscow and St Petersburg in the past two days, facing off against tens of thousands of police and interior ministry troops.",136,153,interior ministry,1,0,1
3XD2A6FGFNVKQHOX8GFMCJMEIO7S9F,"Thousands of Russians have rallied in Moscow and St Petersburg in the past two days, facing off against tens of thousands of police and interior ministry troops.",136,160,interior ministry troops,2,1,3
3XD2A6FGFNVKQHOX8GFMCJMEIO7S9F,"Thousands of Russians have rallied in Moscow and St Petersburg in the past two days, facing off against tens of thousands of police and interior ministry troops.",145,153,ministry,2,0,2
3XD2A6FGFNVKQHOX8GFMCJMEIO7S9F,"Thousands of Russians have rallied in Moscow and St Petersburg in the past two days, facing off against tens of thousands of police and interior ministry troops.",154,160,troops,0,2,2
3XD2A6FGFNVKQHOX8GFMCJMEIO7S9F,Hundreds of protesters have been detained in both cities.,0,8,Hundreds,1,0,1
3XD2A6FGFNVKQHOX8GFMCJMEIO7S9F,Hundreds of protesters have been detained in both cities.,12,22,protesters,2,4,6
3XD2A6FGFNVKQHOX8GFMCJMEIO7S9F,Hundreds of protesters have been detained in both cities.,33,41,detained,7,10,17
3XD2A6FGFNVKQHOX8GFMCJMEIO7S9F,Gorbachev told the Interfax news agency that authorities must hold a fresh election or deal with a rising tide of discontent.,0,9,Gorbachev,1,0,1
3XD2A6FGFNVKQHOX8GFMCJMEIO7S9F,Gorbachev told the Interfax news agency that authorities must hold a fresh election or deal with a rising tide of discontent.,19,27,Interfax,1,1,2
3XD2A6FGFNVKQHOX8GFMCJMEIO7S9F,Gorbachev told the Interfax news agency that authorities must hold a fresh election or deal with a rising tide of discontent.,62,83,hold a fresh election,1,0,1
3XD2A6FGFNVKQHOX8GFMCJMEIO7S9F,Gorbachev told the Interfax news agency that authorities must hold a fresh election or deal with a rising tide of discontent.,75,83,election,1,0,1
3XD2A6FGFNVKQHOX8GFMCJMEIO7S9F,Gorbachev told the Interfax news agency that authorities must hold a fresh election or deal with a rising tide of discontent.,97,124,a rising tide of discontent,0,1,1
3XD2A6FGFNVKQHOX8GFMCJMEIO7S9F,Gorbachev told the Interfax news agency that authorities must hold a fresh election or deal with a rising tide of discontent.,99,110,rising tide,1,1,2
3XD2A6FGFNVKQHOX8GFMCJMEIO7S9F,Gorbachev told the Interfax news agency that authorities must hold a fresh election or deal with a rising tide of discontent.,99,124,rising tide of discontent,3,3,6
3XD2A6FGFNVKQHOX8GFMCJMEIO7S9F,Gorbachev told the Interfax news agency that authorities must hold a fresh election or deal with a rising tide of discontent.,106,110,tide,0,3,3
3XD2A6FGFNVKQHOX8GFMCJMEIO7S9F,Gorbachev told the Interfax news agency that authorities must hold a fresh election or deal with a rising tide of discontent.,106,124,tide of discontent,1,1,2
3XD2A6FGFNVKQHOX8GFMCJMEIO7S9F,Gorbachev told the Interfax news agency that authorities must hold a fresh election or deal with a rising tide of discontent.,114,124,discontent,6,8,14
3XD2A6FGFNVKQHOX8GFMCJMEIO7S9F,"Vladimir Putin's United Russia party won less than 50% of Sunday's vote, a steep fall from its earlier two-thirds majority, according to preliminary results.",0,8,Vladimir,1,0,1
3XD2A6FGFNVKQHOX8GFMCJMEIO7S9F,"Vladimir Putin's United Russia party won less than 50% of Sunday's vote, a steep fall from its earlier two-thirds majority, according to preliminary results.",75,80,steep,1,2,3
3XD2A6FGFNVKQHOX8GFMCJMEIO7S9F,"Vladimir Putin's United Russia party won less than 50% of Sunday's vote, a steep fall from its earlier two-thirds majority, according to preliminary results.",75,85,steep fall,1,5,6
3XD2A6FGFNVKQHOX8GFMCJMEIO7S9F,"Vladimir Putin's United Russia party won less than 50% of Sunday's vote, a steep fall from its earlier two-thirds majority, according to preliminary results.",114,122,majority,0,2,2
3XD2A6FGFNVKQHOX8GFMCJMEIO7S9F,"Vladimir Putin's United Russia party won less than 50% of Sunday's vote, a steep fall from its earlier two-thirds majority, according to preliminary results.",137,148,preliminary,9,4,13
3XD2A6FGFNVKQHOX8GFMCJMEIO7S9F,"Vladimir Putin's United Russia party won less than 50% of Sunday's vote, a steep fall from its earlier two-thirds majority, according to preliminary results.",137,156,preliminary results,2,2,4
3XD2A6FGFNVKQHOX8GFMCJMEIO7S9F,"But opposition parties and international observers said the vote was marred by vote-rigging, including alleged ballot-box stuffing and false voter rolls.",4,14,opposition,3,1,4
3XD2A6FGFNVKQHOX8GFMCJMEIO7S9F,"But opposition parties and international observers said the vote was marred by vote-rigging, including alleged ballot-box stuffing and false voter rolls.",4,22,opposition parties,1,0,1
3XD2A6FGFNVKQHOX8GFMCJMEIO7S9F,"But opposition parties and international observers said the vote was marred by vote-rigging, including alleged ballot-box stuffing and false voter rolls.",27,40,international,2,0,2
3XD2A6FGFNVKQHOX8GFMCJMEIO7S9F,"But opposition parties and international observers said the vote was marred by vote-rigging, including alleged ballot-box stuffing and false voter rolls.",27,50,international observers,1,0,1
3XD2A6FGFNVKQHOX8GFMCJMEIO7S9F,"But opposition parties and international observers said the vote was marred by vote-rigging, including alleged ballot-box stuffing and false voter rolls.",41,50,observers,1,3,4
3XD2A6FGFNVKQHOX8GFMCJMEIO7S9F,"But opposition parties and international observers said the vote was marred by vote-rigging, including alleged ballot-box stuffing and false voter rolls.",69,75,marred,7,10,17
3XD2A6FGFNVKQHOX8GFMCJMEIO7S9F,"But opposition parties and international observers said the vote was marred by vote-rigging, including alleged ballot-box stuffing and false voter rolls.",69,91,marred by vote-rigging,0,1,1
3XD2A6FGFNVKQHOX8GFMCJMEIO7S9F,"But opposition parties and international observers said the vote was marred by vote-rigging, including alleged ballot-box stuffing and false voter rolls.",79,91,vote-rigging,8,10,18
3XD2A6FGFNVKQHOX8GFMCJMEIO7S9F,"But opposition parties and international observers said the vote was marred by vote-rigging, including alleged ballot-box stuffing and false voter rolls.",103,110,alleged,5,4,9
3XD2A6FGFNVKQHOX8GFMCJMEIO7S9F,"But opposition parties and international observers said the vote was marred by vote-rigging, including alleged ballot-box stuffing and false voter rolls.",103,121,alleged ballot-box,1,1,2
3XD2A6FGFNVKQHOX8GFMCJMEIO7S9F,"But opposition parties and international observers said the vote was marred by vote-rigging, including alleged ballot-box stuffing and false voter rolls.",103,130,alleged ballot-box stuffing,1,3,4
3XD2A6FGFNVKQHOX8GFMCJMEIO7S9F,"But opposition parties and international observers said the vote was marred by vote-rigging, including alleged ballot-box stuffing and false voter rolls.",111,121,ballot-box,0,2,2
3XD2A6FGFNVKQHOX8GFMCJMEIO7S9F,"But opposition parties and international observers said the vote was marred by vote-rigging, including alleged ballot-box stuffing and false voter rolls.",111,130,ballot-box stuffing,5,2,7
3XD2A6FGFNVKQHOX8GFMCJMEIO7S9F,"But opposition parties and international observers said the vote was marred by vote-rigging, including alleged ballot-box stuffing and false voter rolls.",122,130,stuffing,0,4,4
3XD2A6FGFNVKQHOX8GFMCJMEIO7S9F,"But opposition parties and international observers said the vote was marred by vote-rigging, including alleged ballot-box stuffing and false voter rolls.",135,152,false voter rolls,4,1,5
3XD2A6FGFNVKQHOX8GFMCJMEIO7S9F,"But opposition parties and international observers said the vote was marred by vote-rigging, including alleged ballot-box stuffing and false voter rolls.",141,152,voter rolls,0,2,2
3XD2A6FGFNVKQHOX8GFMCJMEIO7S9F,"But opposition parties and international observers said the vote was marred by vote-rigging, including alleged ballot-box stuffing and false voter rolls.",147,152,rolls,0,2,2
3CMIQF80GNRLVI7MI5N5X9GB9MBQ6J,It was the second major assault in Kabul in less than three weeks and highlighted the Taliban's continued ability to strike in the heavily guarded capital even when security had been tightened for Obama's visit and Wednesday's anniversary of the killing of al-Qaida leader Osama bin Laden in neighboring Pakistan.,18,31,major assault,1,1,2
3CMIQF80GNRLVI7MI5N5X9GB9MBQ6J,It was the second major assault in Kabul in less than three weeks and highlighted the Taliban's continued ability to strike in the heavily guarded capital even when security had been tightened for Obama's visit and Wednesday's anniversary of the killing of al-Qaida leader Osama bin Laden in neighboring Pakistan.,24,31,assault,8,10,18
3CMIQF80GNRLVI7MI5N5X9GB9MBQ6J,It was the second major assault in Kabul in less than three weeks and highlighted the Taliban's continued ability to strike in the heavily guarded capital even when security had been tightened for Obama's visit and Wednesday's anniversary of the killing of al-Qaida leader Osama bin Laden in neighboring Pakistan.,44,53,less than,1,0,1
3CMIQF80GNRLVI7MI5N5X9GB9MBQ6J,It was the second major assault in Kabul in less than three weeks and highlighted the Taliban's continued ability to strike in the heavily guarded capital even when security had been tightened for Obama's visit and Wednesday's anniversary of the killing of al-Qaida leader Osama bin Laden in neighboring Pakistan.,70,81,highlighted,6,6,12
3CMIQF80GNRLVI7MI5N5X9GB9MBQ6J,It was the second major assault in Kabul in less than three weeks and highlighted the Taliban's continued ability to strike in the heavily guarded capital even when security had been tightened for Obama's visit and Wednesday's anniversary of the killing of al-Qaida leader Osama bin Laden in neighboring Pakistan.,106,113,ability,1,0,1
3CMIQF80GNRLVI7MI5N5X9GB9MBQ6J,It was the second major assault in Kabul in less than three weeks and highlighted the Taliban's continued ability to strike in the heavily guarded capital even when security had been tightened for Obama's visit and Wednesday's anniversary of the killing of al-Qaida leader Osama bin Laden in neighboring Pakistan.,117,123,strike,0,2,2
3CMIQF80GNRLVI7MI5N5X9GB9MBQ6J,It was the second major assault in Kabul in less than three weeks and highlighted the Taliban's continued ability to strike in the heavily guarded capital even when security had been tightened for Obama's visit and Wednesday's anniversary of the killing of al-Qaida leader Osama bin Laden in neighboring Pakistan.,131,138,heavily,1,0,1
3CMIQF80GNRLVI7MI5N5X9GB9MBQ6J,It was the second major assault in Kabul in less than three weeks and highlighted the Taliban's continued ability to strike in the heavily guarded capital even when security had been tightened for Obama's visit and Wednesday's anniversary of the killing of al-Qaida leader Osama bin Laden in neighboring Pakistan.,131,146,heavily guarded,1,2,3
3CMIQF80GNRLVI7MI5N5X9GB9MBQ6J,It was the second major assault in Kabul in less than three weeks and highlighted the Taliban's continued ability to strike in the heavily guarded capital even when security had been tightened for Obama's visit and Wednesday's anniversary of the killing of al-Qaida leader Osama bin Laden in neighboring Pakistan.,139,146,guarded,1,3,4
3CMIQF80GNRLVI7MI5N5X9GB9MBQ6J,It was the second major assault in Kabul in less than three weeks and highlighted the Taliban's continued ability to strike in the heavily guarded capital even when security had been tightened for Obama's visit and Wednesday's anniversary of the killing of al-Qaida leader Osama bin Laden in neighboring Pakistan.,183,192,tightened,4,4,8
3CMIQF80GNRLVI7MI5N5X9GB9MBQ6J,It was the second major assault in Kabul in less than three weeks and highlighted the Taliban's continued ability to strike in the heavily guarded capital even when security had been tightened for Obama's visit and Wednesday's anniversary of the killing of al-Qaida leader Osama bin Laden in neighboring Pakistan.,227,238,anniversary,2,3,5
3CMIQF80GNRLVI7MI5N5X9GB9MBQ6J,It was the second major assault in Kabul in less than three weeks and highlighted the Taliban's continued ability to strike in the heavily guarded capital even when security had been tightened for Obama's visit and Wednesday's anniversary of the killing of al-Qaida leader Osama bin Laden in neighboring Pakistan.,292,303,neighboring,5,2,7
3CMIQF80GNRLVI7MI5N5X9GB9MBQ6J,"Obama arrived at Bagram Air Field late Tuesday, then traveled to Kabul by helicopter for a meeting with President Hamid Karzai in which they signed an agreement governing the U.S. presence after combat troops withdraw in 2014.",24,33,Air Field,0,1,1
3CMIQF80GNRLVI7MI5N5X9GB9MBQ6J,"Obama arrived at Bagram Air Field late Tuesday, then traveled to Kabul by helicopter for a meeting with President Hamid Karzai in which they signed an agreement governing the U.S. presence after combat troops withdraw in 2014.",74,84,helicopter,2,0,2
3CMIQF80GNRLVI7MI5N5X9GB9MBQ6J,"Obama arrived at Bagram Air Field late Tuesday, then traveled to Kabul by helicopter for a meeting with President Hamid Karzai in which they signed an agreement governing the U.S. presence after combat troops withdraw in 2014.",151,160,agreement,2,0,2
3CMIQF80GNRLVI7MI5N5X9GB9MBQ6J,"Obama arrived at Bagram Air Field late Tuesday, then traveled to Kabul by helicopter for a meeting with President Hamid Karzai in which they signed an agreement governing the U.S. presence after combat troops withdraw in 2014.",161,170,governing,4,3,7
3CMIQF80GNRLVI7MI5N5X9GB9MBQ6J,"Obama arrived at Bagram Air Field late Tuesday, then traveled to Kabul by helicopter for a meeting with President Hamid Karzai in which they signed an agreement governing the U.S. presence after combat troops withdraw in 2014.",161,188,governing the U.S. presence,1,0,1
3CMIQF80GNRLVI7MI5N5X9GB9MBQ6J,"Obama arrived at Bagram Air Field late Tuesday, then traveled to Kabul by helicopter for a meeting with President Hamid Karzai in which they signed an agreement governing the U.S. presence after combat troops withdraw in 2014.",180,188,presence,2,0,2
3CMIQF80GNRLVI7MI5N5X9GB9MBQ6J,"Obama arrived at Bagram Air Field late Tuesday, then traveled to Kabul by helicopter for a meeting with President Hamid Karzai in which they signed an agreement governing the U.S. presence after combat troops withdraw in 2014.",195,201,combat,2,4,6
3CMIQF80GNRLVI7MI5N5X9GB9MBQ6J,"Obama arrived at Bagram Air Field late Tuesday, then traveled to Kabul by helicopter for a meeting with President Hamid Karzai in which they signed an agreement governing the U.S. presence after combat troops withdraw in 2014.",195,208,combat troops,1,3,4
3CMIQF80GNRLVI7MI5N5X9GB9MBQ6J,"Obama arrived at Bagram Air Field late Tuesday, then traveled to Kabul by helicopter for a meeting with President Hamid Karzai in which they signed an agreement governing the U.S. presence after combat troops withdraw in 2014.",209,217,withdraw,2,3,5
3CMIQF80GNRLVI7MI5N5X9GB9MBQ6J,"Later, back at the base, he was surrounded by U.S. troops, shaking every hand.",19,23,base,1,0,1
3CMIQF80GNRLVI7MI5N5X9GB9MBQ6J,"Later, back at the base, he was surrounded by U.S. troops, shaking every hand.",32,42,surrounded,4,3,7
3CMIQF80GNRLVI7MI5N5X9GB9MBQ6J,"He then gave a speech broadcast to Americans back home, before ending his lightning visit just before 4:30 a.m.",15,31,speech broadcast,1,1,2
3CMIQF80GNRLVI7MI5N5X9GB9MBQ6J,"He then gave a speech broadcast to Americans back home, before ending his lightning visit just before 4:30 a.m.",22,31,broadcast,8,5,13
3CMIQF80GNRLVI7MI5N5X9GB9MBQ6J,"He then gave a speech broadcast to Americans back home, before ending his lightning visit just before 4:30 a.m.",63,89,ending his lightning visit,1,0,1
3CMIQF80GNRLVI7MI5N5X9GB9MBQ6J,"He then gave a speech broadcast to Americans back home, before ending his lightning visit just before 4:30 a.m.",74,83,lightning,2,4,6
3CMIQF80GNRLVI7MI5N5X9GB9MBQ6J,"He then gave a speech broadcast to Americans back home, before ending his lightning visit just before 4:30 a.m.",74,89,lightning visit,5,3,8
3M7OI89LVYPH1HX3DNMAD4RU57A6CU,"The United Nations estimates that at least 9,000 people have died in the 14-month crisis, while opposition groups put the death toll at more than 11,000.",19,28,estimates,6,3,9
3M7OI89LVYPH1HX3DNMAD4RU57A6CU,"The United Nations estimates that at least 9,000 people have died in the 14-month crisis, while opposition groups put the death toll at more than 11,000.",82,88,crisis,1,2,3
3M7OI89LVYPH1HX3DNMAD4RU57A6CU,"The United Nations estimates that at least 9,000 people have died in the 14-month crisis, while opposition groups put the death toll at more than 11,000.",96,106,opposition,6,1,7
3M7OI89LVYPH1HX3DNMAD4RU57A6CU,"The United Nations estimates that at least 9,000 people have died in the 14-month crisis, while opposition groups put the death toll at more than 11,000.",96,113,opposition groups,2,0,2
3M7OI89LVYPH1HX3DNMAD4RU57A6CU,"The United Nations estimates that at least 9,000 people have died in the 14-month crisis, while opposition groups put the death toll at more than 11,000.",122,132,death toll,3,1,4
3M7OI89LVYPH1HX3DNMAD4RU57A6CU,"The United Nations estimates that at least 9,000 people have died in the 14-month crisis, while opposition groups put the death toll at more than 11,000.",128,132,toll,1,3,4
3M7OI89LVYPH1HX3DNMAD4RU57A6CU,"Despite the ongoing chaos, Syrian state-run media announced that results from recent parliamentary elections will be announced Tuesday.",0,7,Despite,1,2,3
3M7OI89LVYPH1HX3DNMAD4RU57A6CU,"Despite the ongoing chaos, Syrian state-run media announced that results from recent parliamentary elections will be announced Tuesday.",12,19,ongoing,2,2,4
3M7OI89LVYPH1HX3DNMAD4RU57A6CU,"Despite the ongoing chaos, Syrian state-run media announced that results from recent parliamentary elections will be announced Tuesday.",12,25,ongoing chaos,2,2,4
3M7OI89LVYPH1HX3DNMAD4RU57A6CU,"Despite the ongoing chaos, Syrian state-run media announced that results from recent parliamentary elections will be announced Tuesday.",20,25,chaos,10,4,14
3M7OI89LVYPH1HX3DNMAD4RU57A6CU,"Despite the ongoing chaos, Syrian state-run media announced that results from recent parliamentary elections will be announced Tuesday.",34,43,state-run,1,1,2
3M7OI89LVYPH1HX3DNMAD4RU57A6CU,"Despite the ongoing chaos, Syrian state-run media announced that results from recent parliamentary elections will be announced Tuesday.",34,49,state-run media,1,0,1
3M7OI89LVYPH1HX3DNMAD4RU57A6CU,"Despite the ongoing chaos, Syrian state-run media announced that results from recent parliamentary elections will be announced Tuesday.",50,59,announced,1,1,2
3M7OI89LVYPH1HX3DNMAD4RU57A6CU,"Despite the ongoing chaos, Syrian state-run media announced that results from recent parliamentary elections will be announced Tuesday.",78,84,recent,1,1,2
3M7OI89LVYPH1HX3DNMAD4RU57A6CU,"Despite the ongoing chaos, Syrian state-run media announced that results from recent parliamentary elections will be announced Tuesday.",85,98,parliamentary,9,2,11
3M7OI89LVYPH1HX3DNMAD4RU57A6CU,"Despite the ongoing chaos, Syrian state-run media announced that results from recent parliamentary elections will be announced Tuesday.",85,108,parliamentary elections,1,0,1
3M7OI89LVYPH1HX3DNMAD4RU57A6CU,"Despite the ongoing chaos, Syrian state-run media announced that results from recent parliamentary elections will be announced Tuesday.",99,108,elections,1,0,1
3M7OI89LVYPH1HX3DNMAD4RU57A6CU,"Despite the ongoing chaos, Syrian state-run media announced that results from recent parliamentary elections will be announced Tuesday.",117,126,announced,0,1,1
3M7OI89LVYPH1HX3DNMAD4RU57A6CU,"More than 7,000 candidates vied for 250 parliamentary seats.",16,26,candidates,2,1,3
3M7OI89LVYPH1HX3DNMAD4RU57A6CU,"More than 7,000 candidates vied for 250 parliamentary seats.",27,31,vied,1,5,6
3M7OI89LVYPH1HX3DNMAD4RU57A6CU,"More than 7,000 candidates vied for 250 parliamentary seats.",40,53,parliamentary,2,1,3
3M7OI89LVYPH1HX3DNMAD4RU57A6CU,"More than 7,000 candidates vied for 250 parliamentary seats.",40,59,parliamentary seats,1,0,1
3M7OI89LVYPH1HX3DNMAD4RU57A6CU,"But members of the opposition had urged Syrians to boycott the elections, saying a vote for any of the candidates amounted to a vote for al-Assad, whose family has ruled the country for 42 years.",19,29,opposition,3,0,3
3M7OI89LVYPH1HX3DNMAD4RU57A6CU,"But members of the opposition had urged Syrians to boycott the elections, saying a vote for any of the candidates amounted to a vote for al-Assad, whose family has ruled the country for 42 years.",34,39,urged,2,5,7
3M7OI89LVYPH1HX3DNMAD4RU57A6CU,"But members of the opposition had urged Syrians to boycott the elections, saying a vote for any of the candidates amounted to a vote for al-Assad, whose family has ruled the country for 42 years.",51,58,boycott,10,6,16
3M7OI89LVYPH1HX3DNMAD4RU57A6CU,"But members of the opposition had urged Syrians to boycott the elections, saying a vote for any of the candidates amounted to a vote for al-Assad, whose family has ruled the country for 42 years.",103,113,candidates,1,0,1
3M7OI89LVYPH1HX3DNMAD4RU57A6CU,"But members of the opposition had urged Syrians to boycott the elections, saying a vote for any of the candidates amounted to a vote for al-Assad, whose family has ruled the country for 42 years.",114,122,amounted,4,4,8
3M7OI89LVYPH1HX3DNMAD4RU57A6CU,"This reform will grant credibility and build confidence in the financial sector, increase credit flow in our country and lead to home sales at reasonable prices, Deputy Prime Minister Soraya Saenz de Santamaria said at a news conference.",6,12,reform,4,2,6
3M7OI89LVYPH1HX3DNMAD4RU57A6CU,"This reform will grant credibility and build confidence in the financial sector, increase credit flow in our country and lead to home sales at reasonable prices, Deputy Prime Minister Soraya Saenz de Santamaria said at a news conference.",18,23,grant,0,1,1
3M7OI89LVYPH1HX3DNMAD4RU57A6CU,"This reform will grant credibility and build confidence in the financial sector, increase credit flow in our country and lead to home sales at reasonable prices, Deputy Prime Minister Soraya Saenz de Santamaria said at a news conference.",18,35,grant credibility,2,0,2
3M7OI89LVYPH1HX3DNMAD4RU57A6CU,"This reform will grant credibility and build confidence in the financial sector, increase credit flow in our country and lead to home sales at reasonable prices, Deputy Prime Minister Soraya Saenz de Santamaria said at a news conference.",24,35,credibility,10,6,16
3M7OI89LVYPH1HX3DNMAD4RU57A6CU,"This reform will grant credibility and build confidence in the financial sector, increase credit flow in our country and lead to home sales at reasonable prices, Deputy Prime Minister Soraya Saenz de Santamaria said at a news conference.",46,56,confidence,2,1,3
3M7OI89LVYPH1HX3DNMAD4RU57A6CU,"This reform will grant credibility and build confidence in the financial sector, increase credit flow in our country and lead to home sales at reasonable prices, Deputy Prime Minister Soraya Saenz de Santamaria said at a news conference.",64,80,financial sector,3,0,3
3M7OI89LVYPH1HX3DNMAD4RU57A6CU,"This reform will grant credibility and build confidence in the financial sector, increase credit flow in our country and lead to home sales at reasonable prices, Deputy Prime Minister Soraya Saenz de Santamaria said at a news conference.",74,80,sector,3,0,3
3M7OI89LVYPH1HX3DNMAD4RU57A6CU,"This reform will grant credibility and build confidence in the financial sector, increase credit flow in our country and lead to home sales at reasonable prices, Deputy Prime Minister Soraya Saenz de Santamaria said at a news conference.",82,102,increase credit flow,1,0,1
3M7OI89LVYPH1HX3DNMAD4RU57A6CU,"This reform will grant credibility and build confidence in the financial sector, increase credit flow in our country and lead to home sales at reasonable prices, Deputy Prime Minister Soraya Saenz de Santamaria said at a news conference.",91,97,credit,1,0,1
3M7OI89LVYPH1HX3DNMAD4RU57A6CU,"This reform will grant credibility and build confidence in the financial sector, increase credit flow in our country and lead to home sales at reasonable prices, Deputy Prime Minister Soraya Saenz de Santamaria said at a news conference.",91,102,credit flow,3,1,4
3M7OI89LVYPH1HX3DNMAD4RU57A6CU,"This reform will grant credibility and build confidence in the financial sector, increase credit flow in our country and lead to home sales at reasonable prices, Deputy Prime Minister Soraya Saenz de Santamaria said at a news conference.",98,102,flow,0,1,1
3M7OI89LVYPH1HX3DNMAD4RU57A6CU,"This reform will grant credibility and build confidence in the financial sector, increase credit flow in our country and lead to home sales at reasonable prices, Deputy Prime Minister Soraya Saenz de Santamaria said at a news conference.",144,154,reasonable,2,1,3
3M7OI89LVYPH1HX3DNMAD4RU57A6CU,"This reform will grant credibility and build confidence in the financial sector, increase credit flow in our country and lead to home sales at reasonable prices, Deputy Prime Minister Soraya Saenz de Santamaria said at a news conference.",228,238,conference,2,1,3
356ZPKYPUHI2EQGDOB38GVAU4DLPYL,"Mr McGuinness, who is MP for the area, said: ""This family is clearly deeply shocked and traumatised by what has happened over the weekend.",15,37,who is MP for the area,1,0,1
356ZPKYPUHI2EQGDOB38GVAU4DLPYL,"Mr McGuinness, who is MP for the area, said: ""This family is clearly deeply shocked and traumatised by what has happened over the weekend.",69,75,deeply,0,1,1
356ZPKYPUHI2EQGDOB38GVAU4DLPYL,"Mr McGuinness, who is MP for the area, said: ""This family is clearly deeply shocked and traumatised by what has happened over the weekend.",69,83,deeply shocked,0,1,1
356ZPKYPUHI2EQGDOB38GVAU4DLPYL,"Mr McGuinness, who is MP for the area, said: ""This family is clearly deeply shocked and traumatised by what has happened over the weekend.",76,83,shocked,1,0,1
356ZPKYPUHI2EQGDOB38GVAU4DLPYL,"Mr McGuinness, who is MP for the area, said: ""This family is clearly deeply shocked and traumatised by what has happened over the weekend.",76,99,shocked and traumatised,0,1,1
356ZPKYPUHI2EQGDOB38GVAU4DLPYL,"Mr McGuinness, who is MP for the area, said: ""This family is clearly deeply shocked and traumatised by what has happened over the weekend.",88,99,traumatised,10,10,20
356ZPKYPUHI2EQGDOB38GVAU4DLPYL,"Their daughter has been murdered and another daughter seriously injured.	25	33	murdered	2	3	5
356ZPKYPUHI2EQGDOB38GVAU4DLPYL	Their daughter has been murdered and another daughter seriously injured.",55,64,seriously,0,1,1
356ZPKYPUHI2EQGDOB38GVAU4DLPYL,"Their daughter has been murdered and another daughter seriously injured.	55	72	seriously injured	2	1	3
356ZPKYPUHI2EQGDOB38GVAU4DLPYL	I spent some time with the family and offered our support and that of the wider community at this time.",62,89,that of the wider community,1,0,1
356ZPKYPUHI2EQGDOB38GVAU4DLPYL,"I spent some time with the family and offered our support and that of the wider community at this time.""",74,79,wider,0,2,2
356ZPKYPUHI2EQGDOB38GVAU4DLPYL,"I spent some time with the family and offered our support and that of the wider community at this time.""",74,89,wider community,4,4,8
356ZPKYPUHI2EQGDOB38GVAU4DLPYL,"I spent some time with the family and offered our support and that of the wider community at this time.""",80,89,community,1,0,1
356ZPKYPUHI2EQGDOB38GVAU4DLPYL,"It is understood the dead girl was living at her family home, in a neighbouring housing estate, and was visiting her older sister at the time of the shooting.",6,16,understood,1,0,1
356ZPKYPUHI2EQGDOB38GVAU4DLPYL,"It is understood the dead girl was living at her family home, in a neighbouring housing estate, and was visiting her older sister at the time of the shooting.",67,79,neighbouring,3,5,8
356ZPKYPUHI2EQGDOB38GVAU4DLPYL,"It is understood the dead girl was living at her family home, in a neighbouring housing estate, and was visiting her older sister at the time of the shooting.",67,94,neighbouring housing estate,4,1,5
356ZPKYPUHI2EQGDOB38GVAU4DLPYL,"It is understood the dead girl was living at her family home, in a neighbouring housing estate, and was visiting her older sister at the time of the shooting.",80,87,housing,0,1,1
356ZPKYPUHI2EQGDOB38GVAU4DLPYL,"It is understood the dead girl was living at her family home, in a neighbouring housing estate, and was visiting her older sister at the time of the shooting.",80,94,housing estate,1,1,2
356ZPKYPUHI2EQGDOB38GVAU4DLPYL,"It is understood the dead girl was living at her family home, in a neighbouring housing estate, and was visiting her older sister at the time of the shooting.",149,157,shooting,0,1,1
356ZPKYPUHI2EQGDOB38GVAU4DLPYL,"Bellaghy parish priest Fr Andrew Dolan said the teenager died trying to protect her sister: ""When Brenda was under attack, Lauren dived in to save her and in the process lost her own life.",0,8,Bellaghy,1,0,1
356ZPKYPUHI2EQGDOB38GVAU4DLPYL,"Bellaghy parish priest Fr Andrew Dolan said the teenager died trying to protect her sister: ""When Brenda was under attack, Lauren dived in to save her and in the process lost her own life.",0,22,Bellaghy parish priest,1,0,1
356ZPKYPUHI2EQGDOB38GVAU4DLPYL,"Bellaghy parish priest Fr Andrew Dolan said the teenager died trying to protect her sister: ""When Brenda was under attack, Lauren dived in to save her and in the process lost her own life.",9,15,parish,2,4,6
356ZPKYPUHI2EQGDOB38GVAU4DLPYL,"Bellaghy parish priest Fr Andrew Dolan said the teenager died trying to protect her sister: ""When Brenda was under attack, Lauren dived in to save her and in the process lost her own life.",9,22,parish priest,0,1,1
356ZPKYPUHI2EQGDOB38GVAU4DLPYL,"Bellaghy parish priest Fr Andrew Dolan said the teenager died trying to protect her sister: ""When Brenda was under attack, Lauren dived in to save her and in the process lost her own life.",23,25,Fr,1,0,1
356ZPKYPUHI2EQGDOB38GVAU4DLPYL,"Bellaghy parish priest Fr Andrew Dolan said the teenager died trying to protect her sister: ""When Brenda was under attack, Lauren dived in to save her and in the process lost her own life.",123,150,Lauren dived in to save her,1,0,1
356ZPKYPUHI2EQGDOB38GVAU4DLPYL,"Bellaghy parish priest Fr Andrew Dolan said the teenager died trying to protect her sister: ""When Brenda was under attack, Lauren dived in to save her and in the process lost her own life.",130,135,dived,1,1,2
356ZPKYPUHI2EQGDOB38GVAU4DLPYL,"Bellaghy parish priest Fr Andrew Dolan said the teenager died trying to protect her sister: ""When Brenda was under attack, Lauren dived in to save her and in the process lost her own life.",130,138,dived in,1,4,5
356ZPKYPUHI2EQGDOB38GVAU4DLPYL,"Bellaghy parish priest Fr Andrew Dolan said the teenager died trying to protect her sister: ""When Brenda was under attack, Lauren dived in to save her and in the process lost her own life.",155,169,in the process,1,0,1
356ZPKYPUHI2EQGDOB38GVAU4DLPYL,"Bellaghy parish priest Fr Andrew Dolan said the teenager died trying to protect her sister: ""When Brenda was under attack, Lauren dived in to save her and in the process lost her own life.",162,169,process,3,1,4
356ZPKYPUHI2EQGDOB38GVAU4DLPYL,"He told the BBC: ""I'd say they were close in life and in death couldn't be closer.""",54,80,in death couldnt be closer,1,0,1
356ZPKYPUHI2EQGDOB38GVAU4DLPYL,"He told the BBC: ""I'd say they were close in life and in death couldn't be closer.""",63,80,couldnt be closer,0,1,1
3ICOHX7ENCC1K4V27PCOURH6ET40EA,"China's official approval of the deal has been a long time coming - Google managed to score regulatory approvals from the U.S. Department of Justice and the European Commission back in February (on the same day no less), but China's anti-monopoly bureau leapt into action just a few days later.",8,16,official,0,1,1
3ICOHX7ENCC1K4V27PCOURH6ET40EA,"China's official approval of the deal has been a long time coming - Google managed to score regulatory approvals from the U.S. Department of Justice and the European Commission back in February (on the same day no less), but China's anti-monopoly bureau leapt into action just a few days later.",8,25,official approval,2,0,2
3ICOHX7ENCC1K4V27PCOURH6ET40EA,"China's official approval of the deal has been a long time coming - Google managed to score regulatory approvals from the U.S. Department of Justice and the European Commission back in February (on the same day no less), but China's anti-monopoly bureau leapt into action just a few days later.",17,25,approval,1,3,4
3ICOHX7ENCC1K4V27PCOURH6ET40EA,"China's official approval of the deal has been a long time coming - Google managed to score regulatory approvals from the U.S. Department of Justice and the European Commission back in February (on the same day no less), but China's anti-monopoly bureau leapt into action just a few days later.",33,37,deal,0,1,1
3ICOHX7ENCC1K4V27PCOURH6ET40EA,"China's official approval of the deal has been a long time coming - Google managed to score regulatory approvals from the U.S. Department of Justice and the European Commission back in February (on the same day no less), but China's anti-monopoly bureau leapt into action just a few days later.",47,65,a long time coming,1,0,1
3ICOHX7ENCC1K4V27PCOURH6ET40EA,"China's official approval of the deal has been a long time coming - Google managed to score regulatory approvals from the U.S. Department of Justice and the European Commission back in February (on the same day no less), but China's anti-monopoly bureau leapt into action just a few days later.",49,65,long time coming,0,1,1
3ICOHX7ENCC1K4V27PCOURH6ET40EA,"China's official approval of the deal has been a long time coming - Google managed to score regulatory approvals from the U.S. Department of Justice and the European Commission back in February (on the same day no less), but China's anti-monopoly bureau leapt into action just a few days later.",86,91,score,1,1,2
3ICOHX7ENCC1K4V27PCOURH6ET40EA,"China's official approval of the deal has been a long time coming - Google managed to score regulatory approvals from the U.S. Department of Justice and the European Commission back in February (on the same day no less), but China's anti-monopoly bureau leapt into action just a few days later.",92,102,regulatory,7,3,10
3ICOHX7ENCC1K4V27PCOURH6ET40EA,"China's official approval of the deal has been a long time coming - Google managed to score regulatory approvals from the U.S. Department of Justice and the European Commission back in February (on the same day no less), but China's anti-monopoly bureau leapt into action just a few days later.",92,112,regulatory approvals,4,4,8
3ICOHX7ENCC1K4V27PCOURH6ET40EA,"China's official approval of the deal has been a long time coming - Google managed to score regulatory approvals from the U.S. Department of Justice and the European Commission back in February (on the same day no less), but China's anti-monopoly bureau leapt into action just a few days later.",157,176,European Commission,2,0,2
3ICOHX7ENCC1K4V27PCOURH6ET40EA,"China's official approval of the deal has been a long time coming - Google managed to score regulatory approvals from the U.S. Department of Justice and the European Commission back in February (on the same day no less), but China's anti-monopoly bureau leapt into action just a few days later.",166,176,Commission,1,0,1
3ICOHX7ENCC1K4V27PCOURH6ET40EA,"China's official approval of the deal has been a long time coming - Google managed to score regulatory approvals from the U.S. Department of Justice and the European Commission back in February (on the same day no less), but China's anti-monopoly bureau leapt into action just a few days later.",233,246,anti-monopoly,8,7,15
3ICOHX7ENCC1K4V27PCOURH6ET40EA,"China's official approval of the deal has been a long time coming - Google managed to score regulatory approvals from the U.S. Department of Justice and the European Commission back in February (on the same day no less), but China's anti-monopoly bureau leapt into action just a few days later.",233,253,anti-monopoly bureau,4,2,6
3ICOHX7ENCC1K4V27PCOURH6ET40EA,"China's official approval of the deal has been a long time coming - Google managed to score regulatory approvals from the U.S. Department of Justice and the European Commission back in February (on the same day no less), but China's anti-monopoly bureau leapt into action just a few days later.",233,259,anti-monopoly bureau leapt,2,0,2
3ICOHX7ENCC1K4V27PCOURH6ET40EA,"China's official approval of the deal has been a long time coming - Google managed to score regulatory approvals from the U.S. Department of Justice and the European Commission back in February (on the same day no less), but China's anti-monopoly bureau leapt into action just a few days later.",233,271,anti-monopoly bureau leapt into action,0,1,1
3ICOHX7ENCC1K4V27PCOURH6ET40EA,"China's official approval of the deal has been a long time coming - Google managed to score regulatory approvals from the U.S. Department of Justice and the European Commission back in February (on the same day no less), but China's anti-monopoly bureau leapt into action just a few days later.",247,253,bureau,8,1,9
3ICOHX7ENCC1K4V27PCOURH6ET40EA,"China's official approval of the deal has been a long time coming - Google managed to score regulatory approvals from the U.S. Department of Justice and the European Commission back in February (on the same day no less), but China's anti-monopoly bureau leapt into action just a few days later.",247,259,bureau leapt,0,1,1
3ICOHX7ENCC1K4V27PCOURH6ET40EA,"China's official approval of the deal has been a long time coming - Google managed to score regulatory approvals from the U.S. Department of Justice and the European Commission back in February (on the same day no less), but China's anti-monopoly bureau leapt into action just a few days later.",254,259,leapt,1,8,9
3ICOHX7ENCC1K4V27PCOURH6ET40EA,"That period of intense regulatory scrutiny is a routine part of the purchasing process, as every company that makes more than 400 million yuan ($63 million) in China and 10 billion yuan ($1.6 billion) globally is subject to the process.",5,11,period,1,0,1
3ICOHX7ENCC1K4V27PCOURH6ET40EA,"That period of intense regulatory scrutiny is a routine part of the purchasing process, as every company that makes more than 400 million yuan ($63 million) in China and 10 billion yuan ($1.6 billion) globally is subject to the process.",15,22,intense,1,5,6
3ICOHX7ENCC1K4V27PCOURH6ET40EA,"That period of intense regulatory scrutiny is a routine part of the purchasing process, as every company that makes more than 400 million yuan ($63 million) in China and 10 billion yuan ($1.6 billion) globally is subject to the process.",15,42,intense regulatory scrutiny,2,1,3
3ICOHX7ENCC1K4V27PCOURH6ET40EA,"That period of intense regulatory scrutiny is a routine part of the purchasing process, as every company that makes more than 400 million yuan ($63 million) in China and 10 billion yuan ($1.6 billion) globally is subject to the process.",23,33,regulatory,2,0,2
3ICOHX7ENCC1K4V27PCOURH6ET40EA,"That period of intense regulatory scrutiny is a routine part of the purchasing process, as every company that makes more than 400 million yuan ($63 million) in China and 10 billion yuan ($1.6 billion) globally is subject to the process.",23,42,regulatory scrutiny,7,0,7
3ICOHX7ENCC1K4V27PCOURH6ET40EA,"That period of intense regulatory scrutiny is a routine part of the purchasing process, as every company that makes more than 400 million yuan ($63 million) in China and 10 billion yuan ($1.6 billion) globally is subject to the process.",34,42,scrutiny,6,8,14
3ICOHX7ENCC1K4V27PCOURH6ET40EA,"That period of intense regulatory scrutiny is a routine part of the purchasing process, as every company that makes more than 400 million yuan ($63 million) in China and 10 billion yuan ($1.6 billion) globally is subject to the process.",48,55,routine,1,2,3
3ICOHX7ENCC1K4V27PCOURH6ET40EA,"That period of intense regulatory scrutiny is a routine part of the purchasing process, as every company that makes more than 400 million yuan ($63 million) in China and 10 billion yuan ($1.6 billion) globally is subject to the process.",68,78,purchasing,1,0,1
3ICOHX7ENCC1K4V27PCOURH6ET40EA,"That period of intense regulatory scrutiny is a routine part of the purchasing process, as every company that makes more than 400 million yuan ($63 million) in China and 10 billion yuan ($1.6 billion) globally is subject to the process.",68,86,purchasing process,1,0,1
3ICOHX7ENCC1K4V27PCOURH6ET40EA,"That period of intense regulatory scrutiny is a routine part of the purchasing process, as every company that makes more than 400 million yuan ($63 million) in China and 10 billion yuan ($1.6 billion) globally is subject to the process.",181,185,yuan,1,0,1
3ICOHX7ENCC1K4V27PCOURH6ET40EA,"That period of intense regulatory scrutiny is a routine part of the purchasing process, as every company that makes more than 400 million yuan ($63 million) in China and 10 billion yuan ($1.6 billion) globally is subject to the process.",201,209,globally,4,3,7
3ICOHX7ENCC1K4V27PCOURH6ET40EA,"That period of intense regulatory scrutiny is a routine part of the purchasing process, as every company that makes more than 400 million yuan ($63 million) in China and 10 billion yuan ($1.6 billion) globally is subject to the process.",210,220,is subject,1,0,1
3ICOHX7ENCC1K4V27PCOURH6ET40EA,"That period of intense regulatory scrutiny is a routine part of the purchasing process, as every company that makes more than 400 million yuan ($63 million) in China and 10 billion yuan ($1.6 billion) globally is subject to the process.",213,220,subject,1,0,1
3ICOHX7ENCC1K4V27PCOURH6ET40EA,"Google and Motorola originally expected to close the deal in early 2012″, and it turns out they weren't too far from the market.",20,30,originally,1,1,2
3ICOHX7ENCC1K4V27PCOURH6ET40EA,"Google and Motorola originally expected to close the deal in early 2012″, and it turns out they weren't too far from the market.",20,39,originally expected,1,0,1
3ICOHX7ENCC1K4V27PCOURH6ET40EA,"Google and Motorola originally expected to close the deal in early 2012″, and it turns out they weren't too far from the market.",43,57,close the deal,2,0,2
3ICOHX7ENCC1K4V27PCOURH6ET40EA,"Google and Motorola originally expected to close the deal in early 2012″, and it turns out they weren't too far from the market.",53,57,deal,0,1,1
3ICOHX7ENCC1K4V27PCOURH6ET40EA,"Google and Motorola originally expected to close the deal in early 2012″, and it turns out they weren't too far from the market.",97,103,werent,1,1,2
3ICOHX7ENCC1K4V27PCOURH6ET40EA,"With this final approval in place, Google has confirmed that they expect purchase to be completed some time next week.",10,24,final approval,0,1,1
3ICOHX7ENCC1K4V27PCOURH6ET40EA,"With this final approval in place, Google has confirmed that they expect purchase to be completed some time next week.",46,55,confirmed,3,3,6
3ICOHX7ENCC1K4V27PCOURH6ET40EA,"With this final approval in place, Google has confirmed that they expect purchase to be completed some time next week.",73,81,purchase,0,2,2
3UEDKCTP9VRIOFNWOA80714Y53I7KA,"The insurgency also claimed their spring offensive, which began two weeks ago with attacks in Kabul, would be renewed on Thursday, despite a security clamp-down in the capital.",4,14,insurgency,10,10,20
3UEDKCTP9VRIOFNWOA80714Y53I7KA,"The insurgency also claimed their spring offensive, which began two weeks ago with attacks in Kabul, would be renewed on Thursday, despite a security clamp-down in the capital.",20,27,claimed,1,0,1
3UEDKCTP9VRIOFNWOA80714Y53I7KA,"The insurgency also claimed their spring offensive, which began two weeks ago with attacks in Kabul, would be renewed on Thursday, despite a security clamp-down in the capital.",34,40,spring,0,1,1
3UEDKCTP9VRIOFNWOA80714Y53I7KA,"The insurgency also claimed their spring offensive, which began two weeks ago with attacks in Kabul, would be renewed on Thursday, despite a security clamp-down in the capital.",34,50,spring offensive,4,2,6
3UEDKCTP9VRIOFNWOA80714Y53I7KA,"The insurgency also claimed their spring offensive, which began two weeks ago with attacks in Kabul, would be renewed on Thursday, despite a security clamp-down in the capital.",41,50,offensive,5,3,8
3UEDKCTP9VRIOFNWOA80714Y53I7KA,"The insurgency also claimed their spring offensive, which began two weeks ago with attacks in Kabul, would be renewed on Thursday, despite a security clamp-down in the capital.",110,117,renewed,4,1,5
3UEDKCTP9VRIOFNWOA80714Y53I7KA,"The insurgency also claimed their spring offensive, which began two weeks ago with attacks in Kabul, would be renewed on Thursday, despite a security clamp-down in the capital.",131,138,despite,0,2,2
3UEDKCTP9VRIOFNWOA80714Y53I7KA,"The insurgency also claimed their spring offensive, which began two weeks ago with attacks in Kabul, would be renewed on Thursday, despite a security clamp-down in the capital.",141,160,security clamp-down,4,1,5
3UEDKCTP9VRIOFNWOA80714Y53I7KA,"The insurgency also claimed their spring offensive, which began two weeks ago with attacks in Kabul, would be renewed on Thursday, despite a security clamp-down in the capital.",150,160,clamp-down,8,10,18
3UEDKCTP9VRIOFNWOA80714Y53I7KA,"Obama's visit came a year after U.S. special forces troops killed al Qaeda leader Osama bin Laden, the architect of the September 11, 2001, attacks, in a raid in neighboring Pakistan.",37,51,special forces,1,0,1
3UEDKCTP9VRIOFNWOA80714Y53I7KA,"Obama's visit came a year after U.S. special forces troops killed al Qaeda leader Osama bin Laden, the architect of the September 11, 2001, attacks, in a raid in neighboring Pakistan.",37,58,special forces troops,1,0,1
3UEDKCTP9VRIOFNWOA80714Y53I7KA,"Obama's visit came a year after U.S. special forces troops killed al Qaeda leader Osama bin Laden, the architect of the September 11, 2001, attacks, in a raid in neighboring Pakistan.",103,112,architect,9,5,14
3UEDKCTP9VRIOFNWOA80714Y53I7KA,"Obama's visit came a year after U.S. special forces troops killed al Qaeda leader Osama bin Laden, the architect of the September 11, 2001, attacks, in a raid in neighboring Pakistan.",154,158,raid,3,2,5
3UEDKCTP9VRIOFNWOA80714Y53I7KA,"In a televised address to the American people from a base north of Kabul, he said the war in Afghanistan was winding down.",5,14,televised,1,0,1
3UEDKCTP9VRIOFNWOA80714Y53I7KA,"In a televised address to the American people from a base north of Kabul, he said the war in Afghanistan was winding down.",5,22,televised address,1,1,2
3UEDKCTP9VRIOFNWOA80714Y53I7KA,"In a televised address to the American people from a base north of Kabul, he said the war in Afghanistan was winding down.",15,22,address,1,0,1
3UEDKCTP9VRIOFNWOA80714Y53I7KA,"In a televised address to the American people from a base north of Kabul, he said the war in Afghanistan was winding down.",53,57,base,1,0,1
3UEDKCTP9VRIOFNWOA80714Y53I7KA,"In a televised address to the American people from a base north of Kabul, he said the war in Afghanistan was winding down.",109,116,winding,0,5,5
3UEDKCTP9VRIOFNWOA80714Y53I7KA,"In a televised address to the American people from a base north of Kabul, he said the war in Afghanistan was winding down.",109,121,winding down,6,4,10
3UEDKCTP9VRIOFNWOA80714Y53I7KA,"As we emerge from a decade of conflict abroad and economic crisis at home, it's time to renew America, Obama said, speaking against a backdrop of armored vehicles and a U.S. flag.",7,13,emerge,1,5,6
3UEDKCTP9VRIOFNWOA80714Y53I7KA,"As we emerge from a decade of conflict abroad and economic crisis at home, it's time to renew America, Obama said, speaking against a backdrop of armored vehicles and a U.S. flag.",21,27,decade,1,2,3
3UEDKCTP9VRIOFNWOA80714Y53I7KA,"As we emerge from a decade of conflict abroad and economic crisis at home, it's time to renew America, Obama said, speaking against a backdrop of armored vehicles and a U.S. flag.",31,39,conflict,1,1,2
3UEDKCTP9VRIOFNWOA80714Y53I7KA,"As we emerge from a decade of conflict abroad and economic crisis at home, it's time to renew America, Obama said, speaking against a backdrop of armored vehicles and a U.S. flag.",31,46,conflict abroad,1,0,1
3UEDKCTP9VRIOFNWOA80714Y53I7KA,"As we emerge from a decade of conflict abroad and economic crisis at home, it's time to renew America, Obama said, speaking against a backdrop of armored vehicles and a U.S. flag.",40,46,abroad,0,3,3
3UEDKCTP9VRIOFNWOA80714Y53I7KA,"As we emerge from a decade of conflict abroad and economic crisis at home, it's time to renew America, Obama said, speaking against a backdrop of armored vehicles and a U.S. flag.",51,59,economic,1,0,1
3UEDKCTP9VRIOFNWOA80714Y53I7KA,"As we emerge from a decade of conflict abroad and economic crisis at home, it's time to renew America, Obama said, speaking against a backdrop of armored vehicles and a U.S. flag.",51,66,economic crisis,3,0,3
3UEDKCTP9VRIOFNWOA80714Y53I7KA,"As we emerge from a decade of conflict abroad and economic crisis at home, it's time to renew America, Obama said, speaking against a backdrop of armored vehicles and a U.S. flag.",60,66,crisis,0,1,1
3UEDKCTP9VRIOFNWOA80714Y53I7KA,"As we emerge from a decade of conflict abroad and economic crisis at home, it's time to renew America, Obama said, speaking against a backdrop of armored vehicles and a U.S. flag.",89,94,renew,2,1,3
3UEDKCTP9VRIOFNWOA80714Y53I7KA,"As we emerge from a decade of conflict abroad and economic crisis at home, it's time to renew America, Obama said, speaking against a backdrop of armored vehicles and a U.S. flag.",136,144,backdrop,9,10,19
3UEDKCTP9VRIOFNWOA80714Y53I7KA,"As we emerge from a decade of conflict abroad and economic crisis at home, it's time to renew America, Obama said, speaking against a backdrop of armored vehicles and a U.S. flag.",136,164,backdrop of armored vehicles,1,0,1
3UEDKCTP9VRIOFNWOA80714Y53I7KA,"As we emerge from a decade of conflict abroad and economic crisis at home, it's time to renew America, Obama said, speaking against a backdrop of armored vehicles and a U.S. flag.",148,155,armored,3,2,5
3UEDKCTP9VRIOFNWOA80714Y53I7KA,"As we emerge from a decade of conflict abroad and economic crisis at home, it's time to renew America, Obama said, speaking against a backdrop of armored vehicles and a U.S. flag.",148,164,armored vehicles,3,3,6
32204AGAABDAFIXPBS9X0M1ZCDIGHF,A lieutenant who had defected was also killed in the clashes.,2,12,lieutenant,10,3,13
32204AGAABDAFIXPBS9X0M1ZCDIGHF,A lieutenant who had defected was also killed in the clashes.,21,29,defected,7,8,15
32204AGAABDAFIXPBS9X0M1ZCDIGHF,A lieutenant who had defected was also killed in the clashes.,53,60,clashes,4,4,8
32204AGAABDAFIXPBS9X0M1ZCDIGHF,Regime forces launched an offensive on Rastan at the weekend but met with sharp resistance from rebels seeking the ouster of the regime of President Bashar al-Assad.,0,6,Regime,4,2,6
32204AGAABDAFIXPBS9X0M1ZCDIGHF,Regime forces launched an offensive on Rastan at the weekend but met with sharp resistance from rebels seeking the ouster of the regime of President Bashar al-Assad.,0,13,Regime forces,2,2,4
32204AGAABDAFIXPBS9X0M1ZCDIGHF,Regime forces launched an offensive on Rastan at the weekend but met with sharp resistance from rebels seeking the ouster of the regime of President Bashar al-Assad.,14,22,launched,0,2,2
32204AGAABDAFIXPBS9X0M1ZCDIGHF,Regime forces launched an offensive on Rastan at the weekend but met with sharp resistance from rebels seeking the ouster of the regime of President Bashar al-Assad.,26,35,offensive,5,4,9
32204AGAABDAFIXPBS9X0M1ZCDIGHF,Regime forces launched an offensive on Rastan at the weekend but met with sharp resistance from rebels seeking the ouster of the regime of President Bashar al-Assad.,74,79,sharp,0,1,1
32204AGAABDAFIXPBS9X0M1ZCDIGHF,Regime forces launched an offensive on Rastan at the weekend but met with sharp resistance from rebels seeking the ouster of the regime of President Bashar al-Assad.,74,90,sharp resistance,2,0,2
32204AGAABDAFIXPBS9X0M1ZCDIGHF,Regime forces launched an offensive on Rastan at the weekend but met with sharp resistance from rebels seeking the ouster of the regime of President Bashar al-Assad.,80,90,resistance,5,4,9
32204AGAABDAFIXPBS9X0M1ZCDIGHF,Regime forces launched an offensive on Rastan at the weekend but met with sharp resistance from rebels seeking the ouster of the regime of President Bashar al-Assad.,96,102,rebels,1,2,3
32204AGAABDAFIXPBS9X0M1ZCDIGHF,Regime forces launched an offensive on Rastan at the weekend but met with sharp resistance from rebels seeking the ouster of the regime of President Bashar al-Assad.,103,110,seeking,0,1,1
32204AGAABDAFIXPBS9X0M1ZCDIGHF,Regime forces launched an offensive on Rastan at the weekend but met with sharp resistance from rebels seeking the ouster of the regime of President Bashar al-Assad.,115,121,ouster,7,8,15
32204AGAABDAFIXPBS9X0M1ZCDIGHF,Regime forces launched an offensive on Rastan at the weekend but met with sharp resistance from rebels seeking the ouster of the regime of President Bashar al-Assad.,129,135,regime,4,2,6
32204AGAABDAFIXPBS9X0M1ZCDIGHF,Regime forces launched an offensive on Rastan at the weekend but met with sharp resistance from rebels seeking the ouster of the regime of President Bashar al-Assad.,149,164,Bashar al-Assad,1,0,1
32204AGAABDAFIXPBS9X0M1ZCDIGHF,The Observatory said dozens had been wounded in shelling of the city by Syrian troops.,4,15,Observatory,2,2,4
32204AGAABDAFIXPBS9X0M1ZCDIGHF,The Observatory said dozens had been wounded in shelling of the city by Syrian troops.,37,44,wounded,0,2,2
32204AGAABDAFIXPBS9X0M1ZCDIGHF,The Observatory said dozens had been wounded in shelling of the city by Syrian troops.,48,56,shelling,4,6,10
32204AGAABDAFIXPBS9X0M1ZCDIGHF,"The bombardment by regime forces resumed following the deadly clashes, it added.",4,15,bombardment,10,7,17
32204AGAABDAFIXPBS9X0M1ZCDIGHF,"The bombardment by regime forces resumed following the deadly clashes, it added.",19,25,regime,2,1,3
32204AGAABDAFIXPBS9X0M1ZCDIGHF,"The bombardment by regime forces resumed following the deadly clashes, it added.",33,40,resumed,0,3,3
32204AGAABDAFIXPBS9X0M1ZCDIGHF,"The bombardment by regime forces resumed following the deadly clashes, it added.",55,69,deadly clashes,1,1,2
32204AGAABDAFIXPBS9X0M1ZCDIGHF,"In Quraya in the eastern province of Deir az-Zour, a 15-year-old boy was killed by machinegun fire as regime forces raided the town, the Observatory said, bringing the total number of people killed on Monday to 25.",3,9,Quraya,1,0,1
32204AGAABDAFIXPBS9X0M1ZCDIGHF,"In Quraya in the eastern province of Deir az-Zour, a 15-year-old boy was killed by machinegun fire as regime forces raided the town, the Observatory said, bringing the total number of people killed on Monday to 25.",17,33,eastern province,1,0,1
32204AGAABDAFIXPBS9X0M1ZCDIGHF,"In Quraya in the eastern province of Deir az-Zour, a 15-year-old boy was killed by machinegun fire as regime forces raided the town, the Observatory said, bringing the total number of people killed on Monday to 25.",25,33,province,1,1,2
32204AGAABDAFIXPBS9X0M1ZCDIGHF,"In Quraya in the eastern province of Deir az-Zour, a 15-year-old boy was killed by machinegun fire as regime forces raided the town, the Observatory said, bringing the total number of people killed on Monday to 25.",37,49,Deir az-Zour,1,0,1
32204AGAABDAFIXPBS9X0M1ZCDIGHF,"In Quraya in the eastern province of Deir az-Zour, a 15-year-old boy was killed by machinegun fire as regime forces raided the town, the Observatory said, bringing the total number of people killed on Monday to 25.",83,93,machinegun,3,0,3
32204AGAABDAFIXPBS9X0M1ZCDIGHF,"In Quraya in the eastern province of Deir az-Zour, a 15-year-old boy was killed by machinegun fire as regime forces raided the town, the Observatory said, bringing the total number of people killed on Monday to 25.",102,108,regime,2,0,2
32204AGAABDAFIXPBS9X0M1ZCDIGHF,"In Quraya in the eastern province of Deir az-Zour, a 15-year-old boy was killed by machinegun fire as regime forces raided the town, the Observatory said, bringing the total number of people killed on Monday to 25.",102,115,regime forces,1,1,2
32204AGAABDAFIXPBS9X0M1ZCDIGHF,"In Quraya in the eastern province of Deir az-Zour, a 15-year-old boy was killed by machinegun fire as regime forces raided the town, the Observatory said, bringing the total number of people killed on Monday to 25.",116,122,raided,0,5,5
32204AGAABDAFIXPBS9X0M1ZCDIGHF,The watchdog added that 15 residents of the city were arrested.,4,12,watchdog,8,5,13
32204AGAABDAFIXPBS9X0M1ZCDIGHF,"And in the capital Damascus, regime forces raided the neighborhood of Qaboon, while snipers were stationed on the roofs of some buildings.",19,27,Damascus,1,0,1
32204AGAABDAFIXPBS9X0M1ZCDIGHF,"And in the capital Damascus, regime forces raided the neighborhood of Qaboon, while snipers were stationed on the roofs of some buildings.",29,35,regime,4,0,4
32204AGAABDAFIXPBS9X0M1ZCDIGHF,"And in the capital Damascus, regime forces raided the neighborhood of Qaboon, while snipers were stationed on the roofs of some buildings.",43,49,raided,2,1,3
32204AGAABDAFIXPBS9X0M1ZCDIGHF,"And in the capital Damascus, regime forces raided the neighborhood of Qaboon, while snipers were stationed on the roofs of some buildings.",54,66,neighborhood,1,0,1
32204AGAABDAFIXPBS9X0M1ZCDIGHF,"And in the capital Damascus, regime forces raided the neighborhood of Qaboon, while snipers were stationed on the roofs of some buildings.",70,76,Qaboon,1,0,1
32204AGAABDAFIXPBS9X0M1ZCDIGHF,"And in the capital Damascus, regime forces raided the neighborhood of Qaboon, while snipers were stationed on the roofs of some buildings.",84,91,snipers,6,9,15
32204AGAABDAFIXPBS9X0M1ZCDIGHF,"And in the capital Damascus, regime forces raided the neighborhood of Qaboon, while snipers were stationed on the roofs of some buildings.",97,106,stationed,4,4,8
3M0556243SLWBEN536YSNLYJXARNFW,"The goal that I set - to defeat al Qaeda, and deny it a chance to rebuild - is within our reach, Mr. Obama said, adding that ""there will be difficult days ahead.",26,32,defeat,1,1,2
3M0556243SLWBEN536YSNLYJXARNFW,"The goal that I set - to defeat al Qaeda, and deny it a chance to rebuild - is within our reach, Mr. Obama said, adding that ""there will be difficult days ahead.",47,51,deny,1,2,3
3M0556243SLWBEN536YSNLYJXARNFW,"The goal that I set - to defeat al Qaeda, and deny it a chance to rebuild - is within our reach, Mr. Obama said, adding that ""there will be difficult days ahead.",67,74,rebuild,2,2,4
3M0556243SLWBEN536YSNLYJXARNFW,"The goal that I set - to defeat al Qaeda, and deny it a chance to rebuild - is within our reach, Mr. Obama said, adding that ""there will be difficult days ahead.",80,96,within our reach,1,0,1
3M0556243SLWBEN536YSNLYJXARNFW,"The goal that I set - to defeat al Qaeda, and deny it a chance to rebuild - is within our reach, Mr. Obama said, adding that ""there will be difficult days ahead.",142,151,difficult,2,0,2
3M0556243SLWBEN536YSNLYJXARNFW,"The enormous sacrifices of our men and women are not over.""",4,12,enormous,4,5,9
3M0556243SLWBEN536YSNLYJXARNFW,"The enormous sacrifices of our men and women are not over.""",4,23,enormous sacrifices,4,1,5
3M0556243SLWBEN536YSNLYJXARNFW,"The enormous sacrifices of our men and women are not over.""",13,23,sacrifices,4,5,9
3M0556243SLWBEN536YSNLYJXARNFW,"U.S. military's future in Afghanistan Issued twice a year to Congress, the Defense Department report said overall insurgent attacks in Afghanistan fell last year for the first drop in five years and praised Afghan forces for their increased security capabilities.",38,44,Issued,0,2,2
3M0556243SLWBEN536YSNLYJXARNFW,"U.S. military's future in Afghanistan Issued twice a year to Congress, the Defense Department report said overall insurgent attacks in Afghanistan fell last year for the first drop in five years and praised Afghan forces for their increased security capabilities.",38,69,Issued twice a year to Congress,1,0,1
3M0556243SLWBEN536YSNLYJXARNFW,"U.S. military's future in Afghanistan Issued twice a year to Congress, the Defense Department report said overall insurgent attacks in Afghanistan fell last year for the first drop in five years and praised Afghan forces for their increased security capabilities.",61,69,Congress,4,0,4
3M0556243SLWBEN536YSNLYJXARNFW,"U.S. military's future in Afghanistan Issued twice a year to Congress, the Defense Department report said overall insurgent attacks in Afghanistan fell last year for the first drop in five years and praised Afghan forces for their increased security capabilities.",75,82,Defense,1,0,1
3M0556243SLWBEN536YSNLYJXARNFW,"U.S. military's future in Afghanistan Issued twice a year to Congress, the Defense Department report said overall insurgent attacks in Afghanistan fell last year for the first drop in five years and praised Afghan forces for their increased security capabilities.",106,113,overall,0,1,1
3M0556243SLWBEN536YSNLYJXARNFW,"U.S. military's future in Afghanistan Issued twice a year to Congress, the Defense Department report said overall insurgent attacks in Afghanistan fell last year for the first drop in five years and praised Afghan forces for their increased security capabilities.",106,123,overall insurgent,1,0,1
3M0556243SLWBEN536YSNLYJXARNFW,"U.S. military's future in Afghanistan Issued twice a year to Congress, the Defense Department report said overall insurgent attacks in Afghanistan fell last year for the first drop in five years and praised Afghan forces for their increased security capabilities.",106,131,overall insurgent attacks,0,1,1
3M0556243SLWBEN536YSNLYJXARNFW,"U.S. military's future in Afghanistan Issued twice a year to Congress, the Defense Department report said overall insurgent attacks in Afghanistan fell last year for the first drop in five years and praised Afghan forces for their increased security capabilities.",114,123,insurgent,10,8,18
3M0556243SLWBEN536YSNLYJXARNFW,"U.S. military's future in Afghanistan Issued twice a year to Congress, the Defense Department report said overall insurgent attacks in Afghanistan fell last year for the first drop in five years and praised Afghan forces for their increased security capabilities.",114,131,insurgent attacks,4,1,5
3M0556243SLWBEN536YSNLYJXARNFW,"U.S. military's future in Afghanistan Issued twice a year to Congress, the Defense Department report said overall insurgent attacks in Afghanistan fell last year for the first drop in five years and praised Afghan forces for their increased security capabilities.",199,206,praised,1,3,4
3M0556243SLWBEN536YSNLYJXARNFW,"U.S. military's future in Afghanistan Issued twice a year to Congress, the Defense Department report said overall insurgent attacks in Afghanistan fell last year for the first drop in five years and praised Afghan forces for their increased security capabilities.",231,262,increased security capabilities,3,0,3
3M0556243SLWBEN536YSNLYJXARNFW,"U.S. military's future in Afghanistan Issued twice a year to Congress, the Defense Department report said overall insurgent attacks in Afghanistan fell last year for the first drop in five years and praised Afghan forces for their increased security capabilities.",241,249,security,1,0,1
3M0556243SLWBEN536YSNLYJXARNFW,"U.S. military's future in Afghanistan Issued twice a year to Congress, the Defense Department report said overall insurgent attacks in Afghanistan fell last year for the first drop in five years and praised Afghan forces for their increased security capabilities.",241,262,security capabilities,4,3,7
3M0556243SLWBEN536YSNLYJXARNFW,"U.S. military's future in Afghanistan Issued twice a year to Congress, the Defense Department report said overall insurgent attacks in Afghanistan fell last year for the first drop in five years and praised Afghan forces for their increased security capabilities.",250,262,capabilities,5,0,5
3M0556243SLWBEN536YSNLYJXARNFW,"At the same time, the Defense Department said corruption remains widespread and violence in the southern region of Kandahar has increased.",46,56,corruption,10,7,17
3M0556243SLWBEN536YSNLYJXARNFW,"At the same time, the Defense Department said corruption remains widespread and violence in the southern region of Kandahar has increased.",46,75,corruption remains widespread,2,0,2
3M0556243SLWBEN536YSNLYJXARNFW,"At the same time, the Defense Department said corruption remains widespread and violence in the southern region of Kandahar has increased.",57,64,remains,0,1,1
3M0556243SLWBEN536YSNLYJXARNFW,"At the same time, the Defense Department said corruption remains widespread and violence in the southern region of Kandahar has increased.",65,75,widespread,3,7,10
3M0556243SLWBEN536YSNLYJXARNFW,"At the same time, the Defense Department said corruption remains widespread and violence in the southern region of Kandahar has increased.",80,88,violence,0,3,3
3M0556243SLWBEN536YSNLYJXARNFW,"There are around 130,000 forces in Afghanistan, including around 90,000 U.S. forces and 40,000 troops from other nations.",95,101,troops,1,1,2
3K3IX1W4S6S1I8IA85PSD9SN0LUPAK,"In his speech, Obama turned the signing of the promise to stay in Afghanistan into a vehicle for his other promise — to go.",32,39,signing,2,0,2
3K3IX1W4S6S1I8IA85PSD9SN0LUPAK,"In his speech, Obama turned the signing of the promise to stay in Afghanistan into a vehicle for his other promise — to go.",47,54,promise,0,1,1
3K3IX1W4S6S1I8IA85PSD9SN0LUPAK,"In his speech, Obama turned the signing of the promise to stay in Afghanistan into a vehicle for his other promise — to go.",47,62,promise to stay,0,1,1
3K3IX1W4S6S1I8IA85PSD9SN0LUPAK,"In his speech, Obama turned the signing of the promise to stay in Afghanistan into a vehicle for his other promise — to go.",85,92,vehicle,2,0,2
3K3IX1W4S6S1I8IA85PSD9SN0LUPAK,"In his speech, Obama turned the signing of the promise to stay in Afghanistan into a vehicle for his other promise — to go.",107,122,promise — to go,1,0,1
3K3IX1W4S6S1I8IA85PSD9SN0LUPAK,The signing was a quick and businesslike affair at Karzai's palace in Kabul.,28,40,businesslike,3,3,6
3K3IX1W4S6S1I8IA85PSD9SN0LUPAK,The signing was a quick and businesslike affair at Karzai's palace in Kabul.,28,47,businesslike affair,1,4,5
3K3IX1W4S6S1I8IA85PSD9SN0LUPAK,The signing was a quick and businesslike affair at Karzai's palace in Kabul.,41,47,affair,1,1,2
3K3IX1W4S6S1I8IA85PSD9SN0LUPAK,The signing was a quick and businesslike affair at Karzai's palace in Kabul.,60,66,palace,1,0,1
3K3IX1W4S6S1I8IA85PSD9SN0LUPAK,"There were pleasantries, but no pageantry.",11,23,pleasantries,10,10,20
3K3IX1W4S6S1I8IA85PSD9SN0LUPAK,"There were pleasantries, but no pageantry.",32,41,pageantry,10,10,20
3K3IX1W4S6S1I8IA85PSD9SN0LUPAK,"There was also no opportunity for Karzai to make one of the off-message demands or denunciations of U.S. behavior that have exasperated U.S. officials in the past, even when they acknowledged Karzai had a point.",18,29,opportunity,1,1,2
3K3IX1W4S6S1I8IA85PSD9SN0LUPAK,"There was also no opportunity for Karzai to make one of the off-message demands or denunciations of U.S. behavior that have exasperated U.S. officials in the past, even when they acknowledged Karzai had a point.",60,71,off-message,4,3,7
3K3IX1W4S6S1I8IA85PSD9SN0LUPAK,"There was also no opportunity for Karzai to make one of the off-message demands or denunciations of U.S. behavior that have exasperated U.S. officials in the past, even when they acknowledged Karzai had a point.",60,79,off-message demands,2,1,3
3K3IX1W4S6S1I8IA85PSD9SN0LUPAK,"There was also no opportunity for Karzai to make one of the off-message demands or denunciations of U.S. behavior that have exasperated U.S. officials in the past, even when they acknowledged Karzai had a point.",72,79,demands,0,1,1
3K3IX1W4S6S1I8IA85PSD9SN0LUPAK,"There was also no opportunity for Karzai to make one of the off-message demands or denunciations of U.S. behavior that have exasperated U.S. officials in the past, even when they acknowledged Karzai had a point.",83,96,denunciations,10,10,20
3K3IX1W4S6S1I8IA85PSD9SN0LUPAK,"There was also no opportunity for Karzai to make one of the off-message demands or denunciations of U.S. behavior that have exasperated U.S. officials in the past, even when they acknowledged Karzai had a point.",124,135,exasperated,10,10,20
3K3IX1W4S6S1I8IA85PSD9SN0LUPAK,"There was also no opportunity for Karzai to make one of the off-message demands or denunciations of U.S. behavior that have exasperated U.S. officials in the past, even when they acknowledged Karzai had a point.",179,191,acknowledged,5,5,10
3K3IX1W4S6S1I8IA85PSD9SN0LUPAK,"The Afghan people will understand that the United States will stand by them, Obama said, with Karzai seated beside him at the signing table.",63,76,stand by them,1,0,1
3K3IX1W4S6S1I8IA85PSD9SN0LUPAK,"The Afghan people will understand that the United States will stand by them, Obama said, with Karzai seated beside him at the signing table.",128,141,signing table,1,0,1
3K3IX1W4S6S1I8IA85PSD9SN0LUPAK,"They will know that the United States can achieve our goals of destroying al-Qaida and denying it a safe haven, but at the same time we have the capacity to wind down this war and usher in a new era of peace here in Afghanistan.",43,50,achieve,1,0,1
3K3IX1W4S6S1I8IA85PSD9SN0LUPAK,"They will know that the United States can achieve our goals of destroying al-Qaida and denying it a safe haven, but at the same time we have the capacity to wind down this war and usher in a new era of peace here in Afghanistan.",64,74,destroying,1,2,3
3K3IX1W4S6S1I8IA85PSD9SN0LUPAK,"They will know that the United States can achieve our goals of destroying al-Qaida and denying it a safe haven, but at the same time we have the capacity to wind down this war and usher in a new era of peace here in Afghanistan.",88,95,denying,1,2,3
3K3IX1W4S6S1I8IA85PSD9SN0LUPAK,"They will know that the United States can achieve our goals of destroying al-Qaida and denying it a safe haven, but at the same time we have the capacity to wind down this war and usher in a new era of peace here in Afghanistan.",101,111,safe haven,5,5,10
3K3IX1W4S6S1I8IA85PSD9SN0LUPAK,"They will know that the United States can achieve our goals of destroying al-Qaida and denying it a safe haven, but at the same time we have the capacity to wind down this war and usher in a new era of peace here in Afghanistan.",106,111,haven,2,1,3
3K3IX1W4S6S1I8IA85PSD9SN0LUPAK,"They will know that the United States can achieve our goals of destroying al-Qaida and denying it a safe haven, but at the same time we have the capacity to wind down this war and usher in a new era of peace here in Afghanistan.",146,154,capacity,6,1,7
3K3IX1W4S6S1I8IA85PSD9SN0LUPAK,"They will know that the United States can achieve our goals of destroying al-Qaida and denying it a safe haven, but at the same time we have the capacity to wind down this war and usher in a new era of peace here in Afghanistan.",158,167,wind down,0,2,2
3K3IX1W4S6S1I8IA85PSD9SN0LUPAK,"They will know that the United States can achieve our goals of destroying al-Qaida and denying it a safe haven, but at the same time we have the capacity to wind down this war and usher in a new era of peace here in Afghanistan.",181,186,usher,9,9,18
3K3IX1W4S6S1I8IA85PSD9SN0LUPAK,"They will know that the United States can achieve our goals of destroying al-Qaida and denying it a safe haven, but at the same time we have the capacity to wind down this war and usher in a new era of peace here in Afghanistan.",192,199,new era,1,0,1
3K3IX1W4S6S1I8IA85PSD9SN0LUPAK,"They will know that the United States can achieve our goals of destroying al-Qaida and denying it a safe haven, but at the same time we have the capacity to wind down this war and usher in a new era of peace here in Afghanistan.",196,199,era,1,0,1
38B7Q9C28G6F3JQ013CJBEQMZM796G,"Its strategic location and the terrain has helped deserters from disparate units mount raids against army buses and roadblocks manned by Military Intelligence and pro-Assad militia, opposition activists said.",4,13,strategic,8,7,15
38B7Q9C28G6F3JQ013CJBEQMZM796G,"Its strategic location and the terrain has helped deserters from disparate units mount raids against army buses and roadblocks manned by Military Intelligence and pro-Assad militia, opposition activists said.",4,22,strategic location,2,3,5
38B7Q9C28G6F3JQ013CJBEQMZM796G,"Its strategic location and the terrain has helped deserters from disparate units mount raids against army buses and roadblocks manned by Military Intelligence and pro-Assad militia, opposition activists said.",31,38,terrain,5,8,13
38B7Q9C28G6F3JQ013CJBEQMZM796G,"Its strategic location and the terrain has helped deserters from disparate units mount raids against army buses and roadblocks manned by Military Intelligence and pro-Assad militia, opposition activists said.",50,59,deserters,5,10,15
38B7Q9C28G6F3JQ013CJBEQMZM796G,"Its strategic location and the terrain has helped deserters from disparate units mount raids against army buses and roadblocks manned by Military Intelligence and pro-Assad militia, opposition activists said.",50,80,deserters from disparate units,1,0,1
38B7Q9C28G6F3JQ013CJBEQMZM796G,"Its strategic location and the terrain has helped deserters from disparate units mount raids against army buses and roadblocks manned by Military Intelligence and pro-Assad militia, opposition activists said.",65,74,disparate,9,5,14
38B7Q9C28G6F3JQ013CJBEQMZM796G,"Its strategic location and the terrain has helped deserters from disparate units mount raids against army buses and roadblocks manned by Military Intelligence and pro-Assad militia, opposition activists said.",65,80,disparate units,2,2,4
38B7Q9C28G6F3JQ013CJBEQMZM796G,"Its strategic location and the terrain has helped deserters from disparate units mount raids against army buses and roadblocks manned by Military Intelligence and pro-Assad militia, opposition activists said.",81,86,mount,0,1,1
38B7Q9C28G6F3JQ013CJBEQMZM796G,"Its strategic location and the terrain has helped deserters from disparate units mount raids against army buses and roadblocks manned by Military Intelligence and pro-Assad militia, opposition activists said.",81,92,mount raids,1,0,1
38B7Q9C28G6F3JQ013CJBEQMZM796G,"Its strategic location and the terrain has helped deserters from disparate units mount raids against army buses and roadblocks manned by Military Intelligence and pro-Assad militia, opposition activists said.",87,92,raids,2,0,2
38B7Q9C28G6F3JQ013CJBEQMZM796G,"Its strategic location and the terrain has helped deserters from disparate units mount raids against army buses and roadblocks manned by Military Intelligence and pro-Assad militia, opposition activists said.",106,111,buses,0,1,1
38B7Q9C28G6F3JQ013CJBEQMZM796G,"Its strategic location and the terrain has helped deserters from disparate units mount raids against army buses and roadblocks manned by Military Intelligence and pro-Assad militia, opposition activists said.",116,126,roadblocks,1,2,3
38B7Q9C28G6F3JQ013CJBEQMZM796G,"Its strategic location and the terrain has helped deserters from disparate units mount raids against army buses and roadblocks manned by Military Intelligence and pro-Assad militia, opposition activists said.",116,133,roadblocks manned,0,2,2
38B7Q9C28G6F3JQ013CJBEQMZM796G,"Its strategic location and the terrain has helped deserters from disparate units mount raids against army buses and roadblocks manned by Military Intelligence and pro-Assad militia, opposition activists said.",127,133,manned,2,2,4
38B7Q9C28G6F3JQ013CJBEQMZM796G,"Its strategic location and the terrain has helped deserters from disparate units mount raids against army buses and roadblocks manned by Military Intelligence and pro-Assad militia, opposition activists said.",137,180,Military Intelligence and pro-Assad militia,1,1,2
38B7Q9C28G6F3JQ013CJBEQMZM796G,"Its strategic location and the terrain has helped deserters from disparate units mount raids against army buses and roadblocks manned by Military Intelligence and pro-Assad militia, opposition activists said.",146,158,Intelligence,1,0,1
38B7Q9C28G6F3JQ013CJBEQMZM796G,"Its strategic location and the terrain has helped deserters from disparate units mount raids against army buses and roadblocks manned by Military Intelligence and pro-Assad militia, opposition activists said.",182,192,opposition,2,1,3
38B7Q9C28G6F3JQ013CJBEQMZM796G,"Its strategic location and the terrain has helped deserters from disparate units mount raids against army buses and roadblocks manned by Military Intelligence and pro-Assad militia, opposition activists said.",182,202,opposition activists,4,0,4
38B7Q9C28G6F3JQ013CJBEQMZM796G,"Its strategic location and the terrain has helped deserters from disparate units mount raids against army buses and roadblocks manned by Military Intelligence and pro-Assad militia, opposition activists said.",193,202,activists,1,0,1
38B7Q9C28G6F3JQ013CJBEQMZM796G,"Rastan lies about 180 km (110 miles) north of Damascus, among farmland and wheat fields on the Orontes River and on the northern highway leading to Aleppo.",75,80,wheat,0,1,1
38B7Q9C28G6F3JQ013CJBEQMZM796G,"Rastan lies about 180 km (110 miles) north of Damascus, among farmland and wheat fields on the Orontes River and on the northern highway leading to Aleppo.",137,144,leading,0,1,1
38B7Q9C28G6F3JQ013CJBEQMZM796G,"U.N. Secretary General Ban Ki-moon said on Wednesday there was only a narrow window of opportunity to avert full-scale civil war in Syria, which sits at a crossroads of Middle East conflict bordering Turkey, Jordan, Israel, Iraq and Lebanon.",5,34,Secretary General Ban Ki-moon,1,0,1
38B7Q9C28G6F3JQ013CJBEQMZM796G,"U.N. Secretary General Ban Ki-moon said on Wednesday there was only a narrow window of opportunity to avert full-scale civil war in Syria, which sits at a crossroads of Middle East conflict bordering Turkey, Jordan, Israel, Iraq and Lebanon.",70,76,narrow,0,1,1
38B7Q9C28G6F3JQ013CJBEQMZM796G,"U.N. Secretary General Ban Ki-moon said on Wednesday there was only a narrow window of opportunity to avert full-scale civil war in Syria, which sits at a crossroads of Middle East conflict bordering Turkey, Jordan, Israel, Iraq and Lebanon.",70,98,narrow window of opportunity,2,1,3
38B7Q9C28G6F3JQ013CJBEQMZM796G,"U.N. Secretary General Ban Ki-moon said on Wednesday there was only a narrow window of opportunity to avert full-scale civil war in Syria, which sits at a crossroads of Middle East conflict bordering Turkey, Jordan, Israel, Iraq and Lebanon.",77,98,window of opportunity,1,0,1
38B7Q9C28G6F3JQ013CJBEQMZM796G,"U.N. Secretary General Ban Ki-moon said on Wednesday there was only a narrow window of opportunity to avert full-scale civil war in Syria, which sits at a crossroads of Middle East conflict bordering Turkey, Jordan, Israel, Iraq and Lebanon.",102,107,avert,4,10,14
38B7Q9C28G6F3JQ013CJBEQMZM796G,"U.N. Secretary General Ban Ki-moon said on Wednesday there was only a narrow window of opportunity to avert full-scale civil war in Syria, which sits at a crossroads of Middle East conflict bordering Turkey, Jordan, Israel, Iraq and Lebanon.",102,118,avert full-scale,2,0,2
38B7Q9C28G6F3JQ013CJBEQMZM796G,"U.N. Secretary General Ban Ki-moon said on Wednesday there was only a narrow window of opportunity to avert full-scale civil war in Syria, which sits at a crossroads of Middle East conflict bordering Turkey, Jordan, Israel, Iraq and Lebanon.",108,118,full-scale,0,1,1
38B7Q9C28G6F3JQ013CJBEQMZM796G,"U.N. Secretary General Ban Ki-moon said on Wednesday there was only a narrow window of opportunity to avert full-scale civil war in Syria, which sits at a crossroads of Middle East conflict bordering Turkey, Jordan, Israel, Iraq and Lebanon.",119,128,civil war,1,0,1
38B7Q9C28G6F3JQ013CJBEQMZM796G,"U.N. Secretary General Ban Ki-moon said on Wednesday there was only a narrow window of opportunity to avert full-scale civil war in Syria, which sits at a crossroads of Middle East conflict bordering Turkey, Jordan, Israel, Iraq and Lebanon.",155,165,crossroads,2,4,6
38B7Q9C28G6F3JQ013CJBEQMZM796G,"U.N. Secretary General Ban Ki-moon said on Wednesday there was only a narrow window of opportunity to avert full-scale civil war in Syria, which sits at a crossroads of Middle East conflict bordering Turkey, Jordan, Israel, Iraq and Lebanon.",181,189,conflict,2,0,2
38B7Q9C28G6F3JQ013CJBEQMZM796G,"Its 23-million population comprises a mix of faiths, sects and ethnic groups whose tensions resonate in neighboring states.",26,35,comprises,5,3,8
38B7Q9C28G6F3JQ013CJBEQMZM796G,"Its 23-million population comprises a mix of faiths, sects and ethnic groups whose tensions resonate in neighboring states.",45,51,faiths,0,1,1
38B7Q9C28G6F3JQ013CJBEQMZM796G,"Its 23-million population comprises a mix of faiths, sects and ethnic groups whose tensions resonate in neighboring states.",53,58,sects,2,4,6
38B7Q9C28G6F3JQ013CJBEQMZM796G,"Its 23-million population comprises a mix of faiths, sects and ethnic groups whose tensions resonate in neighboring states.",63,69,ethnic,1,1,2
38B7Q9C28G6F3JQ013CJBEQMZM796G,"Its 23-million population comprises a mix of faiths, sects and ethnic groups whose tensions resonate in neighboring states.",63,76,ethnic groups,0,1,1
38B7Q9C28G6F3JQ013CJBEQMZM796G,"Its 23-million population comprises a mix of faiths, sects and ethnic groups whose tensions resonate in neighboring states.",83,91,tensions,2,0,2
38B7Q9C28G6F3JQ013CJBEQMZM796G,"Its 23-million population comprises a mix of faiths, sects and ethnic groups whose tensions resonate in neighboring states.",83,100,tensions resonate,1,0,1
38B7Q9C28G6F3JQ013CJBEQMZM796G,"Its 23-million population comprises a mix of faiths, sects and ethnic groups whose tensions resonate in neighboring states.",83,122,tensions resonate in neighboring states,1,0,1
38B7Q9C28G6F3JQ013CJBEQMZM796G,"Its 23-million population comprises a mix of faiths, sects and ethnic groups whose tensions resonate in neighboring states.",92,100,resonate,9,10,19
38B7Q9C28G6F3JQ013CJBEQMZM796G,"Its 23-million population comprises a mix of faiths, sects and ethnic groups whose tensions resonate in neighboring states.",104,115,neighboring,1,1,2
38B7Q9C28G6F3JQ013CJBEQMZM796G,"The United States, Europe and Gulf Arab states want Assad to step down but his ally Russia has blocked more robust action against the Syrian authorities in the U.N. Security Council and remains firmly behind Annan's six-point peace plan.",79,83,ally,3,0,3
38B7Q9C28G6F3JQ013CJBEQMZM796G,"The United States, Europe and Gulf Arab states want Assad to step down but his ally Russia has blocked more robust action against the Syrian authorities in the U.N. Security Council and remains firmly behind Annan's six-point peace plan.",108,114,robust,6,6,12
38B7Q9C28G6F3JQ013CJBEQMZM796G,"The United States, Europe and Gulf Arab states want Assad to step down but his ally Russia has blocked more robust action against the Syrian authorities in the U.N. Security Council and remains firmly behind Annan's six-point peace plan.",108,121,robust action,1,2,3
38B7Q9C28G6F3JQ013CJBEQMZM796G,"The United States, Europe and Gulf Arab states want Assad to step down but his ally Russia has blocked more robust action against the Syrian authorities in the U.N. Security Council and remains firmly behind Annan's six-point peace plan.",141,152,authorities,0,2,2
38B7Q9C28G6F3JQ013CJBEQMZM796G,"The United States, Europe and Gulf Arab states want Assad to step down but his ally Russia has blocked more robust action against the Syrian authorities in the U.N. Security Council and remains firmly behind Annan's six-point peace plan.",186,207,remains firmly behind,1,0,1
38B7Q9C28G6F3JQ013CJBEQMZM796G,"The United States, Europe and Gulf Arab states want Assad to step down but his ally Russia has blocked more robust action against the Syrian authorities in the U.N. Security Council and remains firmly behind Annan's six-point peace plan.",194,200,firmly,1,0,1
38B7Q9C28G6F3JQ013CJBEQMZM796G,"The United States, Europe and Gulf Arab states want Assad to step down but his ally Russia has blocked more robust action against the Syrian authorities in the U.N. Security Council and remains firmly behind Annan's six-point peace plan.",216,236,six-point peace plan,2,0,2
3RZS0FBRWKBPBNF8SJLJJ4IB1P3CP0,"Shock: Locals in Bellaghy, County Derry, are said to be stunned by the tragic shooting, which happened in Brenda O'Neill's rented house 'All three were arrested in the Toome area and have been taken to the Serious Crime Suite at Antrim police station.'",17,25,Bellaghy,0,1,1
3RZS0FBRWKBPBNF8SJLJJ4IB1P3CP0,"Shock: Locals in Bellaghy, County Derry, are said to be stunned by the tragic shooting, which happened in Brenda O'Neill's rented house 'All three were arrested in the Toome area and have been taken to the Serious Crime Suite at Antrim police station.'",53,63,be stunned,0,1,1
3RZS0FBRWKBPBNF8SJLJJ4IB1P3CP0,"Shock: Locals in Bellaghy, County Derry, are said to be stunned by the tragic shooting, which happened in Brenda O'Neill's rented house 'All three were arrested in the Toome area and have been taken to the Serious Crime Suite at Antrim police station.'",56,63,stunned,8,10,18
3RZS0FBRWKBPBNF8SJLJJ4IB1P3CP0,"Shock: Locals in Bellaghy, County Derry, are said to be stunned by the tragic shooting, which happened in Brenda O'Neill's rented house 'All three were arrested in the Toome area and have been taken to the Serious Crime Suite at Antrim police station.'",71,77,tragic,4,6,10
3RZS0FBRWKBPBNF8SJLJJ4IB1P3CP0,"Shock: Locals in Bellaghy, County Derry, are said to be stunned by the tragic shooting, which happened in Brenda O'Neill's rented house 'All three were arrested in the Toome area and have been taken to the Serious Crime Suite at Antrim police station.'",71,86,tragic shooting,1,0,1
3RZS0FBRWKBPBNF8SJLJJ4IB1P3CP0,"Shock: Locals in Bellaghy, County Derry, are said to be stunned by the tragic shooting, which happened in Brenda O'Neill's rented house 'All three were arrested in the Toome area and have been taken to the Serious Crime Suite at Antrim police station.'",113,120,ONeills,0,1,1
3RZS0FBRWKBPBNF8SJLJJ4IB1P3CP0,"Shock: Locals in Bellaghy, County Derry, are said to be stunned by the tragic shooting, which happened in Brenda O'Neill's rented house 'All three were arrested in the Toome area and have been taken to the Serious Crime Suite at Antrim police station.'",152,160,arrested,1,0,1
3RZS0FBRWKBPBNF8SJLJJ4IB1P3CP0,"Shock: Locals in Bellaghy, County Derry, are said to be stunned by the tragic shooting, which happened in Brenda O'Neill's rented house 'All three were arrested in the Toome area and have been taken to the Serious Crime Suite at Antrim police station.'",168,173,Toome,0,1,1
3RZS0FBRWKBPBNF8SJLJJ4IB1P3CP0,"Shock: Locals in Bellaghy, County Derry, are said to be stunned by the tragic shooting, which happened in Brenda O'Neill's rented house 'All three were arrested in the Toome area and have been taken to the Serious Crime Suite at Antrim police station.'",206,225,Serious Crime Suite,0,1,1
3RZS0FBRWKBPBNF8SJLJJ4IB1P3CP0,"Shock: Locals in Bellaghy, County Derry, are said to be stunned by the tragic shooting, which happened in Brenda O'Neill's rented house 'All three were arrested in the Toome area and have been taken to the Serious Crime Suite at Antrim police station.'",206,250,Serious Crime Suite at Antrim police station,1,0,1
3RZS0FBRWKBPBNF8SJLJJ4IB1P3CP0,"Shock: Locals in Bellaghy, County Derry, are said to be stunned by the tragic shooting, which happened in Brenda O'Neill's rented house 'All three were arrested in the Toome area and have been taken to the Serious Crime Suite at Antrim police station.'",214,225,Crime Suite,0,1,1
3RZS0FBRWKBPBNF8SJLJJ4IB1P3CP0,"Shock: Locals in Bellaghy, County Derry, are said to be stunned by the tragic shooting, which happened in Brenda O'Neill's rented house 'All three were arrested in the Toome area and have been taken to the Serious Crime Suite at Antrim police station.'",220,225,Suite,2,1,3
3RZS0FBRWKBPBNF8SJLJJ4IB1P3CP0,"Shock: Locals in Bellaghy, County Derry, are said to be stunned by the tragic shooting, which happened in Brenda O'Neill's rented house 'All three were arrested in the Toome area and have been taken to the Serious Crime Suite at Antrim police station.'",229,235,Antrim,0,2,2
3RZS0FBRWKBPBNF8SJLJJ4IB1P3CP0,Investigating officers have appealed for anyone with information about the incident to contact them.,0,13,Investigating,7,4,11
3RZS0FBRWKBPBNF8SJLJJ4IB1P3CP0,Investigating officers have appealed for anyone with information about the incident to contact them.,23,36,have appealed,0,1,1
3RZS0FBRWKBPBNF8SJLJJ4IB1P3CP0,Investigating officers have appealed for anyone with information about the incident to contact them.,28,36,appealed,7,7,14
3RZS0FBRWKBPBNF8SJLJJ4IB1P3CP0,Investigating officers have appealed for anyone with information about the incident to contact them.,53,64,information,2,1,3
3RZS0FBRWKBPBNF8SJLJJ4IB1P3CP0,Investigating officers have appealed for anyone with information about the incident to contact them.,75,83,incident,6,3,9
3RZS0FBRWKBPBNF8SJLJJ4IB1P3CP0,"Caoimhe Scullion, Sinn Fein councillor on Magherafelt District Council who lives in Bellaghy, said the tight-knit village had been plunged into shock over the gun attack.",0,7,Caoimhe,0,1,1
3RZS0FBRWKBPBNF8SJLJJ4IB1P3CP0,"Caoimhe Scullion, Sinn Fein councillor on Magherafelt District Council who lives in Bellaghy, said the tight-knit village had been plunged into shock over the gun attack.",28,38,councillor,7,5,12
3RZS0FBRWKBPBNF8SJLJJ4IB1P3CP0,"Caoimhe Scullion, Sinn Fein councillor on Magherafelt District Council who lives in Bellaghy, said the tight-knit village had been plunged into shock over the gun attack.",42,53,Magherafelt,0,1,1
3RZS0FBRWKBPBNF8SJLJJ4IB1P3CP0,"Caoimhe Scullion, Sinn Fein councillor on Magherafelt District Council who lives in Bellaghy, said the tight-knit village had been plunged into shock over the gun attack.",103,113,tight-knit,10,6,16
3RZS0FBRWKBPBNF8SJLJJ4IB1P3CP0,"Caoimhe Scullion, Sinn Fein councillor on Magherafelt District Council who lives in Bellaghy, said the tight-knit village had been plunged into shock over the gun attack.",103,121,tight-knit village,0,1,1
3RZS0FBRWKBPBNF8SJLJJ4IB1P3CP0,"Caoimhe Scullion, Sinn Fein councillor on Magherafelt District Council who lives in Bellaghy, said the tight-knit village had been plunged into shock over the gun attack.",131,138,plunged,8,10,18
3RZS0FBRWKBPBNF8SJLJJ4IB1P3CP0,"Caoimhe Scullion, Sinn Fein councillor on Magherafelt District Council who lives in Bellaghy, said the tight-knit village had been plunged into shock over the gun attack.",131,149,plunged into shock,0,1,1
3RZS0FBRWKBPBNF8SJLJJ4IB1P3CP0,"Caoimhe Scullion, Sinn Fein councillor on Magherafelt District Council who lives in Bellaghy, said the tight-knit village had been plunged into shock over the gun attack.",144,149,shock,1,0,1
3RZS0FBRWKBPBNF8SJLJJ4IB1P3CP0,"'Everybody is in complete shock,' she said.",17,31,complete shock,0,1,1
3RZS0FBRWKBPBNF8SJLJJ4IB1P3CP0,"'Everybody is in complete shock,' she said.",26,31,shock,1,0,1
3RZS0FBRWKBPBNF8SJLJJ4IB1P3CP0,"'We hear these stories happening everywhere else, but you never think it will happen on your doorstep.'",23,43,happening everywhere,1,0,1
3RZS0FBRWKBPBNF8SJLJJ4IB1P3CP0,"'We hear these stories happening everywhere else, but you never think it will happen on your doorstep.'",93,101,doorstep,1,5,6
3RZS0FBRWKBPBNF8SJLJJ4IB1P3CP0,Ms Scullion said everybody knows everybody else in the small village.,3,11,Scullion,0,1,1
3RZS0FBRWKBPBNF8SJLJJ4IB1P3CP0,"Ian Milne, also a Sinn Fein councillor who lives in Bellaghy, said the dead girl marked her 18th birthday within the last two weeks.",18,38,Sinn Fein councillor,1,1,2
3RZS0FBRWKBPBNF8SJLJJ4IB1P3CP0,"Ian Milne, also a Sinn Fein councillor who lives in Bellaghy, said the dead girl marked her 18th birthday within the last two weeks.",23,27,Fein,0,1,1
3RZS0FBRWKBPBNF8SJLJJ4IB1P3CP0,"Ian Milne, also a Sinn Fein councillor who lives in Bellaghy, said the dead girl marked her 18th birthday within the last two weeks.",28,38,councillor,6,2,8
3RZS0FBRWKBPBNF8SJLJJ4IB1P3CP0,"Ian Milne, also a Sinn Fein councillor who lives in Bellaghy, said the dead girl marked her 18th birthday within the last two weeks.",71,87,dead girl marked,0,1,1
3RZS0FBRWKBPBNF8SJLJJ4IB1P3CP0,"Ian Milne, also a Sinn Fein councillor who lives in Bellaghy, said the dead girl marked her 18th birthday within the last two weeks.",81,87,marked,1,0,1
3BFF0DJK8XD3AWXB6MK33JNQBI7STL,National security expert Michael O'Hanlon of the Brookings Institution said he is more encouraged about the prospects for success in Afghanistan after President Obama's speech.,0,24,National security expert,1,1,2
3BFF0DJK8XD3AWXB6MK33JNQBI7STL,National security expert Michael O'Hanlon of the Brookings Institution said he is more encouraged about the prospects for success in Afghanistan after President Obama's speech.,9,17,security,0,2,2
3BFF0DJK8XD3AWXB6MK33JNQBI7STL,National security expert Michael O'Hanlon of the Brookings Institution said he is more encouraged about the prospects for success in Afghanistan after President Obama's speech.,9,24,security expert,0,1,1
3BFF0DJK8XD3AWXB6MK33JNQBI7STL,National security expert Michael O'Hanlon of the Brookings Institution said he is more encouraged about the prospects for success in Afghanistan after President Obama's speech.,49,58,Brookings,1,0,1
3BFF0DJK8XD3AWXB6MK33JNQBI7STL,National security expert Michael O'Hanlon of the Brookings Institution said he is more encouraged about the prospects for success in Afghanistan after President Obama's speech.,59,70,Institution,2,2,4
3BFF0DJK8XD3AWXB6MK33JNQBI7STL,National security expert Michael O'Hanlon of the Brookings Institution said he is more encouraged about the prospects for success in Afghanistan after President Obama's speech.,87,97,encouraged,2,4,6
3BFF0DJK8XD3AWXB6MK33JNQBI7STL,National security expert Michael O'Hanlon of the Brookings Institution said he is more encouraged about the prospects for success in Afghanistan after President Obama's speech.,108,117,prospects,8,8,16
3BFF0DJK8XD3AWXB6MK33JNQBI7STL,"To see the president emphatically state as a matter of wartime leadership that we are really working closely in a committed way with our Afghan partners I think it was an important message, he said.",22,34,emphatically,10,10,20
3BFF0DJK8XD3AWXB6MK33JNQBI7STL,"To see the president emphatically state as a matter of wartime leadership that we are really working closely in a committed way with our Afghan partners I think it was an important message, he said.",22,40,emphatically state,1,0,1
3BFF0DJK8XD3AWXB6MK33JNQBI7STL,"To see the president emphatically state as a matter of wartime leadership that we are really working closely in a committed way with our Afghan partners I think it was an important message, he said.",56,63,wartime,2,3,5
3BFF0DJK8XD3AWXB6MK33JNQBI7STL,"To see the president emphatically state as a matter of wartime leadership that we are really working closely in a committed way with our Afghan partners I think it was an important message, he said.",56,74,wartime leadership,0,1,1
3BFF0DJK8XD3AWXB6MK33JNQBI7STL,"To see the president emphatically state as a matter of wartime leadership that we are really working closely in a committed way with our Afghan partners I think it was an important message, he said.",64,74,leadership,1,1,2
3BFF0DJK8XD3AWXB6MK33JNQBI7STL,"To see the president emphatically state as a matter of wartime leadership that we are really working closely in a committed way with our Afghan partners I think it was an important message, he said.",115,124,committed,3,4,7
3BFF0DJK8XD3AWXB6MK33JNQBI7STL,"To see the president emphatically state as a matter of wartime leadership that we are really working closely in a committed way with our Afghan partners I think it was an important message, he said.",115,128,committed way,1,3,4
3BFF0DJK8XD3AWXB6MK33JNQBI7STL,"He made it pretty clear that, if he's reelected at least, he'll see the mission past 2014 as important but very limited and very focused, O'Hanlon said.",12,18,pretty,1,1,2
3BFF0DJK8XD3AWXB6MK33JNQBI7STL,"He made it pretty clear that, if he's reelected at least, he'll see the mission past 2014 as important but very limited and very focused, O'Hanlon said.",39,48,reelected,5,5,10
3BFF0DJK8XD3AWXB6MK33JNQBI7STL,"He made it pretty clear that, if he's reelected at least, he'll see the mission past 2014 as important but very limited and very focused, O'Hanlon said.",73,80,mission,0,1,1
3BFF0DJK8XD3AWXB6MK33JNQBI7STL,"He made it pretty clear that, if he's reelected at least, he'll see the mission past 2014 as important but very limited and very focused, O'Hanlon said.",130,137,focused,2,3,5
3BFF0DJK8XD3AWXB6MK33JNQBI7STL,"Obama's surprise trip is sure to draw criticism from Republicans, who have accused Mr. Obama of ""spiking the football"" in the days leading up to the one year anniversary of the death of bin Laden.",33,37,draw,0,2,2
3BFF0DJK8XD3AWXB6MK33JNQBI7STL,"Obama's surprise trip is sure to draw criticism from Republicans, who have accused Mr. Obama of ""spiking the football"" in the days leading up to the one year anniversary of the death of bin Laden.",33,47,draw criticism,2,3,5
3BFF0DJK8XD3AWXB6MK33JNQBI7STL,"Obama's surprise trip is sure to draw criticism from Republicans, who have accused Mr. Obama of ""spiking the football"" in the days leading up to the one year anniversary of the death of bin Laden.",38,47,criticism,5,7,12
3BFF0DJK8XD3AWXB6MK33JNQBI7STL,"Obama's surprise trip is sure to draw criticism from Republicans, who have accused Mr. Obama of ""spiking the football"" in the days leading up to the one year anniversary of the death of bin Laden.",75,82,accused,2,5,7
3BFF0DJK8XD3AWXB6MK33JNQBI7STL,"Obama's surprise trip is sure to draw criticism from Republicans, who have accused Mr. Obama of ""spiking the football"" in the days leading up to the one year anniversary of the death of bin Laden.",97,117,spiking the football,6,3,9
3BFF0DJK8XD3AWXB6MK33JNQBI7STL,"Obama's surprise trip is sure to draw criticism from Republicans, who have accused Mr. Obama of ""spiking the football"" in the days leading up to the one year anniversary of the death of bin Laden.",97,104,spiking,1,2,3
3BFF0DJK8XD3AWXB6MK33JNQBI7STL,"Obama's surprise trip is sure to draw criticism from Republicans, who have accused Mr. Obama of ""spiking the football"" in the days leading up to the one year anniversary of the death of bin Laden.",131,138,leading,0,1,1
3BFF0DJK8XD3AWXB6MK33JNQBI7STL,"Obama's surprise trip is sure to draw criticism from Republicans, who have accused Mr. Obama of ""spiking the football"" in the days leading up to the one year anniversary of the death of bin Laden.",158,169,anniversary,3,2,5
3UUIU9GZC5624UZ0UQ7VA8DYYB25TQ,"That prompted the military to deploy its largest warship, the BRP Gregorio del Pilar, which was recently acquired from the United States.",5,13,prompted,3,9,12
3UUIU9GZC5624UZ0UQ7VA8DYYB25TQ,"That prompted the military to deploy its largest warship, the BRP Gregorio del Pilar, which was recently acquired from the United States.",18,26,military,2,0,2
3UUIU9GZC5624UZ0UQ7VA8DYYB25TQ,"That prompted the military to deploy its largest warship, the BRP Gregorio del Pilar, which was recently acquired from the United States.",30,36,deploy,9,10,19
3UUIU9GZC5624UZ0UQ7VA8DYYB25TQ,"That prompted the military to deploy its largest warship, the BRP Gregorio del Pilar, which was recently acquired from the United States.",49,56,warship,1,0,1
3UUIU9GZC5624UZ0UQ7VA8DYYB25TQ,"That prompted the military to deploy its largest warship, the BRP Gregorio del Pilar, which was recently acquired from the United States.",96,113,recently acquired,2,0,2
3UUIU9GZC5624UZ0UQ7VA8DYYB25TQ,"That prompted the military to deploy its largest warship, the BRP Gregorio del Pilar, which was recently acquired from the United States.",105,113,acquired,8,7,15
3UUIU9GZC5624UZ0UQ7VA8DYYB25TQ,"On Tuesday, Filipino sailors from the warship boarded the Chinese vessels for an inspection, discovering large amounts of illegally collected coral, giant clams and live sharks inside the first boat.",12,20,Filipino,0,1,1
3UUIU9GZC5624UZ0UQ7VA8DYYB25TQ,"On Tuesday, Filipino sailors from the warship boarded the Chinese vessels for an inspection, discovering large amounts of illegally collected coral, giant clams and live sharks inside the first boat.",38,45,warship,1,0,1
3UUIU9GZC5624UZ0UQ7VA8DYYB25TQ,"On Tuesday, Filipino sailors from the warship boarded the Chinese vessels for an inspection, discovering large amounts of illegally collected coral, giant clams and live sharks inside the first boat.",46,53,boarded,1,2,3
3UUIU9GZC5624UZ0UQ7VA8DYYB25TQ,"On Tuesday, Filipino sailors from the warship boarded the Chinese vessels for an inspection, discovering large amounts of illegally collected coral, giant clams and live sharks inside the first boat.",58,73,Chinese vessels,0,1,1
3UUIU9GZC5624UZ0UQ7VA8DYYB25TQ,"On Tuesday, Filipino sailors from the warship boarded the Chinese vessels for an inspection, discovering large amounts of illegally collected coral, giant clams and live sharks inside the first boat.",66,73,vessels,5,2,7
3UUIU9GZC5624UZ0UQ7VA8DYYB25TQ,"On Tuesday, Filipino sailors from the warship boarded the Chinese vessels for an inspection, discovering large amounts of illegally collected coral, giant clams and live sharks inside the first boat.",81,91,inspection,3,0,3
3UUIU9GZC5624UZ0UQ7VA8DYYB25TQ,"On Tuesday, Filipino sailors from the warship boarded the Chinese vessels for an inspection, discovering large amounts of illegally collected coral, giant clams and live sharks inside the first boat.",122,131,illegally,2,2,4
3UUIU9GZC5624UZ0UQ7VA8DYYB25TQ,"On Tuesday, Filipino sailors from the warship boarded the Chinese vessels for an inspection, discovering large amounts of illegally collected coral, giant clams and live sharks inside the first boat.",122,147,illegally collected coral,2,1,3
3UUIU9GZC5624UZ0UQ7VA8DYYB25TQ,"On Tuesday, Filipino sailors from the warship boarded the Chinese vessels for an inspection, discovering large amounts of illegally collected coral, giant clams and live sharks inside the first boat.",142,147,coral,2,1,3
3UUIU9GZC5624UZ0UQ7VA8DYYB25TQ,"On Tuesday, Filipino sailors from the warship boarded the Chinese vessels for an inspection, discovering large amounts of illegally collected coral, giant clams and live sharks inside the first boat.",155,160,clams,1,4,5
3UUIU9GZC5624UZ0UQ7VA8DYYB25TQ,"Del Rosario said that the Chinese fishermen had been ""engaged in illegal fishing and harvesting of endangered marine species.""",54,61,engaged,1,1,2
3UUIU9GZC5624UZ0UQ7VA8DYYB25TQ,"Del Rosario said that the Chinese fishermen had been ""engaged in illegal fishing and harvesting of endangered marine species.""",54,80,engaged in illegal fishing,1,0,1
3UUIU9GZC5624UZ0UQ7VA8DYYB25TQ,"Del Rosario said that the Chinese fishermen had been ""engaged in illegal fishing and harvesting of endangered marine species.""",65,72,illegal,1,1,2
3UUIU9GZC5624UZ0UQ7VA8DYYB25TQ,"Del Rosario said that the Chinese fishermen had been ""engaged in illegal fishing and harvesting of endangered marine species.""",85,95,harvesting,3,4,7
3UUIU9GZC5624UZ0UQ7VA8DYYB25TQ,"Del Rosario said that the Chinese fishermen had been ""engaged in illegal fishing and harvesting of endangered marine species.""",85,124,harvesting of endangered marine species,2,0,2
3UUIU9GZC5624UZ0UQ7VA8DYYB25TQ,"Del Rosario said that the Chinese fishermen had been ""engaged in illegal fishing and harvesting of endangered marine species.""",99,109,endangered,5,10,15
3UUIU9GZC5624UZ0UQ7VA8DYYB25TQ,"Del Rosario said that the Chinese fishermen had been ""engaged in illegal fishing and harvesting of endangered marine species.""",99,124,endangered marine species,3,0,3
3UUIU9GZC5624UZ0UQ7VA8DYYB25TQ,"Del Rosario said that the Chinese fishermen had been ""engaged in illegal fishing and harvesting of endangered marine species.""",110,116,marine,1,0,1
3UUIU9GZC5624UZ0UQ7VA8DYYB25TQ,"Del Rosario said that the Chinese fishermen had been ""engaged in illegal fishing and harvesting of endangered marine species.""",117,124,species,2,0,2
3UUIU9GZC5624UZ0UQ7VA8DYYB25TQ,"Two Chinese maritime surveillance ships later approached and positioned themselves between the Philippine warship and the Chinese fishing vessels ""thus preventing the arrests of the erring Chinese fishermen,"" the Philippine statement said.",12,20,maritime,3,3,6
3UUIU9GZC5624UZ0UQ7VA8DYYB25TQ,"Two Chinese maritime surveillance ships later approached and positioned themselves between the Philippine warship and the Chinese fishing vessels ""thus preventing the arrests of the erring Chinese fishermen,"" the Philippine statement said.",12,33,maritime surveillance,3,1,4
3UUIU9GZC5624UZ0UQ7VA8DYYB25TQ,"Two Chinese maritime surveillance ships later approached and positioned themselves between the Philippine warship and the Chinese fishing vessels ""thus preventing the arrests of the erring Chinese fishermen,"" the Philippine statement said.",12,39,maritime surveillance ships,2,0,2
3UUIU9GZC5624UZ0UQ7VA8DYYB25TQ,"Two Chinese maritime surveillance ships later approached and positioned themselves between the Philippine warship and the Chinese fishing vessels ""thus preventing the arrests of the erring Chinese fishermen,"" the Philippine statement said.",21,33,surveillance,4,4,8
3UUIU9GZC5624UZ0UQ7VA8DYYB25TQ,"Two Chinese maritime surveillance ships later approached and positioned themselves between the Philippine warship and the Chinese fishing vessels ""thus preventing the arrests of the erring Chinese fishermen,"" the Philippine statement said.",21,39,surveillance ships,1,1,2
3UUIU9GZC5624UZ0UQ7VA8DYYB25TQ,"Two Chinese maritime surveillance ships later approached and positioned themselves between the Philippine warship and the Chinese fishing vessels ""thus preventing the arrests of the erring Chinese fishermen,"" the Philippine statement said.",46,56,approached,1,0,1
3UUIU9GZC5624UZ0UQ7VA8DYYB25TQ,"Two Chinese maritime surveillance ships later approached and positioned themselves between the Philippine warship and the Chinese fishing vessels ""thus preventing the arrests of the erring Chinese fishermen,"" the Philippine statement said.",61,71,positioned,2,1,3
3UUIU9GZC5624UZ0UQ7VA8DYYB25TQ,"Two Chinese maritime surveillance ships later approached and positioned themselves between the Philippine warship and the Chinese fishing vessels ""thus preventing the arrests of the erring Chinese fishermen,"" the Philippine statement said.",106,113,warship,1,0,1
3UUIU9GZC5624UZ0UQ7VA8DYYB25TQ,"Two Chinese maritime surveillance ships later approached and positioned themselves between the Philippine warship and the Chinese fishing vessels ""thus preventing the arrests of the erring Chinese fishermen,"" the Philippine statement said.",138,145,vessels,1,2,3
3UUIU9GZC5624UZ0UQ7VA8DYYB25TQ,"Two Chinese maritime surveillance ships later approached and positioned themselves between the Philippine warship and the Chinese fishing vessels ""thus preventing the arrests of the erring Chinese fishermen,"" the Philippine statement said.",152,162,preventing,1,0,1
3UUIU9GZC5624UZ0UQ7VA8DYYB25TQ,"Two Chinese maritime surveillance ships later approached and positioned themselves between the Philippine warship and the Chinese fishing vessels ""thus preventing the arrests of the erring Chinese fishermen,"" the Philippine statement said.",182,188,erring,8,8,16
3UUIU9GZC5624UZ0UQ7VA8DYYB25TQ,"The Chinese Embassy said the fishing boats had taken shelter from a storm in the lagoon, and that Philippine troops including some who were armed went into the lagoon and harassed the fishermen.",12,19,Embassy,2,0,2
3UUIU9GZC5624UZ0UQ7VA8DYYB25TQ,"The Chinese Embassy said the fishing boats had taken shelter from a storm in the lagoon, and that Philippine troops including some who were armed went into the lagoon and harassed the fishermen.",53,60,shelter,1,2,3
3UUIU9GZC5624UZ0UQ7VA8DYYB25TQ,"The Chinese Embassy said the fishing boats had taken shelter from a storm in the lagoon, and that Philippine troops including some who were armed went into the lagoon and harassed the fishermen.",81,87,lagoon,6,5,11
3UUIU9GZC5624UZ0UQ7VA8DYYB25TQ,"The Chinese Embassy said the fishing boats had taken shelter from a storm in the lagoon, and that Philippine troops including some who were armed went into the lagoon and harassed the fishermen.",160,166,lagoon,3,1,4
3UUIU9GZC5624UZ0UQ7VA8DYYB25TQ,"The Chinese Embassy said the fishing boats had taken shelter from a storm in the lagoon, and that Philippine troops including some who were armed went into the lagoon and harassed the fishermen.",171,179,harassed,9,7,16
3Y3N5A7N4GAWTNJ0WVBGZRGZY7MMYV,“Obama’s visit to Afghanistan came under huge security preparations.,41,45,huge,0,2,2
3Y3N5A7N4GAWTNJ0WVBGZRGZY7MMYV,“Obama’s visit to Afghanistan came under huge security preparations.,41,67,huge security preparations,1,1,2
3Y3N5A7N4GAWTNJ0WVBGZRGZY7MMYV,“Obama’s visit to Afghanistan came under huge security preparations.,46,54,security,1,1,2
3Y3N5A7N4GAWTNJ0WVBGZRGZY7MMYV,“Obama’s visit to Afghanistan came under huge security preparations.,46,67,security preparations,1,2,3
3Y3N5A7N4GAWTNJ0WVBGZRGZY7MMYV,“Obama’s visit to Afghanistan came under huge security preparations.,55,67,preparations,6,2,8
3Y3N5A7N4GAWTNJ0WVBGZRGZY7MMYV,"Of course it was not risky for him, but it created concerns for citizens of Kabul.",21,26,risky,2,2,4
3Y3N5A7N4GAWTNJ0WVBGZRGZY7MMYV,"Of course it was not risky for him, but it created concerns for citizens of Kabul.",43,59,created concerns,0,1,1
3Y3N5A7N4GAWTNJ0WVBGZRGZY7MMYV,"Of course it was not risky for him, but it created concerns for citizens of Kabul.",51,59,concerns,0,4,4
3Y3N5A7N4GAWTNJ0WVBGZRGZY7MMYV,"Of course it was not risky for him, but it created concerns for citizens of Kabul.",64,72,citizens,1,0,1
3Y3N5A7N4GAWTNJ0WVBGZRGZY7MMYV,"People were worried that many things would happen,” says Muhammad Hassan Haqyar, an independent political analyst in Kabul.",84,95,independent,3,1,4
3Y3N5A7N4GAWTNJ0WVBGZRGZY7MMYV,"People were worried that many things would happen,” says Muhammad Hassan Haqyar, an independent political analyst in Kabul.",84,113,independent political analyst,6,0,6
3Y3N5A7N4GAWTNJ0WVBGZRGZY7MMYV,"People were worried that many things would happen,” says Muhammad Hassan Haqyar, an independent political analyst in Kabul.",96,105,political,2,0,2
3Y3N5A7N4GAWTNJ0WVBGZRGZY7MMYV,"People were worried that many things would happen,” says Muhammad Hassan Haqyar, an independent political analyst in Kabul.",96,113,political analyst,0,1,1
3Y3N5A7N4GAWTNJ0WVBGZRGZY7MMYV,"People were worried that many things would happen,” says Muhammad Hassan Haqyar, an independent political analyst in Kabul.",106,113,analyst,4,2,6
3Y3N5A7N4GAWTNJ0WVBGZRGZY7MMYV,"“We saw the attack this morning that took the lives of many innocent people, but it was completely safe for Obama.”",24,31,morning,1,0,1
3Y3N5A7N4GAWTNJ0WVBGZRGZY7MMYV,"“We saw the attack this morning that took the lives of many innocent people, but it was completely safe for Obama.”",60,68,innocent,2,5,7
3Y3N5A7N4GAWTNJ0WVBGZRGZY7MMYV,"RELATED Afghanistan: 5 areas of concern after the US leaves The Taliban immediately claimed responsibility for the attack, saying they planned and conducted the attack on extremely short notice as soon as they learned about Obama’s arrival in Afghanistan.",0,7,RELATED,0,1,1
3Y3N5A7N4GAWTNJ0WVBGZRGZY7MMYV,"RELATED Afghanistan: 5 areas of concern after the US leaves The Taliban immediately claimed responsibility for the attack, saying they planned and conducted the attack on extremely short notice as soon as they learned about Obama’s arrival in Afghanistan.",32,39,concern,2,1,3
3Y3N5A7N4GAWTNJ0WVBGZRGZY7MMYV,"RELATED Afghanistan: 5 areas of concern after the US leaves The Taliban immediately claimed responsibility for the attack, saying they planned and conducted the attack on extremely short notice as soon as they learned about Obama’s arrival in Afghanistan.",64,71,Taliban,1,0,1
3Y3N5A7N4GAWTNJ0WVBGZRGZY7MMYV,"RELATED Afghanistan: 5 areas of concern after the US leaves The Taliban immediately claimed responsibility for the attack, saying they planned and conducted the attack on extremely short notice as soon as they learned about Obama’s arrival in Afghanistan.",72,83,immediately,2,0,2
3Y3N5A7N4GAWTNJ0WVBGZRGZY7MMYV,"RELATED Afghanistan: 5 areas of concern after the US leaves The Taliban immediately claimed responsibility for the attack, saying they planned and conducted the attack on extremely short notice as soon as they learned about Obama’s arrival in Afghanistan.",84,91,claimed,0,4,4
3Y3N5A7N4GAWTNJ0WVBGZRGZY7MMYV,"RELATED Afghanistan: 5 areas of concern after the US leaves The Taliban immediately claimed responsibility for the attack, saying they planned and conducted the attack on extremely short notice as soon as they learned about Obama’s arrival in Afghanistan.",84,106,claimed responsibility,1,0,1
3Y3N5A7N4GAWTNJ0WVBGZRGZY7MMYV,"RELATED Afghanistan: 5 areas of concern after the US leaves The Taliban immediately claimed responsibility for the attack, saying they planned and conducted the attack on extremely short notice as soon as they learned about Obama’s arrival in Afghanistan.",92,106,responsibility,0,1,1
3Y3N5A7N4GAWTNJ0WVBGZRGZY7MMYV,"RELATED Afghanistan: 5 areas of concern after the US leaves The Taliban immediately claimed responsibility for the attack, saying they planned and conducted the attack on extremely short notice as soon as they learned about Obama’s arrival in Afghanistan.",147,156,conducted,5,3,8
3Y3N5A7N4GAWTNJ0WVBGZRGZY7MMYV,"RELATED Afghanistan: 5 areas of concern after the US leaves The Taliban immediately claimed responsibility for the attack, saying they planned and conducted the attack on extremely short notice as soon as they learned about Obama’s arrival in Afghanistan.",171,180,extremely,2,3,5
3Y3N5A7N4GAWTNJ0WVBGZRGZY7MMYV,"RELATED Afghanistan: 5 areas of concern after the US leaves The Taliban immediately claimed responsibility for the attack, saying they planned and conducted the attack on extremely short notice as soon as they learned about Obama’s arrival in Afghanistan.",171,193,extremely short notice,2,1,3
3Y3N5A7N4GAWTNJ0WVBGZRGZY7MMYV,"RELATED Afghanistan: 5 areas of concern after the US leaves The Taliban immediately claimed responsibility for the attack, saying they planned and conducted the attack on extremely short notice as soon as they learned about Obama’s arrival in Afghanistan.",181,193,short notice,1,0,1
3Y3N5A7N4GAWTNJ0WVBGZRGZY7MMYV,The unsophisticated nature of the attack suggests little planning beyond having fighters and some explosives pre-positioned in the vicinity of Kabul.,4,19,unsophisticated,10,10,20
3Y3N5A7N4GAWTNJ0WVBGZRGZY7MMYV,The unsophisticated nature of the attack suggests little planning beyond having fighters and some explosives pre-positioned in the vicinity of Kabul.,4,26,unsophisticated nature,3,1,4
3Y3N5A7N4GAWTNJ0WVBGZRGZY7MMYV,The unsophisticated nature of the attack suggests little planning beyond having fighters and some explosives pre-positioned in the vicinity of Kabul.,66,72,beyond,0,4,4
3Y3N5A7N4GAWTNJ0WVBGZRGZY7MMYV,The unsophisticated nature of the attack suggests little planning beyond having fighters and some explosives pre-positioned in the vicinity of Kabul.,98,108,explosives,2,3,5
3Y3N5A7N4GAWTNJ0WVBGZRGZY7MMYV,The unsophisticated nature of the attack suggests little planning beyond having fighters and some explosives pre-positioned in the vicinity of Kabul.,109,123,pre-positioned,10,3,13
3Y3N5A7N4GAWTNJ0WVBGZRGZY7MMYV,The unsophisticated nature of the attack suggests little planning beyond having fighters and some explosives pre-positioned in the vicinity of Kabul.,131,139,vicinity,9,8,17
3E6L1VR4XWNO4THD4PCBLACX2WHF6H,"With that, it was back to the sprawling U.S. air base outside the capital to underscore that last point, that he will close down the war and bring U.S. forces home.",30,39,sprawling,10,10,20
3E6L1VR4XWNO4THD4PCBLACX2WHF6H,"With that, it was back to the sprawling U.S. air base outside the capital to underscore that last point, that he will close down the war and bring U.S. forces home.",77,87,underscore,10,10,20
3E6L1VR4XWNO4THD4PCBLACX2WHF6H,"With that, it was back to the sprawling U.S. air base outside the capital to underscore that last point, that he will close down the war and bring U.S. forces home.",118,128,close down,1,0,1
3E6L1VR4XWNO4THD4PCBLACX2WHF6H,"With that, it was back to the sprawling U.S. air base outside the capital to underscore that last point, that he will close down the war and bring U.S. forces home.",152,158,forces,1,0,1
3E6L1VR4XWNO4THD4PCBLACX2WHF6H,"By alighting in Afghanistan on the anniversary of the raid that killed Sept. 11 mastermind Osama bin Laden, Obama was also making an unsubtle show of the power of the presidency.",3,12,alighting,10,10,20
3E6L1VR4XWNO4THD4PCBLACX2WHF6H,"By alighting in Afghanistan on the anniversary of the raid that killed Sept. 11 mastermind Osama bin Laden, Obama was also making an unsubtle show of the power of the presidency.",3,27,alighting in Afghanistan,1,0,1
3E6L1VR4XWNO4THD4PCBLACX2WHF6H,"By alighting in Afghanistan on the anniversary of the raid that killed Sept. 11 mastermind Osama bin Laden, Obama was also making an unsubtle show of the power of the presidency.",35,46,anniversary,2,2,4
3E6L1VR4XWNO4THD4PCBLACX2WHF6H,"By alighting in Afghanistan on the anniversary of the raid that killed Sept. 11 mastermind Osama bin Laden, Obama was also making an unsubtle show of the power of the presidency.",54,58,raid,1,1,2
3E6L1VR4XWNO4THD4PCBLACX2WHF6H,"By alighting in Afghanistan on the anniversary of the raid that killed Sept. 11 mastermind Osama bin Laden, Obama was also making an unsubtle show of the power of the presidency.",80,90,mastermind,6,7,13
3E6L1VR4XWNO4THD4PCBLACX2WHF6H,"By alighting in Afghanistan on the anniversary of the raid that killed Sept. 11 mastermind Osama bin Laden, Obama was also making an unsubtle show of the power of the presidency.",133,141,unsubtle,10,10,20
3E6L1VR4XWNO4THD4PCBLACX2WHF6H,"By alighting in Afghanistan on the anniversary of the raid that killed Sept. 11 mastermind Osama bin Laden, Obama was also making an unsubtle show of the power of the presidency.",133,146,unsubtle show,0,1,1
3E6L1VR4XWNO4THD4PCBLACX2WHF6H,"By alighting in Afghanistan on the anniversary of the raid that killed Sept. 11 mastermind Osama bin Laden, Obama was also making an unsubtle show of the power of the presidency.",133,159,unsubtle show of the power,1,0,1
3E6L1VR4XWNO4THD4PCBLACX2WHF6H,"By alighting in Afghanistan on the anniversary of the raid that killed Sept. 11 mastermind Osama bin Laden, Obama was also making an unsubtle show of the power of the presidency.",167,177,presidency,2,0,2
3E6L1VR4XWNO4THD4PCBLACX2WHF6H,Not only is he the commander in chief who can finally end what many Americans see as an unwinnable war  — Obama was telling Americans that he is the commander in chief who bagged the biggest bad guy in America's recent history.,19,28,commander,1,0,1
3E6L1VR4XWNO4THD4PCBLACX2WHF6H,Not only is he the commander in chief who can finally end what many Americans see as an unwinnable war  — Obama was telling Americans that he is the commander in chief who bagged the biggest bad guy in America's recent history.,19,37,commander in chief,1,0,1
3E6L1VR4XWNO4THD4PCBLACX2WHF6H,Not only is he the commander in chief who can finally end what many Americans see as an unwinnable war  — Obama was telling Americans that he is the commander in chief who bagged the biggest bad guy in America's recent history.,46,53,finally,1,0,1
3E6L1VR4XWNO4THD4PCBLACX2WHF6H,Not only is he the commander in chief who can finally end what many Americans see as an unwinnable war  — Obama was telling Americans that he is the commander in chief who bagged the biggest bad guy in America's recent history.,88,98,unwinnable,5,7,12
3E6L1VR4XWNO4THD4PCBLACX2WHF6H,Not only is he the commander in chief who can finally end what many Americans see as an unwinnable war  — Obama was telling Americans that he is the commander in chief who bagged the biggest bad guy in America's recent history.,88,102,unwinnable war,1,1,2
3E6L1VR4XWNO4THD4PCBLACX2WHF6H,Not only is he the commander in chief who can finally end what many Americans see as an unwinnable war  — Obama was telling Americans that he is the commander in chief who bagged the biggest bad guy in America's recent history.,149,167,commander in chief,2,0,2
3E6L1VR4XWNO4THD4PCBLACX2WHF6H,Not only is he the commander in chief who can finally end what many Americans see as an unwinnable war  — Obama was telling Americans that he is the commander in chief who bagged the biggest bad guy in America's recent history.,172,178,bagged,8,10,18
3E6L1VR4XWNO4THD4PCBLACX2WHF6H,Not only is he the commander in chief who can finally end what many Americans see as an unwinnable war  — Obama was telling Americans that he is the commander in chief who bagged the biggest bad guy in America's recent history.,212,218,recent,0,1,1
3ZUE82NE0A2B8701X4995O8O8R7F83,"  They said it was in response to the  U.S. president's visit and promised more attacks as they launch their  usual ""spring offensive"" across the country.",22,30,response,1,1,2
3ZUE82NE0A2B8701X4995O8O8R7F83,"  They said it was in response to the  U.S. president's visit and promised more attacks as they launch their  usual ""spring offensive"" across the country.",44,54,presidents,1,0,1
3ZUE82NE0A2B8701X4995O8O8R7F83,"  They said it was in response to the  U.S. president's visit and promised more attacks as they launch their  usual ""spring offensive"" across the country.",96,102,launch,1,4,5
3ZUE82NE0A2B8701X4995O8O8R7F83,"  They said it was in response to the  U.S. president's visit and promised more attacks as they launch their  usual ""spring offensive"" across the country.",117,133,spring offensive,9,5,14
3ZUE82NE0A2B8701X4995O8O8R7F83,"  They said it was in response to the  U.S. president's visit and promised more attacks as they launch their  usual ""spring offensive"" across the country.",117,123,spring,0,1,1
3ZUE82NE0A2B8701X4995O8O8R7F83,"  They said it was in response to the  U.S. president's visit and promised more attacks as they launch their  usual ""spring offensive"" across the country.",124,133,offensive,2,1,3
3ZUE82NE0A2B8701X4995O8O8R7F83,"  They said it was in response to the  U.S. president's visit and promised more attacks as they launch their  usual ""spring offensive"" across the country.",135,153,across the country,0,1,1
3ZUE82NE0A2B8701X4995O8O8R7F83,"Afghan officials and eyewitnesses say a suicide car bomber and militants  disguised as women were involved in the deadly assault, which also  wounded 17 people, mostly children.",21,33,eyewitnesses,5,8,13
3ZUE82NE0A2B8701X4995O8O8R7F83,"Afghan officials and eyewitnesses say a suicide car bomber and militants  disguised as women were involved in the deadly assault, which also  wounded 17 people, mostly children.",40,47,suicide,2,1,3
3ZUE82NE0A2B8701X4995O8O8R7F83,"Afghan officials and eyewitnesses say a suicide car bomber and militants  disguised as women were involved in the deadly assault, which also  wounded 17 people, mostly children.",40,58,suicide car bomber,2,0,2
3ZUE82NE0A2B8701X4995O8O8R7F83,"Afghan officials and eyewitnesses say a suicide car bomber and militants  disguised as women were involved in the deadly assault, which also  wounded 17 people, mostly children.",63,72,militants,7,2,9
3ZUE82NE0A2B8701X4995O8O8R7F83,"Afghan officials and eyewitnesses say a suicide car bomber and militants  disguised as women were involved in the deadly assault, which also  wounded 17 people, mostly children.",74,83,disguised,3,9,12
3ZUE82NE0A2B8701X4995O8O8R7F83,"Afghan officials and eyewitnesses say a suicide car bomber and militants  disguised as women were involved in the deadly assault, which also  wounded 17 people, mostly children.",114,128,deadly assault,1,4,5
3ZUE82NE0A2B8701X4995O8O8R7F83,"Afghan officials and eyewitnesses say a suicide car bomber and militants  disguised as women were involved in the deadly assault, which also  wounded 17 people, mostly children.",121,128,assault,4,2,6
3ZUE82NE0A2B8701X4995O8O8R7F83,"Afghan officials and eyewitnesses say a suicide car bomber and militants  disguised as women were involved in the deadly assault, which also  wounded 17 people, mostly children.",142,149,wounded,0,1,1
3ZUE82NE0A2B8701X4995O8O8R7F83,  Afghan security forces swarmed the  area and regained control after hours of gunfire.,9,24,security forces,1,0,1
3ZUE82NE0A2B8701X4995O8O8R7F83,  Afghan security forces swarmed the  area and regained control after hours of gunfire.,25,32,swarmed,8,10,18
3ZUE82NE0A2B8701X4995O8O8R7F83,  Afghan security forces swarmed the  area and regained control after hours of gunfire.,47,55,regained,1,3,4
3ZUE82NE0A2B8701X4995O8O8R7F83,  Afghan security forces swarmed the  area and regained control after hours of gunfire.,47,63,regained control,0,1,1
3ZUE82NE0A2B8701X4995O8O8R7F83,"NATO spokesman General Carsten Jacobson called the bombing ""another   desperate attack"" that resulted in the deaths of innocent Afghan   civilians.",5,14,spokesman,0,1,1
3ZUE82NE0A2B8701X4995O8O8R7F83,"NATO spokesman General Carsten Jacobson called the bombing ""another   desperate attack"" that resulted in the deaths of innocent Afghan   civilians.",70,79,desperate,6,4,10
3ZUE82NE0A2B8701X4995O8O8R7F83,"NATO spokesman General Carsten Jacobson called the bombing ""another   desperate attack"" that resulted in the deaths of innocent Afghan   civilians.",70,86,desperate attack,0,1,1
3ZUE82NE0A2B8701X4995O8O8R7F83,"NATO spokesman General Carsten Jacobson called the bombing ""another   desperate attack"" that resulted in the deaths of innocent Afghan   civilians.",119,127,innocent,2,2,4
3ZUE82NE0A2B8701X4995O8O8R7F83,"NATO spokesman General Carsten Jacobson called the bombing ""another   desperate attack"" that resulted in the deaths of innocent Afghan   civilians.",137,146,civilians,1,0,1
3ZUE82NE0A2B8701X4995O8O8R7F83,"  He credited the Afghan security forces for quickly   responding and said there was no failure in intelligence leading up to   the incident.Meanwhile, NATO officials said a bomb attack killed two service members in the eastern part of the country.Last month, militants staged one of the largest coordinated assaults in Kabul, which paralyzed the city's center and diplomatic area for nearly 18 hours.",5,13,credited,2,2,4
3ZUE82NE0A2B8701X4995O8O8R7F83,"  He credited the Afghan security forces for quickly   responding and said there was no failure in intelligence leading up to   the incident.Meanwhile, NATO officials said a bomb attack killed two service members in the eastern part of the country.Last month, militants staged one of the largest coordinated assaults in Kabul, which paralyzed the city's center and diplomatic area for nearly 18 hours.",55,65,responding,0,1,1
3ZUE82NE0A2B8701X4995O8O8R7F83,"  He credited the Afghan security forces for quickly   responding and said there was no failure in intelligence leading up to   the incident.Meanwhile, NATO officials said a bomb attack killed two service members in the eastern part of the country.Last month, militants staged one of the largest coordinated assaults in Kabul, which paralyzed the city's center and diplomatic area for nearly 18 hours.",88,95,failure,0,1,1
3ZUE82NE0A2B8701X4995O8O8R7F83,"  He credited the Afghan security forces for quickly   responding and said there was no failure in intelligence leading up to   the incident.Meanwhile, NATO officials said a bomb attack killed two service members in the eastern part of the country.Last month, militants staged one of the largest coordinated assaults in Kabul, which paralyzed the city's center and diplomatic area for nearly 18 hours.",88,111,failure in intelligence,1,0,1
3ZUE82NE0A2B8701X4995O8O8R7F83,"  He credited the Afghan security forces for quickly   responding and said there was no failure in intelligence leading up to   the incident.Meanwhile, NATO officials said a bomb attack killed two service members in the eastern part of the country.Last month, militants staged one of the largest coordinated assaults in Kabul, which paralyzed the city's center and diplomatic area for nearly 18 hours.",99,111,intelligence,4,1,5
3ZUE82NE0A2B8701X4995O8O8R7F83,"  He credited the Afghan security forces for quickly   responding and said there was no failure in intelligence leading up to   the incident.Meanwhile, NATO officials said a bomb attack killed two service members in the eastern part of the country.Last month, militants staged one of the largest coordinated assaults in Kabul, which paralyzed the city's center and diplomatic area for nearly 18 hours.",112,119,leading,0,1,1
3ZUE82NE0A2B8701X4995O8O8R7F83,"  He credited the Afghan security forces for quickly   responding and said there was no failure in intelligence leading up to   the incident.Meanwhile, NATO officials said a bomb attack killed two service members in the eastern part of the country.Last month, militants staged one of the largest coordinated assaults in Kabul, which paralyzed the city's center and diplomatic area for nearly 18 hours.",260,269,militants,4,1,5
3ZUE82NE0A2B8701X4995O8O8R7F83,"  He credited the Afghan security forces for quickly   responding and said there was no failure in intelligence leading up to   the incident.Meanwhile, NATO officials said a bomb attack killed two service members in the eastern part of the country.Last month, militants staged one of the largest coordinated assaults in Kabul, which paralyzed the city's center and diplomatic area for nearly 18 hours.",270,276,staged,1,3,4
3ZUE82NE0A2B8701X4995O8O8R7F83,"  He credited the Afghan security forces for quickly   responding and said there was no failure in intelligence leading up to   the incident.Meanwhile, NATO officials said a bomb attack killed two service members in the eastern part of the country.Last month, militants staged one of the largest coordinated assaults in Kabul, which paralyzed the city's center and diplomatic area for nearly 18 hours.",296,307,coordinated,5,4,9
3ZUE82NE0A2B8701X4995O8O8R7F83,"  He credited the Afghan security forces for quickly   responding and said there was no failure in intelligence leading up to   the incident.Meanwhile, NATO officials said a bomb attack killed two service members in the eastern part of the country.Last month, militants staged one of the largest coordinated assaults in Kabul, which paralyzed the city's center and diplomatic area for nearly 18 hours.",296,316,coordinated assaults,4,2,6
3ZUE82NE0A2B8701X4995O8O8R7F83,"  He credited the Afghan security forces for quickly   responding and said there was no failure in intelligence leading up to   the incident.Meanwhile, NATO officials said a bomb attack killed two service members in the eastern part of the country.Last month, militants staged one of the largest coordinated assaults in Kabul, which paralyzed the city's center and diplomatic area for nearly 18 hours.",308,316,assaults,0,1,1
3ZUE82NE0A2B8701X4995O8O8R7F83,"  He credited the Afghan security forces for quickly   responding and said there was no failure in intelligence leading up to   the incident.Meanwhile, NATO officials said a bomb attack killed two service members in the eastern part of the country.Last month, militants staged one of the largest coordinated assaults in Kabul, which paralyzed the city's center and diplomatic area for nearly 18 hours.",333,342,paralyzed,10,10,20
3ZUE82NE0A2B8701X4995O8O8R7F83,"  He credited the Afghan security forces for quickly   responding and said there was no failure in intelligence leading up to   the incident.Meanwhile, NATO officials said a bomb attack killed two service members in the eastern part of the country.Last month, militants staged one of the largest coordinated assaults in Kabul, which paralyzed the city's center and diplomatic area for nearly 18 hours.",365,375,diplomatic,3,0,3
3ZUE82NE0A2B8701X4995O8O8R7F83,"  He credited the Afghan security forces for quickly   responding and said there was no failure in intelligence leading up to   the incident.Meanwhile, NATO officials said a bomb attack killed two service members in the eastern part of the country.Last month, militants staged one of the largest coordinated assaults in Kabul, which paralyzed the city's center and diplomatic area for nearly 18 hours.",365,380,diplomatic area,2,1,3
3UV0D2KX1MKAP6DZL1JWOCSJ65BF4W,"Yet here, in the pre-dawn darkness of Afghanistan, we can see the light of a new day on the horizon, said Obama, seeking a second White House term later this year.",18,26,pre-dawn,7,9,16
3UV0D2KX1MKAP6DZL1JWOCSJ65BF4W,"Yet here, in the pre-dawn darkness of Afghanistan, we can see the light of a new day on the horizon, said Obama, seeking a second White House term later this year.",18,35,pre-dawn darkness,3,2,5
3UV0D2KX1MKAP6DZL1JWOCSJ65BF4W,"Yet here, in the pre-dawn darkness of Afghanistan, we can see the light of a new day on the horizon, said Obama, seeking a second White House term later this year.",59,100,see the light of a new day on the horizon,1,0,1
3UV0D2KX1MKAP6DZL1JWOCSJ65BF4W,"Yet here, in the pre-dawn darkness of Afghanistan, we can see the light of a new day on the horizon, said Obama, seeking a second White House term later this year.",93,100,horizon,4,2,6
3UV0D2KX1MKAP6DZL1JWOCSJ65BF4W,"Yet here, in the pre-dawn darkness of Afghanistan, we can see the light of a new day on the horizon, said Obama, seeking a second White House term later this year.",115,122,seeking,0,1,1
3UV0D2KX1MKAP6DZL1JWOCSJ65BF4W,"Obama flew into Kabul in secret in the dead of night and signed the deal with President Hamid Karzai, cementing 10 years of US aid for Afghanistan after NATO combat troops leave in 2014.",6,10,flew,0,2,2
3UV0D2KX1MKAP6DZL1JWOCSJ65BF4W,"Obama flew into Kabul in secret in the dead of night and signed the deal with President Hamid Karzai, cementing 10 years of US aid for Afghanistan after NATO combat troops leave in 2014.",25,31,secret,0,1,1
3UV0D2KX1MKAP6DZL1JWOCSJ65BF4W,"Obama flew into Kabul in secret in the dead of night and signed the deal with President Hamid Karzai, cementing 10 years of US aid for Afghanistan after NATO combat troops leave in 2014.",39,52,dead of night,6,2,8
3UV0D2KX1MKAP6DZL1JWOCSJ65BF4W,"Obama flew into Kabul in secret in the dead of night and signed the deal with President Hamid Karzai, cementing 10 years of US aid for Afghanistan after NATO combat troops leave in 2014.",102,111,cementing,6,6,12
3UV0D2KX1MKAP6DZL1JWOCSJ65BF4W,"Obama flew into Kabul in secret in the dead of night and signed the deal with President Hamid Karzai, cementing 10 years of US aid for Afghanistan after NATO combat troops leave in 2014.",153,171,NATO combat troops,1,0,1
3UV0D2KX1MKAP6DZL1JWOCSJ65BF4W,"Obama flew into Kabul in secret in the dead of night and signed the deal with President Hamid Karzai, cementing 10 years of US aid for Afghanistan after NATO combat troops leave in 2014.",158,164,combat,1,2,3
3UV0D2KX1MKAP6DZL1JWOCSJ65BF4W,Most Afghans were asleep and he left after about six hours.,18,24,asleep,0,3,3
3UV0D2KX1MKAP6DZL1JWOCSJ65BF4W,"We look forward to a future of peace.	22	28	future	1	0	1
3UV0D2KX1MKAP6DZL1JWOCSJ65BF4W	We look forward to a future of peace.",22,37,future of peace,0,1,1
3UV0D2KX1MKAP6DZL1JWOCSJ65BF4W,"We're agreeing to be long-term partners,"" Obama said at Karzai's palace.",6,14,agreeing,0,1,1
3UV0D2KX1MKAP6DZL1JWOCSJ65BF4W,"We're agreeing to be long-term partners,"" Obama said at Karzai's palace.",21,30,long-term,2,0,2
3UV0D2KX1MKAP6DZL1JWOCSJ65BF4W,"We're agreeing to be long-term partners,"" Obama said at Karzai's palace.",21,39,long-term partners,1,0,1
3UV0D2KX1MKAP6DZL1JWOCSJ65BF4W,"We're agreeing to be long-term partners,"" Obama said at Karzai's palace.",56,63,Karzais,1,0,1
3UV0D2KX1MKAP6DZL1JWOCSJ65BF4W,The Taliban said Karzai had no right to sign the deal and accused him of selling Afghan sovereignty to the Americans.,17,23,Karzai,1,0,1
3UV0D2KX1MKAP6DZL1JWOCSJ65BF4W,The Taliban said Karzai had no right to sign the deal and accused him of selling Afghan sovereignty to the Americans.,58,65,accused,1,5,6
3UV0D2KX1MKAP6DZL1JWOCSJ65BF4W,The Taliban said Karzai had no right to sign the deal and accused him of selling Afghan sovereignty to the Americans.,73,99,selling Afghan sovereignty,1,0,1
3UV0D2KX1MKAP6DZL1JWOCSJ65BF4W,The Taliban said Karzai had no right to sign the deal and accused him of selling Afghan sovereignty to the Americans.,81,99,Afghan sovereignty,1,0,1
3UV0D2KX1MKAP6DZL1JWOCSJ65BF4W,The Taliban said Karzai had no right to sign the deal and accused him of selling Afghan sovereignty to the Americans.,88,99,sovereignty,10,10,20
3UV0D2KX1MKAP6DZL1JWOCSJ65BF4W,"The militants vowed to continue their armed struggle ""against all the contents of this illegitimate document until the full withdrawal of all invading forces and their puppets"" -- referring to the Karzai government.",4,13,militants,3,2,5
3UV0D2KX1MKAP6DZL1JWOCSJ65BF4W,"The militants vowed to continue their armed struggle ""against all the contents of this illegitimate document until the full withdrawal of all invading forces and their puppets"" -- referring to the Karzai government.",4,19,militants vowed,0,1,1
3UV0D2KX1MKAP6DZL1JWOCSJ65BF4W,"The militants vowed to continue their armed struggle ""against all the contents of this illegitimate document until the full withdrawal of all invading forces and their puppets"" -- referring to the Karzai government.",14,19,vowed,2,5,7
3UV0D2KX1MKAP6DZL1JWOCSJ65BF4W,"The militants vowed to continue their armed struggle ""against all the contents of this illegitimate document until the full withdrawal of all invading forces and their puppets"" -- referring to the Karzai government.",14,31,vowed to continue,0,1,1
3UV0D2KX1MKAP6DZL1JWOCSJ65BF4W,"The militants vowed to continue their armed struggle ""against all the contents of this illegitimate document until the full withdrawal of all invading forces and their puppets"" -- referring to the Karzai government.",38,52,armed struggle,4,1,5
3UV0D2KX1MKAP6DZL1JWOCSJ65BF4W,"The militants vowed to continue their armed struggle ""against all the contents of this illegitimate document until the full withdrawal of all invading forces and their puppets"" -- referring to the Karzai government.",44,52,struggle,0,2,2
3UV0D2KX1MKAP6DZL1JWOCSJ65BF4W,"The militants vowed to continue their armed struggle ""against all the contents of this illegitimate document until the full withdrawal of all invading forces and their puppets"" -- referring to the Karzai government.",70,78,contents,1,0,1
3UV0D2KX1MKAP6DZL1JWOCSJ65BF4W,"The militants vowed to continue their armed struggle ""against all the contents of this illegitimate document until the full withdrawal of all invading forces and their puppets"" -- referring to the Karzai government.",70,108,contents of this illegitimate document,1,0,1
3UV0D2KX1MKAP6DZL1JWOCSJ65BF4W,"The militants vowed to continue their armed struggle ""against all the contents of this illegitimate document until the full withdrawal of all invading forces and their puppets"" -- referring to the Karzai government.",87,99,illegitimate,8,9,17
3UV0D2KX1MKAP6DZL1JWOCSJ65BF4W,"The militants vowed to continue their armed struggle ""against all the contents of this illegitimate document until the full withdrawal of all invading forces and their puppets"" -- referring to the Karzai government.",87,108,illegitimate document,3,0,3
3UV0D2KX1MKAP6DZL1JWOCSJ65BF4W,"The militants vowed to continue their armed struggle ""against all the contents of this illegitimate document until the full withdrawal of all invading forces and their puppets"" -- referring to the Karzai government.",124,134,withdrawal,0,3,3
3UV0D2KX1MKAP6DZL1JWOCSJ65BF4W,"The militants vowed to continue their armed struggle ""against all the contents of this illegitimate document until the full withdrawal of all invading forces and their puppets"" -- referring to the Karzai government.",142,150,invading,2,5,7
3UV0D2KX1MKAP6DZL1JWOCSJ65BF4W,"The militants vowed to continue their armed struggle ""against all the contents of this illegitimate document until the full withdrawal of all invading forces and their puppets"" -- referring to the Karzai government.",142,157,invading forces,2,1,3
3UV0D2KX1MKAP6DZL1JWOCSJ65BF4W,"The militants vowed to continue their armed struggle ""against all the contents of this illegitimate document until the full withdrawal of all invading forces and their puppets"" -- referring to the Karzai government.",142,175,invading forces and their puppets,2,0,2
3UV0D2KX1MKAP6DZL1JWOCSJ65BF4W,"The militants vowed to continue their armed struggle ""against all the contents of this illegitimate document until the full withdrawal of all invading forces and their puppets"" -- referring to the Karzai government.",168,175,puppets,5,6,11
3UV0D2KX1MKAP6DZL1JWOCSJ65BF4W,"The militants vowed to continue their armed struggle ""against all the contents of this illegitimate document until the full withdrawal of all invading forces and their puppets"" -- referring to the Karzai government.",180,189,referring,0,1,1
3UV0D2KX1MKAP6DZL1JWOCSJ65BF4W,"The militants vowed to continue their armed struggle ""against all the contents of this illegitimate document until the full withdrawal of all invading forces and their puppets"" -- referring to the Karzai government.",197,203,Karzai,1,0,1
3UV0D2KX1MKAP6DZL1JWOCSJ65BF4W,"The militants vowed to continue their armed struggle ""against all the contents of this illegitimate document until the full withdrawal of all invading forces and their puppets"" -- referring to the Karzai government.",204,214,government,1,0,1
3BVS8WK9Q0WEKW0Y1OZ4ZNBHWD5BIM,The EU believes the deficit will be 6.4 percent this year and will only be reduced by 0.1 percent in 2013.,20,27,deficit,10,8,18
3BVS8WK9Q0WEKW0Y1OZ4ZNBHWD5BIM,"Apart from recent government spending cuts, another reason for this is ""the necessary adjustment of bank balance sheets,"" that will further reduce their willingness to gives loans thereby restricting growth.",18,28,government,1,0,1
3BVS8WK9Q0WEKW0Y1OZ4ZNBHWD5BIM,"Apart from recent government spending cuts, another reason for this is ""the necessary adjustment of bank balance sheets,"" that will further reduce their willingness to gives loans thereby restricting growth.",29,42,spending cuts,2,1,3
3BVS8WK9Q0WEKW0Y1OZ4ZNBHWD5BIM,"Apart from recent government spending cuts, another reason for this is ""the necessary adjustment of bank balance sheets,"" that will further reduce their willingness to gives loans thereby restricting growth.",72,119,the necessary adjustment of bank balance sheets,1,0,1
3BVS8WK9Q0WEKW0Y1OZ4ZNBHWD5BIM,"Apart from recent government spending cuts, another reason for this is ""the necessary adjustment of bank balance sheets,"" that will further reduce their willingness to gives loans thereby restricting growth.",76,96,necessary adjustment,1,2,3
3BVS8WK9Q0WEKW0Y1OZ4ZNBHWD5BIM,"Apart from recent government spending cuts, another reason for this is ""the necessary adjustment of bank balance sheets,"" that will further reduce their willingness to gives loans thereby restricting growth.",86,96,adjustment,2,1,3
3BVS8WK9Q0WEKW0Y1OZ4ZNBHWD5BIM,"Apart from recent government spending cuts, another reason for this is ""the necessary adjustment of bank balance sheets,"" that will further reduce their willingness to gives loans thereby restricting growth.",86,119,adjustment of bank balance sheets,1,0,1
3BVS8WK9Q0WEKW0Y1OZ4ZNBHWD5BIM,"Apart from recent government spending cuts, another reason for this is ""the necessary adjustment of bank balance sheets,"" that will further reduce their willingness to gives loans thereby restricting growth.",100,119,bank balance sheets,2,0,2
3BVS8WK9Q0WEKW0Y1OZ4ZNBHWD5BIM,"Apart from recent government spending cuts, another reason for this is ""the necessary adjustment of bank balance sheets,"" that will further reduce their willingness to gives loans thereby restricting growth.",105,119,balance sheets,0,1,1
3BVS8WK9Q0WEKW0Y1OZ4ZNBHWD5BIM,"Apart from recent government spending cuts, another reason for this is ""the necessary adjustment of bank balance sheets,"" that will further reduce their willingness to gives loans thereby restricting growth.",153,164,willingness,2,7,9
3BVS8WK9Q0WEKW0Y1OZ4ZNBHWD5BIM,"Apart from recent government spending cuts, another reason for this is ""the necessary adjustment of bank balance sheets,"" that will further reduce their willingness to gives loans thereby restricting growth.",180,187,thereby,0,1,1
3BVS8WK9Q0WEKW0Y1OZ4ZNBHWD5BIM,"Apart from recent government spending cuts, another reason for this is ""the necessary adjustment of bank balance sheets,"" that will further reduce their willingness to gives loans thereby restricting growth.",188,199,restricting,6,4,10
3BVS8WK9Q0WEKW0Y1OZ4ZNBHWD5BIM,"The EU expects the Spanish economy to contract by 1.8 percent this year, extending the recession till 2013 when the economy will shrink by a further 0.3 percent.",27,46,economy to contract,1,0,1
3BVS8WK9Q0WEKW0Y1OZ4ZNBHWD5BIM,"The EU expects the Spanish economy to contract by 1.8 percent this year, extending the recession till 2013 when the economy will shrink by a further 0.3 percent.",38,46,contract,2,0,2
3BVS8WK9Q0WEKW0Y1OZ4ZNBHWD5BIM,"The EU expects the Spanish economy to contract by 1.8 percent this year, extending the recession till 2013 when the economy will shrink by a further 0.3 percent.",73,82,extending,0,1,1
3BVS8WK9Q0WEKW0Y1OZ4ZNBHWD5BIM,"The EU expects the Spanish economy to contract by 1.8 percent this year, extending the recession till 2013 when the economy will shrink by a further 0.3 percent.",87,96,recession,10,5,15
3BVS8WK9Q0WEKW0Y1OZ4ZNBHWD5BIM,"The EU expects the Spanish economy to contract by 1.8 percent this year, extending the recession till 2013 when the economy will shrink by a further 0.3 percent.",116,123,economy,1,0,1
3BVS8WK9Q0WEKW0Y1OZ4ZNBHWD5BIM,"The EU expects the Spanish economy to contract by 1.8 percent this year, extending the recession till 2013 when the economy will shrink by a further 0.3 percent.",129,135,shrink,0,6,6
3BVS8WK9Q0WEKW0Y1OZ4ZNBHWD5BIM,"Shortly after arriving, about midnight local time, Mr. Obama and Karzai inked a pact to designate Afghanistan a major non-NATO ally.",65,71,Karzai,1,0,1
3BVS8WK9Q0WEKW0Y1OZ4ZNBHWD5BIM,"Shortly after arriving, about midnight local time, Mr. Obama and Karzai inked a pact to designate Afghanistan a major non-NATO ally.",72,77,inked,1,3,4
3BVS8WK9Q0WEKW0Y1OZ4ZNBHWD5BIM,"Shortly after arriving, about midnight local time, Mr. Obama and Karzai inked a pact to designate Afghanistan a major non-NATO ally.",72,84,inked a pact,3,1,4
3BVS8WK9Q0WEKW0Y1OZ4ZNBHWD5BIM,"Shortly after arriving, about midnight local time, Mr. Obama and Karzai inked a pact to designate Afghanistan a major non-NATO ally.",80,84,pact,3,2,5
3BVS8WK9Q0WEKW0Y1OZ4ZNBHWD5BIM,"Shortly after arriving, about midnight local time, Mr. Obama and Karzai inked a pact to designate Afghanistan a major non-NATO ally.",88,97,designate,10,4,14
3BVS8WK9Q0WEKW0Y1OZ4ZNBHWD5BIM,"Shortly after arriving, about midnight local time, Mr. Obama and Karzai inked a pact to designate Afghanistan a major non-NATO ally.",118,126,non-NATO,3,0,3
3BVS8WK9Q0WEKW0Y1OZ4ZNBHWD5BIM,"Shortly after arriving, about midnight local time, Mr. Obama and Karzai inked a pact to designate Afghanistan a major non-NATO ally.",118,131,non-NATO ally,2,1,3
3BVS8WK9Q0WEKW0Y1OZ4ZNBHWD5BIM,"Shortly after arriving, about midnight local time, Mr. Obama and Karzai inked a pact to designate Afghanistan a major non-NATO ally.",127,131,ally,1,2,3
3BVS8WK9Q0WEKW0Y1OZ4ZNBHWD5BIM,"The agreement says the U.S. will provide aid, advisers and support after NATO combat troops leave in 2014.",41,44,aid,0,1,1
3BVS8WK9Q0WEKW0Y1OZ4ZNBHWD5BIM,"The agreement says the U.S. will provide aid, advisers and support after NATO combat troops leave in 2014.",46,54,advisers,2,0,2
3BVS8WK9Q0WEKW0Y1OZ4ZNBHWD5BIM,"The agreement says the U.S. will provide aid, advisers and support after NATO combat troops leave in 2014.",73,91,NATO combat troops,0,1,1
3BVS8WK9Q0WEKW0Y1OZ4ZNBHWD5BIM,"The agreement says the U.S. will provide aid, advisers and support after NATO combat troops leave in 2014.",78,84,combat,2,0,2
3BVS8WK9Q0WEKW0Y1OZ4ZNBHWD5BIM,"The agreement says the U.S. will provide aid, advisers and support after NATO combat troops leave in 2014.",78,91,combat troops,0,1,1
3BVS8WK9Q0WEKW0Y1OZ4ZNBHWD5BIM,"Obama, Karzai ink partnership deal The visit comes on both the one-year anniversary of the death of Osama bin Laden and the day a new report from the Pentagon giving the war in Afghanistan a mixed review was released.",0,34,"Obama, Karzai ink partnership deal",1,0,1
3BVS8WK9Q0WEKW0Y1OZ4ZNBHWD5BIM,"Obama, Karzai ink partnership deal The visit comes on both the one-year anniversary of the death of Osama bin Laden and the day a new report from the Pentagon giving the war in Afghanistan a mixed review was released.",7,13,Karzai,1,0,1
3BVS8WK9Q0WEKW0Y1OZ4ZNBHWD5BIM,"Obama, Karzai ink partnership deal The visit comes on both the one-year anniversary of the death of Osama bin Laden and the day a new report from the Pentagon giving the war in Afghanistan a mixed review was released.",14,17,ink,1,2,3
3BVS8WK9Q0WEKW0Y1OZ4ZNBHWD5BIM,"Obama, Karzai ink partnership deal The visit comes on both the one-year anniversary of the death of Osama bin Laden and the day a new report from the Pentagon giving the war in Afghanistan a mixed review was released.",14,34,ink partnership deal,1,1,2
3BVS8WK9Q0WEKW0Y1OZ4ZNBHWD5BIM,"Obama, Karzai ink partnership deal The visit comes on both the one-year anniversary of the death of Osama bin Laden and the day a new report from the Pentagon giving the war in Afghanistan a mixed review was released.",18,34,partnership deal,1,0,1
3BVS8WK9Q0WEKW0Y1OZ4ZNBHWD5BIM,"Obama, Karzai ink partnership deal The visit comes on both the one-year anniversary of the death of Osama bin Laden and the day a new report from the Pentagon giving the war in Afghanistan a mixed review was released.",72,83,anniversary,0,2,2
3BVS8WK9Q0WEKW0Y1OZ4ZNBHWD5BIM,"Obama, Karzai ink partnership deal The visit comes on both the one-year anniversary of the death of Osama bin Laden and the day a new report from the Pentagon giving the war in Afghanistan a mixed review was released.",150,158,Pentagon,2,1,3
3BVS8WK9Q0WEKW0Y1OZ4ZNBHWD5BIM,"Obama, Karzai ink partnership deal The visit comes on both the one-year anniversary of the death of Osama bin Laden and the day a new report from the Pentagon giving the war in Afghanistan a mixed review was released.",191,203,mixed review,1,1,2
3BVS8WK9Q0WEKW0Y1OZ4ZNBHWD5BIM,"Obama, Karzai ink partnership deal The visit comes on both the one-year anniversary of the death of Osama bin Laden and the day a new report from the Pentagon giving the war in Afghanistan a mixed review was released.",197,203,review,0,3,3
3BVS8WK9Q0WEKW0Y1OZ4ZNBHWD5BIM,"Obama, Karzai ink partnership deal The visit comes on both the one-year anniversary of the death of Osama bin Laden and the day a new report from the Pentagon giving the war in Afghanistan a mixed review was released.",208,216,released,0,1,1
33CLA8O0MICHQCFXWDF9W53TZKJFR6,"More shots were heard inside the house as a SWAT team arrived and entered through a back entrance, he said.",16,21,heard,0,1,1
33CLA8O0MICHQCFXWDF9W53TZKJFR6,"More shots were heard inside the house as a SWAT team arrived and entered through a back entrance, he said.",44,48,SWAT,3,1,4
33CLA8O0MICHQCFXWDF9W53TZKJFR6,"More shots were heard inside the house as a SWAT team arrived and entered through a back entrance, he said.",44,53,SWAT team,3,2,5
33CLA8O0MICHQCFXWDF9W53TZKJFR6,"More shots were heard inside the house as a SWAT team arrived and entered through a back entrance, he said.",66,73,entered,0,1,1
33CLA8O0MICHQCFXWDF9W53TZKJFR6,"More shots were heard inside the house as a SWAT team arrived and entered through a back entrance, he said.",84,97,back entrance,1,2,3
33CLA8O0MICHQCFXWDF9W53TZKJFR6,"More shots were heard inside the house as a SWAT team arrived and entered through a back entrance, he said.",89,97,entrance,1,2,3
33CLA8O0MICHQCFXWDF9W53TZKJFR6,"A neighbor told police that three of the children had banged on his door shortly before 5 a.m., Goodyear said.",2,10,neighbor,0,1,1
33CLA8O0MICHQCFXWDF9W53TZKJFR6,"A neighbor told police that three of the children had banged on his door shortly before 5 a.m., Goodyear said.",54,60,banged,3,9,12
33CLA8O0MICHQCFXWDF9W53TZKJFR6,"One of them may have been shot and was bleeding, so the neighbor got a towel for the child, he said.",40,48,bleeding,0,5,5
33CLA8O0MICHQCFXWDF9W53TZKJFR6,"One of them may have been shot and was bleeding, so the neighbor got a towel for the child, he said.",57,65,neighbor,0,2,2
33CLA8O0MICHQCFXWDF9W53TZKJFR6,"One of them may have been shot and was bleeding, so the neighbor got a towel for the child, he said.",72,77,towel,0,1,1
33CLA8O0MICHQCFXWDF9W53TZKJFR6,"Tonya Thomas then appeared at the neighbor's door and ordered the children to return home, he said, adding: ""They did.",18,26,appeared,4,2,6
33CLA8O0MICHQCFXWDF9W53TZKJFR6,"It was the worst multiple homicide Goodyear could recall in Brevard County since a shooting in 1987 claimed six lives, including those of two police officers.",11,16,worst,0,2,2
33CLA8O0MICHQCFXWDF9W53TZKJFR6,"It was the worst multiple homicide Goodyear could recall in Brevard County since a shooting in 1987 claimed six lives, including those of two police officers.",11,34,worst multiple homicide,0,1,1
33CLA8O0MICHQCFXWDF9W53TZKJFR6,"It was the worst multiple homicide Goodyear could recall in Brevard County since a shooting in 1987 claimed six lives, including those of two police officers.",17,34,multiple homicide,5,3,8
33CLA8O0MICHQCFXWDF9W53TZKJFR6,"It was the worst multiple homicide Goodyear could recall in Brevard County since a shooting in 1987 claimed six lives, including those of two police officers.",26,34,homicide,8,9,17
33CLA8O0MICHQCFXWDF9W53TZKJFR6,"It was the worst multiple homicide Goodyear could recall in Brevard County since a shooting in 1987 claimed six lives, including those of two police officers.",50,56,recall,1,1,2
33CLA8O0MICHQCFXWDF9W53TZKJFR6,"It was the worst multiple homicide Goodyear could recall in Brevard County since a shooting in 1987 claimed six lives, including those of two police officers.",100,107,claimed,2,2,4
33CLA8O0MICHQCFXWDF9W53TZKJFR6,"It was the worst multiple homicide Goodyear could recall in Brevard County since a shooting in 1987 claimed six lives, including those of two police officers.",119,128,including,0,1,1
33CLA8O0MICHQCFXWDF9W53TZKJFR6,"Goodyear said police had been called to the house on several occasions in the past and the 15-year-old child, a boy, was arrested last month for domestic violence against his mother.",53,70,several occasions,0,1,1
33CLA8O0MICHQCFXWDF9W53TZKJFR6,"Goodyear said police had been called to the house on several occasions in the past and the 15-year-old child, a boy, was arrested last month for domestic violence against his mother.",61,70,occasions,4,2,6
33CLA8O0MICHQCFXWDF9W53TZKJFR6,"Goodyear said police had been called to the house on several occasions in the past and the 15-year-old child, a boy, was arrested last month for domestic violence against his mother.",121,129,arrested,1,2,3
33CLA8O0MICHQCFXWDF9W53TZKJFR6,"Goodyear said police had been called to the house on several occasions in the past and the 15-year-old child, a boy, was arrested last month for domestic violence against his mother.",145,153,domestic,5,1,6
33CLA8O0MICHQCFXWDF9W53TZKJFR6,"Goodyear said police had been called to the house on several occasions in the past and the 15-year-old child, a boy, was arrested last month for domestic violence against his mother.",145,162,domestic violence,6,7,13
33CLA8O0MICHQCFXWDF9W53TZKJFR6,"Goodyear said police had been called to the house on several occasions in the past and the 15-year-old child, a boy, was arrested last month for domestic violence against his mother.",154,162,violence,0,2,2
38VTL6WC4AEYLGYU4WUUIP5DDDK5YF,Others oppose Assad and accuse Damascus of heavy-handed meddling in Lebanese politics.,7,13,oppose,4,1,5
38VTL6WC4AEYLGYU4WUUIP5DDDK5YF,Others oppose Assad and accuse Damascus of heavy-handed meddling in Lebanese politics.,14,19,Assad,1,0,1
38VTL6WC4AEYLGYU4WUUIP5DDDK5YF,Others oppose Assad and accuse Damascus of heavy-handed meddling in Lebanese politics.,24,30,accuse,2,2,4
38VTL6WC4AEYLGYU4WUUIP5DDDK5YF,Others oppose Assad and accuse Damascus of heavy-handed meddling in Lebanese politics.,31,39,Damascus,1,1,2
38VTL6WC4AEYLGYU4WUUIP5DDDK5YF,Others oppose Assad and accuse Damascus of heavy-handed meddling in Lebanese politics.,43,55,heavy-handed,7,3,10
38VTL6WC4AEYLGYU4WUUIP5DDDK5YF,Others oppose Assad and accuse Damascus of heavy-handed meddling in Lebanese politics.,43,64,heavy-handed meddling,2,5,7
38VTL6WC4AEYLGYU4WUUIP5DDDK5YF,Others oppose Assad and accuse Damascus of heavy-handed meddling in Lebanese politics.,56,64,meddling,10,8,18
38VTL6WC4AEYLGYU4WUUIP5DDDK5YF,Others oppose Assad and accuse Damascus of heavy-handed meddling in Lebanese politics.,68,76,Lebanese,1,0,1
38VTL6WC4AEYLGYU4WUUIP5DDDK5YF,"The two sides are the legacy of, and backlash against, Syria's virtual rule over Lebanon from 1976 to 2005 and its continued influence since.",22,28,legacy,4,6,10
38VTL6WC4AEYLGYU4WUUIP5DDDK5YF,"The two sides are the legacy of, and backlash against, Syria's virtual rule over Lebanon from 1976 to 2005 and its continued influence since.",22,31,legacy of,0,2,2
38VTL6WC4AEYLGYU4WUUIP5DDDK5YF,"The two sides are the legacy of, and backlash against, Syria's virtual rule over Lebanon from 1976 to 2005 and its continued influence since.",37,45,backlash,7,9,16
38VTL6WC4AEYLGYU4WUUIP5DDDK5YF,"The two sides are the legacy of, and backlash against, Syria's virtual rule over Lebanon from 1976 to 2005 and its continued influence since.",37,53,backlash against,0,1,1
38VTL6WC4AEYLGYU4WUUIP5DDDK5YF,"The two sides are the legacy of, and backlash against, Syria's virtual rule over Lebanon from 1976 to 2005 and its continued influence since.",63,70,virtual,1,3,4
38VTL6WC4AEYLGYU4WUUIP5DDDK5YF,"The two sides are the legacy of, and backlash against, Syria's virtual rule over Lebanon from 1976 to 2005 and its continued influence since.",63,75,virtual rule,1,3,4
38VTL6WC4AEYLGYU4WUUIP5DDDK5YF,"The two sides are the legacy of, and backlash against, Syria's virtual rule over Lebanon from 1976 to 2005 and its continued influence since.",125,134,influence,1,1,2
38VTL6WC4AEYLGYU4WUUIP5DDDK5YF,Syria's uprising started in March 2011 with protests calling for political reform.,8,16,uprising,6,7,13
38VTL6WC4AEYLGYU4WUUIP5DDDK5YF,Syria's uprising started in March 2011 with protests calling for political reform.,65,81,political reform,3,1,4
38VTL6WC4AEYLGYU4WUUIP5DDDK5YF,Syria's uprising started in March 2011 with protests calling for political reform.,75,81,reform,2,3,5
38VTL6WC4AEYLGYU4WUUIP5DDDK5YF,"The government brutally cracked down on dissent, and many in the opposition have since taken up arms to defend themselves and attack government troops.",4,14,government,1,0,1
38VTL6WC4AEYLGYU4WUUIP5DDDK5YF,"The government brutally cracked down on dissent, and many in the opposition have since taken up arms to defend themselves and attack government troops.",4,23,government brutally,1,0,1
38VTL6WC4AEYLGYU4WUUIP5DDDK5YF,"The government brutally cracked down on dissent, and many in the opposition have since taken up arms to defend themselves and attack government troops.",15,23,brutally,1,4,5
38VTL6WC4AEYLGYU4WUUIP5DDDK5YF,"The government brutally cracked down on dissent, and many in the opposition have since taken up arms to defend themselves and attack government troops.",15,36,brutally cracked down,1,3,4
38VTL6WC4AEYLGYU4WUUIP5DDDK5YF,"The government brutally cracked down on dissent, and many in the opposition have since taken up arms to defend themselves and attack government troops.",24,31,cracked,0,3,3
38VTL6WC4AEYLGYU4WUUIP5DDDK5YF,"The government brutally cracked down on dissent, and many in the opposition have since taken up arms to defend themselves and attack government troops.",24,36,cracked down,0,1,1
38VTL6WC4AEYLGYU4WUUIP5DDDK5YF,"The government brutally cracked down on dissent, and many in the opposition have since taken up arms to defend themselves and attack government troops.",40,47,dissent,10,10,20
38VTL6WC4AEYLGYU4WUUIP5DDDK5YF,"The government brutally cracked down on dissent, and many in the opposition have since taken up arms to defend themselves and attack government troops.",65,75,opposition,4,0,4
38VTL6WC4AEYLGYU4WUUIP5DDDK5YF,"The government brutally cracked down on dissent, and many in the opposition have since taken up arms to defend themselves and attack government troops.",133,143,government,1,0,1
38VTL6WC4AEYLGYU4WUUIP5DDDK5YF,Some soldiers also have switched sides and joined forces with the rebels.,19,38,have switched sides,0,1,1
38VTL6WC4AEYLGYU4WUUIP5DDDK5YF,Some soldiers also have switched sides and joined forces with the rebels.,24,32,switched,1,2,3
38VTL6WC4AEYLGYU4WUUIP5DDDK5YF,Some soldiers also have switched sides and joined forces with the rebels.,24,38,switched sides,1,3,4
38VTL6WC4AEYLGYU4WUUIP5DDDK5YF,Some soldiers also have switched sides and joined forces with the rebels.,43,56,joined forces,1,0,1
38VTL6WC4AEYLGYU4WUUIP5DDDK5YF,Some soldiers also have switched sides and joined forces with the rebels.,66,72,rebels,1,2,3
38VTL6WC4AEYLGYU4WUUIP5DDDK5YF,"World powers have backed the peace plan, which was put forward by U.N.-Arab League envoy Kofi Annan to end the crisis, but the bloodshed has not stopped.",0,12,World powers,1,0,1
38VTL6WC4AEYLGYU4WUUIP5DDDK5YF,"World powers have backed the peace plan, which was put forward by U.N.-Arab League envoy Kofi Annan to end the crisis, but the bloodshed has not stopped.",29,39,peace plan,1,0,1
38VTL6WC4AEYLGYU4WUUIP5DDDK5YF,"World powers have backed the peace plan, which was put forward by U.N.-Arab League envoy Kofi Annan to end the crisis, but the bloodshed has not stopped.",83,88,envoy,6,6,12
38VTL6WC4AEYLGYU4WUUIP5DDDK5YF,"World powers have backed the peace plan, which was put forward by U.N.-Arab League envoy Kofi Annan to end the crisis, but the bloodshed has not stopped.",111,117,crisis,1,0,1
38VTL6WC4AEYLGYU4WUUIP5DDDK5YF,"World powers have backed the peace plan, which was put forward by U.N.-Arab League envoy Kofi Annan to end the crisis, but the bloodshed has not stopped.",127,136,bloodshed,8,5,13
38VTL6WC4AEYLGYU4WUUIP5DDDK5YF,More than 100 U.N. observers have been deployed in Syria to oversee the truce between the government and armed rebels.,19,28,observers,1,0,1
38VTL6WC4AEYLGYU4WUUIP5DDDK5YF,More than 100 U.N. observers have been deployed in Syria to oversee the truce between the government and armed rebels.,39,47,deployed,7,5,12
38VTL6WC4AEYLGYU4WUUIP5DDDK5YF,More than 100 U.N. observers have been deployed in Syria to oversee the truce between the government and armed rebels.,72,77,truce,7,6,13
38VTL6WC4AEYLGYU4WUUIP5DDDK5YF,More than 100 U.N. observers have been deployed in Syria to oversee the truce between the government and armed rebels.,90,100,government,2,0,2
38VTL6WC4AEYLGYU4WUUIP5DDDK5YF,More than 100 U.N. observers have been deployed in Syria to oversee the truce between the government and armed rebels.,105,117,armed rebels,1,0,1
31MBOZ6PAOSZK20A0RSC2N9RWF2CL2,"In the wake of the incident, Netanyahu said Israel sought to preserve the 1979 peace treaty with Egypt, but would seek to ensure that security arrangements would be revamped prior to the resumption of diplomatic activity in Cairo.",0,11,In the wake,1,1,2
31MBOZ6PAOSZK20A0RSC2N9RWF2CL2,"In the wake of the incident, Netanyahu said Israel sought to preserve the 1979 peace treaty with Egypt, but would seek to ensure that security arrangements would be revamped prior to the resumption of diplomatic activity in Cairo.",0,14,In the wake of,0,1,1
31MBOZ6PAOSZK20A0RSC2N9RWF2CL2,"In the wake of the incident, Netanyahu said Israel sought to preserve the 1979 peace treaty with Egypt, but would seek to ensure that security arrangements would be revamped prior to the resumption of diplomatic activity in Cairo.",7,11,wake,1,2,3
31MBOZ6PAOSZK20A0RSC2N9RWF2CL2,"In the wake of the incident, Netanyahu said Israel sought to preserve the 1979 peace treaty with Egypt, but would seek to ensure that security arrangements would be revamped prior to the resumption of diplomatic activity in Cairo.",7,14,wake of,0,1,1
31MBOZ6PAOSZK20A0RSC2N9RWF2CL2,"In the wake of the incident, Netanyahu said Israel sought to preserve the 1979 peace treaty with Egypt, but would seek to ensure that security arrangements would be revamped prior to the resumption of diplomatic activity in Cairo.",7,27,wake of the incident,2,0,2
31MBOZ6PAOSZK20A0RSC2N9RWF2CL2,"In the wake of the incident, Netanyahu said Israel sought to preserve the 1979 peace treaty with Egypt, but would seek to ensure that security arrangements would be revamped prior to the resumption of diplomatic activity in Cairo.",19,27,incident,3,2,5
31MBOZ6PAOSZK20A0RSC2N9RWF2CL2,"In the wake of the incident, Netanyahu said Israel sought to preserve the 1979 peace treaty with Egypt, but would seek to ensure that security arrangements would be revamped prior to the resumption of diplomatic activity in Cairo.",29,38,Netanyahu,1,1,2
31MBOZ6PAOSZK20A0RSC2N9RWF2CL2,"In the wake of the incident, Netanyahu said Israel sought to preserve the 1979 peace treaty with Egypt, but would seek to ensure that security arrangements would be revamped prior to the resumption of diplomatic activity in Cairo.",51,57,sought,5,4,9
31MBOZ6PAOSZK20A0RSC2N9RWF2CL2,"In the wake of the incident, Netanyahu said Israel sought to preserve the 1979 peace treaty with Egypt, but would seek to ensure that security arrangements would be revamped prior to the resumption of diplomatic activity in Cairo.",51,69,sought to preserve,1,1,2
31MBOZ6PAOSZK20A0RSC2N9RWF2CL2,"In the wake of the incident, Netanyahu said Israel sought to preserve the 1979 peace treaty with Egypt, but would seek to ensure that security arrangements would be revamped prior to the resumption of diplomatic activity in Cairo.",61,69,preserve,3,4,7
31MBOZ6PAOSZK20A0RSC2N9RWF2CL2,"In the wake of the incident, Netanyahu said Israel sought to preserve the 1979 peace treaty with Egypt, but would seek to ensure that security arrangements would be revamped prior to the resumption of diplomatic activity in Cairo.",79,91,peace treaty,3,2,5
31MBOZ6PAOSZK20A0RSC2N9RWF2CL2,"In the wake of the incident, Netanyahu said Israel sought to preserve the 1979 peace treaty with Egypt, but would seek to ensure that security arrangements would be revamped prior to the resumption of diplomatic activity in Cairo.",85,91,treaty,0,3,3
31MBOZ6PAOSZK20A0RSC2N9RWF2CL2,"In the wake of the incident, Netanyahu said Israel sought to preserve the 1979 peace treaty with Egypt, but would seek to ensure that security arrangements would be revamped prior to the resumption of diplomatic activity in Cairo.",122,128,ensure,3,2,5
31MBOZ6PAOSZK20A0RSC2N9RWF2CL2,"In the wake of the incident, Netanyahu said Israel sought to preserve the 1979 peace treaty with Egypt, but would seek to ensure that security arrangements would be revamped prior to the resumption of diplomatic activity in Cairo.",134,155,security arrangements,2,2,4
31MBOZ6PAOSZK20A0RSC2N9RWF2CL2,"In the wake of the incident, Netanyahu said Israel sought to preserve the 1979 peace treaty with Egypt, but would seek to ensure that security arrangements would be revamped prior to the resumption of diplomatic activity in Cairo.",165,173,revamped,10,10,20
31MBOZ6PAOSZK20A0RSC2N9RWF2CL2,"In the wake of the incident, Netanyahu said Israel sought to preserve the 1979 peace treaty with Egypt, but would seek to ensure that security arrangements would be revamped prior to the resumption of diplomatic activity in Cairo.",165,179,revamped prior,1,0,1
31MBOZ6PAOSZK20A0RSC2N9RWF2CL2,"In the wake of the incident, Netanyahu said Israel sought to preserve the 1979 peace treaty with Egypt, but would seek to ensure that security arrangements would be revamped prior to the resumption of diplomatic activity in Cairo.",165,182,revamped prior to,1,0,1
31MBOZ6PAOSZK20A0RSC2N9RWF2CL2,"In the wake of the incident, Netanyahu said Israel sought to preserve the 1979 peace treaty with Egypt, but would seek to ensure that security arrangements would be revamped prior to the resumption of diplomatic activity in Cairo.",187,197,resumption,10,9,19
31MBOZ6PAOSZK20A0RSC2N9RWF2CL2,"In the wake of the incident, Netanyahu said Israel sought to preserve the 1979 peace treaty with Egypt, but would seek to ensure that security arrangements would be revamped prior to the resumption of diplomatic activity in Cairo.",187,220,resumption of diplomatic activity,1,0,1
31MBOZ6PAOSZK20A0RSC2N9RWF2CL2,"In the wake of the incident, Netanyahu said Israel sought to preserve the 1979 peace treaty with Egypt, but would seek to ensure that security arrangements would be revamped prior to the resumption of diplomatic activity in Cairo.",201,211,diplomatic,2,2,4
31MBOZ6PAOSZK20A0RSC2N9RWF2CL2,"In the wake of the incident, Netanyahu said Israel sought to preserve the 1979 peace treaty with Egypt, but would seek to ensure that security arrangements would be revamped prior to the resumption of diplomatic activity in Cairo.",201,220,diplomatic activity,4,3,7
31MBOZ6PAOSZK20A0RSC2N9RWF2CL2,"Ben-Dor said that Levanon's recently named successor, Ya'akov Amitai, would leave for Cairo ""as soon as proper security arrangements"" are agreed upon and implemented.",18,26,Levanons,0,1,1
31MBOZ6PAOSZK20A0RSC2N9RWF2CL2,"Ben-Dor said that Levanon's recently named successor, Ya'akov Amitai, would leave for Cairo ""as soon as proper security arrangements"" are agreed upon and implemented.",43,52,successor,7,4,11
31MBOZ6PAOSZK20A0RSC2N9RWF2CL2,"Ben-Dor said that Levanon's recently named successor, Ya'akov Amitai, would leave for Cairo ""as soon as proper security arrangements"" are agreed upon and implemented.",104,132,proper security arrangements,1,0,1
31MBOZ6PAOSZK20A0RSC2N9RWF2CL2,"Ben-Dor said that Levanon's recently named successor, Ya'akov Amitai, would leave for Cairo ""as soon as proper security arrangements"" are agreed upon and implemented.",111,132,security arrangements,2,0,2
31MBOZ6PAOSZK20A0RSC2N9RWF2CL2,"Ben-Dor said that Levanon's recently named successor, Ya'akov Amitai, would leave for Cairo ""as soon as proper security arrangements"" are agreed upon and implemented.",120,132,arrangements,1,1,2
31MBOZ6PAOSZK20A0RSC2N9RWF2CL2,"Ben-Dor said that Levanon's recently named successor, Ya'akov Amitai, would leave for Cairo ""as soon as proper security arrangements"" are agreed upon and implemented.",154,165,implemented,10,5,15
31MBOZ6PAOSZK20A0RSC2N9RWF2CL2,"Israel's internal security agency, Shin Bet, which is responsible for setting the security guidelines for all Israeli diplomatic missions around the world, will okay Amita's departure pending the willingness of Egyptian authorities to approve its request for upgraded security measures, the Ha'aretz daily reported on Sunday.",18,33,security agency,1,0,1
31MBOZ6PAOSZK20A0RSC2N9RWF2CL2,"Israel's internal security agency, Shin Bet, which is responsible for setting the security guidelines for all Israeli diplomatic missions around the world, will okay Amita's departure pending the willingness of Egyptian authorities to approve its request for upgraded security measures, the Ha'aretz daily reported on Sunday.",82,101,security guidelines,1,1,2
31MBOZ6PAOSZK20A0RSC2N9RWF2CL2,"Israel's internal security agency, Shin Bet, which is responsible for setting the security guidelines for all Israeli diplomatic missions around the world, will okay Amita's departure pending the willingness of Egyptian authorities to approve its request for upgraded security measures, the Ha'aretz daily reported on Sunday.",91,101,guidelines,0,2,2
31MBOZ6PAOSZK20A0RSC2N9RWF2CL2,"Israel's internal security agency, Shin Bet, which is responsible for setting the security guidelines for all Israeli diplomatic missions around the world, will okay Amita's departure pending the willingness of Egyptian authorities to approve its request for upgraded security measures, the Ha'aretz daily reported on Sunday.",110,137,Israeli diplomatic missions,1,0,1
31MBOZ6PAOSZK20A0RSC2N9RWF2CL2,"Israel's internal security agency, Shin Bet, which is responsible for setting the security guidelines for all Israeli diplomatic missions around the world, will okay Amita's departure pending the willingness of Egyptian authorities to approve its request for upgraded security measures, the Ha'aretz daily reported on Sunday.",118,128,diplomatic,5,0,5
31MBOZ6PAOSZK20A0RSC2N9RWF2CL2,"Israel's internal security agency, Shin Bet, which is responsible for setting the security guidelines for all Israeli diplomatic missions around the world, will okay Amita's departure pending the willingness of Egyptian authorities to approve its request for upgraded security measures, the Ha'aretz daily reported on Sunday.",118,137,diplomatic missions,2,1,3
31MBOZ6PAOSZK20A0RSC2N9RWF2CL2,"Israel's internal security agency, Shin Bet, which is responsible for setting the security guidelines for all Israeli diplomatic missions around the world, will okay Amita's departure pending the willingness of Egyptian authorities to approve its request for upgraded security measures, the Ha'aretz daily reported on Sunday.",166,172,Amitas,0,1,1
31MBOZ6PAOSZK20A0RSC2N9RWF2CL2,"Israel's internal security agency, Shin Bet, which is responsible for setting the security guidelines for all Israeli diplomatic missions around the world, will okay Amita's departure pending the willingness of Egyptian authorities to approve its request for upgraded security measures, the Ha'aretz daily reported on Sunday.",174,183,departure,1,3,4
31MBOZ6PAOSZK20A0RSC2N9RWF2CL2,"Israel's internal security agency, Shin Bet, which is responsible for setting the security guidelines for all Israeli diplomatic missions around the world, will okay Amita's departure pending the willingness of Egyptian authorities to approve its request for upgraded security measures, the Ha'aretz daily reported on Sunday.",184,191,pending,3,2,5
31MBOZ6PAOSZK20A0RSC2N9RWF2CL2,"Israel's internal security agency, Shin Bet, which is responsible for setting the security guidelines for all Israeli diplomatic missions around the world, will okay Amita's departure pending the willingness of Egyptian authorities to approve its request for upgraded security measures, the Ha'aretz daily reported on Sunday.",196,207,willingness,1,2,3
31MBOZ6PAOSZK20A0RSC2N9RWF2CL2,"Israel's internal security agency, Shin Bet, which is responsible for setting the security guidelines for all Israeli diplomatic missions around the world, will okay Amita's departure pending the willingness of Egyptian authorities to approve its request for upgraded security measures, the Ha'aretz daily reported on Sunday.",220,231,authorities,1,0,1
31MBOZ6PAOSZK20A0RSC2N9RWF2CL2,"Israel's internal security agency, Shin Bet, which is responsible for setting the security guidelines for all Israeli diplomatic missions around the world, will okay Amita's departure pending the willingness of Egyptian authorities to approve its request for upgraded security measures, the Ha'aretz daily reported on Sunday.",235,242,approve,1,0,1
31MBOZ6PAOSZK20A0RSC2N9RWF2CL2,"Israel's internal security agency, Shin Bet, which is responsible for setting the security guidelines for all Israeli diplomatic missions around the world, will okay Amita's departure pending the willingness of Egyptian authorities to approve its request for upgraded security measures, the Ha'aretz daily reported on Sunday.",259,267,upgraded,0,2,2
31MBOZ6PAOSZK20A0RSC2N9RWF2CL2,"Israel's internal security agency, Shin Bet, which is responsible for setting the security guidelines for all Israeli diplomatic missions around the world, will okay Amita's departure pending the willingness of Egyptian authorities to approve its request for upgraded security measures, the Ha'aretz daily reported on Sunday.",259,285,upgraded security measures,1,0,1
31MBOZ6PAOSZK20A0RSC2N9RWF2CL2,"Israel's internal security agency, Shin Bet, which is responsible for setting the security guidelines for all Israeli diplomatic missions around the world, will okay Amita's departure pending the willingness of Egyptian authorities to approve its request for upgraded security measures, the Ha'aretz daily reported on Sunday.",268,285,security measures,1,0,1
31MBOZ6PAOSZK20A0RSC2N9RWF2CL2,"Such measures are to include new quarters for the embassy, more guards, closed-circuit cameras and electronic surveillance measures.",50,57,embassy,1,1,2
31MBOZ6PAOSZK20A0RSC2N9RWF2CL2,"Such measures are to include new quarters for the embassy, more guards, closed-circuit cameras and electronic surveillance measures.",72,86,closed-circuit,2,3,5
31MBOZ6PAOSZK20A0RSC2N9RWF2CL2,"Such measures are to include new quarters for the embassy, more guards, closed-circuit cameras and electronic surveillance measures.",72,94,closed-circuit cameras,2,0,2
31MBOZ6PAOSZK20A0RSC2N9RWF2CL2,"Such measures are to include new quarters for the embassy, more guards, closed-circuit cameras and electronic surveillance measures.",99,122,electronic surveillance,0,2,2
31MBOZ6PAOSZK20A0RSC2N9RWF2CL2,"Such measures are to include new quarters for the embassy, more guards, closed-circuit cameras and electronic surveillance measures.",99,131,electronic surveillance measures,5,0,5
31MBOZ6PAOSZK20A0RSC2N9RWF2CL2,"Such measures are to include new quarters for the embassy, more guards, closed-circuit cameras and electronic surveillance measures.",110,122,surveillance,5,6,11
3KLL7H3EGD2TXFNK0N8J0N49059HVZ,Philippine Foreign Secretary Albert Del Rosario said he met with Chinese Ambassador Ma Keqing and both reaffirmed their governments' positions that the Scarborough Shoal where the ships are facing off was part of their own country's territory and neither was ready to stand down.,11,18,Foreign,1,0,1
3KLL7H3EGD2TXFNK0N8J0N49059HVZ,Philippine Foreign Secretary Albert Del Rosario said he met with Chinese Ambassador Ma Keqing and both reaffirmed their governments' positions that the Scarborough Shoal where the ships are facing off was part of their own country's territory and neither was ready to stand down.,11,28,Foreign Secretary,3,0,3
3KLL7H3EGD2TXFNK0N8J0N49059HVZ,Philippine Foreign Secretary Albert Del Rosario said he met with Chinese Ambassador Ma Keqing and both reaffirmed their governments' positions that the Scarborough Shoal where the ships are facing off was part of their own country's territory and neither was ready to stand down.,19,28,Secretary,1,0,1
3KLL7H3EGD2TXFNK0N8J0N49059HVZ,Philippine Foreign Secretary Albert Del Rosario said he met with Chinese Ambassador Ma Keqing and both reaffirmed their governments' positions that the Scarborough Shoal where the ships are facing off was part of their own country's territory and neither was ready to stand down.,73,83,Ambassador,3,2,5
3KLL7H3EGD2TXFNK0N8J0N49059HVZ,Philippine Foreign Secretary Albert Del Rosario said he met with Chinese Ambassador Ma Keqing and both reaffirmed their governments' positions that the Scarborough Shoal where the ships are facing off was part of their own country's territory and neither was ready to stand down.,103,113,reaffirmed,10,10,20
3KLL7H3EGD2TXFNK0N8J0N49059HVZ,Philippine Foreign Secretary Albert Del Rosario said he met with Chinese Ambassador Ma Keqing and both reaffirmed their governments' positions that the Scarborough Shoal where the ships are facing off was part of their own country's territory and neither was ready to stand down.,120,131,governments,1,0,1
3KLL7H3EGD2TXFNK0N8J0N49059HVZ,Philippine Foreign Secretary Albert Del Rosario said he met with Chinese Ambassador Ma Keqing and both reaffirmed their governments' positions that the Scarborough Shoal where the ships are facing off was part of their own country's territory and neither was ready to stand down.,120,141,governments positions,2,0,2
3KLL7H3EGD2TXFNK0N8J0N49059HVZ,Philippine Foreign Secretary Albert Del Rosario said he met with Chinese Ambassador Ma Keqing and both reaffirmed their governments' positions that the Scarborough Shoal where the ships are facing off was part of their own country's territory and neither was ready to stand down.,152,163,Scarborough,0,1,1
3KLL7H3EGD2TXFNK0N8J0N49059HVZ,Philippine Foreign Secretary Albert Del Rosario said he met with Chinese Ambassador Ma Keqing and both reaffirmed their governments' positions that the Scarborough Shoal where the ships are facing off was part of their own country's territory and neither was ready to stand down.,152,169,Scarborough Shoal,1,1,2
3KLL7H3EGD2TXFNK0N8J0N49059HVZ,Philippine Foreign Secretary Albert Del Rosario said he met with Chinese Ambassador Ma Keqing and both reaffirmed their governments' positions that the Scarborough Shoal where the ships are facing off was part of their own country's territory and neither was ready to stand down.,164,169,Shoal,0,2,2
3KLL7H3EGD2TXFNK0N8J0N49059HVZ,Philippine Foreign Secretary Albert Del Rosario said he met with Chinese Ambassador Ma Keqing and both reaffirmed their governments' positions that the Scarborough Shoal where the ships are facing off was part of their own country's territory and neither was ready to stand down.,190,200,facing off,1,3,4
3KLL7H3EGD2TXFNK0N8J0N49059HVZ,Philippine Foreign Secretary Albert Del Rosario said he met with Chinese Ambassador Ma Keqing and both reaffirmed their governments' positions that the Scarborough Shoal where the ships are facing off was part of their own country's territory and neither was ready to stand down.,233,242,territory,1,3,4
3KLL7H3EGD2TXFNK0N8J0N49059HVZ,Philippine Foreign Secretary Albert Del Rosario said he met with Chinese Ambassador Ma Keqing and both reaffirmed their governments' positions that the Scarborough Shoal where the ships are facing off was part of their own country's territory and neither was ready to stand down.,265,278,to stand down,1,0,1
3KLL7H3EGD2TXFNK0N8J0N49059HVZ,Philippine Foreign Secretary Albert Del Rosario said he met with Chinese Ambassador Ma Keqing and both reaffirmed their governments' positions that the Scarborough Shoal where the ships are facing off was part of their own country's territory and neither was ready to stand down.,268,278,stand down,1,4,5
3KLL7H3EGD2TXFNK0N8J0N49059HVZ,"Del Rosario said that despite the impasse, ""we resolved to seek a diplomatic solution to the issue.""",22,29,despite,0,4,4
3KLL7H3EGD2TXFNK0N8J0N49059HVZ,"Del Rosario said that despite the impasse, ""we resolved to seek a diplomatic solution to the issue.""",34,41,impasse,10,10,20
3KLL7H3EGD2TXFNK0N8J0N49059HVZ,"Del Rosario said that despite the impasse, ""we resolved to seek a diplomatic solution to the issue.""",47,55,resolved,0,5,5
3KLL7H3EGD2TXFNK0N8J0N49059HVZ,"Del Rosario said that despite the impasse, ""we resolved to seek a diplomatic solution to the issue.""",59,63,seek,0,1,1
3KLL7H3EGD2TXFNK0N8J0N49059HVZ,"Del Rosario said that despite the impasse, ""we resolved to seek a diplomatic solution to the issue.""",66,76,diplomatic,4,4,8
3KLL7H3EGD2TXFNK0N8J0N49059HVZ,"Del Rosario said that despite the impasse, ""we resolved to seek a diplomatic solution to the issue.""",66,85,diplomatic solution,5,1,6
3KLL7H3EGD2TXFNK0N8J0N49059HVZ,"Del Rosario said that despite the impasse, ""we resolved to seek a diplomatic solution to the issue.""",93,98,issue,1,0,1
3KLL7H3EGD2TXFNK0N8J0N49059HVZ,The Philippine government said the standoff began when its navy tried to detain Chinese boats fishing in its waters but was stopped by two Chinese surveillance craft.,15,25,government,2,0,2
3KLL7H3EGD2TXFNK0N8J0N49059HVZ,The Philippine government said the standoff began when its navy tried to detain Chinese boats fishing in its waters but was stopped by two Chinese surveillance craft.,35,43,standoff,7,8,15
3KLL7H3EGD2TXFNK0N8J0N49059HVZ,The Philippine government said the standoff began when its navy tried to detain Chinese boats fishing in its waters but was stopped by two Chinese surveillance craft.,73,79,detain,5,3,8
3KLL7H3EGD2TXFNK0N8J0N49059HVZ,The Philippine government said the standoff began when its navy tried to detain Chinese boats fishing in its waters but was stopped by two Chinese surveillance craft.,147,159,surveillance,7,6,13
3KLL7H3EGD2TXFNK0N8J0N49059HVZ,The Philippine government said the standoff began when its navy tried to detain Chinese boats fishing in its waters but was stopped by two Chinese surveillance craft.,147,165,surveillance craft,6,2,8
3KLL7H3EGD2TXFNK0N8J0N49059HVZ,The Philippine government said the standoff began when its navy tried to detain Chinese boats fishing in its waters but was stopped by two Chinese surveillance craft.,160,165,craft,0,1,1
3KLL7H3EGD2TXFNK0N8J0N49059HVZ,The Chinese Embassy accused the Philippine warship of harassing the fishermen and called for it to leave Chinese territory.,20,27,accused,1,1,2
3KLL7H3EGD2TXFNK0N8J0N49059HVZ,The Chinese Embassy accused the Philippine warship of harassing the fishermen and called for it to leave Chinese territory.,54,63,harassing,10,9,19
3KLL7H3EGD2TXFNK0N8J0N49059HVZ,The Chinese Embassy accused the Philippine warship of harassing the fishermen and called for it to leave Chinese territory.,113,122,territory,1,1,2
3KLL7H3EGD2TXFNK0N8J0N49059HVZ,"The South China Sea is home to a myriad of competing territorial claims, most notably the Spratly Islands south of the shoal, an island chain claimed by China, the Philippines, Vietnam, Brunei, Malaysia and Taiwan.",33,39,myriad,8,7,15
3KLL7H3EGD2TXFNK0N8J0N49059HVZ,"The South China Sea is home to a myriad of competing territorial claims, most notably the Spratly Islands south of the shoal, an island chain claimed by China, the Philippines, Vietnam, Brunei, Malaysia and Taiwan.",33,42,myriad of,0,1,1
3KLL7H3EGD2TXFNK0N8J0N49059HVZ,"The South China Sea is home to a myriad of competing territorial claims, most notably the Spratly Islands south of the shoal, an island chain claimed by China, the Philippines, Vietnam, Brunei, Malaysia and Taiwan.",33,71,myriad of competing territorial claims,2,0,2
3KLL7H3EGD2TXFNK0N8J0N49059HVZ,"The South China Sea is home to a myriad of competing territorial claims, most notably the Spratly Islands south of the shoal, an island chain claimed by China, the Philippines, Vietnam, Brunei, Malaysia and Taiwan.",43,52,competing,1,2,3
3KLL7H3EGD2TXFNK0N8J0N49059HVZ,"The South China Sea is home to a myriad of competing territorial claims, most notably the Spratly Islands south of the shoal, an island chain claimed by China, the Philippines, Vietnam, Brunei, Malaysia and Taiwan.",43,71,competing territorial claims,2,0,2
3KLL7H3EGD2TXFNK0N8J0N49059HVZ,"The South China Sea is home to a myriad of competing territorial claims, most notably the Spratly Islands south of the shoal, an island chain claimed by China, the Philippines, Vietnam, Brunei, Malaysia and Taiwan.",53,64,territorial,2,1,3
3KLL7H3EGD2TXFNK0N8J0N49059HVZ,"The South China Sea is home to a myriad of competing territorial claims, most notably the Spratly Islands south of the shoal, an island chain claimed by China, the Philippines, Vietnam, Brunei, Malaysia and Taiwan.",53,71,territorial claims,2,0,2
3KLL7H3EGD2TXFNK0N8J0N49059HVZ,"The South China Sea is home to a myriad of competing territorial claims, most notably the Spratly Islands south of the shoal, an island chain claimed by China, the Philippines, Vietnam, Brunei, Malaysia and Taiwan.",78,85,notably,1,0,1
3KLL7H3EGD2TXFNK0N8J0N49059HVZ,"The South China Sea is home to a myriad of competing territorial claims, most notably the Spratly Islands south of the shoal, an island chain claimed by China, the Philippines, Vietnam, Brunei, Malaysia and Taiwan.",90,97,Spratly,0,2,2
3KLL7H3EGD2TXFNK0N8J0N49059HVZ,"The South China Sea is home to a myriad of competing territorial claims, most notably the Spratly Islands south of the shoal, an island chain claimed by China, the Philippines, Vietnam, Brunei, Malaysia and Taiwan.",119,124,shoal,5,2,7
3KLL7H3EGD2TXFNK0N8J0N49059HVZ,"The South China Sea is home to a myriad of competing territorial claims, most notably the Spratly Islands south of the shoal, an island chain claimed by China, the Philippines, Vietnam, Brunei, Malaysia and Taiwan.",129,135,island,0,1,1
3KLL7H3EGD2TXFNK0N8J0N49059HVZ,"The South China Sea is home to a myriad of competing territorial claims, most notably the Spratly Islands south of the shoal, an island chain claimed by China, the Philippines, Vietnam, Brunei, Malaysia and Taiwan.",142,149,claimed,0,1,1
3N3WJQXELSRMMK883Y36QA05JBML28,De Guindos said even the slightest doubt regarding the values of accounts would make economic recovery more complicated.,25,34,slightest,4,7,11
3N3WJQXELSRMMK883Y36QA05JBML28,De Guindos said even the slightest doubt regarding the values of accounts would make economic recovery more complicated.,25,40,slightest doubt,0,2,2
3N3WJQXELSRMMK883Y36QA05JBML28,De Guindos said even the slightest doubt regarding the values of accounts would make economic recovery more complicated.,55,61,values,1,0,1
3N3WJQXELSRMMK883Y36QA05JBML28,De Guindos said even the slightest doubt regarding the values of accounts would make economic recovery more complicated.,55,73,values of accounts,1,1,2
3N3WJQXELSRMMK883Y36QA05JBML28,De Guindos said even the slightest doubt regarding the values of accounts would make economic recovery more complicated.,85,93,economic,2,0,2
3N3WJQXELSRMMK883Y36QA05JBML28,De Guindos said even the slightest doubt regarding the values of accounts would make economic recovery more complicated.,85,102,economic recovery,4,1,5
3N3WJQXELSRMMK883Y36QA05JBML28,De Guindos said even the slightest doubt regarding the values of accounts would make economic recovery more complicated.,94,102,recovery,0,2,2
3N3WJQXELSRMMK883Y36QA05JBML28,De Guindos said even the slightest doubt regarding the values of accounts would make economic recovery more complicated.,108,119,complicated,5,4,9
3N3WJQXELSRMMK883Y36QA05JBML28,"In Spain, the collapse of the housing market left the country's banks with properties that declined steeply in value over the last three years.",14,22,collapse,5,5,10
3N3WJQXELSRMMK883Y36QA05JBML28,"In Spain, the collapse of the housing market left the country's banks with properties that declined steeply in value over the last three years.",14,44,collapse of the housing market,1,0,1
3N3WJQXELSRMMK883Y36QA05JBML28,"In Spain, the collapse of the housing market left the country's banks with properties that declined steeply in value over the last three years.",30,44,housing market,2,2,4
3N3WJQXELSRMMK883Y36QA05JBML28,"In Spain, the collapse of the housing market left the country's banks with properties that declined steeply in value over the last three years.",91,99,declined,0,3,3
3N3WJQXELSRMMK883Y36QA05JBML28,"In Spain, the collapse of the housing market left the country's banks with properties that declined steeply in value over the last three years.",91,107,declined steeply,2,1,3
3N3WJQXELSRMMK883Y36QA05JBML28,"In Spain, the collapse of the housing market left the country's banks with properties that declined steeply in value over the last three years.",100,107,steeply,5,7,12
3N3WJQXELSRMMK883Y36QA05JBML28,Many individuals are also having problems in meeting their mortgage payments.,5,16,individuals,0,1,1
3N3WJQXELSRMMK883Y36QA05JBML28,Many individuals are also having problems in meeting their mortgage payments.,59,67,mortgage,7,10,17
3N3WJQXELSRMMK883Y36QA05JBML28,Many individuals are also having problems in meeting their mortgage payments.,59,76,mortgage payments,4,3,7
3N3WJQXELSRMMK883Y36QA05JBML28,"Banks will be forced to put some of their mortgages into separate companies, it was announced on Friday.",42,51,mortgages,7,3,10
3N3WJQXELSRMMK883Y36QA05JBML28,"Banks will be forced to put some of their mortgages into separate companies, it was announced on Friday.",57,65,separate,1,0,1
3N3WJQXELSRMMK883Y36QA05JBML28,"Banks will be forced to put some of their mortgages into separate companies, it was announced on Friday.",84,93,announced,1,1,2
3N3WJQXELSRMMK883Y36QA05JBML28,Spain will be liberalize regulations for property rentals in an attempt to make it easier for banks to sell their portfolios of property debt.,14,24,liberalize,10,8,18
3N3WJQXELSRMMK883Y36QA05JBML28,Spain will be liberalize regulations for property rentals in an attempt to make it easier for banks to sell their portfolios of property debt.,14,36,liberalize regulations,6,1,7
3N3WJQXELSRMMK883Y36QA05JBML28,Spain will be liberalize regulations for property rentals in an attempt to make it easier for banks to sell their portfolios of property debt.,41,57,property rentals,2,0,2
3N3WJQXELSRMMK883Y36QA05JBML28,Spain will be liberalize regulations for property rentals in an attempt to make it easier for banks to sell their portfolios of property debt.,50,57,rentals,1,1,2
3N3WJQXELSRMMK883Y36QA05JBML28,Spain will be liberalize regulations for property rentals in an attempt to make it easier for banks to sell their portfolios of property debt.,64,71,attempt,0,2,2
3N3WJQXELSRMMK883Y36QA05JBML28,Spain will be liberalize regulations for property rentals in an attempt to make it easier for banks to sell their portfolios of property debt.,114,124,portfolios,10,10,20
3N3WJQXELSRMMK883Y36QA05JBML28,Spain will be liberalize regulations for property rentals in an attempt to make it easier for banks to sell their portfolios of property debt.,114,141,portfolios of property debt,2,0,2
3N3WJQXELSRMMK883Y36QA05JBML28,Spain will be liberalize regulations for property rentals in an attempt to make it easier for banks to sell their portfolios of property debt.,128,141,property debt,2,0,2
3N3WJQXELSRMMK883Y36QA05JBML28,Spain will be liberalize regulations for property rentals in an attempt to make it easier for banks to sell their portfolios of property debt.,137,141,debt,2,0,2
3N3WJQXELSRMMK883Y36QA05JBML28,These decisions come the same day the European Commission warned that Spain will not meet its target of reducing the state deficit to 5.3 percent this year and to 3 percent in 2013.,38,57,European Commission,1,0,1
3N3WJQXELSRMMK883Y36QA05JBML28,These decisions come the same day the European Commission warned that Spain will not meet its target of reducing the state deficit to 5.3 percent this year and to 3 percent in 2013.,47,57,Commission,1,1,2
3N3WJQXELSRMMK883Y36QA05JBML28,These decisions come the same day the European Commission warned that Spain will not meet its target of reducing the state deficit to 5.3 percent this year and to 3 percent in 2013.,117,130,state deficit,3,2,5
3N3WJQXELSRMMK883Y36QA05JBML28,These decisions come the same day the European Commission warned that Spain will not meet its target of reducing the state deficit to 5.3 percent this year and to 3 percent in 2013.,123,130,deficit,6,6,12
35NNO802AVXGL5PV4E4DQIBBD2JNIN,"The Spanish government unveiled a new reform package for its troubled banks Friday in a desperate bid to convince investors that the sector is solvent and the country has a strategy to avoid the bailout fate of Greece, Ireland and Portugal.",12,22,government,1,0,1
35NNO802AVXGL5PV4E4DQIBBD2JNIN,"The Spanish government unveiled a new reform package for its troubled banks Friday in a desperate bid to convince investors that the sector is solvent and the country has a strategy to avoid the bailout fate of Greece, Ireland and Portugal.",23,31,unveiled,10,10,20
35NNO802AVXGL5PV4E4DQIBBD2JNIN,"The Spanish government unveiled a new reform package for its troubled banks Friday in a desperate bid to convince investors that the sector is solvent and the country has a strategy to avoid the bailout fate of Greece, Ireland and Portugal.",38,44,reform,3,2,5
35NNO802AVXGL5PV4E4DQIBBD2JNIN,"The Spanish government unveiled a new reform package for its troubled banks Friday in a desperate bid to convince investors that the sector is solvent and the country has a strategy to avoid the bailout fate of Greece, Ireland and Portugal.",38,52,reform package,2,0,2
35NNO802AVXGL5PV4E4DQIBBD2JNIN,"The Spanish government unveiled a new reform package for its troubled banks Friday in a desperate bid to convince investors that the sector is solvent and the country has a strategy to avoid the bailout fate of Greece, Ireland and Portugal.",61,69,troubled,0,2,2
35NNO802AVXGL5PV4E4DQIBBD2JNIN,"The Spanish government unveiled a new reform package for its troubled banks Friday in a desperate bid to convince investors that the sector is solvent and the country has a strategy to avoid the bailout fate of Greece, Ireland and Portugal.",61,75,troubled banks,0,1,1
35NNO802AVXGL5PV4E4DQIBBD2JNIN,"The Spanish government unveiled a new reform package for its troubled banks Friday in a desperate bid to convince investors that the sector is solvent and the country has a strategy to avoid the bailout fate of Greece, Ireland and Portugal.",88,97,desperate,4,3,7
35NNO802AVXGL5PV4E4DQIBBD2JNIN,"The Spanish government unveiled a new reform package for its troubled banks Friday in a desperate bid to convince investors that the sector is solvent and the country has a strategy to avoid the bailout fate of Greece, Ireland and Portugal.",88,101,desperate bid,3,0,3
35NNO802AVXGL5PV4E4DQIBBD2JNIN,"The Spanish government unveiled a new reform package for its troubled banks Friday in a desperate bid to convince investors that the sector is solvent and the country has a strategy to avoid the bailout fate of Greece, Ireland and Portugal.",98,101,bid,0,1,1
35NNO802AVXGL5PV4E4DQIBBD2JNIN,"The Spanish government unveiled a new reform package for its troubled banks Friday in a desperate bid to convince investors that the sector is solvent and the country has a strategy to avoid the bailout fate of Greece, Ireland and Portugal.",105,113,convince,1,1,2
35NNO802AVXGL5PV4E4DQIBBD2JNIN,"The Spanish government unveiled a new reform package for its troubled banks Friday in a desperate bid to convince investors that the sector is solvent and the country has a strategy to avoid the bailout fate of Greece, Ireland and Portugal.",105,123,convince investors,1,0,1
35NNO802AVXGL5PV4E4DQIBBD2JNIN,"The Spanish government unveiled a new reform package for its troubled banks Friday in a desperate bid to convince investors that the sector is solvent and the country has a strategy to avoid the bailout fate of Greece, Ireland and Portugal.",114,123,investors,2,1,3
35NNO802AVXGL5PV4E4DQIBBD2JNIN,"The Spanish government unveiled a new reform package for its troubled banks Friday in a desperate bid to convince investors that the sector is solvent and the country has a strategy to avoid the bailout fate of Greece, Ireland and Portugal.",133,139,sector,1,0,1
35NNO802AVXGL5PV4E4DQIBBD2JNIN,"The Spanish government unveiled a new reform package for its troubled banks Friday in a desperate bid to convince investors that the sector is solvent and the country has a strategy to avoid the bailout fate of Greece, Ireland and Portugal.",133,150,sector is solvent,1,0,1
35NNO802AVXGL5PV4E4DQIBBD2JNIN,"The Spanish government unveiled a new reform package for its troubled banks Friday in a desperate bid to convince investors that the sector is solvent and the country has a strategy to avoid the bailout fate of Greece, Ireland and Portugal.",143,150,solvent,9,9,18
35NNO802AVXGL5PV4E4DQIBBD2JNIN,"The Spanish government unveiled a new reform package for its troubled banks Friday in a desperate bid to convince investors that the sector is solvent and the country has a strategy to avoid the bailout fate of Greece, Ireland and Portugal.",173,181,strategy,1,4,5
35NNO802AVXGL5PV4E4DQIBBD2JNIN,"The Spanish government unveiled a new reform package for its troubled banks Friday in a desperate bid to convince investors that the sector is solvent and the country has a strategy to avoid the bailout fate of Greece, Ireland and Portugal.",195,202,bailout,8,9,17
35NNO802AVXGL5PV4E4DQIBBD2JNIN,"The Spanish government unveiled a new reform package for its troubled banks Friday in a desperate bid to convince investors that the sector is solvent and the country has a strategy to avoid the bailout fate of Greece, Ireland and Portugal.",195,207,bailout fate,3,2,5
35NNO802AVXGL5PV4E4DQIBBD2JNIN,"The Spanish government unveiled a new reform package for its troubled banks Friday in a desperate bid to convince investors that the sector is solvent and the country has a strategy to avoid the bailout fate of Greece, Ireland and Portugal.",203,207,fate,0,1,1
35NNO802AVXGL5PV4E4DQIBBD2JNIN,Economy Minister Luis de Guindos announced that banks will be forced to set aside a new €30 billion ($39 billion Cdn) financial cushion against bad loans and to separate property assets from their balance sheets.,33,42,announced,1,0,1
35NNO802AVXGL5PV4E4DQIBBD2JNIN,Economy Minister Luis de Guindos announced that banks will be forced to set aside a new €30 billion ($39 billion Cdn) financial cushion against bad loans and to separate property assets from their balance sheets.,72,81,set aside,1,1,2
35NNO802AVXGL5PV4E4DQIBBD2JNIN,Economy Minister Luis de Guindos announced that banks will be forced to set aside a new €30 billion ($39 billion Cdn) financial cushion against bad loans and to separate property assets from their balance sheets.,76,81,aside,0,1,1
35NNO802AVXGL5PV4E4DQIBBD2JNIN,Economy Minister Luis de Guindos announced that banks will be forced to set aside a new €30 billion ($39 billion Cdn) financial cushion against bad loans and to separate property assets from their balance sheets.,118,135,financial cushion,9,5,14
35NNO802AVXGL5PV4E4DQIBBD2JNIN,Economy Minister Luis de Guindos announced that banks will be forced to set aside a new €30 billion ($39 billion Cdn) financial cushion against bad loans and to separate property assets from their balance sheets.,128,135,cushion,2,2,4
35NNO802AVXGL5PV4E4DQIBBD2JNIN,Economy Minister Luis de Guindos announced that banks will be forced to set aside a new €30 billion ($39 billion Cdn) financial cushion against bad loans and to separate property assets from their balance sheets.,144,153,bad loans,1,2,3
35NNO802AVXGL5PV4E4DQIBBD2JNIN,Economy Minister Luis de Guindos announced that banks will be forced to set aside a new €30 billion ($39 billion Cdn) financial cushion against bad loans and to separate property assets from their balance sheets.,161,185,separate property assets,1,0,1
35NNO802AVXGL5PV4E4DQIBBD2JNIN,Economy Minister Luis de Guindos announced that banks will be forced to set aside a new €30 billion ($39 billion Cdn) financial cushion against bad loans and to separate property assets from their balance sheets.,170,185,property assets,4,0,4
35NNO802AVXGL5PV4E4DQIBBD2JNIN,Economy Minister Luis de Guindos announced that banks will be forced to set aside a new €30 billion ($39 billion Cdn) financial cushion against bad loans and to separate property assets from their balance sheets.,179,185,assets,0,1,1
35NNO802AVXGL5PV4E4DQIBBD2JNIN,Economy Minister Luis de Guindos announced that banks will be forced to set aside a new €30 billion ($39 billion Cdn) financial cushion against bad loans and to separate property assets from their balance sheets.,197,211,balance sheets,4,0,4
35NNO802AVXGL5PV4E4DQIBBD2JNIN,The package is the second by the new conservative government in three months and Spain's fourth in three years.,37,49,conservative,7,3,10
35NNO802AVXGL5PV4E4DQIBBD2JNIN,The government in February told banks to set aside €50 billion ($64.5 billion) in rainy-day funds to protect them against losses in the property market and elsewhere.,45,50,aside,0,1,1
35NNO802AVXGL5PV4E4DQIBBD2JNIN,The government in February told banks to set aside €50 billion ($64.5 billion) in rainy-day funds to protect them against losses in the property market and elsewhere.,82,91,rainy-day,2,2,4
35NNO802AVXGL5PV4E4DQIBBD2JNIN,The government in February told banks to set aside €50 billion ($64.5 billion) in rainy-day funds to protect them against losses in the property market and elsewhere.,82,97,rainy-day funds,4,3,7
35NNO802AVXGL5PV4E4DQIBBD2JNIN,The government in February told banks to set aside €50 billion ($64.5 billion) in rainy-day funds to protect them against losses in the property market and elsewhere.,136,151,property market,2,0,2
35NNO802AVXGL5PV4E4DQIBBD2JNIN,The government in February told banks to set aside €50 billion ($64.5 billion) in rainy-day funds to protect them against losses in the property market and elsewhere.,156,165,elsewhere,0,2,2
3TKXBROM5TBK2FYAPGCLXBUU5VHIJ8,"The news came a day after thousands of Russians rallied in Moscow and St. Petersburg and faced off with police and Interior Ministry troops, who detained and arrested hundreds of protesters, including journalists.",26,35,thousands,2,0,2
3TKXBROM5TBK2FYAPGCLXBUU5VHIJ8,"The news came a day after thousands of Russians rallied in Moscow and St. Petersburg and faced off with police and Interior Ministry troops, who detained and arrested hundreds of protesters, including journalists.",48,55,rallied,7,7,14
3TKXBROM5TBK2FYAPGCLXBUU5VHIJ8,"The news came a day after thousands of Russians rallied in Moscow and St. Petersburg and faced off with police and Interior Ministry troops, who detained and arrested hundreds of protesters, including journalists.",89,98,faced off,1,2,3
3TKXBROM5TBK2FYAPGCLXBUU5VHIJ8,"The news came a day after thousands of Russians rallied in Moscow and St. Petersburg and faced off with police and Interior Ministry troops, who detained and arrested hundreds of protesters, including journalists.",115,132,Interior Ministry,2,1,3
3TKXBROM5TBK2FYAPGCLXBUU5VHIJ8,"The news came a day after thousands of Russians rallied in Moscow and St. Petersburg and faced off with police and Interior Ministry troops, who detained and arrested hundreds of protesters, including journalists.",115,139,Interior Ministry troops,1,0,1
3TKXBROM5TBK2FYAPGCLXBUU5VHIJ8,"The news came a day after thousands of Russians rallied in Moscow and St. Petersburg and faced off with police and Interior Ministry troops, who detained and arrested hundreds of protesters, including journalists.",145,153,detained,9,10,19
3TKXBROM5TBK2FYAPGCLXBUU5VHIJ8,"The news came a day after thousands of Russians rallied in Moscow and St. Petersburg and faced off with police and Interior Ministry troops, who detained and arrested hundreds of protesters, including journalists.",158,166,arrested,1,0,1
3TKXBROM5TBK2FYAPGCLXBUU5VHIJ8,"The news came a day after thousands of Russians rallied in Moscow and St. Petersburg and faced off with police and Interior Ministry troops, who detained and arrested hundreds of protesters, including journalists.",167,175,hundreds,1,0,1
3TKXBROM5TBK2FYAPGCLXBUU5VHIJ8,"The news came a day after thousands of Russians rallied in Moscow and St. Petersburg and faced off with police and Interior Ministry troops, who detained and arrested hundreds of protesters, including journalists.",179,189,protesters,3,3,6
3TKXBROM5TBK2FYAPGCLXBUU5VHIJ8,"The news came a day after thousands of Russians rallied in Moscow and St. Petersburg and faced off with police and Interior Ministry troops, who detained and arrested hundreds of protesters, including journalists.",191,212,including journalists,0,1,1
3TKXBROM5TBK2FYAPGCLXBUU5VHIJ8,"The news came a day after thousands of Russians rallied in Moscow and St. Petersburg and faced off with police and Interior Ministry troops, who detained and arrested hundreds of protesters, including journalists.",201,212,journalists,5,0,5
3TKXBROM5TBK2FYAPGCLXBUU5VHIJ8,"The country's leaders have to admit that there were numerous falsifications and rigging and the results do not reflect the will of the people, Gorbachev told Interfax, according to the AFP.",31,36,admit,0,2,2
3TKXBROM5TBK2FYAPGCLXBUU5VHIJ8,"The country's leaders have to admit that there were numerous falsifications and rigging and the results do not reflect the will of the people, Gorbachev told Interfax, according to the AFP.",53,61,numerous,1,2,3
3TKXBROM5TBK2FYAPGCLXBUU5VHIJ8,"The country's leaders have to admit that there were numerous falsifications and rigging and the results do not reflect the will of the people, Gorbachev told Interfax, according to the AFP.",53,76,numerous falsifications,5,0,5
3TKXBROM5TBK2FYAPGCLXBUU5VHIJ8,"The country's leaders have to admit that there were numerous falsifications and rigging and the results do not reflect the will of the people, Gorbachev told Interfax, according to the AFP.",53,88,numerous falsifications and rigging,0,1,1
3TKXBROM5TBK2FYAPGCLXBUU5VHIJ8,"The country's leaders have to admit that there were numerous falsifications and rigging and the results do not reflect the will of the people, Gorbachev told Interfax, according to the AFP.",62,76,falsifications,10,10,20
3TKXBROM5TBK2FYAPGCLXBUU5VHIJ8,"The country's leaders have to admit that there were numerous falsifications and rigging and the results do not reflect the will of the people, Gorbachev told Interfax, according to the AFP.",81,88,rigging,10,10,20
3TKXBROM5TBK2FYAPGCLXBUU5VHIJ8,"The country's leaders have to admit that there were numerous falsifications and rigging and the results do not reflect the will of the people, Gorbachev told Interfax, according to the AFP.",112,119,reflect,0,2,2
3TKXBROM5TBK2FYAPGCLXBUU5VHIJ8,"The country's leaders have to admit that there were numerous falsifications and rigging and the results do not reflect the will of the people, Gorbachev told Interfax, according to the AFP.",170,179,according,0,1,1
3TKXBROM5TBK2FYAPGCLXBUU5VHIJ8,"The country's leaders have to admit that there were numerous falsifications and rigging and the results do not reflect the will of the people, Gorbachev told Interfax, according to the AFP.",187,190,AFP,1,0,1
3TKXBROM5TBK2FYAPGCLXBUU5VHIJ8,Therefore I think they can only take one decision — annul the results of the election and hold new ones.,42,50,decision,1,0,1
3TKXBROM5TBK2FYAPGCLXBUU5VHIJ8,Therefore I think they can only take one decision — annul the results of the election and hold new ones.,53,58,annul,7,4,11
3TKXBROM5TBK2FYAPGCLXBUU5VHIJ8,Therefore I think they can only take one decision — annul the results of the election and hold new ones.,78,86,election,1,0,1
3TKXBROM5TBK2FYAPGCLXBUU5VHIJ8,Thousands of security forces were out in the Russian capital and helicopters roamed the sky Wednesday in a show of force following the protests over the election that saw Prime Minister Vladimir Putin's party struggle to keep a majority.,13,28,security forces,3,0,3
3TKXBROM5TBK2FYAPGCLXBUU5VHIJ8,Thousands of security forces were out in the Russian capital and helicopters roamed the sky Wednesday in a show of force following the protests over the election that saw Prime Minister Vladimir Putin's party struggle to keep a majority.,65,76,helicopters,1,0,1
3TKXBROM5TBK2FYAPGCLXBUU5VHIJ8,Thousands of security forces were out in the Russian capital and helicopters roamed the sky Wednesday in a show of force following the protests over the election that saw Prime Minister Vladimir Putin's party struggle to keep a majority.,77,83,roamed,6,3,9
3TKXBROM5TBK2FYAPGCLXBUU5VHIJ8,Thousands of security forces were out in the Russian capital and helicopters roamed the sky Wednesday in a show of force following the protests over the election that saw Prime Minister Vladimir Putin's party struggle to keep a majority.,107,120,show of force,1,0,1
3TKXBROM5TBK2FYAPGCLXBUU5VHIJ8,Thousands of security forces were out in the Russian capital and helicopters roamed the sky Wednesday in a show of force following the protests over the election that saw Prime Minister Vladimir Putin's party struggle to keep a majority.,115,120,force,1,0,1
3TKXBROM5TBK2FYAPGCLXBUU5VHIJ8,Thousands of security forces were out in the Russian capital and helicopters roamed the sky Wednesday in a show of force following the protests over the election that saw Prime Minister Vladimir Putin's party struggle to keep a majority.,203,217,party struggle,1,0,1
3TKXBROM5TBK2FYAPGCLXBUU5VHIJ8,Thousands of security forces were out in the Russian capital and helicopters roamed the sky Wednesday in a show of force following the protests over the election that saw Prime Minister Vladimir Putin's party struggle to keep a majority.,209,217,struggle,0,2,2
3TKXBROM5TBK2FYAPGCLXBUU5VHIJ8,Thousands of security forces were out in the Russian capital and helicopters roamed the sky Wednesday in a show of force following the protests over the election that saw Prime Minister Vladimir Putin's party struggle to keep a majority.,228,236,majority,3,0,3
3B9XR6P1WEWAF7K4J6K4BOQH9SUBJY,"The market was bracing itself for at least 50 billion euros in new cash.	16	23	bracing	10	10	20
3B9XR6P1WEWAF7K4J6K4BOQH9SUBJY	The market was bracing itself for at least 50 billion euros in new cash.",16,30,bracing itself,2,0,2
3B9XR6P1WEWAF7K4J6K4BOQH9SUBJY,"The market was bracing itself for at least 50 billion euros in new cash.	64	72	new cash	1	0	1
3B9XR6P1WEWAF7K4J6K4BOQH9SUBJY	You can't put out a number as low as 15 billion without an explanation, said a London-based banking analyst who did not want to be named.",59,70,explanation,3,1,4
3B9XR6P1WEWAF7K4J6K4BOQH9SUBJY,"You can't put out a number as low as 15 billion without an explanation,"" said a London-based banking analyst who did not want to be named.",93,108,banking analyst,5,1,6
3B9XR6P1WEWAF7K4J6K4BOQH9SUBJY,"You can't put out a number as low as 15 billion without an explanation,"" said a London-based banking analyst who did not want to be named.",101,108,analyst,4,5,9
3B9XR6P1WEWAF7K4J6K4BOQH9SUBJY,"Spanish lenders must set aside 30 billion euros, on top of 54 billion euros ordered in February, as provisions against loans which are still performing as well as bad ones while defaults rise in an recession which has sent unemployment to 24 percent.",8,15,lenders,0,3,3
3B9XR6P1WEWAF7K4J6K4BOQH9SUBJY,"Spanish lenders must set aside 30 billion euros, on top of 54 billion euros ordered in February, as provisions against loans which are still performing as well as bad ones while defaults rise in an recession which has sent unemployment to 24 percent.",25,30,aside,1,0,1
3B9XR6P1WEWAF7K4J6K4BOQH9SUBJY,"Spanish lenders must set aside 30 billion euros, on top of 54 billion euros ordered in February, as provisions against loans which are still performing as well as bad ones while defaults rise in an recession which has sent unemployment to 24 percent.",42,47,euros,1,0,1
3B9XR6P1WEWAF7K4J6K4BOQH9SUBJY,"Spanish lenders must set aside 30 billion euros, on top of 54 billion euros ordered in February, as provisions against loans which are still performing as well as bad ones while defaults rise in an recession which has sent unemployment to 24 percent.",100,110,provisions,9,9,18
3B9XR6P1WEWAF7K4J6K4BOQH9SUBJY,"Spanish lenders must set aside 30 billion euros, on top of 54 billion euros ordered in February, as provisions against loans which are still performing as well as bad ones while defaults rise in an recession which has sent unemployment to 24 percent.",100,124,provisions against loans,1,0,1
3B9XR6P1WEWAF7K4J6K4BOQH9SUBJY,"Spanish lenders must set aside 30 billion euros, on top of 54 billion euros ordered in February, as provisions against loans which are still performing as well as bad ones while defaults rise in an recession which has sent unemployment to 24 percent.",141,151,performing,1,2,3
3B9XR6P1WEWAF7K4J6K4BOQH9SUBJY,"Spanish lenders must set aside 30 billion euros, on top of 54 billion euros ordered in February, as provisions against loans which are still performing as well as bad ones while defaults rise in an recession which has sent unemployment to 24 percent.",178,186,defaults,9,6,15
3B9XR6P1WEWAF7K4J6K4BOQH9SUBJY,"Spanish lenders must set aside 30 billion euros, on top of 54 billion euros ordered in February, as provisions against loans which are still performing as well as bad ones while defaults rise in an recession which has sent unemployment to 24 percent.",187,191,rise,0,1,1
3B9XR6P1WEWAF7K4J6K4BOQH9SUBJY,"Spanish lenders must set aside 30 billion euros, on top of 54 billion euros ordered in February, as provisions against loans which are still performing as well as bad ones while defaults rise in an recession which has sent unemployment to 24 percent.",198,207,recession,10,8,18
3B9XR6P1WEWAF7K4J6K4BOQH9SUBJY,"Spanish lenders must set aside 30 billion euros, on top of 54 billion euros ordered in February, as provisions against loans which are still performing as well as bad ones while defaults rise in an recession which has sent unemployment to 24 percent.",223,235,unemployment,1,0,1
3B9XR6P1WEWAF7K4J6K4BOQH9SUBJY,"For banks unable to raise the necessary funds, the government will provide five-year loans, convertible into shares with an interest rate double the rate on government bonds.",20,25,raise,0,1,1
3B9XR6P1WEWAF7K4J6K4BOQH9SUBJY,"For banks unable to raise the necessary funds, the government will provide five-year loans, convertible into shares with an interest rate double the rate on government bonds.",92,103,convertible,9,5,14
3B9XR6P1WEWAF7K4J6K4BOQH9SUBJY,"For banks unable to raise the necessary funds, the government will provide five-year loans, convertible into shares with an interest rate double the rate on government bonds.",92,115,convertible into shares,1,0,1
3B9XR6P1WEWAF7K4J6K4BOQH9SUBJY,"For banks unable to raise the necessary funds, the government will provide five-year loans, convertible into shares with an interest rate double the rate on government bonds.",109,115,shares,0,1,1
3B9XR6P1WEWAF7K4J6K4BOQH9SUBJY,"For banks unable to raise the necessary funds, the government will provide five-year loans, convertible into shares with an interest rate double the rate on government bonds.",124,137,interest rate,2,2,4
3B9XR6P1WEWAF7K4J6K4BOQH9SUBJY,"For banks unable to raise the necessary funds, the government will provide five-year loans, convertible into shares with an interest rate double the rate on government bonds.",157,167,government,1,0,1
3B9XR6P1WEWAF7K4J6K4BOQH9SUBJY,"For banks unable to raise the necessary funds, the government will provide five-year loans, convertible into shares with an interest rate double the rate on government bonds.",157,173,government bonds,1,0,1
3B9XR6P1WEWAF7K4J6K4BOQH9SUBJY,"For banks unable to raise the necessary funds, the government will provide five-year loans, convertible into shares with an interest rate double the rate on government bonds.",168,173,bonds,2,1,3
3B9XR6P1WEWAF7K4J6K4BOQH9SUBJY,"The state will have to raise money on debt markets for the loans to the banks, which will be made through an instrument known as contingent convertibles, or CoCos, which carry the risk that the state ends up with ownership of still-troubled banks.",23,34,raise money,0,1,1
3B9XR6P1WEWAF7K4J6K4BOQH9SUBJY,"The state will have to raise money on debt markets for the loans to the banks, which will be made through an instrument known as contingent convertibles, or CoCos, which carry the risk that the state ends up with ownership of still-troubled banks.",38,42,debt,0,1,1
3B9XR6P1WEWAF7K4J6K4BOQH9SUBJY,"The state will have to raise money on debt markets for the loans to the banks, which will be made through an instrument known as contingent convertibles, or CoCos, which carry the risk that the state ends up with ownership of still-troubled banks.",38,50,debt markets,4,2,6
3B9XR6P1WEWAF7K4J6K4BOQH9SUBJY,"The state will have to raise money on debt markets for the loans to the banks, which will be made through an instrument known as contingent convertibles, or CoCos, which carry the risk that the state ends up with ownership of still-troubled banks.",109,119,instrument,5,1,6
3B9XR6P1WEWAF7K4J6K4BOQH9SUBJY,"The state will have to raise money on debt markets for the loans to the banks, which will be made through an instrument known as contingent convertibles, or CoCos, which carry the risk that the state ends up with ownership of still-troubled banks.",129,139,contingent,4,4,8
3B9XR6P1WEWAF7K4J6K4BOQH9SUBJY,"The state will have to raise money on debt markets for the loans to the banks, which will be made through an instrument known as contingent convertibles, or CoCos, which carry the risk that the state ends up with ownership of still-troubled banks.",129,152,contingent convertibles,9,4,13
3B9XR6P1WEWAF7K4J6K4BOQH9SUBJY,"The state will have to raise money on debt markets for the loans to the banks, which will be made through an instrument known as contingent convertibles, or CoCos, which carry the risk that the state ends up with ownership of still-troubled banks.",129,162,"contingent convertibles, or CoCos",1,0,1
3B9XR6P1WEWAF7K4J6K4BOQH9SUBJY,"The state will have to raise money on debt markets for the loans to the banks, which will be made through an instrument known as contingent convertibles, or CoCos, which carry the risk that the state ends up with ownership of still-troubled banks.",140,152,convertibles,3,0,3
3B9XR6P1WEWAF7K4J6K4BOQH9SUBJY,"The state will have to raise money on debt markets for the loans to the banks, which will be made through an instrument known as contingent convertibles, or CoCos, which carry the risk that the state ends up with ownership of still-troubled banks.",157,162,CoCos,2,0,2
3B9XR6P1WEWAF7K4J6K4BOQH9SUBJY,"The state will have to raise money on debt markets for the loans to the banks, which will be made through an instrument known as contingent convertibles, or CoCos, which carry the risk that the state ends up with ownership of still-troubled banks.",213,222,ownership,0,1,1
3B9XR6P1WEWAF7K4J6K4BOQH9SUBJY,"The state will have to raise money on debt markets for the loans to the banks, which will be made through an instrument known as contingent convertibles, or CoCos, which carry the risk that the state ends up with ownership of still-troubled banks.",226,240,still-troubled,1,1,2
3B9XR6P1WEWAF7K4J6K4BOQH9SUBJY,"The state will have to raise money on debt markets for the loans to the banks, which will be made through an instrument known as contingent convertibles, or CoCos, which carry the risk that the state ends up with ownership of still-troubled banks.",226,246,still-troubled banks,2,1,3
3JYPJ2TAYI9WEZZIJLBKRA3EY2VFPE,"Mr McGlone said: ""South Derry has been shaken by the news of this terrible shooting.",30,45,has been shaken,0,1,1
3JYPJ2TAYI9WEZZIJLBKRA3EY2VFPE,"Mr McGlone said: ""South Derry has been shaken by the news of this terrible shooting.",39,45,shaken,4,3,7
3JYPJ2TAYI9WEZZIJLBKRA3EY2VFPE,"Mr McGlone said: ""South Derry has been shaken by the news of this terrible shooting.",66,74,terrible,1,2,3
3JYPJ2TAYI9WEZZIJLBKRA3EY2VFPE,There is an overwhelming sense of shock amongst local people that something like this has happened so close to home in broad daylight.,13,25,overwhelming,9,10,19
3JYPJ2TAYI9WEZZIJLBKRA3EY2VFPE,There is an overwhelming sense of shock amongst local people that something like this has happened so close to home in broad daylight.,26,40,sense of shock,1,0,1
3JYPJ2TAYI9WEZZIJLBKRA3EY2VFPE,There is an overwhelming sense of shock amongst local people that something like this has happened so close to home in broad daylight.,35,40,shock,1,0,1
3JYPJ2TAYI9WEZZIJLBKRA3EY2VFPE,There is an overwhelming sense of shock amongst local people that something like this has happened so close to home in broad daylight.,41,48,amongst,2,0,2
3JYPJ2TAYI9WEZZIJLBKRA3EY2VFPE,There is an overwhelming sense of shock amongst local people that something like this has happened so close to home in broad daylight.,120,125,broad,1,1,2
3JYPJ2TAYI9WEZZIJLBKRA3EY2VFPE,There is an overwhelming sense of shock amongst local people that something like this has happened so close to home in broad daylight.,120,134,broad daylight,1,2,3
3JYPJ2TAYI9WEZZIJLBKRA3EY2VFPE,"Baset al-Megrahi, the Libyan intelligence officer who was convicted in the 1988 Lockerbie bombing has died at his home in Tripoli, nearly three years after he was released from a Scottish prison.Al-Megrahi was released on Aug. 20, 2009, on compassionate grounds in order for him return home to die after he was diagnosed with prostate cancer.",22,49,Libyan intelligence officer,1,0,1
3JYPJ2TAYI9WEZZIJLBKRA3EY2VFPE,"Baset al-Megrahi, the Libyan intelligence officer who was convicted in the 1988 Lockerbie bombing has died at his home in Tripoli, nearly three years after he was released from a Scottish prison.Al-Megrahi was released on Aug. 20, 2009, on compassionate grounds in order for him return home to die after he was diagnosed with prostate cancer.",29,41,intelligence,2,3,5
3JYPJ2TAYI9WEZZIJLBKRA3EY2VFPE,"Baset al-Megrahi, the Libyan intelligence officer who was convicted in the 1988 Lockerbie bombing has died at his home in Tripoli, nearly three years after he was released from a Scottish prison.Al-Megrahi was released on Aug. 20, 2009, on compassionate grounds in order for him return home to die after he was diagnosed with prostate cancer.",29,49,intelligence officer,1,1,2
3JYPJ2TAYI9WEZZIJLBKRA3EY2VFPE,"Baset al-Megrahi, the Libyan intelligence officer who was convicted in the 1988 Lockerbie bombing has died at his home in Tripoli, nearly three years after he was released from a Scottish prison.Al-Megrahi was released on Aug. 20, 2009, on compassionate grounds in order for him return home to die after he was diagnosed with prostate cancer.",58,67,convicted,3,6,9
3JYPJ2TAYI9WEZZIJLBKRA3EY2VFPE,"Baset al-Megrahi, the Libyan intelligence officer who was convicted in the 1988 Lockerbie bombing has died at his home in Tripoli, nearly three years after he was released from a Scottish prison.Al-Megrahi was released on Aug. 20, 2009, on compassionate grounds in order for him return home to die after he was diagnosed with prostate cancer.",80,89,Lockerbie,0,2,2
3JYPJ2TAYI9WEZZIJLBKRA3EY2VFPE,"Baset al-Megrahi, the Libyan intelligence officer who was convicted in the 1988 Lockerbie bombing has died at his home in Tripoli, nearly three years after he was released from a Scottish prison.Al-Megrahi was released on Aug. 20, 2009, on compassionate grounds in order for him return home to die after he was diagnosed with prostate cancer.",163,171,released,0,2,2
3JYPJ2TAYI9WEZZIJLBKRA3EY2VFPE,"Baset al-Megrahi, the Libyan intelligence officer who was convicted in the 1988 Lockerbie bombing has died at his home in Tripoli, nearly three years after he was released from a Scottish prison.Al-Megrahi was released on Aug. 20, 2009, on compassionate grounds in order for him return home to die after he was diagnosed with prostate cancer.",240,253,compassionate,7,8,15
3JYPJ2TAYI9WEZZIJLBKRA3EY2VFPE,"Baset al-Megrahi, the Libyan intelligence officer who was convicted in the 1988 Lockerbie bombing has died at his home in Tripoli, nearly three years after he was released from a Scottish prison.Al-Megrahi was released on Aug. 20, 2009, on compassionate grounds in order for him return home to die after he was diagnosed with prostate cancer.",240,261,compassionate grounds,6,4,10
3JYPJ2TAYI9WEZZIJLBKRA3EY2VFPE,"Baset al-Megrahi, the Libyan intelligence officer who was convicted in the 1988 Lockerbie bombing has died at his home in Tripoli, nearly three years after he was released from a Scottish prison.Al-Megrahi was released on Aug. 20, 2009, on compassionate grounds in order for him return home to die after he was diagnosed with prostate cancer.",311,320,diagnosed,6,5,11
3JYPJ2TAYI9WEZZIJLBKRA3EY2VFPE,"Baset al-Megrahi, the Libyan intelligence officer who was convicted in the 1988 Lockerbie bombing has died at his home in Tripoli, nearly three years after he was released from a Scottish prison.Al-Megrahi was released on Aug. 20, 2009, on compassionate grounds in order for him return home to die after he was diagnosed with prostate cancer.",326,334,prostate,4,3,7
3JYPJ2TAYI9WEZZIJLBKRA3EY2VFPE,"Baset al-Megrahi, the Libyan intelligence officer who was convicted in the 1988 Lockerbie bombing has died at his home in Tripoli, nearly three years after he was released from a Scottish prison.Al-Megrahi was released on Aug. 20, 2009, on compassionate grounds in order for him return home to die after he was diagnosed with prostate cancer.",326,341,prostate cancer,2,1,3
3JYPJ2TAYI9WEZZIJLBKRA3EY2VFPE,"Al-Megrahi insisted he was innocent, but he kept a strict silence after his release, living in the family villa surrounded by high walls in a posh Tripoli neighborhood, mostly bedridden or taking a few steps with a cane.His son, Khaled al-Megrahi, confirmed that he died in Tripoli in a telephone interview but hung up before giving more details.Saad Nasser al-Megrahi, a relative and a member of the ruling National Transitional Council, said al-Megrahi's health had seriously deteriorated in recent days and he died of cancer-related complications.Al-Megrahi insisted he had nothing to do with the bombing, which killed 270 people, most of them Americans.",11,19,insisted,2,2,4
3JYPJ2TAYI9WEZZIJLBKRA3EY2VFPE,"Al-Megrahi insisted he was innocent, but he kept a strict silence after his release, living in the family villa surrounded by high walls in a posh Tripoli neighborhood, mostly bedridden or taking a few steps with a cane.His son, Khaled al-Megrahi, confirmed that he died in Tripoli in a telephone interview but hung up before giving more details.Saad Nasser al-Megrahi, a relative and a member of the ruling National Transitional Council, said al-Megrahi's health had seriously deteriorated in recent days and he died of cancer-related complications.Al-Megrahi insisted he had nothing to do with the bombing, which killed 270 people, most of them Americans.",27,35,innocent,0,2,2
3JYPJ2TAYI9WEZZIJLBKRA3EY2VFPE,"Al-Megrahi insisted he was innocent, but he kept a strict silence after his release, living in the family villa surrounded by high walls in a posh Tripoli neighborhood, mostly bedridden or taking a few steps with a cane.His son, Khaled al-Megrahi, confirmed that he died in Tripoli in a telephone interview but hung up before giving more details.Saad Nasser al-Megrahi, a relative and a member of the ruling National Transitional Council, said al-Megrahi's health had seriously deteriorated in recent days and he died of cancer-related complications.Al-Megrahi insisted he had nothing to do with the bombing, which killed 270 people, most of them Americans.",51,65,strict silence,1,1,2
3JYPJ2TAYI9WEZZIJLBKRA3EY2VFPE,"Al-Megrahi insisted he was innocent, but he kept a strict silence after his release, living in the family villa surrounded by high walls in a posh Tripoli neighborhood, mostly bedridden or taking a few steps with a cane.His son, Khaled al-Megrahi, confirmed that he died in Tripoli in a telephone interview but hung up before giving more details.Saad Nasser al-Megrahi, a relative and a member of the ruling National Transitional Council, said al-Megrahi's health had seriously deteriorated in recent days and he died of cancer-related complications.Al-Megrahi insisted he had nothing to do with the bombing, which killed 270 people, most of them Americans.",106,111,villa,1,0,1
3JYPJ2TAYI9WEZZIJLBKRA3EY2VFPE,"Al-Megrahi insisted he was innocent, but he kept a strict silence after his release, living in the family villa surrounded by high walls in a posh Tripoli neighborhood, mostly bedridden or taking a few steps with a cane.His son, Khaled al-Megrahi, confirmed that he died in Tripoli in a telephone interview but hung up before giving more details.Saad Nasser al-Megrahi, a relative and a member of the ruling National Transitional Council, said al-Megrahi's health had seriously deteriorated in recent days and he died of cancer-related complications.Al-Megrahi insisted he had nothing to do with the bombing, which killed 270 people, most of them Americans.",112,122,surrounded,2,2,4
3JYPJ2TAYI9WEZZIJLBKRA3EY2VFPE,"Al-Megrahi insisted he was innocent, but he kept a strict silence after his release, living in the family villa surrounded by high walls in a posh Tripoli neighborhood, mostly bedridden or taking a few steps with a cane.His son, Khaled al-Megrahi, confirmed that he died in Tripoli in a telephone interview but hung up before giving more details.Saad Nasser al-Megrahi, a relative and a member of the ruling National Transitional Council, said al-Megrahi's health had seriously deteriorated in recent days and he died of cancer-related complications.Al-Megrahi insisted he had nothing to do with the bombing, which killed 270 people, most of them Americans.",142,146,posh,3,4,7
3JYPJ2TAYI9WEZZIJLBKRA3EY2VFPE,"Al-Megrahi insisted he was innocent, but he kept a strict silence after his release, living in the family villa surrounded by high walls in a posh Tripoli neighborhood, mostly bedridden or taking a few steps with a cane.His son, Khaled al-Megrahi, confirmed that he died in Tripoli in a telephone interview but hung up before giving more details.Saad Nasser al-Megrahi, a relative and a member of the ruling National Transitional Council, said al-Megrahi's health had seriously deteriorated in recent days and he died of cancer-related complications.Al-Megrahi insisted he had nothing to do with the bombing, which killed 270 people, most of them Americans.",155,167,neighborhood,2,0,2
3JYPJ2TAYI9WEZZIJLBKRA3EY2VFPE,"Al-Megrahi insisted he was innocent, but he kept a strict silence after his release, living in the family villa surrounded by high walls in a posh Tripoli neighborhood, mostly bedridden or taking a few steps with a cane.His son, Khaled al-Megrahi, confirmed that he died in Tripoli in a telephone interview but hung up before giving more details.Saad Nasser al-Megrahi, a relative and a member of the ruling National Transitional Council, said al-Megrahi's health had seriously deteriorated in recent days and he died of cancer-related complications.Al-Megrahi insisted he had nothing to do with the bombing, which killed 270 people, most of them Americans.",176,185,bedridden,9,10,19
3JYPJ2TAYI9WEZZIJLBKRA3EY2VFPE,"Al-Megrahi insisted he was innocent, but he kept a strict silence after his release, living in the family villa surrounded by high walls in a posh Tripoli neighborhood, mostly bedridden or taking a few steps with a cane.His son, Khaled al-Megrahi, confirmed that he died in Tripoli in a telephone interview but hung up before giving more details.Saad Nasser al-Megrahi, a relative and a member of the ruling National Transitional Council, said al-Megrahi's health had seriously deteriorated in recent days and he died of cancer-related complications.Al-Megrahi insisted he had nothing to do with the bombing, which killed 270 people, most of them Americans.",215,219,cane,0,1,1
3JYPJ2TAYI9WEZZIJLBKRA3EY2VFPE,"Al-Megrahi insisted he was innocent, but he kept a strict silence after his release, living in the family villa surrounded by high walls in a posh Tripoli neighborhood, mostly bedridden or taking a few steps with a cane.His son, Khaled al-Megrahi, confirmed that he died in Tripoli in a telephone interview but hung up before giving more details.Saad Nasser al-Megrahi, a relative and a member of the ruling National Transitional Council, said al-Megrahi's health had seriously deteriorated in recent days and he died of cancer-related complications.Al-Megrahi insisted he had nothing to do with the bombing, which killed 270 people, most of them Americans.",311,315,hung,0,1,1
3JYPJ2TAYI9WEZZIJLBKRA3EY2VFPE,"Al-Megrahi insisted he was innocent, but he kept a strict silence after his release, living in the family villa surrounded by high walls in a posh Tripoli neighborhood, mostly bedridden or taking a few steps with a cane.His son, Khaled al-Megrahi, confirmed that he died in Tripoli in a telephone interview but hung up before giving more details.Saad Nasser al-Megrahi, a relative and a member of the ruling National Transitional Council, said al-Megrahi's health had seriously deteriorated in recent days and he died of cancer-related complications.Al-Megrahi insisted he had nothing to do with the bombing, which killed 270 people, most of them Americans.",311,318,hung up,0,1,1
3JYPJ2TAYI9WEZZIJLBKRA3EY2VFPE,"Al-Megrahi insisted he was innocent, but he kept a strict silence after his release, living in the family villa surrounded by high walls in a posh Tripoli neighborhood, mostly bedridden or taking a few steps with a cane.His son, Khaled al-Megrahi, confirmed that he died in Tripoli in a telephone interview but hung up before giving more details.Saad Nasser al-Megrahi, a relative and a member of the ruling National Transitional Council, said al-Megrahi's health had seriously deteriorated in recent days and he died of cancer-related complications.Al-Megrahi insisted he had nothing to do with the bombing, which killed 270 people, most of them Americans.",401,407,ruling,0,1,1
3JYPJ2TAYI9WEZZIJLBKRA3EY2VFPE,"Al-Megrahi insisted he was innocent, but he kept a strict silence after his release, living in the family villa surrounded by high walls in a posh Tripoli neighborhood, mostly bedridden or taking a few steps with a cane.His son, Khaled al-Megrahi, confirmed that he died in Tripoli in a telephone interview but hung up before giving more details.Saad Nasser al-Megrahi, a relative and a member of the ruling National Transitional Council, said al-Megrahi's health had seriously deteriorated in recent days and he died of cancer-related complications.Al-Megrahi insisted he had nothing to do with the bombing, which killed 270 people, most of them Americans.",417,429,Transitional,0,1,1
3JYPJ2TAYI9WEZZIJLBKRA3EY2VFPE,"Al-Megrahi insisted he was innocent, but he kept a strict silence after his release, living in the family villa surrounded by high walls in a posh Tripoli neighborhood, mostly bedridden or taking a few steps with a cane.His son, Khaled al-Megrahi, confirmed that he died in Tripoli in a telephone interview but hung up before giving more details.Saad Nasser al-Megrahi, a relative and a member of the ruling National Transitional Council, said al-Megrahi's health had seriously deteriorated in recent days and he died of cancer-related complications.Al-Megrahi insisted he had nothing to do with the bombing, which killed 270 people, most of them Americans.",468,490,seriously deteriorated,2,0,2
3JYPJ2TAYI9WEZZIJLBKRA3EY2VFPE,"Al-Megrahi insisted he was innocent, but he kept a strict silence after his release, living in the family villa surrounded by high walls in a posh Tripoli neighborhood, mostly bedridden or taking a few steps with a cane.His son, Khaled al-Megrahi, confirmed that he died in Tripoli in a telephone interview but hung up before giving more details.Saad Nasser al-Megrahi, a relative and a member of the ruling National Transitional Council, said al-Megrahi's health had seriously deteriorated in recent days and he died of cancer-related complications.Al-Megrahi insisted he had nothing to do with the bombing, which killed 270 people, most of them Americans.",478,490,deteriorated,10,10,20
3JYPJ2TAYI9WEZZIJLBKRA3EY2VFPE,"Al-Megrahi insisted he was innocent, but he kept a strict silence after his release, living in the family villa surrounded by high walls in a posh Tripoli neighborhood, mostly bedridden or taking a few steps with a cane.His son, Khaled al-Megrahi, confirmed that he died in Tripoli in a telephone interview but hung up before giving more details.Saad Nasser al-Megrahi, a relative and a member of the ruling National Transitional Council, said al-Megrahi's health had seriously deteriorated in recent days and he died of cancer-related complications.Al-Megrahi insisted he had nothing to do with the bombing, which killed 270 people, most of them Americans.",521,549,cancer-related complications,2,0,2
3JYPJ2TAYI9WEZZIJLBKRA3EY2VFPE,"Al-Megrahi insisted he was innocent, but he kept a strict silence after his release, living in the family villa surrounded by high walls in a posh Tripoli neighborhood, mostly bedridden or taking a few steps with a cane.His son, Khaled al-Megrahi, confirmed that he died in Tripoli in a telephone interview but hung up before giving more details.Saad Nasser al-Megrahi, a relative and a member of the ruling National Transitional Council, said al-Megrahi's health had seriously deteriorated in recent days and he died of cancer-related complications.Al-Megrahi insisted he had nothing to do with the bombing, which killed 270 people, most of them Americans.",536,549,complications,6,1,7
3JYPJ2TAYI9WEZZIJLBKRA3EY2VFPE,"Al-Megrahi insisted he was innocent, but he kept a strict silence after his release, living in the family villa surrounded by high walls in a posh Tripoli neighborhood, mostly bedridden or taking a few steps with a cane.His son, Khaled al-Megrahi, confirmed that he died in Tripoli in a telephone interview but hung up before giving more details.Saad Nasser al-Megrahi, a relative and a member of the ruling National Transitional Council, said al-Megrahi's health had seriously deteriorated in recent days and he died of cancer-related complications.Al-Megrahi insisted he had nothing to do with the bombing, which killed 270 people, most of them Americans.",561,569,insisted,0,1,1
3AXFSPQOYQZ0SOWKO860UEH2P3PFJE,The Philippine government says its navy tried to detain Chinese fishermen but was prevented by the Chinese surveillance craft.,15,25,government,2,1,3
3AXFSPQOYQZ0SOWKO860UEH2P3PFJE,The Philippine government says its navy tried to detain Chinese fishermen but was prevented by the Chinese surveillance craft.,40,55,tried to detain,0,1,1
3AXFSPQOYQZ0SOWKO860UEH2P3PFJE,The Philippine government says its navy tried to detain Chinese fishermen but was prevented by the Chinese surveillance craft.,49,55,detain,8,6,14
3AXFSPQOYQZ0SOWKO860UEH2P3PFJE,The Philippine government says its navy tried to detain Chinese fishermen but was prevented by the Chinese surveillance craft.,107,119,surveillance,9,6,15
3AXFSPQOYQZ0SOWKO860UEH2P3PFJE,The Philippine government says its navy tried to detain Chinese fishermen but was prevented by the Chinese surveillance craft.,107,125,surveillance craft,5,5,10
3AXFSPQOYQZ0SOWKO860UEH2P3PFJE,The Philippine government says its navy tried to detain Chinese fishermen but was prevented by the Chinese surveillance craft.,120,125,craft,0,1,1
3AXFSPQOYQZ0SOWKO860UEH2P3PFJE,The shoal lies off the north-western province of Zambales.,4,9,shoal,8,5,13
3AXFSPQOYQZ0SOWKO860UEH2P3PFJE,The shoal lies off the north-western province of Zambales.,23,36,north-western,0,1,1
3AXFSPQOYQZ0SOWKO860UEH2P3PFJE,The shoal lies off the north-western province of Zambales.,37,45,province,4,1,5
3AXFSPQOYQZ0SOWKO860UEH2P3PFJE,The shoal lies off the north-western province of Zambales.,49,57,Zambales,1,0,1
3AXFSPQOYQZ0SOWKO860UEH2P3PFJE,"China and the Philippines have been disputing ownership of the shoal, in addition to the Spratly Islands and other areas in the South China Sea.",36,45,disputing,4,5,9
3AXFSPQOYQZ0SOWKO860UEH2P3PFJE,"China and the Philippines have been disputing ownership of the shoal, in addition to the Spratly Islands and other areas in the South China Sea.",36,55,disputing ownership,1,1,2
3AXFSPQOYQZ0SOWKO860UEH2P3PFJE,"China and the Philippines have been disputing ownership of the shoal, in addition to the Spratly Islands and other areas in the South China Sea.",46,55,ownership,1,1,2
3AXFSPQOYQZ0SOWKO860UEH2P3PFJE,"China and the Philippines have been disputing ownership of the shoal, in addition to the Spratly Islands and other areas in the South China Sea.",46,68,ownership of the shoal,1,0,1
3AXFSPQOYQZ0SOWKO860UEH2P3PFJE,"China and the Philippines have been disputing ownership of the shoal, in addition to the Spratly Islands and other areas in the South China Sea.",63,68,shoal,6,3,9
3AXFSPQOYQZ0SOWKO860UEH2P3PFJE,"China and the Philippines have been disputing ownership of the shoal, in addition to the Spratly Islands and other areas in the South China Sea.",89,96,Spratly,0,2,2
3AXFSPQOYQZ0SOWKO860UEH2P3PFJE,"China and the Philippines have been disputing ownership of the shoal, in addition to the Spratly Islands and other areas in the South China Sea.",89,104,Spratly Islands,1,0,1
3AXFSPQOYQZ0SOWKO860UEH2P3PFJE,"The Philippine Department of Foreign Affairs said that on Sunday, a Philippine navy surveillance plane sighted eight Chinese fishing vessels anchored in a lagoon at Scarborough, prompting the military to deploy its largest warship, the BRP Gregorio del Pilar, which was recently acquired from the United States.",29,44,Foreign Affairs,1,1,2
3AXFSPQOYQZ0SOWKO860UEH2P3PFJE,"The Philippine Department of Foreign Affairs said that on Sunday, a Philippine navy surveillance plane sighted eight Chinese fishing vessels anchored in a lagoon at Scarborough, prompting the military to deploy its largest warship, the BRP Gregorio del Pilar, which was recently acquired from the United States.",84,96,surveillance,7,1,8
3AXFSPQOYQZ0SOWKO860UEH2P3PFJE,"The Philippine Department of Foreign Affairs said that on Sunday, a Philippine navy surveillance plane sighted eight Chinese fishing vessels anchored in a lagoon at Scarborough, prompting the military to deploy its largest warship, the BRP Gregorio del Pilar, which was recently acquired from the United States.",84,102,surveillance plane,1,1,2
3AXFSPQOYQZ0SOWKO860UEH2P3PFJE,"The Philippine Department of Foreign Affairs said that on Sunday, a Philippine navy surveillance plane sighted eight Chinese fishing vessels anchored in a lagoon at Scarborough, prompting the military to deploy its largest warship, the BRP Gregorio del Pilar, which was recently acquired from the United States.",103,110,sighted,0,3,3
3AXFSPQOYQZ0SOWKO860UEH2P3PFJE,"The Philippine Department of Foreign Affairs said that on Sunday, a Philippine navy surveillance plane sighted eight Chinese fishing vessels anchored in a lagoon at Scarborough, prompting the military to deploy its largest warship, the BRP Gregorio del Pilar, which was recently acquired from the United States.",125,140,fishing vessels,0,1,1
3AXFSPQOYQZ0SOWKO860UEH2P3PFJE,"The Philippine Department of Foreign Affairs said that on Sunday, a Philippine navy surveillance plane sighted eight Chinese fishing vessels anchored in a lagoon at Scarborough, prompting the military to deploy its largest warship, the BRP Gregorio del Pilar, which was recently acquired from the United States.",133,140,vessels,2,4,6
3AXFSPQOYQZ0SOWKO860UEH2P3PFJE,"The Philippine Department of Foreign Affairs said that on Sunday, a Philippine navy surveillance plane sighted eight Chinese fishing vessels anchored in a lagoon at Scarborough, prompting the military to deploy its largest warship, the BRP Gregorio del Pilar, which was recently acquired from the United States.",133,149,vessels anchored,1,1,2
3AXFSPQOYQZ0SOWKO860UEH2P3PFJE,"The Philippine Department of Foreign Affairs said that on Sunday, a Philippine navy surveillance plane sighted eight Chinese fishing vessels anchored in a lagoon at Scarborough, prompting the military to deploy its largest warship, the BRP Gregorio del Pilar, which was recently acquired from the United States.",141,149,anchored,4,3,7
3AXFSPQOYQZ0SOWKO860UEH2P3PFJE,"The Philippine Department of Foreign Affairs said that on Sunday, a Philippine navy surveillance plane sighted eight Chinese fishing vessels anchored in a lagoon at Scarborough, prompting the military to deploy its largest warship, the BRP Gregorio del Pilar, which was recently acquired from the United States.",155,161,lagoon,7,3,10
3AXFSPQOYQZ0SOWKO860UEH2P3PFJE,"The Philippine Department of Foreign Affairs said that on Sunday, a Philippine navy surveillance plane sighted eight Chinese fishing vessels anchored in a lagoon at Scarborough, prompting the military to deploy its largest warship, the BRP Gregorio del Pilar, which was recently acquired from the United States.",178,187,prompting,3,4,7
3AXFSPQOYQZ0SOWKO860UEH2P3PFJE,"The Philippine Department of Foreign Affairs said that on Sunday, a Philippine navy surveillance plane sighted eight Chinese fishing vessels anchored in a lagoon at Scarborough, prompting the military to deploy its largest warship, the BRP Gregorio del Pilar, which was recently acquired from the United States.",192,200,military,1,0,1
3AXFSPQOYQZ0SOWKO860UEH2P3PFJE,"The Philippine Department of Foreign Affairs said that on Sunday, a Philippine navy surveillance plane sighted eight Chinese fishing vessels anchored in a lagoon at Scarborough, prompting the military to deploy its largest warship, the BRP Gregorio del Pilar, which was recently acquired from the United States.",204,210,deploy,4,4,8
3AXFSPQOYQZ0SOWKO860UEH2P3PFJE,"The Philippine Department of Foreign Affairs said that on Sunday, a Philippine navy surveillance plane sighted eight Chinese fishing vessels anchored in a lagoon at Scarborough, prompting the military to deploy its largest warship, the BRP Gregorio del Pilar, which was recently acquired from the United States.",223,230,warship,0,1,1
3AXFSPQOYQZ0SOWKO860UEH2P3PFJE,"The Philippine Department of Foreign Affairs said that on Sunday, a Philippine navy surveillance plane sighted eight Chinese fishing vessels anchored in a lagoon at Scarborough, prompting the military to deploy its largest warship, the BRP Gregorio del Pilar, which was recently acquired from the United States.",279,287,acquired,3,6,9
3AXFSPQOYQZ0SOWKO860UEH2P3PFJE,"On Tuesday, Filipino sailors from the warship boarded the Chinese vessels for an inspection, discovering large amounts of illegally collected coral, giant clams and live sharks inside the first boat, the department said.",12,28,Filipino sailors,1,0,1
3AXFSPQOYQZ0SOWKO860UEH2P3PFJE,"On Tuesday, Filipino sailors from the warship boarded the Chinese vessels for an inspection, discovering large amounts of illegally collected coral, giant clams and live sharks inside the first boat, the department said.",38,45,warship,1,0,1
3AXFSPQOYQZ0SOWKO860UEH2P3PFJE,"On Tuesday, Filipino sailors from the warship boarded the Chinese vessels for an inspection, discovering large amounts of illegally collected coral, giant clams and live sharks inside the first boat, the department said.",46,53,boarded,0,1,1
3AXFSPQOYQZ0SOWKO860UEH2P3PFJE,"On Tuesday, Filipino sailors from the warship boarded the Chinese vessels for an inspection, discovering large amounts of illegally collected coral, giant clams and live sharks inside the first boat, the department said.",66,73,vessels,2,2,4
3AXFSPQOYQZ0SOWKO860UEH2P3PFJE,"On Tuesday, Filipino sailors from the warship boarded the Chinese vessels for an inspection, discovering large amounts of illegally collected coral, giant clams and live sharks inside the first boat, the department said.",81,91,inspection,2,0,2
3AXFSPQOYQZ0SOWKO860UEH2P3PFJE,"On Tuesday, Filipino sailors from the warship boarded the Chinese vessels for an inspection, discovering large amounts of illegally collected coral, giant clams and live sharks inside the first boat, the department said.",105,147,large amounts of illegally collected coral,2,0,2
3AXFSPQOYQZ0SOWKO860UEH2P3PFJE,"On Tuesday, Filipino sailors from the warship boarded the Chinese vessels for an inspection, discovering large amounts of illegally collected coral, giant clams and live sharks inside the first boat, the department said.",122,131,illegally,0,3,3
3AXFSPQOYQZ0SOWKO860UEH2P3PFJE,"On Tuesday, Filipino sailors from the warship boarded the Chinese vessels for an inspection, discovering large amounts of illegally collected coral, giant clams and live sharks inside the first boat, the department said.",122,141,illegally collected,2,1,3
3AXFSPQOYQZ0SOWKO860UEH2P3PFJE,"On Tuesday, Filipino sailors from the warship boarded the Chinese vessels for an inspection, discovering large amounts of illegally collected coral, giant clams and live sharks inside the first boat, the department said.",142,147,coral,0,2,2
3AXFSPQOYQZ0SOWKO860UEH2P3PFJE,"On Tuesday, Filipino sailors from the warship boarded the Chinese vessels for an inspection, discovering large amounts of illegally collected coral, giant clams and live sharks inside the first boat, the department said.",155,160,clams,1,2,3
362E9TQF2HRABD89HARI0Y2ECQXIGA,"Separately, Spain said early this week it would take over Bankia SA, the largest real estate holder, to boost financial confidence.",0,10,Separately,1,1,2
362E9TQF2HRABD89HARI0Y2ECQXIGA,"Separately, Spain said early this week it would take over Bankia SA, the largest real estate holder, to boost financial confidence.",48,57,take over,0,1,1
362E9TQF2HRABD89HARI0Y2ECQXIGA,"Separately, Spain said early this week it would take over Bankia SA, the largest real estate holder, to boost financial confidence.",81,99,real estate holder,4,1,5
362E9TQF2HRABD89HARI0Y2ECQXIGA,"Separately, Spain said early this week it would take over Bankia SA, the largest real estate holder, to boost financial confidence.",86,92,estate,1,0,1
362E9TQF2HRABD89HARI0Y2ECQXIGA,"Separately, Spain said early this week it would take over Bankia SA, the largest real estate holder, to boost financial confidence.",93,99,holder,0,1,1
362E9TQF2HRABD89HARI0Y2ECQXIGA,"Separately, Spain said early this week it would take over Bankia SA, the largest real estate holder, to boost financial confidence.",104,109,boost,2,4,6
362E9TQF2HRABD89HARI0Y2ECQXIGA,"Separately, Spain said early this week it would take over Bankia SA, the largest real estate holder, to boost financial confidence.",104,130,boost financial confidence,1,1,2
362E9TQF2HRABD89HARI0Y2ECQXIGA,"Separately, Spain said early this week it would take over Bankia SA, the largest real estate holder, to boost financial confidence.",110,119,financial,0,1,1
362E9TQF2HRABD89HARI0Y2ECQXIGA,"Separately, Spain said early this week it would take over Bankia SA, the largest real estate holder, to boost financial confidence.",110,130,financial confidence,3,2,5
362E9TQF2HRABD89HARI0Y2ECQXIGA,"Separately, Spain said early this week it would take over Bankia SA, the largest real estate holder, to boost financial confidence.",120,130,confidence,0,3,3
362E9TQF2HRABD89HARI0Y2ECQXIGA,Spain's 10-year bond yield was up as much as 6.04 percent after the announcement.,16,20,bond,0,1,1
362E9TQF2HRABD89HARI0Y2ECQXIGA,Spain's 10-year bond yield was up as much as 6.04 percent after the announcement.,16,26,bond yield,5,2,7
362E9TQF2HRABD89HARI0Y2ECQXIGA,Spain's 10-year bond yield was up as much as 6.04 percent after the announcement.,21,26,yield,2,7,9
362E9TQF2HRABD89HARI0Y2ECQXIGA,Spain's 10-year bond yield was up as much as 6.04 percent after the announcement.,68,80,announcement,2,4,6
362E9TQF2HRABD89HARI0Y2ECQXIGA,"Banks have until the end of the year to move their holdings of repossessed property into asset management firms for a fire sale, Economy Minister Luis de Guindos told a news conference.",51,59,holdings,1,2,3
362E9TQF2HRABD89HARI0Y2ECQXIGA,"Banks have until the end of the year to move their holdings of repossessed property into asset management firms for a fire sale, Economy Minister Luis de Guindos told a news conference.",51,83,holdings of repossessed property,1,1,2
362E9TQF2HRABD89HARI0Y2ECQXIGA,"Banks have until the end of the year to move their holdings of repossessed property into asset management firms for a fire sale, Economy Minister Luis de Guindos told a news conference.",63,74,repossessed,6,10,16
362E9TQF2HRABD89HARI0Y2ECQXIGA,"Banks have until the end of the year to move their holdings of repossessed property into asset management firms for a fire sale, Economy Minister Luis de Guindos told a news conference.",63,83,repossessed property,4,2,6
362E9TQF2HRABD89HARI0Y2ECQXIGA,"Banks have until the end of the year to move their holdings of repossessed property into asset management firms for a fire sale, Economy Minister Luis de Guindos told a news conference.",89,94,asset,2,0,2
362E9TQF2HRABD89HARI0Y2ECQXIGA,"Banks have until the end of the year to move their holdings of repossessed property into asset management firms for a fire sale, Economy Minister Luis de Guindos told a news conference.",89,105,asset management,1,2,3
362E9TQF2HRABD89HARI0Y2ECQXIGA,"Banks have until the end of the year to move their holdings of repossessed property into asset management firms for a fire sale, Economy Minister Luis de Guindos told a news conference.",89,111,asset management firms,3,2,5
362E9TQF2HRABD89HARI0Y2ECQXIGA,"Banks have until the end of the year to move their holdings of repossessed property into asset management firms for a fire sale, Economy Minister Luis de Guindos told a news conference.",95,105,management,1,0,1
362E9TQF2HRABD89HARI0Y2ECQXIGA,"Banks have until the end of the year to move their holdings of repossessed property into asset management firms for a fire sale, Economy Minister Luis de Guindos told a news conference.",116,127,a fire sale,1,0,1
362E9TQF2HRABD89HARI0Y2ECQXIGA,"Banks have until the end of the year to move their holdings of repossessed property into asset management firms for a fire sale, Economy Minister Luis de Guindos told a news conference.",118,127,fire sale,2,4,6
362E9TQF2HRABD89HARI0Y2ECQXIGA,"Banks have until the end of the year to move their holdings of repossessed property into asset management firms for a fire sale, Economy Minister Luis de Guindos told a news conference.",174,184,conference,1,2,3
362E9TQF2HRABD89HARI0Y2ECQXIGA,"A Spanish government source, however, later said that banks able to cover by themselves losses on their toxic property assets will not be forced to remove them from their books while it will be compulsory for those receiving public help.",10,20,government,1,0,1
362E9TQF2HRABD89HARI0Y2ECQXIGA,"A Spanish government source, however, later said that banks able to cover by themselves losses on their toxic property assets will not be forced to remove them from their books while it will be compulsory for those receiving public help.",104,109,toxic,2,4,6
362E9TQF2HRABD89HARI0Y2ECQXIGA,"A Spanish government source, however, later said that banks able to cover by themselves losses on their toxic property assets will not be forced to remove them from their books while it will be compulsory for those receiving public help.",104,118,toxic property,1,2,3
362E9TQF2HRABD89HARI0Y2ECQXIGA,"A Spanish government source, however, later said that banks able to cover by themselves losses on their toxic property assets will not be forced to remove them from their books while it will be compulsory for those receiving public help.",104,125,toxic property assets,6,4,10
362E9TQF2HRABD89HARI0Y2ECQXIGA,"A Spanish government source, however, later said that banks able to cover by themselves losses on their toxic property assets will not be forced to remove them from their books while it will be compulsory for those receiving public help.",119,125,assets,1,2,3
362E9TQF2HRABD89HARI0Y2ECQXIGA,"A Spanish government source, however, later said that banks able to cover by themselves losses on their toxic property assets will not be forced to remove them from their books while it will be compulsory for those receiving public help.",194,204,compulsory,10,7,17
362E9TQF2HRABD89HARI0Y2ECQXIGA,"A Spanish government source, however, later said that banks able to cover by themselves losses on their toxic property assets will not be forced to remove them from their books while it will be compulsory for those receiving public help.",215,224,receiving,0,1,1
362E9TQF2HRABD89HARI0Y2ECQXIGA,"The state will put less than 15 billion euros into the latest of the four separate bank rescues that Spain has enacted over the past three years, de Guindos estimated.",40,45,euros,1,0,1
362E9TQF2HRABD89HARI0Y2ECQXIGA,"The state will put less than 15 billion euros into the latest of the four separate bank rescues that Spain has enacted over the past three years, de Guindos estimated.",74,82,separate,1,1,2
362E9TQF2HRABD89HARI0Y2ECQXIGA,"The state will put less than 15 billion euros into the latest of the four separate bank rescues that Spain has enacted over the past three years, de Guindos estimated.",83,95,bank rescues,0,1,1
362E9TQF2HRABD89HARI0Y2ECQXIGA,"The state will put less than 15 billion euros into the latest of the four separate bank rescues that Spain has enacted over the past three years, de Guindos estimated.",88,95,rescues,1,2,3
362E9TQF2HRABD89HARI0Y2ECQXIGA,"The state will put less than 15 billion euros into the latest of the four separate bank rescues that Spain has enacted over the past three years, de Guindos estimated.",111,118,enacted,5,7,12
362E9TQF2HRABD89HARI0Y2ECQXIGA,"The state will put less than 15 billion euros into the latest of the four separate bank rescues that Spain has enacted over the past three years, de Guindos estimated.",157,166,estimated,1,1,2
3J6BHNX0U9T7R0FJ4HPP3YQO5INKNY,"President Barack Obama spoke to U.S. troops on the one-year anniversary of Osama bin Laden's death, telling them that as the war winds down both America and Afghanistan are grateful for their sacrifice.",60,71,anniversary,3,3,6
3J6BHNX0U9T7R0FJ4HPP3YQO5INKNY,"President Barack Obama spoke to U.S. troops on the one-year anniversary of Osama bin Laden's death, telling them that as the war winds down both America and Afghanistan are grateful for their sacrifice.",125,134,war winds,0,1,1
3J6BHNX0U9T7R0FJ4HPP3YQO5INKNY,"President Barack Obama spoke to U.S. troops on the one-year anniversary of Osama bin Laden's death, telling them that as the war winds down both America and Afghanistan are grateful for their sacrifice.",125,139,war winds down,1,0,1
3J6BHNX0U9T7R0FJ4HPP3YQO5INKNY,"President Barack Obama spoke to U.S. troops on the one-year anniversary of Osama bin Laden's death, telling them that as the war winds down both America and Afghanistan are grateful for their sacrifice.",129,134,winds,1,0,1
3J6BHNX0U9T7R0FJ4HPP3YQO5INKNY,"President Barack Obama spoke to U.S. troops on the one-year anniversary of Osama bin Laden's death, telling them that as the war winds down both America and Afghanistan are grateful for their sacrifice.",129,139,winds down,4,5,9
3J6BHNX0U9T7R0FJ4HPP3YQO5INKNY,"President Barack Obama spoke to U.S. troops on the one-year anniversary of Osama bin Laden's death, telling them that as the war winds down both America and Afghanistan are grateful for their sacrifice.",173,181,grateful,4,3,7
3J6BHNX0U9T7R0FJ4HPP3YQO5INKNY,"President Barack Obama spoke to U.S. troops on the one-year anniversary of Osama bin Laden's death, telling them that as the war winds down both America and Afghanistan are grateful for their sacrifice.",192,201,sacrifice,7,7,14
3J6BHNX0U9T7R0FJ4HPP3YQO5INKNY,"As that debate raged, the president, acting as commander in chief, landed in Afghanistan on Tuesday afternoon for an unannounced visit to the war zone.",8,14,debate,1,3,4
3J6BHNX0U9T7R0FJ4HPP3YQO5INKNY,"As that debate raged, the president, acting as commander in chief, landed in Afghanistan on Tuesday afternoon for an unannounced visit to the war zone.",8,20,debate raged,1,0,1
3J6BHNX0U9T7R0FJ4HPP3YQO5INKNY,"As that debate raged, the president, acting as commander in chief, landed in Afghanistan on Tuesday afternoon for an unannounced visit to the war zone.",15,20,raged,9,8,17
3J6BHNX0U9T7R0FJ4HPP3YQO5INKNY,"As that debate raged, the president, acting as commander in chief, landed in Afghanistan on Tuesday afternoon for an unannounced visit to the war zone.",47,56,commander,1,0,1
3J6BHNX0U9T7R0FJ4HPP3YQO5INKNY,"As that debate raged, the president, acting as commander in chief, landed in Afghanistan on Tuesday afternoon for an unannounced visit to the war zone.",47,65,commander in chief,0,1,1
3J6BHNX0U9T7R0FJ4HPP3YQO5INKNY,"As that debate raged, the president, acting as commander in chief, landed in Afghanistan on Tuesday afternoon for an unannounced visit to the war zone.",67,73,landed,1,1,2
3J6BHNX0U9T7R0FJ4HPP3YQO5INKNY,"As that debate raged, the president, acting as commander in chief, landed in Afghanistan on Tuesday afternoon for an unannounced visit to the war zone.",117,128,unannounced,6,7,13
3J6BHNX0U9T7R0FJ4HPP3YQO5INKNY,"As that debate raged, the president, acting as commander in chief, landed in Afghanistan on Tuesday afternoon for an unannounced visit to the war zone.",117,134,unannounced visit,1,0,1
3J6BHNX0U9T7R0FJ4HPP3YQO5INKNY,"As that debate raged, the president, acting as commander in chief, landed in Afghanistan on Tuesday afternoon for an unannounced visit to the war zone.",142,150,war zone,1,1,2
3J6BHNX0U9T7R0FJ4HPP3YQO5INKNY,"There, he signed a new security agreement with President Hamid Karzai that outlines a partnership between the two countries that will continue after U.S. combat forces end their mission in 2014.",23,41,security agreement,1,1,2
3J6BHNX0U9T7R0FJ4HPP3YQO5INKNY,"There, he signed a new security agreement with President Hamid Karzai that outlines a partnership between the two countries that will continue after U.S. combat forces end their mission in 2014.",32,41,agreement,1,1,2
3J6BHNX0U9T7R0FJ4HPP3YQO5INKNY,"There, he signed a new security agreement with President Hamid Karzai that outlines a partnership between the two countries that will continue after U.S. combat forces end their mission in 2014.",75,83,outlines,4,7,11
3J6BHNX0U9T7R0FJ4HPP3YQO5INKNY,"There, he signed a new security agreement with President Hamid Karzai that outlines a partnership between the two countries that will continue after U.S. combat forces end their mission in 2014.",86,97,partnership,3,0,3
3J6BHNX0U9T7R0FJ4HPP3YQO5INKNY,"There, he signed a new security agreement with President Hamid Karzai that outlines a partnership between the two countries that will continue after U.S. combat forces end their mission in 2014.",154,160,combat,2,1,3
3J6BHNX0U9T7R0FJ4HPP3YQO5INKNY,"There, he signed a new security agreement with President Hamid Karzai that outlines a partnership between the two countries that will continue after U.S. combat forces end their mission in 2014.",154,167,combat forces,1,3,4
3J6BHNX0U9T7R0FJ4HPP3YQO5INKNY,"There, he signed a new security agreement with President Hamid Karzai that outlines a partnership between the two countries that will continue after U.S. combat forces end their mission in 2014.",178,185,mission,0,2,2
3J6BHNX0U9T7R0FJ4HPP3YQO5INKNY,"The president's trip muted, at least for a few hours, the partisan exchanges over whether his campaign had crossed a line with its bin Laden video.",16,26,trip muted,0,1,1
3J6BHNX0U9T7R0FJ4HPP3YQO5INKNY,"The president's trip muted, at least for a few hours, the partisan exchanges over whether his campaign had crossed a line with its bin Laden video.",21,26,muted,10,9,19
3J6BHNX0U9T7R0FJ4HPP3YQO5INKNY,"The president's trip muted, at least for a few hours, the partisan exchanges over whether his campaign had crossed a line with its bin Laden video.",58,66,partisan,7,7,14
3J6BHNX0U9T7R0FJ4HPP3YQO5INKNY,"The president's trip muted, at least for a few hours, the partisan exchanges over whether his campaign had crossed a line with its bin Laden video.",58,76,partisan exchanges,4,0,4
3J6BHNX0U9T7R0FJ4HPP3YQO5INKNY,"The president's trip muted, at least for a few hours, the partisan exchanges over whether his campaign had crossed a line with its bin Laden video.",67,76,exchanges,2,2,4
3J6BHNX0U9T7R0FJ4HPP3YQO5INKNY,"The president's trip muted, at least for a few hours, the partisan exchanges over whether his campaign had crossed a line with its bin Laden video.",94,102,campaign,5,6,11
3J6BHNX0U9T7R0FJ4HPP3YQO5INKNY,"The president's trip muted, at least for a few hours, the partisan exchanges over whether his campaign had crossed a line with its bin Laden video.",107,121,crossed a line,2,0,2
3QREJ3J433YH30CYS49AQ6MZ0NNKLW,The Green Village assault began around two hours after Obama left.,4,17,Green Village,1,0,1
3QREJ3J433YH30CYS49AQ6MZ0NNKLW,The Green Village assault began around two hours after Obama left.,18,25,assault,5,7,12
3QREJ3J433YH30CYS49AQ6MZ0NNKLW,"Police said suicide attackers wearing burqas struck at 6:15 am (0145 GMT), detonating a car bomb before clashing with guards.",12,19,suicide,3,1,4
3QREJ3J433YH30CYS49AQ6MZ0NNKLW,"Police said suicide attackers wearing burqas struck at 6:15 am (0145 GMT), detonating a car bomb before clashing with guards.",12,29,suicide attackers,2,2,4
3QREJ3J433YH30CYS49AQ6MZ0NNKLW,"Police said suicide attackers wearing burqas struck at 6:15 am (0145 GMT), detonating a car bomb before clashing with guards.",38,44,burqas,8,2,10
3QREJ3J433YH30CYS49AQ6MZ0NNKLW,"Police said suicide attackers wearing burqas struck at 6:15 am (0145 GMT), detonating a car bomb before clashing with guards.",45,51,struck,0,3,3
3QREJ3J433YH30CYS49AQ6MZ0NNKLW,"Police said suicide attackers wearing burqas struck at 6:15 am (0145 GMT), detonating a car bomb before clashing with guards.",75,85,detonating,10,7,17
3QREJ3J433YH30CYS49AQ6MZ0NNKLW,"Police said suicide attackers wearing burqas struck at 6:15 am (0145 GMT), detonating a car bomb before clashing with guards.",104,112,clashing,4,7,11
3QREJ3J433YH30CYS49AQ6MZ0NNKLW,"Police said suicide attackers wearing burqas struck at 6:15 am (0145 GMT), detonating a car bomb before clashing with guards.",104,124,clashing with guards,1,0,1
3QREJ3J433YH30CYS49AQ6MZ0NNKLW,"The interior ministry said seven people were killed, including at least six Afghans.",4,12,interior,2,2,4
3QREJ3J433YH30CYS49AQ6MZ0NNKLW,"The interior ministry said seven people were killed, including at least six Afghans.",4,21,interior ministry,5,1,6
3QREJ3J433YH30CYS49AQ6MZ0NNKLW,"The interior ministry said seven people were killed, including at least six Afghans.",13,21,ministry,4,0,4
3QREJ3J433YH30CYS49AQ6MZ0NNKLW,"The interior ministry said seven people were killed, including at least six Afghans.",53,62,including,0,1,1
3QREJ3J433YH30CYS49AQ6MZ0NNKLW,"There were three attackers, the ministry said, one in the suicide car bomb and two who got inside the complex.",32,40,ministry,2,0,2
3QREJ3J433YH30CYS49AQ6MZ0NNKLW,"There were three attackers, the ministry said, one in the suicide car bomb and two who got inside the complex.",58,65,suicide,2,0,2
3QREJ3J433YH30CYS49AQ6MZ0NNKLW,"There were three attackers, the ministry said, one in the suicide car bomb and two who got inside the complex.",58,74,suicide car bomb,1,0,1
3QREJ3J433YH30CYS49AQ6MZ0NNKLW,"There were three attackers, the ministry said, one in the suicide car bomb and two who got inside the complex.",102,109,complex,6,2,8
3QREJ3J433YH30CYS49AQ6MZ0NNKLW,One blew himself up while the other was shot dead by security forces.,4,8,blew,0,4,4
3QREJ3J433YH30CYS49AQ6MZ0NNKLW,One blew himself up while the other was shot dead by security forces.,4,16,blew himself,0,1,1
3QREJ3J433YH30CYS49AQ6MZ0NNKLW,One blew himself up while the other was shot dead by security forces.,53,68,security forces,1,0,1
3QREJ3J433YH30CYS49AQ6MZ0NNKLW,"Mangled bodies were seen lying in the road after the attack, which left two vehicles completely destroyed and blew out the windows of a nearby school.",0,7,Mangled,10,10,20
3QREJ3J433YH30CYS49AQ6MZ0NNKLW,"Mangled bodies were seen lying in the road after the attack, which left two vehicles completely destroyed and blew out the windows of a nearby school.",0,14,Mangled bodies,1,2,3
3QREJ3J433YH30CYS49AQ6MZ0NNKLW,"Mangled bodies were seen lying in the road after the attack, which left two vehicles completely destroyed and blew out the windows of a nearby school.",76,84,vehicles,1,0,1
3QREJ3J433YH30CYS49AQ6MZ0NNKLW,"Mangled bodies were seen lying in the road after the attack, which left two vehicles completely destroyed and blew out the windows of a nearby school.",96,105,destroyed,1,1,2
3QREJ3J433YH30CYS49AQ6MZ0NNKLW,"Mangled bodies were seen lying in the road after the attack, which left two vehicles completely destroyed and blew out the windows of a nearby school.",110,114,blew,0,2,2
3QREJ3J433YH30CYS49AQ6MZ0NNKLW,"Mangled bodies were seen lying in the road after the attack, which left two vehicles completely destroyed and blew out the windows of a nearby school.",110,118,blew out,0,2,2
3QREJ3J433YH30CYS49AQ6MZ0NNKLW,Health ministry spokesman Kargar Noorughli said 18 people were wounded and eight admitted to hospital.,0,15,Health ministry,1,0,1
3QREJ3J433YH30CYS49AQ6MZ0NNKLW,Health ministry spokesman Kargar Noorughli said 18 people were wounded and eight admitted to hospital.,7,15,ministry,1,0,1
3QREJ3J433YH30CYS49AQ6MZ0NNKLW,Health ministry spokesman Kargar Noorughli said 18 people were wounded and eight admitted to hospital.,16,25,spokesman,3,4,7
3QREJ3J433YH30CYS49AQ6MZ0NNKLW,Health ministry spokesman Kargar Noorughli said 18 people were wounded and eight admitted to hospital.,26,42,Kargar Noorughli,0,1,1
3QREJ3J433YH30CYS49AQ6MZ0NNKLW,Health ministry spokesman Kargar Noorughli said 18 people were wounded and eight admitted to hospital.,63,70,wounded,0,3,3
3QREJ3J433YH30CYS49AQ6MZ0NNKLW,Health ministry spokesman Kargar Noorughli said 18 people were wounded and eight admitted to hospital.,81,89,admitted,2,1,3
3QREJ3J433YH30CYS49AQ6MZ0NNKLW,Health ministry spokesman Kargar Noorughli said 18 people were wounded and eight admitted to hospital.,81,101,admitted to hospital,1,0,1
3QREJ3J433YH30CYS49AQ6MZ0NNKLW,Taliban spokesman Zabiullah Mujahid told AFP the attack was a message to Obama to say the militants would continue to fight until all foreign forces had left.,8,17,spokesman,4,0,4
3QREJ3J433YH30CYS49AQ6MZ0NNKLW,Taliban spokesman Zabiullah Mujahid told AFP the attack was a message to Obama to say the militants would continue to fight until all foreign forces had left.,41,44,AFP,1,0,1
3QREJ3J433YH30CYS49AQ6MZ0NNKLW,Taliban spokesman Zabiullah Mujahid told AFP the attack was a message to Obama to say the militants would continue to fight until all foreign forces had left.,90,99,militants,5,2,7
3QREJ3J433YH30CYS49AQ6MZ0NNKLW,Taliban spokesman Zabiullah Mujahid told AFP the attack was a message to Obama to say the militants would continue to fight until all foreign forces had left.,106,114,continue,1,0,1
3QREJ3J433YH30CYS49AQ6MZ0NNKLW,Taliban spokesman Zabiullah Mujahid told AFP the attack was a message to Obama to say the militants would continue to fight until all foreign forces had left.,134,141,foreign,1,0,1
3QREJ3J433YH30CYS49AQ6MZ0NNKLW,Taliban spokesman Zabiullah Mujahid told AFP the attack was a message to Obama to say the militants would continue to fight until all foreign forces had left.,134,148,foreign forces,2,0,2
3IH9TRB0FB0D7YI6ZR6FTBY8ADTI1D,"Nearly 3,000 U.S. and NATO soldiers have been killed in Afghanistan since the Taliban rulers were ousted in 2001.",0,6,Nearly,1,0,1
3IH9TRB0FB0D7YI6ZR6FTBY8ADTI1D,"Nearly 3,000 U.S. and NATO soldiers have been killed in Afghanistan since the Taliban rulers were ousted in 2001.",22,35,NATO soldiers,1,1,2
3IH9TRB0FB0D7YI6ZR6FTBY8ADTI1D,"Nearly 3,000 U.S. and NATO soldiers have been killed in Afghanistan since the Taliban rulers were ousted in 2001.",78,85,Taliban,1,0,1
3IH9TRB0FB0D7YI6ZR6FTBY8ADTI1D,"Nearly 3,000 U.S. and NATO soldiers have been killed in Afghanistan since the Taliban rulers were ousted in 2001.",86,92,rulers,0,2,2
3IH9TRB0FB0D7YI6ZR6FTBY8ADTI1D,"Nearly 3,000 U.S. and NATO soldiers have been killed in Afghanistan since the Taliban rulers were ousted in 2001.",98,104,ousted,7,10,17
3IH9TRB0FB0D7YI6ZR6FTBY8ADTI1D,"The Taliban, overthrown by U.S.-backed Afghan forces for harboring bin Laden and other militants, were quick to take credit for Wednesday's attack at Green Village, one of several compounds for Westerners on a main road out of the capital.",13,23,overthrown,5,10,15
3IH9TRB0FB0D7YI6ZR6FTBY8ADTI1D,"The Taliban, overthrown by U.S.-backed Afghan forces for harboring bin Laden and other militants, were quick to take credit for Wednesday's attack at Green Village, one of several compounds for Westerners on a main road out of the capital.",27,38,U.S.-backed,1,0,1
3IH9TRB0FB0D7YI6ZR6FTBY8ADTI1D,"The Taliban, overthrown by U.S.-backed Afghan forces for harboring bin Laden and other militants, were quick to take credit for Wednesday's attack at Green Village, one of several compounds for Westerners on a main road out of the capital.",57,66,harboring,10,10,20
3IH9TRB0FB0D7YI6ZR6FTBY8ADTI1D,"The Taliban, overthrown by U.S.-backed Afghan forces for harboring bin Laden and other militants, were quick to take credit for Wednesday's attack at Green Village, one of several compounds for Westerners on a main road out of the capital.",87,96,militants,4,2,6
3IH9TRB0FB0D7YI6ZR6FTBY8ADTI1D,"The Taliban, overthrown by U.S.-backed Afghan forces for harboring bin Laden and other militants, were quick to take credit for Wednesday's attack at Green Village, one of several compounds for Westerners on a main road out of the capital.",117,123,credit,1,0,1
3IH9TRB0FB0D7YI6ZR6FTBY8ADTI1D,"The Taliban, overthrown by U.S.-backed Afghan forces for harboring bin Laden and other militants, were quick to take credit for Wednesday's attack at Green Village, one of several compounds for Westerners on a main road out of the capital.",150,163,Green Village,0,1,1
3IH9TRB0FB0D7YI6ZR6FTBY8ADTI1D,"The Taliban, overthrown by U.S.-backed Afghan forces for harboring bin Laden and other militants, were quick to take credit for Wednesday's attack at Green Village, one of several compounds for Westerners on a main road out of the capital.",180,189,compounds,4,5,9
3IH9TRB0FB0D7YI6ZR6FTBY8ADTI1D,"The Taliban, overthrown by U.S.-backed Afghan forces for harboring bin Laden and other militants, were quick to take credit for Wednesday's attack at Green Village, one of several compounds for Westerners on a main road out of the capital.",194,204,Westerners,1,0,1
3IH9TRB0FB0D7YI6ZR6FTBY8ADTI1D,"This attack was to make clear our reaction to Obama's trip to Afghanistan.	35	43	reaction	0	1	1
3IH9TRB0FB0D7YI6ZR6FTBY8ADTI1D	The message was that instead of signing a strategic partnership deal with Afghanistan, he should think about taking his troops out from Afghanistan and leave it to Afghans to rebuild their country, Taliban spokesman Zabihullah Mujahid told Reuters by telephone from an undisclosed location.",4,11,message,0,1,1
3IH9TRB0FB0D7YI6ZR6FTBY8ADTI1D,"The message was that instead of signing a strategic partnership deal with Afghanistan, he should think about taking his troops out from Afghanistan and leave it to Afghans to rebuild their country,"" Taliban spokesman Zabihullah Mujahid told Reuters by telephone from an undisclosed location.",21,28,instead,0,1,1
3IH9TRB0FB0D7YI6ZR6FTBY8ADTI1D,"The message was that instead of signing a strategic partnership deal with Afghanistan, he should think about taking his troops out from Afghanistan and leave it to Afghans to rebuild their country,"" Taliban spokesman Zabihullah Mujahid told Reuters by telephone from an undisclosed location.",42,51,strategic,4,5,9
3IH9TRB0FB0D7YI6ZR6FTBY8ADTI1D,"The message was that instead of signing a strategic partnership deal with Afghanistan, he should think about taking his troops out from Afghanistan and leave it to Afghans to rebuild their country,"" Taliban spokesman Zabihullah Mujahid told Reuters by telephone from an undisclosed location.",42,63,strategic partnership,1,6,7
3IH9TRB0FB0D7YI6ZR6FTBY8ADTI1D,"The message was that instead of signing a strategic partnership deal with Afghanistan, he should think about taking his troops out from Afghanistan and leave it to Afghans to rebuild their country,"" Taliban spokesman Zabihullah Mujahid told Reuters by telephone from an undisclosed location.",42,68,strategic partnership deal,4,0,4
3IH9TRB0FB0D7YI6ZR6FTBY8ADTI1D,"The message was that instead of signing a strategic partnership deal with Afghanistan, he should think about taking his troops out from Afghanistan and leave it to Afghans to rebuild their country,"" Taliban spokesman Zabihullah Mujahid told Reuters by telephone from an undisclosed location.",52,63,partnership,1,0,1
3IH9TRB0FB0D7YI6ZR6FTBY8ADTI1D,"The message was that instead of signing a strategic partnership deal with Afghanistan, he should think about taking his troops out from Afghanistan and leave it to Afghans to rebuild their country,"" Taliban spokesman Zabihullah Mujahid told Reuters by telephone from an undisclosed location.",175,182,rebuild,0,2,2
3IH9TRB0FB0D7YI6ZR6FTBY8ADTI1D,"The message was that instead of signing a strategic partnership deal with Afghanistan, he should think about taking his troops out from Afghanistan and leave it to Afghans to rebuild their country,"" Taliban spokesman Zabihullah Mujahid told Reuters by telephone from an undisclosed location.",207,216,spokesman,2,1,3
3IH9TRB0FB0D7YI6ZR6FTBY8ADTI1D,"The message was that instead of signing a strategic partnership deal with Afghanistan, he should think about taking his troops out from Afghanistan and leave it to Afghans to rebuild their country,"" Taliban spokesman Zabihullah Mujahid told Reuters by telephone from an undisclosed location.",241,248,Reuters,0,2,2
3IH9TRB0FB0D7YI6ZR6FTBY8ADTI1D,"The message was that instead of signing a strategic partnership deal with Afghanistan, he should think about taking his troops out from Afghanistan and leave it to Afghans to rebuild their country,"" Taliban spokesman Zabihullah Mujahid told Reuters by telephone from an undisclosed location.",270,281,undisclosed,6,6,12
3IH9TRB0FB0D7YI6ZR6FTBY8ADTI1D,"The message was that instead of signing a strategic partnership deal with Afghanistan, he should think about taking his troops out from Afghanistan and leave it to Afghans to rebuild their country,"" Taliban spokesman Zabihullah Mujahid told Reuters by telephone from an undisclosed location.",270,290,undisclosed location,2,4,6
3IH9TRB0FB0D7YI6ZR6FTBY8ADTI1D,"But America's Kabul ambassador, Ryan Crocker, said involvement of the Haqqani network - which Washington believes is based in Pakistan's North Waziristan region and which it blames for high-profile attacks in Kabul in April - could not be ruled out.",20,30,ambassador,2,0,2
3IH9TRB0FB0D7YI6ZR6FTBY8ADTI1D,"But America's Kabul ambassador, Ryan Crocker, said involvement of the Haqqani network - which Washington believes is based in Pakistan's North Waziristan region and which it blames for high-profile attacks in Kabul in April - could not be ruled out.",51,62,involvement,3,5,8
3IH9TRB0FB0D7YI6ZR6FTBY8ADTI1D,"But America's Kabul ambassador, Ryan Crocker, said involvement of the Haqqani network - which Washington believes is based in Pakistan's North Waziristan region and which it blames for high-profile attacks in Kabul in April - could not be ruled out.",78,85,network,1,1,2
3IH9TRB0FB0D7YI6ZR6FTBY8ADTI1D,"But America's Kabul ambassador, Ryan Crocker, said involvement of the Haqqani network - which Washington believes is based in Pakistan's North Waziristan region and which it blames for high-profile attacks in Kabul in April - could not be ruled out.",143,153,Waziristan,0,1,1
3IH9TRB0FB0D7YI6ZR6FTBY8ADTI1D,"But America's Kabul ambassador, Ryan Crocker, said involvement of the Haqqani network - which Washington believes is based in Pakistan's North Waziristan region and which it blames for high-profile attacks in Kabul in April - could not be ruled out.",174,180,blames,1,2,3
3IH9TRB0FB0D7YI6ZR6FTBY8ADTI1D,"But America's Kabul ambassador, Ryan Crocker, said involvement of the Haqqani network - which Washington believes is based in Pakistan's North Waziristan region and which it blames for high-profile attacks in Kabul in April - could not be ruled out.",185,197,high-profile,3,4,7
3IH9TRB0FB0D7YI6ZR6FTBY8ADTI1D,"But America's Kabul ambassador, Ryan Crocker, said involvement of the Haqqani network - which Washington believes is based in Pakistan's North Waziristan region and which it blames for high-profile attacks in Kabul in April - could not be ruled out.",185,205,high-profile attacks,3,4,7
3IH9TRB0FB0D7YI6ZR6FTBY8ADTI1D,"But America's Kabul ambassador, Ryan Crocker, said involvement of the Haqqani network - which Washington believes is based in Pakistan's North Waziristan region and which it blames for high-profile attacks in Kabul in April - could not be ruled out.",239,244,ruled,0,2,2
3IH9TRB0FB0D7YI6ZR6FTBY8ADTI1D,"But America's Kabul ambassador, Ryan Crocker, said involvement of the Haqqani network - which Washington believes is based in Pakistan's North Waziristan region and which it blames for high-profile attacks in Kabul in April - could not be ruled out.",239,248,ruled out,0,1,1
3U18MJKL1UNP823VC48RFFDG0XZNCL,The LCC also posted dire reports of the military aiming mortars and heavy artillery at the Homs village of Al-Burnhanieh.,4,7,LCC,1,0,1
3U18MJKL1UNP823VC48RFFDG0XZNCL,The LCC also posted dire reports of the military aiming mortars and heavy artillery at the Homs village of Al-Burnhanieh.,20,24,dire,9,4,13
3U18MJKL1UNP823VC48RFFDG0XZNCL,The LCC also posted dire reports of the military aiming mortars and heavy artillery at the Homs village of Al-Burnhanieh.,20,32,dire reports,2,4,6
3U18MJKL1UNP823VC48RFFDG0XZNCL,The LCC also posted dire reports of the military aiming mortars and heavy artillery at the Homs village of Al-Burnhanieh.,40,48,military,1,0,1
3U18MJKL1UNP823VC48RFFDG0XZNCL,The LCC also posted dire reports of the military aiming mortars and heavy artillery at the Homs village of Al-Burnhanieh.,40,63,military aiming mortars,0,2,2
3U18MJKL1UNP823VC48RFFDG0XZNCL,The LCC also posted dire reports of the military aiming mortars and heavy artillery at the Homs village of Al-Burnhanieh.,49,55,aiming,0,2,2
3U18MJKL1UNP823VC48RFFDG0XZNCL,The LCC also posted dire reports of the military aiming mortars and heavy artillery at the Homs village of Al-Burnhanieh.,49,63,aiming mortars,2,0,2
3U18MJKL1UNP823VC48RFFDG0XZNCL,The LCC also posted dire reports of the military aiming mortars and heavy artillery at the Homs village of Al-Burnhanieh.,56,63,mortars,10,4,14
3U18MJKL1UNP823VC48RFFDG0XZNCL,The LCC also posted dire reports of the military aiming mortars and heavy artillery at the Homs village of Al-Burnhanieh.,68,83,heavy artillery,2,2,4
3U18MJKL1UNP823VC48RFFDG0XZNCL,The LCC also posted dire reports of the military aiming mortars and heavy artillery at the Homs village of Al-Burnhanieh.,74,83,artillery,10,2,12
3U18MJKL1UNP823VC48RFFDG0XZNCL,Violence from the Syian conflict isn't confined to the country's borders.,0,8,Violence,0,2,2
3U18MJKL1UNP823VC48RFFDG0XZNCL,Violence from the Syian conflict isn't confined to the country's borders.,24,32,conflict,1,2,3
3U18MJKL1UNP823VC48RFFDG0XZNCL,Violence from the Syian conflict isn't confined to the country's borders.,39,47,confined,5,6,11
3U18MJKL1UNP823VC48RFFDG0XZNCL,"In neighboring Lebanon, at least one person was killed and 45 others wounded in ongoing violence, Lebanon's National News Agency reported Monday.",3,14,neighboring,2,0,2
3U18MJKL1UNP823VC48RFFDG0XZNCL,"In neighboring Lebanon, at least one person was killed and 45 others wounded in ongoing violence, Lebanon's National News Agency reported Monday.",69,76,wounded,0,2,2
3U18MJKL1UNP823VC48RFFDG0XZNCL,"In neighboring Lebanon, at least one person was killed and 45 others wounded in ongoing violence, Lebanon's National News Agency reported Monday.",80,87,ongoing,0,1,1
3U18MJKL1UNP823VC48RFFDG0XZNCL,"In neighboring Lebanon, at least one person was killed and 45 others wounded in ongoing violence, Lebanon's National News Agency reported Monday.",80,96,ongoing violence,2,1,3
3U18MJKL1UNP823VC48RFFDG0XZNCL,"In neighboring Lebanon, at least one person was killed and 45 others wounded in ongoing violence, Lebanon's National News Agency reported Monday.",88,96,violence,0,1,1
3U18MJKL1UNP823VC48RFFDG0XZNCL,"The fighting in Lebanon pits residents of Bab al-Tebbaneh, a Sunni stronghold hostile to the Syrian regime, against Alawite residents of Jabal Mohsen, who support Syrian President Bashar al-Assad.",24,28,pits,5,4,9
3U18MJKL1UNP823VC48RFFDG0XZNCL,"The fighting in Lebanon pits residents of Bab al-Tebbaneh, a Sunni stronghold hostile to the Syrian regime, against Alawite residents of Jabal Mohsen, who support Syrian President Bashar al-Assad.",24,38,pits residents,0,1,1
3U18MJKL1UNP823VC48RFFDG0XZNCL,"The fighting in Lebanon pits residents of Bab al-Tebbaneh, a Sunni stronghold hostile to the Syrian regime, against Alawite residents of Jabal Mohsen, who support Syrian President Bashar al-Assad.",61,66,Sunni,0,1,1
3U18MJKL1UNP823VC48RFFDG0XZNCL,"The fighting in Lebanon pits residents of Bab al-Tebbaneh, a Sunni stronghold hostile to the Syrian regime, against Alawite residents of Jabal Mohsen, who support Syrian President Bashar al-Assad.",67,77,stronghold,4,7,11
3U18MJKL1UNP823VC48RFFDG0XZNCL,"The fighting in Lebanon pits residents of Bab al-Tebbaneh, a Sunni stronghold hostile to the Syrian regime, against Alawite residents of Jabal Mohsen, who support Syrian President Bashar al-Assad.",67,85,stronghold hostile,2,2,4
3U18MJKL1UNP823VC48RFFDG0XZNCL,"The fighting in Lebanon pits residents of Bab al-Tebbaneh, a Sunni stronghold hostile to the Syrian regime, against Alawite residents of Jabal Mohsen, who support Syrian President Bashar al-Assad.",78,85,hostile,5,5,10
3U18MJKL1UNP823VC48RFFDG0XZNCL,"The fighting in Lebanon pits residents of Bab al-Tebbaneh, a Sunni stronghold hostile to the Syrian regime, against Alawite residents of Jabal Mohsen, who support Syrian President Bashar al-Assad.",93,106,Syrian regime,1,0,1
3U18MJKL1UNP823VC48RFFDG0XZNCL,"The fighting in Lebanon pits residents of Bab al-Tebbaneh, a Sunni stronghold hostile to the Syrian regime, against Alawite residents of Jabal Mohsen, who support Syrian President Bashar al-Assad.",100,106,regime,2,2,4
3U18MJKL1UNP823VC48RFFDG0XZNCL,"The fighting in Lebanon pits residents of Bab al-Tebbaneh, a Sunni stronghold hostile to the Syrian regime, against Alawite residents of Jabal Mohsen, who support Syrian President Bashar al-Assad.",116,123,Alawite,0,1,1
3U18MJKL1UNP823VC48RFFDG0XZNCL,"Clashes that began Sunday in Lebanon ignited over the arrest of Islamist activist Chadi Mawlawi, who the Lebanese government accuses of being an operative in Al-Qaeda-inspired group.",0,7,Clashes,1,1,2
3U18MJKL1UNP823VC48RFFDG0XZNCL,"Clashes that began Sunday in Lebanon ignited over the arrest of Islamist activist Chadi Mawlawi, who the Lebanese government accuses of being an operative in Al-Qaeda-inspired group.",37,44,ignited,10,10,20
3U18MJKL1UNP823VC48RFFDG0XZNCL,"Clashes that began Sunday in Lebanon ignited over the arrest of Islamist activist Chadi Mawlawi, who the Lebanese government accuses of being an operative in Al-Qaeda-inspired group.",64,81,Islamist activist,2,1,3
3U18MJKL1UNP823VC48RFFDG0XZNCL,"Clashes that began Sunday in Lebanon ignited over the arrest of Islamist activist Chadi Mawlawi, who the Lebanese government accuses of being an operative in Al-Qaeda-inspired group.",114,124,government,1,0,1
3U18MJKL1UNP823VC48RFFDG0XZNCL,"Clashes that began Sunday in Lebanon ignited over the arrest of Islamist activist Chadi Mawlawi, who the Lebanese government accuses of being an operative in Al-Qaeda-inspired group.",125,132,accuses,2,4,6
3U18MJKL1UNP823VC48RFFDG0XZNCL,"Clashes that began Sunday in Lebanon ignited over the arrest of Islamist activist Chadi Mawlawi, who the Lebanese government accuses of being an operative in Al-Qaeda-inspired group.",145,154,operative,9,1,10
3U18MJKL1UNP823VC48RFFDG0XZNCL,"Clashes that began Sunday in Lebanon ignited over the arrest of Islamist activist Chadi Mawlawi, who the Lebanese government accuses of being an operative in Al-Qaeda-inspired group.",158,175,Al-Qaeda-inspired,0,1,1
3U18MJKL1UNP823VC48RFFDG0XZNCL,But his relatives deny the accusation.,18,22,deny,1,1,2
3U18MJKL1UNP823VC48RFFDG0XZNCL,But his relatives deny the accusation.,18,37,deny the accusation,1,0,1
3U18MJKL1UNP823VC48RFFDG0XZNCL,But his relatives deny the accusation.,27,37,accusation,9,6,15
3U18MJKL1UNP823VC48RFFDG0XZNCL,"Ali Hajar, one of Mawlawi's cousins, said Mawlawi supports the Syrian rebels and is trying to help Syrian refugees by providing them with shelter and food.",70,76,rebels,2,1,3
3U18MJKL1UNP823VC48RFFDG0XZNCL,"Ali Hajar, one of Mawlawi's cousins, said Mawlawi supports the Syrian rebels and is trying to help Syrian refugees by providing them with shelter and food.",99,114,Syrian refugees,1,0,1
3U18MJKL1UNP823VC48RFFDG0XZNCL,"Ali Hajar, one of Mawlawi's cousins, said Mawlawi supports the Syrian rebels and is trying to help Syrian refugees by providing them with shelter and food.",106,114,refugees,2,4,6
3U18MJKL1UNP823VC48RFFDG0XZNCL,"Ali Hajar, one of Mawlawi's cousins, said Mawlawi supports the Syrian rebels and is trying to help Syrian refugees by providing them with shelter and food.",138,145,shelter,1,0,1
3MNJFORX8B5SLPHZZ626T4YX616F51,"In Pictures: Winning hearts and minds in Afghanistan Taliban militants detonated a car bomb outside a private, heavily fortified compound home to mostly foreigners at about 6:15 a.m. on Wednesday morning.",13,27,Winning hearts,1,0,1
3MNJFORX8B5SLPHZZ626T4YX616F51,"In Pictures: Winning hearts and minds in Afghanistan Taliban militants detonated a car bomb outside a private, heavily fortified compound home to mostly foreigners at about 6:15 a.m. on Wednesday morning.",61,70,militants,6,2,8
3MNJFORX8B5SLPHZZ626T4YX616F51,"In Pictures: Winning hearts and minds in Afghanistan Taliban militants detonated a car bomb outside a private, heavily fortified compound home to mostly foreigners at about 6:15 a.m. on Wednesday morning.",61,80,militants detonated,1,1,2
3MNJFORX8B5SLPHZZ626T4YX616F51,"In Pictures: Winning hearts and minds in Afghanistan Taliban militants detonated a car bomb outside a private, heavily fortified compound home to mostly foreigners at about 6:15 a.m. on Wednesday morning.",71,80,detonated,6,10,16
3MNJFORX8B5SLPHZZ626T4YX616F51,"In Pictures: Winning hearts and minds in Afghanistan Taliban militants detonated a car bomb outside a private, heavily fortified compound home to mostly foreigners at about 6:15 a.m. on Wednesday morning.",111,137,heavily fortified compound,1,0,1
3MNJFORX8B5SLPHZZ626T4YX616F51,"In Pictures: Winning hearts and minds in Afghanistan Taliban militants detonated a car bomb outside a private, heavily fortified compound home to mostly foreigners at about 6:15 a.m. on Wednesday morning.",119,128,fortified,10,10,20
3MNJFORX8B5SLPHZZ626T4YX616F51,"In Pictures: Winning hearts and minds in Afghanistan Taliban militants detonated a car bomb outside a private, heavily fortified compound home to mostly foreigners at about 6:15 a.m. on Wednesday morning.",129,137,compound,0,3,3
3MNJFORX8B5SLPHZZ626T4YX616F51,"In Pictures: Winning hearts and minds in Afghanistan Taliban militants detonated a car bomb outside a private, heavily fortified compound home to mostly foreigners at about 6:15 a.m. on Wednesday morning.",129,142,compound home,2,0,2
3MNJFORX8B5SLPHZZ626T4YX616F51,"In Pictures: Winning hearts and minds in Afghanistan Taliban militants detonated a car bomb outside a private, heavily fortified compound home to mostly foreigners at about 6:15 a.m. on Wednesday morning.",153,163,foreigners,0,1,1
3MNJFORX8B5SLPHZZ626T4YX616F51,Afghan security forces and Taliban militants then exchanged gunfire.,7,22,security forces,1,0,1
3MNJFORX8B5SLPHZZ626T4YX616F51,Afghan security forces and Taliban militants then exchanged gunfire.,27,34,Taliban,1,0,1
3MNJFORX8B5SLPHZZ626T4YX616F51,Afghan security forces and Taliban militants then exchanged gunfire.,35,44,militants,5,2,7
3MNJFORX8B5SLPHZZ626T4YX616F51,Afghan security forces and Taliban militants then exchanged gunfire.,50,59,exchanged,1,4,5
3MNJFORX8B5SLPHZZ626T4YX616F51,Afghan security forces and Taliban militants then exchanged gunfire.,50,67,exchanged gunfire,0,1,1
3MNJFORX8B5SLPHZZ626T4YX616F51,Afghan security forces and Taliban militants then exchanged gunfire.,60,67,gunfire,0,1,1
3MNJFORX8B5SLPHZZ626T4YX616F51,"Afghan police officials say the situation was under control by 9:00 a.m., but the incident left at least 7 people dead and some 17 people injured.",32,41,situation,1,1,2
3MNJFORX8B5SLPHZZ626T4YX616F51,"Afghan police officials say the situation was under control by 9:00 a.m., but the incident left at least 7 people dead and some 17 people injured.",82,90,incident,2,4,6
3MNJFORX8B5SLPHZZ626T4YX616F51,"The explosion came shortly after Mr. Obama gave a speech invoking ""a new dawn"" with the signing of a US-Afghanistan strategic partnership agreement.",4,13,explosion,2,4,6
3MNJFORX8B5SLPHZZ626T4YX616F51,"The explosion came shortly after Mr. Obama gave a speech invoking ""a new dawn"" with the signing of a US-Afghanistan strategic partnership agreement.",19,26,shortly,0,1,1
3MNJFORX8B5SLPHZZ626T4YX616F51,"The explosion came shortly after Mr. Obama gave a speech invoking ""a new dawn"" with the signing of a US-Afghanistan strategic partnership agreement.",57,65,invoking,5,6,11
3MNJFORX8B5SLPHZZ626T4YX616F51,"The explosion came shortly after Mr. Obama gave a speech invoking ""a new dawn"" with the signing of a US-Afghanistan strategic partnership agreement.",67,77,a new dawn,0,1,1
3MNJFORX8B5SLPHZZ626T4YX616F51,"The explosion came shortly after Mr. Obama gave a speech invoking ""a new dawn"" with the signing of a US-Afghanistan strategic partnership agreement.",69,77,new dawn,0,2,2
3MNJFORX8B5SLPHZZ626T4YX616F51,"The explosion came shortly after Mr. Obama gave a speech invoking ""a new dawn"" with the signing of a US-Afghanistan strategic partnership agreement.",73,77,dawn,1,1,2
3MNJFORX8B5SLPHZZ626T4YX616F51,"The explosion came shortly after Mr. Obama gave a speech invoking ""a new dawn"" with the signing of a US-Afghanistan strategic partnership agreement.",116,125,strategic,4,4,8
3MNJFORX8B5SLPHZZ626T4YX616F51,"The explosion came shortly after Mr. Obama gave a speech invoking ""a new dawn"" with the signing of a US-Afghanistan strategic partnership agreement.",116,137,strategic partnership,0,2,2
3MNJFORX8B5SLPHZZ626T4YX616F51,"The explosion came shortly after Mr. Obama gave a speech invoking ""a new dawn"" with the signing of a US-Afghanistan strategic partnership agreement.",116,147,strategic partnership agreement,3,0,3
3MNJFORX8B5SLPHZZ626T4YX616F51,"The explosion came shortly after Mr. Obama gave a speech invoking ""a new dawn"" with the signing of a US-Afghanistan strategic partnership agreement.",126,147,partnership agreement,0,1,1
3MNJFORX8B5SLPHZZ626T4YX616F51,"The explosion came shortly after Mr. Obama gave a speech invoking ""a new dawn"" with the signing of a US-Afghanistan strategic partnership agreement.",138,147,agreement,0,1,1
3MNJFORX8B5SLPHZZ626T4YX616F51,"The incident not only underscores the difficulties that remain as Afghan security forces take control of increasingly larger share of the country, but also the potential fallout from the Afghan insurgency during high-profile visits.",22,33,underscores,10,10,20
3MNJFORX8B5SLPHZZ626T4YX616F51,"The incident not only underscores the difficulties that remain as Afghan security forces take control of increasingly larger share of the country, but also the potential fallout from the Afghan insurgency during high-profile visits.",38,50,difficulties,1,1,2
3MNJFORX8B5SLPHZZ626T4YX616F51,"The incident not only underscores the difficulties that remain as Afghan security forces take control of increasingly larger share of the country, but also the potential fallout from the Afghan insurgency during high-profile visits.",73,88,security forces,1,0,1
3MNJFORX8B5SLPHZZ626T4YX616F51,"The incident not only underscores the difficulties that remain as Afghan security forces take control of increasingly larger share of the country, but also the potential fallout from the Afghan insurgency during high-profile visits.",105,117,increasingly,3,1,4
3MNJFORX8B5SLPHZZ626T4YX616F51,"The incident not only underscores the difficulties that remain as Afghan security forces take control of increasingly larger share of the country, but also the potential fallout from the Afghan insurgency during high-profile visits.",160,169,potential,3,5,8
3MNJFORX8B5SLPHZZ626T4YX616F51,"The incident not only underscores the difficulties that remain as Afghan security forces take control of increasingly larger share of the country, but also the potential fallout from the Afghan insurgency during high-profile visits.",160,177,potential fallout,3,4,7
3MNJFORX8B5SLPHZZ626T4YX616F51,"The incident not only underscores the difficulties that remain as Afghan security forces take control of increasingly larger share of the country, but also the potential fallout from the Afghan insurgency during high-profile visits.",170,177,fallout,3,3,6
3MNJFORX8B5SLPHZZ626T4YX616F51,"The incident not only underscores the difficulties that remain as Afghan security forces take control of increasingly larger share of the country, but also the potential fallout from the Afghan insurgency during high-profile visits.",194,204,insurgency,10,9,19
3MNJFORX8B5SLPHZZ626T4YX616F51,"The incident not only underscores the difficulties that remain as Afghan security forces take control of increasingly larger share of the country, but also the potential fallout from the Afghan insurgency during high-profile visits.",212,224,high-profile,1,1,2
3MNJFORX8B5SLPHZZ626T4YX616F51,"The incident not only underscores the difficulties that remain as Afghan security forces take control of increasingly larger share of the country, but also the potential fallout from the Afghan insurgency during high-profile visits.",212,231,high-profile visits,1,1,2
3SSN80MU8CPC3UTN6NCY10HM8XLKX9,"The observatory, a Grade II listed building, is not in use at present.",4,15,observatory,9,10,19
3SSN80MU8CPC3UTN6NCY10HM8XLKX9,"The observatory, a Grade II listed building, is not in use at present.",28,43,listed building,0,1,1
3SSN80MU8CPC3UTN6NCY10HM8XLKX9,"A spokeswoman for Merseyside Police said: ""Crime scene investigators are in attendance at the scene and officers are appealing to anyone who may have seen anyone acting suspiciously on Bidston Hill over the last few days to come forward.",2,13,spokeswoman,5,5,10
3SSN80MU8CPC3UTN6NCY10HM8XLKX9,"A spokeswoman for Merseyside Police said: ""Crime scene investigators are in attendance at the scene and officers are appealing to anyone who may have seen anyone acting suspiciously on Bidston Hill over the last few days to come forward.",43,54,Crime scene,0,1,1
3SSN80MU8CPC3UTN6NCY10HM8XLKX9,"A spokeswoman for Merseyside Police said: ""Crime scene investigators are in attendance at the scene and officers are appealing to anyone who may have seen anyone acting suspiciously on Bidston Hill over the last few days to come forward.",43,68,Crime scene investigators,2,2,4
3SSN80MU8CPC3UTN6NCY10HM8XLKX9,"A spokeswoman for Merseyside Police said: ""Crime scene investigators are in attendance at the scene and officers are appealing to anyone who may have seen anyone acting suspiciously on Bidston Hill over the last few days to come forward.",55,68,investigators,2,2,4
3SSN80MU8CPC3UTN6NCY10HM8XLKX9,"A spokeswoman for Merseyside Police said: ""Crime scene investigators are in attendance at the scene and officers are appealing to anyone who may have seen anyone acting suspiciously on Bidston Hill over the last few days to come forward.",73,86,in attendance,1,0,1
3SSN80MU8CPC3UTN6NCY10HM8XLKX9,"A spokeswoman for Merseyside Police said: ""Crime scene investigators are in attendance at the scene and officers are appealing to anyone who may have seen anyone acting suspiciously on Bidston Hill over the last few days to come forward.",76,86,attendance,3,1,4
3SSN80MU8CPC3UTN6NCY10HM8XLKX9,"A spokeswoman for Merseyside Police said: ""Crime scene investigators are in attendance at the scene and officers are appealing to anyone who may have seen anyone acting suspiciously on Bidston Hill over the last few days to come forward.",117,126,appealing,5,5,10
3SSN80MU8CPC3UTN6NCY10HM8XLKX9,"A spokeswoman for Merseyside Police said: ""Crime scene investigators are in attendance at the scene and officers are appealing to anyone who may have seen anyone acting suspiciously on Bidston Hill over the last few days to come forward.",155,181,anyone acting suspiciously,1,0,1
3SSN80MU8CPC3UTN6NCY10HM8XLKX9,"A spokeswoman for Merseyside Police said: ""Crime scene investigators are in attendance at the scene and officers are appealing to anyone who may have seen anyone acting suspiciously on Bidston Hill over the last few days to come forward.",162,181,acting suspiciously,1,1,2
3SSN80MU8CPC3UTN6NCY10HM8XLKX9,"A spokeswoman for Merseyside Police said: ""Crime scene investigators are in attendance at the scene and officers are appealing to anyone who may have seen anyone acting suspiciously on Bidston Hill over the last few days to come forward.",169,181,suspiciously,10,6,16
3SSN80MU8CPC3UTN6NCY10HM8XLKX9,The 18-year-old man arrested on suspicion of murder has been taken to a police station where he will be interviewed by detectives.,33,42,suspicion,6,5,11
3SSN80MU8CPC3UTN6NCY10HM8XLKX9,The 18-year-old man arrested on suspicion of murder has been taken to a police station where he will be interviewed by detectives.,33,52,suspicion of murder,0,2,2
3SSN80MU8CPC3UTN6NCY10HM8XLKX9,The 18-year-old man arrested on suspicion of murder has been taken to a police station where he will be interviewed by detectives.,105,116,interviewed,2,0,2
3SSN80MU8CPC3UTN6NCY10HM8XLKX9,The 18-year-old man arrested on suspicion of murder has been taken to a police station where he will be interviewed by detectives.,120,130,detectives,1,4,5
3SSN80MU8CPC3UTN6NCY10HM8XLKX9,Google says authorities in China have approved its acquisition of Motorola Mobility.,0,6,Google,0,1,1
3SSN80MU8CPC3UTN6NCY10HM8XLKX9,Google says authorities in China have approved its acquisition of Motorola Mobility.,12,23,authorities,2,1,3
3SSN80MU8CPC3UTN6NCY10HM8XLKX9,Google says authorities in China have approved its acquisition of Motorola Mobility.,38,46,approved,1,0,1
3SSN80MU8CPC3UTN6NCY10HM8XLKX9,Google says authorities in China have approved its acquisition of Motorola Mobility.,51,62,acquisition,10,9,19
3SSN80MU8CPC3UTN6NCY10HM8XLKX9,This brings the Internet search giant closer to completing its biggest deal ever.,5,11,brings,0,1,1
3SSN80MU8CPC3UTN6NCY10HM8XLKX9,This brings the Internet search giant closer to completing its biggest deal ever.,16,37,Internet search giant,0,2,2
3SSN80MU8CPC3UTN6NCY10HM8XLKX9,This brings the Internet search giant closer to completing its biggest deal ever.,25,37,search giant,1,1,2
3SSN80MU8CPC3UTN6NCY10HM8XLKX9,The deal was announced last August and had received all necessary regulatory approvals except in China.,13,22,announced,2,0,2
3SSN80MU8CPC3UTN6NCY10HM8XLKX9,The deal was announced last August and had received all necessary regulatory approvals except in China.,52,86,all necessary regulatory approvals,1,0,1
3SSN80MU8CPC3UTN6NCY10HM8XLKX9,The deal was announced last August and had received all necessary regulatory approvals except in China.,56,76,necessary regulatory,1,0,1
3SSN80MU8CPC3UTN6NCY10HM8XLKX9,The deal was announced last August and had received all necessary regulatory approvals except in China.,56,86,necessary regulatory approvals,2,1,3
3SSN80MU8CPC3UTN6NCY10HM8XLKX9,The deal was announced last August and had received all necessary regulatory approvals except in China.,66,76,regulatory,6,0,6
3SSN80MU8CPC3UTN6NCY10HM8XLKX9,The deal was announced last August and had received all necessary regulatory approvals except in China.,66,86,regulatory approvals,2,4,6
3SSN80MU8CPC3UTN6NCY10HM8XLKX9,The deal was announced last August and had received all necessary regulatory approvals except in China.,77,86,approvals,1,0,1
30Z7M1Q8UYLGCGJTMONHRNXXCCI8AA,He did not describe the nature of the calls.,11,19,describe,0,1,1
30Z7M1Q8UYLGCGJTMONHRNXXCCI8AA,He did not describe the nature of the calls.,20,30,the nature,1,0,1
30Z7M1Q8UYLGCGJTMONHRNXXCCI8AA,He did not describe the nature of the calls.,24,30,nature,3,0,3
30Z7M1Q8UYLGCGJTMONHRNXXCCI8AA,"Google Inc. (GOOG) won approval from Chinese regulators for its $12.5 billion purchase of Motorola Mobility Holdings Inc. (MMI), clearing a final hurdle for a deal that boosts its patents portfolio and steps up competition with Apple Inc. “We are pleased the deal has received approval in all jurisdictions,” Motorola Mobility said in an e-mailed statement yesterday, confirming that the transaction has been approved in China.",13,17,GOOG,1,0,1
30Z7M1Q8UYLGCGJTMONHRNXXCCI8AA,"Google Inc. (GOOG) won approval from Chinese regulators for its $12.5 billion purchase of Motorola Mobility Holdings Inc. (MMI), clearing a final hurdle for a deal that boosts its patents portfolio and steps up competition with Apple Inc. “We are pleased the deal has received approval in all jurisdictions,” Motorola Mobility said in an e-mailed statement yesterday, confirming that the transaction has been approved in China.",23,31,approval,0,2,2
30Z7M1Q8UYLGCGJTMONHRNXXCCI8AA,"Google Inc. (GOOG) won approval from Chinese regulators for its $12.5 billion purchase of Motorola Mobility Holdings Inc. (MMI), clearing a final hurdle for a deal that boosts its patents portfolio and steps up competition with Apple Inc. “We are pleased the deal has received approval in all jurisdictions,” Motorola Mobility said in an e-mailed statement yesterday, confirming that the transaction has been approved in China.",45,55,regulators,7,4,11
30Z7M1Q8UYLGCGJTMONHRNXXCCI8AA,"Google Inc. (GOOG) won approval from Chinese regulators for its $12.5 billion purchase of Motorola Mobility Holdings Inc. (MMI), clearing a final hurdle for a deal that boosts its patents portfolio and steps up competition with Apple Inc. “We are pleased the deal has received approval in all jurisdictions,” Motorola Mobility said in an e-mailed statement yesterday, confirming that the transaction has been approved in China.",108,116,Holdings,1,0,1
30Z7M1Q8UYLGCGJTMONHRNXXCCI8AA,"Google Inc. (GOOG) won approval from Chinese regulators for its $12.5 billion purchase of Motorola Mobility Holdings Inc. (MMI), clearing a final hurdle for a deal that boosts its patents portfolio and steps up competition with Apple Inc. “We are pleased the deal has received approval in all jurisdictions,” Motorola Mobility said in an e-mailed statement yesterday, confirming that the transaction has been approved in China.",140,152,final hurdle,2,2,4
30Z7M1Q8UYLGCGJTMONHRNXXCCI8AA,"Google Inc. (GOOG) won approval from Chinese regulators for its $12.5 billion purchase of Motorola Mobility Holdings Inc. (MMI), clearing a final hurdle for a deal that boosts its patents portfolio and steps up competition with Apple Inc. “We are pleased the deal has received approval in all jurisdictions,” Motorola Mobility said in an e-mailed statement yesterday, confirming that the transaction has been approved in China.",146,152,hurdle,4,10,14
30Z7M1Q8UYLGCGJTMONHRNXXCCI8AA,"Google Inc. (GOOG) won approval from Chinese regulators for its $12.5 billion purchase of Motorola Mobility Holdings Inc. (MMI), clearing a final hurdle for a deal that boosts its patents portfolio and steps up competition with Apple Inc. “We are pleased the deal has received approval in all jurisdictions,” Motorola Mobility said in an e-mailed statement yesterday, confirming that the transaction has been approved in China.",169,175,boosts,3,5,8
30Z7M1Q8UYLGCGJTMONHRNXXCCI8AA,"Google Inc. (GOOG) won approval from Chinese regulators for its $12.5 billion purchase of Motorola Mobility Holdings Inc. (MMI), clearing a final hurdle for a deal that boosts its patents portfolio and steps up competition with Apple Inc. “We are pleased the deal has received approval in all jurisdictions,” Motorola Mobility said in an e-mailed statement yesterday, confirming that the transaction has been approved in China.",180,187,patents,2,2,4
30Z7M1Q8UYLGCGJTMONHRNXXCCI8AA,"Google Inc. (GOOG) won approval from Chinese regulators for its $12.5 billion purchase of Motorola Mobility Holdings Inc. (MMI), clearing a final hurdle for a deal that boosts its patents portfolio and steps up competition with Apple Inc. “We are pleased the deal has received approval in all jurisdictions,” Motorola Mobility said in an e-mailed statement yesterday, confirming that the transaction has been approved in China.",180,197,patents portfolio,6,2,8
30Z7M1Q8UYLGCGJTMONHRNXXCCI8AA,"Google Inc. (GOOG) won approval from Chinese regulators for its $12.5 billion purchase of Motorola Mobility Holdings Inc. (MMI), clearing a final hurdle for a deal that boosts its patents portfolio and steps up competition with Apple Inc. “We are pleased the deal has received approval in all jurisdictions,” Motorola Mobility said in an e-mailed statement yesterday, confirming that the transaction has been approved in China.",188,197,portfolio,2,7,9
30Z7M1Q8UYLGCGJTMONHRNXXCCI8AA,"Google Inc. (GOOG) won approval from Chinese regulators for its $12.5 billion purchase of Motorola Mobility Holdings Inc. (MMI), clearing a final hurdle for a deal that boosts its patents portfolio and steps up competition with Apple Inc. “We are pleased the deal has received approval in all jurisdictions,” Motorola Mobility said in an e-mailed statement yesterday, confirming that the transaction has been approved in China.",211,222,competition,2,2,4
30Z7M1Q8UYLGCGJTMONHRNXXCCI8AA,"Google Inc. (GOOG) won approval from Chinese regulators for its $12.5 billion purchase of Motorola Mobility Holdings Inc. (MMI), clearing a final hurdle for a deal that boosts its patents portfolio and steps up competition with Apple Inc. “We are pleased the deal has received approval in all jurisdictions,” Motorola Mobility said in an e-mailed statement yesterday, confirming that the transaction has been approved in China.",293,306,jurisdictions,9,10,19
30Z7M1Q8UYLGCGJTMONHRNXXCCI8AA,"Google Inc. (GOOG) won approval from Chinese regulators for its $12.5 billion purchase of Motorola Mobility Holdings Inc. (MMI), clearing a final hurdle for a deal that boosts its patents portfolio and steps up competition with Apple Inc. “We are pleased the deal has received approval in all jurisdictions,” Motorola Mobility said in an e-mailed statement yesterday, confirming that the transaction has been approved in China.",293,308,"jurisdictions,”",1,0,1
30Z7M1Q8UYLGCGJTMONHRNXXCCI8AA,"Google Inc. (GOOG) won approval from Chinese regulators for its $12.5 billion purchase of Motorola Mobility Holdings Inc. (MMI), clearing a final hurdle for a deal that boosts its patents portfolio and steps up competition with Apple Inc. “We are pleased the deal has received approval in all jurisdictions,” Motorola Mobility said in an e-mailed statement yesterday, confirming that the transaction has been approved in China.",347,356,statement,2,0,2
30Z7M1Q8UYLGCGJTMONHRNXXCCI8AA,"Google Inc. (GOOG) won approval from Chinese regulators for its $12.5 billion purchase of Motorola Mobility Holdings Inc. (MMI), clearing a final hurdle for a deal that boosts its patents portfolio and steps up competition with Apple Inc. “We are pleased the deal has received approval in all jurisdictions,” Motorola Mobility said in an e-mailed statement yesterday, confirming that the transaction has been approved in China.",368,378,confirming,1,1,2
30Z7M1Q8UYLGCGJTMONHRNXXCCI8AA,"Google Inc. (GOOG) won approval from Chinese regulators for its $12.5 billion purchase of Motorola Mobility Holdings Inc. (MMI), clearing a final hurdle for a deal that boosts its patents portfolio and steps up competition with Apple Inc. “We are pleased the deal has received approval in all jurisdictions,” Motorola Mobility said in an e-mailed statement yesterday, confirming that the transaction has been approved in China.",388,399,transaction,5,1,6
30Z7M1Q8UYLGCGJTMONHRNXXCCI8AA,"Google Inc. (GOOG) won approval from Chinese regulators for its $12.5 billion purchase of Motorola Mobility Holdings Inc. (MMI), clearing a final hurdle for a deal that boosts its patents portfolio and steps up competition with Apple Inc. “We are pleased the deal has received approval in all jurisdictions,” Motorola Mobility said in an e-mailed statement yesterday, confirming that the transaction has been approved in China.",409,417,approved,0,1,1
30Z7M1Q8UYLGCGJTMONHRNXXCCI8AA,“We expect to close imminently.”,20,30,imminently,10,10,20
30Z7M1Q8UYLGCGJTMONHRNXXCCI8AA,"The deal helps Larry Page, the Google co-founder who took over as chief executive officer last year, push the Web company to better compete with Apple’s iPhone and gain more clout for its Android software as it expands in the hardware business.",38,48,co-founder,0,1,1
30Z7M1Q8UYLGCGJTMONHRNXXCCI8AA,"The deal helps Larry Page, the Google co-founder who took over as chief executive officer last year, push the Web company to better compete with Apple’s iPhone and gain more clout for its Android software as it expands in the hardware business.",66,89,chief executive officer,1,0,1
30Z7M1Q8UYLGCGJTMONHRNXXCCI8AA,"The deal helps Larry Page, the Google co-founder who took over as chief executive officer last year, push the Web company to better compete with Apple’s iPhone and gain more clout for its Android software as it expands in the hardware business.",72,81,executive,1,0,1
30Z7M1Q8UYLGCGJTMONHRNXXCCI8AA,"The deal helps Larry Page, the Google co-founder who took over as chief executive officer last year, push the Web company to better compete with Apple’s iPhone and gain more clout for its Android software as it expands in the hardware business.",132,139,compete,1,1,2
30Z7M1Q8UYLGCGJTMONHRNXXCCI8AA,"The deal helps Larry Page, the Google co-founder who took over as chief executive officer last year, push the Web company to better compete with Apple’s iPhone and gain more clout for its Android software as it expands in the hardware business.",174,179,clout,8,8,16
30Z7M1Q8UYLGCGJTMONHRNXXCCI8AA,"The deal helps Larry Page, the Google co-founder who took over as chief executive officer last year, push the Web company to better compete with Apple’s iPhone and gain more clout for its Android software as it expands in the hardware business.",188,204,Android software,1,0,1
30Z7M1Q8UYLGCGJTMONHRNXXCCI8AA,"The deal helps Larry Page, the Google co-founder who took over as chief executive officer last year, push the Web company to better compete with Apple’s iPhone and gain more clout for its Android software as it expands in the hardware business.",196,204,software,0,1,1
30Z7M1Q8UYLGCGJTMONHRNXXCCI8AA,"The deal helps Larry Page, the Google co-founder who took over as chief executive officer last year, push the Web company to better compete with Apple’s iPhone and gain more clout for its Android software as it expands in the hardware business.",211,218,expands,0,1,1
30Z7M1Q8UYLGCGJTMONHRNXXCCI8AA,"The deal helps Larry Page, the Google co-founder who took over as chief executive officer last year, push the Web company to better compete with Apple’s iPhone and gain more clout for its Android software as it expands in the hardware business.",226,234,hardware,0,3,3
30Z7M1Q8UYLGCGJTMONHRNXXCCI8AA,"It also gives Google, the worlds’ biggest maker of smartphone software, a trove of 17,000 patents to protect Android devices in legal disputes with competitors.",51,61,smartphone,1,0,1
30Z7M1Q8UYLGCGJTMONHRNXXCCI8AA,"It also gives Google, the worlds’ biggest maker of smartphone software, a trove of 17,000 patents to protect Android devices in legal disputes with competitors.",51,71,smartphone  software,0,1,1
30Z7M1Q8UYLGCGJTMONHRNXXCCI8AA,"It also gives Google, the worlds’ biggest maker of smartphone software, a trove of 17,000 patents to protect Android devices in legal disputes with competitors.",74,79,trove,5,5,10
30Z7M1Q8UYLGCGJTMONHRNXXCCI8AA,"It also gives Google, the worlds’ biggest maker of smartphone software, a trove of 17,000 patents to protect Android devices in legal disputes with competitors.",90,97,patents,3,1,4
30Z7M1Q8UYLGCGJTMONHRNXXCCI8AA,"It also gives Google, the worlds’ biggest maker of smartphone software, a trove of 17,000 patents to protect Android devices in legal disputes with competitors.",117,124,devices,0,2,2
30Z7M1Q8UYLGCGJTMONHRNXXCCI8AA,"It also gives Google, the worlds’ biggest maker of smartphone software, a trove of 17,000 patents to protect Android devices in legal disputes with competitors.",128,142,legal disputes,3,2,5
30Z7M1Q8UYLGCGJTMONHRNXXCCI8AA,"It also gives Google, the worlds’ biggest maker of smartphone software, a trove of 17,000 patents to protect Android devices in legal disputes with competitors.",134,142,disputes,4,4,8
30Z7M1Q8UYLGCGJTMONHRNXXCCI8AA,"It also gives Google, the worlds’ biggest maker of smartphone software, a trove of 17,000 patents to protect Android devices in legal disputes with competitors.",148,159,competitors,5,1,6
31D0ZWOD0A0YUREQRKA2Y8RFTE6A0P,"The daily death toll in Syria has declined as the number of observers has risen, but few experts expect the U.N. plan to succeed in its entirety.",4,20,daily death toll,1,0,1
31D0ZWOD0A0YUREQRKA2Y8RFTE6A0P,"The daily death toll in Syria has declined as the number of observers has risen, but few experts expect the U.N. plan to succeed in its entirety.",10,20,death toll,1,4,5
31D0ZWOD0A0YUREQRKA2Y8RFTE6A0P,"The daily death toll in Syria has declined as the number of observers has risen, but few experts expect the U.N. plan to succeed in its entirety.",16,20,toll,3,1,4
31D0ZWOD0A0YUREQRKA2Y8RFTE6A0P,"The daily death toll in Syria has declined as the number of observers has risen, but few experts expect the U.N. plan to succeed in its entirety.",34,42,declined,1,3,4
31D0ZWOD0A0YUREQRKA2Y8RFTE6A0P,"The daily death toll in Syria has declined as the number of observers has risen, but few experts expect the U.N. plan to succeed in its entirety.",60,69,observers,5,2,7
31D0ZWOD0A0YUREQRKA2Y8RFTE6A0P,"The daily death toll in Syria has declined as the number of observers has risen, but few experts expect the U.N. plan to succeed in its entirety.",70,79,has risen,0,1,1
31D0ZWOD0A0YUREQRKA2Y8RFTE6A0P,"The daily death toll in Syria has declined as the number of observers has risen, but few experts expect the U.N. plan to succeed in its entirety.",74,79,risen,1,1,2
31D0ZWOD0A0YUREQRKA2Y8RFTE6A0P,"The daily death toll in Syria has declined as the number of observers has risen, but few experts expect the U.N. plan to succeed in its entirety.",121,128,succeed,0,1,1
31D0ZWOD0A0YUREQRKA2Y8RFTE6A0P,"The daily death toll in Syria has declined as the number of observers has risen, but few experts expect the U.N. plan to succeed in its entirety.",121,144,succeed in its entirety,1,0,1
31D0ZWOD0A0YUREQRKA2Y8RFTE6A0P,"The daily death toll in Syria has declined as the number of observers has risen, but few experts expect the U.N. plan to succeed in its entirety.",136,144,entirety,5,7,12
31D0ZWOD0A0YUREQRKA2Y8RFTE6A0P,"The Observatory said a total of 19 civilians were killed nationwide, plus two rebels and 5 regime soldiers.",4,15,Observatory,3,3,6
31D0ZWOD0A0YUREQRKA2Y8RFTE6A0P,"The Observatory said a total of 19 civilians were killed nationwide, plus two rebels and 5 regime soldiers.",35,44,civilians,1,2,3
31D0ZWOD0A0YUREQRKA2Y8RFTE6A0P,"The Observatory said a total of 19 civilians were killed nationwide, plus two rebels and 5 regime soldiers.",57,67,nationwide,2,2,4
31D0ZWOD0A0YUREQRKA2Y8RFTE6A0P,"The Observatory said a total of 19 civilians were killed nationwide, plus two rebels and 5 regime soldiers.",78,84,rebels,2,1,3
31D0ZWOD0A0YUREQRKA2Y8RFTE6A0P,"The Observatory said a total of 19 civilians were killed nationwide, plus two rebels and 5 regime soldiers.",91,97,regime,6,3,9
31D0ZWOD0A0YUREQRKA2Y8RFTE6A0P,"The Observatory said a total of 19 civilians were killed nationwide, plus two rebels and 5 regime soldiers.",91,106,regime soldiers,1,1,2
31D0ZWOD0A0YUREQRKA2Y8RFTE6A0P,Activists also reported government attacks in rebellious Damascus suburbs.,0,9,Activists,0,4,4
31D0ZWOD0A0YUREQRKA2Y8RFTE6A0P,Activists also reported government attacks in rebellious Damascus suburbs.,24,34,government,2,0,2
31D0ZWOD0A0YUREQRKA2Y8RFTE6A0P,Activists also reported government attacks in rebellious Damascus suburbs.,46,56,rebellious,10,9,19
31D0ZWOD0A0YUREQRKA2Y8RFTE6A0P,Activists also reported government attacks in rebellious Damascus suburbs.,57,65,Damascus,0,1,1
31D0ZWOD0A0YUREQRKA2Y8RFTE6A0P,Activists also reported government attacks in rebellious Damascus suburbs.,66,73,suburbs,2,4,6
31D0ZWOD0A0YUREQRKA2Y8RFTE6A0P,Omar Hamza said via Skype that three people were killed early Sunday by shells and machine gun rounds fired at Douma.,72,78,shells,3,6,9
31D0ZWOD0A0YUREQRKA2Y8RFTE6A0P,Omar Hamza said via Skype that three people were killed early Sunday by shells and machine gun rounds fired at Douma.,111,116,Douma,0,1,1
31D0ZWOD0A0YUREQRKA2Y8RFTE6A0P,"The government was raiding other areas looking for activists, he said.",4,14,government,2,0,2
31D0ZWOD0A0YUREQRKA2Y8RFTE6A0P,"The government was raiding other areas looking for activists, he said.",19,26,raiding,2,6,8
31D0ZWOD0A0YUREQRKA2Y8RFTE6A0P,"The government was raiding other areas looking for activists, he said.",51,60,activists,2,1,3
31D0ZWOD0A0YUREQRKA2Y8RFTE6A0P,"The Observatory also reported three killed in suburbs east of the capital, one of them a rebel commander.",4,15,Observatory,1,0,1
31D0ZWOD0A0YUREQRKA2Y8RFTE6A0P,"The Observatory also reported three killed in suburbs east of the capital, one of them a rebel commander.",46,53,suburbs,4,4,8
31D0ZWOD0A0YUREQRKA2Y8RFTE6A0P,"The Observatory also reported three killed in suburbs east of the capital, one of them a rebel commander.",54,58,east,0,1,1
31D0ZWOD0A0YUREQRKA2Y8RFTE6A0P,"The Observatory also reported three killed in suburbs east of the capital, one of them a rebel commander.",89,94,rebel,2,2,4
31D0ZWOD0A0YUREQRKA2Y8RFTE6A0P,"The Observatory also reported three killed in suburbs east of the capital, one of them a rebel commander.",89,104,rebel commander,1,0,1
31D0ZWOD0A0YUREQRKA2Y8RFTE6A0P,"The Observatory also reported three killed in suburbs east of the capital, one of them a rebel commander.",95,104,commander,3,0,3
31D0ZWOD0A0YUREQRKA2Y8RFTE6A0P,Activist claims could not be independently verified.,0,8,Activist,1,0,1
31D0ZWOD0A0YUREQRKA2Y8RFTE6A0P,Activist claims could not be independently verified.,29,42,independently,3,0,3
31D0ZWOD0A0YUREQRKA2Y8RFTE6A0P,Activist claims could not be independently verified.,29,51,independently verified,4,4,8
31D0ZWOD0A0YUREQRKA2Y8RFTE6A0P,Activist claims could not be independently verified.,43,51,verified,2,1,3
31D0ZWOD0A0YUREQRKA2Y8RFTE6A0P,The Syrian government did not comment on the reports and bars most media from working in the country.,11,21,government,1,0,1
31D0ZWOD0A0YUREQRKA2Y8RFTE6A0P,The Syrian government did not comment on the reports and bars most media from working in the country.,57,61,bars,4,4,8
31D0ZWOD0A0YUREQRKA2Y8RFTE6A0P,The Syrian government did not comment on the reports and bars most media from working in the country.,67,72,media,1,0,1
368IUKXGA590V667IS8GX4Q1424P6U,Suicide bombers attacked a compound housing Westerners in Kabul on Wednesday hours after U.S. President Barack Obama signed a security pact during a short visit to a city that remains vulnerable to a resilient insurgency.,0,15,Suicide bombers,3,3,6
368IUKXGA590V667IS8GX4Q1424P6U,Suicide bombers attacked a compound housing Westerners in Kabul on Wednesday hours after U.S. President Barack Obama signed a security pact during a short visit to a city that remains vulnerable to a resilient insurgency.,27,35,compound,4,2,6
368IUKXGA590V667IS8GX4Q1424P6U,Suicide bombers attacked a compound housing Westerners in Kabul on Wednesday hours after U.S. President Barack Obama signed a security pact during a short visit to a city that remains vulnerable to a resilient insurgency.,27,43,compound housing,1,2,3
368IUKXGA590V667IS8GX4Q1424P6U,Suicide bombers attacked a compound housing Westerners in Kabul on Wednesday hours after U.S. President Barack Obama signed a security pact during a short visit to a city that remains vulnerable to a resilient insurgency.,126,139,security pact,5,2,7
368IUKXGA590V667IS8GX4Q1424P6U,Suicide bombers attacked a compound housing Westerners in Kabul on Wednesday hours after U.S. President Barack Obama signed a security pact during a short visit to a city that remains vulnerable to a resilient insurgency.,135,139,pact,0,3,3
368IUKXGA590V667IS8GX4Q1424P6U,Suicide bombers attacked a compound housing Westerners in Kabul on Wednesday hours after U.S. President Barack Obama signed a security pact during a short visit to a city that remains vulnerable to a resilient insurgency.,184,194,vulnerable,9,8,17
368IUKXGA590V667IS8GX4Q1424P6U,Suicide bombers attacked a compound housing Westerners in Kabul on Wednesday hours after U.S. President Barack Obama signed a security pact during a short visit to a city that remains vulnerable to a resilient insurgency.,184,220,vulnerable to a resilient insurgency,0,1,1
368IUKXGA590V667IS8GX4Q1424P6U,Suicide bombers attacked a compound housing Westerners in Kabul on Wednesday hours after U.S. President Barack Obama signed a security pact during a short visit to a city that remains vulnerable to a resilient insurgency.,200,209,resilient,6,4,10
368IUKXGA590V667IS8GX4Q1424P6U,Suicide bombers attacked a compound housing Westerners in Kabul on Wednesday hours after U.S. President Barack Obama signed a security pact during a short visit to a city that remains vulnerable to a resilient insurgency.,200,220,resilient insurgency,7,7,14
368IUKXGA590V667IS8GX4Q1424P6U,Suicide bombers attacked a compound housing Westerners in Kabul on Wednesday hours after U.S. President Barack Obama signed a security pact during a short visit to a city that remains vulnerable to a resilient insurgency.,210,220,insurgency,6,3,9
368IUKXGA590V667IS8GX4Q1424P6U,"The Taliban claimed responsibility for the attack which involved a car bomb and insurgents disguised as women on the eastern outskirts of the capital, killing seven people, a Gurkha guard and six passers-by, and wounding 17.",12,19,claimed,1,0,1
368IUKXGA590V667IS8GX4Q1424P6U,"The Taliban claimed responsibility for the attack which involved a car bomb and insurgents disguised as women on the eastern outskirts of the capital, killing seven people, a Gurkha guard and six passers-by, and wounding 17.",20,34,responsibility,2,0,2
368IUKXGA590V667IS8GX4Q1424P6U,"The Taliban claimed responsibility for the attack which involved a car bomb and insurgents disguised as women on the eastern outskirts of the capital, killing seven people, a Gurkha guard and six passers-by, and wounding 17.",80,90,insurgents,9,4,13
368IUKXGA590V667IS8GX4Q1424P6U,"The Taliban claimed responsibility for the attack which involved a car bomb and insurgents disguised as women on the eastern outskirts of the capital, killing seven people, a Gurkha guard and six passers-by, and wounding 17.",80,100,insurgents disguised,1,0,1
368IUKXGA590V667IS8GX4Q1424P6U,"The Taliban claimed responsibility for the attack which involved a car bomb and insurgents disguised as women on the eastern outskirts of the capital, killing seven people, a Gurkha guard and six passers-by, and wounding 17.",91,100,disguised,4,7,11
368IUKXGA590V667IS8GX4Q1424P6U,"The Taliban claimed responsibility for the attack which involved a car bomb and insurgents disguised as women on the eastern outskirts of the capital, killing seven people, a Gurkha guard and six passers-by, and wounding 17.",117,134,eastern outskirts,0,2,2
368IUKXGA590V667IS8GX4Q1424P6U,"The Taliban claimed responsibility for the attack which involved a car bomb and insurgents disguised as women on the eastern outskirts of the capital, killing seven people, a Gurkha guard and six passers-by, and wounding 17.",125,134,outskirts,7,7,14
368IUKXGA590V667IS8GX4Q1424P6U,"The Taliban claimed responsibility for the attack which involved a car bomb and insurgents disguised as women on the eastern outskirts of the capital, killing seven people, a Gurkha guard and six passers-by, and wounding 17.",175,181,Gurkha,1,0,1
368IUKXGA590V667IS8GX4Q1424P6U,"The Taliban claimed responsibility for the attack which involved a car bomb and insurgents disguised as women on the eastern outskirts of the capital, killing seven people, a Gurkha guard and six passers-by, and wounding 17.",175,187,Gurkha guard,0,1,1
368IUKXGA590V667IS8GX4Q1424P6U,"The Taliban claimed responsibility for the attack which involved a car bomb and insurgents disguised as women on the eastern outskirts of the capital, killing seven people, a Gurkha guard and six passers-by, and wounding 17.",196,206,passers-by,0,1,1
368IUKXGA590V667IS8GX4Q1424P6U,"The Taliban claimed responsibility for the attack which involved a car bomb and insurgents disguised as women on the eastern outskirts of the capital, killing seven people, a Gurkha guard and six passers-by, and wounding 17.",212,220,wounding,0,2,2
368IUKXGA590V667IS8GX4Q1424P6U,"The Taliban said it was in response to Obama's visit and to the strategic partnership deal he signed with Afghan President Hamid Karzai, a pact that sets out a long-term U.S. role after most foreign combat troops leave by the end of 2014.",4,11,Taliban,0,1,1
368IUKXGA590V667IS8GX4Q1424P6U,"The Taliban said it was in response to Obama's visit and to the strategic partnership deal he signed with Afghan President Hamid Karzai, a pact that sets out a long-term U.S. role after most foreign combat troops leave by the end of 2014.",27,35,response,0,1,1
368IUKXGA590V667IS8GX4Q1424P6U,"The Taliban said it was in response to Obama's visit and to the strategic partnership deal he signed with Afghan President Hamid Karzai, a pact that sets out a long-term U.S. role after most foreign combat troops leave by the end of 2014.",64,73,strategic,2,4,6
368IUKXGA590V667IS8GX4Q1424P6U,"The Taliban said it was in response to Obama's visit and to the strategic partnership deal he signed with Afghan President Hamid Karzai, a pact that sets out a long-term U.S. role after most foreign combat troops leave by the end of 2014.",64,85,strategic partnership,3,4,7
368IUKXGA590V667IS8GX4Q1424P6U,"The Taliban said it was in response to Obama's visit and to the strategic partnership deal he signed with Afghan President Hamid Karzai, a pact that sets out a long-term U.S. role after most foreign combat troops leave by the end of 2014.",64,90,strategic partnership deal,2,1,3
368IUKXGA590V667IS8GX4Q1424P6U,"The Taliban said it was in response to Obama's visit and to the strategic partnership deal he signed with Afghan President Hamid Karzai, a pact that sets out a long-term U.S. role after most foreign combat troops leave by the end of 2014.",74,85,partnership,1,0,1
368IUKXGA590V667IS8GX4Q1424P6U,"The Taliban said it was in response to Obama's visit and to the strategic partnership deal he signed with Afghan President Hamid Karzai, a pact that sets out a long-term U.S. role after most foreign combat troops leave by the end of 2014.",86,90,deal,0,1,1
368IUKXGA590V667IS8GX4Q1424P6U,"The Taliban said it was in response to Obama's visit and to the strategic partnership deal he signed with Afghan President Hamid Karzai, a pact that sets out a long-term U.S. role after most foreign combat troops leave by the end of 2014.",139,143,pact,1,1,2
368IUKXGA590V667IS8GX4Q1424P6U,"The Taliban said it was in response to Obama's visit and to the strategic partnership deal he signed with Afghan President Hamid Karzai, a pact that sets out a long-term U.S. role after most foreign combat troops leave by the end of 2014.",191,198,foreign,1,0,1
368IUKXGA590V667IS8GX4Q1424P6U,"The Taliban said it was in response to Obama's visit and to the strategic partnership deal he signed with Afghan President Hamid Karzai, a pact that sets out a long-term U.S. role after most foreign combat troops leave by the end of 2014.",199,212,combat troops,0,3,3
368IUKXGA590V667IS8GX4Q1424P6U,"The insurgency also claimed their spring offensive, which began two weeks ago with attacks in Kabul, would be renewed on Thursday, despite a security clamp-down in the capital.",4,14,insurgency,7,2,9
368IUKXGA590V667IS8GX4Q1424P6U,"The insurgency also claimed their spring offensive, which began two weeks ago with attacks in Kabul, would be renewed on Thursday, despite a security clamp-down in the capital.",34,50,spring offensive,4,5,9
368IUKXGA590V667IS8GX4Q1424P6U,"The insurgency also claimed their spring offensive, which began two weeks ago with attacks in Kabul, would be renewed on Thursday, despite a security clamp-down in the capital.",41,50,offensive,3,1,4
368IUKXGA590V667IS8GX4Q1424P6U,"The insurgency also claimed their spring offensive, which began two weeks ago with attacks in Kabul, would be renewed on Thursday, despite a security clamp-down in the capital.",110,117,renewed,3,2,5
368IUKXGA590V667IS8GX4Q1424P6U,"The insurgency also claimed their spring offensive, which began two weeks ago with attacks in Kabul, would be renewed on Thursday, despite a security clamp-down in the capital.",131,138,despite,2,1,3
368IUKXGA590V667IS8GX4Q1424P6U,"The insurgency also claimed their spring offensive, which began two weeks ago with attacks in Kabul, would be renewed on Thursday, despite a security clamp-down in the capital.",141,160,security clamp-down,4,1,5
368IUKXGA590V667IS8GX4Q1424P6U,"The insurgency also claimed their spring offensive, which began two weeks ago with attacks in Kabul, would be renewed on Thursday, despite a security clamp-down in the capital.",150,160,clamp-down,4,8,12
368IUKXGA590V667IS8GX4Q1424P6U,"The insurgency also claimed their spring offensive, which began two weeks ago with attacks in Kabul, would be renewed on Thursday, despite a security clamp-down in the capital.",150,175,clamp-down in the capital,0,1,1
3XAOZ9UYRZSQOW6PCZBO2DPU1BVQ1L,"Shells and rockets have been hitting the town since three a.m. (midnight GMT) at a rate of one a minute.	1	7	Shells	6	3	9
3XAOZ9UYRZSQOW6PCZBO2DPU1BVQ1L	Shells and rockets have been hitting the town since three a.m. (midnight GMT) at a rate of one a minute.",30,37,hitting,1,1,2
3XAOZ9UYRZSQOW6PCZBO2DPU1BVQ1L,"Shells and rockets have been hitting the town since three a.m. (midnight GMT) at a rate of one a minute.	84	88	rate	1	0	1
3XAOZ9UYRZSQOW6PCZBO2DPU1BVQ1L	Rastan has been destroyed, a member of the rebel Free Syrian Army (FSA)in Rastan who declined to be named told Reuters by satellite phone.",0,6,Rastan,1,0,1
3XAOZ9UYRZSQOW6PCZBO2DPU1BVQ1L,"Rastan has been destroyed,"" a member of the rebel Free Syrian Army (FSA)in Rastan who declined to be named told Reuters by satellite phone.",16,25,destroyed,1,2,3
3XAOZ9UYRZSQOW6PCZBO2DPU1BVQ1L,"Rastan has been destroyed,"" a member of the rebel Free Syrian Army (FSA)in Rastan who declined to be named told Reuters by satellite phone.",44,49,rebel,0,3,3
3XAOZ9UYRZSQOW6PCZBO2DPU1BVQ1L,"Rastan has been destroyed,"" a member of the rebel Free Syrian Army (FSA)in Rastan who declined to be named told Reuters by satellite phone.",44,54,rebel Free,1,0,1
3XAOZ9UYRZSQOW6PCZBO2DPU1BVQ1L,"Rastan has been destroyed,"" a member of the rebel Free Syrian Army (FSA)in Rastan who declined to be named told Reuters by satellite phone.",75,81,Rastan,1,0,1
3XAOZ9UYRZSQOW6PCZBO2DPU1BVQ1L,"Rastan has been destroyed,"" a member of the rebel Free Syrian Army (FSA)in Rastan who declined to be named told Reuters by satellite phone.",86,94,declined,5,4,9
3XAOZ9UYRZSQOW6PCZBO2DPU1BVQ1L,"Rastan has been destroyed,"" a member of the rebel Free Syrian Army (FSA)in Rastan who declined to be named told Reuters by satellite phone.",86,106,declined to be named,0,1,1
3XAOZ9UYRZSQOW6PCZBO2DPU1BVQ1L,"Rastan has been destroyed,"" a member of the rebel Free Syrian Army (FSA)in Rastan who declined to be named told Reuters by satellite phone.",112,119,Reuters,2,0,2
3XAOZ9UYRZSQOW6PCZBO2DPU1BVQ1L,"Rastan has been destroyed,"" a member of the rebel Free Syrian Army (FSA)in Rastan who declined to be named told Reuters by satellite phone.",123,132,satellite,5,1,6
3XAOZ9UYRZSQOW6PCZBO2DPU1BVQ1L,"Rastan has been destroyed,"" a member of the rebel Free Syrian Army (FSA)in Rastan who declined to be named told Reuters by satellite phone.",123,138,satellite phone,3,0,3
3XAOZ9UYRZSQOW6PCZBO2DPU1BVQ1L,"He said among those killed was Ahmad Ayoub, an FSA commander whose fighters were battling the army forces which he said were made up of elite units and members of Military Intelligence.",47,50,FSA,1,0,1
3XAOZ9UYRZSQOW6PCZBO2DPU1BVQ1L,"He said among those killed was Ahmad Ayoub, an FSA commander whose fighters were battling the army forces which he said were made up of elite units and members of Military Intelligence.",47,75,FSA commander whose fighters,1,0,1
3XAOZ9UYRZSQOW6PCZBO2DPU1BVQ1L,"He said among those killed was Ahmad Ayoub, an FSA commander whose fighters were battling the army forces which he said were made up of elite units and members of Military Intelligence.",51,60,commander,1,0,1
3XAOZ9UYRZSQOW6PCZBO2DPU1BVQ1L,"He said among those killed was Ahmad Ayoub, an FSA commander whose fighters were battling the army forces which he said were made up of elite units and members of Military Intelligence.",81,89,battling,2,3,5
3XAOZ9UYRZSQOW6PCZBO2DPU1BVQ1L,"He said among those killed was Ahmad Ayoub, an FSA commander whose fighters were battling the army forces which he said were made up of elite units and members of Military Intelligence.",136,141,elite,6,5,11
3XAOZ9UYRZSQOW6PCZBO2DPU1BVQ1L,"He said among those killed was Ahmad Ayoub, an FSA commander whose fighters were battling the army forces which he said were made up of elite units and members of Military Intelligence.",136,147,elite units,4,1,5
3XAOZ9UYRZSQOW6PCZBO2DPU1BVQ1L,"He said among those killed was Ahmad Ayoub, an FSA commander whose fighters were battling the army forces which he said were made up of elite units and members of Military Intelligence.",163,184,Military Intelligence,0,1,1
3XAOZ9UYRZSQOW6PCZBO2DPU1BVQ1L,"He said among those killed was Ahmad Ayoub, an FSA commander whose fighters were battling the army forces which he said were made up of elite units and members of Military Intelligence.",172,184,Intelligence,2,2,4
3XAOZ9UYRZSQOW6PCZBO2DPU1BVQ1L,"The British-based Observatory said fighting began at dawn on Monday and that rebels destroyed three armored personnel carriers and seized two others, capturing around 15 soldiers.",4,43,British-based Observatory said fighting,1,0,1
3XAOZ9UYRZSQOW6PCZBO2DPU1BVQ1L,"The British-based Observatory said fighting began at dawn on Monday and that rebels destroyed three armored personnel carriers and seized two others, capturing around 15 soldiers.",18,29,Observatory,0,5,5
3XAOZ9UYRZSQOW6PCZBO2DPU1BVQ1L,"The British-based Observatory said fighting began at dawn on Monday and that rebels destroyed three armored personnel carriers and seized two others, capturing around 15 soldiers.",53,57,dawn,2,2,4
3XAOZ9UYRZSQOW6PCZBO2DPU1BVQ1L,"The British-based Observatory said fighting began at dawn on Monday and that rebels destroyed three armored personnel carriers and seized two others, capturing around 15 soldiers.",77,83,rebels,2,2,4
3XAOZ9UYRZSQOW6PCZBO2DPU1BVQ1L,"The British-based Observatory said fighting began at dawn on Monday and that rebels destroyed three armored personnel carriers and seized two others, capturing around 15 soldiers.",84,93,destroyed,1,0,1
3XAOZ9UYRZSQOW6PCZBO2DPU1BVQ1L,"The British-based Observatory said fighting began at dawn on Monday and that rebels destroyed three armored personnel carriers and seized two others, capturing around 15 soldiers.",100,107,armored,5,5,10
3XAOZ9UYRZSQOW6PCZBO2DPU1BVQ1L,"The British-based Observatory said fighting began at dawn on Monday and that rebels destroyed three armored personnel carriers and seized two others, capturing around 15 soldiers.",100,117,armored personnel,1,0,1
3XAOZ9UYRZSQOW6PCZBO2DPU1BVQ1L,"The British-based Observatory said fighting began at dawn on Monday and that rebels destroyed three armored personnel carriers and seized two others, capturing around 15 soldiers.",100,126,armored personnel carriers,5,1,6
3XAOZ9UYRZSQOW6PCZBO2DPU1BVQ1L,"The British-based Observatory said fighting began at dawn on Monday and that rebels destroyed three armored personnel carriers and seized two others, capturing around 15 soldiers.",108,117,personnel,1,2,3
3XAOZ9UYRZSQOW6PCZBO2DPU1BVQ1L,"The British-based Observatory said fighting began at dawn on Monday and that rebels destroyed three armored personnel carriers and seized two others, capturing around 15 soldiers.",108,126,personnel carriers,0,1,1
3XAOZ9UYRZSQOW6PCZBO2DPU1BVQ1L,"The British-based Observatory said fighting began at dawn on Monday and that rebels destroyed three armored personnel carriers and seized two others, capturing around 15 soldiers.",131,137,seized,6,9,15
3XAOZ9UYRZSQOW6PCZBO2DPU1BVQ1L,"The British-based Observatory said fighting began at dawn on Monday and that rebels destroyed three armored personnel carriers and seized two others, capturing around 15 soldiers.",150,159,capturing,1,1,2
3XAOZ9UYRZSQOW6PCZBO2DPU1BVQ1L,Syria's uprising began as a peaceful protest movement but has become increasingly militarized as rebels fight back against Assad's violent crackdown.,8,16,uprising,7,6,13
3XAOZ9UYRZSQOW6PCZBO2DPU1BVQ1L,Syria's uprising began as a peaceful protest movement but has become increasingly militarized as rebels fight back against Assad's violent crackdown.,28,53,peaceful protest movement,1,1,2
3XAOZ9UYRZSQOW6PCZBO2DPU1BVQ1L,Syria's uprising began as a peaceful protest movement but has become increasingly militarized as rebels fight back against Assad's violent crackdown.,69,93,increasingly militarized,1,0,1
3XAOZ9UYRZSQOW6PCZBO2DPU1BVQ1L,Syria's uprising began as a peaceful protest movement but has become increasingly militarized as rebels fight back against Assad's violent crackdown.,69,103,increasingly militarized as rebels,1,0,1
3XAOZ9UYRZSQOW6PCZBO2DPU1BVQ1L,Syria's uprising began as a peaceful protest movement but has become increasingly militarized as rebels fight back against Assad's violent crackdown.,82,93,militarized,10,4,14
3XAOZ9UYRZSQOW6PCZBO2DPU1BVQ1L,Syria's uprising began as a peaceful protest movement but has become increasingly militarized as rebels fight back against Assad's violent crackdown.,97,103,rebels,0,1,1
3XAOZ9UYRZSQOW6PCZBO2DPU1BVQ1L,Syria's uprising began as a peaceful protest movement but has become increasingly militarized as rebels fight back against Assad's violent crackdown.,131,148,violent crackdown,0,1,1
3XAOZ9UYRZSQOW6PCZBO2DPU1BVQ1L,Syria's uprising began as a peaceful protest movement but has become increasingly militarized as rebels fight back against Assad's violent crackdown.,139,148,crackdown,8,10,18
3PA41K45VN5JZ6KC12D83IQXZDO7PB,"Mr Obama sought to portray the withdrawal as an unalloyed achievement, although it remains far from certain that the Afghan government can hold its own against the Taliban with reduced US support, or that what were once considered critical US goals in the country can still be met.",9,15,sought,4,6,10
3PA41K45VN5JZ6KC12D83IQXZDO7PB,"Mr Obama sought to portray the withdrawal as an unalloyed achievement, although it remains far from certain that the Afghan government can hold its own against the Taliban with reduced US support, or that what were once considered critical US goals in the country can still be met.",9,26,sought to portray,0,1,1
3PA41K45VN5JZ6KC12D83IQXZDO7PB,"Mr Obama sought to portray the withdrawal as an unalloyed achievement, although it remains far from certain that the Afghan government can hold its own against the Taliban with reduced US support, or that what were once considered critical US goals in the country can still be met.",19,26,portray,6,10,16
3PA41K45VN5JZ6KC12D83IQXZDO7PB,"Mr Obama sought to portray the withdrawal as an unalloyed achievement, although it remains far from certain that the Afghan government can hold its own against the Taliban with reduced US support, or that what were once considered critical US goals in the country can still be met.",31,41,withdrawal,3,8,11
3PA41K45VN5JZ6KC12D83IQXZDO7PB,"Mr Obama sought to portray the withdrawal as an unalloyed achievement, although it remains far from certain that the Afghan government can hold its own against the Taliban with reduced US support, or that what were once considered critical US goals in the country can still be met.",48,57,unalloyed,9,10,19
3PA41K45VN5JZ6KC12D83IQXZDO7PB,"Mr Obama sought to portray the withdrawal as an unalloyed achievement, although it remains far from certain that the Afghan government can hold its own against the Taliban with reduced US support, or that what were once considered critical US goals in the country can still be met.",48,69,unalloyed achievement,5,3,8
3PA41K45VN5JZ6KC12D83IQXZDO7PB,"Mr Obama sought to portray the withdrawal as an unalloyed achievement, although it remains far from certain that the Afghan government can hold its own against the Taliban with reduced US support, or that what were once considered critical US goals in the country can still be met.",58,69,achievement,1,0,1
3PA41K45VN5JZ6KC12D83IQXZDO7PB,"Mr Obama sought to portray the withdrawal as an unalloyed achievement, although it remains far from certain that the Afghan government can hold its own against the Taliban with reduced US support, or that what were once considered critical US goals in the country can still be met.",91,107,far from certain,1,0,1
3PA41K45VN5JZ6KC12D83IQXZDO7PB,"Mr Obama sought to portray the withdrawal as an unalloyed achievement, although it remains far from certain that the Afghan government can hold its own against the Taliban with reduced US support, or that what were once considered critical US goals in the country can still be met.",177,184,reduced,1,3,4
3PA41K45VN5JZ6KC12D83IQXZDO7PB,"Mr Obama sought to portray the withdrawal as an unalloyed achievement, although it remains far from certain that the Afghan government can hold its own against the Taliban with reduced US support, or that what were once considered critical US goals in the country can still be met.",220,230,considered,1,2,3
3PA41K45VN5JZ6KC12D83IQXZDO7PB,"Mr Obama sought to portray the withdrawal as an unalloyed achievement, although it remains far from certain that the Afghan government can hold its own against the Taliban with reduced US support, or that what were once considered critical US goals in the country can still be met.",231,239,critical,2,3,5
3PA41K45VN5JZ6KC12D83IQXZDO7PB,"Mr Obama's  six-hour visit, ending a year to the day after Osama bin Laden was killed in a raid in  Pakistan, was laden with symbolism, historic and political.",91,95,raid,0,1,1
3PA41K45VN5JZ6KC12D83IQXZDO7PB,"Mr Obama's  six-hour visit, ending a year to the day after Osama bin Laden was killed in a raid in  Pakistan, was laden with symbolism, historic and political.",114,119,laden,6,3,9
3PA41K45VN5JZ6KC12D83IQXZDO7PB,"Mr Obama's  six-hour visit, ending a year to the day after Osama bin Laden was killed in a raid in  Pakistan, was laden with symbolism, historic and political.",114,134,laden with symbolism,1,1,2
3PA41K45VN5JZ6KC12D83IQXZDO7PB,"Mr Obama's  six-hour visit, ending a year to the day after Osama bin Laden was killed in a raid in  Pakistan, was laden with symbolism, historic and political.",125,134,symbolism,10,9,19
3PA41K45VN5JZ6KC12D83IQXZDO7PB,"Mr Obama's  six-hour visit, ending a year to the day after Osama bin Laden was killed in a raid in  Pakistan, was laden with symbolism, historic and political.",136,144,historic,1,1,2
3PA41K45VN5JZ6KC12D83IQXZDO7PB,"Mr Obama's  six-hour visit, ending a year to the day after Osama bin Laden was killed in a raid in  Pakistan, was laden with symbolism, historic and political.",149,158,political,2,0,2
3PA41K45VN5JZ6KC12D83IQXZDO7PB,"Speaking from the country where the September 11 terrorist attacks were incubated, Mr Obama suggested  America had come full circle.''",49,58,terrorist,0,1,1
3PA41K45VN5JZ6KC12D83IQXZDO7PB,"Speaking from the country where the September 11 terrorist attacks were incubated, Mr Obama suggested  America had come full circle.''",72,81,incubated,10,10,20
3PA41K45VN5JZ6KC12D83IQXZDO7PB,"Speaking from the country where the September 11 terrorist attacks were incubated, Mr Obama suggested  America had come full circle.''",92,101,suggested,2,3,5
3PA41K45VN5JZ6KC12D83IQXZDO7PB,"Speaking from the country where the September 11 terrorist attacks were incubated, Mr Obama suggested  America had come full circle.''",111,131,had come full circle,1,1,2
3PA41K45VN5JZ6KC12D83IQXZDO7PB,"Speaking from the country where the September 11 terrorist attacks were incubated, Mr Obama suggested  America had come full circle.''",115,131,come full circle,1,1,2
3PA41K45VN5JZ6KC12D83IQXZDO7PB,"Speaking from the country where the September 11 terrorist attacks were incubated, Mr Obama suggested  America had come full circle.''",120,131,full circle,1,2,3
3PA41K45VN5JZ6KC12D83IQXZDO7PB,"One year ago, from a base here in Afghanistan, our troops launched the operation that killed Osama bin Laden,'' he said. ''",58,66,launched,5,1,6
3PA41K45VN5JZ6KC12D83IQXZDO7PB,"One year ago, from a base here in Afghanistan, our troops launched the operation that killed Osama bin Laden,'' he said. ''",58,80,launched the operation,1,0,1
3PA41K45VN5JZ6KC12D83IQXZDO7PB,"One year ago, from a base here in Afghanistan, our troops launched the operation that killed Osama bin Laden,'' he said. ''",71,80,operation,3,2,5
3PA41K45VN5JZ6KC12D83IQXZDO7PB,"One year ago, from a base here in Afghanistan, our troops launched the operation that killed Osama bin Laden,'' he said. ''",71,92,operation that killed,0,1,1
3JVP4ZJHDPTD09XO382FF6FY5LNI0A,"Al Qaeda is still there.	1	9	Al Qaeda	1	0	1
3JVP4ZJHDPTD09XO382FF6FY5LNI0A	We do feel we are prevailing in this with our Afghan partners, he said.",18,28,prevailing,10,10,20
3JVP4ZJHDPTD09XO382FF6FY5LNI0A,"We do feel we are prevailing in this with our Afghan partners,"" he said.",46,52,Afghan,1,0,1
3JVP4ZJHDPTD09XO382FF6FY5LNI0A,"We cannot be in a position of taking on ourselves bringing perfection to Afghanistan.	19	30	position of	1	0	1
3JVP4ZJHDPTD09XO382FF6FY5LNI0A	We cannot be in a position of taking on ourselves bringing perfection to Afghanistan.",51,70,bringing perfection,1,0,1
3JVP4ZJHDPTD09XO382FF6FY5LNI0A,"We cannot be in a position of taking on ourselves bringing perfection to Afghanistan.	60	70	perfection	4	2	6
3JVP4ZJHDPTD09XO382FF6FY5LNI0A	We cannot be in a position of taking on ourselves bringing perfection to Afghanistan.",74,85,Afghanistan,1,0,1
3JVP4ZJHDPTD09XO382FF6FY5LNI0A,"That has to be left to Afghans.""",15,30,left to Afghans,0,1,1
3JVP4ZJHDPTD09XO382FF6FY5LNI0A,"That has to be left to Afghans.""",23,30,Afghans,1,0,1
3JVP4ZJHDPTD09XO382FF6FY5LNI0A,But Crocker said there would be no repeat of the 1990s when a withdrawal of Western backers in the wake of the Soviet withdrawal unleashed a vicious civil war out of which the Taliban and al Qaeda support bases arose.,4,11,Crocker,1,0,1
3JVP4ZJHDPTD09XO382FF6FY5LNI0A,But Crocker said there would be no repeat of the 1990s when a withdrawal of Western backers in the wake of the Soviet withdrawal unleashed a vicious civil war out of which the Taliban and al Qaeda support bases arose.,62,72,withdrawal,3,4,7
3JVP4ZJHDPTD09XO382FF6FY5LNI0A,But Crocker said there would be no repeat of the 1990s when a withdrawal of Western backers in the wake of the Soviet withdrawal unleashed a vicious civil war out of which the Taliban and al Qaeda support bases arose.,76,91,Western backers,1,2,3
3JVP4ZJHDPTD09XO382FF6FY5LNI0A,But Crocker said there would be no repeat of the 1990s when a withdrawal of Western backers in the wake of the Soviet withdrawal unleashed a vicious civil war out of which the Taliban and al Qaeda support bases arose.,84,91,backers,3,2,5
3JVP4ZJHDPTD09XO382FF6FY5LNI0A,But Crocker said there would be no repeat of the 1990s when a withdrawal of Western backers in the wake of the Soviet withdrawal unleashed a vicious civil war out of which the Taliban and al Qaeda support bases arose.,92,106,in the wake of,0,1,1
3JVP4ZJHDPTD09XO382FF6FY5LNI0A,But Crocker said there would be no repeat of the 1990s when a withdrawal of Western backers in the wake of the Soviet withdrawal unleashed a vicious civil war out of which the Taliban and al Qaeda support bases arose.,99,103,wake,1,0,1
3JVP4ZJHDPTD09XO382FF6FY5LNI0A,But Crocker said there would be no repeat of the 1990s when a withdrawal of Western backers in the wake of the Soviet withdrawal unleashed a vicious civil war out of which the Taliban and al Qaeda support bases arose.,111,128,Soviet withdrawal,1,0,1
3JVP4ZJHDPTD09XO382FF6FY5LNI0A,But Crocker said there would be no repeat of the 1990s when a withdrawal of Western backers in the wake of the Soviet withdrawal unleashed a vicious civil war out of which the Taliban and al Qaeda support bases arose.,118,128,withdrawal,0,2,2
3JVP4ZJHDPTD09XO382FF6FY5LNI0A,But Crocker said there would be no repeat of the 1990s when a withdrawal of Western backers in the wake of the Soviet withdrawal unleashed a vicious civil war out of which the Taliban and al Qaeda support bases arose.,118,138,withdrawal unleashed,0,2,2
3JVP4ZJHDPTD09XO382FF6FY5LNI0A,But Crocker said there would be no repeat of the 1990s when a withdrawal of Western backers in the wake of the Soviet withdrawal unleashed a vicious civil war out of which the Taliban and al Qaeda support bases arose.,129,138,unleashed,7,10,17
3JVP4ZJHDPTD09XO382FF6FY5LNI0A,But Crocker said there would be no repeat of the 1990s when a withdrawal of Western backers in the wake of the Soviet withdrawal unleashed a vicious civil war out of which the Taliban and al Qaeda support bases arose.,139,158,a vicious civil war,0,1,1
3JVP4ZJHDPTD09XO382FF6FY5LNI0A,But Crocker said there would be no repeat of the 1990s when a withdrawal of Western backers in the wake of the Soviet withdrawal unleashed a vicious civil war out of which the Taliban and al Qaeda support bases arose.,141,148,vicious,6,8,14
3JVP4ZJHDPTD09XO382FF6FY5LNI0A,But Crocker said there would be no repeat of the 1990s when a withdrawal of Western backers in the wake of the Soviet withdrawal unleashed a vicious civil war out of which the Taliban and al Qaeda support bases arose.,141,158,vicious civil war,2,0,2
3JVP4ZJHDPTD09XO382FF6FY5LNI0A,But Crocker said there would be no repeat of the 1990s when a withdrawal of Western backers in the wake of the Soviet withdrawal unleashed a vicious civil war out of which the Taliban and al Qaeda support bases arose.,159,171,out of which,1,0,1
3JVP4ZJHDPTD09XO382FF6FY5LNI0A,But Crocker said there would be no repeat of the 1990s when a withdrawal of Western backers in the wake of the Soviet withdrawal unleashed a vicious civil war out of which the Taliban and al Qaeda support bases arose.,176,183,Taliban,1,0,1
3JVP4ZJHDPTD09XO382FF6FY5LNI0A,But Crocker said there would be no repeat of the 1990s when a withdrawal of Western backers in the wake of the Soviet withdrawal unleashed a vicious civil war out of which the Taliban and al Qaeda support bases arose.,188,196,al Qaeda,1,0,1
3JVP4ZJHDPTD09XO382FF6FY5LNI0A,But Crocker said there would be no repeat of the 1990s when a withdrawal of Western backers in the wake of the Soviet withdrawal unleashed a vicious civil war out of which the Taliban and al Qaeda support bases arose.,197,210,support bases,0,1,1
3JVP4ZJHDPTD09XO382FF6FY5LNI0A,But Crocker said there would be no repeat of the 1990s when a withdrawal of Western backers in the wake of the Soviet withdrawal unleashed a vicious civil war out of which the Taliban and al Qaeda support bases arose.,211,216,arose,4,3,7
3JVP4ZJHDPTD09XO382FF6FY5LNI0A,"Taliban bombers attacked a heavily fortified guesthouse used by Westerners in Kabul on Wednesday, announcing the start of their annual in defiance of calls from visiting US President Barack Obama that the war was ending.",27,44,heavily fortified,1,1,2
3JVP4ZJHDPTD09XO382FF6FY5LNI0A,"Taliban bombers attacked a heavily fortified guesthouse used by Westerners in Kabul on Wednesday, announcing the start of their annual in defiance of calls from visiting US President Barack Obama that the war was ending.",27,55,heavily fortified guesthouse,1,0,1
3JVP4ZJHDPTD09XO382FF6FY5LNI0A,"Taliban bombers attacked a heavily fortified guesthouse used by Westerners in Kabul on Wednesday, announcing the start of their annual in defiance of calls from visiting US President Barack Obama that the war was ending.",35,44,fortified,10,9,19
3JVP4ZJHDPTD09XO382FF6FY5LNI0A,"Taliban bombers attacked a heavily fortified guesthouse used by Westerners in Kabul on Wednesday, announcing the start of their annual in defiance of calls from visiting US President Barack Obama that the war was ending.",35,55,fortified guesthouse,1,0,1
3JVP4ZJHDPTD09XO382FF6FY5LNI0A,"Taliban bombers attacked a heavily fortified guesthouse used by Westerners in Kabul on Wednesday, announcing the start of their annual in defiance of calls from visiting US President Barack Obama that the war was ending.",45,55,guesthouse,0,1,1
3JVP4ZJHDPTD09XO382FF6FY5LNI0A,"Taliban bombers attacked a heavily fortified guesthouse used by Westerners in Kabul on Wednesday, announcing the start of their annual in defiance of calls from visiting US President Barack Obama that the war was ending.",98,108,announcing,2,2,4
3JVP4ZJHDPTD09XO382FF6FY5LNI0A,"Taliban bombers attacked a heavily fortified guesthouse used by Westerners in Kabul on Wednesday, announcing the start of their annual in defiance of calls from visiting US President Barack Obama that the war was ending.",128,134,annual,1,0,1
3JVP4ZJHDPTD09XO382FF6FY5LNI0A,"Taliban bombers attacked a heavily fortified guesthouse used by Westerners in Kabul on Wednesday, announcing the start of their annual in defiance of calls from visiting US President Barack Obama that the war was ending.",128,146,annual in defiance,1,0,1
3JVP4ZJHDPTD09XO382FF6FY5LNI0A,"Taliban bombers attacked a heavily fortified guesthouse used by Westerners in Kabul on Wednesday, announcing the start of their annual in defiance of calls from visiting US President Barack Obama that the war was ending.",135,146,in defiance,1,1,2
3JVP4ZJHDPTD09XO382FF6FY5LNI0A,"Taliban bombers attacked a heavily fortified guesthouse used by Westerners in Kabul on Wednesday, announcing the start of their annual in defiance of calls from visiting US President Barack Obama that the war was ending.",135,155,in defiance of calls,1,0,1
3JVP4ZJHDPTD09XO382FF6FY5LNI0A,"Taliban bombers attacked a heavily fortified guesthouse used by Westerners in Kabul on Wednesday, announcing the start of their annual in defiance of calls from visiting US President Barack Obama that the war was ending.",138,146,defiance,10,9,19
3JVP4ZJHDPTD09XO382FF6FY5LNI0A,"Taliban bombers attacked a heavily fortified guesthouse used by Westerners in Kabul on Wednesday, announcing the start of their annual in defiance of calls from visiting US President Barack Obama that the war was ending.",183,195,Barack Obama,1,0,1
3JVP4ZJHDPTD09XO382FF6FY5LNI0A,"Seven people were killed after attackers in burqas detonated a suicide car bomb and clashed with guards at the ""Green Village"" complex of guesthouses used by the European Union, the United Nations and aid groups, officials said.",44,50,burqas,5,2,7
3JVP4ZJHDPTD09XO382FF6FY5LNI0A,"Seven people were killed after attackers in burqas detonated a suicide car bomb and clashed with guards at the ""Green Village"" complex of guesthouses used by the European Union, the United Nations and aid groups, officials said.",44,60,burqas detonated,3,0,3
3JVP4ZJHDPTD09XO382FF6FY5LNI0A,"Seven people were killed after attackers in burqas detonated a suicide car bomb and clashed with guards at the ""Green Village"" complex of guesthouses used by the European Union, the United Nations and aid groups, officials said.",51,60,detonated,6,6,12
3JVP4ZJHDPTD09XO382FF6FY5LNI0A,"Seven people were killed after attackers in burqas detonated a suicide car bomb and clashed with guards at the ""Green Village"" complex of guesthouses used by the European Union, the United Nations and aid groups, officials said.",63,70,suicide,0,1,1
3JVP4ZJHDPTD09XO382FF6FY5LNI0A,"Seven people were killed after attackers in burqas detonated a suicide car bomb and clashed with guards at the ""Green Village"" complex of guesthouses used by the European Union, the United Nations and aid groups, officials said.",63,79,suicide car bomb,1,0,1
3JVP4ZJHDPTD09XO382FF6FY5LNI0A,"Seven people were killed after attackers in burqas detonated a suicide car bomb and clashed with guards at the ""Green Village"" complex of guesthouses used by the European Union, the United Nations and aid groups, officials said.",84,91,clashed,2,4,6
3JVP4ZJHDPTD09XO382FF6FY5LNI0A,"Seven people were killed after attackers in burqas detonated a suicide car bomb and clashed with guards at the ""Green Village"" complex of guesthouses used by the European Union, the United Nations and aid groups, officials said.",127,134,complex,2,0,2
3JVP4ZJHDPTD09XO382FF6FY5LNI0A,"Seven people were killed after attackers in burqas detonated a suicide car bomb and clashed with guards at the ""Green Village"" complex of guesthouses used by the European Union, the United Nations and aid groups, officials said.",138,149,guesthouses,2,1,3
3JVP4ZJHDPTD09XO382FF6FY5LNI0A,"Seven people were killed after attackers in burqas detonated a suicide car bomb and clashed with guards at the ""Green Village"" complex of guesthouses used by the European Union, the United Nations and aid groups, officials said.",201,211,aid groups,1,0,1
3JVP4ZJHDPTD09XO382FF6FY5LNI0A,"Seven people were killed after attackers in burqas detonated a suicide car bomb and clashed with guards at the ""Green Village"" complex of guesthouses used by the European Union, the United Nations and aid groups, officials said.",213,222,officials,2,0,2
39O0SQZVJN84BJ0REUHX8DQC1W07RU,He also dismissed allegations of corruption among his United Russia party members.,8,17,dismissed,5,1,6
39O0SQZVJN84BJ0REUHX8DQC1W07RU,He also dismissed allegations of corruption among his United Russia party members.,8,29,dismissed allegations,3,1,4
39O0SQZVJN84BJ0REUHX8DQC1W07RU,He also dismissed allegations of corruption among his United Russia party members.,18,29,allegations,10,10,20
39O0SQZVJN84BJ0REUHX8DQC1W07RU,He also dismissed allegations of corruption among his United Russia party members.,18,43,allegations of corruption,3,0,3
39O0SQZVJN84BJ0REUHX8DQC1W07RU,He also dismissed allegations of corruption among his United Russia party members.,33,43,corruption,8,5,13
39O0SQZVJN84BJ0REUHX8DQC1W07RU,He also dismissed allegations of corruption among his United Russia party members.,54,73,United Russia party,1,0,1
39O0SQZVJN84BJ0REUHX8DQC1W07RU,"A Philippine warship was in a standoff with Chinese surveillance ships Wednesday in disputed waters of the Spratly Islands, Philippine officials said.",13,20,warship,1,0,1
39O0SQZVJN84BJ0REUHX8DQC1W07RU,"A Philippine warship was in a standoff with Chinese surveillance ships Wednesday in disputed waters of the Spratly Islands, Philippine officials said.",30,38,standoff,5,10,15
39O0SQZVJN84BJ0REUHX8DQC1W07RU,"A Philippine warship was in a standoff with Chinese surveillance ships Wednesday in disputed waters of the Spratly Islands, Philippine officials said.",52,64,surveillance,10,7,17
39O0SQZVJN84BJ0REUHX8DQC1W07RU,"A Philippine warship was in a standoff with Chinese surveillance ships Wednesday in disputed waters of the Spratly Islands, Philippine officials said.",52,70,surveillance ships,2,1,3
39O0SQZVJN84BJ0REUHX8DQC1W07RU,"A Philippine warship was in a standoff with Chinese surveillance ships Wednesday in disputed waters of the Spratly Islands, Philippine officials said.",84,92,disputed,6,3,9
39O0SQZVJN84BJ0REUHX8DQC1W07RU,"A Philippine warship was in a standoff with Chinese surveillance ships Wednesday in disputed waters of the Spratly Islands, Philippine officials said.",84,99,disputed waters,0,4,4
39O0SQZVJN84BJ0REUHX8DQC1W07RU,"A Philippine warship was in a standoff with Chinese surveillance ships Wednesday in disputed waters of the Spratly Islands, Philippine officials said.",107,122,Spratly Islands,1,0,1
39O0SQZVJN84BJ0REUHX8DQC1W07RU,"The Philippine Foreign Affairs Department said the situation developed Tuesday when the Chinese surveillance ships placed themselves between the Philippine patrol boat BRP Gregorio del Pilar and several Chinese fishing boats, GMA News reported The face-off was playing out near Scarborough, or Panatag, Shoal, which both the Philippines and China claim.",51,60,situation,0,1,1
39O0SQZVJN84BJ0REUHX8DQC1W07RU,"The Philippine Foreign Affairs Department said the situation developed Tuesday when the Chinese surveillance ships placed themselves between the Philippine patrol boat BRP Gregorio del Pilar and several Chinese fishing boats, GMA News reported The face-off was playing out near Scarborough, or Panatag, Shoal, which both the Philippines and China claim.",61,70,developed,0,1,1
39O0SQZVJN84BJ0REUHX8DQC1W07RU,"The Philippine Foreign Affairs Department said the situation developed Tuesday when the Chinese surveillance ships placed themselves between the Philippine patrol boat BRP Gregorio del Pilar and several Chinese fishing boats, GMA News reported The face-off was playing out near Scarborough, or Panatag, Shoal, which both the Philippines and China claim.",96,108,surveillance,5,2,7
39O0SQZVJN84BJ0REUHX8DQC1W07RU,"The Philippine Foreign Affairs Department said the situation developed Tuesday when the Chinese surveillance ships placed themselves between the Philippine patrol boat BRP Gregorio del Pilar and several Chinese fishing boats, GMA News reported The face-off was playing out near Scarborough, or Panatag, Shoal, which both the Philippines and China claim.",96,114,surveillance ships,0,1,1
39O0SQZVJN84BJ0REUHX8DQC1W07RU,"The Philippine Foreign Affairs Department said the situation developed Tuesday when the Chinese surveillance ships placed themselves between the Philippine patrol boat BRP Gregorio del Pilar and several Chinese fishing boats, GMA News reported The face-off was playing out near Scarborough, or Panatag, Shoal, which both the Philippines and China claim.",156,162,patrol,1,1,2
39O0SQZVJN84BJ0REUHX8DQC1W07RU,"The Philippine Foreign Affairs Department said the situation developed Tuesday when the Chinese surveillance ships placed themselves between the Philippine patrol boat BRP Gregorio del Pilar and several Chinese fishing boats, GMA News reported The face-off was playing out near Scarborough, or Panatag, Shoal, which both the Philippines and China claim.",156,167,patrol boat,0,1,1
39O0SQZVJN84BJ0REUHX8DQC1W07RU,"The Philippine Foreign Affairs Department said the situation developed Tuesday when the Chinese surveillance ships placed themselves between the Philippine patrol boat BRP Gregorio del Pilar and several Chinese fishing boats, GMA News reported The face-off was playing out near Scarborough, or Panatag, Shoal, which both the Philippines and China claim.",248,256,face-off,5,6,11
39O0SQZVJN84BJ0REUHX8DQC1W07RU,"The Philippine Foreign Affairs Department said the situation developed Tuesday when the Chinese surveillance ships placed themselves between the Philippine patrol boat BRP Gregorio del Pilar and several Chinese fishing boats, GMA News reported The face-off was playing out near Scarborough, or Panatag, Shoal, which both the Philippines and China claim.",261,272,playing out,1,0,1
39O0SQZVJN84BJ0REUHX8DQC1W07RU,"The Philippine Foreign Affairs Department said the situation developed Tuesday when the Chinese surveillance ships placed themselves between the Philippine patrol boat BRP Gregorio del Pilar and several Chinese fishing boats, GMA News reported The face-off was playing out near Scarborough, or Panatag, Shoal, which both the Philippines and China claim.",303,308,Shoal,1,0,1
39O0SQZVJN84BJ0REUHX8DQC1W07RU,"Foreign Affairs Secretary Albert del Rosario was seeking a diplomatic solution with Chinese Ambassador Ma Keqing, the TV network said.",49,56,seeking,0,1,1
39O0SQZVJN84BJ0REUHX8DQC1W07RU,"Foreign Affairs Secretary Albert del Rosario was seeking a diplomatic solution with Chinese Ambassador Ma Keqing, the TV network said.",59,69,diplomatic,5,5,10
39O0SQZVJN84BJ0REUHX8DQC1W07RU,"Foreign Affairs Secretary Albert del Rosario was seeking a diplomatic solution with Chinese Ambassador Ma Keqing, the TV network said.",59,78,diplomatic solution,3,3,6
39O0SQZVJN84BJ0REUHX8DQC1W07RU,"Foreign Affairs Secretary Albert del Rosario was seeking a diplomatic solution with Chinese Ambassador Ma Keqing, the TV network said.",92,102,Ambassador,1,0,1
39O0SQZVJN84BJ0REUHX8DQC1W07RU,The Chinese Embassy said it had received a report that a dozen Chinese fishing boats had taken refuge in a lagoon of Huangyan Island to escape foul weather when the Philippine gunboat blocked the lagoon entrance and sent 12 Philippine soldiers to harass the Chinese fishermen.,32,40,received,0,1,1
39O0SQZVJN84BJ0REUHX8DQC1W07RU,The Chinese Embassy said it had received a report that a dozen Chinese fishing boats had taken refuge in a lagoon of Huangyan Island to escape foul weather when the Philippine gunboat blocked the lagoon entrance and sent 12 Philippine soldiers to harass the Chinese fishermen.,89,101,taken refuge,2,0,2
39O0SQZVJN84BJ0REUHX8DQC1W07RU,The Chinese Embassy said it had received a report that a dozen Chinese fishing boats had taken refuge in a lagoon of Huangyan Island to escape foul weather when the Philippine gunboat blocked the lagoon entrance and sent 12 Philippine soldiers to harass the Chinese fishermen.,95,101,refuge,7,5,12
39O0SQZVJN84BJ0REUHX8DQC1W07RU,The Chinese Embassy said it had received a report that a dozen Chinese fishing boats had taken refuge in a lagoon of Huangyan Island to escape foul weather when the Philippine gunboat blocked the lagoon entrance and sent 12 Philippine soldiers to harass the Chinese fishermen.,107,113,lagoon,5,4,9
39O0SQZVJN84BJ0REUHX8DQC1W07RU,The Chinese Embassy said it had received a report that a dozen Chinese fishing boats had taken refuge in a lagoon of Huangyan Island to escape foul weather when the Philippine gunboat blocked the lagoon entrance and sent 12 Philippine soldiers to harass the Chinese fishermen.,136,142,escape,0,2,2
39O0SQZVJN84BJ0REUHX8DQC1W07RU,The Chinese Embassy said it had received a report that a dozen Chinese fishing boats had taken refuge in a lagoon of Huangyan Island to escape foul weather when the Philippine gunboat blocked the lagoon entrance and sent 12 Philippine soldiers to harass the Chinese fishermen.,143,147,foul,0,2,2
39O0SQZVJN84BJ0REUHX8DQC1W07RU,The Chinese Embassy said it had received a report that a dozen Chinese fishing boats had taken refuge in a lagoon of Huangyan Island to escape foul weather when the Philippine gunboat blocked the lagoon entrance and sent 12 Philippine soldiers to harass the Chinese fishermen.,143,155,foul weather,2,3,5
39O0SQZVJN84BJ0REUHX8DQC1W07RU,The Chinese Embassy said it had received a report that a dozen Chinese fishing boats had taken refuge in a lagoon of Huangyan Island to escape foul weather when the Philippine gunboat blocked the lagoon entrance and sent 12 Philippine soldiers to harass the Chinese fishermen.,176,183,gunboat,1,1,2
39O0SQZVJN84BJ0REUHX8DQC1W07RU,The Chinese Embassy said it had received a report that a dozen Chinese fishing boats had taken refuge in a lagoon of Huangyan Island to escape foul weather when the Philippine gunboat blocked the lagoon entrance and sent 12 Philippine soldiers to harass the Chinese fishermen.,247,253,harass,6,9,15
3MQKOF1EE2PP0OIN41UPV48PE9FDW2,"However, Olli Rehn, the EU's monetary affairs chief, said the European Commission has full confidence in the determination of the Spanish government to meet the fiscal targets.",9,18,Olli Rehn,1,0,1
3MQKOF1EE2PP0OIN41UPV48PE9FDW2,"However, Olli Rehn, the EU's monetary affairs chief, said the European Commission has full confidence in the determination of the Spanish government to meet the fiscal targets.",24,50,EUs monetary affairs chief,1,0,1
3MQKOF1EE2PP0OIN41UPV48PE9FDW2,"However, Olli Rehn, the EU's monetary affairs chief, said the European Commission has full confidence in the determination of the Spanish government to meet the fiscal targets.",29,37,monetary,5,3,8
3MQKOF1EE2PP0OIN41UPV48PE9FDW2,"However, Olli Rehn, the EU's monetary affairs chief, said the European Commission has full confidence in the determination of the Spanish government to meet the fiscal targets.",29,45,monetary affairs,3,4,7
3MQKOF1EE2PP0OIN41UPV48PE9FDW2,"However, Olli Rehn, the EU's monetary affairs chief, said the European Commission has full confidence in the determination of the Spanish government to meet the fiscal targets.",29,51,monetary affairs chief,2,0,2
3MQKOF1EE2PP0OIN41UPV48PE9FDW2,"However, Olli Rehn, the EU's monetary affairs chief, said the European Commission has full confidence in the determination of the Spanish government to meet the fiscal targets.",71,81,Commission,0,1,1
3MQKOF1EE2PP0OIN41UPV48PE9FDW2,"However, Olli Rehn, the EU's monetary affairs chief, said the European Commission has full confidence in the determination of the Spanish government to meet the fiscal targets.",91,101,confidence,3,3,6
3MQKOF1EE2PP0OIN41UPV48PE9FDW2,"However, Olli Rehn, the EU's monetary affairs chief, said the European Commission has full confidence in the determination of the Spanish government to meet the fiscal targets.",109,122,determination,7,4,11
3MQKOF1EE2PP0OIN41UPV48PE9FDW2,"However, Olli Rehn, the EU's monetary affairs chief, said the European Commission has full confidence in the determination of the Spanish government to meet the fiscal targets.",161,167,fiscal,5,7,12
3MQKOF1EE2PP0OIN41UPV48PE9FDW2,"However, Olli Rehn, the EU's monetary affairs chief, said the European Commission has full confidence in the determination of the Spanish government to meet the fiscal targets.",161,175,fiscal targets,7,3,10
3MQKOF1EE2PP0OIN41UPV48PE9FDW2,"However, Olli Rehn, the EU's monetary affairs chief, said the European Commission has full confidence in the determination of the Spanish government to meet the fiscal targets.",168,175,targets,1,0,1
3MQKOF1EE2PP0OIN41UPV48PE9FDW2,He said that the key to restoring confidence and growth for Spain was to tackle the immediate fiscal and financial challenges with full determination.,24,33,restoring,4,2,6
3MQKOF1EE2PP0OIN41UPV48PE9FDW2,He said that the key to restoring confidence and growth for Spain was to tackle the immediate fiscal and financial challenges with full determination.,24,44,restoring confidence,0,1,1
3MQKOF1EE2PP0OIN41UPV48PE9FDW2,He said that the key to restoring confidence and growth for Spain was to tackle the immediate fiscal and financial challenges with full determination.,24,55,restoring confidence and growth,1,0,1
3MQKOF1EE2PP0OIN41UPV48PE9FDW2,He said that the key to restoring confidence and growth for Spain was to tackle the immediate fiscal and financial challenges with full determination.,49,55,growth,0,1,1
3MQKOF1EE2PP0OIN41UPV48PE9FDW2,He said that the key to restoring confidence and growth for Spain was to tackle the immediate fiscal and financial challenges with full determination.,73,79,tackle,2,7,9
3MQKOF1EE2PP0OIN41UPV48PE9FDW2,He said that the key to restoring confidence and growth for Spain was to tackle the immediate fiscal and financial challenges with full determination.,94,100,fiscal,7,2,9
3MQKOF1EE2PP0OIN41UPV48PE9FDW2,He said that the key to restoring confidence and growth for Spain was to tackle the immediate fiscal and financial challenges with full determination.,94,125,fiscal and financial challenges,1,1,2
3MQKOF1EE2PP0OIN41UPV48PE9FDW2,He said that the key to restoring confidence and growth for Spain was to tackle the immediate fiscal and financial challenges with full determination.,105,114,financial,1,0,1
3MQKOF1EE2PP0OIN41UPV48PE9FDW2,He said that the key to restoring confidence and growth for Spain was to tackle the immediate fiscal and financial challenges with full determination.,115,125,challenges,0,1,1
3MQKOF1EE2PP0OIN41UPV48PE9FDW2,He said that the key to restoring confidence and growth for Spain was to tackle the immediate fiscal and financial challenges with full determination.,136,149,determination,1,1,2
3MQKOF1EE2PP0OIN41UPV48PE9FDW2,"The government in Spain has announced a new set of financial reforms, particularly aimed at cleaning up the country's banking system, which is saddled with bad loans.",28,37,announced,0,1,1
3MQKOF1EE2PP0OIN41UPV48PE9FDW2,"The government in Spain has announced a new set of financial reforms, particularly aimed at cleaning up the country's banking system, which is saddled with bad loans.",51,68,financial reforms,6,1,7
3MQKOF1EE2PP0OIN41UPV48PE9FDW2,"The government in Spain has announced a new set of financial reforms, particularly aimed at cleaning up the country's banking system, which is saddled with bad loans.",61,68,reforms,2,3,5
3MQKOF1EE2PP0OIN41UPV48PE9FDW2,"The government in Spain has announced a new set of financial reforms, particularly aimed at cleaning up the country's banking system, which is saddled with bad loans.",70,82,particularly,1,1,2
3MQKOF1EE2PP0OIN41UPV48PE9FDW2,"The government in Spain has announced a new set of financial reforms, particularly aimed at cleaning up the country's banking system, which is saddled with bad loans.",83,88,aimed,0,1,1
3MQKOF1EE2PP0OIN41UPV48PE9FDW2,"The government in Spain has announced a new set of financial reforms, particularly aimed at cleaning up the country's banking system, which is saddled with bad loans.",143,150,saddled,10,10,20
3MQKOF1EE2PP0OIN41UPV48PE9FDW2,"The government in Spain has announced a new set of financial reforms, particularly aimed at cleaning up the country's banking system, which is saddled with bad loans.",143,165,saddled with bad loans,1,0,1
3MQKOF1EE2PP0OIN41UPV48PE9FDW2,"The government in Spain has announced a new set of financial reforms, particularly aimed at cleaning up the country's banking system, which is saddled with bad loans.",156,165,bad loans,0,1,1
3MQKOF1EE2PP0OIN41UPV48PE9FDW2,It approved measures forcing banks to set aside a new 30bn euro ($39bn) financial cushion on top of 54bn euros ordered in February as insurance against bad loans on property.,3,11,approved,1,0,1
3MQKOF1EE2PP0OIN41UPV48PE9FDW2,It approved measures forcing banks to set aside a new 30bn euro ($39bn) financial cushion on top of 54bn euros ordered in February as insurance against bad loans on property.,12,20,measures,2,1,3
3MQKOF1EE2PP0OIN41UPV48PE9FDW2,It approved measures forcing banks to set aside a new 30bn euro ($39bn) financial cushion on top of 54bn euros ordered in February as insurance against bad loans on property.,38,47,set aside,0,1,1
3MQKOF1EE2PP0OIN41UPV48PE9FDW2,It approved measures forcing banks to set aside a new 30bn euro ($39bn) financial cushion on top of 54bn euros ordered in February as insurance against bad loans on property.,42,47,aside,0,1,1
3MQKOF1EE2PP0OIN41UPV48PE9FDW2,It approved measures forcing banks to set aside a new 30bn euro ($39bn) financial cushion on top of 54bn euros ordered in February as insurance against bad loans on property.,72,89,financial cushion,8,2,10
3MQKOF1EE2PP0OIN41UPV48PE9FDW2,It approved measures forcing banks to set aside a new 30bn euro ($39bn) financial cushion on top of 54bn euros ordered in February as insurance against bad loans on property.,82,89,cushion,1,3,4
3MQKOF1EE2PP0OIN41UPV48PE9FDW2,It approved measures forcing banks to set aside a new 30bn euro ($39bn) financial cushion on top of 54bn euros ordered in February as insurance against bad loans on property.,152,161,bad loans,1,0,1
3MQKOF1EE2PP0OIN41UPV48PE9FDW2,The new rules also require banks to separate property assets from their balance sheets.,36,44,separate,1,0,1
3MQKOF1EE2PP0OIN41UPV48PE9FDW2,The new rules also require banks to separate property assets from their balance sheets.,45,60,property assets,2,1,3
3MQKOF1EE2PP0OIN41UPV48PE9FDW2,The new rules also require banks to separate property assets from their balance sheets.,54,60,assets,5,2,7
3MQKOF1EE2PP0OIN41UPV48PE9FDW2,The new rules also require banks to separate property assets from their balance sheets.,72,86,balance sheets,7,2,9
36GJS3V78VR66OSFZSCICZHEP5MGJK,"As a result, with the recession, so many people were left unable to pay for their mortgages, and the banks are left to deal with the after-effects, she said.",23,32,recession,10,10,20
36GJS3V78VR66OSFZSCICZHEP5MGJK,"As a result, with the recession, so many people were left unable to pay for their mortgages, and the banks are left to deal with the after-effects, she said.",59,65,unable,0,1,1
36GJS3V78VR66OSFZSCICZHEP5MGJK,"As a result, with the recession, so many people were left unable to pay for their mortgages, and the banks are left to deal with the after-effects, she said.",83,92,mortgages,10,10,20
36GJS3V78VR66OSFZSCICZHEP5MGJK,"As a result, with the recession, so many people were left unable to pay for their mortgages, and the banks are left to deal with the after-effects, she said.",134,147,after-effects,9,4,13
36GJS3V78VR66OSFZSCICZHEP5MGJK,"A resident of Madrid told Al Jazeera: ""It's not the fault of the people who bought their homes with mortgages that they might not have been able to afford.",2,10,resident,1,2,3
36GJS3V78VR66OSFZSCICZHEP5MGJK,"A resident of Madrid told Al Jazeera: ""It's not the fault of the people who bought their homes with mortgages that they might not have been able to afford.",52,57,fault,0,1,1
36GJS3V78VR66OSFZSCICZHEP5MGJK,"A resident of Madrid told Al Jazeera: ""It's not the fault of the people who bought their homes with mortgages that they might not have been able to afford.",76,82,bought,0,1,1
36GJS3V78VR66OSFZSCICZHEP5MGJK,"A resident of Madrid told Al Jazeera: ""It's not the fault of the people who bought their homes with mortgages that they might not have been able to afford.",100,109,mortgages,5,2,7
36GJS3V78VR66OSFZSCICZHEP5MGJK,"A resident of Madrid told Al Jazeera: ""It's not the fault of the people who bought their homes with mortgages that they might not have been able to afford.",148,154,afford,2,5,7
36GJS3V78VR66OSFZSCICZHEP5MGJK,"It's the fault of the politicians and those making bad lending decisions with our economy, Shrinking eurozone The developments come amid the release by the EU of new figures confirming that the eurozone will shrink 0.3 per cent in 2012.",23,34,politicians,3,0,3
36GJS3V78VR66OSFZSCICZHEP5MGJK,"It's the fault of the politicians and those making bad lending decisions with our economy, Shrinking eurozone The developments come amid the release by the EU of new figures confirming that the eurozone will shrink 0.3 per cent in 2012.",52,73,bad lending decisions,2,1,3
36GJS3V78VR66OSFZSCICZHEP5MGJK,"It's the fault of the politicians and those making bad lending decisions with our economy, Shrinking eurozone The developments come amid the release by the EU of new figures confirming that the eurozone will shrink 0.3 per cent in 2012.",56,63,lending,1,5,6
36GJS3V78VR66OSFZSCICZHEP5MGJK,"It's the fault of the politicians and those making bad lending decisions with our economy, Shrinking eurozone The developments come amid the release by the EU of new figures confirming that the eurozone will shrink 0.3 per cent in 2012.",56,73,lending decisions,0,1,1
36GJS3V78VR66OSFZSCICZHEP5MGJK,"It's the fault of the politicians and those making bad lending decisions with our economy, Shrinking eurozone The developments come amid the release by the EU of new figures confirming that the eurozone will shrink 0.3 per cent in 2012.",64,73,decisions,0,1,1
36GJS3V78VR66OSFZSCICZHEP5MGJK,"It's the fault of the politicians and those making bad lending decisions with our economy, Shrinking eurozone The developments come amid the release by the EU of new figures confirming that the eurozone will shrink 0.3 per cent in 2012.",83,90,economy,3,1,4
36GJS3V78VR66OSFZSCICZHEP5MGJK,"It's the fault of the politicians and those making bad lending decisions with our economy, Shrinking eurozone The developments come amid the release by the EU of new figures confirming that the eurozone will shrink 0.3 per cent in 2012.",93,102,Shrinking,2,3,5
36GJS3V78VR66OSFZSCICZHEP5MGJK,"It's the fault of the politicians and those making bad lending decisions with our economy, Shrinking eurozone The developments come amid the release by the EU of new figures confirming that the eurozone will shrink 0.3 per cent in 2012.",93,111,Shrinking eurozone,0,1,1
36GJS3V78VR66OSFZSCICZHEP5MGJK,"It's the fault of the politicians and those making bad lending decisions with our economy, Shrinking eurozone The developments come amid the release by the EU of new figures confirming that the eurozone will shrink 0.3 per cent in 2012.",103,111,eurozone,8,1,9
36GJS3V78VR66OSFZSCICZHEP5MGJK,"It's the fault of the politicians and those making bad lending decisions with our economy, Shrinking eurozone The developments come amid the release by the EU of new figures confirming that the eurozone will shrink 0.3 per cent in 2012.",116,128,developments,2,2,4
36GJS3V78VR66OSFZSCICZHEP5MGJK,"It's the fault of the politicians and those making bad lending decisions with our economy, Shrinking eurozone The developments come amid the release by the EU of new figures confirming that the eurozone will shrink 0.3 per cent in 2012.",134,138,amid,5,5,10
36GJS3V78VR66OSFZSCICZHEP5MGJK,"It's the fault of the politicians and those making bad lending decisions with our economy, Shrinking eurozone The developments come amid the release by the EU of new figures confirming that the eurozone will shrink 0.3 per cent in 2012.",164,175,new figures,1,0,1
36GJS3V78VR66OSFZSCICZHEP5MGJK,"It's the fault of the politicians and those making bad lending decisions with our economy, Shrinking eurozone The developments come amid the release by the EU of new figures confirming that the eurozone will shrink 0.3 per cent in 2012.",176,186,confirming,1,2,3
36GJS3V78VR66OSFZSCICZHEP5MGJK,"It's the fault of the politicians and those making bad lending decisions with our economy, Shrinking eurozone The developments come amid the release by the EU of new figures confirming that the eurozone will shrink 0.3 per cent in 2012.",196,204,eurozone,5,0,5
36GJS3V78VR66OSFZSCICZHEP5MGJK,"It's the fault of the politicians and those making bad lending decisions with our economy, Shrinking eurozone The developments come amid the release by the EU of new figures confirming that the eurozone will shrink 0.3 per cent in 2012.",196,216,eurozone will shrink,1,0,1
36GJS3V78VR66OSFZSCICZHEP5MGJK,"It's the fault of the politicians and those making bad lending decisions with our economy, Shrinking eurozone The developments come amid the release by the EU of new figures confirming that the eurozone will shrink 0.3 per cent in 2012.",210,216,shrink,1,2,3
36GJS3V78VR66OSFZSCICZHEP5MGJK,"In Spain, one in four of its workforce is without a job, and the latest prediction from the EU says Spain is going to stay in recession for some time to come.",29,38,workforce,6,2,8
36GJS3V78VR66OSFZSCICZHEP5MGJK,"In Spain, one in four of its workforce is without a job, and the latest prediction from the EU says Spain is going to stay in recession for some time to come.",72,82,prediction,8,4,12
36GJS3V78VR66OSFZSCICZHEP5MGJK,"In Spain, one in four of its workforce is without a job, and the latest prediction from the EU says Spain is going to stay in recession for some time to come.",118,135,stay in recession,1,0,1
36GJS3V78VR66OSFZSCICZHEP5MGJK,"In Spain, one in four of its workforce is without a job, and the latest prediction from the EU says Spain is going to stay in recession for some time to come.",126,135,recession,9,3,12
3LXX8KJXPWA5SPW41ZYDSECDLZ49OZ,"The allegations of election fraud have fired up the opposition, which has long seen its protests crushed and its pleas ignored by the Kremlin-dominated media.",4,15,allegations,10,10,20
3LXX8KJXPWA5SPW41ZYDSECDLZ49OZ,"The allegations of election fraud have fired up the opposition, which has long seen its protests crushed and its pleas ignored by the Kremlin-dominated media.",4,33,allegations of election fraud,1,0,1
3LXX8KJXPWA5SPW41ZYDSECDLZ49OZ,"The allegations of election fraud have fired up the opposition, which has long seen its protests crushed and its pleas ignored by the Kremlin-dominated media.",19,33,election fraud,2,2,4
3LXX8KJXPWA5SPW41ZYDSECDLZ49OZ,"The allegations of election fraud have fired up the opposition, which has long seen its protests crushed and its pleas ignored by the Kremlin-dominated media.",28,33,fraud,1,1,2
3LXX8KJXPWA5SPW41ZYDSECDLZ49OZ,"The allegations of election fraud have fired up the opposition, which has long seen its protests crushed and its pleas ignored by the Kremlin-dominated media.",39,44,fired,0,1,1
3LXX8KJXPWA5SPW41ZYDSECDLZ49OZ,"The allegations of election fraud have fired up the opposition, which has long seen its protests crushed and its pleas ignored by the Kremlin-dominated media.",39,47,fired up,0,1,1
3LXX8KJXPWA5SPW41ZYDSECDLZ49OZ,"The allegations of election fraud have fired up the opposition, which has long seen its protests crushed and its pleas ignored by the Kremlin-dominated media.",52,62,opposition,4,1,5
3LXX8KJXPWA5SPW41ZYDSECDLZ49OZ,"The allegations of election fraud have fired up the opposition, which has long seen its protests crushed and its pleas ignored by the Kremlin-dominated media.",88,104,protests crushed,0,1,1
3LXX8KJXPWA5SPW41ZYDSECDLZ49OZ,"The allegations of election fraud have fired up the opposition, which has long seen its protests crushed and its pleas ignored by the Kremlin-dominated media.",97,104,crushed,0,2,2
3LXX8KJXPWA5SPW41ZYDSECDLZ49OZ,"The allegations of election fraud have fired up the opposition, which has long seen its protests crushed and its pleas ignored by the Kremlin-dominated media.",113,118,pleas,3,6,9
3LXX8KJXPWA5SPW41ZYDSECDLZ49OZ,"The allegations of election fraud have fired up the opposition, which has long seen its protests crushed and its pleas ignored by the Kremlin-dominated media.",119,126,ignored,0,2,2
3LXX8KJXPWA5SPW41ZYDSECDLZ49OZ,"The allegations of election fraud have fired up the opposition, which has long seen its protests crushed and its pleas ignored by the Kremlin-dominated media.",134,151,Kremlin-dominated,6,0,6
3LXX8KJXPWA5SPW41ZYDSECDLZ49OZ,"The allegations of election fraud have fired up the opposition, which has long seen its protests crushed and its pleas ignored by the Kremlin-dominated media.",134,157,Kremlin-dominated media,5,0,5
3LXX8KJXPWA5SPW41ZYDSECDLZ49OZ,"On Facebook, more than 12,000 people signed up to a page announcing an opposition rally for Saturday - and many of them have never taken part in political demonstrations Mariya Boyarintseva, a 24-year-old event manager, told The Associated Press that she has never been to a political rally before but she was going to Saturday's protest.",57,67,announcing,2,0,2
3LXX8KJXPWA5SPW41ZYDSECDLZ49OZ,"On Facebook, more than 12,000 people signed up to a page announcing an opposition rally for Saturday - and many of them have never taken part in political demonstrations Mariya Boyarintseva, a 24-year-old event manager, told The Associated Press that she has never been to a political rally before but she was going to Saturday's protest.",71,81,opposition,4,0,4
3LXX8KJXPWA5SPW41ZYDSECDLZ49OZ,"On Facebook, more than 12,000 people signed up to a page announcing an opposition rally for Saturday - and many of them have never taken part in political demonstrations Mariya Boyarintseva, a 24-year-old event manager, told The Associated Press that she has never been to a political rally before but she was going to Saturday's protest.",71,87,opposition rally,6,0,6
3LXX8KJXPWA5SPW41ZYDSECDLZ49OZ,"On Facebook, more than 12,000 people signed up to a page announcing an opposition rally for Saturday - and many of them have never taken part in political demonstrations Mariya Boyarintseva, a 24-year-old event manager, told The Associated Press that she has never been to a political rally before but she was going to Saturday's protest.",82,87,rally,0,2,2
3LXX8KJXPWA5SPW41ZYDSECDLZ49OZ,"On Facebook, more than 12,000 people signed up to a page announcing an opposition rally for Saturday - and many of them have never taken part in political demonstrations Mariya Boyarintseva, a 24-year-old event manager, told The Associated Press that she has never been to a political rally before but she was going to Saturday's protest.",145,169,political demonstrations,5,2,7
3LXX8KJXPWA5SPW41ZYDSECDLZ49OZ,"On Facebook, more than 12,000 people signed up to a page announcing an opposition rally for Saturday - and many of them have never taken part in political demonstrations Mariya Boyarintseva, a 24-year-old event manager, told The Associated Press that she has never been to a political rally before but she was going to Saturday's protest.",155,169,demonstrations,7,4,11
3LXX8KJXPWA5SPW41ZYDSECDLZ49OZ,"On Facebook, more than 12,000 people signed up to a page announcing an opposition rally for Saturday - and many of them have never taken part in political demonstrations Mariya Boyarintseva, a 24-year-old event manager, told The Associated Press that she has never been to a political rally before but she was going to Saturday's protest.",229,239,Associated,0,1,1
3LXX8KJXPWA5SPW41ZYDSECDLZ49OZ,"On Facebook, more than 12,000 people signed up to a page announcing an opposition rally for Saturday - and many of them have never taken part in political demonstrations Mariya Boyarintseva, a 24-year-old event manager, told The Associated Press that she has never been to a political rally before but she was going to Saturday's protest.",229,245,Associated Press,0,1,1
3LXX8KJXPWA5SPW41ZYDSECDLZ49OZ,"On Facebook, more than 12,000 people signed up to a page announcing an opposition rally for Saturday - and many of them have never taken part in political demonstrations Mariya Boyarintseva, a 24-year-old event manager, told The Associated Press that she has never been to a political rally before but she was going to Saturday's protest.",275,290,political rally,2,0,2
3LXX8KJXPWA5SPW41ZYDSECDLZ49OZ,"On Facebook, more than 12,000 people signed up to a page announcing an opposition rally for Saturday - and many of them have never taken part in political demonstrations Mariya Boyarintseva, a 24-year-old event manager, told The Associated Press that she has never been to a political rally before but she was going to Saturday's protest.",285,290,rally,0,2,2
3LXX8KJXPWA5SPW41ZYDSECDLZ49OZ,"On Facebook, more than 12,000 people signed up to a page announcing an opposition rally for Saturday - and many of them have never taken part in political demonstrations Mariya Boyarintseva, a 24-year-old event manager, told The Associated Press that she has never been to a political rally before but she was going to Saturday's protest.",330,337,protest,0,1,1
3LXX8KJXPWA5SPW41ZYDSECDLZ49OZ,"Boyarintseva said she didn't go to rallies Monday or Tuesday in Moscow - which ended with clashes with police and hundreds detained - because ""it felt a bit scary.""",35,42,rallies,2,2,4
3LXX8KJXPWA5SPW41ZYDSECDLZ49OZ,"Boyarintseva said she didn't go to rallies Monday or Tuesday in Moscow - which ended with clashes with police and hundreds detained - because ""it felt a bit scary.""",90,97,clashes,3,2,5
3LXX8KJXPWA5SPW41ZYDSECDLZ49OZ,"Boyarintseva said she didn't go to rallies Monday or Tuesday in Moscow - which ended with clashes with police and hundreds detained - because ""it felt a bit scary.""",123,131,detained,10,10,20
3LXX8KJXPWA5SPW41ZYDSECDLZ49OZ,"Boyarintseva said she didn't go to rallies Monday or Tuesday in Moscow - which ended with clashes with police and hundreds detained - because ""it felt a bit scary.""",157,162,scary,1,7,8
3LXX8KJXPWA5SPW41ZYDSECDLZ49OZ,Anti-Putin demonstrators take to streets as preliminary results indicate his United Russia party won less than 50% of votes Thousands of security forces have been patrolling Moscow while helicopters roam the sky amid protests over scandal-hit elections that saw Vladimir Putin's party struggle to keep a majority.,0,10,Anti-Putin,0,1,1
3LXX8KJXPWA5SPW41ZYDSECDLZ49OZ,Anti-Putin demonstrators take to streets as preliminary results indicate his United Russia party won less than 50% of votes Thousands of security forces have been patrolling Moscow while helicopters roam the sky amid protests over scandal-hit elections that saw Vladimir Putin's party struggle to keep a majority.,0,24,Anti-Putin demonstrators,1,0,1
3LXX8KJXPWA5SPW41ZYDSECDLZ49OZ,Anti-Putin demonstrators take to streets as preliminary results indicate his United Russia party won less than 50% of votes Thousands of security forces have been patrolling Moscow while helicopters roam the sky amid protests over scandal-hit elections that saw Vladimir Putin's party struggle to keep a majority.,11,24,demonstrators,8,2,10
3LXX8KJXPWA5SPW41ZYDSECDLZ49OZ,Anti-Putin demonstrators take to streets as preliminary results indicate his United Russia party won less than 50% of votes Thousands of security forces have been patrolling Moscow while helicopters roam the sky amid protests over scandal-hit elections that saw Vladimir Putin's party struggle to keep a majority.,44,55,preliminary,9,5,14
3LXX8KJXPWA5SPW41ZYDSECDLZ49OZ,Anti-Putin demonstrators take to streets as preliminary results indicate his United Russia party won less than 50% of votes Thousands of security forces have been patrolling Moscow while helicopters roam the sky amid protests over scandal-hit elections that saw Vladimir Putin's party struggle to keep a majority.,44,63,preliminary results,3,0,3
3LXX8KJXPWA5SPW41ZYDSECDLZ49OZ,Anti-Putin demonstrators take to streets as preliminary results indicate his United Russia party won less than 50% of votes Thousands of security forces have been patrolling Moscow while helicopters roam the sky amid protests over scandal-hit elections that saw Vladimir Putin's party struggle to keep a majority.,137,152,security forces,2,0,2
3LXX8KJXPWA5SPW41ZYDSECDLZ49OZ,Anti-Putin demonstrators take to streets as preliminary results indicate his United Russia party won less than 50% of votes Thousands of security forces have been patrolling Moscow while helicopters roam the sky amid protests over scandal-hit elections that saw Vladimir Putin's party struggle to keep a majority.,163,173,patrolling,8,6,14
3LXX8KJXPWA5SPW41ZYDSECDLZ49OZ,Anti-Putin demonstrators take to streets as preliminary results indicate his United Russia party won less than 50% of votes Thousands of security forces have been patrolling Moscow while helicopters roam the sky amid protests over scandal-hit elections that saw Vladimir Putin's party struggle to keep a majority.,187,198,helicopters,2,0,2
3LXX8KJXPWA5SPW41ZYDSECDLZ49OZ,Anti-Putin demonstrators take to streets as preliminary results indicate his United Russia party won less than 50% of votes Thousands of security forces have been patrolling Moscow while helicopters roam the sky amid protests over scandal-hit elections that saw Vladimir Putin's party struggle to keep a majority.,199,203,roam,1,1,2
3LXX8KJXPWA5SPW41ZYDSECDLZ49OZ,Anti-Putin demonstrators take to streets as preliminary results indicate his United Russia party won less than 50% of votes Thousands of security forces have been patrolling Moscow while helicopters roam the sky amid protests over scandal-hit elections that saw Vladimir Putin's party struggle to keep a majority.,212,216,amid,4,4,8
3LXX8KJXPWA5SPW41ZYDSECDLZ49OZ,Anti-Putin demonstrators take to streets as preliminary results indicate his United Russia party won less than 50% of votes Thousands of security forces have been patrolling Moscow while helicopters roam the sky amid protests over scandal-hit elections that saw Vladimir Putin's party struggle to keep a majority.,212,225,amid protests,1,1,2
3LXX8KJXPWA5SPW41ZYDSECDLZ49OZ,Anti-Putin demonstrators take to streets as preliminary results indicate his United Russia party won less than 50% of votes Thousands of security forces have been patrolling Moscow while helicopters roam the sky amid protests over scandal-hit elections that saw Vladimir Putin's party struggle to keep a majority.,231,242,scandal-hit,5,3,8
3LXX8KJXPWA5SPW41ZYDSECDLZ49OZ,Anti-Putin demonstrators take to streets as preliminary results indicate his United Russia party won less than 50% of votes Thousands of security forces have been patrolling Moscow while helicopters roam the sky amid protests over scandal-hit elections that saw Vladimir Putin's party struggle to keep a majority.,231,252,scandal-hit elections,2,2,4
3LXX8KJXPWA5SPW41ZYDSECDLZ49OZ,Anti-Putin demonstrators take to streets as preliminary results indicate his United Russia party won less than 50% of votes Thousands of security forces have been patrolling Moscow while helicopters roam the sky amid protests over scandal-hit elections that saw Vladimir Putin's party struggle to keep a majority.,285,293,struggle,0,3,3
3LXX8KJXPWA5SPW41ZYDSECDLZ49OZ,Anti-Putin demonstrators take to streets as preliminary results indicate his United Russia party won less than 50% of votes Thousands of security forces have been patrolling Moscow while helicopters roam the sky amid protests over scandal-hit elections that saw Vladimir Putin's party struggle to keep a majority.,304,312,majority,1,1,2
39KV3A5D188GCY04TJH2YNV8NYJ7SI,Assembly Deputy First Minister Martin McGuinness said he had visited the women's family over the weekend.,0,8,Assembly,2,0,2
39KV3A5D188GCY04TJH2YNV8NYJ7SI,Assembly Deputy First Minister Martin McGuinness said he had visited the women's family over the weekend.,0,15,Assembly Deputy,1,0,1
39KV3A5D188GCY04TJH2YNV8NYJ7SI,Assembly Deputy First Minister Martin McGuinness said he had visited the women's family over the weekend.,0,30,Assembly Deputy First Minister,2,1,3
39KV3A5D188GCY04TJH2YNV8NYJ7SI,Assembly Deputy First Minister Martin McGuinness said he had visited the women's family over the weekend.,22,30,Minister,1,0,1
39KV3A5D188GCY04TJH2YNV8NYJ7SI,Assembly Deputy First Minister Martin McGuinness said he had visited the women's family over the weekend.,61,68,visited,0,1,1
39KV3A5D188GCY04TJH2YNV8NYJ7SI,He said the family was in deep shock and had appealed to the media to respect their privacy.,26,36,deep shock,1,1,2
39KV3A5D188GCY04TJH2YNV8NYJ7SI,He said the family was in deep shock and had appealed to the media to respect their privacy.,31,36,shock,1,0,1
39KV3A5D188GCY04TJH2YNV8NYJ7SI,He said the family was in deep shock and had appealed to the media to respect their privacy.,45,53,appealed,10,7,17
39KV3A5D188GCY04TJH2YNV8NYJ7SI,He said the family was in deep shock and had appealed to the media to respect their privacy.,61,66,media,2,1,3
39KV3A5D188GCY04TJH2YNV8NYJ7SI,He said the family was in deep shock and had appealed to the media to respect their privacy.,70,77,respect,0,1,1
39KV3A5D188GCY04TJH2YNV8NYJ7SI,He said the family was in deep shock and had appealed to the media to respect their privacy.,70,91,respect their privacy,1,0,1
39KV3A5D188GCY04TJH2YNV8NYJ7SI,He said the family was in deep shock and had appealed to the media to respect their privacy.,84,91,privacy,1,1,2
39KV3A5D188GCY04TJH2YNV8NYJ7SI,"This family is clearly deeply shocked and traumatised by what has happened over the weekend, he said.",31,38,shocked,1,1,2
39KV3A5D188GCY04TJH2YNV8NYJ7SI,"This family is clearly deeply shocked and traumatised by what has happened over the weekend, he said.",31,54,shocked and traumatised,2,0,2
39KV3A5D188GCY04TJH2YNV8NYJ7SI,"This family is clearly deeply shocked and traumatised by what has happened over the weekend, he said.",43,54,traumatised,10,10,20
39KV3A5D188GCY04TJH2YNV8NYJ7SI,"I spent some time with the family and offered our support and that of the wider community at this time.	39	46	offered	0	1	1
39KV3A5D188GCY04TJH2YNV8NYJ7SI	I spent some time with the family and offered our support and that of the wider community at this time.",39,58,offered our support,0,1,1
39KV3A5D188GCY04TJH2YNV8NYJ7SI,"I spent some time with the family and offered our support and that of the wider community at this time.	75	80	wider	0	1	1
39KV3A5D188GCY04TJH2YNV8NYJ7SI	I spent some time with the family and offered our support and that of the wider community at this time.",75,90,wider community,3,1,4
39KV3A5D188GCY04TJH2YNV8NYJ7SI,"I spent some time with the family and offered our support and that of the wider community at this time.	81	90	community	1	0	1
39KV3A5D188GCY04TJH2YNV8NYJ7SI	The family have asked me to appeal to the media for privacy as they seek to come to terms with this tragedy in the coming days.""",26,35,to appeal,0,1,1
39KV3A5D188GCY04TJH2YNV8NYJ7SI,The family have asked me to appeal to the media for privacy as they seek to come to terms with this tragedy in the coming days.,29,35,appeal,3,2,5
39KV3A5D188GCY04TJH2YNV8NYJ7SI,The family have asked me to appeal to the media for privacy as they seek to come to terms with this tragedy in the coming days.,29,48,appeal to the media,0,1,1
39KV3A5D188GCY04TJH2YNV8NYJ7SI,The family have asked me to appeal to the media for privacy as they seek to come to terms with this tragedy in the coming days.,43,48,media,1,0,1
39KV3A5D188GCY04TJH2YNV8NYJ7SI,The family have asked me to appeal to the media for privacy as they seek to come to terms with this tragedy in the coming days.,53,60,privacy,1,2,3
39KV3A5D188GCY04TJH2YNV8NYJ7SI,The family have asked me to appeal to the media for privacy as they seek to come to terms with this tragedy in the coming days.,69,73,seek,1,1,2
39KV3A5D188GCY04TJH2YNV8NYJ7SI,The family have asked me to appeal to the media for privacy as they seek to come to terms with this tragedy in the coming days.,85,90,terms,0,1,1
39KV3A5D188GCY04TJH2YNV8NYJ7SI,The family have asked me to appeal to the media for privacy as they seek to come to terms with this tragedy in the coming days.,101,108,tragedy,6,8,14
39KV3A5D188GCY04TJH2YNV8NYJ7SI,Israel's outgoing ambassadoe to Egypt visited Cairo on Sunday for the first time since Israeli diplomats were returned to Israel following an attack on the Israeli embassy by Egyptian protesters two months ago.,9,17,outgoing,2,1,3
39KV3A5D188GCY04TJH2YNV8NYJ7SI,Israel's outgoing ambassadoe to Egypt visited Cairo on Sunday for the first time since Israeli diplomats were returned to Israel following an attack on the Israeli embassy by Egyptian protesters two months ago.,9,28,outgoing ambassadoe,2,1,3
39KV3A5D188GCY04TJH2YNV8NYJ7SI,Israel's outgoing ambassadoe to Egypt visited Cairo on Sunday for the first time since Israeli diplomats were returned to Israel following an attack on the Israeli embassy by Egyptian protesters two months ago.,18,28,ambassadoe,10,3,13
39KV3A5D188GCY04TJH2YNV8NYJ7SI,Israel's outgoing ambassadoe to Egypt visited Cairo on Sunday for the first time since Israeli diplomats were returned to Israel following an attack on the Israeli embassy by Egyptian protesters two months ago.,95,104,diplomats,8,8,16
39KV3A5D188GCY04TJH2YNV8NYJ7SI,Israel's outgoing ambassadoe to Egypt visited Cairo on Sunday for the first time since Israeli diplomats were returned to Israel following an attack on the Israeli embassy by Egyptian protesters two months ago.,164,171,embassy,6,2,8
39KV3A5D188GCY04TJH2YNV8NYJ7SI,Israel's outgoing ambassadoe to Egypt visited Cairo on Sunday for the first time since Israeli diplomats were returned to Israel following an attack on the Israeli embassy by Egyptian protesters two months ago.,184,194,protesters,2,7,9
3BS6ERDL938R693HDJHLXA9CQ7M6DU,"The U.S. president, who is in the midst of a re-election campaign, touted the Navy SEAL raid that killed bin Laden a year ago Wednesday, noting that the operation was launched from a base in Afghanistan.",34,39,midst,7,6,13
3BS6ERDL938R693HDJHLXA9CQ7M6DU,"The U.S. president, who is in the midst of a re-election campaign, touted the Navy SEAL raid that killed bin Laden a year ago Wednesday, noting that the operation was launched from a base in Afghanistan.",34,65,midst of a re-election campaign,1,0,1
3BS6ERDL938R693HDJHLXA9CQ7M6DU,"The U.S. president, who is in the midst of a re-election campaign, touted the Navy SEAL raid that killed bin Laden a year ago Wednesday, noting that the operation was launched from a base in Afghanistan.",45,65,re-election campaign,1,1,2
3BS6ERDL938R693HDJHLXA9CQ7M6DU,"The U.S. president, who is in the midst of a re-election campaign, touted the Navy SEAL raid that killed bin Laden a year ago Wednesday, noting that the operation was launched from a base in Afghanistan.",57,65,campaign,5,2,7
3BS6ERDL938R693HDJHLXA9CQ7M6DU,"The U.S. president, who is in the midst of a re-election campaign, touted the Navy SEAL raid that killed bin Laden a year ago Wednesday, noting that the operation was launched from a base in Afghanistan.",67,73,touted,6,10,16
3BS6ERDL938R693HDJHLXA9CQ7M6DU,"The U.S. president, who is in the midst of a re-election campaign, touted the Navy SEAL raid that killed bin Laden a year ago Wednesday, noting that the operation was launched from a base in Afghanistan.",67,92,touted the Navy SEAL raid,1,0,1
3BS6ERDL938R693HDJHLXA9CQ7M6DU,"The U.S. president, who is in the midst of a re-election campaign, touted the Navy SEAL raid that killed bin Laden a year ago Wednesday, noting that the operation was launched from a base in Afghanistan.",137,143,noting,1,0,1
3BS6ERDL938R693HDJHLXA9CQ7M6DU,"The U.S. president, who is in the midst of a re-election campaign, touted the Navy SEAL raid that killed bin Laden a year ago Wednesday, noting that the operation was launched from a base in Afghanistan.",153,162,operation,3,0,3
3BS6ERDL938R693HDJHLXA9CQ7M6DU,"The U.S. president, who is in the midst of a re-election campaign, touted the Navy SEAL raid that killed bin Laden a year ago Wednesday, noting that the operation was launched from a base in Afghanistan.",167,175,launched,2,3,5
3BS6ERDL938R693HDJHLXA9CQ7M6DU,"He also said that ""the tide has turned"" over the last three years.",19,38,the tide has turned,5,2,7
3BS6ERDL938R693HDJHLXA9CQ7M6DU,"He also said that ""the tide has turned"" over the last three years.",23,27,tide,0,1,1
3BS6ERDL938R693HDJHLXA9CQ7M6DU,"He also said that ""the tide has turned"" over the last three years.",23,38,tide has turned,1,2,3
3BS6ERDL938R693HDJHLXA9CQ7M6DU,"We broke the Taliban's momentum.	4	31	broke the Talibans momentum	1	0	1
3BS6ERDL938R693HDJHLXA9CQ7M6DU	We broke the Taliban's momentum.",14,22,Talibans,1,0,1
3BS6ERDL938R693HDJHLXA9CQ7M6DU,"We broke the Taliban's momentum.	24	32	momentum	9	8	17
3BS6ERDL938R693HDJHLXA9CQ7M6DU	We've built strong Afghan security forces.	19	34	Afghan security	1	0	1
3BS6ERDL938R693HDJHLXA9CQ7M6DU	We've built strong Afghan security forces.	26	34	security	1	0	1
3BS6ERDL938R693HDJHLXA9CQ7M6DU	We've built strong Afghan security forces.	26	41	security forces	0	1	1
3BS6ERDL938R693HDJHLXA9CQ7M6DU	We devastated al-Qaida's leadership, taking out over 20 of their top 30 leaders, he said.",3,13,devastated,10,10,20
3BS6ERDL938R693HDJHLXA9CQ7M6DU,"We devastated al-Qaida's leadership, taking out over 20 of their top 30 leaders,"" he said.",14,23,al-Qaidas,1,0,1
3BS6ERDL938R693HDJHLXA9CQ7M6DU,But the violence that erupted about 90 minutes after his departure was a stark reminder of the difficult task still ahead for Afghan troops as they work to secure their country after U.S. and other foreign troops end their combat mission following nearly a decade at war.,8,16,violence,0,2,2
3BS6ERDL938R693HDJHLXA9CQ7M6DU,But the violence that erupted about 90 minutes after his departure was a stark reminder of the difficult task still ahead for Afghan troops as they work to secure their country after U.S. and other foreign troops end their combat mission following nearly a decade at war.,22,29,erupted,9,9,18
3BS6ERDL938R693HDJHLXA9CQ7M6DU,But the violence that erupted about 90 minutes after his departure was a stark reminder of the difficult task still ahead for Afghan troops as they work to secure their country after U.S. and other foreign troops end their combat mission following nearly a decade at war.,57,66,departure,2,1,3
3BS6ERDL938R693HDJHLXA9CQ7M6DU,But the violence that erupted about 90 minutes after his departure was a stark reminder of the difficult task still ahead for Afghan troops as they work to secure their country after U.S. and other foreign troops end their combat mission following nearly a decade at war.,73,78,stark,4,5,9
3BS6ERDL938R693HDJHLXA9CQ7M6DU,But the violence that erupted about 90 minutes after his departure was a stark reminder of the difficult task still ahead for Afghan troops as they work to secure their country after U.S. and other foreign troops end their combat mission following nearly a decade at war.,73,87,stark reminder,3,6,9
3BS6ERDL938R693HDJHLXA9CQ7M6DU,But the violence that erupted about 90 minutes after his departure was a stark reminder of the difficult task still ahead for Afghan troops as they work to secure their country after U.S. and other foreign troops end their combat mission following nearly a decade at war.,95,104,difficult,1,0,1
3BS6ERDL938R693HDJHLXA9CQ7M6DU,But the violence that erupted about 90 minutes after his departure was a stark reminder of the difficult task still ahead for Afghan troops as they work to secure their country after U.S. and other foreign troops end their combat mission following nearly a decade at war.,95,109,difficult task,0,1,1
3BS6ERDL938R693HDJHLXA9CQ7M6DU,But the violence that erupted about 90 minutes after his departure was a stark reminder of the difficult task still ahead for Afghan troops as they work to secure their country after U.S. and other foreign troops end their combat mission following nearly a decade at war.,126,139,Afghan troops,1,0,1
3BS6ERDL938R693HDJHLXA9CQ7M6DU,But the violence that erupted about 90 minutes after his departure was a stark reminder of the difficult task still ahead for Afghan troops as they work to secure their country after U.S. and other foreign troops end their combat mission following nearly a decade at war.,156,162,secure,1,0,1
3BS6ERDL938R693HDJHLXA9CQ7M6DU,But the violence that erupted about 90 minutes after his departure was a stark reminder of the difficult task still ahead for Afghan troops as they work to secure their country after U.S. and other foreign troops end their combat mission following nearly a decade at war.,198,205,foreign,1,0,1
3BS6ERDL938R693HDJHLXA9CQ7M6DU,But the violence that erupted about 90 minutes after his departure was a stark reminder of the difficult task still ahead for Afghan troops as they work to secure their country after U.S. and other foreign troops end their combat mission following nearly a decade at war.,206,212,troops,0,1,1
3BS6ERDL938R693HDJHLXA9CQ7M6DU,But the violence that erupted about 90 minutes after his departure was a stark reminder of the difficult task still ahead for Afghan troops as they work to secure their country after U.S. and other foreign troops end their combat mission following nearly a decade at war.,223,229,combat,3,1,4
3BS6ERDL938R693HDJHLXA9CQ7M6DU,But the violence that erupted about 90 minutes after his departure was a stark reminder of the difficult task still ahead for Afghan troops as they work to secure their country after U.S. and other foreign troops end their combat mission following nearly a decade at war.,223,237,combat mission,3,5,8
3BS6ERDL938R693HDJHLXA9CQ7M6DU,But the violence that erupted about 90 minutes after his departure was a stark reminder of the difficult task still ahead for Afghan troops as they work to secure their country after U.S. and other foreign troops end their combat mission following nearly a decade at war.,223,247,combat mission following,1,0,1
3BS6ERDL938R693HDJHLXA9CQ7M6DU,But the violence that erupted about 90 minutes after his departure was a stark reminder of the difficult task still ahead for Afghan troops as they work to secure their country after U.S. and other foreign troops end their combat mission following nearly a decade at war.,257,263,decade,3,6,9
341YLJU21I0KWJ02IV6TYU8D2J7I2U,"It does not commit Washington to specific troop or funding levels for Afghanistan, though is meant to signal U.S. foes that despite ending the longest war in U.S. history, Washington intends to ensure Afghanistan does not revert to a haven for terror groups like al-Qaeda.",12,18,commit,3,3,6
341YLJU21I0KWJ02IV6TYU8D2J7I2U,"It does not commit Washington to specific troop or funding levels for Afghanistan, though is meant to signal U.S. foes that despite ending the longest war in U.S. history, Washington intends to ensure Afghanistan does not revert to a haven for terror groups like al-Qaeda.",33,41,specific,1,1,2
341YLJU21I0KWJ02IV6TYU8D2J7I2U,"It does not commit Washington to specific troop or funding levels for Afghanistan, though is meant to signal U.S. foes that despite ending the longest war in U.S. history, Washington intends to ensure Afghanistan does not revert to a haven for terror groups like al-Qaeda.",33,65,specific troop or funding levels,1,0,1
341YLJU21I0KWJ02IV6TYU8D2J7I2U,"It does not commit Washington to specific troop or funding levels for Afghanistan, though is meant to signal U.S. foes that despite ending the longest war in U.S. history, Washington intends to ensure Afghanistan does not revert to a haven for terror groups like al-Qaeda.",51,58,funding,0,2,2
341YLJU21I0KWJ02IV6TYU8D2J7I2U,"It does not commit Washington to specific troop or funding levels for Afghanistan, though is meant to signal U.S. foes that despite ending the longest war in U.S. history, Washington intends to ensure Afghanistan does not revert to a haven for terror groups like al-Qaeda.",51,65,funding levels,2,2,4
341YLJU21I0KWJ02IV6TYU8D2J7I2U,"It does not commit Washington to specific troop or funding levels for Afghanistan, though is meant to signal U.S. foes that despite ending the longest war in U.S. history, Washington intends to ensure Afghanistan does not revert to a haven for terror groups like al-Qaeda.",59,65,levels,1,0,1
341YLJU21I0KWJ02IV6TYU8D2J7I2U,"It does not commit Washington to specific troop or funding levels for Afghanistan, though is meant to signal U.S. foes that despite ending the longest war in U.S. history, Washington intends to ensure Afghanistan does not revert to a haven for terror groups like al-Qaeda.",70,81,Afghanistan,1,0,1
341YLJU21I0KWJ02IV6TYU8D2J7I2U,"It does not commit Washington to specific troop or funding levels for Afghanistan, though is meant to signal U.S. foes that despite ending the longest war in U.S. history, Washington intends to ensure Afghanistan does not revert to a haven for terror groups like al-Qaeda.",93,98,meant,0,1,1
341YLJU21I0KWJ02IV6TYU8D2J7I2U,"It does not commit Washington to specific troop or funding levels for Afghanistan, though is meant to signal U.S. foes that despite ending the longest war in U.S. history, Washington intends to ensure Afghanistan does not revert to a haven for terror groups like al-Qaeda.",93,108,meant to signal,1,0,1
341YLJU21I0KWJ02IV6TYU8D2J7I2U,"It does not commit Washington to specific troop or funding levels for Afghanistan, though is meant to signal U.S. foes that despite ending the longest war in U.S. history, Washington intends to ensure Afghanistan does not revert to a haven for terror groups like al-Qaeda.",102,108,signal,0,1,1
341YLJU21I0KWJ02IV6TYU8D2J7I2U,"It does not commit Washington to specific troop or funding levels for Afghanistan, though is meant to signal U.S. foes that despite ending the longest war in U.S. history, Washington intends to ensure Afghanistan does not revert to a haven for terror groups like al-Qaeda.",109,118,U.S. foes,1,0,1
341YLJU21I0KWJ02IV6TYU8D2J7I2U,"It does not commit Washington to specific troop or funding levels for Afghanistan, though is meant to signal U.S. foes that despite ending the longest war in U.S. history, Washington intends to ensure Afghanistan does not revert to a haven for terror groups like al-Qaeda.",114,118,foes,3,6,9
341YLJU21I0KWJ02IV6TYU8D2J7I2U,"It does not commit Washington to specific troop or funding levels for Afghanistan, though is meant to signal U.S. foes that despite ending the longest war in U.S. history, Washington intends to ensure Afghanistan does not revert to a haven for terror groups like al-Qaeda.",124,131,despite,1,5,6
341YLJU21I0KWJ02IV6TYU8D2J7I2U,"It does not commit Washington to specific troop or funding levels for Afghanistan, though is meant to signal U.S. foes that despite ending the longest war in U.S. history, Washington intends to ensure Afghanistan does not revert to a haven for terror groups like al-Qaeda.",183,190,intends,5,3,8
341YLJU21I0KWJ02IV6TYU8D2J7I2U,"It does not commit Washington to specific troop or funding levels for Afghanistan, though is meant to signal U.S. foes that despite ending the longest war in U.S. history, Washington intends to ensure Afghanistan does not revert to a haven for terror groups like al-Qaeda.",194,200,ensure,2,4,6
341YLJU21I0KWJ02IV6TYU8D2J7I2U,"It does not commit Washington to specific troop or funding levels for Afghanistan, though is meant to signal U.S. foes that despite ending the longest war in U.S. history, Washington intends to ensure Afghanistan does not revert to a haven for terror groups like al-Qaeda.",201,212,Afghanistan,1,0,1
341YLJU21I0KWJ02IV6TYU8D2J7I2U,"It does not commit Washington to specific troop or funding levels for Afghanistan, though is meant to signal U.S. foes that despite ending the longest war in U.S. history, Washington intends to ensure Afghanistan does not revert to a haven for terror groups like al-Qaeda.",222,228,revert,5,6,11
341YLJU21I0KWJ02IV6TYU8D2J7I2U,"It does not commit Washington to specific troop or funding levels for Afghanistan, though is meant to signal U.S. foes that despite ending the longest war in U.S. history, Washington intends to ensure Afghanistan does not revert to a haven for terror groups like al-Qaeda.",222,239,revert to a haven,1,1,2
341YLJU21I0KWJ02IV6TYU8D2J7I2U,"It does not commit Washington to specific troop or funding levels for Afghanistan, though is meant to signal U.S. foes that despite ending the longest war in U.S. history, Washington intends to ensure Afghanistan does not revert to a haven for terror groups like al-Qaeda.",234,239,haven,6,7,13
341YLJU21I0KWJ02IV6TYU8D2J7I2U,"It does not commit Washington to specific troop or funding levels for Afghanistan, though is meant to signal U.S. foes that despite ending the longest war in U.S. history, Washington intends to ensure Afghanistan does not revert to a haven for terror groups like al-Qaeda.",244,250,terror,1,0,1
341YLJU21I0KWJ02IV6TYU8D2J7I2U,"It does not commit Washington to specific troop or funding levels for Afghanistan, though is meant to signal U.S. foes that despite ending the longest war in U.S. history, Washington intends to ensure Afghanistan does not revert to a haven for terror groups like al-Qaeda.",263,271,al-Qaeda,2,0,2
341YLJU21I0KWJ02IV6TYU8D2J7I2U,"But after a war that has cost the lives of nearly 3,000 U.S. and allied troops, maimed tens of thousands more, saw thousands of Afghans killed and cost hundreds of billions of dollars, Afghanistan’s future is deeply uncertain.",25,39,cost the lives,1,0,1
341YLJU21I0KWJ02IV6TYU8D2J7I2U,"But after a war that has cost the lives of nearly 3,000 U.S. and allied troops, maimed tens of thousands more, saw thousands of Afghans killed and cost hundreds of billions of dollars, Afghanistan’s future is deeply uncertain.",65,71,allied,1,4,5
341YLJU21I0KWJ02IV6TYU8D2J7I2U,"But after a war that has cost the lives of nearly 3,000 U.S. and allied troops, maimed tens of thousands more, saw thousands of Afghans killed and cost hundreds of billions of dollars, Afghanistan’s future is deeply uncertain.",65,78,allied troops,1,3,4
341YLJU21I0KWJ02IV6TYU8D2J7I2U,"But after a war that has cost the lives of nearly 3,000 U.S. and allied troops, maimed tens of thousands more, saw thousands of Afghans killed and cost hundreds of billions of dollars, Afghanistan’s future is deeply uncertain.",80,86,maimed,10,10,20
341YLJU21I0KWJ02IV6TYU8D2J7I2U,"But after a war that has cost the lives of nearly 3,000 U.S. and allied troops, maimed tens of thousands more, saw thousands of Afghans killed and cost hundreds of billions of dollars, Afghanistan’s future is deeply uncertain.",80,104,maimed tens of thousands,0,1,1
341YLJU21I0KWJ02IV6TYU8D2J7I2U,"But after a war that has cost the lives of nearly 3,000 U.S. and allied troops, maimed tens of thousands more, saw thousands of Afghans killed and cost hundreds of billions of dollars, Afghanistan’s future is deeply uncertain.",80,109,maimed tens of thousands more,0,1,1
341YLJU21I0KWJ02IV6TYU8D2J7I2U,"But after a war that has cost the lives of nearly 3,000 U.S. and allied troops, maimed tens of thousands more, saw thousands of Afghans killed and cost hundreds of billions of dollars, Afghanistan’s future is deeply uncertain.",128,135,Afghans,1,0,1
341YLJU21I0KWJ02IV6TYU8D2J7I2U,"But after a war that has cost the lives of nearly 3,000 U.S. and allied troops, maimed tens of thousands more, saw thousands of Afghans killed and cost hundreds of billions of dollars, Afghanistan’s future is deeply uncertain.",185,198,Afghanistan’s,1,0,1
341YLJU21I0KWJ02IV6TYU8D2J7I2U,"But after a war that has cost the lives of nearly 3,000 U.S. and allied troops, maimed tens of thousands more, saw thousands of Afghans killed and cost hundreds of billions of dollars, Afghanistan’s future is deeply uncertain.",209,215,deeply,0,1,1
341YLJU21I0KWJ02IV6TYU8D2J7I2U,"But after a war that has cost the lives of nearly 3,000 U.S. and allied troops, maimed tens of thousands more, saw thousands of Afghans killed and cost hundreds of billions of dollars, Afghanistan’s future is deeply uncertain.",209,225,deeply uncertain,0,1,1
341YLJU21I0KWJ02IV6TYU8D2J7I2U,"But after a war that has cost the lives of nearly 3,000 U.S. and allied troops, maimed tens of thousands more, saw thousands of Afghans killed and cost hundreds of billions of dollars, Afghanistan’s future is deeply uncertain.",216,225,uncertain,3,3,6
341YLJU21I0KWJ02IV6TYU8D2J7I2U,"PRESIDENT Barack Obama, speaking to a US television audience  from Bagram Air Base, said he had travelled there to herald a new era in the relationship between the US and Afghanistan, ''a future in which war ends, and a new chapter begins''.",10,16,Barack,1,0,1
341YLJU21I0KWJ02IV6TYU8D2J7I2U,"PRESIDENT Barack Obama, speaking to a US television audience  from Bagram Air Base, said he had travelled there to herald a new era in the relationship between the US and Afghanistan, ''a future in which war ends, and a new chapter begins''.",52,60,audience,2,2,4
341YLJU21I0KWJ02IV6TYU8D2J7I2U,"PRESIDENT Barack Obama, speaking to a US television audience  from Bagram Air Base, said he had travelled there to herald a new era in the relationship between the US and Afghanistan, ''a future in which war ends, and a new chapter begins''.",67,77,Bagram Air,1,0,1
341YLJU21I0KWJ02IV6TYU8D2J7I2U,"PRESIDENT Barack Obama, speaking to a US television audience  from Bagram Air Base, said he had travelled there to herald a new era in the relationship between the US and Afghanistan, ''a future in which war ends, and a new chapter begins''.",112,121,to herald,0,1,1
341YLJU21I0KWJ02IV6TYU8D2J7I2U,"PRESIDENT Barack Obama, speaking to a US television audience  from Bagram Air Base, said he had travelled there to herald a new era in the relationship between the US and Afghanistan, ''a future in which war ends, and a new chapter begins''.",115,121,herald,9,9,18
341YLJU21I0KWJ02IV6TYU8D2J7I2U,"PRESIDENT Barack Obama, speaking to a US television audience  from Bagram Air Base, said he had travelled there to herald a new era in the relationship between the US and Afghanistan, ''a future in which war ends, and a new chapter begins''.",115,131,herald a new era,3,0,3
341YLJU21I0KWJ02IV6TYU8D2J7I2U,"PRESIDENT Barack Obama, speaking to a US television audience  from Bagram Air Base, said he had travelled there to herald a new era in the relationship between the US and Afghanistan, ''a future in which war ends, and a new chapter begins''.",122,131,a new era,1,1,2
341YLJU21I0KWJ02IV6TYU8D2J7I2U,"PRESIDENT Barack Obama, speaking to a US television audience  from Bagram Air Base, said he had travelled there to herald a new era in the relationship between the US and Afghanistan, ''a future in which war ends, and a new chapter begins''.",124,131,new era,0,1,1
341YLJU21I0KWJ02IV6TYU8D2J7I2U,"PRESIDENT Barack Obama, speaking to a US television audience  from Bagram Air Base, said he had travelled there to herald a new era in the relationship between the US and Afghanistan, ''a future in which war ends, and a new chapter begins''.",116,119,era,2,1,3
341YLJU21I0KWJ02IV6TYU8D2J7I2U,"PRESIDENT Barack Obama, speaking to a US television audience  from Bagram Air Base, said he had travelled there to herald a new era in the relationship between the US and Afghanistan, ''a future in which war ends, and a new chapter begins''.",139,151,relationship,2,0,2
389A2A304OJMN6BOBY6T43H3THR0CH,The authorities identified her as Tonya Thomas.,4,15,authorities,7,3,10
389A2A304OJMN6BOBY6T43H3THR0CH,The authorities identified her as Tonya Thomas.,16,26,identified,1,4,5
389A2A304OJMN6BOBY6T43H3THR0CH,"The children were identified as Pebbles Johnson, 17; Jaxs Johnson, 15; Jazlin Johnson, 13; and Joel Johnson, 12.",18,28,identified,4,2,6
389A2A304OJMN6BOBY6T43H3THR0CH,"The children were identified as Pebbles Johnson, 17; Jaxs Johnson, 15; Jazlin Johnson, 13; and Joel Johnson, 12.",32,39,Pebbles,0,1,1
389A2A304OJMN6BOBY6T43H3THR0CH,Lieutenant Goodyear said at a news conference that the authorities had received a 911 call from a neighbor of Ms. Thomas at 4:50 a.m.,0,10,Lieutenant,8,1,9
389A2A304OJMN6BOBY6T43H3THR0CH,Lieutenant Goodyear said at a news conference that the authorities had received a 911 call from a neighbor of Ms. Thomas at 4:50 a.m.,30,45,news conference,2,1,3
389A2A304OJMN6BOBY6T43H3THR0CH,Lieutenant Goodyear said at a news conference that the authorities had received a 911 call from a neighbor of Ms. Thomas at 4:50 a.m.,35,45,conference,3,2,5
389A2A304OJMN6BOBY6T43H3THR0CH,Lieutenant Goodyear said at a news conference that the authorities had received a 911 call from a neighbor of Ms. Thomas at 4:50 a.m.,55,66,authorities,2,0,2
389A2A304OJMN6BOBY6T43H3THR0CH,The neighbor reported having heard gun shots from Ms. Thomas's home followed by a knock on her door.,4,12,neighbor,0,1,1
389A2A304OJMN6BOBY6T43H3THR0CH,The neighbor reported having heard gun shots from Ms. Thomas's home followed by a knock on her door.,13,21,reported,0,1,1
389A2A304OJMN6BOBY6T43H3THR0CH,The neighbor reported having heard gun shots from Ms. Thomas's home followed by a knock on her door.,29,34,heard,0,1,1
389A2A304OJMN6BOBY6T43H3THR0CH,The neighbor reported having heard gun shots from Ms. Thomas's home followed by a knock on her door.,82,87,knock,0,2,2
389A2A304OJMN6BOBY6T43H3THR0CH,The neighbor reported having heard gun shots from Ms. Thomas's home followed by a knock on her door.,82,99,knock on her door,1,0,1
389A2A304OJMN6BOBY6T43H3THR0CH,"The neighbor, whom the authorities have not identified, said that when she opened the door, three of Ms. Thomas' children were on the door step.",23,34,authorities,9,1,10
389A2A304OJMN6BOBY6T43H3THR0CH,"The neighbor, whom the authorities have not identified, said that when she opened the door, three of Ms. Thomas' children were on the door step.",44,54,identified,2,0,2
389A2A304OJMN6BOBY6T43H3THR0CH,"The neighbor, whom the authorities have not identified, said that when she opened the door, three of Ms. Thomas' children were on the door step.",134,143,door step,0,2,2
389A2A304OJMN6BOBY6T43H3THR0CH,"They did appear to be shot, Lieutenant Goodyear said.",10,16,appear,0,4,4
389A2A304OJMN6BOBY6T43H3THR0CH,"They did appear to be shot, Lieutenant Goodyear said.",30,40,Lieutenant,3,0,3
389A2A304OJMN6BOBY6T43H3THR0CH,"They did appear to be shot, Lieutenant Goodyear said.",30,49,Lieutenant Goodyear,0,1,1
389A2A304OJMN6BOBY6T43H3THR0CH,He did not describe the injuries.,11,19,describe,0,4,4
389A2A304OJMN6BOBY6T43H3THR0CH,He did not describe the injuries.,24,32,injuries,2,2,4
389A2A304OJMN6BOBY6T43H3THR0CH,"Moments later, the neighbor said, Ms. Thomas, 33, emerged from her house and called her children to come back home.",0,7,Moments,1,1,2
389A2A304OJMN6BOBY6T43H3THR0CH,"Moments later, the neighbor said, Ms. Thomas, 33, emerged from her house and called her children to come back home.",19,27,neighbor,0,1,1
389A2A304OJMN6BOBY6T43H3THR0CH,"Moments later, the neighbor said, Ms. Thomas, 33, emerged from her house and called her children to come back home.",50,57,emerged,9,10,19
382GHPVPHSSF9UX616IUN33M4GU342,"Goodyear said police previously responded to the Florida ""Space Coast"" home, about 15 miles south of Cape Canaveral, for domestic disturbance calls involving Jaxs Johnson.",0,8,Goodyear,1,0,1
382GHPVPHSSF9UX616IUN33M4GU342,"Goodyear said police previously responded to the Florida ""Space Coast"" home, about 15 miles south of Cape Canaveral, for domestic disturbance calls involving Jaxs Johnson.",21,31,previously,1,1,2
382GHPVPHSSF9UX616IUN33M4GU342,"Goodyear said police previously responded to the Florida ""Space Coast"" home, about 15 miles south of Cape Canaveral, for domestic disturbance calls involving Jaxs Johnson.",21,41,previously responded,1,0,1
382GHPVPHSSF9UX616IUN33M4GU342,"Goodyear said police previously responded to the Florida ""Space Coast"" home, about 15 miles south of Cape Canaveral, for domestic disturbance calls involving Jaxs Johnson.",32,41,responded,0,3,3
382GHPVPHSSF9UX616IUN33M4GU342,"Goodyear said police previously responded to the Florida ""Space Coast"" home, about 15 miles south of Cape Canaveral, for domestic disturbance calls involving Jaxs Johnson.",58,69,Space Coast,1,0,1
382GHPVPHSSF9UX616IUN33M4GU342,"Goodyear said police previously responded to the Florida ""Space Coast"" home, about 15 miles south of Cape Canaveral, for domestic disturbance calls involving Jaxs Johnson.",101,115,Cape Canaveral,1,1,2
382GHPVPHSSF9UX616IUN33M4GU342,"Goodyear said police previously responded to the Florida ""Space Coast"" home, about 15 miles south of Cape Canaveral, for domestic disturbance calls involving Jaxs Johnson.",121,129,domestic,2,2,4
382GHPVPHSSF9UX616IUN33M4GU342,"Goodyear said police previously responded to the Florida ""Space Coast"" home, about 15 miles south of Cape Canaveral, for domestic disturbance calls involving Jaxs Johnson.",121,141,domestic disturbance,7,3,10
382GHPVPHSSF9UX616IUN33M4GU342,"Goodyear said police previously responded to the Florida ""Space Coast"" home, about 15 miles south of Cape Canaveral, for domestic disturbance calls involving Jaxs Johnson.",121,147,domestic disturbance calls,2,0,2
382GHPVPHSSF9UX616IUN33M4GU342,"Goodyear said police previously responded to the Florida ""Space Coast"" home, about 15 miles south of Cape Canaveral, for domestic disturbance calls involving Jaxs Johnson.",130,141,disturbance,4,6,10
382GHPVPHSSF9UX616IUN33M4GU342,"Goodyear said police previously responded to the Florida ""Space Coast"" home, about 15 miles south of Cape Canaveral, for domestic disturbance calls involving Jaxs Johnson.",148,157,involving,0,1,1
382GHPVPHSSF9UX616IUN33M4GU342,"Goodyear said police previously responded to the Florida ""Space Coast"" home, about 15 miles south of Cape Canaveral, for domestic disturbance calls involving Jaxs Johnson.",158,170,Jaxs Johnson,1,0,1
382GHPVPHSSF9UX616IUN33M4GU342,"Goodyear said that of Tuesday afternoon, authorities had no motive for the killings.",41,52,authorities,5,2,7
382GHPVPHSSF9UX616IUN33M4GU342,"Goodyear said that of Tuesday afternoon, authorities had no motive for the killings.",60,66,motive,7,7,14
382GHPVPHSSF9UX616IUN33M4GU342,The Philippines foreign secretary has said he and the Chinese ambassador have agreed to resolve diplomatically a stand-off involving a Philippine warship and two Chinese surveillance vessels in a disputed area of the South China Sea.,16,23,foreign,1,1,2
382GHPVPHSSF9UX616IUN33M4GU342,The Philippines foreign secretary has said he and the Chinese ambassador have agreed to resolve diplomatically a stand-off involving a Philippine warship and two Chinese surveillance vessels in a disputed area of the South China Sea.,16,33,foreign secretary,3,1,4
382GHPVPHSSF9UX616IUN33M4GU342,The Philippines foreign secretary has said he and the Chinese ambassador have agreed to resolve diplomatically a stand-off involving a Philippine warship and two Chinese surveillance vessels in a disputed area of the South China Sea.,54,72,Chinese ambassador,1,0,1
382GHPVPHSSF9UX616IUN33M4GU342,The Philippines foreign secretary has said he and the Chinese ambassador have agreed to resolve diplomatically a stand-off involving a Philippine warship and two Chinese surveillance vessels in a disputed area of the South China Sea.,62,72,ambassador,3,3,6
382GHPVPHSSF9UX616IUN33M4GU342,The Philippines foreign secretary has said he and the Chinese ambassador have agreed to resolve diplomatically a stand-off involving a Philippine warship and two Chinese surveillance vessels in a disputed area of the South China Sea.,88,95,resolve,0,4,4
382GHPVPHSSF9UX616IUN33M4GU342,The Philippines foreign secretary has said he and the Chinese ambassador have agreed to resolve diplomatically a stand-off involving a Philippine warship and two Chinese surveillance vessels in a disputed area of the South China Sea.,88,110,resolve diplomatically,1,2,3
382GHPVPHSSF9UX616IUN33M4GU342,The Philippines foreign secretary has said he and the Chinese ambassador have agreed to resolve diplomatically a stand-off involving a Philippine warship and two Chinese surveillance vessels in a disputed area of the South China Sea.,96,110,diplomatically,6,6,12
382GHPVPHSSF9UX616IUN33M4GU342,The Philippines foreign secretary has said he and the Chinese ambassador have agreed to resolve diplomatically a stand-off involving a Philippine warship and two Chinese surveillance vessels in a disputed area of the South China Sea.,113,122,stand-off,5,10,15
382GHPVPHSSF9UX616IUN33M4GU342,The Philippines foreign secretary has said he and the Chinese ambassador have agreed to resolve diplomatically a stand-off involving a Philippine warship and two Chinese surveillance vessels in a disputed area of the South China Sea.,123,132,involving,0,1,1
382GHPVPHSSF9UX616IUN33M4GU342,The Philippines foreign secretary has said he and the Chinese ambassador have agreed to resolve diplomatically a stand-off involving a Philippine warship and two Chinese surveillance vessels in a disputed area of the South China Sea.,135,153,Philippine warship,1,0,1
382GHPVPHSSF9UX616IUN33M4GU342,The Philippines foreign secretary has said he and the Chinese ambassador have agreed to resolve diplomatically a stand-off involving a Philippine warship and two Chinese surveillance vessels in a disputed area of the South China Sea.,146,153,warship,1,0,1
382GHPVPHSSF9UX616IUN33M4GU342,The Philippines foreign secretary has said he and the Chinese ambassador have agreed to resolve diplomatically a stand-off involving a Philippine warship and two Chinese surveillance vessels in a disputed area of the South China Sea.,162,190,Chinese surveillance vessels,1,0,1
382GHPVPHSSF9UX616IUN33M4GU342,The Philippines foreign secretary has said he and the Chinese ambassador have agreed to resolve diplomatically a stand-off involving a Philippine warship and two Chinese surveillance vessels in a disputed area of the South China Sea.,170,182,surveillance,3,8,11
382GHPVPHSSF9UX616IUN33M4GU342,The Philippines foreign secretary has said he and the Chinese ambassador have agreed to resolve diplomatically a stand-off involving a Philippine warship and two Chinese surveillance vessels in a disputed area of the South China Sea.,170,190,surveillance vessels,5,3,8
382GHPVPHSSF9UX616IUN33M4GU342,The Philippines foreign secretary has said he and the Chinese ambassador have agreed to resolve diplomatically a stand-off involving a Philippine warship and two Chinese surveillance vessels in a disputed area of the South China Sea.,183,190,vessels,2,1,3
382GHPVPHSSF9UX616IUN33M4GU342,The Philippines foreign secretary has said he and the Chinese ambassador have agreed to resolve diplomatically a stand-off involving a Philippine warship and two Chinese surveillance vessels in a disputed area of the South China Sea.,196,204,disputed,5,2,7
382GHPVPHSSF9UX616IUN33M4GU342,The Philippines foreign secretary has said he and the Chinese ambassador have agreed to resolve diplomatically a stand-off involving a Philippine warship and two Chinese surveillance vessels in a disputed area of the South China Sea.,196,209,disputed area,0,3,3
382GHPVPHSSF9UX616IUN33M4GU342,Albert Del Rosario said he met ambassador Ma Keqing and both reaffirmed their governments' positions that the Scarborough Shoal where the ships are facing off was part of their own country's territory.,31,41,ambassador,3,0,3
382GHPVPHSSF9UX616IUN33M4GU342,Albert Del Rosario said he met ambassador Ma Keqing and both reaffirmed their governments' positions that the Scarborough Shoal where the ships are facing off was part of their own country's territory.,45,51,Keqing,0,1,1
382GHPVPHSSF9UX616IUN33M4GU342,Albert Del Rosario said he met ambassador Ma Keqing and both reaffirmed their governments' positions that the Scarborough Shoal where the ships are facing off was part of their own country's territory.,61,71,reaffirmed,9,9,18
382GHPVPHSSF9UX616IUN33M4GU342,Albert Del Rosario said he met ambassador Ma Keqing and both reaffirmed their governments' positions that the Scarborough Shoal where the ships are facing off was part of their own country's territory.,122,127,Shoal,0,2,2
382GHPVPHSSF9UX616IUN33M4GU342,Albert Del Rosario said he met ambassador Ma Keqing and both reaffirmed their governments' positions that the Scarborough Shoal where the ships are facing off was part of their own country's territory.,148,158,facing off,0,3,3
382GHPVPHSSF9UX616IUN33M4GU342,Albert Del Rosario said he met ambassador Ma Keqing and both reaffirmed their governments' positions that the Scarborough Shoal where the ships are facing off was part of their own country's territory.,191,200,territory,1,3,4
382GHPVPHSSF9UX616IUN33M4GU342,"Mr Del Rosario said that despite the impasse, ""we resolved to seek a diplomatic solution to the issue"".",25,32,despite,0,2,2
382GHPVPHSSF9UX616IUN33M4GU342,"Mr Del Rosario said that despite the impasse, ""we resolved to seek a diplomatic solution to the issue"".",37,44,impasse,10,10,20
382GHPVPHSSF9UX616IUN33M4GU342,"Mr Del Rosario said that despite the impasse, ""we resolved to seek a diplomatic solution to the issue"".",62,66,seek,0,1,1
382GHPVPHSSF9UX616IUN33M4GU342,"Mr Del Rosario said that despite the impasse, ""we resolved to seek a diplomatic solution to the issue"".",69,79,diplomatic,4,0,4
382GHPVPHSSF9UX616IUN33M4GU342,"Mr Del Rosario said that despite the impasse, ""we resolved to seek a diplomatic solution to the issue"".",69,88,diplomatic solution,5,0,5
382GHPVPHSSF9UX616IUN33M4GU342,"Mr Del Rosario said that despite the impasse, ""we resolved to seek a diplomatic solution to the issue"".",96,101,issue,0,1,1
3JHB4BPSFKA8D19KGCQHHJ7D00M9Q7,"Our stand since we agreed to acquire Motorola has not changed and we look forward to closing the deal, a Google spokesperson told AFP.",1,10,Our stand,0,1,1
3JHB4BPSFKA8D19KGCQHHJ7D00M9Q7,"Our stand since we agreed to acquire Motorola has not changed and we look forward to closing the deal, a Google spokesperson told AFP.",5,10,stand,0,2,2
3JHB4BPSFKA8D19KGCQHHJ7D00M9Q7,"Our stand since we agreed to acquire Motorola has not changed and we look forward to closing the deal, a Google spokesperson told AFP.",30,37,acquire,9,7,16
3JHB4BPSFKA8D19KGCQHHJ7D00M9Q7,"Our stand since we agreed to acquire Motorola has not changed and we look forward to closing the deal, a Google spokesperson told AFP.",70,85,look forward to,0,1,1
3JHB4BPSFKA8D19KGCQHHJ7D00M9Q7,"Our stand since we agreed to acquire Motorola has not changed and we look forward to closing the deal, a Google spokesperson told AFP.",86,102,closing the deal,2,0,2
3JHB4BPSFKA8D19KGCQHHJ7D00M9Q7,"Our stand since we agreed to acquire Motorola has not changed and we look forward to closing the deal, a Google spokesperson told AFP.",98,102,deal,0,1,1
3JHB4BPSFKA8D19KGCQHHJ7D00M9Q7,"Our stand since we agreed to acquire Motorola has not changed and we look forward to closing the deal, a Google spokesperson told AFP.",114,126,spokesperson,4,6,10
3JHB4BPSFKA8D19KGCQHHJ7D00M9Q7,"Our stand since we agreed to acquire Motorola has not changed and we look forward to closing the deal, a Google spokesperson told AFP.",132,135,AFP,1,0,1
3JHB4BPSFKA8D19KGCQHHJ7D00M9Q7,"Google will acquire 17,000 patents with the purchase of Motorola Mobility and has been strengthening its patent portfolio as the fight for dominance in the booming smartphone and tablet market increasingly involves lawsuits claiming infringement of patented technology.",12,19,acquire,3,2,5
3JHB4BPSFKA8D19KGCQHHJ7D00M9Q7,"Google will acquire 17,000 patents with the purchase of Motorola Mobility and has been strengthening its patent portfolio as the fight for dominance in the booming smartphone and tablet market increasingly involves lawsuits claiming infringement of patented technology.",27,34,patents,9,0,9
3JHB4BPSFKA8D19KGCQHHJ7D00M9Q7,"Google will acquire 17,000 patents with the purchase of Motorola Mobility and has been strengthening its patent portfolio as the fight for dominance in the booming smartphone and tablet market increasingly involves lawsuits claiming infringement of patented technology.",44,52,purchase,1,0,1
3JHB4BPSFKA8D19KGCQHHJ7D00M9Q7,"Google will acquire 17,000 patents with the purchase of Motorola Mobility and has been strengthening its patent portfolio as the fight for dominance in the booming smartphone and tablet market increasingly involves lawsuits claiming infringement of patented technology.",87,100,strengthening,6,4,10
3JHB4BPSFKA8D19KGCQHHJ7D00M9Q7,"Google will acquire 17,000 patents with the purchase of Motorola Mobility and has been strengthening its patent portfolio as the fight for dominance in the booming smartphone and tablet market increasingly involves lawsuits claiming infringement of patented technology.",105,111,patent,1,0,1
3JHB4BPSFKA8D19KGCQHHJ7D00M9Q7,"Google will acquire 17,000 patents with the purchase of Motorola Mobility and has been strengthening its patent portfolio as the fight for dominance in the booming smartphone and tablet market increasingly involves lawsuits claiming infringement of patented technology.",105,121,patent portfolio,9,5,14
3JHB4BPSFKA8D19KGCQHHJ7D00M9Q7,"Google will acquire 17,000 patents with the purchase of Motorola Mobility and has been strengthening its patent portfolio as the fight for dominance in the booming smartphone and tablet market increasingly involves lawsuits claiming infringement of patented technology.",112,121,portfolio,2,3,5
3JHB4BPSFKA8D19KGCQHHJ7D00M9Q7,"Google will acquire 17,000 patents with the purchase of Motorola Mobility and has been strengthening its patent portfolio as the fight for dominance in the booming smartphone and tablet market increasingly involves lawsuits claiming infringement of patented technology.",129,148,fight for dominance,0,1,1
3JHB4BPSFKA8D19KGCQHHJ7D00M9Q7,"Google will acquire 17,000 patents with the purchase of Motorola Mobility and has been strengthening its patent portfolio as the fight for dominance in the booming smartphone and tablet market increasingly involves lawsuits claiming infringement of patented technology.",139,148,dominance,10,4,14
3JHB4BPSFKA8D19KGCQHHJ7D00M9Q7,"Google will acquire 17,000 patents with the purchase of Motorola Mobility and has been strengthening its patent portfolio as the fight for dominance in the booming smartphone and tablet market increasingly involves lawsuits claiming infringement of patented technology.",156,163,booming,3,5,8
3JHB4BPSFKA8D19KGCQHHJ7D00M9Q7,"Google will acquire 17,000 patents with the purchase of Motorola Mobility and has been strengthening its patent portfolio as the fight for dominance in the booming smartphone and tablet market increasingly involves lawsuits claiming infringement of patented technology.",164,174,smartphone,1,0,1
3JHB4BPSFKA8D19KGCQHHJ7D00M9Q7,"Google will acquire 17,000 patents with the purchase of Motorola Mobility and has been strengthening its patent portfolio as the fight for dominance in the booming smartphone and tablet market increasingly involves lawsuits claiming infringement of patented technology.",193,205,increasingly,1,0,1
3JHB4BPSFKA8D19KGCQHHJ7D00M9Q7,"Google will acquire 17,000 patents with the purchase of Motorola Mobility and has been strengthening its patent portfolio as the fight for dominance in the booming smartphone and tablet market increasingly involves lawsuits claiming infringement of patented technology.",215,223,lawsuits,0,3,3
3JHB4BPSFKA8D19KGCQHHJ7D00M9Q7,"Google will acquire 17,000 patents with the purchase of Motorola Mobility and has been strengthening its patent portfolio as the fight for dominance in the booming smartphone and tablet market increasingly involves lawsuits claiming infringement of patented technology.",233,245,infringement,10,10,20
3JHB4BPSFKA8D19KGCQHHJ7D00M9Q7,"Google will acquire 17,000 patents with the purchase of Motorola Mobility and has been strengthening its patent portfolio as the fight for dominance in the booming smartphone and tablet market increasingly involves lawsuits claiming infringement of patented technology.",233,268,infringement of patented technology,1,0,1
3JHB4BPSFKA8D19KGCQHHJ7D00M9Q7,"Google will acquire 17,000 patents with the purchase of Motorola Mobility and has been strengthening its patent portfolio as the fight for dominance in the booming smartphone and tablet market increasingly involves lawsuits claiming infringement of patented technology.",249,257,patented,4,1,5
3JHB4BPSFKA8D19KGCQHHJ7D00M9Q7,"Google will acquire 17,000 patents with the purchase of Motorola Mobility and has been strengthening its patent portfolio as the fight for dominance in the booming smartphone and tablet market increasingly involves lawsuits claiming infringement of patented technology.",249,268,patented technology,5,0,5
3JHB4BPSFKA8D19KGCQHHJ7D00M9Q7,"Google will acquire 17,000 patents with the purchase of Motorola Mobility and has been strengthening its patent portfolio as the fight for dominance in the booming smartphone and tablet market increasingly involves lawsuits claiming infringement of patented technology.",258,268,technology,1,0,1
3JHB4BPSFKA8D19KGCQHHJ7D00M9Q7,"Apple and South Korea's Samsung, whose devices are powered by Google's Android software, are currently involved in lengthy and costly patent fights being waged on several continents.",103,111,involved,0,1,1
3JHB4BPSFKA8D19KGCQHHJ7D00M9Q7,"Apple and South Korea's Samsung, whose devices are powered by Google's Android software, are currently involved in lengthy and costly patent fights being waged on several continents.",115,133,lengthy and costly,0,1,1
3JHB4BPSFKA8D19KGCQHHJ7D00M9Q7,"Apple and South Korea's Samsung, whose devices are powered by Google's Android software, are currently involved in lengthy and costly patent fights being waged on several continents.",134,140,patent,4,1,5
3JHB4BPSFKA8D19KGCQHHJ7D00M9Q7,"Apple and South Korea's Samsung, whose devices are powered by Google's Android software, are currently involved in lengthy and costly patent fights being waged on several continents.",134,147,patent fights,2,2,4
3JHB4BPSFKA8D19KGCQHHJ7D00M9Q7,"Apple and South Korea's Samsung, whose devices are powered by Google's Android software, are currently involved in lengthy and costly patent fights being waged on several continents.",154,159,waged,3,7,10
3JHB4BPSFKA8D19KGCQHHJ7D00M9Q7,"Apple and South Korea's Samsung, whose devices are powered by Google's Android software, are currently involved in lengthy and costly patent fights being waged on several continents.",171,181,continents,2,0,2
3JHB4BPSFKA8D19KGCQHHJ7D00M9Q7,"In announcing the Motorola Mobility acquisition in August, Google chief executive Larry Page said it will ""enable us to better protect Android from anti-competitive threats from Microsoft, Apple and other companies.""",3,13,announcing,1,0,1
3JHB4BPSFKA8D19KGCQHHJ7D00M9Q7,"In announcing the Motorola Mobility acquisition in August, Google chief executive Larry Page said it will ""enable us to better protect Android from anti-competitive threats from Microsoft, Apple and other companies.""",36,47,acquisition,10,8,18
3JHB4BPSFKA8D19KGCQHHJ7D00M9Q7,"In announcing the Motorola Mobility acquisition in August, Google chief executive Larry Page said it will ""enable us to better protect Android from anti-competitive threats from Microsoft, Apple and other companies.""",66,81,chief executive,0,1,1
3JHB4BPSFKA8D19KGCQHHJ7D00M9Q7,"In announcing the Motorola Mobility acquisition in August, Google chief executive Larry Page said it will ""enable us to better protect Android from anti-competitive threats from Microsoft, Apple and other companies.""",72,81,executive,1,0,1
3JHB4BPSFKA8D19KGCQHHJ7D00M9Q7,"In announcing the Motorola Mobility acquisition in August, Google chief executive Larry Page said it will ""enable us to better protect Android from anti-competitive threats from Microsoft, Apple and other companies.""",107,113,enable,1,1,2
3JHB4BPSFKA8D19KGCQHHJ7D00M9Q7,"In announcing the Motorola Mobility acquisition in August, Google chief executive Larry Page said it will ""enable us to better protect Android from anti-competitive threats from Microsoft, Apple and other companies.""",148,164,anti-competitive,7,2,9
3JHB4BPSFKA8D19KGCQHHJ7D00M9Q7,"In announcing the Motorola Mobility acquisition in August, Google chief executive Larry Page said it will ""enable us to better protect Android from anti-competitive threats from Microsoft, Apple and other companies.""",148,172,anti-competitive threats,4,3,7
3S8APUMBJXKUA5Y80GTJWQYPHYGFBT,"WFTV, Orlando, Fla., reported officers saw someone come outside briefly with a gun, before retreating into the house.",15,18,Fla,1,0,1
3S8APUMBJXKUA5Y80GTJWQYPHYGFBT,"WFTV, Orlando, Fla., reported officers saw someone come outside briefly with a gun, before retreating into the house.",21,29,reported,1,0,1
3S8APUMBJXKUA5Y80GTJWQYPHYGFBT,"WFTV, Orlando, Fla., reported officers saw someone come outside briefly with a gun, before retreating into the house.",51,71,come outside briefly,1,0,1
3S8APUMBJXKUA5Y80GTJWQYPHYGFBT,"WFTV, Orlando, Fla., reported officers saw someone come outside briefly with a gun, before retreating into the house.",64,71,briefly,3,4,7
3S8APUMBJXKUA5Y80GTJWQYPHYGFBT,"WFTV, Orlando, Fla., reported officers saw someone come outside briefly with a gun, before retreating into the house.",91,101,retreating,8,10,18
3S8APUMBJXKUA5Y80GTJWQYPHYGFBT,"WFTV, Orlando, Fla., reported officers saw someone come outside briefly with a gun, before retreating into the house.",91,116,retreating into the house,1,0,1
3S8APUMBJXKUA5Y80GTJWQYPHYGFBT,One last shot followed before two SWAT teams were dispatched to enter the home.,14,22,followed,0,1,1
3S8APUMBJXKUA5Y80GTJWQYPHYGFBT,One last shot followed before two SWAT teams were dispatched to enter the home.,34,38,SWAT,1,2,3
3S8APUMBJXKUA5Y80GTJWQYPHYGFBT,One last shot followed before two SWAT teams were dispatched to enter the home.,34,44,SWAT teams,3,3,6
3S8APUMBJXKUA5Y80GTJWQYPHYGFBT,One last shot followed before two SWAT teams were dispatched to enter the home.,50,60,dispatched,9,10,19
3S8APUMBJXKUA5Y80GTJWQYPHYGFBT,"It was there officers found the bodies of Tonya Thomas, 33, Joel Johnson, 12, Jazlin Johnson, 13, and Jaxs Johnson, 15.",78,84,Jazlin,0,1,1
3S8APUMBJXKUA5Y80GTJWQYPHYGFBT,Sheriff's deputies said Thomas appeared to have died from a self-inflicted gunshot wound and apparently shot her four children.,0,7,Sheriff,1,0,1
3S8APUMBJXKUA5Y80GTJWQYPHYGFBT,Sheriff's deputies said Thomas appeared to have died from a self-inflicted gunshot wound and apparently shot her four children.,0,8,Sheriffs,0,1,1
3S8APUMBJXKUA5Y80GTJWQYPHYGFBT,Sheriff's deputies said Thomas appeared to have died from a self-inflicted gunshot wound and apparently shot her four children.,10,18,deputies,2,3,5
3S8APUMBJXKUA5Y80GTJWQYPHYGFBT,Sheriff's deputies said Thomas appeared to have died from a self-inflicted gunshot wound and apparently shot her four children.,31,39,appeared,1,0,1
3S8APUMBJXKUA5Y80GTJWQYPHYGFBT,Sheriff's deputies said Thomas appeared to have died from a self-inflicted gunshot wound and apparently shot her four children.,60,74,self-inflicted,10,10,20
3S8APUMBJXKUA5Y80GTJWQYPHYGFBT,Sheriff's deputies said Thomas appeared to have died from a self-inflicted gunshot wound and apparently shot her four children.,75,82,gunshot,1,0,1
3S8APUMBJXKUA5Y80GTJWQYPHYGFBT,Sheriff's deputies said Thomas appeared to have died from a self-inflicted gunshot wound and apparently shot her four children.,93,103,apparently,5,4,9
3S8APUMBJXKUA5Y80GTJWQYPHYGFBT,WFTV reported Thomas sent a text message to her neighbor around 3 a.m. saying she wanted to be cremated with her children.,28,40,text message,1,1,2
3S8APUMBJXKUA5Y80GTJWQYPHYGFBT,WFTV reported Thomas sent a text message to her neighbor around 3 a.m. saying she wanted to be cremated with her children.,48,56,neighbor,1,0,1
3S8APUMBJXKUA5Y80GTJWQYPHYGFBT,WFTV reported Thomas sent a text message to her neighbor around 3 a.m. saying she wanted to be cremated with her children.,95,103,cremated,10,10,20
3S8APUMBJXKUA5Y80GTJWQYPHYGFBT,"The neighbor, who was asleep, did not see the text message until after shots were heard.",4,12,neighbor,0,2,2
3S8APUMBJXKUA5Y80GTJWQYPHYGFBT,"The neighbor, who was asleep, did not see the text message until after shots were heard.",22,28,asleep,0,1,1
3S8APUMBJXKUA5Y80GTJWQYPHYGFBT,"WKMG-TV, Orlando, Fla., reported police had been called to the home for a domestic disturbance a few weeks ago.",18,21,Fla,1,0,1
3S8APUMBJXKUA5Y80GTJWQYPHYGFBT,"WKMG-TV, Orlando, Fla., reported police had been called to the home for a domestic disturbance a few weeks ago.",24,32,reported,0,1,1
3S8APUMBJXKUA5Y80GTJWQYPHYGFBT,"WKMG-TV, Orlando, Fla., reported police had been called to the home for a domestic disturbance a few weeks ago.",74,82,domestic,1,0,1
3S8APUMBJXKUA5Y80GTJWQYPHYGFBT,"WKMG-TV, Orlando, Fla., reported police had been called to the home for a domestic disturbance a few weeks ago.",74,94,domestic disturbance,10,5,15
3S8APUMBJXKUA5Y80GTJWQYPHYGFBT,"WKMG-TV, Orlando, Fla., reported police had been called to the home for a domestic disturbance a few weeks ago.",83,94,disturbance,1,2,3
3SBX2M1TKDO7GV38ZHUQ0BWXDV5Q4Y,The extra capital will have to be raised by the banks themselves or from government loans for which an interest of 10 percent will be charged.,4,17,extra capital,0,1,1
3SBX2M1TKDO7GV38ZHUQ0BWXDV5Q4Y,The extra capital will have to be raised by the banks themselves or from government loans for which an interest of 10 percent will be charged.,10,17,capital,6,0,6
3SBX2M1TKDO7GV38ZHUQ0BWXDV5Q4Y,The extra capital will have to be raised by the banks themselves or from government loans for which an interest of 10 percent will be charged.,34,40,raised,0,2,2
3SBX2M1TKDO7GV38ZHUQ0BWXDV5Q4Y,The extra capital will have to be raised by the banks themselves or from government loans for which an interest of 10 percent will be charged.,73,83,government,1,0,1
3SBX2M1TKDO7GV38ZHUQ0BWXDV5Q4Y,The extra capital will have to be raised by the banks themselves or from government loans for which an interest of 10 percent will be charged.,73,89,government loans,1,0,1
3SBX2M1TKDO7GV38ZHUQ0BWXDV5Q4Y,The extra capital will have to be raised by the banks themselves or from government loans for which an interest of 10 percent will be charged.,134,141,charged,1,2,3
3SBX2M1TKDO7GV38ZHUQ0BWXDV5Q4Y,"Earlier this year, the government had obliged Spanish banks to find 54 billion euros of extra capital to shield against bad loans.",23,33,government,1,0,1
3SBX2M1TKDO7GV38ZHUQ0BWXDV5Q4Y,"Earlier this year, the government had obliged Spanish banks to find 54 billion euros of extra capital to shield against bad loans.",38,45,obliged,10,10,20
3SBX2M1TKDO7GV38ZHUQ0BWXDV5Q4Y,"Earlier this year, the government had obliged Spanish banks to find 54 billion euros of extra capital to shield against bad loans.",79,84,euros,0,1,1
3SBX2M1TKDO7GV38ZHUQ0BWXDV5Q4Y,"Earlier this year, the government had obliged Spanish banks to find 54 billion euros of extra capital to shield against bad loans.",102,119,to shield against,1,0,1
3SBX2M1TKDO7GV38ZHUQ0BWXDV5Q4Y,"Earlier this year, the government had obliged Spanish banks to find 54 billion euros of extra capital to shield against bad loans.",105,111,shield,5,8,13
3SBX2M1TKDO7GV38ZHUQ0BWXDV5Q4Y,"Earlier this year, the government had obliged Spanish banks to find 54 billion euros of extra capital to shield against bad loans.",105,119,shield against,1,0,1
3SBX2M1TKDO7GV38ZHUQ0BWXDV5Q4Y,"Earlier this year, the government had obliged Spanish banks to find 54 billion euros of extra capital to shield against bad loans.",120,129,bad loans,0,1,1
3SBX2M1TKDO7GV38ZHUQ0BWXDV5Q4Y,De Guindos said the decision had been taken to restore confidence and credibility in Spain's financial system.,20,28,decision,0,1,1
3SBX2M1TKDO7GV38ZHUQ0BWXDV5Q4Y,De Guindos said the decision had been taken to restore confidence and credibility in Spain's financial system.,47,54,restore,3,3,6
3SBX2M1TKDO7GV38ZHUQ0BWXDV5Q4Y,De Guindos said the decision had been taken to restore confidence and credibility in Spain's financial system.,47,65,restore confidence,1,1,2
3SBX2M1TKDO7GV38ZHUQ0BWXDV5Q4Y,De Guindos said the decision had been taken to restore confidence and credibility in Spain's financial system.,55,65,confidence,2,1,3
3SBX2M1TKDO7GV38ZHUQ0BWXDV5Q4Y,De Guindos said the decision had been taken to restore confidence and credibility in Spain's financial system.,70,81,credibility,10,10,20
3SBX2M1TKDO7GV38ZHUQ0BWXDV5Q4Y,De Guindos said the decision had been taken to restore confidence and credibility in Spain's financial system.,93,102,financial,1,1,2
3SBX2M1TKDO7GV38ZHUQ0BWXDV5Q4Y,"The move comes just two days after the government nationalized 45 percent of Bankia, the country's fourth biggest bank.",39,62,government nationalized,1,0,1
3SBX2M1TKDO7GV38ZHUQ0BWXDV5Q4Y,"The move comes just two days after the government nationalized 45 percent of Bankia, the country's fourth biggest bank.",50,62,nationalized,8,3,11
3SBX2M1TKDO7GV38ZHUQ0BWXDV5Q4Y,"At the end of last month, ratings agency Standard and Poor's downgraded a majority of Spain's banks.",26,40,ratings agency,2,1,3
3SBX2M1TKDO7GV38ZHUQ0BWXDV5Q4Y,"At the end of last month, ratings agency Standard and Poor's downgraded a majority of Spain's banks.",41,58,Standard and Poor,1,0,1
3SBX2M1TKDO7GV38ZHUQ0BWXDV5Q4Y,"At the end of last month, ratings agency Standard and Poor's downgraded a majority of Spain's banks.",41,59,Standard and Poors,1,0,1
3SBX2M1TKDO7GV38ZHUQ0BWXDV5Q4Y,"At the end of last month, ratings agency Standard and Poor's downgraded a majority of Spain's banks.",61,71,downgraded,7,10,17
3SBX2M1TKDO7GV38ZHUQ0BWXDV5Q4Y,"At the end of last month, ratings agency Standard and Poor's downgraded a majority of Spain's banks.",74,82,majority,0,1,1
3SBX2M1TKDO7GV38ZHUQ0BWXDV5Q4Y,The government has decided to appoint two independent auditors who will have the task of valuing the real-estate portfolios of the country's banks.,19,26,decided,0,1,1
3SBX2M1TKDO7GV38ZHUQ0BWXDV5Q4Y,The government has decided to appoint two independent auditors who will have the task of valuing the real-estate portfolios of the country's banks.,30,37,appoint,1,1,2
3SBX2M1TKDO7GV38ZHUQ0BWXDV5Q4Y,The government has decided to appoint two independent auditors who will have the task of valuing the real-estate portfolios of the country's banks.,42,62,independent auditors,4,1,5
3SBX2M1TKDO7GV38ZHUQ0BWXDV5Q4Y,The government has decided to appoint two independent auditors who will have the task of valuing the real-estate portfolios of the country's banks.,54,62,auditors,8,4,12
3SBX2M1TKDO7GV38ZHUQ0BWXDV5Q4Y,The government has decided to appoint two independent auditors who will have the task of valuing the real-estate portfolios of the country's banks.,89,96,valuing,2,5,7
3SBX2M1TKDO7GV38ZHUQ0BWXDV5Q4Y,The government has decided to appoint two independent auditors who will have the task of valuing the real-estate portfolios of the country's banks.,101,112,real-estate,0,2,2
3SBX2M1TKDO7GV38ZHUQ0BWXDV5Q4Y,The government has decided to appoint two independent auditors who will have the task of valuing the real-estate portfolios of the country's banks.,101,123,real-estate portfolios,7,1,8
3SBX2M1TKDO7GV38ZHUQ0BWXDV5Q4Y,The government has decided to appoint two independent auditors who will have the task of valuing the real-estate portfolios of the country's banks.,113,123,portfolios,6,9,15
3PR3LXCWSF0SMYAW2QL9BR36W2L9XD,The president flew in secret to sign a long-awaited security compact with Afghanistan.,4,13,president,1,0,1
3PR3LXCWSF0SMYAW2QL9BR36W2L9XD,The president flew in secret to sign a long-awaited security compact with Afghanistan.,14,18,flew,0,2,2
3PR3LXCWSF0SMYAW2QL9BR36W2L9XD,The president flew in secret to sign a long-awaited security compact with Afghanistan.,39,51,long-awaited,3,7,10
3PR3LXCWSF0SMYAW2QL9BR36W2L9XD,The president flew in secret to sign a long-awaited security compact with Afghanistan.,39,68,long-awaited security compact,0,1,1
3PR3LXCWSF0SMYAW2QL9BR36W2L9XD,The president flew in secret to sign a long-awaited security compact with Afghanistan.,52,68,security compact,4,3,7
3PR3LXCWSF0SMYAW2QL9BR36W2L9XD,The president flew in secret to sign a long-awaited security compact with Afghanistan.,61,68,compact,4,4,8
3PR3LXCWSF0SMYAW2QL9BR36W2L9XD,"It was after midnight in Kabul when the signing took place, and 4 a.m. there when Obama addressed Americans in a specially arranged speech at 7:30 p.m. Washington time on network television.",36,47,the signing,0,1,1
3PR3LXCWSF0SMYAW2QL9BR36W2L9XD,"It was after midnight in Kabul when the signing took place, and 4 a.m. there when Obama addressed Americans in a specially arranged speech at 7:30 p.m. Washington time on network television.",40,47,signing,1,0,1
3PR3LXCWSF0SMYAW2QL9BR36W2L9XD,"It was after midnight in Kabul when the signing took place, and 4 a.m. there when Obama addressed Americans in a specially arranged speech at 7:30 p.m. Washington time on network television.",88,97,addressed,2,2,4
3PR3LXCWSF0SMYAW2QL9BR36W2L9XD,"It was after midnight in Kabul when the signing took place, and 4 a.m. there when Obama addressed Americans in a specially arranged speech at 7:30 p.m. Washington time on network television.",113,122,specially,1,0,1
3PR3LXCWSF0SMYAW2QL9BR36W2L9XD,"It was after midnight in Kabul when the signing took place, and 4 a.m. there when Obama addressed Americans in a specially arranged speech at 7:30 p.m. Washington time on network television.",113,131,specially arranged,2,1,3
3PR3LXCWSF0SMYAW2QL9BR36W2L9XD,"It was after midnight in Kabul when the signing took place, and 4 a.m. there when Obama addressed Americans in a specially arranged speech at 7:30 p.m. Washington time on network television.",123,131,arranged,2,4,6
3PR3LXCWSF0SMYAW2QL9BR36W2L9XD,"It was after midnight in Kabul when the signing took place, and 4 a.m. there when Obama addressed Americans in a specially arranged speech at 7:30 p.m. Washington time on network television.",171,189,network television,1,0,1
3PR3LXCWSF0SMYAW2QL9BR36W2L9XD,"It was after midnight in Kabul when the signing took place, and 4 a.m. there when Obama addressed Americans in a specially arranged speech at 7:30 p.m. Washington time on network television.",179,189,television,1,0,1
3PR3LXCWSF0SMYAW2QL9BR36W2L9XD,"My fellow Americans, Obama said from Bagram Air Field, ""we have traveled through more than a decade under the dark cloud of war.",4,10,fellow,0,1,1
3PR3LXCWSF0SMYAW2QL9BR36W2L9XD,"My fellow Americans, Obama said from Bagram Air Field, ""we have traveled through more than a decade under the dark cloud of war.",39,45,Bagram,0,1,1
3PR3LXCWSF0SMYAW2QL9BR36W2L9XD,"My fellow Americans, Obama said from Bagram Air Field, ""we have traveled through more than a decade under the dark cloud of war.",95,101,decade,2,7,9
3PR3LXCWSF0SMYAW2QL9BR36W2L9XD,"My fellow Americans, Obama said from Bagram Air Field, ""we have traveled through more than a decade under the dark cloud of war.",112,122,dark cloud,1,1,2
3PR3LXCWSF0SMYAW2QL9BR36W2L9XD,"My fellow Americans, Obama said from Bagram Air Field, ""we have traveled through more than a decade under the dark cloud of war.",112,129,dark cloud of war,3,1,4
3PR3LXCWSF0SMYAW2QL9BR36W2L9XD,"Yet here, in the predawn darkness of Afghanistan, we can see the light of a new day on the horizon.""",17,24,predawn,7,10,17
3PR3LXCWSF0SMYAW2QL9BR36W2L9XD,"Yet here, in the predawn darkness of Afghanistan, we can see the light of a new day on the horizon.""",17,33,predawn darkness,3,2,5
3PR3LXCWSF0SMYAW2QL9BR36W2L9XD,"Yet here, in the predawn darkness of Afghanistan, we can see the light of a new day on the horizon.""",91,98,horizon,5,7,12
3PR3LXCWSF0SMYAW2QL9BR36W2L9XD,"The backdrop of armored troop carriers matched Obama's message of praise for U.S. forces who fought and died in Afghanistan, but it was an odd fit for what followed — a direct appeal to American optimism and self-interest in an election year.",4,12,backdrop,6,9,15
3PR3LXCWSF0SMYAW2QL9BR36W2L9XD,"The backdrop of armored troop carriers matched Obama's message of praise for U.S. forces who fought and died in Afghanistan, but it was an odd fit for what followed — a direct appeal to American optimism and self-interest in an election year.",16,23,armored,4,7,11
3PR3LXCWSF0SMYAW2QL9BR36W2L9XD,"The backdrop of armored troop carriers matched Obama's message of praise for U.S. forces who fought and died in Afghanistan, but it was an odd fit for what followed — a direct appeal to American optimism and self-interest in an election year.",16,38,armored troop carriers,4,0,4
3PR3LXCWSF0SMYAW2QL9BR36W2L9XD,"The backdrop of armored troop carriers matched Obama's message of praise for U.S. forces who fought and died in Afghanistan, but it was an odd fit for what followed — a direct appeal to American optimism and self-interest in an election year.",24,38,troop carriers,1,0,1
3PR3LXCWSF0SMYAW2QL9BR36W2L9XD,"The backdrop of armored troop carriers matched Obama's message of praise for U.S. forces who fought and died in Afghanistan, but it was an odd fit for what followed — a direct appeal to American optimism and self-interest in an election year.",55,62,message,1,0,1
3PR3LXCWSF0SMYAW2QL9BR36W2L9XD,"The backdrop of armored troop carriers matched Obama's message of praise for U.S. forces who fought and died in Afghanistan, but it was an odd fit for what followed — a direct appeal to American optimism and self-interest in an election year.",66,72,praise,0,1,1
3PR3LXCWSF0SMYAW2QL9BR36W2L9XD,"The backdrop of armored troop carriers matched Obama's message of praise for U.S. forces who fought and died in Afghanistan, but it was an odd fit for what followed — a direct appeal to American optimism and self-interest in an election year.",93,99,fought,0,1,1
3PR3LXCWSF0SMYAW2QL9BR36W2L9XD,"The backdrop of armored troop carriers matched Obama's message of praise for U.S. forces who fought and died in Afghanistan, but it was an odd fit for what followed — a direct appeal to American optimism and self-interest in an election year.",139,142,odd,0,1,1
3PR3LXCWSF0SMYAW2QL9BR36W2L9XD,"The backdrop of armored troop carriers matched Obama's message of praise for U.S. forces who fought and died in Afghanistan, but it was an odd fit for what followed — a direct appeal to American optimism and self-interest in an election year.",139,146,odd fit,3,4,7
3PR3LXCWSF0SMYAW2QL9BR36W2L9XD,"The backdrop of armored troop carriers matched Obama's message of praise for U.S. forces who fought and died in Afghanistan, but it was an odd fit for what followed — a direct appeal to American optimism and self-interest in an election year.",143,146,fit,1,0,1
3PR3LXCWSF0SMYAW2QL9BR36W2L9XD,"The backdrop of armored troop carriers matched Obama's message of praise for U.S. forces who fought and died in Afghanistan, but it was an odd fit for what followed — a direct appeal to American optimism and self-interest in an election year.",169,182,direct appeal,0,1,1
3PR3LXCWSF0SMYAW2QL9BR36W2L9XD,"The backdrop of armored troop carriers matched Obama's message of praise for U.S. forces who fought and died in Afghanistan, but it was an odd fit for what followed — a direct appeal to American optimism and self-interest in an election year.",176,182,appeal,3,2,5
3PR3LXCWSF0SMYAW2QL9BR36W2L9XD,"The backdrop of armored troop carriers matched Obama's message of praise for U.S. forces who fought and died in Afghanistan, but it was an odd fit for what followed — a direct appeal to American optimism and self-interest in an election year.",186,203,American optimism,0,1,1
3PR3LXCWSF0SMYAW2QL9BR36W2L9XD,"The backdrop of armored troop carriers matched Obama's message of praise for U.S. forces who fought and died in Afghanistan, but it was an odd fit for what followed — a direct appeal to American optimism and self-interest in an election year.",195,203,optimism,8,10,18
3PR3LXCWSF0SMYAW2QL9BR36W2L9XD,"The backdrop of armored troop carriers matched Obama's message of praise for U.S. forces who fought and died in Afghanistan, but it was an odd fit for what followed — a direct appeal to American optimism and self-interest in an election year.",208,221,self-interest,5,6,11
3WPCIUYH1A9X87ET9WPE8K1QAFXDTC,"Fighting flared in Tripoli again on Monday, leaving two people dead and nine wounded, a security official told the AFP news agency.",0,15,Fighting flared,1,1,2
3WPCIUYH1A9X87ET9WPE8K1QAFXDTC,"Fighting flared in Tripoli again on Monday, leaving two people dead and nine wounded, a security official told the AFP news agency.",9,15,flared,8,10,18
3WPCIUYH1A9X87ET9WPE8K1QAFXDTC,"Fighting flared in Tripoli again on Monday, leaving two people dead and nine wounded, a security official told the AFP news agency.",19,26,Tripoli,1,0,1
3WPCIUYH1A9X87ET9WPE8K1QAFXDTC,"Fighting flared in Tripoli again on Monday, leaving two people dead and nine wounded, a security official told the AFP news agency.",77,84,wounded,1,1,2
3WPCIUYH1A9X87ET9WPE8K1QAFXDTC,"Fighting flared in Tripoli again on Monday, leaving two people dead and nine wounded, a security official told the AFP news agency.",88,96,security,1,0,1
3WPCIUYH1A9X87ET9WPE8K1QAFXDTC,"Fighting flared in Tripoli again on Monday, leaving two people dead and nine wounded, a security official told the AFP news agency.",115,118,AFP,1,0,1
3WPCIUYH1A9X87ET9WPE8K1QAFXDTC,"France, the eurozone's second largest economy, is headed for a 4.5 percent deficit, the commission said, despite a forecast of slight growth.",12,21,eurozones,5,0,5
3WPCIUYH1A9X87ET9WPE8K1QAFXDTC,"France, the eurozone's second largest economy, is headed for a 4.5 percent deficit, the commission said, despite a forecast of slight growth.",38,45,economy,1,1,2
3WPCIUYH1A9X87ET9WPE8K1QAFXDTC,"France, the eurozone's second largest economy, is headed for a 4.5 percent deficit, the commission said, despite a forecast of slight growth.",75,82,deficit,9,7,16
3WPCIUYH1A9X87ET9WPE8K1QAFXDTC,"France, the eurozone's second largest economy, is headed for a 4.5 percent deficit, the commission said, despite a forecast of slight growth.",88,98,commission,4,1,5
3WPCIUYH1A9X87ET9WPE8K1QAFXDTC,"France, the eurozone's second largest economy, is headed for a 4.5 percent deficit, the commission said, despite a forecast of slight growth.",105,112,despite,0,2,2
3WPCIUYH1A9X87ET9WPE8K1QAFXDTC,"France, the eurozone's second largest economy, is headed for a 4.5 percent deficit, the commission said, despite a forecast of slight growth.",115,123,forecast,4,7,11
3WPCIUYH1A9X87ET9WPE8K1QAFXDTC,"France, the eurozone's second largest economy, is headed for a 4.5 percent deficit, the commission said, despite a forecast of slight growth.",127,133,slight,0,1,1
3WPCIUYH1A9X87ET9WPE8K1QAFXDTC,"The EU forecasts  show that the 17-nation eurozone, which includes Spain, France and powerhouse Germany, will overall only make slow recovery from recession later this year.",4,16,EU forecasts,0,1,1
3WPCIUYH1A9X87ET9WPE8K1QAFXDTC,"The EU forecasts  show that the 17-nation eurozone, which includes Spain, France and powerhouse Germany, will overall only make slow recovery from recession later this year.",7,16,forecasts,0,1,1
3WPCIUYH1A9X87ET9WPE8K1QAFXDTC,"The EU forecasts  show that the 17-nation eurozone, which includes Spain, France and powerhouse Germany, will overall only make slow recovery from recession later this year.",42,50,eurozone,0,1,1
3WPCIUYH1A9X87ET9WPE8K1QAFXDTC,"The EU forecasts  show that the 17-nation eurozone, which includes Spain, France and powerhouse Germany, will overall only make slow recovery from recession later this year.",85,95,powerhouse,5,2,7
3WPCIUYH1A9X87ET9WPE8K1QAFXDTC,"The EU forecasts  show that the 17-nation eurozone, which includes Spain, France and powerhouse Germany, will overall only make slow recovery from recession later this year.",133,141,recovery,0,1,1
3WPCIUYH1A9X87ET9WPE8K1QAFXDTC,"The EU forecasts  show that the 17-nation eurozone, which includes Spain, France and powerhouse Germany, will overall only make slow recovery from recession later this year.",147,156,recession,9,10,19
3WPCIUYH1A9X87ET9WPE8K1QAFXDTC,"EU's economics affairs commissioner Olli Rehn said he was confident that Spain would tackle its ""immediate fiscal and financial challenges with full determination.""",23,35,commissioner,2,1,3
3WPCIUYH1A9X87ET9WPE8K1QAFXDTC,"EU's economics affairs commissioner Olli Rehn said he was confident that Spain would tackle its ""immediate fiscal and financial challenges with full determination.""",36,45,Olli Rehn,1,0,1
3WPCIUYH1A9X87ET9WPE8K1QAFXDTC,"EU's economics affairs commissioner Olli Rehn said he was confident that Spain would tackle its ""immediate fiscal and financial challenges with full determination.""",58,67,confident,1,2,3
3WPCIUYH1A9X87ET9WPE8K1QAFXDTC,"EU's economics affairs commissioner Olli Rehn said he was confident that Spain would tackle its ""immediate fiscal and financial challenges with full determination.""",85,91,tackle,0,7,7
3WPCIUYH1A9X87ET9WPE8K1QAFXDTC,"EU's economics affairs commissioner Olli Rehn said he was confident that Spain would tackle its ""immediate fiscal and financial challenges with full determination.""",97,106,immediate,0,1,1
3WPCIUYH1A9X87ET9WPE8K1QAFXDTC,"EU's economics affairs commissioner Olli Rehn said he was confident that Spain would tackle its ""immediate fiscal and financial challenges with full determination.""",97,113,immediate fiscal,1,0,1
3WPCIUYH1A9X87ET9WPE8K1QAFXDTC,"EU's economics affairs commissioner Olli Rehn said he was confident that Spain would tackle its ""immediate fiscal and financial challenges with full determination.""",97,138,immediate fiscal and financial challenges,1,0,1
3WPCIUYH1A9X87ET9WPE8K1QAFXDTC,"EU's economics affairs commissioner Olli Rehn said he was confident that Spain would tackle its ""immediate fiscal and financial challenges with full determination.""",107,113,fiscal,8,8,16
3WPCIUYH1A9X87ET9WPE8K1QAFXDTC,"EU's economics affairs commissioner Olli Rehn said he was confident that Spain would tackle its ""immediate fiscal and financial challenges with full determination.""",107,138,fiscal and financial challenges,0,1,1
3WPCIUYH1A9X87ET9WPE8K1QAFXDTC,"EU's economics affairs commissioner Olli Rehn said he was confident that Spain would tackle its ""immediate fiscal and financial challenges with full determination.""",118,127,financial,1,1,2
3WPCIUYH1A9X87ET9WPE8K1QAFXDTC,"EU's economics affairs commissioner Olli Rehn said he was confident that Spain would tackle its ""immediate fiscal and financial challenges with full determination.""",128,138,challenges,0,1,1
3WPCIUYH1A9X87ET9WPE8K1QAFXDTC,"EU's economics affairs commissioner Olli Rehn said he was confident that Spain would tackle its ""immediate fiscal and financial challenges with full determination.""",144,162,full determination,2,0,2
3WPCIUYH1A9X87ET9WPE8K1QAFXDTC,"EU's economics affairs commissioner Olli Rehn said he was confident that Spain would tackle its ""immediate fiscal and financial challenges with full determination.""",149,162,determination,5,3,8
3WPCIUYH1A9X87ET9WPE8K1QAFXDTC,"In particular, Rehn said, Spain's regional governments must reign in what he termed ""excessive spending.""",3,13,particular,0,1,1
3WPCIUYH1A9X87ET9WPE8K1QAFXDTC,"In particular, Rehn said, Spain's regional governments must reign in what he termed ""excessive spending.""",60,65,reign,2,5,7
3WPCIUYH1A9X87ET9WPE8K1QAFXDTC,"In particular, Rehn said, Spain's regional governments must reign in what he termed ""excessive spending.""",60,68,reign in,2,2,4
3WPCIUYH1A9X87ET9WPE8K1QAFXDTC,"In particular, Rehn said, Spain's regional governments must reign in what he termed ""excessive spending.""",77,83,termed,0,1,1
3WPCIUYH1A9X87ET9WPE8K1QAFXDTC,"In particular, Rehn said, Spain's regional governments must reign in what he termed ""excessive spending.""",85,94,excessive,4,1,5
3WPCIUYH1A9X87ET9WPE8K1QAFXDTC,"In particular, Rehn said, Spain's regional governments must reign in what he termed ""excessive spending.""",85,103,excessive spending,2,1,3
3WPCIUYH1A9X87ET9WPE8K1QAFXDTC,"KABUL, Afghanistan (AP) — The Taliban struck back less than two hours after President Barack Obama left Afghanistan on Wednesday, targeting a foreigners' housing compound with a suicide car bomb and militants disguised as women in an assault that killed at least seven people.",30,37,Taliban,1,0,1
3WPCIUYH1A9X87ET9WPE8K1QAFXDTC,"KABUL, Afghanistan (AP) — The Taliban struck back less than two hours after President Barack Obama left Afghanistan on Wednesday, targeting a foreigners' housing compound with a suicide car bomb and militants disguised as women in an assault that killed at least seven people.",38,44,struck,0,1,1
3WPCIUYH1A9X87ET9WPE8K1QAFXDTC,"KABUL, Afghanistan (AP) — The Taliban struck back less than two hours after President Barack Obama left Afghanistan on Wednesday, targeting a foreigners' housing compound with a suicide car bomb and militants disguised as women in an assault that killed at least seven people.",38,49,struck back,0,1,1
3WPCIUYH1A9X87ET9WPE8K1QAFXDTC,"KABUL, Afghanistan (AP) — The Taliban struck back less than two hours after President Barack Obama left Afghanistan on Wednesday, targeting a foreigners' housing compound with a suicide car bomb and militants disguised as women in an assault that killed at least seven people.",130,139,targeting,2,1,3
3WPCIUYH1A9X87ET9WPE8K1QAFXDTC,"KABUL, Afghanistan (AP) — The Taliban struck back less than two hours after President Barack Obama left Afghanistan on Wednesday, targeting a foreigners' housing compound with a suicide car bomb and militants disguised as women in an assault that killed at least seven people.",142,152,foreigners,1,0,1
3WPCIUYH1A9X87ET9WPE8K1QAFXDTC,"KABUL, Afghanistan (AP) — The Taliban struck back less than two hours after President Barack Obama left Afghanistan on Wednesday, targeting a foreigners' housing compound with a suicide car bomb and militants disguised as women in an assault that killed at least seven people.",154,170,housing compound,0,1,1
3WPCIUYH1A9X87ET9WPE8K1QAFXDTC,"KABUL, Afghanistan (AP) — The Taliban struck back less than two hours after President Barack Obama left Afghanistan on Wednesday, targeting a foreigners' housing compound with a suicide car bomb and militants disguised as women in an assault that killed at least seven people.",162,170,compound,1,0,1
3WPCIUYH1A9X87ET9WPE8K1QAFXDTC,"KABUL, Afghanistan (AP) — The Taliban struck back less than two hours after President Barack Obama left Afghanistan on Wednesday, targeting a foreigners' housing compound with a suicide car bomb and militants disguised as women in an assault that killed at least seven people.",178,194,suicide car bomb,1,0,1
3WPCIUYH1A9X87ET9WPE8K1QAFXDTC,"KABUL, Afghanistan (AP) — The Taliban struck back less than two hours after President Barack Obama left Afghanistan on Wednesday, targeting a foreigners' housing compound with a suicide car bomb and militants disguised as women in an assault that killed at least seven people.",199,208,militants,3,2,5
3WPCIUYH1A9X87ET9WPE8K1QAFXDTC,"KABUL, Afghanistan (AP) — The Taliban struck back less than two hours after President Barack Obama left Afghanistan on Wednesday, targeting a foreigners' housing compound with a suicide car bomb and militants disguised as women in an assault that killed at least seven people.",199,227,militants disguised as women,1,0,1
3WPCIUYH1A9X87ET9WPE8K1QAFXDTC,"KABUL, Afghanistan (AP) — The Taliban struck back less than two hours after President Barack Obama left Afghanistan on Wednesday, targeting a foreigners' housing compound with a suicide car bomb and militants disguised as women in an assault that killed at least seven people.",209,218,disguised,4,8,12
3WPCIUYH1A9X87ET9WPE8K1QAFXDTC,"KABUL, Afghanistan (AP) — The Taliban struck back less than two hours after President Barack Obama left Afghanistan on Wednesday, targeting a foreigners' housing compound with a suicide car bomb and militants disguised as women in an assault that killed at least seven people.",234,241,assault,2,4,6
35F6NGNVM8KHRYDJIJMS8SRUPHX7T7,"Egyptian protesters broke into the Israeli Embassy in September, dumping hundreds of documents out of its windows after a day of demonstrations.",9,19,protesters,4,6,10
35F6NGNVM8KHRYDJIJMS8SRUPHX7T7,"Egyptian protesters broke into the Israeli Embassy in September, dumping hundreds of documents out of its windows after a day of demonstrations.",20,25,broke,0,1,1
35F6NGNVM8KHRYDJIJMS8SRUPHX7T7,"Egyptian protesters broke into the Israeli Embassy in September, dumping hundreds of documents out of its windows after a day of demonstrations.",35,50,Israeli Embassy,2,0,2
35F6NGNVM8KHRYDJIJMS8SRUPHX7T7,"Egyptian protesters broke into the Israeli Embassy in September, dumping hundreds of documents out of its windows after a day of demonstrations.",43,50,Embassy,5,0,5
35F6NGNVM8KHRYDJIJMS8SRUPHX7T7,"Egyptian protesters broke into the Israeli Embassy in September, dumping hundreds of documents out of its windows after a day of demonstrations.",65,72,dumping,2,9,11
35F6NGNVM8KHRYDJIJMS8SRUPHX7T7,"Egyptian protesters broke into the Israeli Embassy in September, dumping hundreds of documents out of its windows after a day of demonstrations.",65,94,dumping hundreds of documents,1,0,1
35F6NGNVM8KHRYDJIJMS8SRUPHX7T7,"Egyptian protesters broke into the Israeli Embassy in September, dumping hundreds of documents out of its windows after a day of demonstrations.",85,94,documents,3,0,3
35F6NGNVM8KHRYDJIJMS8SRUPHX7T7,"Egyptian protesters broke into the Israeli Embassy in September, dumping hundreds of documents out of its windows after a day of demonstrations.",129,143,demonstrations,10,3,13
35F6NGNVM8KHRYDJIJMS8SRUPHX7T7,Protesters used sledge hammers and their bare hands to tear apart the embassy's security wall.,0,10,Protesters,2,0,2
35F6NGNVM8KHRYDJIJMS8SRUPHX7T7,Protesters used sledge hammers and their bare hands to tear apart the embassy's security wall.,16,22,sledge,1,4,5
35F6NGNVM8KHRYDJIJMS8SRUPHX7T7,Protesters used sledge hammers and their bare hands to tear apart the embassy's security wall.,16,30,sledge hammers,6,6,12
35F6NGNVM8KHRYDJIJMS8SRUPHX7T7,Protesters used sledge hammers and their bare hands to tear apart the embassy's security wall.,41,45,bare,1,3,4
35F6NGNVM8KHRYDJIJMS8SRUPHX7T7,Protesters used sledge hammers and their bare hands to tear apart the embassy's security wall.,41,51,bare hands,1,0,1
35F6NGNVM8KHRYDJIJMS8SRUPHX7T7,Protesters used sledge hammers and their bare hands to tear apart the embassy's security wall.,55,59,tear,0,2,2
35F6NGNVM8KHRYDJIJMS8SRUPHX7T7,Protesters used sledge hammers and their bare hands to tear apart the embassy's security wall.,55,65,tear apart,0,1,1
35F6NGNVM8KHRYDJIJMS8SRUPHX7T7,Protesters used sledge hammers and their bare hands to tear apart the embassy's security wall.,70,78,embassys,1,0,1
35F6NGNVM8KHRYDJIJMS8SRUPHX7T7,Protesters used sledge hammers and their bare hands to tear apart the embassy's security wall.,80,93,security wall,2,1,3
35F6NGNVM8KHRYDJIJMS8SRUPHX7T7,Egyptian soldiers guarding the shattered entrance of the Israeli Embassy in Cairo Sunday.,18,26,guarding,0,1,1
35F6NGNVM8KHRYDJIJMS8SRUPHX7T7,Egyptian soldiers guarding the shattered entrance of the Israeli Embassy in Cairo Sunday.,31,40,shattered,8,5,13
35F6NGNVM8KHRYDJIJMS8SRUPHX7T7,Egyptian soldiers guarding the shattered entrance of the Israeli Embassy in Cairo Sunday.,31,49,shattered entrance,3,2,5
35F6NGNVM8KHRYDJIJMS8SRUPHX7T7,Egyptian soldiers guarding the shattered entrance of the Israeli Embassy in Cairo Sunday.,65,72,Embassy,2,0,2
35F6NGNVM8KHRYDJIJMS8SRUPHX7T7,"Three Egyptian civilians were killed and a total of 1,049 injured, including 46 police and military soldiers, during the attack on the embassy, as Egyptian forces confronted the mob.",15,24,civilians,1,2,3
35F6NGNVM8KHRYDJIJMS8SRUPHX7T7,"Three Egyptian civilians were killed and a total of 1,049 injured, including 46 police and military soldiers, during the attack on the embassy, as Egyptian forces confronted the mob.",91,108,military soldiers,1,0,1
35F6NGNVM8KHRYDJIJMS8SRUPHX7T7,"Three Egyptian civilians were killed and a total of 1,049 injured, including 46 police and military soldiers, during the attack on the embassy, as Egyptian forces confronted the mob.",135,142,embassy,1,0,1
35F6NGNVM8KHRYDJIJMS8SRUPHX7T7,"Three Egyptian civilians were killed and a total of 1,049 injured, including 46 police and military soldiers, during the attack on the embassy, as Egyptian forces confronted the mob.",163,173,confronted,9,7,16
35F6NGNVM8KHRYDJIJMS8SRUPHX7T7,"Three Egyptian civilians were killed and a total of 1,049 injured, including 46 police and military soldiers, during the attack on the embassy, as Egyptian forces confronted the mob.",178,181,mob,2,5,7
35F6NGNVM8KHRYDJIJMS8SRUPHX7T7,"Israel's ambassador Yitzhak Levanon, who is due to be replaced as ambassador to Egypt in two weeks, arrived in the country on Sunday for the first time since that attack.",9,19,ambassador,5,0,5
35F6NGNVM8KHRYDJIJMS8SRUPHX7T7,"Israel's ambassador Yitzhak Levanon, who is due to be replaced as ambassador to Egypt in two weeks, arrived in the country on Sunday for the first time since that attack.",9,35,ambassador Yitzhak Levanon,1,0,1
35F6NGNVM8KHRYDJIJMS8SRUPHX7T7,"Israel's ambassador Yitzhak Levanon, who is due to be replaced as ambassador to Egypt in two weeks, arrived in the country on Sunday for the first time since that attack.",54,62,replaced,0,1,1
35F6NGNVM8KHRYDJIJMS8SRUPHX7T7,"Israel's ambassador Yitzhak Levanon, who is due to be replaced as ambassador to Egypt in two weeks, arrived in the country on Sunday for the first time since that attack.",66,76,ambassador,5,0,5
35F6NGNVM8KHRYDJIJMS8SRUPHX7T7,He was planning to stay in Cairo for two days to hold a series of farewell meetings with Egyptian officials and other foreign representative.,66,74,farewell,4,5,9
35F6NGNVM8KHRYDJIJMS8SRUPHX7T7,He was planning to stay in Cairo for two days to hold a series of farewell meetings with Egyptian officials and other foreign representative.,66,83,farewell meetings,6,3,9
35F6NGNVM8KHRYDJIJMS8SRUPHX7T7,He was planning to stay in Cairo for two days to hold a series of farewell meetings with Egyptian officials and other foreign representative.,112,140,other foreign representative,1,0,1
35F6NGNVM8KHRYDJIJMS8SRUPHX7T7,He was planning to stay in Cairo for two days to hold a series of farewell meetings with Egyptian officials and other foreign representative.,118,140,foreign representative,4,0,4
35F6NGNVM8KHRYDJIJMS8SRUPHX7T7,He was planning to stay in Cairo for two days to hold a series of farewell meetings with Egyptian officials and other foreign representative.,126,140,representative,4,2,6
3IJ95K7NDXD2PEJ0EQ4A56YVYPRNGV,"In the latest effort to isolate Syria internationally, European Union foreign ministers agreed fresh sanctions against the country on Monday, the 15th round so far to protest against the repression of dissidents.",14,20,effort,0,2,2
3IJ95K7NDXD2PEJ0EQ4A56YVYPRNGV,"In the latest effort to isolate Syria internationally, European Union foreign ministers agreed fresh sanctions against the country on Monday, the 15th round so far to protest against the repression of dissidents.",24,31,isolate,7,5,12
3IJ95K7NDXD2PEJ0EQ4A56YVYPRNGV,"In the latest effort to isolate Syria internationally, European Union foreign ministers agreed fresh sanctions against the country on Monday, the 15th round so far to protest against the repression of dissidents.",38,53,internationally,2,1,3
3IJ95K7NDXD2PEJ0EQ4A56YVYPRNGV,"In the latest effort to isolate Syria internationally, European Union foreign ministers agreed fresh sanctions against the country on Monday, the 15th round so far to protest against the repression of dissidents.",70,77,foreign,1,0,1
3IJ95K7NDXD2PEJ0EQ4A56YVYPRNGV,"In the latest effort to isolate Syria internationally, European Union foreign ministers agreed fresh sanctions against the country on Monday, the 15th round so far to protest against the repression of dissidents.",78,87,ministers,1,0,1
3IJ95K7NDXD2PEJ0EQ4A56YVYPRNGV,"In the latest effort to isolate Syria internationally, European Union foreign ministers agreed fresh sanctions against the country on Monday, the 15th round so far to protest against the repression of dissidents.",95,110,fresh sanctions,2,1,3
3IJ95K7NDXD2PEJ0EQ4A56YVYPRNGV,"In the latest effort to isolate Syria internationally, European Union foreign ministers agreed fresh sanctions against the country on Monday, the 15th round so far to protest against the repression of dissidents.",101,110,sanctions,8,5,13
3IJ95K7NDXD2PEJ0EQ4A56YVYPRNGV,"In the latest effort to isolate Syria internationally, European Union foreign ministers agreed fresh sanctions against the country on Monday, the 15th round so far to protest against the repression of dissidents.",187,197,repression,6,10,16
3IJ95K7NDXD2PEJ0EQ4A56YVYPRNGV,"In the latest effort to isolate Syria internationally, European Union foreign ministers agreed fresh sanctions against the country on Monday, the 15th round so far to protest against the repression of dissidents.",187,211,repression of dissidents,1,0,1
3IJ95K7NDXD2PEJ0EQ4A56YVYPRNGV,"In the latest effort to isolate Syria internationally, European Union foreign ministers agreed fresh sanctions against the country on Monday, the 15th round so far to protest against the repression of dissidents.",201,211,dissidents,10,10,20
3IJ95K7NDXD2PEJ0EQ4A56YVYPRNGV,"An EU statement issued at a meeting of ministers said they adopted ""sanctions against the Syrian regime"" but gave no details.",6,15,statement,0,1,1
3IJ95K7NDXD2PEJ0EQ4A56YVYPRNGV,"An EU statement issued at a meeting of ministers said they adopted ""sanctions against the Syrian regime"" but gave no details.",16,22,issued,0,1,1
3IJ95K7NDXD2PEJ0EQ4A56YVYPRNGV,"An EU statement issued at a meeting of ministers said they adopted ""sanctions against the Syrian regime"" but gave no details.",59,66,adopted,2,1,3
3IJ95K7NDXD2PEJ0EQ4A56YVYPRNGV,"An EU statement issued at a meeting of ministers said they adopted ""sanctions against the Syrian regime"" but gave no details.",68,77,sanctions,7,0,7
3IJ95K7NDXD2PEJ0EQ4A56YVYPRNGV,"An EU statement issued at a meeting of ministers said they adopted ""sanctions against the Syrian regime"" but gave no details.",97,103,regime,5,3,8
3IJ95K7NDXD2PEJ0EQ4A56YVYPRNGV,"An EU diplomat confirmed, however, that the ministers agreed to impose an assets freeze and visa ban on two firms and three people believed to provide funding for the regime.",3,14,EU diplomat,1,0,1
3IJ95K7NDXD2PEJ0EQ4A56YVYPRNGV,"An EU diplomat confirmed, however, that the ministers agreed to impose an assets freeze and visa ban on two firms and three people believed to provide funding for the regime.",6,14,diplomat,2,2,4
3IJ95K7NDXD2PEJ0EQ4A56YVYPRNGV,"An EU diplomat confirmed, however, that the ministers agreed to impose an assets freeze and visa ban on two firms and three people believed to provide funding for the regime.",15,24,confirmed,0,3,3
3IJ95K7NDXD2PEJ0EQ4A56YVYPRNGV,"An EU diplomat confirmed, however, that the ministers agreed to impose an assets freeze and visa ban on two firms and three people believed to provide funding for the regime.",44,53,ministers,1,0,1
3IJ95K7NDXD2PEJ0EQ4A56YVYPRNGV,"An EU diplomat confirmed, however, that the ministers agreed to impose an assets freeze and visa ban on two firms and three people believed to provide funding for the regime.",64,70,impose,3,2,5
3IJ95K7NDXD2PEJ0EQ4A56YVYPRNGV,"An EU diplomat confirmed, however, that the ministers agreed to impose an assets freeze and visa ban on two firms and three people believed to provide funding for the regime.",74,80,assets,1,0,1
3IJ95K7NDXD2PEJ0EQ4A56YVYPRNGV,"An EU diplomat confirmed, however, that the ministers agreed to impose an assets freeze and visa ban on two firms and three people believed to provide funding for the regime.",74,87,assets freeze,8,4,12
3IJ95K7NDXD2PEJ0EQ4A56YVYPRNGV,"An EU diplomat confirmed, however, that the ministers agreed to impose an assets freeze and visa ban on two firms and three people believed to provide funding for the regime.",81,87,freeze,0,1,1
3IJ95K7NDXD2PEJ0EQ4A56YVYPRNGV,"An EU diplomat confirmed, however, that the ministers agreed to impose an assets freeze and visa ban on two firms and three people believed to provide funding for the regime.",92,96,visa,0,1,1
3IJ95K7NDXD2PEJ0EQ4A56YVYPRNGV,"An EU diplomat confirmed, however, that the ministers agreed to impose an assets freeze and visa ban on two firms and three people believed to provide funding for the regime.",92,100,visa ban,3,1,4
3IJ95K7NDXD2PEJ0EQ4A56YVYPRNGV,"An EU diplomat confirmed, however, that the ministers agreed to impose an assets freeze and visa ban on two firms and three people believed to provide funding for the regime.",151,158,funding,1,1,2
3IJ95K7NDXD2PEJ0EQ4A56YVYPRNGV,"An EU diplomat confirmed, however, that the ministers agreed to impose an assets freeze and visa ban on two firms and three people believed to provide funding for the regime.",167,173,regime,5,0,5
3IJ95K7NDXD2PEJ0EQ4A56YVYPRNGV,"Syria-linked violence has spilled across the border into Lebanon, with five people killed since Saturday during clashes in the northern port city of Tripoli, according to officials.",0,12,Syria-linked,1,1,2
3IJ95K7NDXD2PEJ0EQ4A56YVYPRNGV,"Syria-linked violence has spilled across the border into Lebanon, with five people killed since Saturday during clashes in the northern port city of Tripoli, according to officials.",0,21,Syria-linked violence,1,0,1
3IJ95K7NDXD2PEJ0EQ4A56YVYPRNGV,"Syria-linked violence has spilled across the border into Lebanon, with five people killed since Saturday during clashes in the northern port city of Tripoli, according to officials.",13,21,violence,0,2,2
3IJ95K7NDXD2PEJ0EQ4A56YVYPRNGV,"Syria-linked violence has spilled across the border into Lebanon, with five people killed since Saturday during clashes in the northern port city of Tripoli, according to officials.",26,33,spilled,3,5,8
3IJ95K7NDXD2PEJ0EQ4A56YVYPRNGV,"Syria-linked violence has spilled across the border into Lebanon, with five people killed since Saturday during clashes in the northern port city of Tripoli, according to officials.",45,51,border,1,0,1
3IJ95K7NDXD2PEJ0EQ4A56YVYPRNGV,"Syria-linked violence has spilled across the border into Lebanon, with five people killed since Saturday during clashes in the northern port city of Tripoli, according to officials.",112,119,clashes,3,2,5
3IJ95K7NDXD2PEJ0EQ4A56YVYPRNGV,Gunbattles erupted on Saturday between residents loyal to Syrian President Bashar al-Assad and those supportive of the Syrian opposition.,0,10,Gunbattles,1,1,2
3IJ95K7NDXD2PEJ0EQ4A56YVYPRNGV,Gunbattles erupted on Saturday between residents loyal to Syrian President Bashar al-Assad and those supportive of the Syrian opposition.,11,18,erupted,5,9,14
3IJ95K7NDXD2PEJ0EQ4A56YVYPRNGV,Gunbattles erupted on Saturday between residents loyal to Syrian President Bashar al-Assad and those supportive of the Syrian opposition.,49,54,loyal,0,2,2
3IJ95K7NDXD2PEJ0EQ4A56YVYPRNGV,Gunbattles erupted on Saturday between residents loyal to Syrian President Bashar al-Assad and those supportive of the Syrian opposition.,101,111,supportive,3,3,6
3IJ95K7NDXD2PEJ0EQ4A56YVYPRNGV,Gunbattles erupted on Saturday between residents loyal to Syrian President Bashar al-Assad and those supportive of the Syrian opposition.,126,136,opposition,2,0,2
3AA88CN98P413ZJXBJY0KEOV9QCKYL,"The EU ministers agreed to an assets freeze and visa ban on two firms and three people believed to provide funding for the regime, according to the office of EU foreign policy chief Catherine Ashton.",7,16,ministers,1,0,1
3AA88CN98P413ZJXBJY0KEOV9QCKYL,"The EU ministers agreed to an assets freeze and visa ban on two firms and three people believed to provide funding for the regime, according to the office of EU foreign policy chief Catherine Ashton.",30,36,assets,2,3,5
3AA88CN98P413ZJXBJY0KEOV9QCKYL,"The EU ministers agreed to an assets freeze and visa ban on two firms and three people believed to provide funding for the regime, according to the office of EU foreign policy chief Catherine Ashton.",30,43,assets freeze,7,2,9
3AA88CN98P413ZJXBJY0KEOV9QCKYL,"The EU ministers agreed to an assets freeze and visa ban on two firms and three people believed to provide funding for the regime, according to the office of EU foreign policy chief Catherine Ashton.",30,56,assets freeze and visa ban,0,1,1
3AA88CN98P413ZJXBJY0KEOV9QCKYL,"The EU ministers agreed to an assets freeze and visa ban on two firms and three people believed to provide funding for the regime, according to the office of EU foreign policy chief Catherine Ashton.",37,43,freeze,3,2,5
3AA88CN98P413ZJXBJY0KEOV9QCKYL,"The EU ministers agreed to an assets freeze and visa ban on two firms and three people believed to provide funding for the regime, according to the office of EU foreign policy chief Catherine Ashton.",48,52,visa,0,1,1
3AA88CN98P413ZJXBJY0KEOV9QCKYL,"The EU ministers agreed to an assets freeze and visa ban on two firms and three people believed to provide funding for the regime, according to the office of EU foreign policy chief Catherine Ashton.",48,56,visa ban,4,0,4
3AA88CN98P413ZJXBJY0KEOV9QCKYL,"The EU ministers agreed to an assets freeze and visa ban on two firms and three people believed to provide funding for the regime, according to the office of EU foreign policy chief Catherine Ashton.",53,56,ban,0,2,2
3AA88CN98P413ZJXBJY0KEOV9QCKYL,"The EU ministers agreed to an assets freeze and visa ban on two firms and three people believed to provide funding for the regime, according to the office of EU foreign policy chief Catherine Ashton.",87,95,believed,0,1,1
3AA88CN98P413ZJXBJY0KEOV9QCKYL,"The EU ministers agreed to an assets freeze and visa ban on two firms and three people believed to provide funding for the regime, according to the office of EU foreign policy chief Catherine Ashton.",87,106,believed to provide,1,0,1
3AA88CN98P413ZJXBJY0KEOV9QCKYL,"The EU ministers agreed to an assets freeze and visa ban on two firms and three people believed to provide funding for the regime, according to the office of EU foreign policy chief Catherine Ashton.",107,114,funding,1,1,2
3AA88CN98P413ZJXBJY0KEOV9QCKYL,"The EU ministers agreed to an assets freeze and visa ban on two firms and three people believed to provide funding for the regime, according to the office of EU foreign policy chief Catherine Ashton.",123,129,regime,9,3,12
3AA88CN98P413ZJXBJY0KEOV9QCKYL,"The continuing violence is appalling, Ashton said Monday.",16,24,violence,0,2,2
3AA88CN98P413ZJXBJY0KEOV9QCKYL,"The continuing violence is appalling, Ashton said Monday.",28,37,appalling,10,10,20
3AA88CN98P413ZJXBJY0KEOV9QCKYL,"Inside Syria, regime forces suffered heavy casualties Monday during clashes at Rastan, a city that has been pummeled by government forces, opposition activists said.",14,20,regime,3,0,3
3AA88CN98P413ZJXBJY0KEOV9QCKYL,"Inside Syria, regime forces suffered heavy casualties Monday during clashes at Rastan, a city that has been pummeled by government forces, opposition activists said.",14,27,regime forces,1,2,3
3AA88CN98P413ZJXBJY0KEOV9QCKYL,"Inside Syria, regime forces suffered heavy casualties Monday during clashes at Rastan, a city that has been pummeled by government forces, opposition activists said.",37,53,heavy casualties,2,1,3
3AA88CN98P413ZJXBJY0KEOV9QCKYL,"Inside Syria, regime forces suffered heavy casualties Monday during clashes at Rastan, a city that has been pummeled by government forces, opposition activists said.",43,53,casualties,4,7,11
3AA88CN98P413ZJXBJY0KEOV9QCKYL,"Inside Syria, regime forces suffered heavy casualties Monday during clashes at Rastan, a city that has been pummeled by government forces, opposition activists said.",68,75,clashes,0,3,3
3AA88CN98P413ZJXBJY0KEOV9QCKYL,"Inside Syria, regime forces suffered heavy casualties Monday during clashes at Rastan, a city that has been pummeled by government forces, opposition activists said.",108,116,pummeled,10,10,20
3AA88CN98P413ZJXBJY0KEOV9QCKYL,"Inside Syria, regime forces suffered heavy casualties Monday during clashes at Rastan, a city that has been pummeled by government forces, opposition activists said.",139,159,opposition activists,2,0,2
3AA88CN98P413ZJXBJY0KEOV9QCKYL,"Inside Syria, regime forces suffered heavy casualties Monday during clashes at Rastan, a city that has been pummeled by government forces, opposition activists said.",150,159,activists,1,0,1
3AA88CN98P413ZJXBJY0KEOV9QCKYL,"The Syrian Observatory for Human Rights said it received ""preliminary information that three armored personnel carriers were destroyed and that at least 23 soldiers were killed.""",11,22,Observatory,1,1,2
3AA88CN98P413ZJXBJY0KEOV9QCKYL,"The Syrian Observatory for Human Rights said it received ""preliminary information that three armored personnel carriers were destroyed and that at least 23 soldiers were killed.""",48,56,received,1,1,2
3AA88CN98P413ZJXBJY0KEOV9QCKYL,"The Syrian Observatory for Human Rights said it received ""preliminary information that three armored personnel carriers were destroyed and that at least 23 soldiers were killed.""",58,69,preliminary,10,2,12
3AA88CN98P413ZJXBJY0KEOV9QCKYL,"The Syrian Observatory for Human Rights said it received ""preliminary information that three armored personnel carriers were destroyed and that at least 23 soldiers were killed.""",58,81,preliminary information,3,0,3
3AA88CN98P413ZJXBJY0KEOV9QCKYL,"The Syrian Observatory for Human Rights said it received ""preliminary information that three armored personnel carriers were destroyed and that at least 23 soldiers were killed.""",93,100,armored,4,5,9
3AA88CN98P413ZJXBJY0KEOV9QCKYL,"The Syrian Observatory for Human Rights said it received ""preliminary information that three armored personnel carriers were destroyed and that at least 23 soldiers were killed.""",93,110,armored personnel,0,1,1
3AA88CN98P413ZJXBJY0KEOV9QCKYL,"The Syrian Observatory for Human Rights said it received ""preliminary information that three armored personnel carriers were destroyed and that at least 23 soldiers were killed.""",93,119,armored personnel carriers,4,0,4
3AA88CN98P413ZJXBJY0KEOV9QCKYL,"The Syrian Observatory for Human Rights said it received ""preliminary information that three armored personnel carriers were destroyed and that at least 23 soldiers were killed.""",101,110,personnel,3,0,3
3AA88CN98P413ZJXBJY0KEOV9QCKYL,"The Syrian Observatory for Human Rights said it received ""preliminary information that three armored personnel carriers were destroyed and that at least 23 soldiers were killed.""",111,119,carriers,0,1,1
3AA88CN98P413ZJXBJY0KEOV9QCKYL,"The Syrian Observatory for Human Rights said it received ""preliminary information that three armored personnel carriers were destroyed and that at least 23 soldiers were killed.""",125,134,destroyed,0,1,1
3AA88CN98P413ZJXBJY0KEOV9QCKYL,Medical supplies were running low after more than 60 people were reportedly injured from a barrage of roughly 255 mortar shells that rained on Rastan.,0,16,Medical supplies,0,1,1
3AA88CN98P413ZJXBJY0KEOV9QCKYL,Medical supplies were running low after more than 60 people were reportedly injured from a barrage of roughly 255 mortar shells that rained on Rastan.,22,33,running low,1,0,1
3AA88CN98P413ZJXBJY0KEOV9QCKYL,Medical supplies were running low after more than 60 people were reportedly injured from a barrage of roughly 255 mortar shells that rained on Rastan.,65,75,reportedly,1,0,1
3AA88CN98P413ZJXBJY0KEOV9QCKYL,Medical supplies were running low after more than 60 people were reportedly injured from a barrage of roughly 255 mortar shells that rained on Rastan.,91,98,barrage,8,10,18
3AA88CN98P413ZJXBJY0KEOV9QCKYL,Medical supplies were running low after more than 60 people were reportedly injured from a barrage of roughly 255 mortar shells that rained on Rastan.,102,109,roughly,0,1,1
3AA88CN98P413ZJXBJY0KEOV9QCKYL,Medical supplies were running low after more than 60 people were reportedly injured from a barrage of roughly 255 mortar shells that rained on Rastan.,114,120,mortar,2,2,4
3AA88CN98P413ZJXBJY0KEOV9QCKYL,Medical supplies were running low after more than 60 people were reportedly injured from a barrage of roughly 255 mortar shells that rained on Rastan.,114,127,mortar shells,3,2,5
3AA88CN98P413ZJXBJY0KEOV9QCKYL,Medical supplies were running low after more than 60 people were reportedly injured from a barrage of roughly 255 mortar shells that rained on Rastan.,121,127,shells,0,2,2
3AA88CN98P413ZJXBJY0KEOV9QCKYL,"Elsewhere in Syria, at least four people were killed Monday, including a child struck by random gunfire from the regime's army in Deir Ezzor, said the Local Coordination Committees of Syria, an opposition network.",79,85,struck,1,1,2
3AA88CN98P413ZJXBJY0KEOV9QCKYL,"Elsewhere in Syria, at least four people were killed Monday, including a child struck by random gunfire from the regime's army in Deir Ezzor, said the Local Coordination Committees of Syria, an opposition network.",89,95,random,2,2,4
3AA88CN98P413ZJXBJY0KEOV9QCKYL,"Elsewhere in Syria, at least four people were killed Monday, including a child struck by random gunfire from the regime's army in Deir Ezzor, said the Local Coordination Committees of Syria, an opposition network.",89,103,random gunfire,0,1,1
3AA88CN98P413ZJXBJY0KEOV9QCKYL,"Elsewhere in Syria, at least four people were killed Monday, including a child struck by random gunfire from the regime's army in Deir Ezzor, said the Local Coordination Committees of Syria, an opposition network.",113,120,regimes,1,0,1
3AA88CN98P413ZJXBJY0KEOV9QCKYL,"Elsewhere in Syria, at least four people were killed Monday, including a child struck by random gunfire from the regime's army in Deir Ezzor, said the Local Coordination Committees of Syria, an opposition network.",113,125,regimes army,3,1,4
3AA88CN98P413ZJXBJY0KEOV9QCKYL,"Elsewhere in Syria, at least four people were killed Monday, including a child struck by random gunfire from the regime's army in Deir Ezzor, said the Local Coordination Committees of Syria, an opposition network.",151,180,Local Coordination Committees,1,0,1
3AA88CN98P413ZJXBJY0KEOV9QCKYL,"Elsewhere in Syria, at least four people were killed Monday, including a child struck by random gunfire from the regime's army in Deir Ezzor, said the Local Coordination Committees of Syria, an opposition network.",157,169,Coordination,1,1,2
3AA88CN98P413ZJXBJY0KEOV9QCKYL,"Elsewhere in Syria, at least four people were killed Monday, including a child struck by random gunfire from the regime's army in Deir Ezzor, said the Local Coordination Committees of Syria, an opposition network.",194,204,opposition,3,0,3
3AA88CN98P413ZJXBJY0KEOV9QCKYL,"Elsewhere in Syria, at least four people were killed Monday, including a child struck by random gunfire from the regime's army in Deir Ezzor, said the Local Coordination Committees of Syria, an opposition network.",194,212,opposition network,2,0,2
3I7SHAD35MXDE3NZ9MLGMEW2U8D7MF,"The group has also shown a focus on high profile assaults in Kabul, such as the April 15 coordinated attacks in the capital and eastern Afghanistan.",27,32,focus,0,3,3
3I7SHAD35MXDE3NZ9MLGMEW2U8D7MF,"The group has also shown a focus on high profile assaults in Kabul, such as the April 15 coordinated attacks in the capital and eastern Afghanistan.",36,48,high profile,4,3,7
3I7SHAD35MXDE3NZ9MLGMEW2U8D7MF,"The group has also shown a focus on high profile assaults in Kabul, such as the April 15 coordinated attacks in the capital and eastern Afghanistan.",36,57,high profile assaults,1,2,3
3I7SHAD35MXDE3NZ9MLGMEW2U8D7MF,"The group has also shown a focus on high profile assaults in Kabul, such as the April 15 coordinated attacks in the capital and eastern Afghanistan.",41,48,profile,0,1,1
3I7SHAD35MXDE3NZ9MLGMEW2U8D7MF,"The group has also shown a focus on high profile assaults in Kabul, such as the April 15 coordinated attacks in the capital and eastern Afghanistan.",49,57,assaults,6,6,12
3I7SHAD35MXDE3NZ9MLGMEW2U8D7MF,"The group has also shown a focus on high profile assaults in Kabul, such as the April 15 coordinated attacks in the capital and eastern Afghanistan.",89,100,coordinated,8,4,12
3I7SHAD35MXDE3NZ9MLGMEW2U8D7MF,"The group has also shown a focus on high profile assaults in Kabul, such as the April 15 coordinated attacks in the capital and eastern Afghanistan.",89,108,coordinated attacks,4,1,5
3I7SHAD35MXDE3NZ9MLGMEW2U8D7MF,"The group has also shown a focus on high profile assaults in Kabul, such as the April 15 coordinated attacks in the capital and eastern Afghanistan.",116,123,capital,1,0,1
3I7SHAD35MXDE3NZ9MLGMEW2U8D7MF,"Obama has drawn some flak for making his trip to Afghanistan overnight and leaving at sunrise, which some observers say shows little faith in the security situation here.",10,25,drawn some flak,1,0,1
3I7SHAD35MXDE3NZ9MLGMEW2U8D7MF,"Obama has drawn some flak for making his trip to Afghanistan overnight and leaving at sunrise, which some observers say shows little faith in the security situation here.",21,25,flak,10,10,20
3I7SHAD35MXDE3NZ9MLGMEW2U8D7MF,"Obama has drawn some flak for making his trip to Afghanistan overnight and leaving at sunrise, which some observers say shows little faith in the security situation here.",61,70,overnight,0,2,2
3I7SHAD35MXDE3NZ9MLGMEW2U8D7MF,"Obama has drawn some flak for making his trip to Afghanistan overnight and leaving at sunrise, which some observers say shows little faith in the security situation here.",106,115,observers,3,1,4
3I7SHAD35MXDE3NZ9MLGMEW2U8D7MF,"Obama has drawn some flak for making his trip to Afghanistan overnight and leaving at sunrise, which some observers say shows little faith in the security situation here.",133,138,faith,1,1,2
3I7SHAD35MXDE3NZ9MLGMEW2U8D7MF,"Obama has drawn some flak for making his trip to Afghanistan overnight and leaving at sunrise, which some observers say shows little faith in the security situation here.",146,164,security situation,2,0,2
3I7SHAD35MXDE3NZ9MLGMEW2U8D7MF,"Obama has drawn some flak for making his trip to Afghanistan overnight and leaving at sunrise, which some observers say shows little faith in the security situation here.",155,164,situation,1,1,2
3I7SHAD35MXDE3NZ9MLGMEW2U8D7MF,"Among most Afghans, however, the timing of the trip is of little concern.",55,72,of little concern,1,0,1
3I7SHAD35MXDE3NZ9MLGMEW2U8D7MF,"Among most Afghans, however, the timing of the trip is of little concern.",58,72,little concern,2,1,3
3I7SHAD35MXDE3NZ9MLGMEW2U8D7MF,"Among most Afghans, however, the timing of the trip is of little concern.",65,72,concern,0,3,3
3I7SHAD35MXDE3NZ9MLGMEW2U8D7MF,That Obama made the trip to sign the agreement in person remains the most salient point.,37,46,agreement,1,0,1
3I7SHAD35MXDE3NZ9MLGMEW2U8D7MF,That Obama made the trip to sign the agreement in person remains the most salient point.,74,81,salient,10,7,17
3I7SHAD35MXDE3NZ9MLGMEW2U8D7MF,That Obama made the trip to sign the agreement in person remains the most salient point.,74,87,salient point,2,4,6
3I7SHAD35MXDE3NZ9MLGMEW2U8D7MF,"Many Afghans have been looking for assurance that the US will not abandon the country after 2014, as the international community did for Afghanistan after the Soviet war ended.",35,44,assurance,7,7,14
3I7SHAD35MXDE3NZ9MLGMEW2U8D7MF,"Many Afghans have been looking for assurance that the US will not abandon the country after 2014, as the international community did for Afghanistan after the Soviet war ended.",62,73,not abandon,1,0,1
3I7SHAD35MXDE3NZ9MLGMEW2U8D7MF,"Many Afghans have been looking for assurance that the US will not abandon the country after 2014, as the international community did for Afghanistan after the Soviet war ended.",66,73,abandon,0,9,9
3I7SHAD35MXDE3NZ9MLGMEW2U8D7MF,"Many Afghans have been looking for assurance that the US will not abandon the country after 2014, as the international community did for Afghanistan after the Soviet war ended.",105,118,international,1,0,1
3I7SHAD35MXDE3NZ9MLGMEW2U8D7MF,"Many Afghans have been looking for assurance that the US will not abandon the country after 2014, as the international community did for Afghanistan after the Soviet war ended.",105,128,international community,3,1,4
3I7SHAD35MXDE3NZ9MLGMEW2U8D7MF,"Many Afghans have been looking for assurance that the US will not abandon the country after 2014, as the international community did for Afghanistan after the Soviet war ended.",159,165,Soviet,0,1,1
3I7SHAD35MXDE3NZ9MLGMEW2U8D7MF,"Many Afghans have been looking for assurance that the US will not abandon the country after 2014, as the international community did for Afghanistan after the Soviet war ended.",159,169,Soviet war,1,0,1
3I7SHAD35MXDE3NZ9MLGMEW2U8D7MF,"“We don’t know why they choose such a time, but it doesn’t matter if they signed it in the night time or the day time,” says Rasheed Waziri, a member of the Afghanistan Regional Studies Center.",24,42,choose such a time,1,0,1
3I7SHAD35MXDE3NZ9MLGMEW2U8D7MF,"“We don’t know why they choose such a time, but it doesn’t matter if they signed it in the night time or the day time,” says Rasheed Waziri, a member of the Afghanistan Regional Studies Center.",169,177,Regional,1,0,1
3J9L0X0VDFNDXY56SLPN98PZO139WB,"Google will report to an independent monitor in China on its efforts to comply with terms of the deal approval, according to the website.",25,36,independent,3,2,5
3J9L0X0VDFNDXY56SLPN98PZO139WB,"Google will report to an independent monitor in China on its efforts to comply with terms of the deal approval, according to the website.",25,44,independent monitor,7,1,8
3J9L0X0VDFNDXY56SLPN98PZO139WB,"Google will report to an independent monitor in China on its efforts to comply with terms of the deal approval, according to the website.",37,44,monitor,1,4,5
3J9L0X0VDFNDXY56SLPN98PZO139WB,"Google will report to an independent monitor in China on its efforts to comply with terms of the deal approval, according to the website.",72,78,comply,7,10,17
3J9L0X0VDFNDXY56SLPN98PZO139WB,"Google will report to an independent monitor in China on its efforts to comply with terms of the deal approval, according to the website.",72,83,comply with,0,1,1
3J9L0X0VDFNDXY56SLPN98PZO139WB,"Google will report to an independent monitor in China on its efforts to comply with terms of the deal approval, according to the website.",72,89,comply with terms,0,1,1
3J9L0X0VDFNDXY56SLPN98PZO139WB,"Google will report to an independent monitor in China on its efforts to comply with terms of the deal approval, according to the website.",97,101,deal,0,1,1
3J9L0X0VDFNDXY56SLPN98PZO139WB,"Google will report to an independent monitor in China on its efforts to comply with terms of the deal approval, according to the website.",97,110,deal approval,1,0,1
3J9L0X0VDFNDXY56SLPN98PZO139WB,"Google will report to an independent monitor in China on its efforts to comply with terms of the deal approval, according to the website.",102,110,approval,0,3,3
3J9L0X0VDFNDXY56SLPN98PZO139WB,"Google will report to an independent monitor in China on its efforts to comply with terms of the deal approval, according to the website.",112,121,according,0,1,1
3J9L0X0VDFNDXY56SLPN98PZO139WB,Google fell 3.6 percent to $600.40 yesterday in New York trading.,7,11,fell,0,1,1
3J9L0X0VDFNDXY56SLPN98PZO139WB,Google fell 3.6 percent to $600.40 yesterday in New York trading.,48,65,New York  trading,1,0,1
3J9L0X0VDFNDXY56SLPN98PZO139WB,Google fell 3.6 percent to $600.40 yesterday in New York trading.,57,64,trading,0,1,1
3J9L0X0VDFNDXY56SLPN98PZO139WB,The shares have fallen 7 percent this year.,4,10,shares,2,2,4
3J9L0X0VDFNDXY56SLPN98PZO139WB,Motorola Mobility closed unchanged at $39.20.,9,17,Mobility,0,2,2
3J9L0X0VDFNDXY56SLPN98PZO139WB,Motorola Mobility closed unchanged at $39.20.,18,34,closed unchanged,1,0,1
3J9L0X0VDFNDXY56SLPN98PZO139WB,Motorola Mobility closed unchanged at $39.20.,25,34,unchanged,2,2,4
3J9L0X0VDFNDXY56SLPN98PZO139WB,The stock is up 1 percent year to date.,4,9,stock,1,0,1
3J9L0X0VDFNDXY56SLPN98PZO139WB,The stock is up 1 percent year to date.,26,38,year to date,1,0,1
3J9L0X0VDFNDXY56SLPN98PZO139WB,"After graduating, he returned to the new TechCrunch to as a full-time mobile writer.",6,16,graduating,3,6,9
3J9L0X0VDFNDXY56SLPN98PZO139WB,"After graduating, he returned to the new TechCrunch to as a full-time mobile writer.",41,51,TechCrunch,2,0,2
3J9L0X0VDFNDXY56SLPN98PZO139WB,"After graduating, he returned to the new TechCrunch to as a full-time mobile writer.",70,83,mobile writer,3,3,6
3J9L0X0VDFNDXY56SLPN98PZO139WB,"He counts advertising, running, musical theater,...        → Learn More It's been just over nine months since Google announced their intentions to acquire hardware manufacturer Motorola Mobility for $12.5 billion, and now it seems that the final pieces of the deal have fallen into place.",10,21,advertising,2,0,2
3J9L0X0VDFNDXY56SLPN98PZO139WB,"He counts advertising, running, musical theater,...        → Learn More It's been just over nine months since Google announced their intentions to acquire hardware manufacturer Motorola Mobility for $12.5 billion, and now it seems that the final pieces of the deal have fallen into place.",117,126,announced,2,1,3
3J9L0X0VDFNDXY56SLPN98PZO139WB,"He counts advertising, running, musical theater,...        → Learn More It's been just over nine months since Google announced their intentions to acquire hardware manufacturer Motorola Mobility for $12.5 billion, and now it seems that the final pieces of the deal have fallen into place.",133,143,intentions,6,3,9
3J9L0X0VDFNDXY56SLPN98PZO139WB,"He counts advertising, running, musical theater,...        → Learn More It's been just over nine months since Google announced their intentions to acquire hardware manufacturer Motorola Mobility for $12.5 billion, and now it seems that the final pieces of the deal have fallen into place.",147,154,acquire,10,5,15
3J9L0X0VDFNDXY56SLPN98PZO139WB,"He counts advertising, running, musical theater,...        → Learn More It's been just over nine months since Google announced their intentions to acquire hardware manufacturer Motorola Mobility for $12.5 billion, and now it seems that the final pieces of the deal have fallen into place.",147,176,acquire hardware manufacturer,1,0,1
3J9L0X0VDFNDXY56SLPN98PZO139WB,"He counts advertising, running, musical theater,...        → Learn More It's been just over nine months since Google announced their intentions to acquire hardware manufacturer Motorola Mobility for $12.5 billion, and now it seems that the final pieces of the deal have fallen into place.",155,163,hardware,1,1,2
3J9L0X0VDFNDXY56SLPN98PZO139WB,"He counts advertising, running, musical theater,...        → Learn More It's been just over nine months since Google announced their intentions to acquire hardware manufacturer Motorola Mobility for $12.5 billion, and now it seems that the final pieces of the deal have fallen into place.",155,176,hardware manufacturer,2,0,2
3J9L0X0VDFNDXY56SLPN98PZO139WB,"He counts advertising, running, musical theater,...        → Learn More It's been just over nine months since Google announced their intentions to acquire hardware manufacturer Motorola Mobility for $12.5 billion, and now it seems that the final pieces of the deal have fallen into place.",164,176,manufacturer,3,1,4
3J9L0X0VDFNDXY56SLPN98PZO139WB,"He counts advertising, running, musical theater,...        → Learn More It's been just over nine months since Google announced their intentions to acquire hardware manufacturer Motorola Mobility for $12.5 billion, and now it seems that the final pieces of the deal have fallen into place.",240,252,final pieces,0,1,1
3J9L0X0VDFNDXY56SLPN98PZO139WB,"He counts advertising, running, musical theater,...        → Learn More It's been just over nine months since Google announced their intentions to acquire hardware manufacturer Motorola Mobility for $12.5 billion, and now it seems that the final pieces of the deal have fallen into place.",260,264,deal,0,1,1
3J9L0X0VDFNDXY56SLPN98PZO139WB,"According to a new report from the Associated Press, Chinese officials have finally given the Google-Motorola deal their blessing.",121,129,blessing,4,9,13
3DTJ4WT8BDGYMP1SBJPG0QKSW0NEZG,The victim 32-year-old male was shot in the chest and arm by a lone gunman who approached the car he was sitting in outside a pub on Sarsfield Road in Ballyfermot at 11:10pm.,4,10,victim,3,5,8
3DTJ4WT8BDGYMP1SBJPG0QKSW0NEZG,The victim 32-year-old male was shot in the chest and arm by a lone gunman who approached the car he was sitting in outside a pub on Sarsfield Road in Ballyfermot at 11:10pm.,44,49,chest,0,1,1
3DTJ4WT8BDGYMP1SBJPG0QKSW0NEZG,The victim 32-year-old male was shot in the chest and arm by a lone gunman who approached the car he was sitting in outside a pub on Sarsfield Road in Ballyfermot at 11:10pm.,63,67,lone,2,2,4
3DTJ4WT8BDGYMP1SBJPG0QKSW0NEZG,The victim 32-year-old male was shot in the chest and arm by a lone gunman who approached the car he was sitting in outside a pub on Sarsfield Road in Ballyfermot at 11:10pm.,63,74,lone gunman,3,0,3
3DTJ4WT8BDGYMP1SBJPG0QKSW0NEZG,The victim 32-year-old male was shot in the chest and arm by a lone gunman who approached the car he was sitting in outside a pub on Sarsfield Road in Ballyfermot at 11:10pm.,68,74,gunman,1,1,2
3DTJ4WT8BDGYMP1SBJPG0QKSW0NEZG,The victim 32-year-old male was shot in the chest and arm by a lone gunman who approached the car he was sitting in outside a pub on Sarsfield Road in Ballyfermot at 11:10pm.,79,89,approached,1,3,4
3DTJ4WT8BDGYMP1SBJPG0QKSW0NEZG,The victim 32-year-old male was shot in the chest and arm by a lone gunman who approached the car he was sitting in outside a pub on Sarsfield Road in Ballyfermot at 11:10pm.,126,129,pub,3,3,6
3DTJ4WT8BDGYMP1SBJPG0QKSW0NEZG,The injured man was able to drive his car to Cloverhill Prison where he got help.,4,11,injured,0,2,2
3DTJ4WT8BDGYMP1SBJPG0QKSW0NEZG,The injured man was able to drive his car to Cloverhill Prison where he got help.,56,62,Prison,0,1,1
3DTJ4WT8BDGYMP1SBJPG0QKSW0NEZG,He is being treated at Tallaght  Hospital but his injuries are not thought to be life-threatening.,12,19,treated,1,0,1
3DTJ4WT8BDGYMP1SBJPG0QKSW0NEZG,He is being treated at Tallaght  Hospital but his injuries are not thought to be life-threatening.,81,97,life-threatening,8,10,18
3DTJ4WT8BDGYMP1SBJPG0QKSW0NEZG,Another silver saloon car was found burnt out later.,8,21,silver saloon,1,0,1
3DTJ4WT8BDGYMP1SBJPG0QKSW0NEZG,Another silver saloon car was found burnt out later.,8,25,silver saloon car,1,0,1
3DTJ4WT8BDGYMP1SBJPG0QKSW0NEZG,Another silver saloon car was found burnt out later.,15,21,saloon,3,0,3
3DTJ4WT8BDGYMP1SBJPG0QKSW0NEZG,Another silver saloon car was found burnt out later.,15,25,saloon car,4,1,5
3DTJ4WT8BDGYMP1SBJPG0QKSW0NEZG,Another silver saloon car was found burnt out later.,36,45,burnt out,1,0,1
3DTJ4WT8BDGYMP1SBJPG0QKSW0NEZG,Both vehicles will also be technically examined.,27,38,technically,4,0,4
3DTJ4WT8BDGYMP1SBJPG0QKSW0NEZG,Both vehicles will also be technically examined.,27,47,technically examined,5,2,7
3DTJ4WT8BDGYMP1SBJPG0QKSW0NEZG,Both vehicles will also be technically examined.,39,47,examined,3,1,4
3DTJ4WT8BDGYMP1SBJPG0QKSW0NEZG,Gardaí are asking anyone who was in the Sarsfield   Road area of Ballyfermot or in the Golden Bridge Terrace area to contact them on 01-666-7200.,0,6,Gardaí,0,2,2
3DTJ4WT8BDGYMP1SBJPG0QKSW0NEZG,Gardaí are asking anyone who was in the Sarsfield   Road area of Ballyfermot or in the Golden Bridge Terrace area to contact them on 01-666-7200.,65,76,Ballyfermot,1,0,1
3DTJ4WT8BDGYMP1SBJPG0QKSW0NEZG,Gardaí are asking anyone who was in the Sarsfield   Road area of Ballyfermot or in the Golden Bridge Terrace area to contact them on 01-666-7200.,101,108,Terrace,0,1,1
3DTJ4WT8BDGYMP1SBJPG0QKSW0NEZG,"The Philippine government said Wednesday it agreed with China to diplomatically resolve a tense standoff involving a Philippine warship and two Chinese surveillance vessels in the disputed South China Sea, the most dangerous confrontation between the sides in recent years.",15,25,government,1,0,1
3DTJ4WT8BDGYMP1SBJPG0QKSW0NEZG,"The Philippine government said Wednesday it agreed with China to diplomatically resolve a tense standoff involving a Philippine warship and two Chinese surveillance vessels in the disputed South China Sea, the most dangerous confrontation between the sides in recent years.",65,79,diplomatically,10,3,13
3DTJ4WT8BDGYMP1SBJPG0QKSW0NEZG,"The Philippine government said Wednesday it agreed with China to diplomatically resolve a tense standoff involving a Philippine warship and two Chinese surveillance vessels in the disputed South China Sea, the most dangerous confrontation between the sides in recent years.",65,87,diplomatically resolve,3,4,7
3DTJ4WT8BDGYMP1SBJPG0QKSW0NEZG,"The Philippine government said Wednesday it agreed with China to diplomatically resolve a tense standoff involving a Philippine warship and two Chinese surveillance vessels in the disputed South China Sea, the most dangerous confrontation between the sides in recent years.",80,87,resolve,2,1,3
3DTJ4WT8BDGYMP1SBJPG0QKSW0NEZG,"The Philippine government said Wednesday it agreed with China to diplomatically resolve a tense standoff involving a Philippine warship and two Chinese surveillance vessels in the disputed South China Sea, the most dangerous confrontation between the sides in recent years.",90,104,tense standoff,3,0,3
3DTJ4WT8BDGYMP1SBJPG0QKSW0NEZG,"The Philippine government said Wednesday it agreed with China to diplomatically resolve a tense standoff involving a Philippine warship and two Chinese surveillance vessels in the disputed South China Sea, the most dangerous confrontation between the sides in recent years.",96,104,standoff,5,9,14
3DTJ4WT8BDGYMP1SBJPG0QKSW0NEZG,"The Philippine government said Wednesday it agreed with China to diplomatically resolve a tense standoff involving a Philippine warship and two Chinese surveillance vessels in the disputed South China Sea, the most dangerous confrontation between the sides in recent years.",105,114,involving,1,2,3
3DTJ4WT8BDGYMP1SBJPG0QKSW0NEZG,"The Philippine government said Wednesday it agreed with China to diplomatically resolve a tense standoff involving a Philippine warship and two Chinese surveillance vessels in the disputed South China Sea, the most dangerous confrontation between the sides in recent years.",128,135,warship,1,0,1
3DTJ4WT8BDGYMP1SBJPG0QKSW0NEZG,"The Philippine government said Wednesday it agreed with China to diplomatically resolve a tense standoff involving a Philippine warship and two Chinese surveillance vessels in the disputed South China Sea, the most dangerous confrontation between the sides in recent years.",152,164,surveillance,5,6,11
3DTJ4WT8BDGYMP1SBJPG0QKSW0NEZG,"The Philippine government said Wednesday it agreed with China to diplomatically resolve a tense standoff involving a Philippine warship and two Chinese surveillance vessels in the disputed South China Sea, the most dangerous confrontation between the sides in recent years.",152,172,surveillance vessels,6,1,7
3DTJ4WT8BDGYMP1SBJPG0QKSW0NEZG,"The Philippine government said Wednesday it agreed with China to diplomatically resolve a tense standoff involving a Philippine warship and two Chinese surveillance vessels in the disputed South China Sea, the most dangerous confrontation between the sides in recent years.",165,172,vessels,0,2,2
3DTJ4WT8BDGYMP1SBJPG0QKSW0NEZG,"The Philippine government said Wednesday it agreed with China to diplomatically resolve a tense standoff involving a Philippine warship and two Chinese surveillance vessels in the disputed South China Sea, the most dangerous confrontation between the sides in recent years.",180,188,disputed,5,5,10
3DTJ4WT8BDGYMP1SBJPG0QKSW0NEZG,"The Philippine government said Wednesday it agreed with China to diplomatically resolve a tense standoff involving a Philippine warship and two Chinese surveillance vessels in the disputed South China Sea, the most dangerous confrontation between the sides in recent years.",215,238,dangerous confrontation,2,0,2
3DTJ4WT8BDGYMP1SBJPG0QKSW0NEZG,"The Philippine government said Wednesday it agreed with China to diplomatically resolve a tense standoff involving a Philippine warship and two Chinese surveillance vessels in the disputed South China Sea, the most dangerous confrontation between the sides in recent years.",225,238,confrontation,10,9,19
3WJGKMRWVIAGMQCINAUOJA1MN60DCN,Wash said the family attended services last Sunday but had been absent for a few weeks before that.,21,29,attended,1,0,1
3WJGKMRWVIAGMQCINAUOJA1MN60DCN,Wash said the family attended services last Sunday but had been absent for a few weeks before that.,21,38,attended services,1,0,1
3WJGKMRWVIAGMQCINAUOJA1MN60DCN,Wash said the family attended services last Sunday but had been absent for a few weeks before that.,30,38,services,0,1,1
3WJGKMRWVIAGMQCINAUOJA1MN60DCN,Wash said the family attended services last Sunday but had been absent for a few weeks before that.,55,70,had been absent,0,1,1
3WJGKMRWVIAGMQCINAUOJA1MN60DCN,Wash said the family attended services last Sunday but had been absent for a few weeks before that.,64,70,absent,3,1,4
3WJGKMRWVIAGMQCINAUOJA1MN60DCN,"I don't know what could have happened in the past couple of days, Wash said.",51,65,couple of days,0,1,1
3WJGKMRWVIAGMQCINAUOJA1MN60DCN,It's a tragedy to the church and the community.,8,15,tragedy,10,8,18
3WJGKMRWVIAGMQCINAUOJA1MN60DCN,It's a tragedy to the church and the community.,38,47,community,3,0,3
3WJGKMRWVIAGMQCINAUOJA1MN60DCN,A 21-year-old woman who was seriously injured in a shooting incident in Co Derry yesterday remains in a critical condition at Belfast's Royal Victoria Hospital.,28,45,seriously injured,0,2,2
3WJGKMRWVIAGMQCINAUOJA1MN60DCN,A 21-year-old woman who was seriously injured in a shooting incident in Co Derry yesterday remains in a critical condition at Belfast's Royal Victoria Hospital.,51,59,shooting,1,1,2
3WJGKMRWVIAGMQCINAUOJA1MN60DCN,A 21-year-old woman who was seriously injured in a shooting incident in Co Derry yesterday remains in a critical condition at Belfast's Royal Victoria Hospital.,51,68,shooting incident,2,2,4
3WJGKMRWVIAGMQCINAUOJA1MN60DCN,A 21-year-old woman who was seriously injured in a shooting incident in Co Derry yesterday remains in a critical condition at Belfast's Royal Victoria Hospital.,60,68,incident,1,0,1
3WJGKMRWVIAGMQCINAUOJA1MN60DCN,A 21-year-old woman who was seriously injured in a shooting incident in Co Derry yesterday remains in a critical condition at Belfast's Royal Victoria Hospital.,91,98,remains,0,1,1
3WJGKMRWVIAGMQCINAUOJA1MN60DCN,A 21-year-old woman who was seriously injured in a shooting incident in Co Derry yesterday remains in a critical condition at Belfast's Royal Victoria Hospital.,104,112,critical,5,4,9
3WJGKMRWVIAGMQCINAUOJA1MN60DCN,A 21-year-old woman who was seriously injured in a shooting incident in Co Derry yesterday remains in a critical condition at Belfast's Royal Victoria Hospital.,104,122,critical condition,3,2,5
3WJGKMRWVIAGMQCINAUOJA1MN60DCN,"Her sister, Lauren O'Neill, 18, was killed in the gun attack at a house in William Court, Bellaghy yesterday morning.",50,71,gun attack at a house,1,0,1
3WJGKMRWVIAGMQCINAUOJA1MN60DCN,"A 26-year-old man, who was arrested on suspicion of murder, remains in custody assisting police with their inquiries.",39,48,suspicion,10,6,16
3WJGKMRWVIAGMQCINAUOJA1MN60DCN,"A 26-year-old man, who was arrested on suspicion of murder, remains in custody assisting police with their inquiries.",39,58,suspicion of murder,2,3,5
3WJGKMRWVIAGMQCINAUOJA1MN60DCN,"A 26-year-old man, who was arrested on suspicion of murder, remains in custody assisting police with their inquiries.",68,78,in custody,2,0,2
3WJGKMRWVIAGMQCINAUOJA1MN60DCN,"A 26-year-old man, who was arrested on suspicion of murder, remains in custody assisting police with their inquiries.",71,78,custody,3,3,6
3WJGKMRWVIAGMQCINAUOJA1MN60DCN,"A 26-year-old man, who was arrested on suspicion of murder, remains in custody assisting police with their inquiries.",71,95,custody assisting police,1,0,1
3WJGKMRWVIAGMQCINAUOJA1MN60DCN,"A 26-year-old man, who was arrested on suspicion of murder, remains in custody assisting police with their inquiries.",79,88,assisting,1,2,3
3WJGKMRWVIAGMQCINAUOJA1MN60DCN,"A 26-year-old man, who was arrested on suspicion of murder, remains in custody assisting police with their inquiries.",107,116,inquiries,4,5,9
3WJGKMRWVIAGMQCINAUOJA1MN60DCN,"Police say a man and woman, both aged 28, who were arrested on suspicion of assisting an offender were both released unconditionally last night.",63,72,suspicion,5,2,7
3WJGKMRWVIAGMQCINAUOJA1MN60DCN,"Police say a man and woman, both aged 28, who were arrested on suspicion of assisting an offender were both released unconditionally last night.",63,85,suspicion of assisting,0,1,1
3WJGKMRWVIAGMQCINAUOJA1MN60DCN,"Police say a man and woman, both aged 28, who were arrested on suspicion of assisting an offender were both released unconditionally last night.",63,97,suspicion of assisting an offender,1,0,1
3WJGKMRWVIAGMQCINAUOJA1MN60DCN,"Police say a man and woman, both aged 28, who were arrested on suspicion of assisting an offender were both released unconditionally last night.",76,85,assisting,1,1,2
3WJGKMRWVIAGMQCINAUOJA1MN60DCN,"Police say a man and woman, both aged 28, who were arrested on suspicion of assisting an offender were both released unconditionally last night.",76,97,assisting an offender,1,1,2
3WJGKMRWVIAGMQCINAUOJA1MN60DCN,"Police say a man and woman, both aged 28, who were arrested on suspicion of assisting an offender were both released unconditionally last night.",89,97,offender,4,4,8
3WJGKMRWVIAGMQCINAUOJA1MN60DCN,"Police say a man and woman, both aged 28, who were arrested on suspicion of assisting an offender were both released unconditionally last night.",108,132,released unconditionally,4,1,5
3WJGKMRWVIAGMQCINAUOJA1MN60DCN,"Police say a man and woman, both aged 28, who were arrested on suspicion of assisting an offender were both released unconditionally last night.",117,132,unconditionally,10,5,15
30U1YOGZGAXWT71EKWKOYF548WJDSN,Many defectors from the army comes from Rastan.,6,15,defectors,10,10,20
30U1YOGZGAXWT71EKWKOYF548WJDSN,Many defectors from the army comes from Rastan.,41,47,Rastan,2,2,4
30U1YOGZGAXWT71EKWKOYF548WJDSN,"Syrian authorities say more than 2,500 members of the security forces have been killed since the uprising began in March last year.",7,18,authorities,2,2,4
30U1YOGZGAXWT71EKWKOYF548WJDSN,"Syrian authorities say more than 2,500 members of the security forces have been killed since the uprising began in March last year.",54,69,security forces,3,0,3
30U1YOGZGAXWT71EKWKOYF548WJDSN,"Syrian authorities say more than 2,500 members of the security forces have been killed since the uprising began in March last year.",97,105,uprising,7,10,17
30U1YOGZGAXWT71EKWKOYF548WJDSN,"Opposition activists say more than 9,000 people have been killed.",0,10,Opposition,4,1,5
30U1YOGZGAXWT71EKWKOYF548WJDSN,"Opposition activists say more than 9,000 people have been killed.",0,20,Opposition activists,5,2,7
30U1YOGZGAXWT71EKWKOYF548WJDSN,"Opposition activists say more than 9,000 people have been killed.",11,20,activists,1,3,4
30U1YOGZGAXWT71EKWKOYF548WJDSN,EU sanctions Monday's violence further undermines a UN-backed peace plan that is supposed to bring an end to Syria's deadly crisis.,0,12,EU sanctions,1,0,1
30U1YOGZGAXWT71EKWKOYF548WJDSN,EU sanctions Monday's violence further undermines a UN-backed peace plan that is supposed to bring an end to Syria's deadly crisis.,3,12,sanctions,9,1,10
30U1YOGZGAXWT71EKWKOYF548WJDSN,EU sanctions Monday's violence further undermines a UN-backed peace plan that is supposed to bring an end to Syria's deadly crisis.,39,49,undermines,6,10,16
30U1YOGZGAXWT71EKWKOYF548WJDSN,EU sanctions Monday's violence further undermines a UN-backed peace plan that is supposed to bring an end to Syria's deadly crisis.,52,61,UN-backed,1,0,1
30U1YOGZGAXWT71EKWKOYF548WJDSN,EU sanctions Monday's violence further undermines a UN-backed peace plan that is supposed to bring an end to Syria's deadly crisis.,52,72,UN-backed peace plan,0,1,1
30U1YOGZGAXWT71EKWKOYF548WJDSN,EU sanctions Monday's violence further undermines a UN-backed peace plan that is supposed to bring an end to Syria's deadly crisis.,62,72,peace plan,1,0,1
30U1YOGZGAXWT71EKWKOYF548WJDSN,EU sanctions Monday's violence further undermines a UN-backed peace plan that is supposed to bring an end to Syria's deadly crisis.,81,89,supposed,1,2,3
30U1YOGZGAXWT71EKWKOYF548WJDSN,EU sanctions Monday's violence further undermines a UN-backed peace plan that is supposed to bring an end to Syria's deadly crisis.,117,130,deadly crisis,2,2,4
30U1YOGZGAXWT71EKWKOYF548WJDSN,EU sanctions Monday's violence further undermines a UN-backed peace plan that is supposed to bring an end to Syria's deadly crisis.,124,130,crisis,1,4,5
30U1YOGZGAXWT71EKWKOYF548WJDSN,"A ceasefire that was supposed to begin on April 12 has had only a limited effect, throwing into doubt the rest of the plan that calls for talks between President Bashar al-Assad's government and those seeking to end his rule.",2,11,ceasefire,10,10,20
30U1YOGZGAXWT71EKWKOYF548WJDSN,"A ceasefire that was supposed to begin on April 12 has had only a limited effect, throwing into doubt the rest of the plan that calls for talks between President Bashar al-Assad's government and those seeking to end his rule.",21,29,supposed,0,1,1
30U1YOGZGAXWT71EKWKOYF548WJDSN,"A ceasefire that was supposed to begin on April 12 has had only a limited effect, throwing into doubt the rest of the plan that calls for talks between President Bashar al-Assad's government and those seeking to end his rule.",82,101,throwing into doubt,1,1,2
30U1YOGZGAXWT71EKWKOYF548WJDSN,"A ceasefire that was supposed to begin on April 12 has had only a limited effect, throwing into doubt the rest of the plan that calls for talks between President Bashar al-Assad's government and those seeking to end his rule.",162,178,Bashar al-Assads,1,0,1
30U1YOGZGAXWT71EKWKOYF548WJDSN,"A ceasefire that was supposed to begin on April 12 has had only a limited effect, throwing into doubt the rest of the plan that calls for talks between President Bashar al-Assad's government and those seeking to end his rule.",201,208,seeking,0,2,2
30U1YOGZGAXWT71EKWKOYF548WJDSN,Part of the plan includes the deployment in flashpoint areas of around 300 UN military observers.,30,40,deployment,9,8,17
30U1YOGZGAXWT71EKWKOYF548WJDSN,Part of the plan includes the deployment in flashpoint areas of around 300 UN military observers.,44,54,flashpoint,5,6,11
30U1YOGZGAXWT71EKWKOYF548WJDSN,Part of the plan includes the deployment in flashpoint areas of around 300 UN military observers.,44,60,flashpoint areas,6,4,10
30U1YOGZGAXWT71EKWKOYF548WJDSN,Part of the plan includes the deployment in flashpoint areas of around 300 UN military observers.,75,96,UN military observers,1,0,1
30U1YOGZGAXWT71EKWKOYF548WJDSN,Part of the plan includes the deployment in flashpoint areas of around 300 UN military observers.,78,96,military observers,1,0,1
30U1YOGZGAXWT71EKWKOYF548WJDSN,Part of the plan includes the deployment in flashpoint areas of around 300 UN military observers.,87,96,observers,1,1,2
30U1YOGZGAXWT71EKWKOYF548WJDSN,"By Sunday,189 observers were on the ground, and several more arrived on Monday.",14,23,observers,2,0,2
30U1YOGZGAXWT71EKWKOYF548WJDSN,"By Sunday,189 observers were on the ground, and several more arrived on Monday.",14,42,observers were on the ground,1,0,1
302OLP89DZ8IOJ96303MT9TG233ACI,I believe that ignoring public opinion discredits the authorities and destabilises the situation.,16,24,ignoring,3,4,7
302OLP89DZ8IOJ96303MT9TG233ACI,I believe that ignoring public opinion discredits the authorities and destabilises the situation.,25,39,public opinion,1,0,1
302OLP89DZ8IOJ96303MT9TG233ACI,I believe that ignoring public opinion discredits the authorities and destabilises the situation.,40,50,discredits,10,9,19
302OLP89DZ8IOJ96303MT9TG233ACI,I believe that ignoring public opinion discredits the authorities and destabilises the situation.,40,66,discredits the authorities,1,0,1
302OLP89DZ8IOJ96303MT9TG233ACI,I believe that ignoring public opinion discredits the authorities and destabilises the situation.,55,66,authorities,2,2,4
302OLP89DZ8IOJ96303MT9TG233ACI,I believe that ignoring public opinion discredits the authorities and destabilises the situation.,71,83,destabilises,10,9,19
302OLP89DZ8IOJ96303MT9TG233ACI,I believe that ignoring public opinion discredits the authorities and destabilises the situation.,71,97,destabilises the situation,2,0,2
302OLP89DZ8IOJ96303MT9TG233ACI,I believe that ignoring public opinion discredits the authorities and destabilises the situation.,88,97,situation,1,1,2
302OLP89DZ8IOJ96303MT9TG233ACI,"Gorbachev added that authorities ""must admit that there have been numerous falsifications and ballot stuffing"".",0,9,Gorbachev,0,1,1
302OLP89DZ8IOJ96303MT9TG233ACI,"Gorbachev added that authorities ""must admit that there have been numerous falsifications and ballot stuffing"".",66,74,numerous,1,1,2
302OLP89DZ8IOJ96303MT9TG233ACI,"Gorbachev added that authorities ""must admit that there have been numerous falsifications and ballot stuffing"".",66,89,numerous falsifications,2,2,4
302OLP89DZ8IOJ96303MT9TG233ACI,"Gorbachev added that authorities ""must admit that there have been numerous falsifications and ballot stuffing"".",66,109,numerous falsifications and ballot stuffing,1,0,1
302OLP89DZ8IOJ96303MT9TG233ACI,"Gorbachev added that authorities ""must admit that there have been numerous falsifications and ballot stuffing"".",75,89,falsifications,10,10,20
302OLP89DZ8IOJ96303MT9TG233ACI,"Gorbachev added that authorities ""must admit that there have been numerous falsifications and ballot stuffing"".",94,100,ballot,2,2,4
302OLP89DZ8IOJ96303MT9TG233ACI,"Gorbachev added that authorities ""must admit that there have been numerous falsifications and ballot stuffing"".",94,109,ballot stuffing,6,5,11
302OLP89DZ8IOJ96303MT9TG233ACI,"Gorbachev added that authorities ""must admit that there have been numerous falsifications and ballot stuffing"".",101,109,stuffing,1,4,5
302OLP89DZ8IOJ96303MT9TG233ACI,"Sunday's parliamentary vote suggested Russians are tiring of Putin and his United Russia party, which has dominated all other political forces in the country for a dozen years and earned a reputation for corruption.",9,22,parliamentary,4,3,7
302OLP89DZ8IOJ96303MT9TG233ACI,"Sunday's parliamentary vote suggested Russians are tiring of Putin and his United Russia party, which has dominated all other political forces in the country for a dozen years and earned a reputation for corruption.",9,27,parliamentary vote,1,0,1
302OLP89DZ8IOJ96303MT9TG233ACI,"Sunday's parliamentary vote suggested Russians are tiring of Putin and his United Russia party, which has dominated all other political forces in the country for a dozen years and earned a reputation for corruption.",51,57,tiring,0,3,3
302OLP89DZ8IOJ96303MT9TG233ACI,"Sunday's parliamentary vote suggested Russians are tiring of Putin and his United Russia party, which has dominated all other political forces in the country for a dozen years and earned a reputation for corruption.",51,60,tiring of,1,0,1
302OLP89DZ8IOJ96303MT9TG233ACI,"Sunday's parliamentary vote suggested Russians are tiring of Putin and his United Russia party, which has dominated all other political forces in the country for a dozen years and earned a reputation for corruption.",106,115,dominated,6,5,11
302OLP89DZ8IOJ96303MT9TG233ACI,"Sunday's parliamentary vote suggested Russians are tiring of Putin and his United Russia party, which has dominated all other political forces in the country for a dozen years and earned a reputation for corruption.",126,142,political forces,1,0,1
302OLP89DZ8IOJ96303MT9TG233ACI,"Sunday's parliamentary vote suggested Russians are tiring of Putin and his United Russia party, which has dominated all other political forces in the country for a dozen years and earned a reputation for corruption.",180,186,earned,0,1,1
302OLP89DZ8IOJ96303MT9TG233ACI,"Sunday's parliamentary vote suggested Russians are tiring of Putin and his United Russia party, which has dominated all other political forces in the country for a dozen years and earned a reputation for corruption.",189,199,reputation,2,3,5
302OLP89DZ8IOJ96303MT9TG233ACI,"Sunday's parliamentary vote suggested Russians are tiring of Putin and his United Russia party, which has dominated all other political forces in the country for a dozen years and earned a reputation for corruption.",189,214,reputation for corruption,1,0,1
302OLP89DZ8IOJ96303MT9TG233ACI,"Sunday's parliamentary vote suggested Russians are tiring of Putin and his United Russia party, which has dominated all other political forces in the country for a dozen years and earned a reputation for corruption.",204,214,corruption,7,6,13
302OLP89DZ8IOJ96303MT9TG233ACI,"Putin, meanwhile, officially registered on Wednesday to run for the presidency in March, but the unusually sustained protests of the past two days suggested his drive to retake the job he held from 2000-2008 may not go as smoothly as he had expected.",7,16,meanwhile,0,1,1
302OLP89DZ8IOJ96303MT9TG233ACI,"Putin, meanwhile, officially registered on Wednesday to run for the presidency in March, but the unusually sustained protests of the past two days suggested his drive to retake the job he held from 2000-2008 may not go as smoothly as he had expected.",29,39,registered,0,1,1
302OLP89DZ8IOJ96303MT9TG233ACI,"Putin, meanwhile, officially registered on Wednesday to run for the presidency in March, but the unusually sustained protests of the past two days suggested his drive to retake the job he held from 2000-2008 may not go as smoothly as he had expected.",97,106,unusually,1,0,1
302OLP89DZ8IOJ96303MT9TG233ACI,"Putin, meanwhile, officially registered on Wednesday to run for the presidency in March, but the unusually sustained protests of the past two days suggested his drive to retake the job he held from 2000-2008 may not go as smoothly as he had expected.",97,125,unusually sustained protests,1,0,1
302OLP89DZ8IOJ96303MT9TG233ACI,"Putin, meanwhile, officially registered on Wednesday to run for the presidency in March, but the unusually sustained protests of the past two days suggested his drive to retake the job he held from 2000-2008 may not go as smoothly as he had expected.",107,116,sustained,7,5,12
302OLP89DZ8IOJ96303MT9TG233ACI,"Putin, meanwhile, officially registered on Wednesday to run for the presidency in March, but the unusually sustained protests of the past two days suggested his drive to retake the job he held from 2000-2008 may not go as smoothly as he had expected.",107,125,sustained protests,0,1,1
302OLP89DZ8IOJ96303MT9TG233ACI,"Putin, meanwhile, officially registered on Wednesday to run for the presidency in March, but the unusually sustained protests of the past two days suggested his drive to retake the job he held from 2000-2008 may not go as smoothly as he had expected.",117,125,protests,0,2,2
302OLP89DZ8IOJ96303MT9TG233ACI,"Putin, meanwhile, officially registered on Wednesday to run for the presidency in March, but the unusually sustained protests of the past two days suggested his drive to retake the job he held from 2000-2008 may not go as smoothly as he had expected.",161,166,drive,1,0,1
302OLP89DZ8IOJ96303MT9TG233ACI,"Putin, meanwhile, officially registered on Wednesday to run for the presidency in March, but the unusually sustained protests of the past two days suggested his drive to retake the job he held from 2000-2008 may not go as smoothly as he had expected.",170,176,retake,1,2,3
302OLP89DZ8IOJ96303MT9TG233ACI,"Putin, meanwhile, officially registered on Wednesday to run for the presidency in March, but the unusually sustained protests of the past two days suggested his drive to retake the job he held from 2000-2008 may not go as smoothly as he had expected.",222,230,smoothly,0,3,3
302OLP89DZ8IOJ96303MT9TG233ACI,"More opposition rallies were expected, along with another new pro-Putin gathering in central Moscow.",5,15,opposition,1,0,1
302OLP89DZ8IOJ96303MT9TG233ACI,"More opposition rallies were expected, along with another new pro-Putin gathering in central Moscow.",5,23,opposition rallies,4,0,4
302OLP89DZ8IOJ96303MT9TG233ACI,"More opposition rallies were expected, along with another new pro-Putin gathering in central Moscow.",16,23,rallies,1,4,5
302OLP89DZ8IOJ96303MT9TG233ACI,"More opposition rallies were expected, along with another new pro-Putin gathering in central Moscow.",62,71,pro-Putin,2,0,2
302OLP89DZ8IOJ96303MT9TG233ACI,"More opposition rallies were expected, along with another new pro-Putin gathering in central Moscow.",62,81,pro-Putin gathering,1,0,1
302OLP89DZ8IOJ96303MT9TG233ACI,"More opposition rallies were expected, along with another new pro-Putin gathering in central Moscow.",72,81,gathering,0,2,2
302OLP89DZ8IOJ96303MT9TG233ACI,Ex-Soviet leader Mikhail Gorbachev says Russian authorities must annul the parliamentary vote results and hold a new election.,25,34,Gorbachev,0,1,1
302OLP89DZ8IOJ96303MT9TG233ACI,Ex-Soviet leader Mikhail Gorbachev says Russian authorities must annul the parliamentary vote results and hold a new election.,48,59,authorities,1,2,3
302OLP89DZ8IOJ96303MT9TG233ACI,Ex-Soviet leader Mikhail Gorbachev says Russian authorities must annul the parliamentary vote results and hold a new election.,60,93,must annul the parliamentary vote,1,0,1
302OLP89DZ8IOJ96303MT9TG233ACI,Ex-Soviet leader Mikhail Gorbachev says Russian authorities must annul the parliamentary vote results and hold a new election.,65,70,annul,6,5,11
302OLP89DZ8IOJ96303MT9TG233ACI,Ex-Soviet leader Mikhail Gorbachev says Russian authorities must annul the parliamentary vote results and hold a new election.,75,88,parliamentary,3,1,4
302OLP89DZ8IOJ96303MT9TG233ACI,Ex-Soviet leader Mikhail Gorbachev says Russian authorities must annul the parliamentary vote results and hold a new election.,75,101,parliamentary vote results,1,0,1
302OLP89DZ8IOJ96303MT9TG233ACI,Ex-Soviet leader Mikhail Gorbachev says Russian authorities must annul the parliamentary vote results and hold a new election.,117,125,election,1,0,1
3R0WOCG21MAC8KTI91FODGNSTT4DU3,"More than 12,000 people, the majority of them civilians, have died since the Syrian uprising began in March 2011, according to the watchdog, including more than 900 killed since the April 12 truce.",29,37,majority,0,2,2
3R0WOCG21MAC8KTI91FODGNSTT4DU3,"More than 12,000 people, the majority of them civilians, have died since the Syrian uprising began in March 2011, according to the watchdog, including more than 900 killed since the April 12 truce.",46,55,civilians,5,2,7
3R0WOCG21MAC8KTI91FODGNSTT4DU3,"More than 12,000 people, the majority of them civilians, have died since the Syrian uprising began in March 2011, according to the watchdog, including more than 900 killed since the April 12 truce.",77,92,Syrian uprising,1,0,1
3R0WOCG21MAC8KTI91FODGNSTT4DU3,"More than 12,000 people, the majority of them civilians, have died since the Syrian uprising began in March 2011, according to the watchdog, including more than 900 killed since the April 12 truce.",84,92,uprising,7,3,10
3R0WOCG21MAC8KTI91FODGNSTT4DU3,"More than 12,000 people, the majority of them civilians, have died since the Syrian uprising began in March 2011, according to the watchdog, including more than 900 killed since the April 12 truce.",114,123,according,0,1,1
3R0WOCG21MAC8KTI91FODGNSTT4DU3,"More than 12,000 people, the majority of them civilians, have died since the Syrian uprising began in March 2011, according to the watchdog, including more than 900 killed since the April 12 truce.",131,139,watchdog,9,8,17
3R0WOCG21MAC8KTI91FODGNSTT4DU3,"More than 12,000 people, the majority of them civilians, have died since the Syrian uprising began in March 2011, according to the watchdog, including more than 900 killed since the April 12 truce.",141,150,including,0,1,1
3R0WOCG21MAC8KTI91FODGNSTT4DU3,"More than 12,000 people, the majority of them civilians, have died since the Syrian uprising began in March 2011, according to the watchdog, including more than 900 killed since the April 12 truce.",191,196,truce,1,3,4
3R0WOCG21MAC8KTI91FODGNSTT4DU3,Spanish banks will be forced to set aside extra funds as part of drastic reforms announced by the government to protect the fragile economy.,36,41,aside,0,2,2
3R0WOCG21MAC8KTI91FODGNSTT4DU3,Spanish banks will be forced to set aside extra funds as part of drastic reforms announced by the government to protect the fragile economy.,65,72,drastic,3,4,7
3R0WOCG21MAC8KTI91FODGNSTT4DU3,Spanish banks will be forced to set aside extra funds as part of drastic reforms announced by the government to protect the fragile economy.,65,80,drastic reforms,6,2,8
3R0WOCG21MAC8KTI91FODGNSTT4DU3,Spanish banks will be forced to set aside extra funds as part of drastic reforms announced by the government to protect the fragile economy.,73,80,reforms,1,2,3
3R0WOCG21MAC8KTI91FODGNSTT4DU3,Spanish banks will be forced to set aside extra funds as part of drastic reforms announced by the government to protect the fragile economy.,81,90,announced,1,2,3
3R0WOCG21MAC8KTI91FODGNSTT4DU3,Spanish banks will be forced to set aside extra funds as part of drastic reforms announced by the government to protect the fragile economy.,98,108,government,1,0,1
3R0WOCG21MAC8KTI91FODGNSTT4DU3,Spanish banks will be forced to set aside extra funds as part of drastic reforms announced by the government to protect the fragile economy.,124,131,fragile,6,6,12
3R0WOCG21MAC8KTI91FODGNSTT4DU3,Spanish banks will be forced to set aside extra funds as part of drastic reforms announced by the government to protect the fragile economy.,124,139,fragile economy,5,2,7
3R0WOCG21MAC8KTI91FODGNSTT4DU3,Banks will need to increase their cover on sound property loans from 7% to 30% and separate real estate assets from their balance sheets.,19,27,increase,0,1,1
3R0WOCG21MAC8KTI91FODGNSTT4DU3,Banks will need to increase their cover on sound property loans from 7% to 30% and separate real estate assets from their balance sheets.,43,63,sound property loans,3,1,4
3R0WOCG21MAC8KTI91FODGNSTT4DU3,Banks will need to increase their cover on sound property loans from 7% to 30% and separate real estate assets from their balance sheets.,83,91,separate,0,1,1
3R0WOCG21MAC8KTI91FODGNSTT4DU3,Banks will need to increase their cover on sound property loans from 7% to 30% and separate real estate assets from their balance sheets.,92,110,real estate assets,2,1,3
3R0WOCG21MAC8KTI91FODGNSTT4DU3,Banks will need to increase their cover on sound property loans from 7% to 30% and separate real estate assets from their balance sheets.,104,110,assets,3,2,5
3R0WOCG21MAC8KTI91FODGNSTT4DU3,Banks will need to increase their cover on sound property loans from 7% to 30% and separate real estate assets from their balance sheets.,122,136,balance sheets,4,1,5
3R0WOCG21MAC8KTI91FODGNSTT4DU3,"It is the second banking reform passed by the country's conservative government since it came into power in December, and comes just days after it was forced to part-nationalise Bankia, the country's fourth-largest bank due to the effect of the bursting of the property bubble.",17,31,banking reform,2,0,2
3R0WOCG21MAC8KTI91FODGNSTT4DU3,"It is the second banking reform passed by the country's conservative government since it came into power in December, and comes just days after it was forced to part-nationalise Bankia, the country's fourth-largest bank due to the effect of the bursting of the property bubble.",25,31,reform,1,2,3
3R0WOCG21MAC8KTI91FODGNSTT4DU3,"It is the second banking reform passed by the country's conservative government since it came into power in December, and comes just days after it was forced to part-nationalise Bankia, the country's fourth-largest bank due to the effect of the bursting of the property bubble.",56,68,conservative,8,3,11
3R0WOCG21MAC8KTI91FODGNSTT4DU3,"It is the second banking reform passed by the country's conservative government since it came into power in December, and comes just days after it was forced to part-nationalise Bankia, the country's fourth-largest bank due to the effect of the bursting of the property bubble.",56,79,conservative government,0,1,1
3R0WOCG21MAC8KTI91FODGNSTT4DU3,"It is the second banking reform passed by the country's conservative government since it came into power in December, and comes just days after it was forced to part-nationalise Bankia, the country's fourth-largest bank due to the effect of the bursting of the property bubble.",161,177,part-nationalise,10,3,13
3R0WOCG21MAC8KTI91FODGNSTT4DU3,"It is the second banking reform passed by the country's conservative government since it came into power in December, and comes just days after it was forced to part-nationalise Bankia, the country's fourth-largest bank due to the effect of the bursting of the property bubble.",161,184,part-nationalise Bankia,1,1,2
3R0WOCG21MAC8KTI91FODGNSTT4DU3,"It is the second banking reform passed by the country's conservative government since it came into power in December, and comes just days after it was forced to part-nationalise Bankia, the country's fourth-largest bank due to the effect of the bursting of the property bubble.",245,253,bursting,4,8,12
3R0WOCG21MAC8KTI91FODGNSTT4DU3,"It is the second banking reform passed by the country's conservative government since it came into power in December, and comes just days after it was forced to part-nationalise Bankia, the country's fourth-largest bank due to the effect of the bursting of the property bubble.",261,276,property bubble,6,4,10
3R0WOCG21MAC8KTI91FODGNSTT4DU3,"It is the second banking reform passed by the country's conservative government since it came into power in December, and comes just days after it was forced to part-nationalise Bankia, the country's fourth-largest bank due to the effect of the bursting of the property bubble.",270,276,bubble,0,2,2
33NKDW9FFXJUKWHZEAV0DH4E3OCCXO,"It has been an ongoing problem on our street with them, Hudson said.",13,31,an ongoing problem,1,0,1
33NKDW9FFXJUKWHZEAV0DH4E3OCCXO,"It has been an ongoing problem on our street with them, Hudson said.",16,23,ongoing,7,4,11
33NKDW9FFXJUKWHZEAV0DH4E3OCCXO,"It has been an ongoing problem on our street with them, Hudson said.",16,31,ongoing problem,0,3,3
33NKDW9FFXJUKWHZEAV0DH4E3OCCXO,Goodyear said Jaxs Johnson had recently been arrested on a domestic violence charge.,31,39,recently,0,1,1
33NKDW9FFXJUKWHZEAV0DH4E3OCCXO,Goodyear said Jaxs Johnson had recently been arrested on a domestic violence charge.,45,53,arrested,1,1,2
33NKDW9FFXJUKWHZEAV0DH4E3OCCXO,Goodyear said Jaxs Johnson had recently been arrested on a domestic violence charge.,59,67,domestic,3,1,4
33NKDW9FFXJUKWHZEAV0DH4E3OCCXO,Goodyear said Jaxs Johnson had recently been arrested on a domestic violence charge.,59,76,domestic violence,1,7,8
33NKDW9FFXJUKWHZEAV0DH4E3OCCXO,Goodyear said Jaxs Johnson had recently been arrested on a domestic violence charge.,59,83,domestic violence charge,5,1,6
33NKDW9FFXJUKWHZEAV0DH4E3OCCXO,Goodyear said Jaxs Johnson had recently been arrested on a domestic violence charge.,68,76,violence,0,2,2
33NKDW9FFXJUKWHZEAV0DH4E3OCCXO,Goodyear said Jaxs Johnson had recently been arrested on a domestic violence charge.,77,83,charge,0,1,1
33NKDW9FFXJUKWHZEAV0DH4E3OCCXO,He said he didn't know if the boy had been accused of hitting his mother or causing damage at the house.,43,50,accused,7,5,12
33NKDW9FFXJUKWHZEAV0DH4E3OCCXO,He said he didn't know if the boy had been accused of hitting his mother or causing damage at the house.,43,53,accused of,0,1,1
33NKDW9FFXJUKWHZEAV0DH4E3OCCXO,He said he didn't know if the boy had been accused of hitting his mother or causing damage at the house.,84,90,damage,0,2,2
33NKDW9FFXJUKWHZEAV0DH4E3OCCXO,"A pastor at the church the family attended described it as ""normal stuff.""",2,8,pastor,3,1,4
33NKDW9FFXJUKWHZEAV0DH4E3OCCXO,"A pastor at the church the family attended described it as ""normal stuff.""",34,42,attended,0,2,2
33NKDW9FFXJUKWHZEAV0DH4E3OCCXO,"A pastor at the church the family attended described it as ""normal stuff.""",43,52,described,2,1,3
33NKDW9FFXJUKWHZEAV0DH4E3OCCXO,"A pastor at the church the family attended described it as ""normal stuff.""",60,72,normal stuff,0,5,5
33NKDW9FFXJUKWHZEAV0DH4E3OCCXO,"A pastor at the church the family attended described it as ""normal stuff.""",67,72,stuff,0,2,2
33NKDW9FFXJUKWHZEAV0DH4E3OCCXO,"I think he was punching some walls or something, said Jarvis Wash, pastor of the Real Church in Rockledge, Fla.",16,24,punching,2,7,9
33NKDW9FFXJUKWHZEAV0DH4E3OCCXO,"I think he was punching some walls or something, said Jarvis Wash, pastor of the Real Church in Rockledge, Fla.",16,35,punching some walls,0,1,1
33NKDW9FFXJUKWHZEAV0DH4E3OCCXO,"I think he was punching some walls or something, said Jarvis Wash, pastor of the Real Church in Rockledge, Fla.",98,107,Rockledge,1,0,1
33NKDW9FFXJUKWHZEAV0DH4E3OCCXO,"I think he was punching some walls or something, said Jarvis Wash, pastor of the Real Church in Rockledge, Fla.",109,112,Fla,1,0,1
33NKDW9FFXJUKWHZEAV0DH4E3OCCXO,Wash said the family attended services last Sunday but had been absent for a few weeks before that.,21,29,attended,0,2,2
33NKDW9FFXJUKWHZEAV0DH4E3OCCXO,Wash said the family attended services last Sunday but had been absent for a few weeks before that.,21,38,attended services,2,1,3
33NKDW9FFXJUKWHZEAV0DH4E3OCCXO,Wash said the family attended services last Sunday but had been absent for a few weeks before that.,30,38,services,1,0,1
33NKDW9FFXJUKWHZEAV0DH4E3OCCXO,Wash said the family attended services last Sunday but had been absent for a few weeks before that.,55,70,had been absent,0,1,1
33NKDW9FFXJUKWHZEAV0DH4E3OCCXO,Wash said the family attended services last Sunday but had been absent for a few weeks before that.,64,70,absent,4,1,5
33NKDW9FFXJUKWHZEAV0DH4E3OCCXO,"I don't know what could have happened in the past couple of days, Wash said.",30,38,happened,1,1,2
33NKDW9FFXJUKWHZEAV0DH4E3OCCXO,"I don't know what could have happened in the past couple of days, Wash said.",46,65,past couple of days,0,1,1
33NKDW9FFXJUKWHZEAV0DH4E3OCCXO,It's a tragedy to the church and the community.,8,15,tragedy,10,10,20
33NKDW9FFXJUKWHZEAV0DH4E3OCCXO,It's a tragedy to the church and the community.,38,47,community,1,1,2
3WA2XVDZEMIWYFHH9ES53SRXQJN6EN,Guindos said the European Commission report failed to take account of all austerity measures.,0,7,Guindos,1,0,1
3WA2XVDZEMIWYFHH9ES53SRXQJN6EN,Guindos said the European Commission report failed to take account of all austerity measures.,17,36,European Commission,2,0,2
3WA2XVDZEMIWYFHH9ES53SRXQJN6EN,Guindos said the European Commission report failed to take account of all austerity measures.,26,36,Commission,2,0,2
3WA2XVDZEMIWYFHH9ES53SRXQJN6EN,Guindos said the European Commission report failed to take account of all austerity measures.,54,66,take account,1,0,1
3WA2XVDZEMIWYFHH9ES53SRXQJN6EN,Guindos said the European Commission report failed to take account of all austerity measures.,74,83,austerity,10,7,17
3WA2XVDZEMIWYFHH9ES53SRXQJN6EN,Guindos said the European Commission report failed to take account of all austerity measures.,74,92,austerity measures,5,3,8
3WA2XVDZEMIWYFHH9ES53SRXQJN6EN,"Al Jazeera's Sonia Gallego, reporting from Madrid, said ""with the gravity of the economic situation [in Spain], it is getting increasingly difficult"" for the government to refinance as much of the debt as it can.",66,73,gravity,9,2,11
3WA2XVDZEMIWYFHH9ES53SRXQJN6EN,"Al Jazeera's Sonia Gallego, reporting from Madrid, said ""with the gravity of the economic situation [in Spain], it is getting increasingly difficult"" for the government to refinance as much of the debt as it can.",66,99,gravity of the economic situation,1,1,2
3WA2XVDZEMIWYFHH9ES53SRXQJN6EN,"Al Jazeera's Sonia Gallego, reporting from Madrid, said ""with the gravity of the economic situation [in Spain], it is getting increasingly difficult"" for the government to refinance as much of the debt as it can.",81,89,economic,1,0,1
3WA2XVDZEMIWYFHH9ES53SRXQJN6EN,"Al Jazeera's Sonia Gallego, reporting from Madrid, said ""with the gravity of the economic situation [in Spain], it is getting increasingly difficult"" for the government to refinance as much of the debt as it can.",81,99,economic situation,2,0,2
3WA2XVDZEMIWYFHH9ES53SRXQJN6EN,"Al Jazeera's Sonia Gallego, reporting from Madrid, said ""with the gravity of the economic situation [in Spain], it is getting increasingly difficult"" for the government to refinance as much of the debt as it can.",90,99,situation,0,1,1
3WA2XVDZEMIWYFHH9ES53SRXQJN6EN,"Al Jazeera's Sonia Gallego, reporting from Madrid, said ""with the gravity of the economic situation [in Spain], it is getting increasingly difficult"" for the government to refinance as much of the debt as it can.",126,138,increasingly,1,0,1
3WA2XVDZEMIWYFHH9ES53SRXQJN6EN,"Al Jazeera's Sonia Gallego, reporting from Madrid, said ""with the gravity of the economic situation [in Spain], it is getting increasingly difficult"" for the government to refinance as much of the debt as it can.",126,148,increasingly difficult,0,1,1
3WA2XVDZEMIWYFHH9ES53SRXQJN6EN,"Al Jazeera's Sonia Gallego, reporting from Madrid, said ""with the gravity of the economic situation [in Spain], it is getting increasingly difficult"" for the government to refinance as much of the debt as it can.",158,168,government,1,0,1
3WA2XVDZEMIWYFHH9ES53SRXQJN6EN,"Al Jazeera's Sonia Gallego, reporting from Madrid, said ""with the gravity of the economic situation [in Spain], it is getting increasingly difficult"" for the government to refinance as much of the debt as it can.",172,181,refinance,9,7,16
3WA2XVDZEMIWYFHH9ES53SRXQJN6EN,"Spain's banks were hit by billions of euros of losses after a decade-long property bubble burst in 2008 and concerns about them, and the country's overspending regional governments have fanned fears of a new eurozone debt crisis.",19,22,hit,1,0,1
3WA2XVDZEMIWYFHH9ES53SRXQJN6EN,"Spain's banks were hit by billions of euros of losses after a decade-long property bubble burst in 2008 and concerns about them, and the country's overspending regional governments have fanned fears of a new eurozone debt crisis.",38,43,euros,2,0,2
3WA2XVDZEMIWYFHH9ES53SRXQJN6EN,"Spain's banks were hit by billions of euros of losses after a decade-long property bubble burst in 2008 and concerns about them, and the country's overspending regional governments have fanned fears of a new eurozone debt crisis.",62,73,decade-long,1,4,5
3WA2XVDZEMIWYFHH9ES53SRXQJN6EN,"Spain's banks were hit by billions of euros of losses after a decade-long property bubble burst in 2008 and concerns about them, and the country's overspending regional governments have fanned fears of a new eurozone debt crisis.",62,89,decade-long property bubble,0,2,2
3WA2XVDZEMIWYFHH9ES53SRXQJN6EN,"Spain's banks were hit by billions of euros of losses after a decade-long property bubble burst in 2008 and concerns about them, and the country's overspending regional governments have fanned fears of a new eurozone debt crisis.",74,89,property bubble,4,1,5
3WA2XVDZEMIWYFHH9ES53SRXQJN6EN,"Spain's banks were hit by billions of euros of losses after a decade-long property bubble burst in 2008 and concerns about them, and the country's overspending regional governments have fanned fears of a new eurozone debt crisis.",74,95,property bubble burst,2,1,3
3WA2XVDZEMIWYFHH9ES53SRXQJN6EN,"Spain's banks were hit by billions of euros of losses after a decade-long property bubble burst in 2008 and concerns about them, and the country's overspending regional governments have fanned fears of a new eurozone debt crisis.",83,89,bubble,1,0,1
3WA2XVDZEMIWYFHH9ES53SRXQJN6EN,"Spain's banks were hit by billions of euros of losses after a decade-long property bubble burst in 2008 and concerns about them, and the country's overspending regional governments have fanned fears of a new eurozone debt crisis.",83,95,bubble burst,2,2,4
3WA2XVDZEMIWYFHH9ES53SRXQJN6EN,"Spain's banks were hit by billions of euros of losses after a decade-long property bubble burst in 2008 and concerns about them, and the country's overspending regional governments have fanned fears of a new eurozone debt crisis.",90,95,burst,0,2,2
3WA2XVDZEMIWYFHH9ES53SRXQJN6EN,"Spain's banks were hit by billions of euros of losses after a decade-long property bubble burst in 2008 and concerns about them, and the country's overspending regional governments have fanned fears of a new eurozone debt crisis.",108,116,concerns,1,1,2
3WA2XVDZEMIWYFHH9ES53SRXQJN6EN,"Spain's banks were hit by billions of euros of losses after a decade-long property bubble burst in 2008 and concerns about them, and the country's overspending regional governments have fanned fears of a new eurozone debt crisis.",147,159,overspending,2,6,8
3WA2XVDZEMIWYFHH9ES53SRXQJN6EN,"Spain's banks were hit by billions of euros of losses after a decade-long property bubble burst in 2008 and concerns about them, and the country's overspending regional governments have fanned fears of a new eurozone debt crisis.",160,168,regional,1,0,1
3WA2XVDZEMIWYFHH9ES53SRXQJN6EN,"Spain's banks were hit by billions of euros of losses after a decade-long property bubble burst in 2008 and concerns about them, and the country's overspending regional governments have fanned fears of a new eurozone debt crisis.",186,192,fanned,5,9,14
3WA2XVDZEMIWYFHH9ES53SRXQJN6EN,"Spain's banks were hit by billions of euros of losses after a decade-long property bubble burst in 2008 and concerns about them, and the country's overspending regional governments have fanned fears of a new eurozone debt crisis.",186,198,fanned fears,0,1,1
3WA2XVDZEMIWYFHH9ES53SRXQJN6EN,"Spain's banks were hit by billions of euros of losses after a decade-long property bubble burst in 2008 and concerns about them, and the country's overspending regional governments have fanned fears of a new eurozone debt crisis.",208,216,eurozone,5,0,5
3WA2XVDZEMIWYFHH9ES53SRXQJN6EN,"Spain's banks were hit by billions of euros of losses after a decade-long property bubble burst in 2008 and concerns about them, and the country's overspending regional governments have fanned fears of a new eurozone debt crisis.",208,228,eurozone debt crisis,1,1,2
3WA2XVDZEMIWYFHH9ES53SRXQJN6EN,"Spain's banks were hit by billions of euros of losses after a decade-long property bubble burst in 2008 and concerns about them, and the country's overspending regional governments have fanned fears of a new eurozone debt crisis.",217,228,debt crisis,2,0,2
3WA2XVDZEMIWYFHH9ES53SRXQJN6EN,"Spain's banks were hit by billions of euros of losses after a decade-long property bubble burst in 2008 and concerns about them, and the country's overspending regional governments have fanned fears of a new eurozone debt crisis.",222,228,crisis,1,1,2
3WA2XVDZEMIWYFHH9ES53SRXQJN6EN,"Toxic assets now total 184bn euros, but many fear the hole is even bigger.",0,5,Toxic,1,2,3
3WA2XVDZEMIWYFHH9ES53SRXQJN6EN,"Toxic assets now total 184bn euros, but many fear the hole is even bigger.",0,12,Toxic assets,6,7,13
3WA2XVDZEMIWYFHH9ES53SRXQJN6EN,"Toxic assets now total 184bn euros, but many fear the hole is even bigger.",6,12,assets,1,2,3
3WA2XVDZEMIWYFHH9ES53SRXQJN6EN,"Toxic assets now total 184bn euros, but many fear the hole is even bigger.",45,58,fear the hole,0,1,1
3WA2XVDZEMIWYFHH9ES53SRXQJN6EN,"Toxic assets now total 184bn euros, but many fear the hole is even bigger.",54,58,hole,0,1,1
3WA2XVDZEMIWYFHH9ES53SRXQJN6EN,Successive waves of bank sector clean-ups have failed to convince investors.,0,10,Successive,6,3,9
3WA2XVDZEMIWYFHH9ES53SRXQJN6EN,Successive waves of bank sector clean-ups have failed to convince investors.,0,16,Successive waves,2,3,5
3WA2XVDZEMIWYFHH9ES53SRXQJN6EN,Successive waves of bank sector clean-ups have failed to convince investors.,25,31,sector,2,0,2
3WA2XVDZEMIWYFHH9ES53SRXQJN6EN,Successive waves of bank sector clean-ups have failed to convince investors.,32,41,clean-ups,1,5,6
3WA2XVDZEMIWYFHH9ES53SRXQJN6EN,Successive waves of bank sector clean-ups have failed to convince investors.,57,65,convince,1,2,3
3WA2XVDZEMIWYFHH9ES53SRXQJN6EN,Successive waves of bank sector clean-ups have failed to convince investors.,66,75,investors,1,0,1
3WA2XVDZEMIWYFHH9ES53SRXQJN6EN,Our correspondent said that the toxic assets were a result of the property bubble.,4,17,correspondent,4,1,5
3WA2XVDZEMIWYFHH9ES53SRXQJN6EN,Our correspondent said that the toxic assets were a result of the property bubble.,32,44,toxic assets,5,1,6
3WA2XVDZEMIWYFHH9ES53SRXQJN6EN,Our correspondent said that the toxic assets were a result of the property bubble.,38,44,assets,1,0,1
3WA2XVDZEMIWYFHH9ES53SRXQJN6EN,Our correspondent said that the toxic assets were a result of the property bubble.,66,81,property bubble,6,1,7
3BDORL6HKKEAN0VN5BP8OZIQ163CR1,Republicans warily saluted Obama's war-zone trip but accused him of craven politics nonetheless.,0,26,Republicans warily saluted,0,1,1
3BDORL6HKKEAN0VN5BP8OZIQ163CR1,Republicans warily saluted Obama's war-zone trip but accused him of craven politics nonetheless.,12,18,warily,10,10,20
3BDORL6HKKEAN0VN5BP8OZIQ163CR1,Republicans warily saluted Obama's war-zone trip but accused him of craven politics nonetheless.,12,26,warily saluted,1,0,1
3BDORL6HKKEAN0VN5BP8OZIQ163CR1,Republicans warily saluted Obama's war-zone trip but accused him of craven politics nonetheless.,19,26,saluted,2,0,2
3BDORL6HKKEAN0VN5BP8OZIQ163CR1,Republicans warily saluted Obama's war-zone trip but accused him of craven politics nonetheless.,35,43,war-zone,0,1,1
3BDORL6HKKEAN0VN5BP8OZIQ163CR1,Republicans warily saluted Obama's war-zone trip but accused him of craven politics nonetheless.,35,48,war-zone trip,0,1,1
3BDORL6HKKEAN0VN5BP8OZIQ163CR1,Republicans warily saluted Obama's war-zone trip but accused him of craven politics nonetheless.,53,60,accused,0,5,5
3BDORL6HKKEAN0VN5BP8OZIQ163CR1,Republicans warily saluted Obama's war-zone trip but accused him of craven politics nonetheless.,68,74,craven,10,9,19
3BDORL6HKKEAN0VN5BP8OZIQ163CR1,Republicans warily saluted Obama's war-zone trip but accused him of craven politics nonetheless.,68,83,craven politics,1,2,3
3BDORL6HKKEAN0VN5BP8OZIQ163CR1,Republicans warily saluted Obama's war-zone trip but accused him of craven politics nonetheless.,84,95,nonetheless,5,8,13
3BDORL6HKKEAN0VN5BP8OZIQ163CR1,"Clearly this trip is campaign-related, said Sen. Jim Inhofe, a senior member of the Senate Armed Services Committee.",22,38,campaign-related,4,4,8
3BDORL6HKKEAN0VN5BP8OZIQ163CR1,"This trip to Afghanistan is an attempt to shore up his national security credentials, because he has spent the past three years gutting our military, a reference to tightening defense budgets.",32,39,attempt,0,1,1
3BDORL6HKKEAN0VN5BP8OZIQ163CR1,"This trip to Afghanistan is an attempt to shore up his national security credentials, because he has spent the past three years gutting our military, a reference to tightening defense budgets.",32,51,attempt to shore up,1,0,1
3BDORL6HKKEAN0VN5BP8OZIQ163CR1,"This trip to Afghanistan is an attempt to shore up his national security credentials, because he has spent the past three years gutting our military, a reference to tightening defense budgets.",40,51,to shore up,1,0,1
3BDORL6HKKEAN0VN5BP8OZIQ163CR1,"This trip to Afghanistan is an attempt to shore up his national security credentials, because he has spent the past three years gutting our military, a reference to tightening defense budgets.",43,48,shore,0,2,2
3BDORL6HKKEAN0VN5BP8OZIQ163CR1,"This trip to Afghanistan is an attempt to shore up his national security credentials, because he has spent the past three years gutting our military, a reference to tightening defense budgets.",43,51,shore up,7,3,10
3BDORL6HKKEAN0VN5BP8OZIQ163CR1,"This trip to Afghanistan is an attempt to shore up his national security credentials, because he has spent the past three years gutting our military, a reference to tightening defense budgets.",56,85,national security credentials,2,1,3
3BDORL6HKKEAN0VN5BP8OZIQ163CR1,"This trip to Afghanistan is an attempt to shore up his national security credentials, because he has spent the past three years gutting our military, a reference to tightening defense budgets.",65,85,security credentials,1,0,1
3BDORL6HKKEAN0VN5BP8OZIQ163CR1,"This trip to Afghanistan is an attempt to shore up his national security credentials, because he has spent the past three years gutting our military, a reference to tightening defense budgets.",74,85,credentials,7,5,12
3BDORL6HKKEAN0VN5BP8OZIQ163CR1,"This trip to Afghanistan is an attempt to shore up his national security credentials, because he has spent the past three years gutting our military, a reference to tightening defense budgets.",129,136,gutting,8,7,15
3BDORL6HKKEAN0VN5BP8OZIQ163CR1,"This trip to Afghanistan is an attempt to shore up his national security credentials, because he has spent the past three years gutting our military, a reference to tightening defense budgets.",129,149,gutting our military,1,1,2
3BDORL6HKKEAN0VN5BP8OZIQ163CR1,"This trip to Afghanistan is an attempt to shore up his national security credentials, because he has spent the past three years gutting our military, a reference to tightening defense budgets.",167,177,tightening,1,3,4
3BDORL6HKKEAN0VN5BP8OZIQ163CR1,"This trip to Afghanistan is an attempt to shore up his national security credentials, because he has spent the past three years gutting our military, a reference to tightening defense budgets.",167,193,tightening defense budgets,1,1,2
3BDORL6HKKEAN0VN5BP8OZIQ163CR1,"This trip to Afghanistan is an attempt to shore up his national security credentials, because he has spent the past three years gutting our military, a reference to tightening defense budgets.",178,193,defense budgets,1,0,1
3BDORL6HKKEAN0VN5BP8OZIQ163CR1,"Obama's presumed Republican opponent, Mitt Romney, was in New York accusing the president of politicizing the fleeting unity that came with bin Laden's death.",8,16,presumed,3,5,8
3BDORL6HKKEAN0VN5BP8OZIQ163CR1,"Obama's presumed Republican opponent, Mitt Romney, was in New York accusing the president of politicizing the fleeting unity that came with bin Laden's death.",28,36,opponent,2,0,2
3BDORL6HKKEAN0VN5BP8OZIQ163CR1,"Obama's presumed Republican opponent, Mitt Romney, was in New York accusing the president of politicizing the fleeting unity that came with bin Laden's death.",93,105,politicizing,7,2,9
3BDORL6HKKEAN0VN5BP8OZIQ163CR1,"Obama's presumed Republican opponent, Mitt Romney, was in New York accusing the president of politicizing the fleeting unity that came with bin Laden's death.",93,124,politicizing the fleeting unity,1,1,2
3BDORL6HKKEAN0VN5BP8OZIQ163CR1,"Obama's presumed Republican opponent, Mitt Romney, was in New York accusing the president of politicizing the fleeting unity that came with bin Laden's death.",110,118,fleeting,9,4,13
3BDORL6HKKEAN0VN5BP8OZIQ163CR1,"Obama's presumed Republican opponent, Mitt Romney, was in New York accusing the president of politicizing the fleeting unity that came with bin Laden's death.",110,124,fleeting unity,3,4,7
3BDORL6HKKEAN0VN5BP8OZIQ163CR1,"Stephen Biddle, a defense analyst at the Council on Foreign Relations, said Obama will be hard pressed to convince Afghans or Pakistanis that the United States will remain an effective security partner once most U.S. troops have gone home.",18,33,defense analyst,3,0,3
3BDORL6HKKEAN0VN5BP8OZIQ163CR1,"Stephen Biddle, a defense analyst at the Council on Foreign Relations, said Obama will be hard pressed to convince Afghans or Pakistanis that the United States will remain an effective security partner once most U.S. troops have gone home.",26,33,analyst,2,1,3
3BDORL6HKKEAN0VN5BP8OZIQ163CR1,"Stephen Biddle, a defense analyst at the Council on Foreign Relations, said Obama will be hard pressed to convince Afghans or Pakistanis that the United States will remain an effective security partner once most U.S. troops have gone home.",41,69,Council on Foreign Relations,1,0,1
3BDORL6HKKEAN0VN5BP8OZIQ163CR1,"Stephen Biddle, a defense analyst at the Council on Foreign Relations, said Obama will be hard pressed to convince Afghans or Pakistanis that the United States will remain an effective security partner once most U.S. troops have gone home.",76,114,Obama will be hard pressed to convince,1,0,1
3BDORL6HKKEAN0VN5BP8OZIQ163CR1,"Stephen Biddle, a defense analyst at the Council on Foreign Relations, said Obama will be hard pressed to convince Afghans or Pakistanis that the United States will remain an effective security partner once most U.S. troops have gone home.",90,102,hard pressed,9,1,10
3BDORL6HKKEAN0VN5BP8OZIQ163CR1,"Stephen Biddle, a defense analyst at the Council on Foreign Relations, said Obama will be hard pressed to convince Afghans or Pakistanis that the United States will remain an effective security partner once most U.S. troops have gone home.",106,114,convince,0,1,1
3BDORL6HKKEAN0VN5BP8OZIQ163CR1,"Stephen Biddle, a defense analyst at the Council on Foreign Relations, said Obama will be hard pressed to convince Afghans or Pakistanis that the United States will remain an effective security partner once most U.S. troops have gone home.",175,184,effective,1,0,1
3BDORL6HKKEAN0VN5BP8OZIQ163CR1,"Stephen Biddle, a defense analyst at the Council on Foreign Relations, said Obama will be hard pressed to convince Afghans or Pakistanis that the United States will remain an effective security partner once most U.S. troops have gone home.",185,201,security partner,2,0,2
3Z8UJEJOCZEG603II1EL4BE2PV593A,"Syrian troops shelled a rebel-held town on Monday, sparking intense clashes that sent bloodied victims flooding into hospitals and clinics, activists said.",7,13,troops,0,1,1
3Z8UJEJOCZEG603II1EL4BE2PV593A,"Syrian troops shelled a rebel-held town on Monday, sparking intense clashes that sent bloodied victims flooding into hospitals and clinics, activists said.",14,21,shelled,7,10,17
3Z8UJEJOCZEG603II1EL4BE2PV593A,"Syrian troops shelled a rebel-held town on Monday, sparking intense clashes that sent bloodied victims flooding into hospitals and clinics, activists said.",24,34,rebel-held,5,5,10
3Z8UJEJOCZEG603II1EL4BE2PV593A,"Syrian troops shelled a rebel-held town on Monday, sparking intense clashes that sent bloodied victims flooding into hospitals and clinics, activists said.",51,59,sparking,6,5,11
3Z8UJEJOCZEG603II1EL4BE2PV593A,"Syrian troops shelled a rebel-held town on Monday, sparking intense clashes that sent bloodied victims flooding into hospitals and clinics, activists said.",51,67,sparking intense,0,1,1
3Z8UJEJOCZEG603II1EL4BE2PV593A,"Syrian troops shelled a rebel-held town on Monday, sparking intense clashes that sent bloodied victims flooding into hospitals and clinics, activists said.",51,75,sparking intense clashes,1,2,3
3Z8UJEJOCZEG603II1EL4BE2PV593A,"Syrian troops shelled a rebel-held town on Monday, sparking intense clashes that sent bloodied victims flooding into hospitals and clinics, activists said.",60,67,intense,2,1,3
3Z8UJEJOCZEG603II1EL4BE2PV593A,"Syrian troops shelled a rebel-held town on Monday, sparking intense clashes that sent bloodied victims flooding into hospitals and clinics, activists said.",60,75,intense clashes,1,2,3
3Z8UJEJOCZEG603II1EL4BE2PV593A,"Syrian troops shelled a rebel-held town on Monday, sparking intense clashes that sent bloodied victims flooding into hospitals and clinics, activists said.",86,94,bloodied,4,2,6
3Z8UJEJOCZEG603II1EL4BE2PV593A,"Syrian troops shelled a rebel-held town on Monday, sparking intense clashes that sent bloodied victims flooding into hospitals and clinics, activists said.",86,102,bloodied victims,0,1,1
3Z8UJEJOCZEG603II1EL4BE2PV593A,"Syrian troops shelled a rebel-held town on Monday, sparking intense clashes that sent bloodied victims flooding into hospitals and clinics, activists said.",95,102,victims,0,1,1
3Z8UJEJOCZEG603II1EL4BE2PV593A,"Syrian troops shelled a rebel-held town on Monday, sparking intense clashes that sent bloodied victims flooding into hospitals and clinics, activists said.",103,111,flooding,0,2,2
3Z8UJEJOCZEG603II1EL4BE2PV593A,"Syrian troops shelled a rebel-held town on Monday, sparking intense clashes that sent bloodied victims flooding into hospitals and clinics, activists said.",140,149,activists,5,2,7
3Z8UJEJOCZEG603II1EL4BE2PV593A,"The violence in Rastan, in the restive central Homs province, and elsewhere around the country is eroding an internationally brokered peace plan that many observers see as the last hope to calm the 14-month-old crisis.",4,12,violence,0,3,3
3Z8UJEJOCZEG603II1EL4BE2PV593A,"The violence in Rastan, in the restive central Homs province, and elsewhere around the country is eroding an internationally brokered peace plan that many observers see as the last hope to calm the 14-month-old crisis.",31,38,restive,8,8,16
3Z8UJEJOCZEG603II1EL4BE2PV593A,"The violence in Rastan, in the restive central Homs province, and elsewhere around the country is eroding an internationally brokered peace plan that many observers see as the last hope to calm the 14-month-old crisis.",52,60,province,2,0,2
3Z8UJEJOCZEG603II1EL4BE2PV593A,"The violence in Rastan, in the restive central Homs province, and elsewhere around the country is eroding an internationally brokered peace plan that many observers see as the last hope to calm the 14-month-old crisis.",66,75,elsewhere,0,1,1
3Z8UJEJOCZEG603II1EL4BE2PV593A,"The violence in Rastan, in the restive central Homs province, and elsewhere around the country is eroding an internationally brokered peace plan that many observers see as the last hope to calm the 14-month-old crisis.",98,105,eroding,9,10,19
3Z8UJEJOCZEG603II1EL4BE2PV593A,"The violence in Rastan, in the restive central Homs province, and elsewhere around the country is eroding an internationally brokered peace plan that many observers see as the last hope to calm the 14-month-old crisis.",109,124,internationally,1,0,1
3Z8UJEJOCZEG603II1EL4BE2PV593A,"The violence in Rastan, in the restive central Homs province, and elsewhere around the country is eroding an internationally brokered peace plan that many observers see as the last hope to calm the 14-month-old crisis.",109,133,internationally brokered,1,0,1
3Z8UJEJOCZEG603II1EL4BE2PV593A,"The violence in Rastan, in the restive central Homs province, and elsewhere around the country is eroding an internationally brokered peace plan that many observers see as the last hope to calm the 14-month-old crisis.",109,144,internationally brokered peace plan,1,1,2
3Z8UJEJOCZEG603II1EL4BE2PV593A,"The violence in Rastan, in the restive central Homs province, and elsewhere around the country is eroding an internationally brokered peace plan that many observers see as the last hope to calm the 14-month-old crisis.",125,133,brokered,5,8,13
3Z8UJEJOCZEG603II1EL4BE2PV593A,"The violence in Rastan, in the restive central Homs province, and elsewhere around the country is eroding an internationally brokered peace plan that many observers see as the last hope to calm the 14-month-old crisis.",125,144,brokered peace plan,1,0,1
3Z8UJEJOCZEG603II1EL4BE2PV593A,"The violence in Rastan, in the restive central Homs province, and elsewhere around the country is eroding an internationally brokered peace plan that many observers see as the last hope to calm the 14-month-old crisis.",155,164,observers,0,1,1
3Z8UJEJOCZEG603II1EL4BE2PV593A,"The violence in Rastan, in the restive central Homs province, and elsewhere around the country is eroding an internationally brokered peace plan that many observers see as the last hope to calm the 14-month-old crisis.",211,217,crisis,1,2,3
3Z8UJEJOCZEG603II1EL4BE2PV593A,An amateur video showed a young girl who apparently suffered shrapnel wounds in her thigh undergoing treatment in a makeshift Rastan hospital while screaming in pain.,3,10,amateur,4,5,9
3Z8UJEJOCZEG603II1EL4BE2PV593A,An amateur video showed a young girl who apparently suffered shrapnel wounds in her thigh undergoing treatment in a makeshift Rastan hospital while screaming in pain.,3,16,amateur video,0,1,1
3Z8UJEJOCZEG603II1EL4BE2PV593A,An amateur video showed a young girl who apparently suffered shrapnel wounds in her thigh undergoing treatment in a makeshift Rastan hospital while screaming in pain.,41,51,apparently,0,3,3
3Z8UJEJOCZEG603II1EL4BE2PV593A,An amateur video showed a young girl who apparently suffered shrapnel wounds in her thigh undergoing treatment in a makeshift Rastan hospital while screaming in pain.,52,60,suffered,0,2,2
3Z8UJEJOCZEG603II1EL4BE2PV593A,An amateur video showed a young girl who apparently suffered shrapnel wounds in her thigh undergoing treatment in a makeshift Rastan hospital while screaming in pain.,61,69,shrapnel,10,8,18
3Z8UJEJOCZEG603II1EL4BE2PV593A,An amateur video showed a young girl who apparently suffered shrapnel wounds in her thigh undergoing treatment in a makeshift Rastan hospital while screaming in pain.,61,76,shrapnel wounds,1,4,5
3Z8UJEJOCZEG603II1EL4BE2PV593A,An amateur video showed a young girl who apparently suffered shrapnel wounds in her thigh undergoing treatment in a makeshift Rastan hospital while screaming in pain.,70,76,wounds,1,0,1
3Z8UJEJOCZEG603II1EL4BE2PV593A,An amateur video showed a young girl who apparently suffered shrapnel wounds in her thigh undergoing treatment in a makeshift Rastan hospital while screaming in pain.,90,100,undergoing,1,1,2
3Z8UJEJOCZEG603II1EL4BE2PV593A,An amateur video showed a young girl who apparently suffered shrapnel wounds in her thigh undergoing treatment in a makeshift Rastan hospital while screaming in pain.,116,125,makeshift,8,8,16
3Z8UJEJOCZEG603II1EL4BE2PV593A,An amateur video showed a young girl who apparently suffered shrapnel wounds in her thigh undergoing treatment in a makeshift Rastan hospital while screaming in pain.,148,157,screaming,0,5,5
3Z8UJEJOCZEG603II1EL4BE2PV593A,"Rastan, just north of Homs, has been under rebel control since January.",43,48,rebel,0,4,4
3Z8UJEJOCZEG603II1EL4BE2PV593A,"Rastan, just north of Homs, has been under rebel control since January.",43,56,rebel control,1,1,2
3Z8UJEJOCZEG603II1EL4BE2PV593A,The Britain-based Syrian Observatory for Human Rights and the activist network called the Local Coordination Committees said the latest shelling of Rastan started on Sunday.,25,36,Observatory,1,3,4
3Z8UJEJOCZEG603II1EL4BE2PV593A,The Britain-based Syrian Observatory for Human Rights and the activist network called the Local Coordination Committees said the latest shelling of Rastan started on Sunday.,41,53,Human Rights,1,0,1
3Z8UJEJOCZEG603II1EL4BE2PV593A,The Britain-based Syrian Observatory for Human Rights and the activist network called the Local Coordination Committees said the latest shelling of Rastan started on Sunday.,62,70,activist,3,0,3
3Z8UJEJOCZEG603II1EL4BE2PV593A,The Britain-based Syrian Observatory for Human Rights and the activist network called the Local Coordination Committees said the latest shelling of Rastan started on Sunday.,62,78,activist network,3,1,4
3Z8UJEJOCZEG603II1EL4BE2PV593A,The Britain-based Syrian Observatory for Human Rights and the activist network called the Local Coordination Committees said the latest shelling of Rastan started on Sunday.,96,119,Coordination Committees,1,1,2
3Z8UJEJOCZEG603II1EL4BE2PV593A,The Britain-based Syrian Observatory for Human Rights and the activist network called the Local Coordination Committees said the latest shelling of Rastan started on Sunday.,136,144,shelling,7,2,9
3VEI3XUCZRYTHP4RAGBE8ZHX1Q6PRJ,"Three of the children, at least one already wounded, fled to the home of a neighbor who had been awakened by gunfire, but Thomas immediately called the children back and killed them, sheriff's spokesman Tom Goodyear said.",44,51,wounded,3,4,7
3VEI3XUCZRYTHP4RAGBE8ZHX1Q6PRJ,"Three of the children, at least one already wounded, fled to the home of a neighbor who had been awakened by gunfire, but Thomas immediately called the children back and killed them, sheriff's spokesman Tom Goodyear said.",53,57,fled,1,9,10
3VEI3XUCZRYTHP4RAGBE8ZHX1Q6PRJ,"Three of the children, at least one already wounded, fled to the home of a neighbor who had been awakened by gunfire, but Thomas immediately called the children back and killed them, sheriff's spokesman Tom Goodyear said.",75,83,neighbor,0,1,1
3VEI3XUCZRYTHP4RAGBE8ZHX1Q6PRJ,"Three of the children, at least one already wounded, fled to the home of a neighbor who had been awakened by gunfire, but Thomas immediately called the children back and killed them, sheriff's spokesman Tom Goodyear said.",88,105,had been awakened,0,1,1
3VEI3XUCZRYTHP4RAGBE8ZHX1Q6PRJ,"Three of the children, at least one already wounded, fled to the home of a neighbor who had been awakened by gunfire, but Thomas immediately called the children back and killed them, sheriff's spokesman Tom Goodyear said.",97,105,awakened,4,7,11
3VEI3XUCZRYTHP4RAGBE8ZHX1Q6PRJ,"Three of the children, at least one already wounded, fled to the home of a neighbor who had been awakened by gunfire, but Thomas immediately called the children back and killed them, sheriff's spokesman Tom Goodyear said.",109,116,gunfire,1,1,2
3VEI3XUCZRYTHP4RAGBE8ZHX1Q6PRJ,"Three of the children, at least one already wounded, fled to the home of a neighbor who had been awakened by gunfire, but Thomas immediately called the children back and killed them, sheriff's spokesman Tom Goodyear said.",129,140,immediately,1,1,2
3VEI3XUCZRYTHP4RAGBE8ZHX1Q6PRJ,"Three of the children, at least one already wounded, fled to the home of a neighbor who had been awakened by gunfire, but Thomas immediately called the children back and killed them, sheriff's spokesman Tom Goodyear said.",183,190,sheriff,1,0,1
3VEI3XUCZRYTHP4RAGBE8ZHX1Q6PRJ,"Three of the children, at least one already wounded, fled to the home of a neighbor who had been awakened by gunfire, but Thomas immediately called the children back and killed them, sheriff's spokesman Tom Goodyear said.",183,201,sheriffs spokesman,1,0,1
3VEI3XUCZRYTHP4RAGBE8ZHX1Q6PRJ,"Three of the children, at least one already wounded, fled to the home of a neighbor who had been awakened by gunfire, but Thomas immediately called the children back and killed them, sheriff's spokesman Tom Goodyear said.",193,202,spokesman,4,6,10
3VEI3XUCZRYTHP4RAGBE8ZHX1Q6PRJ,"The neighbor called 911 as they left his home, Goodyear said.",4,12,neighbor,0,1,1
3VEI3XUCZRYTHP4RAGBE8ZHX1Q6PRJ,"See the story at NBC station WESH of Orlando ""She was very calm,"" Goodyear said of the neighbor's report. """,17,28,NBC station,0,1,1
3VEI3XUCZRYTHP4RAGBE8ZHX1Q6PRJ,"See the story at NBC station WESH of Orlando ""She was very calm,"" Goodyear said of the neighbor's report. """,83,103,the neighbors report,1,0,1
3VEI3XUCZRYTHP4RAGBE8ZHX1Q6PRJ,"See the story at NBC station WESH of Orlando ""She was very calm,"" Goodyear said of the neighbor's report. """,87,96,neighbors,0,1,1
3VEI3XUCZRYTHP4RAGBE8ZHX1Q6PRJ,"See the story at NBC station WESH of Orlando ""She was very calm,"" Goodyear said of the neighbor's report. """,87,103,neighbors report,0,1,1
3VEI3XUCZRYTHP4RAGBE8ZHX1Q6PRJ,";She called them back and they walked back to the house.""",31,42,walked back,0,1,1
3VEI3XUCZRYTHP4RAGBE8ZHX1Q6PRJ,"Arriving deputies found one of the children, Pebbles Johnson, 17, lying in the front yard of the Bright Avenue home and spotted a person at the front door, Goodyear said.",0,8,Arriving,1,1,2
3VEI3XUCZRYTHP4RAGBE8ZHX1Q6PRJ,"Arriving deputies found one of the children, Pebbles Johnson, 17, lying in the front yard of the Bright Avenue home and spotted a person at the front door, Goodyear said.",0,17,Arriving deputies,1,1,2
3VEI3XUCZRYTHP4RAGBE8ZHX1Q6PRJ,"Arriving deputies found one of the children, Pebbles Johnson, 17, lying in the front yard of the Bright Avenue home and spotted a person at the front door, Goodyear said.",9,17,deputies,5,4,9
3VEI3XUCZRYTHP4RAGBE8ZHX1Q6PRJ,"Arriving deputies found one of the children, Pebbles Johnson, 17, lying in the front yard of the Bright Avenue home and spotted a person at the front door, Goodyear said.",45,52,Pebbles,0,1,1
3VEI3XUCZRYTHP4RAGBE8ZHX1Q6PRJ,"Arriving deputies found one of the children, Pebbles Johnson, 17, lying in the front yard of the Bright Avenue home and spotted a person at the front door, Goodyear said.",66,71,lying,0,1,1
3VEI3XUCZRYTHP4RAGBE8ZHX1Q6PRJ,"Arriving deputies found one of the children, Pebbles Johnson, 17, lying in the front yard of the Bright Avenue home and spotted a person at the front door, Goodyear said.",79,89,front yard,0,1,1
3VEI3XUCZRYTHP4RAGBE8ZHX1Q6PRJ,"Arriving deputies found one of the children, Pebbles Johnson, 17, lying in the front yard of the Bright Avenue home and spotted a person at the front door, Goodyear said.",120,127,spotted,4,8,12
3VEI3XUCZRYTHP4RAGBE8ZHX1Q6PRJ,"Arriving deputies found one of the children, Pebbles Johnson, 17, lying in the front yard of the Bright Avenue home and spotted a person at the front door, Goodyear said.",120,136,spotted a person,0,1,1
3VEI3XUCZRYTHP4RAGBE8ZHX1Q6PRJ,"The person ducked back inside after seeing deputies, he said.",11,17,ducked,7,9,16
3VEI3XUCZRYTHP4RAGBE8ZHX1Q6PRJ,"The person ducked back inside after seeing deputies, he said.",11,22,ducked back,1,4,5
3VEI3XUCZRYTHP4RAGBE8ZHX1Q6PRJ,"The person ducked back inside after seeing deputies, he said.",11,29,ducked back inside,0,1,1
3VEI3XUCZRYTHP4RAGBE8ZHX1Q6PRJ,"The person ducked back inside after seeing deputies, he said.",43,51,deputies,3,3,6
3VEI3XUCZRYTHP4RAGBE8ZHX1Q6PRJ,The teen was declared dead when she was transferred to an ambulance.,4,8,teen,1,0,1
3VEI3XUCZRYTHP4RAGBE8ZHX1Q6PRJ,The teen was declared dead when she was transferred to an ambulance.,13,21,declared,3,3,6
3VEI3XUCZRYTHP4RAGBE8ZHX1Q6PRJ,The teen was declared dead when she was transferred to an ambulance.,40,51,transferred,6,5,11
3VEI3XUCZRYTHP4RAGBE8ZHX1Q6PRJ,The teen was declared dead when she was transferred to an ambulance.,40,67,transferred to an ambulance,0,1,1
3VEI3XUCZRYTHP4RAGBE8ZHX1Q6PRJ,The teen was declared dead when she was transferred to an ambulance.,58,67,ambulance,3,1,4
35JDMRECC4AYV86NLR1RFJ4MKXQGEZ,"Among the dead were a Shiite imam, Sheikh Abbas al-Laham, who leads the prayers in the Ruqayya mosque in Damascus, a revered place of pilgrimage for many religious Iranians.",22,28,Shiite,0,1,1
35JDMRECC4AYV86NLR1RFJ4MKXQGEZ,"Among the dead were a Shiite imam, Sheikh Abbas al-Laham, who leads the prayers in the Ruqayya mosque in Damascus, a revered place of pilgrimage for many religious Iranians.",22,33,Shiite imam,2,0,2
35JDMRECC4AYV86NLR1RFJ4MKXQGEZ,"Among the dead were a Shiite imam, Sheikh Abbas al-Laham, who leads the prayers in the Ruqayya mosque in Damascus, a revered place of pilgrimage for many religious Iranians.",29,33,imam,2,0,2
35JDMRECC4AYV86NLR1RFJ4MKXQGEZ,"Among the dead were a Shiite imam, Sheikh Abbas al-Laham, who leads the prayers in the Ruqayya mosque in Damascus, a revered place of pilgrimage for many religious Iranians.",35,41,Sheikh,1,0,1
35JDMRECC4AYV86NLR1RFJ4MKXQGEZ,"Among the dead were a Shiite imam, Sheikh Abbas al-Laham, who leads the prayers in the Ruqayya mosque in Damascus, a revered place of pilgrimage for many religious Iranians.",35,56,Sheikh Abbas al-Laham,1,0,1
35JDMRECC4AYV86NLR1RFJ4MKXQGEZ,"Among the dead were a Shiite imam, Sheikh Abbas al-Laham, who leads the prayers in the Ruqayya mosque in Damascus, a revered place of pilgrimage for many religious Iranians.",42,56,Abbas al-Laham,1,0,1
35JDMRECC4AYV86NLR1RFJ4MKXQGEZ,"Among the dead were a Shiite imam, Sheikh Abbas al-Laham, who leads the prayers in the Ruqayya mosque in Damascus, a revered place of pilgrimage for many religious Iranians.",87,94,Ruqayya,1,0,1
35JDMRECC4AYV86NLR1RFJ4MKXQGEZ,"Among the dead were a Shiite imam, Sheikh Abbas al-Laham, who leads the prayers in the Ruqayya mosque in Damascus, a revered place of pilgrimage for many religious Iranians.",87,101,Ruqayya mosque,2,0,2
35JDMRECC4AYV86NLR1RFJ4MKXQGEZ,"Among the dead were a Shiite imam, Sheikh Abbas al-Laham, who leads the prayers in the Ruqayya mosque in Damascus, a revered place of pilgrimage for many religious Iranians.",95,101,mosque,3,0,3
35JDMRECC4AYV86NLR1RFJ4MKXQGEZ,"Among the dead were a Shiite imam, Sheikh Abbas al-Laham, who leads the prayers in the Ruqayya mosque in Damascus, a revered place of pilgrimage for many religious Iranians.",105,113,Damascus,1,0,1
35JDMRECC4AYV86NLR1RFJ4MKXQGEZ,"Among the dead were a Shiite imam, Sheikh Abbas al-Laham, who leads the prayers in the Ruqayya mosque in Damascus, a revered place of pilgrimage for many religious Iranians.",115,130,a revered place,1,0,1
35JDMRECC4AYV86NLR1RFJ4MKXQGEZ,"Among the dead were a Shiite imam, Sheikh Abbas al-Laham, who leads the prayers in the Ruqayya mosque in Damascus, a revered place of pilgrimage for many religious Iranians.",117,124,revered,9,8,17
35JDMRECC4AYV86NLR1RFJ4MKXQGEZ,"Among the dead were a Shiite imam, Sheikh Abbas al-Laham, who leads the prayers in the Ruqayya mosque in Damascus, a revered place of pilgrimage for many religious Iranians.",117,130,revered place,0,1,1
35JDMRECC4AYV86NLR1RFJ4MKXQGEZ,"Among the dead were a Shiite imam, Sheikh Abbas al-Laham, who leads the prayers in the Ruqayya mosque in Damascus, a revered place of pilgrimage for many religious Iranians.",134,144,pilgrimage,10,9,19
35JDMRECC4AYV86NLR1RFJ4MKXQGEZ,"The cleric was assassinated by unidentified gunmen in Damascus, the Observatory said.",4,10,cleric,6,0,6
35JDMRECC4AYV86NLR1RFJ4MKXQGEZ,"The cleric was assassinated by unidentified gunmen in Damascus, the Observatory said.",15,27,assassinated,10,8,18
35JDMRECC4AYV86NLR1RFJ4MKXQGEZ,"The cleric was assassinated by unidentified gunmen in Damascus, the Observatory said.",31,43,unidentified,3,2,5
35JDMRECC4AYV86NLR1RFJ4MKXQGEZ,"The cleric was assassinated by unidentified gunmen in Damascus, the Observatory said.",31,50,unidentified gunmen,0,1,1
35JDMRECC4AYV86NLR1RFJ4MKXQGEZ,"The cleric was assassinated by unidentified gunmen in Damascus, the Observatory said.",44,50,gunmen,1,0,1
35JDMRECC4AYV86NLR1RFJ4MKXQGEZ,"The cleric was assassinated by unidentified gunmen in Damascus, the Observatory said.",68,79,Observatory,1,4,5
35JDMRECC4AYV86NLR1RFJ4MKXQGEZ,"Iran supports the Damascus regime, which since 15 March 2011 has faced an unprecedented popular revolt.",27,33,regime,6,4,10
35JDMRECC4AYV86NLR1RFJ4MKXQGEZ,"Iran supports the Damascus regime, which since 15 March 2011 has faced an unprecedented popular revolt.",74,87,unprecedented,10,8,18
35JDMRECC4AYV86NLR1RFJ4MKXQGEZ,"Iran supports the Damascus regime, which since 15 March 2011 has faced an unprecedented popular revolt.",96,102,revolt,5,7,12
35JDMRECC4AYV86NLR1RFJ4MKXQGEZ,"More than 12,000 people, the majority of them civilians, have died since the Syrian uprising began in March 2011, according to the watchdog, including more than 900 killed since the April 12 truce.",46,55,civilians,3,0,3
35JDMRECC4AYV86NLR1RFJ4MKXQGEZ,"More than 12,000 people, the majority of them civilians, have died since the Syrian uprising began in March 2011, according to the watchdog, including more than 900 killed since the April 12 truce.",77,92,Syrian uprising,1,0,1
35JDMRECC4AYV86NLR1RFJ4MKXQGEZ,"More than 12,000 people, the majority of them civilians, have died since the Syrian uprising began in March 2011, according to the watchdog, including more than 900 killed since the April 12 truce.",84,92,uprising,2,4,6
35JDMRECC4AYV86NLR1RFJ4MKXQGEZ,"More than 12,000 people, the majority of them civilians, have died since the Syrian uprising began in March 2011, according to the watchdog, including more than 900 killed since the April 12 truce.",131,139,watchdog,4,6,10
35JDMRECC4AYV86NLR1RFJ4MKXQGEZ,"More than 12,000 people, the majority of them civilians, have died since the Syrian uprising began in March 2011, according to the watchdog, including more than 900 killed since the April 12 truce.",191,196,truce,0,1,1
35JDMRECC4AYV86NLR1RFJ4MKXQGEZ,European Union foreign ministers agreed Monday to impose fresh sanctions on Syria as a U.N.-backed peace plan -- along with all other diplomatic efforts -- has yet to stop the carnage that mounts every day.,0,14,European Union,1,0,1
35JDMRECC4AYV86NLR1RFJ4MKXQGEZ,European Union foreign ministers agreed Monday to impose fresh sanctions on Syria as a U.N.-backed peace plan -- along with all other diplomatic efforts -- has yet to stop the carnage that mounts every day.,15,32,foreign ministers,1,0,1
35JDMRECC4AYV86NLR1RFJ4MKXQGEZ,European Union foreign ministers agreed Monday to impose fresh sanctions on Syria as a U.N.-backed peace plan -- along with all other diplomatic efforts -- has yet to stop the carnage that mounts every day.,50,56,impose,2,6,8
35JDMRECC4AYV86NLR1RFJ4MKXQGEZ,European Union foreign ministers agreed Monday to impose fresh sanctions on Syria as a U.N.-backed peace plan -- along with all other diplomatic efforts -- has yet to stop the carnage that mounts every day.,50,72,impose fresh sanctions,1,0,1
35JDMRECC4AYV86NLR1RFJ4MKXQGEZ,European Union foreign ministers agreed Monday to impose fresh sanctions on Syria as a U.N.-backed peace plan -- along with all other diplomatic efforts -- has yet to stop the carnage that mounts every day.,57,72,fresh sanctions,2,0,2
35JDMRECC4AYV86NLR1RFJ4MKXQGEZ,European Union foreign ministers agreed Monday to impose fresh sanctions on Syria as a U.N.-backed peace plan -- along with all other diplomatic efforts -- has yet to stop the carnage that mounts every day.,63,72,sanctions,2,5,7
35JDMRECC4AYV86NLR1RFJ4MKXQGEZ,European Union foreign ministers agreed Monday to impose fresh sanctions on Syria as a U.N.-backed peace plan -- along with all other diplomatic efforts -- has yet to stop the carnage that mounts every day.,87,98,U.N.-backed,1,0,1
35JDMRECC4AYV86NLR1RFJ4MKXQGEZ,European Union foreign ministers agreed Monday to impose fresh sanctions on Syria as a U.N.-backed peace plan -- along with all other diplomatic efforts -- has yet to stop the carnage that mounts every day.,87,109,U.N.-backed peace plan,0,1,1
35JDMRECC4AYV86NLR1RFJ4MKXQGEZ,European Union foreign ministers agreed Monday to impose fresh sanctions on Syria as a U.N.-backed peace plan -- along with all other diplomatic efforts -- has yet to stop the carnage that mounts every day.,134,144,diplomatic,4,3,7
35JDMRECC4AYV86NLR1RFJ4MKXQGEZ,European Union foreign ministers agreed Monday to impose fresh sanctions on Syria as a U.N.-backed peace plan -- along with all other diplomatic efforts -- has yet to stop the carnage that mounts every day.,134,152,diplomatic efforts,4,1,5
35JDMRECC4AYV86NLR1RFJ4MKXQGEZ,European Union foreign ministers agreed Monday to impose fresh sanctions on Syria as a U.N.-backed peace plan -- along with all other diplomatic efforts -- has yet to stop the carnage that mounts every day.,176,183,carnage,10,9,19
35JDMRECC4AYV86NLR1RFJ4MKXQGEZ,European Union foreign ministers agreed Monday to impose fresh sanctions on Syria as a U.N.-backed peace plan -- along with all other diplomatic efforts -- has yet to stop the carnage that mounts every day.,189,195,mounts,3,1,4
3TLFH2L6Y9PA5XGDC75XC1AME1B2TM,"He didn't see the text until he woke up this morning, Goodyear said.",19,23,text,0,1,1
3TLFH2L6Y9PA5XGDC75XC1AME1B2TM,"He didn't see the text until he woke up this morning, Goodyear said.",33,40,woke up,0,2,2
3TLFH2L6Y9PA5XGDC75XC1AME1B2TM,"Deputies identified the children as Pebbles Johnson, 17; Jaxs Johnson, 15; Jazlin Johnson, 13; and Joel Johnson, 12.",0,8,Deputies,4,4,8
3TLFH2L6Y9PA5XGDC75XC1AME1B2TM,"Deputies identified the children as Pebbles Johnson, 17; Jaxs Johnson, 15; Jazlin Johnson, 13; and Joel Johnson, 12.",9,19,identified,5,3,8
3TLFH2L6Y9PA5XGDC75XC1AME1B2TM,"Deputies identified the children as Pebbles Johnson, 17; Jaxs Johnson, 15; Jazlin Johnson, 13; and Joel Johnson, 12.",36,43,Pebbles,0,1,1
3TLFH2L6Y9PA5XGDC75XC1AME1B2TM,"The shooting happened in Port St. John, about 24 kilometres west of Cape Canaveral in an area known as the ""Space Coast"" because it is the home of NASA's Kennedy Space Center, the location of numerous famed shuttle launches.",4,12,shooting,0,1,1
3TLFH2L6Y9PA5XGDC75XC1AME1B2TM,"The shooting happened in Port St. John, about 24 kilometres west of Cape Canaveral in an area known as the ""Space Coast"" because it is the home of NASA's Kennedy Space Center, the location of numerous famed shuttle launches.",13,21,happened,0,1,1
3TLFH2L6Y9PA5XGDC75XC1AME1B2TM,"The shooting happened in Port St. John, about 24 kilometres west of Cape Canaveral in an area known as the ""Space Coast"" because it is the home of NASA's Kennedy Space Center, the location of numerous famed shuttle launches.",49,59,kilometres,4,0,4
3TLFH2L6Y9PA5XGDC75XC1AME1B2TM,"The shooting happened in Port St. John, about 24 kilometres west of Cape Canaveral in an area known as the ""Space Coast"" because it is the home of NASA's Kennedy Space Center, the location of numerous famed shuttle launches.",108,119,Space Coast,1,0,1
3TLFH2L6Y9PA5XGDC75XC1AME1B2TM,"The shooting happened in Port St. John, about 24 kilometres west of Cape Canaveral in an area known as the ""Space Coast"" because it is the home of NASA's Kennedy Space Center, the location of numerous famed shuttle launches.",180,188,location,0,1,1
3TLFH2L6Y9PA5XGDC75XC1AME1B2TM,"The shooting happened in Port St. John, about 24 kilometres west of Cape Canaveral in an area known as the ""Space Coast"" because it is the home of NASA's Kennedy Space Center, the location of numerous famed shuttle launches.",192,200,numerous,4,4,8
3TLFH2L6Y9PA5XGDC75XC1AME1B2TM,"The shooting happened in Port St. John, about 24 kilometres west of Cape Canaveral in an area known as the ""Space Coast"" because it is the home of NASA's Kennedy Space Center, the location of numerous famed shuttle launches.",201,206,famed,1,5,6
3TLFH2L6Y9PA5XGDC75XC1AME1B2TM,"The shooting happened in Port St. John, about 24 kilometres west of Cape Canaveral in an area known as the ""Space Coast"" because it is the home of NASA's Kennedy Space Center, the location of numerous famed shuttle launches.",201,223,famed shuttle launches,1,1,2
3TLFH2L6Y9PA5XGDC75XC1AME1B2TM,"The shooting happened in Port St. John, about 24 kilometres west of Cape Canaveral in an area known as the ""Space Coast"" because it is the home of NASA's Kennedy Space Center, the location of numerous famed shuttle launches.",207,214,shuttle,3,3,6
3TLFH2L6Y9PA5XGDC75XC1AME1B2TM,"The shooting happened in Port St. John, about 24 kilometres west of Cape Canaveral in an area known as the ""Space Coast"" because it is the home of NASA's Kennedy Space Center, the location of numerous famed shuttle launches.",207,223,shuttle launches,1,3,4
3TLFH2L6Y9PA5XGDC75XC1AME1B2TM,"The shooting happened in Port St. John, about 24 kilometres west of Cape Canaveral in an area known as the ""Space Coast"" because it is the home of NASA's Kennedy Space Center, the location of numerous famed shuttle launches.",215,223,launches,2,3,5
3TLFH2L6Y9PA5XGDC75XC1AME1B2TM,A spokesman for the Department of Children and Families wouldn't immediately comment on whether the family had a history with the agency.,2,11,spokesman,3,5,8
3TLFH2L6Y9PA5XGDC75XC1AME1B2TM,A spokesman for the Department of Children and Families wouldn't immediately comment on whether the family had a history with the agency.,65,76,immediately,3,2,5
3TLFH2L6Y9PA5XGDC75XC1AME1B2TM,A spokesman for the Department of Children and Families wouldn't immediately comment on whether the family had a history with the agency.,65,84,immediately comment,1,0,1
3TLFH2L6Y9PA5XGDC75XC1AME1B2TM,A spokesman for the Department of Children and Families wouldn't immediately comment on whether the family had a history with the agency.,111,120,a history,1,0,1
3TLFH2L6Y9PA5XGDC75XC1AME1B2TM,A spokesman for the Department of Children and Families wouldn't immediately comment on whether the family had a history with the agency.,113,120,history,0,1,1
3TLFH2L6Y9PA5XGDC75XC1AME1B2TM,A spokesman for the Department of Children and Families wouldn't immediately comment on whether the family had a history with the agency.,130,136,agency,2,0,2
3TLFH2L6Y9PA5XGDC75XC1AME1B2TM,Goodyear said deputies had responded to the house for domestic complaints previously.,14,22,deputies,0,1,1
3TLFH2L6Y9PA5XGDC75XC1AME1B2TM,Goodyear said deputies had responded to the house for domestic complaints previously.,27,36,responded,2,2,4
3TLFH2L6Y9PA5XGDC75XC1AME1B2TM,Goodyear said deputies had responded to the house for domestic complaints previously.,54,62,domestic,2,1,3
3TLFH2L6Y9PA5XGDC75XC1AME1B2TM,Goodyear said deputies had responded to the house for domestic complaints previously.,54,73,domestic complaints,7,5,12
3TLFH2L6Y9PA5XGDC75XC1AME1B2TM,Goodyear said deputies had responded to the house for domestic complaints previously.,63,73,complaints,2,1,3
3TLFH2L6Y9PA5XGDC75XC1AME1B2TM,Goodyear said deputies had responded to the house for domestic complaints previously.,74,84,previously,1,1,2
3TLFH2L6Y9PA5XGDC75XC1AME1B2TM,"Jamie Hudson, whose mother lives two doors down from the family, said the boys in the family were known to shoot BBs at a home across the street and had threatened to set it on fire.",107,116,shoot BBs,0,2,2
3TLFH2L6Y9PA5XGDC75XC1AME1B2TM,"Jamie Hudson, whose mother lives two doors down from the family, said the boys in the family were known to shoot BBs at a home across the street and had threatened to set it on fire.",113,116,BBs,0,1,1
3TLFH2L6Y9PA5XGDC75XC1AME1B2TM,"Jamie Hudson, whose mother lives two doors down from the family, said the boys in the family were known to shoot BBs at a home across the street and had threatened to set it on fire.",153,163,threatened,4,10,14
3TLFH2L6Y9PA5XGDC75XC1AME1B2TM,"Jamie Hudson, whose mother lives two doors down from the family, said the boys in the family were known to shoot BBs at a home across the street and had threatened to set it on fire.",167,181,set it on fire,0,1,1
3QREJ3J433YH30CYS49AQ6MZ3G0LKZ,"#37-1 Guatemalan Supreme Court approves impeachment of President Molina Yesterday in Guatemala, the Supreme Court approved the attorney general's request to impeach President Otto Pérez Molina.",31,39,approves,0,1,1
3QREJ3J433YH30CYS49AQ6MZ3G0LKZ,"#37-1 Guatemalan Supreme Court approves impeachment of President Molina Yesterday in Guatemala, the Supreme Court approved the attorney general's request to impeach President Otto Pérez Molina.",31,51,approves impeachment,1,0,1
3QREJ3J433YH30CYS49AQ6MZ3G0LKZ,"#37-1 Guatemalan Supreme Court approves impeachment of President Molina Yesterday in Guatemala, the Supreme Court approved the attorney general's request to impeach President Otto Pérez Molina.",40,51,impeachment,10,10,20
3QREJ3J433YH30CYS49AQ6MZ3G0LKZ,"#37-1 Guatemalan Supreme Court approves impeachment of President Molina Yesterday in Guatemala, the Supreme Court approved the attorney general's request to impeach President Otto Pérez Molina.",100,113,Supreme Court,1,0,1
3QREJ3J433YH30CYS49AQ6MZ3G0LKZ,"#37-1 Guatemalan Supreme Court approves impeachment of President Molina Yesterday in Guatemala, the Supreme Court approved the attorney general's request to impeach President Otto Pérez Molina.",127,135,attorney,1,1,2
3QREJ3J433YH30CYS49AQ6MZ3G0LKZ,"#37-1 Guatemalan Supreme Court approves impeachment of President Molina Yesterday in Guatemala, the Supreme Court approved the attorney general's request to impeach President Otto Pérez Molina.",127,143,attorney general,1,1,2
3QREJ3J433YH30CYS49AQ6MZ3G0LKZ,"#37-1 Guatemalan Supreme Court approves impeachment of President Molina Yesterday in Guatemala, the Supreme Court approved the attorney general's request to impeach President Otto Pérez Molina.",127,144,attorney generals,1,1,2
3QREJ3J433YH30CYS49AQ6MZ3G0LKZ,"#37-1 Guatemalan Supreme Court approves impeachment of President Molina Yesterday in Guatemala, the Supreme Court approved the attorney general's request to impeach President Otto Pérez Molina.",157,164,impeach,7,3,10
3QREJ3J433YH30CYS49AQ6MZ3G0LKZ,"#37-1 Guatemalan Supreme Court approves impeachment of President Molina Yesterday in Guatemala, the Supreme Court approved the attorney general's request to impeach President Otto Pérez Molina.",175,185,Otto Pérez,0,1,1
3QREJ3J433YH30CYS49AQ6MZ3G0LKZ,"#37-1 Guatemalan Supreme Court approves impeachment of President Molina Yesterday in Guatemala, the Supreme Court approved the attorney general's request to impeach President Otto Pérez Molina.",180,185,Pérez,1,0,1
3QREJ3J433YH30CYS49AQ6MZ3G0LKZ,"#37-2 President Molina, pictured here in 2013, is accused of corruption.",24,32,pictured,0,2,2
3QREJ3J433YH30CYS49AQ6MZ3G0LKZ,"#37-2 President Molina, pictured here in 2013, is accused of corruption.",50,57,accused,3,3,6
3QREJ3J433YH30CYS49AQ6MZ3G0LKZ,"#37-2 President Molina, pictured here in 2013, is accused of corruption.",50,71,accused of corruption,0,1,1
3QREJ3J433YH30CYS49AQ6MZ3G0LKZ,"#37-2 President Molina, pictured here in 2013, is accused of corruption.",61,71,corruption,8,4,12
3QREJ3J433YH30CYS49AQ6MZ3G0LKZ,#37-3 The final decision on lifting Presidential immunity now falls to Congress.,16,24,decision,1,0,1
3QREJ3J433YH30CYS49AQ6MZ3G0LKZ,#37-3 The final decision on lifting Presidential immunity now falls to Congress.,28,35,lifting,0,1,1
3QREJ3J433YH30CYS49AQ6MZ3G0LKZ,#37-3 The final decision on lifting Presidential immunity now falls to Congress.,28,57,lifting Presidential immunity,0,1,1
3QREJ3J433YH30CYS49AQ6MZ3G0LKZ,#37-3 The final decision on lifting Presidential immunity now falls to Congress.,49,57,immunity,10,8,18
3QREJ3J433YH30CYS49AQ6MZ3G0LKZ,#37-3 The final decision on lifting Presidential immunity now falls to Congress.,62,67,falls,0,1,1
3QREJ3J433YH30CYS49AQ6MZ3G0LKZ,#37-4 The case relates to a corruption scandal known locally as La Linea((en)) which has seen Vice President Roxana Baldetti arrested and charged with fraud and receiving bribes.,28,38,corruption,4,1,5
3QREJ3J433YH30CYS49AQ6MZ3G0LKZ,#37-4 The case relates to a corruption scandal known locally as La Linea((en)) which has seen Vice President Roxana Baldetti arrested and charged with fraud and receiving bribes.,28,46,corruption scandal,1,0,1
3QREJ3J433YH30CYS49AQ6MZ3G0LKZ,#37-4 The case relates to a corruption scandal known locally as La Linea((en)) which has seen Vice President Roxana Baldetti arrested and charged with fraud and receiving bribes.,39,46,scandal,1,6,7
3QREJ3J433YH30CYS49AQ6MZ3G0LKZ,#37-4 The case relates to a corruption scandal known locally as La Linea((en)) which has seen Vice President Roxana Baldetti arrested and charged with fraud and receiving bribes.,64,76,La Linea((en,0,1,1
3QREJ3J433YH30CYS49AQ6MZ3G0LKZ,#37-4 The case relates to a corruption scandal known locally as La Linea((en)) which has seen Vice President Roxana Baldetti arrested and charged with fraud and receiving bribes.,109,124,Roxana Baldetti,0,1,1
3QREJ3J433YH30CYS49AQ6MZ3G0LKZ,#37-4 The case relates to a corruption scandal known locally as La Linea((en)) which has seen Vice President Roxana Baldetti arrested and charged with fraud and receiving bribes.,116,124,Baldetti,1,0,1
3QREJ3J433YH30CYS49AQ6MZ3G0LKZ,#37-4 The case relates to a corruption scandal known locally as La Linea((en)) which has seen Vice President Roxana Baldetti arrested and charged with fraud and receiving bribes.,151,156,fraud,5,3,8
3QREJ3J433YH30CYS49AQ6MZ3G0LKZ,#37-4 The case relates to a corruption scandal known locally as La Linea((en)) which has seen Vice President Roxana Baldetti arrested and charged with fraud and receiving bribes.,161,177,receiving bribes,0,1,1
3QREJ3J433YH30CYS49AQ6MZ3G0LKZ,#37-4 The case relates to a corruption scandal known locally as La Linea((en)) which has seen Vice President Roxana Baldetti arrested and charged with fraud and receiving bribes.,171,177,bribes,6,7,13
3QREJ3J433YH30CYS49AQ6MZ3G0LKZ,#37-5 Prosecutors allege Baldetti and Molina between them received half of all bribes in the case.,6,17,Prosecutors,2,2,4
3QREJ3J433YH30CYS49AQ6MZ3G0LKZ,#37-5 Prosecutors allege Baldetti and Molina between them received half of all bribes in the case.,6,24,Prosecutors allege,0,1,1
3QREJ3J433YH30CYS49AQ6MZ3G0LKZ,#37-5 Prosecutors allege Baldetti and Molina between them received half of all bribes in the case.,18,24,allege,1,3,4
3QREJ3J433YH30CYS49AQ6MZ3G0LKZ,#37-5 Prosecutors allege Baldetti and Molina between them received half of all bribes in the case.,25,33,Baldetti,1,1,2
3QREJ3J433YH30CYS49AQ6MZ3G0LKZ,#37-5 Prosecutors allege Baldetti and Molina between them received half of all bribes in the case.,79,85,bribes,1,4,5
3QREJ3J433YH30CYS49AQ6MZ3G0LKZ,"#37-6 Congress previously refused to impeach Molina but the investigation has since broadened, with ministerial resignations.",37,44,impeach,3,1,4
3QREJ3J433YH30CYS49AQ6MZ3G0LKZ,"#37-6 Congress previously refused to impeach Molina but the investigation has since broadened, with ministerial resignations.",60,73,investigation,2,2,4
3QREJ3J433YH30CYS49AQ6MZ3G0LKZ,"#37-6 Congress previously refused to impeach Molina but the investigation has since broadened, with ministerial resignations.",84,93,broadened,4,6,10
3QREJ3J433YH30CYS49AQ6MZ3G0LKZ,"#37-6 Congress previously refused to impeach Molina but the investigation has since broadened, with ministerial resignations.",100,111,ministerial,3,0,3
3QREJ3J433YH30CYS49AQ6MZ3G0LKZ,"#37-6 Congress previously refused to impeach Molina but the investigation has since broadened, with ministerial resignations.",100,124,ministerial resignations,6,1,7
3QREJ3J433YH30CYS49AQ6MZ3G0LKZ,"#37-6 Congress previously refused to impeach Molina but the investigation has since broadened, with ministerial resignations.",112,124,resignations,8,2,10
3QREJ3J433YH30CYS49AQ6MZ3G0LKZ,"#37-7 Molina, however, has stood firm in the face of widespread popular protests demanding he leave office.",27,32,stood,0,1,1
3QREJ3J433YH30CYS49AQ6MZ3G0LKZ,"#37-7 Molina, however, has stood firm in the face of widespread popular protests demanding he leave office.",53,63,widespread,2,4,6
3QREJ3J433YH30CYS49AQ6MZ3G0LKZ,"#37-7 Molina, however, has stood firm in the face of widespread popular protests demanding he leave office.",72,80,protests,2,0,2
3QREJ3J433YH30CYS49AQ6MZ3G0LKZ,"#37-7 Molina, however, has stood firm in the face of widespread popular protests demanding he leave office.",81,90,demanding,1,1,2
3QREJ3J433YH30CYS49AQ6MZ3G0LKZ,#37-8 Elections are scheduled for September 6.,6,15,Elections,1,0,1
3QREJ3J433YH30CYS49AQ6MZ3G0LKZ,#37-8 Elections are scheduled for September 6.,20,29,scheduled,3,2,5
3DWGDA5POF5IT426YY5Y80O2L821VV,#3-11 Pavlensky commented the rape charges had a political motivation behind it and denied the allegations.,16,25,commented,0,3,3
3DWGDA5POF5IT426YY5Y80O2L821VV,#3-11 Pavlensky commented the rape charges had a political motivation behind it and denied the allegations.,30,34,rape,2,0,2
3DWGDA5POF5IT426YY5Y80O2L821VV,#3-11 Pavlensky commented the rape charges had a political motivation behind it and denied the allegations.,30,42,rape charges,0,1,1
3DWGDA5POF5IT426YY5Y80O2L821VV,#3-11 Pavlensky commented the rape charges had a political motivation behind it and denied the allegations.,35,42,charges,0,1,1
3DWGDA5POF5IT426YY5Y80O2L821VV,#3-11 Pavlensky commented the rape charges had a political motivation behind it and denied the allegations.,49,69,political motivation,1,2,3
3DWGDA5POF5IT426YY5Y80O2L821VV,#3-11 Pavlensky commented the rape charges had a political motivation behind it and denied the allegations.,59,69,motivation,4,6,10
3DWGDA5POF5IT426YY5Y80O2L821VV,#3-11 Pavlensky commented the rape charges had a political motivation behind it and denied the allegations.,84,90,denied,2,3,5
3DWGDA5POF5IT426YY5Y80O2L821VV,#3-11 Pavlensky commented the rape charges had a political motivation behind it and denied the allegations.,95,106,allegations,10,8,18
3DWGDA5POF5IT426YY5Y80O2L821VV,"#3-12 Olga Papernaya, former art director at Moscow's film club said, ""Alas, yesterday a national hero and a great performance artist, today — it’s true — a criminal, a psychopath and a rapist"".",11,20,Papernaya,1,0,1
3DWGDA5POF5IT426YY5Y80O2L821VV,"#3-12 Olga Papernaya, former art director at Moscow's film club said, ""Alas, yesterday a national hero and a great performance artist, today — it’s true — a criminal, a psychopath and a rapist"".",71,75,Alas,2,0,2
3DWGDA5POF5IT426YY5Y80O2L821VV,"#3-12 Olga Papernaya, former art director at Moscow's film club said, ""Alas, yesterday a national hero and a great performance artist, today — it’s true — a criminal, a psychopath and a rapist"".",89,97,national,0,1,1
3DWGDA5POF5IT426YY5Y80O2L821VV,"#3-12 Olga Papernaya, former art director at Moscow's film club said, ""Alas, yesterday a national hero and a great performance artist, today — it’s true — a criminal, a psychopath and a rapist"".",115,126,performance,1,0,1
3DWGDA5POF5IT426YY5Y80O2L821VV,"#3-12 Olga Papernaya, former art director at Moscow's film club said, ""Alas, yesterday a national hero and a great performance artist, today — it’s true — a criminal, a psychopath and a rapist"".",115,133,performance artist,1,0,1
3DWGDA5POF5IT426YY5Y80O2L821VV,"#3-12 Olga Papernaya, former art director at Moscow's film club said, ""Alas, yesterday a national hero and a great performance artist, today — it’s true — a criminal, a psychopath and a rapist"".",157,165,criminal,1,0,1
3DWGDA5POF5IT426YY5Y80O2L821VV,"#3-12 Olga Papernaya, former art director at Moscow's film club said, ""Alas, yesterday a national hero and a great performance artist, today — it’s true — a criminal, a psychopath and a rapist"".",169,179,psychopath,10,9,19
3DWGDA5POF5IT426YY5Y80O2L821VV,"#3-12 Olga Papernaya, former art director at Moscow's film club said, ""Alas, yesterday a national hero and a great performance artist, today — it’s true — a criminal, a psychopath and a rapist"".",169,192,psychopath and a rapist,1,0,1
3DWGDA5POF5IT426YY5Y80O2L821VV,"#3-12 Olga Papernaya, former art director at Moscow's film club said, ""Alas, yesterday a national hero and a great performance artist, today — it’s true — a criminal, a psychopath and a rapist"".",186,192,rapist,4,4,8
3DWGDA5POF5IT426YY5Y80O2L821VV,"#3-13 Pavlensky, Oksana, and their two daughters left for Ukraine in mid-December before flying to France.",58,65,Ukraine,1,0,1
3DWGDA5POF5IT426YY5Y80O2L821VV,"#3-15 In one of several painful performances, Pyotr Pavlensky sewed his lips to support members of musical band Pussy Riot who were imprisoned that time.",24,44,painful performances,0,3,3
3DWGDA5POF5IT426YY5Y80O2L821VV,"#3-15 In one of several painful performances, Pyotr Pavlensky sewed his lips to support members of musical band Pussy Riot who were imprisoned that time.",32,44,performances,2,1,3
3DWGDA5POF5IT426YY5Y80O2L821VV,"#3-15 In one of several painful performances, Pyotr Pavlensky sewed his lips to support members of musical band Pussy Riot who were imprisoned that time.",46,61,Pyotr Pavlensky,1,0,1
3DWGDA5POF5IT426YY5Y80O2L821VV,"#3-15 In one of several painful performances, Pyotr Pavlensky sewed his lips to support members of musical band Pussy Riot who were imprisoned that time.",62,67,sewed,0,4,4
3DWGDA5POF5IT426YY5Y80O2L821VV,"#3-15 In one of several painful performances, Pyotr Pavlensky sewed his lips to support members of musical band Pussy Riot who were imprisoned that time.",62,76,sewed his lips,3,2,5
3DWGDA5POF5IT426YY5Y80O2L821VV,"#3-15 In one of several painful performances, Pyotr Pavlensky sewed his lips to support members of musical band Pussy Riot who were imprisoned that time.",72,76,lips,0,1,1
3DWGDA5POF5IT426YY5Y80O2L821VV,"#3-15 In one of several painful performances, Pyotr Pavlensky sewed his lips to support members of musical band Pussy Riot who were imprisoned that time.",99,106,musical,0,1,1
3DWGDA5POF5IT426YY5Y80O2L821VV,"#3-15 In one of several painful performances, Pyotr Pavlensky sewed his lips to support members of musical band Pussy Riot who were imprisoned that time.",112,122,Pussy Riot,1,0,1
3DWGDA5POF5IT426YY5Y80O2L821VV,"#3-15 In one of several painful performances, Pyotr Pavlensky sewed his lips to support members of musical band Pussy Riot who were imprisoned that time.",118,122,Riot,1,0,1
3DWGDA5POF5IT426YY5Y80O2L821VV,"#3-15 In one of several painful performances, Pyotr Pavlensky sewed his lips to support members of musical band Pussy Riot who were imprisoned that time.",132,142,imprisoned,7,5,12
3DWGDA5POF5IT426YY5Y80O2L821VV,#3-16 The band members were charged with hooliganism for performing an anti-Putin song in a church.,41,52,hooliganism,10,10,20
3DWGDA5POF5IT426YY5Y80O2L821VV,#3-16 The band members were charged with hooliganism for performing an anti-Putin song in a church.,71,81,anti-Putin,1,0,1
3DWGDA5POF5IT426YY5Y80O2L821VV,"#3-17 In 2013, he nailed his scrotum in Moscow's Red Square naming the art as ""Fixation"".",18,24,nailed,0,3,3
3DWGDA5POF5IT426YY5Y80O2L821VV,"#3-17 In 2013, he nailed his scrotum in Moscow's Red Square naming the art as ""Fixation"".",18,36,nailed his scrotum,1,1,2
3DWGDA5POF5IT426YY5Y80O2L821VV,"#3-17 In 2013, he nailed his scrotum in Moscow's Red Square naming the art as ""Fixation"".",29,36,scrotum,9,5,14
3DWGDA5POF5IT426YY5Y80O2L821VV,"#3-17 In 2013, he nailed his scrotum in Moscow's Red Square naming the art as ""Fixation"".",79,87,Fixation,8,3,11
368IUKXGA590V667IS8GX4Q17VH6PD,"#13-17 Matt O'Brien of The Washington Post claims a large tax cut that would result for the wealthiest 1% of citizens if Obamacare funds were not converted to other purposes, estimated at about $32,820 annually per person by the Tax Policy Center, is also a significant motive.",7,18,Matt OBrien,0,1,1
368IUKXGA590V667IS8GX4Q17VH6PD,"#13-17 Matt O'Brien of The Washington Post claims a large tax cut that would result for the wealthiest 1% of citizens if Obamacare funds were not converted to other purposes, estimated at about $32,820 annually per person by the Tax Policy Center, is also a significant motive.",27,42,Washington Post,1,0,1
368IUKXGA590V667IS8GX4Q17VH6PD,"#13-17 Matt O'Brien of The Washington Post claims a large tax cut that would result for the wealthiest 1% of citizens if Obamacare funds were not converted to other purposes, estimated at about $32,820 annually per person by the Tax Policy Center, is also a significant motive.",43,49,claims,3,0,3
368IUKXGA590V667IS8GX4Q17VH6PD,"#13-17 Matt O'Brien of The Washington Post claims a large tax cut that would result for the wealthiest 1% of citizens if Obamacare funds were not converted to other purposes, estimated at about $32,820 annually per person by the Tax Policy Center, is also a significant motive.",58,65,tax cut,2,0,2
368IUKXGA590V667IS8GX4Q17VH6PD,"#13-17 Matt O'Brien of The Washington Post claims a large tax cut that would result for the wealthiest 1% of citizens if Obamacare funds were not converted to other purposes, estimated at about $32,820 annually per person by the Tax Policy Center, is also a significant motive.",92,102,wealthiest,3,6,9
368IUKXGA590V667IS8GX4Q17VH6PD,"#13-17 Matt O'Brien of The Washington Post claims a large tax cut that would result for the wealthiest 1% of citizens if Obamacare funds were not converted to other purposes, estimated at about $32,820 annually per person by the Tax Policy Center, is also a significant motive.",109,117,citizens,1,0,1
368IUKXGA590V667IS8GX4Q17VH6PD,"#13-17 Matt O'Brien of The Washington Post claims a large tax cut that would result for the wealthiest 1% of citizens if Obamacare funds were not converted to other purposes, estimated at about $32,820 annually per person by the Tax Policy Center, is also a significant motive.",121,130,Obamacare,2,1,3
368IUKXGA590V667IS8GX4Q17VH6PD,"#13-17 Matt O'Brien of The Washington Post claims a large tax cut that would result for the wealthiest 1% of citizens if Obamacare funds were not converted to other purposes, estimated at about $32,820 annually per person by the Tax Policy Center, is also a significant motive.",131,136,funds,1,0,1
368IUKXGA590V667IS8GX4Q17VH6PD,"#13-17 Matt O'Brien of The Washington Post claims a large tax cut that would result for the wealthiest 1% of citizens if Obamacare funds were not converted to other purposes, estimated at about $32,820 annually per person by the Tax Policy Center, is also a significant motive.",146,155,converted,6,2,8
368IUKXGA590V667IS8GX4Q17VH6PD,"#13-17 Matt O'Brien of The Washington Post claims a large tax cut that would result for the wealthiest 1% of citizens if Obamacare funds were not converted to other purposes, estimated at about $32,820 annually per person by the Tax Policy Center, is also a significant motive.",165,173,purposes,0,1,1
368IUKXGA590V667IS8GX4Q17VH6PD,"#13-17 Matt O'Brien of The Washington Post claims a large tax cut that would result for the wealthiest 1% of citizens if Obamacare funds were not converted to other purposes, estimated at about $32,820 annually per person by the Tax Policy Center, is also a significant motive.",175,184,estimated,6,3,9
368IUKXGA590V667IS8GX4Q17VH6PD,"#13-17 Matt O'Brien of The Washington Post claims a large tax cut that would result for the wealthiest 1% of citizens if Obamacare funds were not converted to other purposes, estimated at about $32,820 annually per person by the Tax Policy Center, is also a significant motive.",202,210,annually,2,3,5
368IUKXGA590V667IS8GX4Q17VH6PD,"#13-17 Matt O'Brien of The Washington Post claims a large tax cut that would result for the wealthiest 1% of citizens if Obamacare funds were not converted to other purposes, estimated at about $32,820 annually per person by the Tax Policy Center, is also a significant motive.",233,239,Policy,0,1,1
368IUKXGA590V667IS8GX4Q17VH6PD,"#13-17 Matt O'Brien of The Washington Post claims a large tax cut that would result for the wealthiest 1% of citizens if Obamacare funds were not converted to other purposes, estimated at about $32,820 annually per person by the Tax Policy Center, is also a significant motive.",258,269,significant,8,4,12
368IUKXGA590V667IS8GX4Q17VH6PD,"#13-17 Matt O'Brien of The Washington Post claims a large tax cut that would result for the wealthiest 1% of citizens if Obamacare funds were not converted to other purposes, estimated at about $32,820 annually per person by the Tax Policy Center, is also a significant motive.",258,276,significant motive,1,1,2
368IUKXGA590V667IS8GX4Q17VH6PD,"#13-17 Matt O'Brien of The Washington Post claims a large tax cut that would result for the wealthiest 1% of citizens if Obamacare funds were not converted to other purposes, estimated at about $32,820 annually per person by the Tax Policy Center, is also a significant motive.",270,276,motive,1,5,6
368IUKXGA590V667IS8GX4Q17VH6PD,"#13-18 Republican Senators set a date of January 27 to repeal Obamacare, according to NBC News.",7,17,Republican,1,0,1
368IUKXGA590V667IS8GX4Q17VH6PD,"#13-18 Republican Senators set a date of January 27 to repeal Obamacare, according to NBC News.",7,26,Republican Senators,2,0,2
368IUKXGA590V667IS8GX4Q17VH6PD,"#13-18 Republican Senators set a date of January 27 to repeal Obamacare, according to NBC News.",18,26,Senators,0,1,1
368IUKXGA590V667IS8GX4Q17VH6PD,"#13-18 Republican Senators set a date of January 27 to repeal Obamacare, according to NBC News.",55,61,repeal,5,6,11
368IUKXGA590V667IS8GX4Q17VH6PD,"#13-18 Republican Senators set a date of January 27 to repeal Obamacare, according to NBC News.",62,71,Obamacare,2,1,3
368IUKXGA590V667IS8GX4Q17VH6PD,#13-19 House Majority Leader Kevin McCarthy of California says legislation repealing Obamacare and replacing it could ready by late February.,7,21,House Majority,1,0,1
368IUKXGA590V667IS8GX4Q17VH6PD,#13-19 House Majority Leader Kevin McCarthy of California says legislation repealing Obamacare and replacing it could ready by late February.,13,21,Majority,0,1,1
368IUKXGA590V667IS8GX4Q17VH6PD,#13-19 House Majority Leader Kevin McCarthy of California says legislation repealing Obamacare and replacing it could ready by late February.,29,43,Kevin McCarthy,0,1,1
368IUKXGA590V667IS8GX4Q17VH6PD,#13-19 House Majority Leader Kevin McCarthy of California says legislation repealing Obamacare and replacing it could ready by late February.,63,74,legislation,6,3,9
368IUKXGA590V667IS8GX4Q17VH6PD,#13-19 House Majority Leader Kevin McCarthy of California says legislation repealing Obamacare and replacing it could ready by late February.,63,84,legislation repealing,2,2,4
368IUKXGA590V667IS8GX4Q17VH6PD,#13-19 House Majority Leader Kevin McCarthy of California says legislation repealing Obamacare and replacing it could ready by late February.,75,84,repealing,4,7,11
368IUKXGA590V667IS8GX4Q17VH6PD,#13-19 House Majority Leader Kevin McCarthy of California says legislation repealing Obamacare and replacing it could ready by late February.,85,94,Obamacare,2,1,3
368IUKXGA590V667IS8GX4Q17VH6PD,#13-19 House Majority Leader Kevin McCarthy of California says legislation repealing Obamacare and replacing it could ready by late February.,99,108,replacing,0,2,2
368IUKXGA590V667IS8GX4Q17VH6PD,"#13-20 According to Democratic Senator Bernie Sanders, as many as 30 million people could lose their health insurance if the ACA is repealed",20,30,Democratic,2,0,2
368IUKXGA590V667IS8GX4Q17VH6PD,"#13-20 According to Democratic Senator Bernie Sanders, as many as 30 million people could lose their health insurance if the ACA is repealed",31,38,Senator,0,1,1
368IUKXGA590V667IS8GX4Q17VH6PD,"#13-20 According to Democratic Senator Bernie Sanders, as many as 30 million people could lose their health insurance if the ACA is repealed",69,76,million,0,1,1
368IUKXGA590V667IS8GX4Q17VH6PD,"#13-20 According to Democratic Senator Bernie Sanders, as many as 30 million people could lose their health insurance if the ACA is repealed",101,117,health insurance,1,0,1
368IUKXGA590V667IS8GX4Q17VH6PD,"#13-20 According to Democratic Senator Bernie Sanders, as many as 30 million people could lose their health insurance if the ACA is repealed",108,117,insurance,2,1,3
368IUKXGA590V667IS8GX4Q17VH6PD,"#13-20 According to Democratic Senator Bernie Sanders, as many as 30 million people could lose their health insurance if the ACA is repealed",125,128,ACA,0,2,2
368IUKXGA590V667IS8GX4Q17VH6PD,"#14-1 Fighter jet crashes during Children's Day airshow in Thailand A fighter jet crashed, killing the pilot, at Hat Yai International Airport, Songkhla​, Thailand this morning during an annual Children's Day airshow.",14,25,jet crashes,0,1,1
368IUKXGA590V667IS8GX4Q17VH6PD,"#14-1 Fighter jet crashes during Children's Day airshow in Thailand A fighter jet crashed, killing the pilot, at Hat Yai International Airport, Songkhla​, Thailand this morning during an annual Children's Day airshow.",18,25,crashes,0,1,1
368IUKXGA590V667IS8GX4Q17VH6PD,"#14-1 Fighter jet crashes during Children's Day airshow in Thailand A fighter jet crashed, killing the pilot, at Hat Yai International Airport, Songkhla​, Thailand this morning during an annual Children's Day airshow.",48,55,airshow,2,5,7
368IUKXGA590V667IS8GX4Q17VH6PD,"#14-1 Fighter jet crashes during Children's Day airshow in Thailand A fighter jet crashed, killing the pilot, at Hat Yai International Airport, Songkhla​, Thailand this morning during an annual Children's Day airshow.",59,67,Thailand,0,1,1
368IUKXGA590V667IS8GX4Q17VH6PD,"#14-1 Fighter jet crashes during Children's Day airshow in Thailand A fighter jet crashed, killing the pilot, at Hat Yai International Airport, Songkhla​, Thailand this morning during an annual Children's Day airshow.",82,89,crashed,0,1,1
368IUKXGA590V667IS8GX4Q17VH6PD,"#14-1 Fighter jet crashes during Children's Day airshow in Thailand A fighter jet crashed, killing the pilot, at Hat Yai International Airport, Songkhla​, Thailand this morning during an annual Children's Day airshow.",103,108,pilot,2,0,2
368IUKXGA590V667IS8GX4Q17VH6PD,"#14-1 Fighter jet crashes during Children's Day airshow in Thailand A fighter jet crashed, killing the pilot, at Hat Yai International Airport, Songkhla​, Thailand this morning during an annual Children's Day airshow.",121,134,International,1,0,1
368IUKXGA590V667IS8GX4Q17VH6PD,"#14-1 Fighter jet crashes during Children's Day airshow in Thailand A fighter jet crashed, killing the pilot, at Hat Yai International Airport, Songkhla​, Thailand this morning during an annual Children's Day airshow.",144,153,Songkhla​,0,1,1
368IUKXGA590V667IS8GX4Q17VH6PD,"#14-1 Fighter jet crashes during Children's Day airshow in Thailand A fighter jet crashed, killing the pilot, at Hat Yai International Airport, Songkhla​, Thailand this morning during an annual Children's Day airshow.",187,193,annual,1,0,1
368IUKXGA590V667IS8GX4Q17VH6PD,"#14-1 Fighter jet crashes during Children's Day airshow in Thailand A fighter jet crashed, killing the pilot, at Hat Yai International Airport, Songkhla​, Thailand this morning during an annual Children's Day airshow.",209,216,airshow,3,3,6
33NOQL7T9O0HDOR1YG3G8GO6NPE8ZM,"#14-2 The JAS 39C Gripen crashed onto a runway at around 9:30 am local time (0230 UTC) and exploded, closing the airport to commercial flights.",18,24,Gripen,3,1,4
33NOQL7T9O0HDOR1YG3G8GO6NPE8ZM,"#14-2 The JAS 39C Gripen crashed onto a runway at around 9:30 am local time (0230 UTC) and exploded, closing the airport to commercial flights.",25,32,crashed,2,1,3
33NOQL7T9O0HDOR1YG3G8GO6NPE8ZM,"#14-2 The JAS 39C Gripen crashed onto a runway at around 9:30 am local time (0230 UTC) and exploded, closing the airport to commercial flights.",40,46,runway,1,3,4
33NOQL7T9O0HDOR1YG3G8GO6NPE8ZM,"#14-2 The JAS 39C Gripen crashed onto a runway at around 9:30 am local time (0230 UTC) and exploded, closing the airport to commercial flights.",91,99,exploded,3,6,9
33NOQL7T9O0HDOR1YG3G8GO6NPE8ZM,"#14-2 The JAS 39C Gripen crashed onto a runway at around 9:30 am local time (0230 UTC) and exploded, closing the airport to commercial flights.",124,134,commercial,9,1,10
33NOQL7T9O0HDOR1YG3G8GO6NPE8ZM,#14-3 The pilot was identified as Squadron Leader Dilokrit Pattavee.,20,30,identified,2,1,3
33NOQL7T9O0HDOR1YG3G8GO6NPE8ZM,#14-3 The pilot was identified as Squadron Leader Dilokrit Pattavee.,34,42,Squadron,2,2,4
33NOQL7T9O0HDOR1YG3G8GO6NPE8ZM,#14-3 The pilot was identified as Squadron Leader Dilokrit Pattavee.,34,49,Squadron Leader,5,0,5
33NOQL7T9O0HDOR1YG3G8GO6NPE8ZM,#14-3 The pilot was identified as Squadron Leader Dilokrit Pattavee.,50,67,Dilokrit Pattavee,0,1,1
33NOQL7T9O0HDOR1YG3G8GO6NPE8ZM,#14-4 Local media reports an airport fire vehicle rolled over while responding.,42,49,vehicle,1,0,1
33NOQL7T9O0HDOR1YG3G8GO6NPE8ZM,#14-4 Local media reports an airport fire vehicle rolled over while responding.,42,61,vehicle rolled over,0,1,1
33NOQL7T9O0HDOR1YG3G8GO6NPE8ZM,#14-4 Local media reports an airport fire vehicle rolled over while responding.,50,56,rolled,1,3,4
33NOQL7T9O0HDOR1YG3G8GO6NPE8ZM,#14-4 Local media reports an airport fire vehicle rolled over while responding.,50,61,rolled over,1,0,1
33NOQL7T9O0HDOR1YG3G8GO6NPE8ZM,#14-4 Local media reports an airport fire vehicle rolled over while responding.,68,78,responding,1,3,4
33NOQL7T9O0HDOR1YG3G8GO6NPE8ZM,#14-5 Children screamed in video footage of the crash.,15,23,screamed,3,5,8
33NOQL7T9O0HDOR1YG3G8GO6NPE8ZM,#14-5 Children screamed in video footage of the crash.,27,40,video footage,0,2,2
33NOQL7T9O0HDOR1YG3G8GO6NPE8ZM,#14-5 Children screamed in video footage of the crash.,33,40,footage,3,2,5
33NOQL7T9O0HDOR1YG3G8GO6NPE8ZM,#14-5 Children screamed in video footage of the crash.,48,53,crash,0,1,1
33NOQL7T9O0HDOR1YG3G8GO6NPE8ZM,"#14-6 The Royal Thai Air Force asked that images of the accident not be shared, but this has not deterred the press.",10,30,Royal Thai Air Force,1,0,1
33NOQL7T9O0HDOR1YG3G8GO6NPE8ZM,"#14-6 The Royal Thai Air Force asked that images of the accident not be shared, but this has not deterred the press.",56,64,accident,2,0,2
33NOQL7T9O0HDOR1YG3G8GO6NPE8ZM,"#14-6 The Royal Thai Air Force asked that images of the accident not be shared, but this has not deterred the press.",97,105,deterred,10,10,20
33NOQL7T9O0HDOR1YG3G8GO6NPE8ZM,#14-7 Air Force spokesperson Pongsak Semachai said an investigatory commission would be formed.,16,28,spokesperson,5,2,7
33NOQL7T9O0HDOR1YG3G8GO6NPE8ZM,#14-7 Air Force spokesperson Pongsak Semachai said an investigatory commission would be formed.,29,45,Pongsak Semachai,0,1,1
33NOQL7T9O0HDOR1YG3G8GO6NPE8ZM,#14-7 Air Force spokesperson Pongsak Semachai said an investigatory commission would be formed.,54,67,investigatory,3,3,6
33NOQL7T9O0HDOR1YG3G8GO6NPE8ZM,#14-7 Air Force spokesperson Pongsak Semachai said an investigatory commission would be formed.,54,78,investigatory commission,9,3,12
33NOQL7T9O0HDOR1YG3G8GO6NPE8ZM,#14-7 Air Force spokesperson Pongsak Semachai said an investigatory commission would be formed.,68,78,commission,1,0,1
33NOQL7T9O0HDOR1YG3G8GO6NPE8ZM,#14-7 Air Force spokesperson Pongsak Semachai said an investigatory commission would be formed.,88,94,formed,1,0,1
33NOQL7T9O0HDOR1YG3G8GO6NPE8ZM,#14-8 Prime Minister Prayut Chan-o-cha offered his sympathies to Pattavee's relatives.,21,38,Prayut Chan-o-cha,0,1,1
33NOQL7T9O0HDOR1YG3G8GO6NPE8ZM,#14-8 Prime Minister Prayut Chan-o-cha offered his sympathies to Pattavee's relatives.,39,46,offered,0,1,1
33NOQL7T9O0HDOR1YG3G8GO6NPE8ZM,#14-8 Prime Minister Prayut Chan-o-cha offered his sympathies to Pattavee's relatives.,39,61,offered his sympathies,0,1,1
33NOQL7T9O0HDOR1YG3G8GO6NPE8ZM,#14-8 Prime Minister Prayut Chan-o-cha offered his sympathies to Pattavee's relatives.,51,61,sympathies,10,6,16
33NOQL7T9O0HDOR1YG3G8GO6NPE8ZM,#14-8 Prime Minister Prayut Chan-o-cha offered his sympathies to Pattavee's relatives.,65,74,Pattavees,0,1,1
33NOQL7T9O0HDOR1YG3G8GO6NPE8ZM,#14-8 Prime Minister Prayut Chan-o-cha offered his sympathies to Pattavee's relatives.,76,85,relatives,1,1,2
33NOQL7T9O0HDOR1YG3G8GO6NPE8ZM,#14-9 Thailand began purchasing the Swedish-built Gripen jets in 2008 and has twelve.,21,31,purchasing,0,2,2
33NOQL7T9O0HDOR1YG3G8GO6NPE8ZM,#14-9 Thailand began purchasing the Swedish-built Gripen jets in 2008 and has twelve.,50,61,Gripen jets,1,0,1
33NOQL7T9O0HDOR1YG3G8GO6NPE8ZM,"#14-10 None of its neighbours have similar aircraft, which cost the nation around 2.5 billion baht (US$70 million) each.",19,29,neighbours,3,0,3
33NOQL7T9O0HDOR1YG3G8GO6NPE8ZM,"#14-10 None of its neighbours have similar aircraft, which cost the nation around 2.5 billion baht (US$70 million) each.",43,51,aircraft,0,1,1
33NOQL7T9O0HDOR1YG3G8GO6NPE8ZM,"#14-10 None of its neighbours have similar aircraft, which cost the nation around 2.5 billion baht (US$70 million) each.",94,98,baht,4,0,4
34O39PNDK69RDV3HRBTDDFC8MEGBRV,#11-2 These experiments were performed on laboratory mice.,12,23,experiments,7,1,8
34O39PNDK69RDV3HRBTDDFC8MEGBRV,#11-2 These experiments were performed on laboratory mice.,29,38,performed,3,1,4
34O39PNDK69RDV3HRBTDDFC8MEGBRV,#11-2 These experiments were performed on laboratory mice.,42,52,laboratory,8,1,9
34O39PNDK69RDV3HRBTDDFC8MEGBRV,#11-2 These experiments were performed on laboratory mice.,42,57,laboratory mice,0,1,1
34O39PNDK69RDV3HRBTDDFC8MEGBRV,#11-2 These experiments were performed on laboratory mice.,53,57,mice,0,2,2
34O39PNDK69RDV3HRBTDDFC8MEGBRV,#11-3 The research team used an engineered virus to target and alter specific sets of neurons.,10,18,research,0,1,1
34O39PNDK69RDV3HRBTDDFC8MEGBRV,#11-3 The research team used an engineered virus to target and alter specific sets of neurons.,32,42,engineered,4,2,6
34O39PNDK69RDV3HRBTDDFC8MEGBRV,#11-3 The research team used an engineered virus to target and alter specific sets of neurons.,32,48,engineered virus,2,1,3
34O39PNDK69RDV3HRBTDDFC8MEGBRV,#11-3 The research team used an engineered virus to target and alter specific sets of neurons.,43,48,virus,1,0,1
34O39PNDK69RDV3HRBTDDFC8MEGBRV,#11-3 The research team used an engineered virus to target and alter specific sets of neurons.,52,58,target,0,1,1
34O39PNDK69RDV3HRBTDDFC8MEGBRV,#11-3 The research team used an engineered virus to target and alter specific sets of neurons.,63,68,alter,1,0,1
34O39PNDK69RDV3HRBTDDFC8MEGBRV,#11-3 The research team used an engineered virus to target and alter specific sets of neurons.,69,77,specific,1,0,1
34O39PNDK69RDV3HRBTDDFC8MEGBRV,#11-3 The research team used an engineered virus to target and alter specific sets of neurons.,69,82,specific sets,0,2,2
34O39PNDK69RDV3HRBTDDFC8MEGBRV,#11-3 The research team used an engineered virus to target and alter specific sets of neurons.,86,93,neurons,10,3,13
34O39PNDK69RDV3HRBTDDFC8MEGBRV,#11-4 Then they fitted the mice with intracranial optical fibers so they could expose their brains to blue light at will.,16,22,fitted,0,2,2
34O39PNDK69RDV3HRBTDDFC8MEGBRV,#11-4 Then they fitted the mice with intracranial optical fibers so they could expose their brains to blue light at will.,37,49,intracranial,9,9,18
34O39PNDK69RDV3HRBTDDFC8MEGBRV,#11-4 Then they fitted the mice with intracranial optical fibers so they could expose their brains to blue light at will.,37,64,intracranial optical fibers,4,3,7
34O39PNDK69RDV3HRBTDDFC8MEGBRV,#11-4 Then they fitted the mice with intracranial optical fibers so they could expose their brains to blue light at will.,50,57,optical,4,0,4
34O39PNDK69RDV3HRBTDDFC8MEGBRV,#11-4 Then they fitted the mice with intracranial optical fibers so they could expose their brains to blue light at will.,58,64,fibers,1,1,2
34O39PNDK69RDV3HRBTDDFC8MEGBRV,#11-4 Then they fitted the mice with intracranial optical fibers so they could expose their brains to blue light at will.,79,85,expose,1,0,1
34O39PNDK69RDV3HRBTDDFC8MEGBRV,"#11-5 The system excited two different sets of neurons, both located in the amygdala, which is the part of the brain associated with emotion and aggression.",17,24,excited,1,2,3
34O39PNDK69RDV3HRBTDDFC8MEGBRV,"#11-5 The system excited two different sets of neurons, both located in the amygdala, which is the part of the brain associated with emotion and aggression.",47,54,neurons,3,1,4
34O39PNDK69RDV3HRBTDDFC8MEGBRV,"#11-5 The system excited two different sets of neurons, both located in the amygdala, which is the part of the brain associated with emotion and aggression.",76,84,amygdala,10,6,16
34O39PNDK69RDV3HRBTDDFC8MEGBRV,"#11-5 The system excited two different sets of neurons, both located in the amygdala, which is the part of the brain associated with emotion and aggression.",133,155,emotion and aggression,1,0,1
34O39PNDK69RDV3HRBTDDFC8MEGBRV,"#11-5 The system excited two different sets of neurons, both located in the amygdala, which is the part of the brain associated with emotion and aggression.",145,155,aggression,3,6,9
34O39PNDK69RDV3HRBTDDFC8MEGBRV,"#11-6 One set stimulated prey pursuit behavior, such as stalking, and the other stimulated the animal to use its jaw and neck muscles.",14,24,stimulated,3,5,8
34O39PNDK69RDV3HRBTDDFC8MEGBRV,"#11-6 One set stimulated prey pursuit behavior, such as stalking, and the other stimulated the animal to use its jaw and neck muscles.",14,37,stimulated prey pursuit,1,0,1
34O39PNDK69RDV3HRBTDDFC8MEGBRV,"#11-6 One set stimulated prey pursuit behavior, such as stalking, and the other stimulated the animal to use its jaw and neck muscles.",14,46,stimulated prey pursuit behavior,2,1,3
34O39PNDK69RDV3HRBTDDFC8MEGBRV,"#11-6 One set stimulated prey pursuit behavior, such as stalking, and the other stimulated the animal to use its jaw and neck muscles.",25,29,prey,2,1,3
34O39PNDK69RDV3HRBTDDFC8MEGBRV,"#11-6 One set stimulated prey pursuit behavior, such as stalking, and the other stimulated the animal to use its jaw and neck muscles.",25,37,prey pursuit,0,1,1
34O39PNDK69RDV3HRBTDDFC8MEGBRV,"#11-6 One set stimulated prey pursuit behavior, such as stalking, and the other stimulated the animal to use its jaw and neck muscles.",25,46,prey pursuit behavior,0,2,2
34O39PNDK69RDV3HRBTDDFC8MEGBRV,"#11-6 One set stimulated prey pursuit behavior, such as stalking, and the other stimulated the animal to use its jaw and neck muscles.",30,37,pursuit,5,4,9
34O39PNDK69RDV3HRBTDDFC8MEGBRV,"#11-6 One set stimulated prey pursuit behavior, such as stalking, and the other stimulated the animal to use its jaw and neck muscles.",38,46,behavior,2,0,2
34O39PNDK69RDV3HRBTDDFC8MEGBRV,"#11-6 One set stimulated prey pursuit behavior, such as stalking, and the other stimulated the animal to use its jaw and neck muscles.",56,64,stalking,3,5,8
34O39PNDK69RDV3HRBTDDFC8MEGBRV,"#11-6 One set stimulated prey pursuit behavior, such as stalking, and the other stimulated the animal to use its jaw and neck muscles.",80,90,stimulated,2,5,7
34O39PNDK69RDV3HRBTDDFC8MEGBRV,"#11-6 One set stimulated prey pursuit behavior, such as stalking, and the other stimulated the animal to use its jaw and neck muscles.",113,116,jaw,0,1,1
34O39PNDK69RDV3HRBTDDFC8MEGBRV,"#11-7 When exposed to the laser, the primed mice would first stalk and then pounce on and bite any object in their enclosure, even objects without any food scent or prey value, like sticks and bottle caps.",11,18,exposed,0,1,1
34O39PNDK69RDV3HRBTDDFC8MEGBRV,"#11-7 When exposed to the laser, the primed mice would first stalk and then pounce on and bite any object in their enclosure, even objects without any food scent or prey value, like sticks and bottle caps.",37,43,primed,5,3,8
34O39PNDK69RDV3HRBTDDFC8MEGBRV,"#11-7 When exposed to the laser, the primed mice would first stalk and then pounce on and bite any object in their enclosure, even objects without any food scent or prey value, like sticks and bottle caps.",37,48,primed mice,0,1,1
34O39PNDK69RDV3HRBTDDFC8MEGBRV,"#11-7 When exposed to the laser, the primed mice would first stalk and then pounce on and bite any object in their enclosure, even objects without any food scent or prey value, like sticks and bottle caps.",61,66,stalk,1,2,3
34O39PNDK69RDV3HRBTDDFC8MEGBRV,"#11-7 When exposed to the laser, the primed mice would first stalk and then pounce on and bite any object in their enclosure, even objects without any food scent or prey value, like sticks and bottle caps.",61,82,stalk and then pounce,0,1,1
34O39PNDK69RDV3HRBTDDFC8MEGBRV,"#11-7 When exposed to the laser, the primed mice would first stalk and then pounce on and bite any object in their enclosure, even objects without any food scent or prey value, like sticks and bottle caps.",76,82,pounce,4,5,9
34O39PNDK69RDV3HRBTDDFC8MEGBRV,"#11-7 When exposed to the laser, the primed mice would first stalk and then pounce on and bite any object in their enclosure, even objects without any food scent or prey value, like sticks and bottle caps.",76,85,pounce on,0,1,1
34O39PNDK69RDV3HRBTDDFC8MEGBRV,"#11-7 When exposed to the laser, the primed mice would first stalk and then pounce on and bite any object in their enclosure, even objects without any food scent or prey value, like sticks and bottle caps.",115,124,enclosure,1,5,6
34O39PNDK69RDV3HRBTDDFC8MEGBRV,"#11-7 When exposed to the laser, the primed mice would first stalk and then pounce on and bite any object in their enclosure, even objects without any food scent or prey value, like sticks and bottle caps.",156,161,scent,1,0,1
34O39PNDK69RDV3HRBTDDFC8MEGBRV,"#11-7 When exposed to the laser, the primed mice would first stalk and then pounce on and bite any object in their enclosure, even objects without any food scent or prey value, like sticks and bottle caps.",165,169,prey,0,1,1
3EHVO81VN5MDB37MT9OUTZXTDTRH1L,"#13-11 Representative Tom MacArthur of New Jersey agreed, saying, ""We're loading a gun here.",7,21,Representative,9,3,12
3EHVO81VN5MDB37MT9OUTZXTDTRH1L,"#13-12 I want to know where it's pointed before we start the process.""",22,39,where its pointed,1,0,1
3EHVO81VN5MDB37MT9OUTZXTDTRH1L,"#13-12 I want to know where it's pointed before we start the process.""",61,68,process,3,1,4
3EHVO81VN5MDB37MT9OUTZXTDTRH1L,"#13-13 Anna Merlan of Jezebel and Anthony Taylor of the Associated Press dismiss Trump's timeline as ""impossible"" given the complicated nature of U.S. congressional workings.",22,29,Jezebel,1,0,1
3EHVO81VN5MDB37MT9OUTZXTDTRH1L,"#13-13 Anna Merlan of Jezebel and Anthony Taylor of the Associated Press dismiss Trump's timeline as ""impossible"" given the complicated nature of U.S. congressional workings.",56,66,Associated,1,0,1
3EHVO81VN5MDB37MT9OUTZXTDTRH1L,"#13-13 Anna Merlan of Jezebel and Anthony Taylor of the Associated Press dismiss Trump's timeline as ""impossible"" given the complicated nature of U.S. congressional workings.",56,72,Associated Press,1,0,1
3EHVO81VN5MDB37MT9OUTZXTDTRH1L,"#13-13 Anna Merlan of Jezebel and Anthony Taylor of the Associated Press dismiss Trump's timeline as ""impossible"" given the complicated nature of U.S. congressional workings.",73,80,dismiss,3,4,7
3EHVO81VN5MDB37MT9OUTZXTDTRH1L,"#13-13 Anna Merlan of Jezebel and Anthony Taylor of the Associated Press dismiss Trump's timeline as ""impossible"" given the complicated nature of U.S. congressional workings.",89,97,timeline,0,4,4
3EHVO81VN5MDB37MT9OUTZXTDTRH1L,"#13-13 Anna Merlan of Jezebel and Anthony Taylor of the Associated Press dismiss Trump's timeline as ""impossible"" given the complicated nature of U.S. congressional workings.",102,112,impossible,0,1,1
3EHVO81VN5MDB37MT9OUTZXTDTRH1L,"#13-13 Anna Merlan of Jezebel and Anthony Taylor of the Associated Press dismiss Trump's timeline as ""impossible"" given the complicated nature of U.S. congressional workings.",124,135,complicated,2,2,4
3EHVO81VN5MDB37MT9OUTZXTDTRH1L,"#13-13 Anna Merlan of Jezebel and Anthony Taylor of the Associated Press dismiss Trump's timeline as ""impossible"" given the complicated nature of U.S. congressional workings.",124,142,complicated nature,1,2,3
3EHVO81VN5MDB37MT9OUTZXTDTRH1L,"#13-13 Anna Merlan of Jezebel and Anthony Taylor of the Associated Press dismiss Trump's timeline as ""impossible"" given the complicated nature of U.S. congressional workings.",151,164,congressional,7,3,10
3EHVO81VN5MDB37MT9OUTZXTDTRH1L,"#13-13 Anna Merlan of Jezebel and Anthony Taylor of the Associated Press dismiss Trump's timeline as ""impossible"" given the complicated nature of U.S. congressional workings.",151,173,congressional workings,2,1,3
3EHVO81VN5MDB37MT9OUTZXTDTRH1L,"#13-13 Anna Merlan of Jezebel and Anthony Taylor of the Associated Press dismiss Trump's timeline as ""impossible"" given the complicated nature of U.S. congressional workings.",165,173,workings,1,0,1
3EHVO81VN5MDB37MT9OUTZXTDTRH1L,"#13-14 Senator Collins agreed, saying ""I don't see any possibility of our being able to come up with a comprehensive reform bill that would replace Obamacare by the end of this month.",55,66,possibility,3,0,3
3EHVO81VN5MDB37MT9OUTZXTDTRH1L,"#13-14 Senator Collins agreed, saying ""I don't see any possibility of our being able to come up with a comprehensive reform bill that would replace Obamacare by the end of this month.",103,116,comprehensive,9,8,17
3EHVO81VN5MDB37MT9OUTZXTDTRH1L,"#13-14 Senator Collins agreed, saying ""I don't see any possibility of our being able to come up with a comprehensive reform bill that would replace Obamacare by the end of this month.",103,123,comprehensive reform,3,2,5
3EHVO81VN5MDB37MT9OUTZXTDTRH1L,"#13-14 Senator Collins agreed, saying ""I don't see any possibility of our being able to come up with a comprehensive reform bill that would replace Obamacare by the end of this month.",103,128,comprehensive reform bill,3,0,3
3EHVO81VN5MDB37MT9OUTZXTDTRH1L,"#13-14 Senator Collins agreed, saying ""I don't see any possibility of our being able to come up with a comprehensive reform bill that would replace Obamacare by the end of this month.",117,123,reform,1,1,2
3EHVO81VN5MDB37MT9OUTZXTDTRH1L,"#13-14 Senator Collins agreed, saying ""I don't see any possibility of our being able to come up with a comprehensive reform bill that would replace Obamacare by the end of this month.",117,128,reform bill,1,0,1
3EHVO81VN5MDB37MT9OUTZXTDTRH1L,"#13-14 Senator Collins agreed, saying ""I don't see any possibility of our being able to come up with a comprehensive reform bill that would replace Obamacare by the end of this month.",124,128,bill,0,1,1
3EHVO81VN5MDB37MT9OUTZXTDTRH1L,"#13-14 Senator Collins agreed, saying ""I don't see any possibility of our being able to come up with a comprehensive reform bill that would replace Obamacare by the end of this month.",148,157,Obamacare,2,0,2
3EHVO81VN5MDB37MT9OUTZXTDTRH1L,"#13-15 I just don't see that as being feasible.""",38,46,feasible,8,10,18
3EHVO81VN5MDB37MT9OUTZXTDTRH1L,"#13-16 The Affordable Care Act, which is often cited as a key accomplishment of the Obama administration, has had a mixed reputation, and many conservatives believe a market-based health care system would be more flexible and efficient and less costly, and many believe that the Affordable Care Act only passed because of Obama's later discredited pledge that no one who liked their current health plan would have to switch.",7,30,The Affordable Care Act,1,0,1
3EHVO81VN5MDB37MT9OUTZXTDTRH1L,"#13-16 The Affordable Care Act, which is often cited as a key accomplishment of the Obama administration, has had a mixed reputation, and many conservatives believe a market-based health care system would be more flexible and efficient and less costly, and many believe that the Affordable Care Act only passed because of Obama's later discredited pledge that no one who liked their current health plan would have to switch.",11,21,Affordable,0,3,3
3EHVO81VN5MDB37MT9OUTZXTDTRH1L,"#13-16 The Affordable Care Act, which is often cited as a key accomplishment of the Obama administration, has had a mixed reputation, and many conservatives believe a market-based health care system would be more flexible and efficient and less costly, and many believe that the Affordable Care Act only passed because of Obama's later discredited pledge that no one who liked their current health plan would have to switch.",47,52,cited,0,1,1
3EHVO81VN5MDB37MT9OUTZXTDTRH1L,"#13-16 The Affordable Care Act, which is often cited as a key accomplishment of the Obama administration, has had a mixed reputation, and many conservatives believe a market-based health care system would be more flexible and efficient and less costly, and many believe that the Affordable Care Act only passed because of Obama's later discredited pledge that no one who liked their current health plan would have to switch.",58,76,key accomplishment,0,1,1
3EHVO81VN5MDB37MT9OUTZXTDTRH1L,"#13-16 The Affordable Care Act, which is often cited as a key accomplishment of the Obama administration, has had a mixed reputation, and many conservatives believe a market-based health care system would be more flexible and efficient and less costly, and many believe that the Affordable Care Act only passed because of Obama's later discredited pledge that no one who liked their current health plan would have to switch.",62,76,accomplishment,6,8,14
3EHVO81VN5MDB37MT9OUTZXTDTRH1L,"#13-16 The Affordable Care Act, which is often cited as a key accomplishment of the Obama administration, has had a mixed reputation, and many conservatives believe a market-based health care system would be more flexible and efficient and less costly, and many believe that the Affordable Care Act only passed because of Obama's later discredited pledge that no one who liked their current health plan would have to switch.",90,104,administration,1,0,1
3EHVO81VN5MDB37MT9OUTZXTDTRH1L,"#13-16 The Affordable Care Act, which is often cited as a key accomplishment of the Obama administration, has had a mixed reputation, and many conservatives believe a market-based health care system would be more flexible and efficient and less costly, and many believe that the Affordable Care Act only passed because of Obama's later discredited pledge that no one who liked their current health plan would have to switch.",116,132,mixed reputation,1,0,1
3EHVO81VN5MDB37MT9OUTZXTDTRH1L,"#13-16 The Affordable Care Act, which is often cited as a key accomplishment of the Obama administration, has had a mixed reputation, and many conservatives believe a market-based health care system would be more flexible and efficient and less costly, and many believe that the Affordable Care Act only passed because of Obama's later discredited pledge that no one who liked their current health plan would have to switch.",122,132,reputation,4,4,8
3EHVO81VN5MDB37MT9OUTZXTDTRH1L,"#13-16 The Affordable Care Act, which is often cited as a key accomplishment of the Obama administration, has had a mixed reputation, and many conservatives believe a market-based health care system would be more flexible and efficient and less costly, and many believe that the Affordable Care Act only passed because of Obama's later discredited pledge that no one who liked their current health plan would have to switch.",143,156,conservatives,3,4,7
3EHVO81VN5MDB37MT9OUTZXTDTRH1L,"#13-16 The Affordable Care Act, which is often cited as a key accomplishment of the Obama administration, has had a mixed reputation, and many conservatives believe a market-based health care system would be more flexible and efficient and less costly, and many believe that the Affordable Care Act only passed because of Obama's later discredited pledge that no one who liked their current health plan would have to switch.",167,179,market-based,3,1,4
3EHVO81VN5MDB37MT9OUTZXTDTRH1L,"#13-16 The Affordable Care Act, which is often cited as a key accomplishment of the Obama administration, has had a mixed reputation, and many conservatives believe a market-based health care system would be more flexible and efficient and less costly, and many believe that the Affordable Care Act only passed because of Obama's later discredited pledge that no one who liked their current health plan would have to switch.",167,198,market-based health care system,1,0,1
3EHVO81VN5MDB37MT9OUTZXTDTRH1L,"#13-16 The Affordable Care Act, which is often cited as a key accomplishment of the Obama administration, has had a mixed reputation, and many conservatives believe a market-based health care system would be more flexible and efficient and less costly, and many believe that the Affordable Care Act only passed because of Obama's later discredited pledge that no one who liked their current health plan would have to switch.",213,221,flexible,0,3,3
3EHVO81VN5MDB37MT9OUTZXTDTRH1L,"#13-16 The Affordable Care Act, which is often cited as a key accomplishment of the Obama administration, has had a mixed reputation, and many conservatives believe a market-based health care system would be more flexible and efficient and less costly, and many believe that the Affordable Care Act only passed because of Obama's later discredited pledge that no one who liked their current health plan would have to switch.",226,235,efficient,1,2,3
3EHVO81VN5MDB37MT9OUTZXTDTRH1L,"#13-16 The Affordable Care Act, which is often cited as a key accomplishment of the Obama administration, has had a mixed reputation, and many conservatives believe a market-based health care system would be more flexible and efficient and less costly, and many believe that the Affordable Care Act only passed because of Obama's later discredited pledge that no one who liked their current health plan would have to switch.",245,251,costly,1,0,1
3EHVO81VN5MDB37MT9OUTZXTDTRH1L,"#13-16 The Affordable Care Act, which is often cited as a key accomplishment of the Obama administration, has had a mixed reputation, and many conservatives believe a market-based health care system would be more flexible and efficient and less costly, and many believe that the Affordable Care Act only passed because of Obama's later discredited pledge that no one who liked their current health plan would have to switch.",279,289,Affordable,0,1,1
3EHVO81VN5MDB37MT9OUTZXTDTRH1L,"#13-16 The Affordable Care Act, which is often cited as a key accomplishment of the Obama administration, has had a mixed reputation, and many conservatives believe a market-based health care system would be more flexible and efficient and less costly, and many believe that the Affordable Care Act only passed because of Obama's later discredited pledge that no one who liked their current health plan would have to switch.",279,298,Affordable Care Act,1,0,1
3EHVO81VN5MDB37MT9OUTZXTDTRH1L,"#13-16 The Affordable Care Act, which is often cited as a key accomplishment of the Obama administration, has had a mixed reputation, and many conservatives believe a market-based health care system would be more flexible and efficient and less costly, and many believe that the Affordable Care Act only passed because of Obama's later discredited pledge that no one who liked their current health plan would have to switch.",336,347,discredited,6,5,11
3EHVO81VN5MDB37MT9OUTZXTDTRH1L,"#13-16 The Affordable Care Act, which is often cited as a key accomplishment of the Obama administration, has had a mixed reputation, and many conservatives believe a market-based health care system would be more flexible and efficient and less costly, and many believe that the Affordable Care Act only passed because of Obama's later discredited pledge that no one who liked their current health plan would have to switch.",336,354,discredited pledge,4,2,6
3EHVO81VN5MDB37MT9OUTZXTDTRH1L,"#13-16 The Affordable Care Act, which is often cited as a key accomplishment of the Obama administration, has had a mixed reputation, and many conservatives believe a market-based health care system would be more flexible and efficient and less costly, and many believe that the Affordable Care Act only passed because of Obama's later discredited pledge that no one who liked their current health plan would have to switch.",348,354,pledge,2,5,7
3EHVO81VN5MDB37MT9OUTZXTDTRH1L,"#13-16 The Affordable Care Act, which is often cited as a key accomplishment of the Obama administration, has had a mixed reputation, and many conservatives believe a market-based health care system would be more flexible and efficient and less costly, and many believe that the Affordable Care Act only passed because of Obama's later discredited pledge that no one who liked their current health plan would have to switch.",417,423,switch,1,2,3
37VHPF5VYC445VGR62J8XINLE7SC8R,"#7-9 Following the collision Manas airport was closed, and yesterday was declared a day of national mourning in Kyrgyzstan.",19,28,collision,9,6,15
37VHPF5VYC445VGR62J8XINLE7SC8R,"#7-9 Following the collision Manas airport was closed, and yesterday was declared a day of national mourning in Kyrgyzstan.",35,42,airport,1,0,1
37VHPF5VYC445VGR62J8XINLE7SC8R,"#7-9 Following the collision Manas airport was closed, and yesterday was declared a day of national mourning in Kyrgyzstan.",59,68,yesterday,1,0,1
37VHPF5VYC445VGR62J8XINLE7SC8R,"#7-9 Following the collision Manas airport was closed, and yesterday was declared a day of national mourning in Kyrgyzstan.",91,108,national mourning,1,1,2
37VHPF5VYC445VGR62J8XINLE7SC8R,"#7-9 Following the collision Manas airport was closed, and yesterday was declared a day of national mourning in Kyrgyzstan.",100,108,mourning,9,6,15
37VHPF5VYC445VGR62J8XINLE7SC8R,"#7-9 Following the collision Manas airport was closed, and yesterday was declared a day of national mourning in Kyrgyzstan.",112,122,Kyrgyzstan,3,1,4
37VHPF5VYC445VGR62J8XINLE7SC8R,#7-10 The flight was operated by ACT Airlines.,10,16,flight,1,0,1
37VHPF5VYC445VGR62J8XINLE7SC8R,#7-10 The flight was operated by ACT Airlines.,21,29,operated,2,1,3
37VHPF5VYC445VGR62J8XINLE7SC8R,"#7-11 Manas international airport is located outside the capital city of Bishkek, and has been the location of other fatal crashes.",12,25,international,3,0,3
37VHPF5VYC445VGR62J8XINLE7SC8R,"#7-11 Manas international airport is located outside the capital city of Bishkek, and has been the location of other fatal crashes.",73,80,Bishkek,2,0,2
37VHPF5VYC445VGR62J8XINLE7SC8R,"#7-11 Manas international airport is located outside the capital city of Bishkek, and has been the location of other fatal crashes.",117,122,fatal,6,4,10
37VHPF5VYC445VGR62J8XINLE7SC8R,"#7-11 Manas international airport is located outside the capital city of Bishkek, and has been the location of other fatal crashes.",117,130,fatal crashes,0,2,2
37VHPF5VYC445VGR62J8XINLE7SC8R,"#7-11 Manas international airport is located outside the capital city of Bishkek, and has been the location of other fatal crashes.",123,130,crashes,0,2,2
37VHPF5VYC445VGR62J8XINLE7SC8R,"#7-12 These include a Boeing 737 en route to Iran, which crashed shortly after take-off in 2008, killing 68 of at least 90 people on board.",33,41,en route,0,3,3
37VHPF5VYC445VGR62J8XINLE7SC8R,"#7-12 These include a Boeing 737 en route to Iran, which crashed shortly after take-off in 2008, killing 68 of at least 90 people on board.",57,64,crashed,0,2,2
37VHPF5VYC445VGR62J8XINLE7SC8R,"#7-12 These include a Boeing 737 en route to Iran, which crashed shortly after take-off in 2008, killing 68 of at least 90 people on board.",65,87,shortly after take-off,1,0,1
37VHPF5VYC445VGR62J8XINLE7SC8R,"#7-12 These include a Boeing 737 en route to Iran, which crashed shortly after take-off in 2008, killing 68 of at least 90 people on board.",79,87,take-off,1,3,4
37VHPF5VYC445VGR62J8XINLE7SC8R,"#7-12 These include a Boeing 737 en route to Iran, which crashed shortly after take-off in 2008, killing 68 of at least 90 people on board.",123,138,people on board,0,1,1
37VHPF5VYC445VGR62J8XINLE7SC8R,"#7-12 These include a Boeing 737 en route to Iran, which crashed shortly after take-off in 2008, killing 68 of at least 90 people on board.",130,138,on board,1,0,1
37VHPF5VYC445VGR62J8XINLE7SC8R,"#7-12 These include a Boeing 737 en route to Iran, which crashed shortly after take-off in 2008, killing 68 of at least 90 people on board.",133,138,board,1,0,1
37VHPF5VYC445VGR62J8XINLE7SC8R,#8-1 Robben signs contract extension with Bayern German football club FC Bayern Munich yesterday announced Dutch winger Arjen Robben has signed a one contract extension until June 2018.,18,26,contract,2,2,4
37VHPF5VYC445VGR62J8XINLE7SC8R,#8-1 Robben signs contract extension with Bayern German football club FC Bayern Munich yesterday announced Dutch winger Arjen Robben has signed a one contract extension until June 2018.,18,36,contract extension,2,1,3
37VHPF5VYC445VGR62J8XINLE7SC8R,#8-1 Robben signs contract extension with Bayern German football club FC Bayern Munich yesterday announced Dutch winger Arjen Robben has signed a one contract extension until June 2018.,27,36,extension,3,5,8
37VHPF5VYC445VGR62J8XINLE7SC8R,#8-1 Robben signs contract extension with Bayern German football club FC Bayern Munich yesterday announced Dutch winger Arjen Robben has signed a one contract extension until June 2018.,42,70,Bayern  German football club,1,0,1
37VHPF5VYC445VGR62J8XINLE7SC8R,#8-1 Robben signs contract extension with Bayern German football club FC Bayern Munich yesterday announced Dutch winger Arjen Robben has signed a one contract extension until June 2018.,97,106,announced,2,0,2
37VHPF5VYC445VGR62J8XINLE7SC8R,#8-1 Robben signs contract extension with Bayern German football club FC Bayern Munich yesterday announced Dutch winger Arjen Robben has signed a one contract extension until June 2018.,107,119,Dutch winger,0,2,2
37VHPF5VYC445VGR62J8XINLE7SC8R,#8-1 Robben signs contract extension with Bayern German football club FC Bayern Munich yesterday announced Dutch winger Arjen Robben has signed a one contract extension until June 2018.,113,119,winger,3,1,4
37VHPF5VYC445VGR62J8XINLE7SC8R,#8-1 Robben signs contract extension with Bayern German football club FC Bayern Munich yesterday announced Dutch winger Arjen Robben has signed a one contract extension until June 2018.,120,125,Arjen,1,0,1
37VHPF5VYC445VGR62J8XINLE7SC8R,#8-1 Robben signs contract extension with Bayern German football club FC Bayern Munich yesterday announced Dutch winger Arjen Robben has signed a one contract extension until June 2018.,146,168,one contract extension,1,0,1
37VHPF5VYC445VGR62J8XINLE7SC8R,#8-1 Robben signs contract extension with Bayern German football club FC Bayern Munich yesterday announced Dutch winger Arjen Robben has signed a one contract extension until June 2018.,150,168,contract extension,1,0,1
37VHPF5VYC445VGR62J8XINLE7SC8R,#8-1 Robben signs contract extension with Bayern German football club FC Bayern Munich yesterday announced Dutch winger Arjen Robben has signed a one contract extension until June 2018.,159,168,extension,6,2,8
37VHPF5VYC445VGR62J8XINLE7SC8R,"#8-3 Spending seven years with Munich, Robben has scored 82 goals in 152 Bundesliga appearances and netted 23 goals in 53 UEFA Champions League matches.",5,13,Spending,1,0,1
37VHPF5VYC445VGR62J8XINLE7SC8R,"#8-3 Spending seven years with Munich, Robben has scored 82 goals in 152 Bundesliga appearances and netted 23 goals in 53 UEFA Champions League matches.",31,37,Munich,0,1,1
37VHPF5VYC445VGR62J8XINLE7SC8R,"#8-3 Spending seven years with Munich, Robben has scored 82 goals in 152 Bundesliga appearances and netted 23 goals in 53 UEFA Champions League matches.",50,56,scored,1,0,1
37VHPF5VYC445VGR62J8XINLE7SC8R,"#8-3 Spending seven years with Munich, Robben has scored 82 goals in 152 Bundesliga appearances and netted 23 goals in 53 UEFA Champions League matches.",73,83,Bundesliga,2,1,3
37VHPF5VYC445VGR62J8XINLE7SC8R,"#8-3 Spending seven years with Munich, Robben has scored 82 goals in 152 Bundesliga appearances and netted 23 goals in 53 UEFA Champions League matches.",73,95,Bundesliga appearances,1,0,1
37VHPF5VYC445VGR62J8XINLE7SC8R,"#8-3 Spending seven years with Munich, Robben has scored 82 goals in 152 Bundesliga appearances and netted 23 goals in 53 UEFA Champions League matches.",84,95,appearances,4,3,7
37VHPF5VYC445VGR62J8XINLE7SC8R,"#8-3 Spending seven years with Munich, Robben has scored 82 goals in 152 Bundesliga appearances and netted 23 goals in 53 UEFA Champions League matches.",100,106,netted,3,10,13
37VHPF5VYC445VGR62J8XINLE7SC8R,"#8-3 Spending seven years with Munich, Robben has scored 82 goals in 152 Bundesliga appearances and netted 23 goals in 53 UEFA Champions League matches.",137,143,League,2,0,2
3OEWW2KGQJCHVF9LDF3FEAV3EC8OD6,"#42-105 For example, once we find the source of the medicine in nature... would species without access to this source also have evolved the same behaviour in the lab?",38,44,source,0,1,1
3OEWW2KGQJCHVF9LDF3FEAV3EC8OD6,"#42-105 For example, once we find the source of the medicine in nature... would species without access to this source also have evolved the same behaviour in the lab?",52,60,medicine,0,1,1
3OEWW2KGQJCHVF9LDF3FEAV3EC8OD6,"#42-105 For example, once we find the source of the medicine in nature... would species without access to this source also have evolved the same behaviour in the lab?",52,70,medicine in nature,1,0,1
3OEWW2KGQJCHVF9LDF3FEAV3EC8OD6,"#42-105 For example, once we find the source of the medicine in nature... would species without access to this source also have evolved the same behaviour in the lab?",80,87,species,3,4,7
3OEWW2KGQJCHVF9LDF3FEAV3EC8OD6,"#42-105 For example, once we find the source of the medicine in nature... would species without access to this source also have evolved the same behaviour in the lab?",96,102,access,2,2,4
3OEWW2KGQJCHVF9LDF3FEAV3EC8OD6,"#42-105 For example, once we find the source of the medicine in nature... would species without access to this source also have evolved the same behaviour in the lab?",111,117,source,0,1,1
3OEWW2KGQJCHVF9LDF3FEAV3EC8OD6,"#42-105 For example, once we find the source of the medicine in nature... would species without access to this source also have evolved the same behaviour in the lab?",128,135,evolved,7,3,10
3OEWW2KGQJCHVF9LDF3FEAV3EC8OD6,"#42-105 For example, once we find the source of the medicine in nature... would species without access to this source also have evolved the same behaviour in the lab?",128,154,evolved the same behaviour,1,0,1
3OEWW2KGQJCHVF9LDF3FEAV3EC8OD6,"#42-105 For example, once we find the source of the medicine in nature... would species without access to this source also have evolved the same behaviour in the lab?",145,154,behaviour,4,1,5
3OEWW2KGQJCHVF9LDF3FEAV3EC8OD6,#42-107 Also... can ants medicate their friends?,25,33,medicate,5,5,10
3OEWW2KGQJCHVF9LDF3FEAV3EC8OD6,#42-108 :) Wikinews: What other research are you working on right now?,32,40,research,1,1,2
3OEWW2KGQJCHVF9LDF3FEAV3EC8OD6,#42-109 NB Phew...lots!,11,15,Phew,1,1,2
3OEWW2KGQJCHVF9LDF3FEAV3EC8OD6,#42-110 I still have some questions left unanswered from my Ph.D. work related to how ants recognize who is a friend and who isn't.,26,35,questions,1,0,1
3OEWW2KGQJCHVF9LDF3FEAV3EC8OD6,#42-110 I still have some questions left unanswered from my Ph.D. work related to how ants recognize who is a friend and who isn't.,41,51,unanswered,4,5,9
3OEWW2KGQJCHVF9LDF3FEAV3EC8OD6,#42-110 I still have some questions left unanswered from my Ph.D. work related to how ants recognize who is a friend and who isn't.,60,64,Ph.D,1,0,1
3OEWW2KGQJCHVF9LDF3FEAV3EC8OD6,#42-110 I still have some questions left unanswered from my Ph.D. work related to how ants recognize who is a friend and who isn't.,86,90,ants,0,1,1
3OEWW2KGQJCHVF9LDF3FEAV3EC8OD6,#42-110 I still have some questions left unanswered from my Ph.D. work related to how ants recognize who is a friend and who isn't.,91,100,recognize,5,5,10
3OEWW2KGQJCHVF9LDF3FEAV3EC8OD6,"#42-111 I also started collaborating with Prof. Michael Poulsen from the University of Copenhagen on immunity in fungus-growing termites, as well as their chemical recognition abilities.",23,36,collaborating,8,8,16
3OEWW2KGQJCHVF9LDF3FEAV3EC8OD6,"#42-111 I also started collaborating with Prof. Michael Poulsen from the University of Copenhagen on immunity in fungus-growing termites, as well as their chemical recognition abilities.",87,97,Copenhagen,0,2,2
3OEWW2KGQJCHVF9LDF3FEAV3EC8OD6,"#42-111 I also started collaborating with Prof. Michael Poulsen from the University of Copenhagen on immunity in fungus-growing termites, as well as their chemical recognition abilities.",101,109,immunity,8,7,15
3OEWW2KGQJCHVF9LDF3FEAV3EC8OD6,"#42-111 I also started collaborating with Prof. Michael Poulsen from the University of Copenhagen on immunity in fungus-growing termites, as well as their chemical recognition abilities.",101,136,immunity in fungus-growing termites,1,0,1
3OEWW2KGQJCHVF9LDF3FEAV3EC8OD6,"#42-111 I also started collaborating with Prof. Michael Poulsen from the University of Copenhagen on immunity in fungus-growing termites, as well as their chemical recognition abilities.",113,127,fungus-growing,6,3,9
3OEWW2KGQJCHVF9LDF3FEAV3EC8OD6,"#42-111 I also started collaborating with Prof. Michael Poulsen from the University of Copenhagen on immunity in fungus-growing termites, as well as their chemical recognition abilities.",113,136,fungus-growing termites,0,2,2
3OEWW2KGQJCHVF9LDF3FEAV3EC8OD6,"#42-111 I also started collaborating with Prof. Michael Poulsen from the University of Copenhagen on immunity in fungus-growing termites, as well as their chemical recognition abilities.",128,136,termites,6,7,13
3OEWW2KGQJCHVF9LDF3FEAV3EC8OD6,"#42-111 I also started collaborating with Prof. Michael Poulsen from the University of Copenhagen on immunity in fungus-growing termites, as well as their chemical recognition abilities.",155,163,chemical,2,0,2
3OEWW2KGQJCHVF9LDF3FEAV3EC8OD6,"#42-111 I also started collaborating with Prof. Michael Poulsen from the University of Copenhagen on immunity in fungus-growing termites, as well as their chemical recognition abilities.",155,175,chemical recognition,1,0,1
3OEWW2KGQJCHVF9LDF3FEAV3EC8OD6,"#42-111 I also started collaborating with Prof. Michael Poulsen from the University of Copenhagen on immunity in fungus-growing termites, as well as their chemical recognition abilities.",155,185,chemical recognition abilities,4,0,4
3OEWW2KGQJCHVF9LDF3FEAV3EC8OD6,"#42-111 I also started collaborating with Prof. Michael Poulsen from the University of Copenhagen on immunity in fungus-growing termites, as well as their chemical recognition abilities.",164,175,recognition,4,2,6
3OEWW2KGQJCHVF9LDF3FEAV3EC8OD6,"#42-111 I also started collaborating with Prof. Michael Poulsen from the University of Copenhagen on immunity in fungus-growing termites, as well as their chemical recognition abilities.",164,185,recognition abilities,0,2,2
3OEWW2KGQJCHVF9LDF3FEAV3EC8OD6,"#42-112 Furthermore we're working on social parasitism in wood-ants (ants have lots of animals exploiting the nest for shelter and resources, which all somehow have to get in to the fortress without getting killed).",8,19,Furthermore,2,1,3
3OEWW2KGQJCHVF9LDF3FEAV3EC8OD6,"#42-112 Furthermore we're working on social parasitism in wood-ants (ants have lots of animals exploiting the nest for shelter and resources, which all somehow have to get in to the fortress without getting killed).",37,54,social parasitism,4,2,6
3OEWW2KGQJCHVF9LDF3FEAV3EC8OD6,"#42-112 Furthermore we're working on social parasitism in wood-ants (ants have lots of animals exploiting the nest for shelter and resources, which all somehow have to get in to the fortress without getting killed).",44,54,parasitism,10,8,18
3OEWW2KGQJCHVF9LDF3FEAV3EC8OD6,"#42-112 Furthermore we're working on social parasitism in wood-ants (ants have lots of animals exploiting the nest for shelter and resources, which all somehow have to get in to the fortress without getting killed).",58,67,wood-ants,1,2,3
3OEWW2KGQJCHVF9LDF3FEAV3EC8OD6,"#42-112 Furthermore we're working on social parasitism in wood-ants (ants have lots of animals exploiting the nest for shelter and resources, which all somehow have to get in to the fortress without getting killed).",95,105,exploiting,6,4,10
3OEWW2KGQJCHVF9LDF3FEAV3EC8OD6,"#42-112 Furthermore we're working on social parasitism in wood-ants (ants have lots of animals exploiting the nest for shelter and resources, which all somehow have to get in to the fortress without getting killed).",110,114,nest,0,1,1
3OEWW2KGQJCHVF9LDF3FEAV3EC8OD6,"#42-112 Furthermore we're working on social parasitism in wood-ants (ants have lots of animals exploiting the nest for shelter and resources, which all somehow have to get in to the fortress without getting killed).",119,126,shelter,1,2,3
3OEWW2KGQJCHVF9LDF3FEAV3EC8OD6,"#42-112 Furthermore we're working on social parasitism in wood-ants (ants have lots of animals exploiting the nest for shelter and resources, which all somehow have to get in to the fortress without getting killed).",131,140,resources,1,2,3
3OEWW2KGQJCHVF9LDF3FEAV3EC8OD6,"#42-112 Furthermore we're working on social parasitism in wood-ants (ants have lots of animals exploiting the nest for shelter and resources, which all somehow have to get in to the fortress without getting killed).",152,159,somehow,0,1,1
3OEWW2KGQJCHVF9LDF3FEAV3EC8OD6,"#42-112 Furthermore we're working on social parasitism in wood-ants (ants have lots of animals exploiting the nest for shelter and resources, which all somehow have to get in to the fortress without getting killed).",182,190,fortress,7,6,13
3AXFSPQOYQZ0SOWKO860UEH2RVEJFT,#42-26 WWikinews: What methods and equipment were used for this investigation?,23,30,methods,2,0,2
3AXFSPQOYQZ0SOWKO860UEH2RVEJFT,#42-26 WWikinews: What methods and equipment were used for this investigation?,35,44,equipment,8,5,13
3AXFSPQOYQZ0SOWKO860UEH2RVEJFT,"#42-28 I try to work on a very low budget, and like to build most of the experimental setups myself (we actually have equipment in the lab nicknamed the 'Nickinator', 'i-Nick' and the 'Nicktendo64').",31,41,low budget,0,2,2
3AXFSPQOYQZ0SOWKO860UEH2RVEJFT,"#42-28 I try to work on a very low budget, and like to build most of the experimental setups myself (we actually have equipment in the lab nicknamed the 'Nickinator', 'i-Nick' and the 'Nicktendo64').",35,41,budget,6,4,10
3AXFSPQOYQZ0SOWKO860UEH2RVEJFT,"#42-28 I try to work on a very low budget, and like to build most of the experimental setups myself (we actually have equipment in the lab nicknamed the 'Nickinator', 'i-Nick' and the 'Nicktendo64').",73,85,experimental,10,1,11
3AXFSPQOYQZ0SOWKO860UEH2RVEJFT,"#42-28 I try to work on a very low budget, and like to build most of the experimental setups myself (we actually have equipment in the lab nicknamed the 'Nickinator', 'i-Nick' and the 'Nicktendo64').",73,92,experimental setups,1,2,3
3AXFSPQOYQZ0SOWKO860UEH2RVEJFT,"#42-28 I try to work on a very low budget, and like to build most of the experimental setups myself (we actually have equipment in the lab nicknamed the 'Nickinator', 'i-Nick' and the 'Nicktendo64').",86,92,setups,0,4,4
3AXFSPQOYQZ0SOWKO860UEH2RVEJFT,"#42-28 I try to work on a very low budget, and like to build most of the experimental setups myself (we actually have equipment in the lab nicknamed the 'Nickinator', 'i-Nick' and the 'Nicktendo64').",118,127,equipment,4,1,5
3AXFSPQOYQZ0SOWKO860UEH2RVEJFT,"#42-28 I try to work on a very low budget, and like to build most of the experimental setups myself (we actually have equipment in the lab nicknamed the 'Nickinator', 'i-Nick' and the 'Nicktendo64').",139,148,nicknamed,2,6,8
3AXFSPQOYQZ0SOWKO860UEH2RVEJFT,"#42-28 I try to work on a very low budget, and like to build most of the experimental setups myself (we actually have equipment in the lab nicknamed the 'Nickinator', 'i-Nick' and the 'Nicktendo64').",154,164,Nickinator,2,1,3
3AXFSPQOYQZ0SOWKO860UEH2RVEJFT,"#42-28 I try to work on a very low budget, and like to build most of the experimental setups myself (we actually have equipment in the lab nicknamed the 'Nickinator', 'i-Nick' and the 'Nicktendo64').",168,174,i-Nick,1,0,1
3AXFSPQOYQZ0SOWKO860UEH2RVEJFT,"#42-29 There's not that much money in fundamental science at the moment, so I try to cut the costs wherever possible.",38,49,fundamental,10,7,17
3AXFSPQOYQZ0SOWKO860UEH2RVEJFT,"#42-29 There's not that much money in fundamental science at the moment, so I try to cut the costs wherever possible.",38,57,fundamental science,2,1,3
3AXFSPQOYQZ0SOWKO860UEH2RVEJFT,"#42-29 There's not that much money in fundamental science at the moment, so I try to cut the costs wherever possible.",50,57,science,2,0,2
3AXFSPQOYQZ0SOWKO860UEH2RVEJFT,"#42-29 There's not that much money in fundamental science at the moment, so I try to cut the costs wherever possible.",99,107,wherever,0,1,1
3AXFSPQOYQZ0SOWKO860UEH2RVEJFT,#42-30 We collected wild colonies of Formica fusca by searching through old tree-trunks in old logging sites in southern Finland.,20,24,wild,0,1,1
3AXFSPQOYQZ0SOWKO860UEH2RVEJFT,#42-30 We collected wild colonies of Formica fusca by searching through old tree-trunks in old logging sites in southern Finland.,20,33,wild colonies,1,1,2
3AXFSPQOYQZ0SOWKO860UEH2RVEJFT,#42-30 We collected wild colonies of Formica fusca by searching through old tree-trunks in old logging sites in southern Finland.,25,33,colonies,5,3,8
3AXFSPQOYQZ0SOWKO860UEH2RVEJFT,#42-30 We collected wild colonies of Formica fusca by searching through old tree-trunks in old logging sites in southern Finland.,37,50,Formica fusca,4,1,5
3AXFSPQOYQZ0SOWKO860UEH2RVEJFT,#42-30 We collected wild colonies of Formica fusca by searching through old tree-trunks in old logging sites in southern Finland.,45,50,fusca,2,3,5
3AXFSPQOYQZ0SOWKO860UEH2RVEJFT,#42-30 We collected wild colonies of Formica fusca by searching through old tree-trunks in old logging sites in southern Finland.,54,63,searching,0,1,1
3AXFSPQOYQZ0SOWKO860UEH2RVEJFT,#42-30 We collected wild colonies of Formica fusca by searching through old tree-trunks in old logging sites in southern Finland.,76,87,tree-trunks,1,4,5
3AXFSPQOYQZ0SOWKO860UEH2RVEJFT,#42-30 We collected wild colonies of Formica fusca by searching through old tree-trunks in old logging sites in southern Finland.,95,102,logging,2,6,8
3AXFSPQOYQZ0SOWKO860UEH2RVEJFT,#42-30 We collected wild colonies of Formica fusca by searching through old tree-trunks in old logging sites in southern Finland.,95,108,logging sites,1,3,4
3AXFSPQOYQZ0SOWKO860UEH2RVEJFT,#42-31 We then housed the ants in nests I made using Y-tong [aerated concrete].,15,21,housed,0,3,3
3AXFSPQOYQZ0SOWKO860UEH2RVEJFT,#42-31 We then housed the ants in nests I made using Y-tong [aerated concrete].,26,30,ants,0,1,1
3AXFSPQOYQZ0SOWKO860UEH2RVEJFT,#42-31 We then housed the ants in nests I made using Y-tong [aerated concrete].,34,39,nests,0,3,3
3AXFSPQOYQZ0SOWKO860UEH2RVEJFT,#42-31 We then housed the ants in nests I made using Y-tong [aerated concrete].,53,59,Y-tong,2,0,2
3AXFSPQOYQZ0SOWKO860UEH2RVEJFT,#42-31 We then housed the ants in nests I made using Y-tong [aerated concrete].,53,77,Y-tong [aerated concrete,0,1,1
3AXFSPQOYQZ0SOWKO860UEH2RVEJFT,#42-31 We then housed the ants in nests I made using Y-tong [aerated concrete].,61,68,aerated,1,1,2
3AXFSPQOYQZ0SOWKO860UEH2RVEJFT,#42-31 We then housed the ants in nests I made using Y-tong [aerated concrete].,61,77,aerated concrete,1,1,2
3AXFSPQOYQZ0SOWKO860UEH2RVEJFT,#42-31 We then housed the ants in nests I made using Y-tong [aerated concrete].,69,77,concrete,1,0,1
3AXFSPQOYQZ0SOWKO860UEH2RVEJFT,#42-32 It's very soft stone that you can easily carve.,48,53,carve,1,8,9
3AXFSPQOYQZ0SOWKO860UEH2RVEJFT,#42-33 We carved out little squares for the ants to live in (covered with old CD covers to prevent them escaping).,10,16,carved,0,2,2
3AXFSPQOYQZ0SOWKO860UEH2RVEJFT,#42-33 We carved out little squares for the ants to live in (covered with old CD covers to prevent them escaping).,74,87,old CD covers,1,0,1
3AXFSPQOYQZ0SOWKO860UEH2RVEJFT,#42-33 We carved out little squares for the ants to live in (covered with old CD covers to prevent them escaping).,91,98,prevent,1,1,2
3AXFSPQOYQZ0SOWKO860UEH2RVEJFT,#42-33 We carved out little squares for the ants to live in (covered with old CD covers to prevent them escaping).,104,112,escaping,2,1,3
3IQ9O0AYW60EGIUF1AQPZHH35PXITO,#21-11 He joined F1 team Force India in 2012.,25,36,Force India,1,0,1
3IQ9O0AYW60EGIUF1AQPZHH35PXITO,"#21-12 In 2013, he joined Marussia F1; the following year, at the 2014 Monaco Grand Prix, he scored his and Marussia's first points with a ninth-place finish.",19,25,joined,0,1,1
3IQ9O0AYW60EGIUF1AQPZHH35PXITO,"#21-12 In 2013, he joined Marussia F1; the following year, at the 2014 Monaco Grand Prix, he scored his and Marussia's first points with a ninth-place finish.",26,34,Marussia,2,2,4
3IQ9O0AYW60EGIUF1AQPZHH35PXITO,"#21-12 In 2013, he joined Marussia F1; the following year, at the 2014 Monaco Grand Prix, he scored his and Marussia's first points with a ninth-place finish.",43,52,following,1,2,3
3IQ9O0AYW60EGIUF1AQPZHH35PXITO,"#21-12 In 2013, he joined Marussia F1; the following year, at the 2014 Monaco Grand Prix, he scored his and Marussia's first points with a ninth-place finish.",71,77,Monaco,1,0,1
3IQ9O0AYW60EGIUF1AQPZHH35PXITO,"#21-12 In 2013, he joined Marussia F1; the following year, at the 2014 Monaco Grand Prix, he scored his and Marussia's first points with a ninth-place finish.",71,88,Monaco Grand Prix,1,1,2
3IQ9O0AYW60EGIUF1AQPZHH35PXITO,"#21-12 In 2013, he joined Marussia F1; the following year, at the 2014 Monaco Grand Prix, he scored his and Marussia's first points with a ninth-place finish.",78,88,Grand Prix,1,0,1
3IQ9O0AYW60EGIUF1AQPZHH35PXITO,"#21-12 In 2013, he joined Marussia F1; the following year, at the 2014 Monaco Grand Prix, he scored his and Marussia's first points with a ninth-place finish.",93,99,scored,0,2,2
3IQ9O0AYW60EGIUF1AQPZHH35PXITO,"#21-12 In 2013, he joined Marussia F1; the following year, at the 2014 Monaco Grand Prix, he scored his and Marussia's first points with a ninth-place finish.",108,117,Marussias,1,1,2
3IQ9O0AYW60EGIUF1AQPZHH35PXITO,"#21-12 In 2013, he joined Marussia F1; the following year, at the 2014 Monaco Grand Prix, he scored his and Marussia's first points with a ninth-place finish.",139,150,ninth-place,1,1,2
3IQ9O0AYW60EGIUF1AQPZHH35PXITO,"#21-12 In 2013, he joined Marussia F1; the following year, at the 2014 Monaco Grand Prix, he scored his and Marussia's first points with a ninth-place finish.",139,157,ninth-place finish,0,1,1
3IQ9O0AYW60EGIUF1AQPZHH35PXITO,"#21-13 After the accident, the FIA, which sanctions Formula One racing, formed a panel to investigate the crash.",17,25,accident,2,1,3
3IQ9O0AYW60EGIUF1AQPZHH35PXITO,"#21-13 After the accident, the FIA, which sanctions Formula One racing, formed a panel to investigate the crash.",42,51,sanctions,10,5,15
3IQ9O0AYW60EGIUF1AQPZHH35PXITO,"#21-13 After the accident, the FIA, which sanctions Formula One racing, formed a panel to investigate the crash.",52,63,Formula One,1,0,1
3IQ9O0AYW60EGIUF1AQPZHH35PXITO,"#21-13 After the accident, the FIA, which sanctions Formula One racing, formed a panel to investigate the crash.",52,70,Formula One racing,0,1,1
3IQ9O0AYW60EGIUF1AQPZHH35PXITO,"#21-13 After the accident, the FIA, which sanctions Formula One racing, formed a panel to investigate the crash.",64,70,racing,0,1,1
3IQ9O0AYW60EGIUF1AQPZHH35PXITO,"#21-13 After the accident, the FIA, which sanctions Formula One racing, formed a panel to investigate the crash.",81,86,panel,4,4,8
3IQ9O0AYW60EGIUF1AQPZHH35PXITO,"#21-13 After the accident, the FIA, which sanctions Formula One racing, formed a panel to investigate the crash.",90,101,investigate,8,5,13
3IQ9O0AYW60EGIUF1AQPZHH35PXITO,"#21-13 After the accident, the FIA, which sanctions Formula One racing, formed a panel to investigate the crash.",106,111,crash,0,2,2
3IQ9O0AYW60EGIUF1AQPZHH35PXITO,"#21-14 Afterwards, the group revealed its findings: as Bianchi entered the run-off area of the track, he disabled the failsafe mechanism by ""[applying] both throttle and brake together, using both feet"", while his front wheels were locked; the panel also stated he did not slow down enough to control his car.",7,17,Afterwards,1,2,3
3IQ9O0AYW60EGIUF1AQPZHH35PXITO,"#21-14 Afterwards, the group revealed its findings: as Bianchi entered the run-off area of the track, he disabled the failsafe mechanism by ""[applying] both throttle and brake together, using both feet"", while his front wheels were locked; the panel also stated he did not slow down enough to control his car.",29,37,revealed,2,4,6
3IQ9O0AYW60EGIUF1AQPZHH35PXITO,"#21-14 Afterwards, the group revealed its findings: as Bianchi entered the run-off area of the track, he disabled the failsafe mechanism by ""[applying] both throttle and brake together, using both feet"", while his front wheels were locked; the panel also stated he did not slow down enough to control his car.",29,50,revealed its findings,0,1,1
3IQ9O0AYW60EGIUF1AQPZHH35PXITO,"#21-14 Afterwards, the group revealed its findings: as Bianchi entered the run-off area of the track, he disabled the failsafe mechanism by ""[applying] both throttle and brake together, using both feet"", while his front wheels were locked; the panel also stated he did not slow down enough to control his car.",55,62,Bianchi,0,2,2
3IQ9O0AYW60EGIUF1AQPZHH35PXITO,"#21-14 Afterwards, the group revealed its findings: as Bianchi entered the run-off area of the track, he disabled the failsafe mechanism by ""[applying] both throttle and brake together, using both feet"", while his front wheels were locked; the panel also stated he did not slow down enough to control his car.",63,70,entered,0,1,1
3IQ9O0AYW60EGIUF1AQPZHH35PXITO,"#21-14 Afterwards, the group revealed its findings: as Bianchi entered the run-off area of the track, he disabled the failsafe mechanism by ""[applying] both throttle and brake together, using both feet"", while his front wheels were locked; the panel also stated he did not slow down enough to control his car.",75,82,run-off,1,3,4
3IQ9O0AYW60EGIUF1AQPZHH35PXITO,"#21-14 Afterwards, the group revealed its findings: as Bianchi entered the run-off area of the track, he disabled the failsafe mechanism by ""[applying] both throttle and brake together, using both feet"", while his front wheels were locked; the panel also stated he did not slow down enough to control his car.",75,87,run-off area,2,0,2
3IQ9O0AYW60EGIUF1AQPZHH35PXITO,"#21-14 Afterwards, the group revealed its findings: as Bianchi entered the run-off area of the track, he disabled the failsafe mechanism by ""[applying] both throttle and brake together, using both feet"", while his front wheels were locked; the panel also stated he did not slow down enough to control his car.",95,100,track,0,1,1
3IQ9O0AYW60EGIUF1AQPZHH35PXITO,"#21-14 Afterwards, the group revealed its findings: as Bianchi entered the run-off area of the track, he disabled the failsafe mechanism by ""[applying] both throttle and brake together, using both feet"", while his front wheels were locked; the panel also stated he did not slow down enough to control his car.",105,113,disabled,5,4,9
3IQ9O0AYW60EGIUF1AQPZHH35PXITO,"#21-14 Afterwards, the group revealed its findings: as Bianchi entered the run-off area of the track, he disabled the failsafe mechanism by ""[applying] both throttle and brake together, using both feet"", while his front wheels were locked; the panel also stated he did not slow down enough to control his car.",118,126,failsafe,8,9,17
3IQ9O0AYW60EGIUF1AQPZHH35PXITO,"#21-14 Afterwards, the group revealed its findings: as Bianchi entered the run-off area of the track, he disabled the failsafe mechanism by ""[applying] both throttle and brake together, using both feet"", while his front wheels were locked; the panel also stated he did not slow down enough to control his car.",118,136,failsafe mechanism,5,2,7
3IQ9O0AYW60EGIUF1AQPZHH35PXITO,"#21-14 Afterwards, the group revealed its findings: as Bianchi entered the run-off area of the track, he disabled the failsafe mechanism by ""[applying] both throttle and brake together, using both feet"", while his front wheels were locked; the panel also stated he did not slow down enough to control his car.",127,136,mechanism,4,2,6
3IQ9O0AYW60EGIUF1AQPZHH35PXITO,"#21-14 Afterwards, the group revealed its findings: as Bianchi entered the run-off area of the track, he disabled the failsafe mechanism by ""[applying] both throttle and brake together, using both feet"", while his front wheels were locked; the panel also stated he did not slow down enough to control his car.",157,165,throttle,10,9,19
3IQ9O0AYW60EGIUF1AQPZHH35PXITO,"#21-14 Afterwards, the group revealed its findings: as Bianchi entered the run-off area of the track, he disabled the failsafe mechanism by ""[applying] both throttle and brake together, using both feet"", while his front wheels were locked; the panel also stated he did not slow down enough to control his car.",157,184,throttle and brake together,0,1,1
3IQ9O0AYW60EGIUF1AQPZHH35PXITO,"#21-14 Afterwards, the group revealed its findings: as Bianchi entered the run-off area of the track, he disabled the failsafe mechanism by ""[applying] both throttle and brake together, using both feet"", while his front wheels were locked; the panel also stated he did not slow down enough to control his car.",170,175,brake,0,3,3
3IQ9O0AYW60EGIUF1AQPZHH35PXITO,"#21-15 Eventually, F1 mandated the use of the ""virtual safety car"", which requires drivers to enter the pit lane at slower speeds instead of proceeding around the track.",7,17,Eventually,0,3,3
3IQ9O0AYW60EGIUF1AQPZHH35PXITO,"#21-15 Eventually, F1 mandated the use of the ""virtual safety car"", which requires drivers to enter the pit lane at slower speeds instead of proceeding around the track.",22,30,mandated,10,10,20
3IQ9O0AYW60EGIUF1AQPZHH35PXITO,"#21-15 Eventually, F1 mandated the use of the ""virtual safety car"", which requires drivers to enter the pit lane at slower speeds instead of proceeding around the track.",47,65,virtual safety car,2,2,4
3IQ9O0AYW60EGIUF1AQPZHH35PXITO,"#21-15 Eventually, F1 mandated the use of the ""virtual safety car"", which requires drivers to enter the pit lane at slower speeds instead of proceeding around the track.",47,54,virtual,1,0,1
3IQ9O0AYW60EGIUF1AQPZHH35PXITO,"#21-15 Eventually, F1 mandated the use of the ""virtual safety car"", which requires drivers to enter the pit lane at slower speeds instead of proceeding around the track.",74,82,requires,0,1,1
3IQ9O0AYW60EGIUF1AQPZHH35PXITO,"#21-15 Eventually, F1 mandated the use of the ""virtual safety car"", which requires drivers to enter the pit lane at slower speeds instead of proceeding around the track.",94,112,enter the pit lane,0,1,1
3IQ9O0AYW60EGIUF1AQPZHH35PXITO,"#21-15 Eventually, F1 mandated the use of the ""virtual safety car"", which requires drivers to enter the pit lane at slower speeds instead of proceeding around the track.",100,107,the pit,1,0,1
3IQ9O0AYW60EGIUF1AQPZHH35PXITO,"#21-15 Eventually, F1 mandated the use of the ""virtual safety car"", which requires drivers to enter the pit lane at slower speeds instead of proceeding around the track.",104,107,pit,0,1,1
3IQ9O0AYW60EGIUF1AQPZHH35PXITO,"#21-15 Eventually, F1 mandated the use of the ""virtual safety car"", which requires drivers to enter the pit lane at slower speeds instead of proceeding around the track.",141,151,proceeding,9,3,12
3G9UA71JVVVNDVHE6P8O6M4LT7VJ7P,#34-12 The broadcasts began on August 10 and South Korea says the broadcasts will continue.,11,21,broadcasts,8,4,12
3G9UA71JVVVNDVHE6P8O6M4LT7VJ7P,#34-12 The broadcasts began on August 10 and South Korea says the broadcasts will continue.,66,76,broadcasts,1,2,3
3G9UA71JVVVNDVHE6P8O6M4LT7VJ7P,"#34-13 After the exchange of fire, North Korea stated it would attack any loudspeakers broadcasting propaganda and would respond, militarily, within 48 hours if the broadcasts do not stop.",17,25,exchange,3,2,5
3G9UA71JVVVNDVHE6P8O6M4LT7VJ7P,"#34-13 After the exchange of fire, North Korea stated it would attack any loudspeakers broadcasting propaganda and would respond, militarily, within 48 hours if the broadcasts do not stop.",29,33,fire,1,0,1
3G9UA71JVVVNDVHE6P8O6M4LT7VJ7P,"#34-13 After the exchange of fire, North Korea stated it would attack any loudspeakers broadcasting propaganda and would respond, militarily, within 48 hours if the broadcasts do not stop.",74,86,loudspeakers,1,1,2
3G9UA71JVVVNDVHE6P8O6M4LT7VJ7P,"#34-13 After the exchange of fire, North Korea stated it would attack any loudspeakers broadcasting propaganda and would respond, militarily, within 48 hours if the broadcasts do not stop.",74,99,loudspeakers broadcasting,0,1,1
3G9UA71JVVVNDVHE6P8O6M4LT7VJ7P,"#34-13 After the exchange of fire, North Korea stated it would attack any loudspeakers broadcasting propaganda and would respond, militarily, within 48 hours if the broadcasts do not stop.",74,110,loudspeakers broadcasting propaganda,1,0,1
3G9UA71JVVVNDVHE6P8O6M4LT7VJ7P,"#34-13 After the exchange of fire, North Korea stated it would attack any loudspeakers broadcasting propaganda and would respond, militarily, within 48 hours if the broadcasts do not stop.",87,99,broadcasting,0,1,1
3G9UA71JVVVNDVHE6P8O6M4LT7VJ7P,"#34-13 After the exchange of fire, North Korea stated it would attack any loudspeakers broadcasting propaganda and would respond, militarily, within 48 hours if the broadcasts do not stop.",100,110,propaganda,10,9,19
3G9UA71JVVVNDVHE6P8O6M4LT7VJ7P,"#34-13 After the exchange of fire, North Korea stated it would attack any loudspeakers broadcasting propaganda and would respond, militarily, within 48 hours if the broadcasts do not stop.",121,128,respond,1,1,2
3G9UA71JVVVNDVHE6P8O6M4LT7VJ7P,"#34-13 After the exchange of fire, North Korea stated it would attack any loudspeakers broadcasting propaganda and would respond, militarily, within 48 hours if the broadcasts do not stop.",130,140,militarily,4,2,6
3G9UA71JVVVNDVHE6P8O6M4LT7VJ7P,"#34-13 After the exchange of fire, North Korea stated it would attack any loudspeakers broadcasting propaganda and would respond, militarily, within 48 hours if the broadcasts do not stop.",165,175,broadcasts,1,0,1
3G9UA71JVVVNDVHE6P8O6M4LT7VJ7P,#34-14 Both countries have put their militaries on high levels of alert.,37,47,militaries,3,0,3
3G9UA71JVVVNDVHE6P8O6M4LT7VJ7P,#34-14 Both countries have put their militaries on high levels of alert.,66,71,alert,0,2,2
3G9UA71JVVVNDVHE6P8O6M4LT7VJ7P,"#35-1 UK judge withholds report from Thai death penalty defendants In a judgement released today Mr Justice Green, sitting in the High Court in London, spoke of his ""very considerable unease"" as he rejected an application by two defendants in a Thai death penalty case.",15,24,withholds,1,5,6
3G9UA71JVVVNDVHE6P8O6M4LT7VJ7P,"#35-1 UK judge withholds report from Thai death penalty defendants In a judgement released today Mr Justice Green, sitting in the High Court in London, spoke of his ""very considerable unease"" as he rejected an application by two defendants in a Thai death penalty case.",42,47,death,1,0,1
3G9UA71JVVVNDVHE6P8O6M4LT7VJ7P,"#35-1 UK judge withholds report from Thai death penalty defendants In a judgement released today Mr Justice Green, sitting in the High Court in London, spoke of his ""very considerable unease"" as he rejected an application by two defendants in a Thai death penalty case.",42,55,death penalty,0,1,1
3G9UA71JVVVNDVHE6P8O6M4LT7VJ7P,"#35-1 UK judge withholds report from Thai death penalty defendants In a judgement released today Mr Justice Green, sitting in the High Court in London, spoke of his ""very considerable unease"" as he rejected an application by two defendants in a Thai death penalty case.",48,66,penalty defendants,1,0,1
3G9UA71JVVVNDVHE6P8O6M4LT7VJ7P,"#35-1 UK judge withholds report from Thai death penalty defendants In a judgement released today Mr Justice Green, sitting in the High Court in London, spoke of his ""very considerable unease"" as he rejected an application by two defendants in a Thai death penalty case.",56,66,defendants,1,5,6
3G9UA71JVVVNDVHE6P8O6M4LT7VJ7P,"#35-1 UK judge withholds report from Thai death penalty defendants In a judgement released today Mr Justice Green, sitting in the High Court in London, spoke of his ""very considerable unease"" as he rejected an application by two defendants in a Thai death penalty case.",72,81,judgement,4,0,4
3G9UA71JVVVNDVHE6P8O6M4LT7VJ7P,"#35-1 UK judge withholds report from Thai death penalty defendants In a judgement released today Mr Justice Green, sitting in the High Court in London, spoke of his ""very considerable unease"" as he rejected an application by two defendants in a Thai death penalty case.",82,90,released,1,0,1
3G9UA71JVVVNDVHE6P8O6M4LT7VJ7P,"#35-1 UK judge withholds report from Thai death penalty defendants In a judgement released today Mr Justice Green, sitting in the High Court in London, spoke of his ""very considerable unease"" as he rejected an application by two defendants in a Thai death penalty case.",166,190,very considerable unease,1,0,1
3G9UA71JVVVNDVHE6P8O6M4LT7VJ7P,"#35-1 UK judge withholds report from Thai death penalty defendants In a judgement released today Mr Justice Green, sitting in the High Court in London, spoke of his ""very considerable unease"" as he rejected an application by two defendants in a Thai death penalty case.",171,183,considerable,2,2,4
3G9UA71JVVVNDVHE6P8O6M4LT7VJ7P,"#35-1 UK judge withholds report from Thai death penalty defendants In a judgement released today Mr Justice Green, sitting in the High Court in London, spoke of his ""very considerable unease"" as he rejected an application by two defendants in a Thai death penalty case.",171,190,considerable unease,1,2,3
3G9UA71JVVVNDVHE6P8O6M4LT7VJ7P,"#35-1 UK judge withholds report from Thai death penalty defendants In a judgement released today Mr Justice Green, sitting in the High Court in London, spoke of his ""very considerable unease"" as he rejected an application by two defendants in a Thai death penalty case.",184,190,unease,6,4,10
3G9UA71JVVVNDVHE6P8O6M4LT7VJ7P,"#35-1 UK judge withholds report from Thai death penalty defendants In a judgement released today Mr Justice Green, sitting in the High Court in London, spoke of his ""very considerable unease"" as he rejected an application by two defendants in a Thai death penalty case.",198,206,rejected,4,0,4
3G9UA71JVVVNDVHE6P8O6M4LT7VJ7P,"#35-1 UK judge withholds report from Thai death penalty defendants In a judgement released today Mr Justice Green, sitting in the High Court in London, spoke of his ""very considerable unease"" as he rejected an application by two defendants in a Thai death penalty case.",210,221,application,3,1,4
3G9UA71JVVVNDVHE6P8O6M4LT7VJ7P,"#35-1 UK judge withholds report from Thai death penalty defendants In a judgement released today Mr Justice Green, sitting in the High Court in London, spoke of his ""very considerable unease"" as he rejected an application by two defendants in a Thai death penalty case.",229,239,defendants,4,1,5
3G9UA71JVVVNDVHE6P8O6M4LT7VJ7P,"#35-1 UK judge withholds report from Thai death penalty defendants In a judgement released today Mr Justice Green, sitting in the High Court in London, spoke of his ""very considerable unease"" as he rejected an application by two defendants in a Thai death penalty case.",256,263,penalty,1,2,3
3G9UA71JVVVNDVHE6P8O6M4LT7VJ7P,#35-2 The pair sought a Metropolitan Police report they hoped could assist their defence.,15,21,sought,0,3,3
3G9UA71JVVVNDVHE6P8O6M4LT7VJ7P,#35-2 The pair sought a Metropolitan Police report they hoped could assist their defence.,24,36,Metropolitan,4,1,5
3G9UA71JVVVNDVHE6P8O6M4LT7VJ7P,#35-2 The pair sought a Metropolitan Police report they hoped could assist their defence.,68,74,assist,2,2,4
3G9UA71JVVVNDVHE6P8O6M4LT7VJ7P,#35-2 The pair sought a Metropolitan Police report they hoped could assist their defence.,68,88,assist their defence,1,0,1
3G9UA71JVVVNDVHE6P8O6M4LT7VJ7P,#35-2 The pair sought a Metropolitan Police report they hoped could assist their defence.,81,88,defence,4,0,4
3G9UA71JVVVNDVHE6P8O6M4LT7VJ7P,"#35-3 The murders occurred on the picturesque resort island of Koh Tao, pictured here from file.",10,17,murders,1,1,2
3G9UA71JVVVNDVHE6P8O6M4LT7VJ7P,"#35-3 The murders occurred on the picturesque resort island of Koh Tao, pictured here from file.",18,26,occurred,3,0,3
3G9UA71JVVVNDVHE6P8O6M4LT7VJ7P,"#35-3 The murders occurred on the picturesque resort island of Koh Tao, pictured here from file.",34,45,picturesque,10,8,18
3G9UA71JVVVNDVHE6P8O6M4LT7VJ7P,"#35-3 The murders occurred on the picturesque resort island of Koh Tao, pictured here from file.",34,59,picturesque resort island,2,0,2
3G9UA71JVVVNDVHE6P8O6M4LT7VJ7P,"#35-3 The murders occurred on the picturesque resort island of Koh Tao, pictured here from file.",63,70,Koh Tao,0,1,1
3G9UA71JVVVNDVHE6P8O6M4LT7VJ7P,"#35-3 The murders occurred on the picturesque resort island of Koh Tao, pictured here from file.",72,80,pictured,0,1,1
32W3UF2EZOM3MUTPUZTVG67GCLWC4K,"#35-23 Thai Prime Minister Chan-o-cha, pictured here in December, was directly involved in negotiations that led to the report being produced.",18,26,Minister,1,0,1
32W3UF2EZOM3MUTPUZTVG67GCLWC4K,"#35-23 Thai Prime Minister Chan-o-cha, pictured here in December, was directly involved in negotiations that led to the report being produced.",39,47,pictured,0,3,3
32W3UF2EZOM3MUTPUZTVG67GCLWC4K,"#35-23 Thai Prime Minister Chan-o-cha, pictured here in December, was directly involved in negotiations that led to the report being produced.",91,103,negotiations,10,7,17
32W3UF2EZOM3MUTPUZTVG67GCLWC4K,"#35-23 Thai Prime Minister Chan-o-cha, pictured here in December, was directly involved in negotiations that led to the report being produced.",109,112,led,0,1,1
32W3UF2EZOM3MUTPUZTVG67GCLWC4K,"#35-24 Both men say they were starved, suffocated, stripped naked, exposed to cold temperatures, beaten, threatened, and denied legal representation.",30,37,starved,1,8,9
32W3UF2EZOM3MUTPUZTVG67GCLWC4K,"#35-24 Both men say they were starved, suffocated, stripped naked, exposed to cold temperatures, beaten, threatened, and denied legal representation.",30,65,"starved, suffocated, stripped naked",1,0,1
32W3UF2EZOM3MUTPUZTVG67GCLWC4K,"#35-24 Both men say they were starved, suffocated, stripped naked, exposed to cold temperatures, beaten, threatened, and denied legal representation.",39,49,suffocated,9,8,17
32W3UF2EZOM3MUTPUZTVG67GCLWC4K,"#35-24 Both men say they were starved, suffocated, stripped naked, exposed to cold temperatures, beaten, threatened, and denied legal representation.",51,59,stripped,2,8,10
32W3UF2EZOM3MUTPUZTVG67GCLWC4K,"#35-24 Both men say they were starved, suffocated, stripped naked, exposed to cold temperatures, beaten, threatened, and denied legal representation.",51,65,stripped naked,0,1,1
32W3UF2EZOM3MUTPUZTVG67GCLWC4K,"#35-24 Both men say they were starved, suffocated, stripped naked, exposed to cold temperatures, beaten, threatened, and denied legal representation.",67,74,exposed,0,1,1
32W3UF2EZOM3MUTPUZTVG67GCLWC4K,"#35-24 Both men say they were starved, suffocated, stripped naked, exposed to cold temperatures, beaten, threatened, and denied legal representation.",83,95,temperatures,3,0,3
32W3UF2EZOM3MUTPUZTVG67GCLWC4K,"#35-24 Both men say they were starved, suffocated, stripped naked, exposed to cold temperatures, beaten, threatened, and denied legal representation.",97,103,beaten,0,1,1
32W3UF2EZOM3MUTPUZTVG67GCLWC4K,"#35-24 Both men say they were starved, suffocated, stripped naked, exposed to cold temperatures, beaten, threatened, and denied legal representation.",105,115,threatened,7,6,13
32W3UF2EZOM3MUTPUZTVG67GCLWC4K,"#35-24 Both men say they were starved, suffocated, stripped naked, exposed to cold temperatures, beaten, threatened, and denied legal representation.",121,127,denied,2,1,3
32W3UF2EZOM3MUTPUZTVG67GCLWC4K,"#35-24 Both men say they were starved, suffocated, stripped naked, exposed to cold temperatures, beaten, threatened, and denied legal representation.",121,148,denied legal representation,1,0,1
32W3UF2EZOM3MUTPUZTVG67GCLWC4K,"#35-24 Both men say they were starved, suffocated, stripped naked, exposed to cold temperatures, beaten, threatened, and denied legal representation.",128,148,legal representation,1,1,2
32W3UF2EZOM3MUTPUZTVG67GCLWC4K,"#35-24 Both men say they were starved, suffocated, stripped naked, exposed to cold temperatures, beaten, threatened, and denied legal representation.",134,148,representation,2,0,2
32W3UF2EZOM3MUTPUZTVG67GCLWC4K,#35-25 The Royal Thai Police deny any misconduct.,11,21,Royal Thai,0,1,1
32W3UF2EZOM3MUTPUZTVG67GCLWC4K,#35-25 The Royal Thai Police deny any misconduct.,38,48,misconduct,10,6,16
32W3UF2EZOM3MUTPUZTVG67GCLWC4K,#35-26 Mr Justice Green read the report himself and decided not to release it as it was of no assistance to the pair.,7,23,Mr Justice Green,0,1,1
32W3UF2EZOM3MUTPUZTVG67GCLWC4K,#35-26 Mr Justice Green read the report himself and decided not to release it as it was of no assistance to the pair.,94,104,assistance,3,0,3
32W3UF2EZOM3MUTPUZTVG67GCLWC4K,#35-27 The report is known to contain some material disputed by Lin and Phyo.,11,37,report is known to contain,0,1,1
32W3UF2EZOM3MUTPUZTVG67GCLWC4K,#35-27 The report is known to contain some material disputed by Lin and Phyo.,43,51,material,1,0,1
32W3UF2EZOM3MUTPUZTVG67GCLWC4K,#35-27 The report is known to contain some material disputed by Lin and Phyo.,52,60,disputed,5,7,12
32W3UF2EZOM3MUTPUZTVG67GCLWC4K,#35-27 The report is known to contain some material disputed by Lin and Phyo.,72,76,Phyo,1,1,2
32W3UF2EZOM3MUTPUZTVG67GCLWC4K,"#35-28 It says they repeated their confessions at various times, including in court with legal representation, before retracting them.",35,46,confessions,5,6,11
32W3UF2EZOM3MUTPUZTVG67GCLWC4K,"#35-28 It says they repeated their confessions at various times, including in court with legal representation, before retracting them.",95,109,representation,4,0,4
32W3UF2EZOM3MUTPUZTVG67GCLWC4K,"#35-28 It says they repeated their confessions at various times, including in court with legal representation, before retracting them.",118,128,retracting,10,8,18
32W3UF2EZOM3MUTPUZTVG67GCLWC4K,"#35-29 It also says they have not backed up their torture claims with evidence, medical or otherwise.",34,43,backed up,1,2,3
32W3UF2EZOM3MUTPUZTVG67GCLWC4K,"#35-29 It also says they have not backed up their torture claims with evidence, medical or otherwise.",50,57,torture,4,5,9
32W3UF2EZOM3MUTPUZTVG67GCLWC4K,"#35-29 It also says they have not backed up their torture claims with evidence, medical or otherwise.",70,78,evidence,3,0,3
32W3UF2EZOM3MUTPUZTVG67GCLWC4K,"#35-30 Mr Justice Green said the report described ""in many respects [...] no more than the routine conduct of a serious crime investigation.",29,49,the report described,0,1,1
32W3UF2EZOM3MUTPUZTVG67GCLWC4K,"#35-30 Mr Justice Green said the report described ""in many respects [...] no more than the routine conduct of a serious crime investigation.",40,49,described,2,0,2
32W3UF2EZOM3MUTPUZTVG67GCLWC4K,"#35-30 Mr Justice Green said the report described ""in many respects [...] no more than the routine conduct of a serious crime investigation.",91,98,routine,3,3,6
32W3UF2EZOM3MUTPUZTVG67GCLWC4K,"#35-30 Mr Justice Green said the report described ""in many respects [...] no more than the routine conduct of a serious crime investigation.",91,106,routine conduct,0,1,1
32W3UF2EZOM3MUTPUZTVG67GCLWC4K,"#35-30 Mr Justice Green said the report described ""in many respects [...] no more than the routine conduct of a serious crime investigation.",99,106,conduct,3,0,3
32W3UF2EZOM3MUTPUZTVG67GCLWC4K,"#35-30 Mr Justice Green said the report described ""in many respects [...] no more than the routine conduct of a serious crime investigation.",120,139,crime investigation,0,1,1
32W3UF2EZOM3MUTPUZTVG67GCLWC4K,"#35-30 Mr Justice Green said the report described ""in many respects [...] no more than the routine conduct of a serious crime investigation.",126,139,investigation,2,1,3
3PKJ68EHDNXK6KNQJYU0XZTF7ARHJP,#41-11 Extradition to Austria is possible.,7,18,Extradition,10,10,20
3PKJ68EHDNXK6KNQJYU0XZTF7ARHJP,"#41-13 The children are thought to be aged three, eight, and ten years, alongside an eighteen-month-old baby.",20,31,are thought,0,1,1
3PKJ68EHDNXK6KNQJYU0XZTF7ARHJP,"#41-13 The children are thought to be aged three, eight, and ten years, alongside an eighteen-month-old baby.",72,81,alongside,4,3,7
3PKJ68EHDNXK6KNQJYU0XZTF7ARHJP,"#41-13 The children are thought to be aged three, eight, and ten years, alongside an eighteen-month-old baby.",85,103,eighteen-month-old,1,1,2
3PKJ68EHDNXK6KNQJYU0XZTF7ARHJP,"#41-14 ""There was also a Syrian travel document found"" police spokesman Hans Peter Doskozil told journalists ""so of course our first assumption is that these people were migrants, and likely a group of Syrian migrants.",25,31,Syrian,0,1,1
3PKJ68EHDNXK6KNQJYU0XZTF7ARHJP,"#41-14 ""There was also a Syrian travel document found"" police spokesman Hans Peter Doskozil told journalists ""so of course our first assumption is that these people were migrants, and likely a group of Syrian migrants.",32,47,travel document,1,0,1
3PKJ68EHDNXK6KNQJYU0XZTF7ARHJP,"#41-14 ""There was also a Syrian travel document found"" police spokesman Hans Peter Doskozil told journalists ""so of course our first assumption is that these people were migrants, and likely a group of Syrian migrants.",39,47,document,2,1,3
3PKJ68EHDNXK6KNQJYU0XZTF7ARHJP,"#41-14 ""There was also a Syrian travel document found"" police spokesman Hans Peter Doskozil told journalists ""so of course our first assumption is that these people were migrants, and likely a group of Syrian migrants.",62,71,spokesman,1,3,4
3PKJ68EHDNXK6KNQJYU0XZTF7ARHJP,"#41-14 ""There was also a Syrian travel document found"" police spokesman Hans Peter Doskozil told journalists ""so of course our first assumption is that these people were migrants, and likely a group of Syrian migrants.",72,76,Hans,0,1,1
3PKJ68EHDNXK6KNQJYU0XZTF7ARHJP,"#41-14 ""There was also a Syrian travel document found"" police spokesman Hans Peter Doskozil told journalists ""so of course our first assumption is that these people were migrants, and likely a group of Syrian migrants.",77,91,Peter Doskozil,0,1,1
3PKJ68EHDNXK6KNQJYU0XZTF7ARHJP,"#41-14 ""There was also a Syrian travel document found"" police spokesman Hans Peter Doskozil told journalists ""so of course our first assumption is that these people were migrants, and likely a group of Syrian migrants.",83,91,Doskozil,1,0,1
3PKJ68EHDNXK6KNQJYU0XZTF7ARHJP,"#41-14 ""There was also a Syrian travel document found"" police spokesman Hans Peter Doskozil told journalists ""so of course our first assumption is that these people were migrants, and likely a group of Syrian migrants.",97,108,journalists,3,1,4
3PKJ68EHDNXK6KNQJYU0XZTF7ARHJP,"#41-14 ""There was also a Syrian travel document found"" police spokesman Hans Peter Doskozil told journalists ""so of course our first assumption is that these people were migrants, and likely a group of Syrian migrants.",127,143,first assumption,0,1,1
3PKJ68EHDNXK6KNQJYU0XZTF7ARHJP,"#41-14 ""There was also a Syrian travel document found"" police spokesman Hans Peter Doskozil told journalists ""so of course our first assumption is that these people were migrants, and likely a group of Syrian migrants.",133,143,assumption,10,6,16
3PKJ68EHDNXK6KNQJYU0XZTF7ARHJP,"#41-14 ""There was also a Syrian travel document found"" police spokesman Hans Peter Doskozil told journalists ""so of course our first assumption is that these people were migrants, and likely a group of Syrian migrants.",170,178,migrants,8,6,14
3PKJ68EHDNXK6KNQJYU0XZTF7ARHJP,"#41-14 ""There was also a Syrian travel document found"" police spokesman Hans Peter Doskozil told journalists ""so of course our first assumption is that these people were migrants, and likely a group of Syrian migrants.",202,208,Syrian,0,1,1
3PKJ68EHDNXK6KNQJYU0XZTF7ARHJP,"#41-14 ""There was also a Syrian travel document found"" police spokesman Hans Peter Doskozil told journalists ""so of course our first assumption is that these people were migrants, and likely a group of Syrian migrants.",209,217,migrants,3,0,3
3PKJ68EHDNXK6KNQJYU0XZTF7ARHJP,"#41-15 We can rule out that they were Africans"".",14,22,rule out,1,1,2
3PKJ68EHDNXK6KNQJYU0XZTF7ARHJP,"#41-16 The four accused were escorted into court in Kecskemet, central Hungary, by a police convoy.",16,23,accused,3,3,6
3PKJ68EHDNXK6KNQJYU0XZTF7ARHJP,"#41-16 The four accused were escorted into court in Kecskemet, central Hungary, by a police convoy.",29,37,escorted,8,10,18
3PKJ68EHDNXK6KNQJYU0XZTF7ARHJP,"#41-16 The four accused were escorted into court in Kecskemet, central Hungary, by a police convoy.",52,61,Kecskemet,2,0,2
3PKJ68EHDNXK6KNQJYU0XZTF7ARHJP,"#41-16 The four accused were escorted into court in Kecskemet, central Hungary, by a police convoy.",63,70,central,1,0,1
3PKJ68EHDNXK6KNQJYU0XZTF7ARHJP,"#41-16 The four accused were escorted into court in Kecskemet, central Hungary, by a police convoy.",85,98,police convoy,0,1,1
3PKJ68EHDNXK6KNQJYU0XZTF7ARHJP,"#41-16 The four accused were escorted into court in Kecskemet, central Hungary, by a police convoy.",92,98,convoy,8,5,13
3PKJ68EHDNXK6KNQJYU0XZTF7ARHJP,#41-17 Reportedly the lorry traveled from Kecskemet.,7,17,Reportedly,1,1,2
3PKJ68EHDNXK6KNQJYU0XZTF7ARHJP,#41-17 Reportedly the lorry traveled from Kecskemet.,22,27,lorry,2,1,3
3PKJ68EHDNXK6KNQJYU0XZTF7ARHJP,#41-17 Reportedly the lorry traveled from Kecskemet.,28,36,traveled,0,1,1
3PKJ68EHDNXK6KNQJYU0XZTF7ARHJP,#41-17 Reportedly the lorry traveled from Kecskemet.,42,51,Kecskemet,1,1,2
3PKJ68EHDNXK6KNQJYU0XZTF7ARHJP,"#41-18 Hungary is presently building a border fence across the Serbian frontier, as migrants from war-torn Syria and other regions seek access to the Schengen Area of free movement, which covers most of the EU.",18,27,presently,2,0,2
3PKJ68EHDNXK6KNQJYU0XZTF7ARHJP,"#41-18 Hungary is presently building a border fence across the Serbian frontier, as migrants from war-torn Syria and other regions seek access to the Schengen Area of free movement, which covers most of the EU.",28,45,building a border,1,0,1
3PKJ68EHDNXK6KNQJYU0XZTF7ARHJP,"#41-18 Hungary is presently building a border fence across the Serbian frontier, as migrants from war-torn Syria and other regions seek access to the Schengen Area of free movement, which covers most of the EU.",46,51,fence,0,2,2
3PKJ68EHDNXK6KNQJYU0XZTF7ARHJP,"#41-18 Hungary is presently building a border fence across the Serbian frontier, as migrants from war-torn Syria and other regions seek access to the Schengen Area of free movement, which covers most of the EU.",63,70,Serbian,1,0,1
3PKJ68EHDNXK6KNQJYU0XZTF7ARHJP,"#41-18 Hungary is presently building a border fence across the Serbian frontier, as migrants from war-torn Syria and other regions seek access to the Schengen Area of free movement, which covers most of the EU.",63,79,Serbian frontier,1,0,1
3PKJ68EHDNXK6KNQJYU0XZTF7ARHJP,"#41-18 Hungary is presently building a border fence across the Serbian frontier, as migrants from war-torn Syria and other regions seek access to the Schengen Area of free movement, which covers most of the EU.",71,79,frontier,5,3,8
3PKJ68EHDNXK6KNQJYU0XZTF7ARHJP,"#41-18 Hungary is presently building a border fence across the Serbian frontier, as migrants from war-torn Syria and other regions seek access to the Schengen Area of free movement, which covers most of the EU.",84,92,migrants,3,1,4
3PKJ68EHDNXK6KNQJYU0XZTF7ARHJP,"#41-18 Hungary is presently building a border fence across the Serbian frontier, as migrants from war-torn Syria and other regions seek access to the Schengen Area of free movement, which covers most of the EU.",98,106,war-torn,2,0,2
3PKJ68EHDNXK6KNQJYU0XZTF7ARHJP,"#41-18 Hungary is presently building a border fence across the Serbian frontier, as migrants from war-torn Syria and other regions seek access to the Schengen Area of free movement, which covers most of the EU.",98,112,war-torn Syria,0,1,1
3PKJ68EHDNXK6KNQJYU0XZTF7ARHJP,"#41-18 Hungary is presently building a border fence across the Serbian frontier, as migrants from war-torn Syria and other regions seek access to the Schengen Area of free movement, which covers most of the EU.",136,142,access,2,0,2
3PKJ68EHDNXK6KNQJYU0XZTF7ARHJP,"#41-18 Hungary is presently building a border fence across the Serbian frontier, as migrants from war-torn Syria and other regions seek access to the Schengen Area of free movement, which covers most of the EU.",136,145,access to,0,1,1
3PKJ68EHDNXK6KNQJYU0XZTF7ARHJP,"#41-18 Hungary is presently building a border fence across the Serbian frontier, as migrants from war-torn Syria and other regions seek access to the Schengen Area of free movement, which covers most of the EU.",150,158,Schengen,2,0,2
3PKJ68EHDNXK6KNQJYU0XZTF7ARHJP,"#41-18 Hungary is presently building a border fence across the Serbian frontier, as migrants from war-torn Syria and other regions seek access to the Schengen Area of free movement, which covers most of the EU.",172,180,movement,1,2,3
3DWNFENNE3WQU8ZV4RAH3AKB2554JQ,"#39-6 The lorry is on the so-called ""Eastern Motorway"", the A4, close to the Hungarian border.",10,15,lorry,5,3,8
3DWNFENNE3WQU8ZV4RAH3AKB2554JQ,"#39-6 The lorry is on the so-called ""Eastern Motorway"", the A4, close to the Hungarian border.",26,35,so-called,1,0,1
3DWNFENNE3WQU8ZV4RAH3AKB2554JQ,"#39-6 The lorry is on the so-called ""Eastern Motorway"", the A4, close to the Hungarian border.",37,53,Eastern Motorway,0,1,1
3DWNFENNE3WQU8ZV4RAH3AKB2554JQ,"#39-6 The lorry is on the so-called ""Eastern Motorway"", the A4, close to the Hungarian border.",45,53,Motorway,1,0,1
3DWNFENNE3WQU8ZV4RAH3AKB2554JQ,"#39-6 The lorry is on the so-called ""Eastern Motorway"", the A4, close to the Hungarian border.",77,86,Hungarian,2,1,3
3DWNFENNE3WQU8ZV4RAH3AKB2554JQ,"#39-7 It was on the hard shoulder between Neusiedl and Parndorf, closer to Parndorf.",20,33,hard shoulder,1,1,2
3DWNFENNE3WQU8ZV4RAH3AKB2554JQ,"#39-7 It was on the hard shoulder between Neusiedl and Parndorf, closer to Parndorf.",42,50,Neusiedl,2,1,3
3DWNFENNE3WQU8ZV4RAH3AKB2554JQ,"#39-7 It was on the hard shoulder between Neusiedl and Parndorf, closer to Parndorf.",55,63,Parndorf,2,1,3
3DWNFENNE3WQU8ZV4RAH3AKB2554JQ,"#39-7 It was on the hard shoulder between Neusiedl and Parndorf, closer to Parndorf.",65,71,closer,0,1,1
3DWNFENNE3WQU8ZV4RAH3AKB2554JQ,#39-8 The victims are thought to have suffocated.,10,17,victims,1,2,3
3DWNFENNE3WQU8ZV4RAH3AKB2554JQ,#39-8 The victims are thought to have suffocated.,38,48,suffocated,10,9,19
3DWNFENNE3WQU8ZV4RAH3AKB2554JQ,#39-9 Police are seeking the driver.,17,24,seeking,0,3,3
3DWNFENNE3WQU8ZV4RAH3AKB2554JQ,"#39-10 The Krone published an image of a non-articulated food lorry on the hard shoulder, which they report is the vehicle in question.",11,16,Krone,0,1,1
3DWNFENNE3WQU8ZV4RAH3AKB2554JQ,"#39-10 The Krone published an image of a non-articulated food lorry on the hard shoulder, which they report is the vehicle in question.",17,26,published,3,1,4
3DWNFENNE3WQU8ZV4RAH3AKB2554JQ,"#39-10 The Krone published an image of a non-articulated food lorry on the hard shoulder, which they report is the vehicle in question.",41,56,non-articulated,10,9,19
3DWNFENNE3WQU8ZV4RAH3AKB2554JQ,"#39-10 The Krone published an image of a non-articulated food lorry on the hard shoulder, which they report is the vehicle in question.",62,67,lorry,3,1,4
3DWNFENNE3WQU8ZV4RAH3AKB2554JQ,"#39-10 The Krone published an image of a non-articulated food lorry on the hard shoulder, which they report is the vehicle in question.",75,88,hard shoulder,0,1,1
3DWNFENNE3WQU8ZV4RAH3AKB2554JQ,"#39-10 The Krone published an image of a non-articulated food lorry on the hard shoulder, which they report is the vehicle in question.",115,122,vehicle,2,0,2
3DWNFENNE3WQU8ZV4RAH3AKB2554JQ,#39-11 The photo shows a pool of dark liquid on the ground beside the vehicle.,38,44,liquid,1,0,1
3DWNFENNE3WQU8ZV4RAH3AKB2554JQ,#39-12 Video from a passing motorist shows at least one helicopter on-scene.,20,36,passing motorist,1,0,1
3DWNFENNE3WQU8ZV4RAH3AKB2554JQ,#39-12 Video from a passing motorist shows at least one helicopter on-scene.,28,36,motorist,0,3,3
3DWNFENNE3WQU8ZV4RAH3AKB2554JQ,#39-12 Video from a passing motorist shows at least one helicopter on-scene.,56,66,helicopter,4,1,5
3DWNFENNE3WQU8ZV4RAH3AKB2554JQ,#39-12 Video from a passing motorist shows at least one helicopter on-scene.,67,75,on-scene,1,2,3
3DWNFENNE3WQU8ZV4RAH3AKB2554JQ,"#39-13 The truck, which has pictures of meat on the side, shows branding for Slovakian food firm Hyza.",64,72,branding,1,6,7
3DWNFENNE3WQU8ZV4RAH3AKB2554JQ,"#39-13 The truck, which has pictures of meat on the side, shows branding for Slovakian food firm Hyza.",77,86,Slovakian,2,0,2
3DWNFENNE3WQU8ZV4RAH3AKB2554JQ,"#39-13 The truck, which has pictures of meat on the side, shows branding for Slovakian food firm Hyza.",97,101,Hyza,2,0,2
3DWNFENNE3WQU8ZV4RAH3AKB2554JQ,"#39-14 Earlier today the company's website sported an apparent anti-immigration graphic, which has since been removed.",25,41,companys website,1,0,1
3DWNFENNE3WQU8ZV4RAH3AKB2554JQ,"#39-14 Earlier today the company's website sported an apparent anti-immigration graphic, which has since been removed.",43,50,sported,1,3,4
3DWNFENNE3WQU8ZV4RAH3AKB2554JQ,"#39-14 Earlier today the company's website sported an apparent anti-immigration graphic, which has since been removed.",54,62,apparent,6,2,8
3DWNFENNE3WQU8ZV4RAH3AKB2554JQ,"#39-14 Earlier today the company's website sported an apparent anti-immigration graphic, which has since been removed.",54,79,apparent anti-immigration,2,0,2
3DWNFENNE3WQU8ZV4RAH3AKB2554JQ,"#39-14 Earlier today the company's website sported an apparent anti-immigration graphic, which has since been removed.",54,87,apparent anti-immigration graphic,0,2,2
3DWNFENNE3WQU8ZV4RAH3AKB2554JQ,"#39-14 Earlier today the company's website sported an apparent anti-immigration graphic, which has since been removed.",63,79,anti-immigration,6,4,10
3DWNFENNE3WQU8ZV4RAH3AKB2554JQ,"#39-14 Earlier today the company's website sported an apparent anti-immigration graphic, which has since been removed.",63,87,anti-immigration graphic,2,1,3
3DWNFENNE3WQU8ZV4RAH3AKB2554JQ,"#39-14 Earlier today the company's website sported an apparent anti-immigration graphic, which has since been removed.",80,87,graphic,3,2,5
3DWNFENNE3WQU8ZV4RAH3AKB2554JQ,#39-15 Wikinews got in touch with Hyza.,7,15,Wikinews,3,0,3
3EKTG13IZU4CTOC1DGMQ5JE3SLVLM4,#41-2 Their detention relates to Thursday's discovery of a lorry full of corpses in Austria.,12,21,detention,9,6,15
3EKTG13IZU4CTOC1DGMQ5JE3SLVLM4,#41-2 Their detention relates to Thursday's discovery of a lorry full of corpses in Austria.,12,29,detention relates,1,0,1
3EKTG13IZU4CTOC1DGMQ5JE3SLVLM4,#41-2 Their detention relates to Thursday's discovery of a lorry full of corpses in Austria.,22,29,relates,0,1,1
3EKTG13IZU4CTOC1DGMQ5JE3SLVLM4,#41-2 Their detention relates to Thursday's discovery of a lorry full of corpses in Austria.,44,53,discovery,2,1,3
3EKTG13IZU4CTOC1DGMQ5JE3SLVLM4,#41-2 Their detention relates to Thursday's discovery of a lorry full of corpses in Austria.,59,64,lorry,5,2,7
3EKTG13IZU4CTOC1DGMQ5JE3SLVLM4,#41-2 Their detention relates to Thursday's discovery of a lorry full of corpses in Austria.,73,80,corpses,4,10,14
3EKTG13IZU4CTOC1DGMQ5JE3SLVLM4,#41-3 The death toll was yesterday finalised at 71.,10,20,death toll,1,1,2
3EKTG13IZU4CTOC1DGMQ5JE3SLVLM4,#41-3 The death toll was yesterday finalised at 71.,16,20,toll,0,2,2
3EKTG13IZU4CTOC1DGMQ5JE3SLVLM4,#41-3 The death toll was yesterday finalised at 71.,25,34,yesterday,0,1,1
3EKTG13IZU4CTOC1DGMQ5JE3SLVLM4,#41-3 The death toll was yesterday finalised at 71.,35,44,finalised,4,0,4
3EKTG13IZU4CTOC1DGMQ5JE3SLVLM4,"#41-4 Today's hearing took place at the Palace of Justice in Kecskemet, pictured here from file.",14,21,hearing,0,3,3
3EKTG13IZU4CTOC1DGMQ5JE3SLVLM4,"#41-4 Today's hearing took place at the Palace of Justice in Kecskemet, pictured here from file.",61,70,Kecskemet,4,1,5
3EKTG13IZU4CTOC1DGMQ5JE3SLVLM4,"#41-4 Today's hearing took place at the Palace of Justice in Kecskemet, pictured here from file.",72,80,pictured,0,1,1
3EKTG13IZU4CTOC1DGMQ5JE3SLVLM4,"#41-5 The lorry had been abandoned since Wednesday on the hard shoulder of the ""Eastern Motorway"", near the Hungarian border.",10,15,lorry,3,1,4
3EKTG13IZU4CTOC1DGMQ5JE3SLVLM4,"#41-5 The lorry had been abandoned since Wednesday on the hard shoulder of the ""Eastern Motorway"", near the Hungarian border.",25,34,abandoned,6,7,13
3EKTG13IZU4CTOC1DGMQ5JE3SLVLM4,"#41-5 The lorry had been abandoned since Wednesday on the hard shoulder of the ""Eastern Motorway"", near the Hungarian border.",58,71,hard shoulder,2,1,3
3EKTG13IZU4CTOC1DGMQ5JE3SLVLM4,"#41-5 The lorry had been abandoned since Wednesday on the hard shoulder of the ""Eastern Motorway"", near the Hungarian border.",63,71,shoulder,1,1,2
3EKTG13IZU4CTOC1DGMQ5JE3SLVLM4,"#41-5 The lorry had been abandoned since Wednesday on the hard shoulder of the ""Eastern Motorway"", near the Hungarian border.",80,96,Eastern Motorway,2,1,3
3EKTG13IZU4CTOC1DGMQ5JE3SLVLM4,"#41-5 The lorry had been abandoned since Wednesday on the hard shoulder of the ""Eastern Motorway"", near the Hungarian border.",108,117,Hungarian,0,1,1
3EKTG13IZU4CTOC1DGMQ5JE3SLVLM4,"#41-6 Roadworkers became suspicious of dark liquid seeping from the vehicle, and responding police found the bodies.",6,17,Roadworkers,3,3,6
3EKTG13IZU4CTOC1DGMQ5JE3SLVLM4,"#41-6 Roadworkers became suspicious of dark liquid seeping from the vehicle, and responding police found the bodies.",25,35,suspicious,8,5,13
3EKTG13IZU4CTOC1DGMQ5JE3SLVLM4,"#41-6 Roadworkers became suspicious of dark liquid seeping from the vehicle, and responding police found the bodies.",51,58,seeping,3,4,7
3EKTG13IZU4CTOC1DGMQ5JE3SLVLM4,"#41-6 Roadworkers became suspicious of dark liquid seeping from the vehicle, and responding police found the bodies.",68,75,vehicle,1,0,1
3EKTG13IZU4CTOC1DGMQ5JE3SLVLM4,"#41-6 Roadworkers became suspicious of dark liquid seeping from the vehicle, and responding police found the bodies.",81,91,responding,1,2,3
3EKTG13IZU4CTOC1DGMQ5JE3SLVLM4,#41-7 Initial police estimates were that 20–50 were suffocated in the back of the lorry which was near Parndorf.,21,30,estimates,2,3,5
3EKTG13IZU4CTOC1DGMQ5JE3SLVLM4,#41-7 Initial police estimates were that 20–50 were suffocated in the back of the lorry which was near Parndorf.,52,62,suffocated,10,7,17
3EKTG13IZU4CTOC1DGMQ5JE3SLVLM4,#41-7 Initial police estimates were that 20–50 were suffocated in the back of the lorry which was near Parndorf.,82,87,lorry,1,1,2
3EKTG13IZU4CTOC1DGMQ5JE3SLVLM4,#41-7 Initial police estimates were that 20–50 were suffocated in the back of the lorry which was near Parndorf.,103,111,Parndorf,1,1,2
3EKTG13IZU4CTOC1DGMQ5JE3SLVLM4,#41-8 The arrested men are thought to include the vehicle's owner and at least two drivers.,10,18,arrested,2,0,2
3EKTG13IZU4CTOC1DGMQ5JE3SLVLM4,#41-9 Three are Bulgarian and one is from Afghanistan.,16,25,Bulgarian,0,1,1
3EKTG13IZU4CTOC1DGMQ5JE3SLVLM4,"#41-10 Criminal suspects in Hungary can generally be held for 72 hours before charge but prosecutors, citing the seriousness of the case, want the period extended.",7,15,Criminal,1,0,1
3EKTG13IZU4CTOC1DGMQ5JE3SLVLM4,"#41-10 Criminal suspects in Hungary can generally be held for 72 hours before charge but prosecutors, citing the seriousness of the case, want the period extended.",7,24,Criminal suspects,1,2,3
3EKTG13IZU4CTOC1DGMQ5JE3SLVLM4,"#41-10 Criminal suspects in Hungary can generally be held for 72 hours before charge but prosecutors, citing the seriousness of the case, want the period extended.",16,24,suspects,0,2,2
3EKTG13IZU4CTOC1DGMQ5JE3SLVLM4,"#41-10 Criminal suspects in Hungary can generally be held for 72 hours before charge but prosecutors, citing the seriousness of the case, want the period extended.",89,100,prosecutors,10,8,18
3EKTG13IZU4CTOC1DGMQ5JE3SLVLM4,"#41-10 Criminal suspects in Hungary can generally be held for 72 hours before charge but prosecutors, citing the seriousness of the case, want the period extended.",102,108,citing,1,1,2
3EKTG13IZU4CTOC1DGMQ5JE3SLVLM4,"#41-10 Criminal suspects in Hungary can generally be held for 72 hours before charge but prosecutors, citing the seriousness of the case, want the period extended.",113,124,seriousness,3,3,6
3EKTG13IZU4CTOC1DGMQ5JE3SLVLM4,"#41-10 Criminal suspects in Hungary can generally be held for 72 hours before charge but prosecutors, citing the seriousness of the case, want the period extended.",154,162,extended,4,1,5
35JDMRECC4AYV86NLR1RFJ4MN2IEG2,"#30-12 It was dubbed the ""gag law""((es)) or the ""gagging law"".",14,20,dubbed,6,10,16
35JDMRECC4AYV86NLR1RFJ4MN2IEG2,"#30-12 It was dubbed the ""gag law""((es)) or the ""gagging law"".",26,29,gag,1,2,3
35JDMRECC4AYV86NLR1RFJ4MN2IEG2,"#30-12 It was dubbed the ""gag law""((es)) or the ""gagging law"".",26,33,gag law,3,2,5
35JDMRECC4AYV86NLR1RFJ4MN2IEG2,"#30-12 It was dubbed the ""gag law""((es)) or the ""gagging law"".",36,38,es,1,0,1
35JDMRECC4AYV86NLR1RFJ4MN2IEG2,"#30-12 It was dubbed the ""gag law""((es)) or the ""gagging law"".",49,56,gagging,2,4,6
35JDMRECC4AYV86NLR1RFJ4MN2IEG2,"#30-12 It was dubbed the ""gag law""((es)) or the ""gagging law"".",49,60,gagging law,2,2,4
35JDMRECC4AYV86NLR1RFJ4MN2IEG2,"#30-13 The law prohibits ""the unauthorized use of images of police officers that might jeopardize their or their family's safety or that of protected facilities or police operations"".",15,24,prohibits,3,5,8
35JDMRECC4AYV86NLR1RFJ4MN2IEG2,"#30-13 The law prohibits ""the unauthorized use of images of police officers that might jeopardize their or their family's safety or that of protected facilities or police operations"".",30,42,unauthorized,8,6,14
35JDMRECC4AYV86NLR1RFJ4MN2IEG2,"#30-13 The law prohibits ""the unauthorized use of images of police officers that might jeopardize their or their family's safety or that of protected facilities or police operations"".",87,97,jeopardize,10,10,20
35JDMRECC4AYV86NLR1RFJ4MN2IEG2,"#30-13 The law prohibits ""the unauthorized use of images of police officers that might jeopardize their or their family's safety or that of protected facilities or police operations"".",140,149,protected,2,0,2
35JDMRECC4AYV86NLR1RFJ4MN2IEG2,"#30-13 The law prohibits ""the unauthorized use of images of police officers that might jeopardize their or their family's safety or that of protected facilities or police operations"".",150,160,facilities,4,1,5
35JDMRECC4AYV86NLR1RFJ4MN2IEG2,"#30-13 The law prohibits ""the unauthorized use of images of police officers that might jeopardize their or their family's safety or that of protected facilities or police operations"".",171,181,operations,2,0,2
35JDMRECC4AYV86NLR1RFJ4MN2IEG2,"#30-14 Judge Joaquim Bosch, Judges for Democracy spokesperson, said: ""It is not a law for citizens' security, but a law for the government to avoid citizens’ protests.",13,26,Joaquim Bosch,1,1,2
35JDMRECC4AYV86NLR1RFJ4MN2IEG2,"#30-14 Judge Joaquim Bosch, Judges for Democracy spokesperson, said: ""It is not a law for citizens' security, but a law for the government to avoid citizens’ protests.",39,61,Democracy spokesperson,0,1,1
35JDMRECC4AYV86NLR1RFJ4MN2IEG2,"#30-14 Judge Joaquim Bosch, Judges for Democracy spokesperson, said: ""It is not a law for citizens' security, but a law for the government to avoid citizens’ protests.",49,61,spokesperson,1,2,3
35JDMRECC4AYV86NLR1RFJ4MN2IEG2,"#30-14 Judge Joaquim Bosch, Judges for Democracy spokesperson, said: ""It is not a law for citizens' security, but a law for the government to avoid citizens’ protests.",90,98,citizens,1,0,1
35JDMRECC4AYV86NLR1RFJ4MN2IEG2,"#30-14 Judge Joaquim Bosch, Judges for Democracy spokesperson, said: ""It is not a law for citizens' security, but a law for the government to avoid citizens’ protests.",90,107,citizens security,1,0,1
35JDMRECC4AYV86NLR1RFJ4MN2IEG2,"#30-14 Judge Joaquim Bosch, Judges for Democracy spokesperson, said: ""It is not a law for citizens' security, but a law for the government to avoid citizens’ protests.",158,166,protests,1,2,3
35JDMRECC4AYV86NLR1RFJ4MN2IEG2,"#30-15 All opinion polls indicate that the Spanish society is not at all preoccupied by security but by the economic situation and political corruption.""",25,42,indicate that the,0,1,1
35JDMRECC4AYV86NLR1RFJ4MN2IEG2,"#30-15 All opinion polls indicate that the Spanish society is not at all preoccupied by security but by the economic situation and political corruption.""",73,84,preoccupied,8,6,14
35JDMRECC4AYV86NLR1RFJ4MN2IEG2,"#30-15 All opinion polls indicate that the Spanish society is not at all preoccupied by security but by the economic situation and political corruption.""",108,126,economic situation,1,1,2
35JDMRECC4AYV86NLR1RFJ4MN2IEG2,"#30-15 All opinion polls indicate that the Spanish society is not at all preoccupied by security but by the economic situation and political corruption.""",131,151,political corruption,2,0,2
35JDMRECC4AYV86NLR1RFJ4MN2IEG2,"#30-15 All opinion polls indicate that the Spanish society is not at all preoccupied by security but by the economic situation and political corruption.""",141,151,corruption,5,2,7
35JDMRECC4AYV86NLR1RFJ4MN2IEG2,"#30-16 Amnesty International condemned the law in a report: ""With threats of fines or threats of being beaten, the government is trying to stigmatize and criminalize people who are just practicing their rights.""",7,28,Amnesty International,1,0,1
35JDMRECC4AYV86NLR1RFJ4MN2IEG2,"#30-16 Amnesty International condemned the law in a report: ""With threats of fines or threats of being beaten, the government is trying to stigmatize and criminalize people who are just practicing their rights.""",15,38,International condemned,1,0,1
35JDMRECC4AYV86NLR1RFJ4MN2IEG2,"#30-16 Amnesty International condemned the law in a report: ""With threats of fines or threats of being beaten, the government is trying to stigmatize and criminalize people who are just practicing their rights.""",29,38,condemned,6,6,12
35JDMRECC4AYV86NLR1RFJ4MN2IEG2,"#30-16 Amnesty International condemned the law in a report: ""With threats of fines or threats of being beaten, the government is trying to stigmatize and criminalize people who are just practicing their rights.""",66,73,threats,1,1,2
35JDMRECC4AYV86NLR1RFJ4MN2IEG2,"#30-16 Amnesty International condemned the law in a report: ""With threats of fines or threats of being beaten, the government is trying to stigmatize and criminalize people who are just practicing their rights.""",136,149,to stigmatize,1,0,1
35JDMRECC4AYV86NLR1RFJ4MN2IEG2,"#30-16 Amnesty International condemned the law in a report: ""With threats of fines or threats of being beaten, the government is trying to stigmatize and criminalize people who are just practicing their rights.""",139,149,stigmatize,10,10,20
35JDMRECC4AYV86NLR1RFJ4MN2IEG2,"#30-16 Amnesty International condemned the law in a report: ""With threats of fines or threats of being beaten, the government is trying to stigmatize and criminalize people who are just practicing their rights.""",139,165,stigmatize and criminalize,1,0,1
35JDMRECC4AYV86NLR1RFJ4MN2IEG2,"#30-16 Amnesty International condemned the law in a report: ""With threats of fines or threats of being beaten, the government is trying to stigmatize and criminalize people who are just practicing their rights.""",154,165,criminalize,10,2,12
35JDMRECC4AYV86NLR1RFJ4MN2IEG2,"#30-17 Virginia Álvarez, who wrote the report, noted, ""instead of listening to their demands, instead of starting a dialogue, authorities are doing everything they can to impede people from protesting"".",7,23,Virginia Álvarez,1,0,1
35JDMRECC4AYV86NLR1RFJ4MN2IEG2,"#30-17 Virginia Álvarez, who wrote the report, noted, ""instead of listening to their demands, instead of starting a dialogue, authorities are doing everything they can to impede people from protesting"".",55,92,instead of listening to their demands,0,1,1
35JDMRECC4AYV86NLR1RFJ4MN2IEG2,"#30-17 Virginia Álvarez, who wrote the report, noted, ""instead of listening to their demands, instead of starting a dialogue, authorities are doing everything they can to impede people from protesting"".",116,124,dialogue,4,2,6
35JDMRECC4AYV86NLR1RFJ4MN2IEG2,"#30-17 Virginia Álvarez, who wrote the report, noted, ""instead of listening to their demands, instead of starting a dialogue, authorities are doing everything they can to impede people from protesting"".",126,137,authorities,1,0,1
35JDMRECC4AYV86NLR1RFJ4MN2IEG2,"#30-17 Virginia Álvarez, who wrote the report, noted, ""instead of listening to their demands, instead of starting a dialogue, authorities are doing everything they can to impede people from protesting"".",171,177,impede,8,8,16
35JDMRECC4AYV86NLR1RFJ4MN2IEG2,"#30-17 Virginia Álvarez, who wrote the report, noted, ""instead of listening to their demands, instead of starting a dialogue, authorities are doing everything they can to impede people from protesting"".",171,200,impede people from protesting,1,0,1
35JDMRECC4AYV86NLR1RFJ4MN2IEG2,"#30-17 Virginia Álvarez, who wrote the report, noted, ""instead of listening to their demands, instead of starting a dialogue, authorities are doing everything they can to impede people from protesting"".",190,200,protesting,1,0,1
3IYI9285WS1TPCCAX6GZM8WZUIMJCI,#38-4 Around fifteen shots were reported fired.,21,26,shots,0,1,1
3IYI9285WS1TPCCAX6GZM8WZUIMJCI,#38-4 Around fifteen shots were reported fired.,32,40,reported,1,2,3
3IYI9285WS1TPCCAX6GZM8WZUIMJCI,"#38-5 Parker and Ward were killed, while the interviewee, Vicki Gardner, was transported to hospital and underwent surgery for her injuries, later listed in stable condition.",45,56,interviewee,10,9,19
3IYI9285WS1TPCCAX6GZM8WZUIMJCI,"#38-5 Parker and Ward were killed, while the interviewee, Vicki Gardner, was transported to hospital and underwent surgery for her injuries, later listed in stable condition.",58,71,Vicki Gardner,0,1,1
3IYI9285WS1TPCCAX6GZM8WZUIMJCI,"#38-5 Parker and Ward were killed, while the interviewee, Vicki Gardner, was transported to hospital and underwent surgery for her injuries, later listed in stable condition.",77,88,transported,3,2,5
3IYI9285WS1TPCCAX6GZM8WZUIMJCI,"#38-5 Parker and Ward were killed, while the interviewee, Vicki Gardner, was transported to hospital and underwent surgery for her injuries, later listed in stable condition.",105,114,underwent,4,7,11
3IYI9285WS1TPCCAX6GZM8WZUIMJCI,"#38-5 Parker and Ward were killed, while the interviewee, Vicki Gardner, was transported to hospital and underwent surgery for her injuries, later listed in stable condition.",105,122,underwent surgery,1,2,3
3IYI9285WS1TPCCAX6GZM8WZUIMJCI,"#38-5 Parker and Ward were killed, while the interviewee, Vicki Gardner, was transported to hospital and underwent surgery for her injuries, later listed in stable condition.",115,122,surgery,1,1,2
3IYI9285WS1TPCCAX6GZM8WZUIMJCI,"#38-5 Parker and Ward were killed, while the interviewee, Vicki Gardner, was transported to hospital and underwent surgery for her injuries, later listed in stable condition.",131,139,injuries,1,1,2
3IYI9285WS1TPCCAX6GZM8WZUIMJCI,"#38-5 Parker and Ward were killed, while the interviewee, Vicki Gardner, was transported to hospital and underwent surgery for her injuries, later listed in stable condition.",157,163,stable,1,1,2
3IYI9285WS1TPCCAX6GZM8WZUIMJCI,"#38-5 Parker and Ward were killed, while the interviewee, Vicki Gardner, was transported to hospital and underwent surgery for her injuries, later listed in stable condition.",157,173,stable condition,0,2,2
3IYI9285WS1TPCCAX6GZM8WZUIMJCI,"#38-6 The gunman, later identified as 41 year-old Vester Lee Flanagan II, fled the scene.",10,16,gunman,0,1,1
3IYI9285WS1TPCCAX6GZM8WZUIMJCI,"#38-6 The gunman, later identified as 41 year-old Vester Lee Flanagan II, fled the scene.",24,34,identified,1,1,2
3IYI9285WS1TPCCAX6GZM8WZUIMJCI,"#38-6 The gunman, later identified as 41 year-old Vester Lee Flanagan II, fled the scene.",50,69,Vester Lee Flanagan,0,1,1
3IYI9285WS1TPCCAX6GZM8WZUIMJCI,"#38-6 The gunman, later identified as 41 year-old Vester Lee Flanagan II, fled the scene.",74,78,fled,0,5,5
3IYI9285WS1TPCCAX6GZM8WZUIMJCI,"#38-6 The gunman, later identified as 41 year-old Vester Lee Flanagan II, fled the scene.",83,88,scene,0,1,1
3IYI9285WS1TPCCAX6GZM8WZUIMJCI,#38-7 A brief police chase ensued several hours later when law enforcement attempted unsuccessfully to pull Flanagan over on Interstate 66 in Fauquier County.,8,13,brief,0,1,1
3IYI9285WS1TPCCAX6GZM8WZUIMJCI,#38-7 A brief police chase ensued several hours later when law enforcement attempted unsuccessfully to pull Flanagan over on Interstate 66 in Fauquier County.,21,26,chase,0,3,3
3IYI9285WS1TPCCAX6GZM8WZUIMJCI,#38-7 A brief police chase ensued several hours later when law enforcement attempted unsuccessfully to pull Flanagan over on Interstate 66 in Fauquier County.,27,33,ensued,9,10,19
3IYI9285WS1TPCCAX6GZM8WZUIMJCI,#38-7 A brief police chase ensued several hours later when law enforcement attempted unsuccessfully to pull Flanagan over on Interstate 66 in Fauquier County.,59,74,law enforcement,1,3,4
3IYI9285WS1TPCCAX6GZM8WZUIMJCI,#38-7 A brief police chase ensued several hours later when law enforcement attempted unsuccessfully to pull Flanagan over on Interstate 66 in Fauquier County.,63,74,enforcement,8,3,11
3IYI9285WS1TPCCAX6GZM8WZUIMJCI,#38-7 A brief police chase ensued several hours later when law enforcement attempted unsuccessfully to pull Flanagan over on Interstate 66 in Fauquier County.,63,84,enforcement attempted,1,1,2
3IYI9285WS1TPCCAX6GZM8WZUIMJCI,#38-7 A brief police chase ensued several hours later when law enforcement attempted unsuccessfully to pull Flanagan over on Interstate 66 in Fauquier County.,75,84,attempted,1,2,3
3IYI9285WS1TPCCAX6GZM8WZUIMJCI,#38-7 A brief police chase ensued several hours later when law enforcement attempted unsuccessfully to pull Flanagan over on Interstate 66 in Fauquier County.,85,99,unsuccessfully,6,2,8
3IYI9285WS1TPCCAX6GZM8WZUIMJCI,#38-7 A brief police chase ensued several hours later when law enforcement attempted unsuccessfully to pull Flanagan over on Interstate 66 in Fauquier County.,108,116,Flanagan,2,0,2
3IYI9285WS1TPCCAX6GZM8WZUIMJCI,#38-7 A brief police chase ensued several hours later when law enforcement attempted unsuccessfully to pull Flanagan over on Interstate 66 in Fauquier County.,125,135,Interstate,1,2,3
3IYI9285WS1TPCCAX6GZM8WZUIMJCI,#38-7 A brief police chase ensued several hours later when law enforcement attempted unsuccessfully to pull Flanagan over on Interstate 66 in Fauquier County.,142,150,Fauquier,2,0,2
3IYI9285WS1TPCCAX6GZM8WZUIMJCI,"#38-8 Shortly after, Flanagan pulled off the road and shot himself.",30,40,pulled off,1,0,1
3IYI9285WS1TPCCAX6GZM8WZUIMJCI,#38-9 He was pronounced dead at a Fairfax-area hospital around 1:30 PM local time (1730 UTC).,13,23,pronounced,8,7,15
3IYI9285WS1TPCCAX6GZM8WZUIMJCI,#38-9 He was pronounced dead at a Fairfax-area hospital around 1:30 PM local time (1730 UTC).,34,46,Fairfax-area,1,1,2
3IYI9285WS1TPCCAX6GZM8WZUIMJCI,"#38-10 Flanagan, who reported under the alias ""Bryce Williams"", was fired by the station in 2013.",21,29,reported,0,1,1
3IYI9285WS1TPCCAX6GZM8WZUIMJCI,"#38-10 Flanagan, who reported under the alias ""Bryce Williams"", was fired by the station in 2013.",40,45,alias,5,1,6
3IYI9285WS1TPCCAX6GZM8WZUIMJCI,"#38-10 Flanagan, who reported under the alias ""Bryce Williams"", was fired by the station in 2013.",47,61,Bryce Williams,0,1,1
3IYI9285WS1TPCCAX6GZM8WZUIMJCI,"#38-11 According to WDBJ president and general manager Jeffrey Marks, speaking to CBS News, Flanagan was ""an unhappy man"" and ""difficult to work with"".",20,24,WDBJ,1,0,1
3IYI9285WS1TPCCAX6GZM8WZUIMJCI,"#38-11 According to WDBJ president and general manager Jeffrey Marks, speaking to CBS News, Flanagan was ""an unhappy man"" and ""difficult to work with"".",92,100,Flanagan,0,1,1
3IYI9285WS1TPCCAX6GZM8WZUIMJCI,"#38-11 According to WDBJ president and general manager Jeffrey Marks, speaking to CBS News, Flanagan was ""an unhappy man"" and ""difficult to work with"".",127,136,difficult,1,1,2
3PMR2DOWOO2IN9KAFP6N2016K4A454,"#21-4 Cquote2.svg This is the first F1 race-related driver death since the 1994 San Marino Grand Prix, when Ayrton Senna was killed.",39,51,race-related,2,3,5
3PMR2DOWOO2IN9KAFP6N2016K4A454,"#21-4 Cquote2.svg This is the first F1 race-related driver death since the 1994 San Marino Grand Prix, when Ayrton Senna was killed.",39,64,race-related driver death,1,0,1
3PMR2DOWOO2IN9KAFP6N2016K4A454,"#21-4 Cquote2.svg This is the first F1 race-related driver death since the 1994 San Marino Grand Prix, when Ayrton Senna was killed.",84,101,Marino Grand Prix,0,1,1
3PMR2DOWOO2IN9KAFP6N2016K4A454,"#21-4 Cquote2.svg This is the first F1 race-related driver death since the 1994 San Marino Grand Prix, when Ayrton Senna was killed.",91,101,Grand Prix,1,0,1
3PMR2DOWOO2IN9KAFP6N2016K4A454,"#21-4 Cquote2.svg This is the first F1 race-related driver death since the 1994 San Marino Grand Prix, when Ayrton Senna was killed.",108,114,Ayrton,1,1,2
3PMR2DOWOO2IN9KAFP6N2016K4A454,"#21-5 On October 5, 2014, at the late portion of the Japanese Grand Prix at Suzuka Circuit, Bianchi collided with a tractor crane that had been attending to the crashed car of Adrian Sutil.",33,45,late portion,1,3,4
3PMR2DOWOO2IN9KAFP6N2016K4A454,"#21-5 On October 5, 2014, at the late portion of the Japanese Grand Prix at Suzuka Circuit, Bianchi collided with a tractor crane that had been attending to the crashed car of Adrian Sutil.",38,45,portion,2,0,2
3PMR2DOWOO2IN9KAFP6N2016K4A454,"#21-5 On October 5, 2014, at the late portion of the Japanese Grand Prix at Suzuka Circuit, Bianchi collided with a tractor crane that had been attending to the crashed car of Adrian Sutil.",62,72,Grand Prix,0,1,1
3PMR2DOWOO2IN9KAFP6N2016K4A454,"#21-5 On October 5, 2014, at the late portion of the Japanese Grand Prix at Suzuka Circuit, Bianchi collided with a tractor crane that had been attending to the crashed car of Adrian Sutil.",76,82,Suzuka,0,1,1
3PMR2DOWOO2IN9KAFP6N2016K4A454,"#21-5 On October 5, 2014, at the late portion of the Japanese Grand Prix at Suzuka Circuit, Bianchi collided with a tractor crane that had been attending to the crashed car of Adrian Sutil.",83,90,Circuit,2,0,2
3PMR2DOWOO2IN9KAFP6N2016K4A454,"#21-5 On October 5, 2014, at the late portion of the Japanese Grand Prix at Suzuka Circuit, Bianchi collided with a tractor crane that had been attending to the crashed car of Adrian Sutil.",92,99,Bianchi,1,0,1
3PMR2DOWOO2IN9KAFP6N2016K4A454,"#21-5 On October 5, 2014, at the late portion of the Japanese Grand Prix at Suzuka Circuit, Bianchi collided with a tractor crane that had been attending to the crashed car of Adrian Sutil.",92,108,Bianchi collided,0,1,1
3PMR2DOWOO2IN9KAFP6N2016K4A454,"#21-5 On October 5, 2014, at the late portion of the Japanese Grand Prix at Suzuka Circuit, Bianchi collided with a tractor crane that had been attending to the crashed car of Adrian Sutil.",100,108,collided,9,8,17
3PMR2DOWOO2IN9KAFP6N2016K4A454,"#21-5 On October 5, 2014, at the late portion of the Japanese Grand Prix at Suzuka Circuit, Bianchi collided with a tractor crane that had been attending to the crashed car of Adrian Sutil.",116,129,tractor crane,1,0,1
3PMR2DOWOO2IN9KAFP6N2016K4A454,"#21-5 On October 5, 2014, at the late portion of the Japanese Grand Prix at Suzuka Circuit, Bianchi collided with a tractor crane that had been attending to the crashed car of Adrian Sutil.",124,129,crane,0,2,2
3PMR2DOWOO2IN9KAFP6N2016K4A454,"#21-5 On October 5, 2014, at the late portion of the Japanese Grand Prix at Suzuka Circuit, Bianchi collided with a tractor crane that had been attending to the crashed car of Adrian Sutil.",144,153,attending,1,0,1
3PMR2DOWOO2IN9KAFP6N2016K4A454,"#21-5 On October 5, 2014, at the late portion of the Japanese Grand Prix at Suzuka Circuit, Bianchi collided with a tractor crane that had been attending to the crashed car of Adrian Sutil.",161,168,crashed,0,2,2
3PMR2DOWOO2IN9KAFP6N2016K4A454,"#21-6 Bianchi's helmet became wedged underneath the tractor, causing a diffuse axonal injury, and he fell into a coma.",6,14,Bianchis,0,1,1
3PMR2DOWOO2IN9KAFP6N2016K4A454,"#21-6 Bianchi's helmet became wedged underneath the tractor, causing a diffuse axonal injury, and he fell into a coma.",30,36,wedged,5,10,15
3PMR2DOWOO2IN9KAFP6N2016K4A454,"#21-6 Bianchi's helmet became wedged underneath the tractor, causing a diffuse axonal injury, and he fell into a coma.",30,47,wedged underneath,1,3,4
3PMR2DOWOO2IN9KAFP6N2016K4A454,"#21-6 Bianchi's helmet became wedged underneath the tractor, causing a diffuse axonal injury, and he fell into a coma.",37,47,underneath,0,3,3
3PMR2DOWOO2IN9KAFP6N2016K4A454,"#21-6 Bianchi's helmet became wedged underneath the tractor, causing a diffuse axonal injury, and he fell into a coma.",71,78,diffuse,6,2,8
3PMR2DOWOO2IN9KAFP6N2016K4A454,"#21-6 Bianchi's helmet became wedged underneath the tractor, causing a diffuse axonal injury, and he fell into a coma.",71,85,diffuse axonal,2,0,2
3PMR2DOWOO2IN9KAFP6N2016K4A454,"#21-6 Bianchi's helmet became wedged underneath the tractor, causing a diffuse axonal injury, and he fell into a coma.",71,92,diffuse axonal injury,5,5,10
3PMR2DOWOO2IN9KAFP6N2016K4A454,"#21-6 Bianchi's helmet became wedged underneath the tractor, causing a diffuse axonal injury, and he fell into a coma.",79,85,axonal,5,5,10
3PMR2DOWOO2IN9KAFP6N2016K4A454,"#21-6 Bianchi's helmet became wedged underneath the tractor, causing a diffuse axonal injury, and he fell into a coma.",79,92,axonal injury,1,1,2
3PMR2DOWOO2IN9KAFP6N2016K4A454,"#21-6 Bianchi's helmet became wedged underneath the tractor, causing a diffuse axonal injury, and he fell into a coma.",86,92,injury,3,0,3
3PMR2DOWOO2IN9KAFP6N2016K4A454,"#21-6 Bianchi's helmet became wedged underneath the tractor, causing a diffuse axonal injury, and he fell into a coma.",113,117,coma,4,5,9
3PMR2DOWOO2IN9KAFP6N2016K4A454,"#21-7 After being treated at a Japanese medical centre, he was moved about two months after the accident to a hospital in Nice.",96,104,accident,1,0,1
3PMR2DOWOO2IN9KAFP6N2016K4A454,"#21-8 Placed in the intensive care unit, in December he began rehabilitation therapy.",20,29,intensive,2,3,5
3PMR2DOWOO2IN9KAFP6N2016K4A454,"#21-8 Placed in the intensive care unit, in December he began rehabilitation therapy.",20,39,intensive care unit,1,1,2
3PMR2DOWOO2IN9KAFP6N2016K4A454,"#21-8 Placed in the intensive care unit, in December he began rehabilitation therapy.",62,76,rehabilitation,9,6,15
3PMR2DOWOO2IN9KAFP6N2016K4A454,"#21-8 Placed in the intensive care unit, in December he began rehabilitation therapy.",62,84,rehabilitation therapy,2,4,6
3PMR2DOWOO2IN9KAFP6N2016K4A454,"#21-8 Placed in the intensive care unit, in December he began rehabilitation therapy.",77,84,therapy,0,1,1
3PMR2DOWOO2IN9KAFP6N2016K4A454,"#21-9 Bianchi's father, Philippe, described his non-progress as a ""daily torture"".",24,32,Philippe,0,1,1
3PMR2DOWOO2IN9KAFP6N2016K4A454,"#21-9 Bianchi's father, Philippe, described his non-progress as a ""daily torture"".",34,43,described,1,0,1
3PMR2DOWOO2IN9KAFP6N2016K4A454,"#21-9 Bianchi's father, Philippe, described his non-progress as a ""daily torture"".",48,60,non-progress,2,2,4
3PMR2DOWOO2IN9KAFP6N2016K4A454,"#21-9 Bianchi's father, Philippe, described his non-progress as a ""daily torture"".",67,80,daily torture,2,3,5
3PMR2DOWOO2IN9KAFP6N2016K4A454,"#21-9 Bianchi's father, Philippe, described his non-progress as a ""daily torture"".",73,80,torture,4,2,6
3PMR2DOWOO2IN9KAFP6N2016K4A454,"#21-10 Bianchi, the 2007 French Formula Renault and 2009 Formula 3 Euro Series champion, was the inaugural member of the Ferrari Driver Academy.",40,47,Renault,0,1,1
3PMR2DOWOO2IN9KAFP6N2016K4A454,"#21-10 Bianchi, the 2007 French Formula Renault and 2009 Formula 3 Euro Series champion, was the inaugural member of the Ferrari Driver Academy.",97,106,inaugural,8,4,12
3PMR2DOWOO2IN9KAFP6N2016K4A454,"#21-10 Bianchi, the 2007 French Formula Renault and 2009 Formula 3 Euro Series champion, was the inaugural member of the Ferrari Driver Academy.",97,113,inaugural member,3,1,4
3PMR2DOWOO2IN9KAFP6N2016K4A454,"#21-10 Bianchi, the 2007 French Formula Renault and 2009 Formula 3 Euro Series champion, was the inaugural member of the Ferrari Driver Academy.",121,128,Ferrari,0,1,1
3WYZV0QBFJEBARPT0AZ52XYWNV1BXR,#3-3 The 32-year-old artist has been charged on several occasions.,37,44,charged,1,4,5
3WYZV0QBFJEBARPT0AZ52XYWNV1BXR,#3-3 The 32-year-old artist has been charged on several occasions.,56,65,occasions,5,2,7
3WYZV0QBFJEBARPT0AZ52XYWNV1BXR,"#3-4 In the November 2015, Pavlensky set Russia's Federal Security Service's headquarters' door on fire in Moscow.",27,36,Pavlensky,1,2,3
3WYZV0QBFJEBARPT0AZ52XYWNV1BXR,"#3-4 In the November 2015, Pavlensky set Russia's Federal Security Service's headquarters' door on fire in Moscow.",41,48,Russias,0,1,1
3WYZV0QBFJEBARPT0AZ52XYWNV1BXR,"#3-4 In the November 2015, Pavlensky set Russia's Federal Security Service's headquarters' door on fire in Moscow.",50,57,Federal,1,0,1
3WYZV0QBFJEBARPT0AZ52XYWNV1BXR,"#3-4 In the November 2015, Pavlensky set Russia's Federal Security Service's headquarters' door on fire in Moscow.",50,74,Federal Security Service,1,0,1
3WYZV0QBFJEBARPT0AZ52XYWNV1BXR,"#3-4 In the November 2015, Pavlensky set Russia's Federal Security Service's headquarters' door on fire in Moscow.",77,89,headquarters,5,1,6
3WYZV0QBFJEBARPT0AZ52XYWNV1BXR,"#3-5 Pavlensky called this an artwork named ""Threat"" and was sentenced to a prison term for vandalism.",5,14,Pavlensky,0,1,1
3WYZV0QBFJEBARPT0AZ52XYWNV1BXR,"#3-5 Pavlensky called this an artwork named ""Threat"" and was sentenced to a prison term for vandalism.",30,37,artwork,1,1,2
3WYZV0QBFJEBARPT0AZ52XYWNV1BXR,"#3-5 Pavlensky called this an artwork named ""Threat"" and was sentenced to a prison term for vandalism.",45,51,Threat,3,3,6
3WYZV0QBFJEBARPT0AZ52XYWNV1BXR,"#3-5 Pavlensky called this an artwork named ""Threat"" and was sentenced to a prison term for vandalism.",61,70,sentenced,2,3,5
3WYZV0QBFJEBARPT0AZ52XYWNV1BXR,"#3-5 Pavlensky called this an artwork named ""Threat"" and was sentenced to a prison term for vandalism.",76,82,prison,0,1,1
3WYZV0QBFJEBARPT0AZ52XYWNV1BXR,"#3-5 Pavlensky called this an artwork named ""Threat"" and was sentenced to a prison term for vandalism.",83,87,term,0,1,1
3WYZV0QBFJEBARPT0AZ52XYWNV1BXR,"#3-5 Pavlensky called this an artwork named ""Threat"" and was sentenced to a prison term for vandalism.",92,101,vandalism,10,10,20
3WYZV0QBFJEBARPT0AZ52XYWNV1BXR,"#3-6 He was released seven months later, in June.",12,20,released,0,1,1
3WYZV0QBFJEBARPT0AZ52XYWNV1BXR,"#3-7 Anastasia Slonina, an actress working in a theatre in Moscow called Teatr.doc, known for liberal plays, filed rape charges on Pavlensky and his partner Oksana.",5,22,Anastasia Slonina,0,1,1
3WYZV0QBFJEBARPT0AZ52XYWNV1BXR,"#3-7 Anastasia Slonina, an actress working in a theatre in Moscow called Teatr.doc, known for liberal plays, filed rape charges on Pavlensky and his partner Oksana.",27,34,actress,1,0,1
3WYZV0QBFJEBARPT0AZ52XYWNV1BXR,"#3-7 Anastasia Slonina, an actress working in a theatre in Moscow called Teatr.doc, known for liberal plays, filed rape charges on Pavlensky and his partner Oksana.",48,55,theatre,1,0,1
3WYZV0QBFJEBARPT0AZ52XYWNV1BXR,"#3-7 Anastasia Slonina, an actress working in a theatre in Moscow called Teatr.doc, known for liberal plays, filed rape charges on Pavlensky and his partner Oksana.",73,78,Teatr,0,1,1
3WYZV0QBFJEBARPT0AZ52XYWNV1BXR,"#3-7 Anastasia Slonina, an actress working in a theatre in Moscow called Teatr.doc, known for liberal plays, filed rape charges on Pavlensky and his partner Oksana.",73,82,Teatr.doc,0,1,1
3WYZV0QBFJEBARPT0AZ52XYWNV1BXR,"#3-7 Anastasia Slonina, an actress working in a theatre in Moscow called Teatr.doc, known for liberal plays, filed rape charges on Pavlensky and his partner Oksana.",94,101,liberal,7,2,9
3WYZV0QBFJEBARPT0AZ52XYWNV1BXR,"#3-7 Anastasia Slonina, an actress working in a theatre in Moscow called Teatr.doc, known for liberal plays, filed rape charges on Pavlensky and his partner Oksana.",94,107,liberal plays,0,1,1
3WYZV0QBFJEBARPT0AZ52XYWNV1BXR,"#3-7 Anastasia Slonina, an actress working in a theatre in Moscow called Teatr.doc, known for liberal plays, filed rape charges on Pavlensky and his partner Oksana.",109,114,filed,0,1,1
3WYZV0QBFJEBARPT0AZ52XYWNV1BXR,"#3-7 Anastasia Slonina, an actress working in a theatre in Moscow called Teatr.doc, known for liberal plays, filed rape charges on Pavlensky and his partner Oksana.",109,127,filed rape charges,0,1,1
3WYZV0QBFJEBARPT0AZ52XYWNV1BXR,"#3-7 Anastasia Slonina, an actress working in a theatre in Moscow called Teatr.doc, known for liberal plays, filed rape charges on Pavlensky and his partner Oksana.",115,119,rape,1,1,2
3WYZV0QBFJEBARPT0AZ52XYWNV1BXR,"#3-7 Anastasia Slonina, an actress working in a theatre in Moscow called Teatr.doc, known for liberal plays, filed rape charges on Pavlensky and his partner Oksana.",120,127,charges,0,1,1
3WYZV0QBFJEBARPT0AZ52XYWNV1BXR,"#3-7 Anastasia Slonina, an actress working in a theatre in Moscow called Teatr.doc, known for liberal plays, filed rape charges on Pavlensky and his partner Oksana.",131,140,Pavlensky,0,1,1
3WYZV0QBFJEBARPT0AZ52XYWNV1BXR,"#3-7 Anastasia Slonina, an actress working in a theatre in Moscow called Teatr.doc, known for liberal plays, filed rape charges on Pavlensky and his partner Oksana.",157,163,Oksana,0,3,3
3WYZV0QBFJEBARPT0AZ52XYWNV1BXR,#3-8 The theatre claims to have a CCTV video footage of Pavlensky and other men beating Slonina's boyfriend in the parking lot on October 31.,17,23,claims,1,1,2
3WYZV0QBFJEBARPT0AZ52XYWNV1BXR,#3-8 The theatre claims to have a CCTV video footage of Pavlensky and other men beating Slonina's boyfriend in the parking lot on October 31.,34,52,CCTV video footage,1,0,1
3WYZV0QBFJEBARPT0AZ52XYWNV1BXR,#3-8 The theatre claims to have a CCTV video footage of Pavlensky and other men beating Slonina's boyfriend in the parking lot on October 31.,39,52,video footage,1,1,2
3WYZV0QBFJEBARPT0AZ52XYWNV1BXR,#3-8 The theatre claims to have a CCTV video footage of Pavlensky and other men beating Slonina's boyfriend in the parking lot on October 31.,45,52,footage,2,4,6
3WYZV0QBFJEBARPT0AZ52XYWNV1BXR,#3-8 The theatre claims to have a CCTV video footage of Pavlensky and other men beating Slonina's boyfriend in the parking lot on October 31.,56,65,Pavlensky,0,1,1
3WYZV0QBFJEBARPT0AZ52XYWNV1BXR,#3-8 The theatre claims to have a CCTV video footage of Pavlensky and other men beating Slonina's boyfriend in the parking lot on October 31.,80,87,beating,0,1,1
3WYZV0QBFJEBARPT0AZ52XYWNV1BXR,#3-8 The theatre claims to have a CCTV video footage of Pavlensky and other men beating Slonina's boyfriend in the parking lot on October 31.,88,95,Slonina,1,0,1
3WYZV0QBFJEBARPT0AZ52XYWNV1BXR,#3-8 The theatre claims to have a CCTV video footage of Pavlensky and other men beating Slonina's boyfriend in the parking lot on October 31.,88,96,Sloninas,0,1,1
3WYZV0QBFJEBARPT0AZ52XYWNV1BXR,#3-9 Pavlensky said he does not appear in the video.,32,38,appear,0,1,1
3WYZV0QBFJEBARPT0AZ52XYWNV1BXR,"#3-10 Pavlensky and Oksana were detained in December at Sheremetyevo airport for questioning, which went on for seven hours.",32,40,detained,10,8,18
3WYZV0QBFJEBARPT0AZ52XYWNV1BXR,"#3-10 Pavlensky and Oksana were detained in December at Sheremetyevo airport for questioning, which went on for seven hours.",56,68,Sheremetyevo,2,3,5
3WYZV0QBFJEBARPT0AZ52XYWNV1BXR,"#3-10 Pavlensky and Oksana were detained in December at Sheremetyevo airport for questioning, which went on for seven hours.",81,92,questioning,4,2,6
39I4RL8QGJIU3245GR7WRX4WPD14HL,"#36-7 The following day, Indianapolis Motor Speedway president Doug Boles and Hulman & Company Mark Miles officially announced Wilson's death.",25,37,Indianapolis,0,1,1
39I4RL8QGJIU3245GR7WRX4WPD14HL,"#36-7 The following day, Indianapolis Motor Speedway president Doug Boles and Hulman & Company Mark Miles officially announced Wilson's death.",25,52,Indianapolis Motor Speedway,1,0,1
39I4RL8QGJIU3245GR7WRX4WPD14HL,"#36-7 The following day, Indianapolis Motor Speedway president Doug Boles and Hulman & Company Mark Miles officially announced Wilson's death.",63,73,Doug Boles,0,1,1
39I4RL8QGJIU3245GR7WRX4WPD14HL,"#36-7 The following day, Indianapolis Motor Speedway president Doug Boles and Hulman & Company Mark Miles officially announced Wilson's death.",78,84,Hulman,0,1,1
39I4RL8QGJIU3245GR7WRX4WPD14HL,"#36-7 The following day, Indianapolis Motor Speedway president Doug Boles and Hulman & Company Mark Miles officially announced Wilson's death.",95,105,Mark Miles,0,1,1
39I4RL8QGJIU3245GR7WRX4WPD14HL,"#36-7 The following day, Indianapolis Motor Speedway president Doug Boles and Hulman & Company Mark Miles officially announced Wilson's death.",106,116,officially,5,1,6
39I4RL8QGJIU3245GR7WRX4WPD14HL,"#36-7 The following day, Indianapolis Motor Speedway president Doug Boles and Hulman & Company Mark Miles officially announced Wilson's death.",106,126,officially announced,0,1,1
39I4RL8QGJIU3245GR7WRX4WPD14HL,"#36-7 The following day, Indianapolis Motor Speedway president Doug Boles and Hulman & Company Mark Miles officially announced Wilson's death.",117,126,announced,7,0,7
39I4RL8QGJIU3245GR7WRX4WPD14HL,"#36-7 The following day, Indianapolis Motor Speedway president Doug Boles and Hulman & Company Mark Miles officially announced Wilson's death.",127,134,Wilsons,0,1,1
39I4RL8QGJIU3245GR7WRX4WPD14HL,"#36-8 Karam was able to walk away from the accident, and was evaluated for a right foot injury; he was released from the hospital the same day.",43,51,accident,3,1,4
39I4RL8QGJIU3245GR7WRX4WPD14HL,"#36-8 Karam was able to walk away from the accident, and was evaluated for a right foot injury; he was released from the hospital the same day.",61,70,evaluated,10,10,20
39I4RL8QGJIU3245GR7WRX4WPD14HL,"#36-8 Karam was able to walk away from the accident, and was evaluated for a right foot injury; he was released from the hospital the same day.",83,94,foot injury,0,1,1
39I4RL8QGJIU3245GR7WRX4WPD14HL,"#36-8 Karam was able to walk away from the accident, and was evaluated for a right foot injury; he was released from the hospital the same day.",88,94,injury,1,0,1
39I4RL8QGJIU3245GR7WRX4WPD14HL,"#36-8 Karam was able to walk away from the accident, and was evaluated for a right foot injury; he was released from the hospital the same day.",103,111,released,1,2,3
39I4RL8QGJIU3245GR7WRX4WPD14HL,"#36-9 Wilson's Andretti Autosport teammate Ryan Hunter-Reay won the race, though he did not celebrate upon finding out about Wilson's accident.",15,23,Andretti,0,1,1
39I4RL8QGJIU3245GR7WRX4WPD14HL,"#36-9 Wilson's Andretti Autosport teammate Ryan Hunter-Reay won the race, though he did not celebrate upon finding out about Wilson's accident.",24,33,Autosport,2,0,2
39I4RL8QGJIU3245GR7WRX4WPD14HL,"#36-9 Wilson's Andretti Autosport teammate Ryan Hunter-Reay won the race, though he did not celebrate upon finding out about Wilson's accident.",34,42,teammate,3,5,8
39I4RL8QGJIU3245GR7WRX4WPD14HL,"#36-9 Wilson's Andretti Autosport teammate Ryan Hunter-Reay won the race, though he did not celebrate upon finding out about Wilson's accident.",34,47,teammate Ryan,0,1,1
39I4RL8QGJIU3245GR7WRX4WPD14HL,"#36-9 Wilson's Andretti Autosport teammate Ryan Hunter-Reay won the race, though he did not celebrate upon finding out about Wilson's accident.",48,59,Hunter-Reay,0,1,1
39I4RL8QGJIU3245GR7WRX4WPD14HL,"#36-9 Wilson's Andretti Autosport teammate Ryan Hunter-Reay won the race, though he did not celebrate upon finding out about Wilson's accident.",92,101,celebrate,5,0,5
39I4RL8QGJIU3245GR7WRX4WPD14HL,"#36-10 In Victory Lane, he stated, ""My first thoughts are with Justin, for sure[...] He's a friend, a teammate, and it's a bit hard not knowing anything.""",10,22,Victory Lane,1,0,1
39I4RL8QGJIU3245GR7WRX4WPD14HL,"#36-10 In Victory Lane, he stated, ""My first thoughts are with Justin, for sure[...] He's a friend, a teammate, and it's a bit hard not knowing anything.""",27,33,stated,1,1,2
39I4RL8QGJIU3245GR7WRX4WPD14HL,"#36-10 In Victory Lane, he stated, ""My first thoughts are with Justin, for sure[...] He's a friend, a teammate, and it's a bit hard not knowing anything.""",102,110,teammate,2,4,6
39I4RL8QGJIU3245GR7WRX4WPD14HL,"#36-10 In Victory Lane, he stated, ""My first thoughts are with Justin, for sure[...] He's a friend, a teammate, and it's a bit hard not knowing anything.""",127,131,hard,0,1,1
39I4RL8QGJIU3245GR7WRX4WPD14HL,"#36-11 Wilson, a former Formula One and Champ Car driver, did not have a ride entering the 2015 season, and joined Andretti on a seven-race deal.",24,35,Formula One,2,1,3
39I4RL8QGJIU3245GR7WRX4WPD14HL,"#36-11 Wilson, a former Formula One and Champ Car driver, did not have a ride entering the 2015 season, and joined Andretti on a seven-race deal.",40,56,Champ Car driver,0,1,1
39I4RL8QGJIU3245GR7WRX4WPD14HL,"#36-11 Wilson, a former Formula One and Champ Car driver, did not have a ride entering the 2015 season, and joined Andretti on a seven-race deal.",73,77,ride,0,1,1
39I4RL8QGJIU3245GR7WRX4WPD14HL,"#36-11 Wilson, a former Formula One and Champ Car driver, did not have a ride entering the 2015 season, and joined Andretti on a seven-race deal.",78,86,entering,0,1,1
39I4RL8QGJIU3245GR7WRX4WPD14HL,"#36-11 Wilson, a former Formula One and Champ Car driver, did not have a ride entering the 2015 season, and joined Andretti on a seven-race deal.",115,123,Andretti,1,2,3
39I4RL8QGJIU3245GR7WRX4WPD14HL,"#36-11 Wilson, a former Formula One and Champ Car driver, did not have a ride entering the 2015 season, and joined Andretti on a seven-race deal.",129,139,seven-race,0,2,2
39I4RL8QGJIU3245GR7WRX4WPD14HL,"#36-11 Wilson, a former Formula One and Champ Car driver, did not have a ride entering the 2015 season, and joined Andretti on a seven-race deal.",129,144,seven-race deal,2,0,2
39I4RL8QGJIU3245GR7WRX4WPD14HL,"#36-11 Wilson, a former Formula One and Champ Car driver, did not have a ride entering the 2015 season, and joined Andretti on a seven-race deal.",140,144,deal,0,2,2
39I4RL8QGJIU3245GR7WRX4WPD14HL,"#36-12 The contract had previously been for two races, but after acquiring sponsorship, the deal was increased by five events; earlier in August, Wilson recorded a best finish of second at Mid-Ohio Sports Car Course.",11,19,contract,6,2,8
39I4RL8QGJIU3245GR7WRX4WPD14HL,"#36-12 The contract had previously been for two races, but after acquiring sponsorship, the deal was increased by five events; earlier in August, Wilson recorded a best finish of second at Mid-Ohio Sports Car Course.",24,34,previously,4,2,6
39I4RL8QGJIU3245GR7WRX4WPD14HL,"#36-12 The contract had previously been for two races, but after acquiring sponsorship, the deal was increased by five events; earlier in August, Wilson recorded a best finish of second at Mid-Ohio Sports Car Course.",65,74,acquiring,6,8,14
39I4RL8QGJIU3245GR7WRX4WPD14HL,"#36-12 The contract had previously been for two races, but after acquiring sponsorship, the deal was increased by five events; earlier in August, Wilson recorded a best finish of second at Mid-Ohio Sports Car Course.",65,86,acquiring sponsorship,4,0,4
39I4RL8QGJIU3245GR7WRX4WPD14HL,"#36-12 The contract had previously been for two races, but after acquiring sponsorship, the deal was increased by five events; earlier in August, Wilson recorded a best finish of second at Mid-Ohio Sports Car Course.",75,86,sponsorship,9,5,14
39I4RL8QGJIU3245GR7WRX4WPD14HL,"#36-12 The contract had previously been for two races, but after acquiring sponsorship, the deal was increased by five events; earlier in August, Wilson recorded a best finish of second at Mid-Ohio Sports Car Course.",101,110,increased,0,1,1
39I4RL8QGJIU3245GR7WRX4WPD14HL,"#36-12 The contract had previously been for two races, but after acquiring sponsorship, the deal was increased by five events; earlier in August, Wilson recorded a best finish of second at Mid-Ohio Sports Car Course.",119,125,events,1,0,1
39I4RL8QGJIU3245GR7WRX4WPD14HL,"#36-12 The contract had previously been for two races, but after acquiring sponsorship, the deal was increased by five events; earlier in August, Wilson recorded a best finish of second at Mid-Ohio Sports Car Course.",153,161,recorded,1,2,3
39I4RL8QGJIU3245GR7WRX4WPD14HL,"#36-12 The contract had previously been for two races, but after acquiring sponsorship, the deal was increased by five events; earlier in August, Wilson recorded a best finish of second at Mid-Ohio Sports Car Course.",164,175,best finish,1,0,1
39I4RL8QGJIU3245GR7WRX4WPD14HL,"#36-12 The contract had previously been for two races, but after acquiring sponsorship, the deal was increased by five events; earlier in August, Wilson recorded a best finish of second at Mid-Ohio Sports Car Course.",189,215,Mid-Ohio Sports Car Course,0,1,1
388CL5C1RJOQ1ABQMJ6DDE67BZWHLR,"#42-69 I don't own a car, so that means I'm excused right?",44,51,excused,5,4,9
388CL5C1RJOQ1ABQMJ6DDE67BZWHLR,#42-70 ;) Wikinews: This is the first evidence for self-medicating insects.,38,46,evidence,4,1,5
388CL5C1RJOQ1ABQMJ6DDE67BZWHLR,#42-70 ;) Wikinews: This is the first evidence for self-medicating insects.,51,66,self-medicating,9,6,15
388CL5C1RJOQ1ABQMJ6DDE67BZWHLR,#42-70 ;) Wikinews: This is the first evidence for self-medicating insects.,51,74,self-medicating insects,1,1,2
388CL5C1RJOQ1ABQMJ6DDE67BZWHLR,#42-70 ;) Wikinews: This is the first evidence for self-medicating insects.,67,74,insects,1,0,1
388CL5C1RJOQ1ABQMJ6DDE67BZWHLR,#42-71 How widespread do you think this phenomenon could be in reality?,11,21,widespread,5,9,14
388CL5C1RJOQ1ABQMJ6DDE67BZWHLR,#42-71 How widespread do you think this phenomenon could be in reality?,11,50,widespread do you think this phenomenon,1,0,1
388CL5C1RJOQ1ABQMJ6DDE67BZWHLR,#42-71 How widespread do you think this phenomenon could be in reality?,40,50,phenomenon,10,10,20
388CL5C1RJOQ1ABQMJ6DDE67BZWHLR,#42-72 NB: It's not actually the first evidence for self-medication in insects.,33,47,first evidence,1,0,1
388CL5C1RJOQ1ABQMJ6DDE67BZWHLR,#42-72 NB: It's not actually the first evidence for self-medication in insects.,39,47,evidence,1,2,3
388CL5C1RJOQ1ABQMJ6DDE67BZWHLR,#42-72 NB: It's not actually the first evidence for self-medication in insects.,52,67,self-medication,4,1,5
388CL5C1RJOQ1ABQMJ6DDE67BZWHLR,"#42-73 Moths and fruit flies definitely do it, and there's evidence in honey bees and bumble-bees as well.",7,12,Moths,0,4,4
388CL5C1RJOQ1ABQMJ6DDE67BZWHLR,"#42-73 Moths and fruit flies definitely do it, and there's evidence in honey bees and bumble-bees as well.",29,39,definitely,0,2,2
388CL5C1RJOQ1ABQMJ6DDE67BZWHLR,"#42-73 Moths and fruit flies definitely do it, and there's evidence in honey bees and bumble-bees as well.",59,67,evidence,3,2,5
388CL5C1RJOQ1ABQMJ6DDE67BZWHLR,"#42-73 Moths and fruit flies definitely do it, and there's evidence in honey bees and bumble-bees as well.",59,105,evidence in honey bees and bumble-bees as well,1,0,1
388CL5C1RJOQ1ABQMJ6DDE67BZWHLR,"#42-73 Moths and fruit flies definitely do it, and there's evidence in honey bees and bumble-bees as well.",86,97,bumble-bees,3,5,8
388CL5C1RJOQ1ABQMJ6DDE67BZWHLR,#42-74 So it seems to be quite wide-spread in the insect world.,31,42,wide-spread,2,2,4
388CL5C1RJOQ1ABQMJ6DDE67BZWHLR,#42-74 So it seems to be quite wide-spread in the insect world.,50,56,insect,1,0,1
388CL5C1RJOQ1ABQMJ6DDE67BZWHLR,#42-74 So it seems to be quite wide-spread in the insect world.,50,62,insect world,0,1,1
388CL5C1RJOQ1ABQMJ6DDE67BZWHLR,"#42-75 I have no doubt that as time goes on, there will be more and more cases documented.",17,22,doubt,0,1,1
388CL5C1RJOQ1ABQMJ6DDE67BZWHLR,"#42-75 I have no doubt that as time goes on, there will be more and more cases documented.",73,89,cases documented,1,0,1
388CL5C1RJOQ1ABQMJ6DDE67BZWHLR,"#42-75 I have no doubt that as time goes on, there will be more and more cases documented.",79,89,documented,7,6,13
388CL5C1RJOQ1ABQMJ6DDE67BZWHLR,#42-76 Insects (and animals in general) seem to be quite good at taking care of themselves.,65,90,taking care of themselves,1,0,1
388CL5C1RJOQ1ABQMJ6DDE67BZWHLR,#42-77 Wikinews: How might ants locate healing substances in the wild?,32,38,locate,1,0,1
388CL5C1RJOQ1ABQMJ6DDE67BZWHLR,#42-77 Wikinews: How might ants locate healing substances in the wild?,39,46,healing,1,5,6
388CL5C1RJOQ1ABQMJ6DDE67BZWHLR,#42-77 Wikinews: How might ants locate healing substances in the wild?,39,57,healing substances,2,3,5
388CL5C1RJOQ1ABQMJ6DDE67BZWHLR,#42-77 Wikinews: How might ants locate healing substances in the wild?,47,57,substances,2,2,4
3MVY4USGB6OD1IH0CALZPCLH36JISZ,"#16-2 The Obamas and Bidens, pictured together from file, have enjoyed an unusually close and warm relationship.",21,27,Bidens,0,1,1
3MVY4USGB6OD1IH0CALZPCLH36JISZ,"#16-2 The Obamas and Bidens, pictured together from file, have enjoyed an unusually close and warm relationship.",29,37,pictured,1,3,4
3MVY4USGB6OD1IH0CALZPCLH36JISZ,"#16-2 The Obamas and Bidens, pictured together from file, have enjoyed an unusually close and warm relationship.",29,46,pictured together,1,0,1
3MVY4USGB6OD1IH0CALZPCLH36JISZ,"#16-2 The Obamas and Bidens, pictured together from file, have enjoyed an unusually close and warm relationship.",52,56,file,0,1,1
3MVY4USGB6OD1IH0CALZPCLH36JISZ,"#16-2 The Obamas and Bidens, pictured together from file, have enjoyed an unusually close and warm relationship.",63,70,enjoyed,0,1,1
3MVY4USGB6OD1IH0CALZPCLH36JISZ,"#16-2 The Obamas and Bidens, pictured together from file, have enjoyed an unusually close and warm relationship.",74,83,unusually,3,3,6
3MVY4USGB6OD1IH0CALZPCLH36JISZ,"#16-2 The Obamas and Bidens, pictured together from file, have enjoyed an unusually close and warm relationship.",94,111,warm relationship,0,1,1
3MVY4USGB6OD1IH0CALZPCLH36JISZ,"#16-3 In a ceremony described by the press as highly emotional, Obama cited his choice of Biden as a running mate as one of the best of his career and described their few arguments as the sort that brothers would have and Biden himself as ""a lion of American history.""",11,19,ceremony,4,6,10
3MVY4USGB6OD1IH0CALZPCLH36JISZ,"#16-3 In a ceremony described by the press as highly emotional, Obama cited his choice of Biden as a running mate as one of the best of his career and described their few arguments as the sort that brothers would have and Biden himself as ""a lion of American history.""",20,29,described,0,1,1
3MVY4USGB6OD1IH0CALZPCLH36JISZ,"#16-3 In a ceremony described by the press as highly emotional, Obama cited his choice of Biden as a running mate as one of the best of his career and described their few arguments as the sort that brothers would have and Biden himself as ""a lion of American history.""",46,62,highly emotional,1,1,2
3MVY4USGB6OD1IH0CALZPCLH36JISZ,"#16-3 In a ceremony described by the press as highly emotional, Obama cited his choice of Biden as a running mate as one of the best of his career and described their few arguments as the sort that brothers would have and Biden himself as ""a lion of American history.""",53,62,emotional,1,2,3
3MVY4USGB6OD1IH0CALZPCLH36JISZ,"#16-3 In a ceremony described by the press as highly emotional, Obama cited his choice of Biden as a running mate as one of the best of his career and described their few arguments as the sort that brothers would have and Biden himself as ""a lion of American history.""",70,75,cited,3,2,5
3MVY4USGB6OD1IH0CALZPCLH36JISZ,"#16-3 In a ceremony described by the press as highly emotional, Obama cited his choice of Biden as a running mate as one of the best of his career and described their few arguments as the sort that brothers would have and Biden himself as ""a lion of American history.""",101,113,running mate,1,2,3
3MVY4USGB6OD1IH0CALZPCLH36JISZ,"#16-3 In a ceremony described by the press as highly emotional, Obama cited his choice of Biden as a running mate as one of the best of his career and described their few arguments as the sort that brothers would have and Biden himself as ""a lion of American history.""",109,113,mate,0,2,2
3MVY4USGB6OD1IH0CALZPCLH36JISZ,"#16-3 In a ceremony described by the press as highly emotional, Obama cited his choice of Biden as a running mate as one of the best of his career and described their few arguments as the sort that brothers would have and Biden himself as ""a lion of American history.""",140,146,career,1,0,1
3MVY4USGB6OD1IH0CALZPCLH36JISZ,"#16-3 In a ceremony described by the press as highly emotional, Obama cited his choice of Biden as a running mate as one of the best of his career and described their few arguments as the sort that brothers would have and Biden himself as ""a lion of American history.""",151,160,described,1,1,2
3MVY4USGB6OD1IH0CALZPCLH36JISZ,"#16-3 In a ceremony described by the press as highly emotional, Obama cited his choice of Biden as a running mate as one of the best of his career and described their few arguments as the sort that brothers would have and Biden himself as ""a lion of American history.""",171,180,arguments,5,4,9
3MVY4USGB6OD1IH0CALZPCLH36JISZ,"#16-3 In a ceremony described by the press as highly emotional, Obama cited his choice of Biden as a running mate as one of the best of his career and described their few arguments as the sort that brothers would have and Biden himself as ""a lion of American history.""",240,266,a lion of American history,1,0,1
3MVY4USGB6OD1IH0CALZPCLH36JISZ,"#16-4 This made only the fourth time in U.S. history that this modified form, the Medal of Freedom with distinction, has been awarded.",63,71,modified,8,4,12
3MVY4USGB6OD1IH0CALZPCLH36JISZ,"#16-4 This made only the fourth time in U.S. history that this modified form, the Medal of Freedom with distinction, has been awarded.",63,76,modified form,2,2,4
3MVY4USGB6OD1IH0CALZPCLH36JISZ,"#16-4 This made only the fourth time in U.S. history that this modified form, the Medal of Freedom with distinction, has been awarded.",82,98,Medal of Freedom,1,0,1
3MVY4USGB6OD1IH0CALZPCLH36JISZ,"#16-4 This made only the fourth time in U.S. history that this modified form, the Medal of Freedom with distinction, has been awarded.",104,115,distinction,10,7,17
3MVY4USGB6OD1IH0CALZPCLH36JISZ,"#16-4 This made only the fourth time in U.S. history that this modified form, the Medal of Freedom with distinction, has been awarded.",126,133,awarded,0,2,2
3MVY4USGB6OD1IH0CALZPCLH36JISZ,"#16-5 Biden joined Pope John Paul II, then-former President Ronald Reagan, and former General and Secretary of State Colin Powell.",19,33,Pope John Paul,0,1,1
3MVY4USGB6OD1IH0CALZPCLH36JISZ,"#16-5 Biden joined Pope John Paul II, then-former President Ronald Reagan, and former General and Secretary of State Colin Powell.",38,49,then-former,0,1,1
3MVY4USGB6OD1IH0CALZPCLH36JISZ,"#16-5 Biden joined Pope John Paul II, then-former President Ronald Reagan, and former General and Secretary of State Colin Powell.",98,107,Secretary,1,0,1
3MVY4USGB6OD1IH0CALZPCLH36JISZ,"#16-5 Biden joined Pope John Paul II, then-former President Ronald Reagan, and former General and Secretary of State Colin Powell.",98,116,Secretary of State,1,0,1
3MVY4USGB6OD1IH0CALZPCLH36JISZ,"#16-5 Biden joined Pope John Paul II, then-former President Ronald Reagan, and former General and Secretary of State Colin Powell.",117,129,Colin Powell,0,1,1
3MVY4USGB6OD1IH0CALZPCLH36JISZ,"#16-6 Early during the ceremony, Obama noted comically ""this also gives the Internet one last chance to talk about our 'bromance.'""",23,31,ceremony,1,0,1
3MVY4USGB6OD1IH0CALZPCLH36JISZ,"#16-6 Early during the ceremony, Obama noted comically ""this also gives the Internet one last chance to talk about our 'bromance.'""",45,54,comically,10,7,17
3MVY4USGB6OD1IH0CALZPCLH36JISZ,"#16-6 Early during the ceremony, Obama noted comically ""this also gives the Internet one last chance to talk about our 'bromance.'""",120,128,bromance,10,9,19
3HO4MYYR12PDNBE3ZE7A7AD0FC96U9,"#29-5 Martin, best known for spreading multiple conspiracy theories concerning the birth and religion of U.S. President Barack Obama, previously ran for the Democratic Party presidential nomination in 1988, and unsuccessfully sought the backing of the Republican Party in 2000 and 2012.",29,38,spreading,1,5,6
3HO4MYYR12PDNBE3ZE7A7AD0FC96U9,"#29-5 Martin, best known for spreading multiple conspiracy theories concerning the birth and religion of U.S. President Barack Obama, previously ran for the Democratic Party presidential nomination in 1988, and unsuccessfully sought the backing of the Republican Party in 2000 and 2012.",29,47,spreading multiple,0,1,1
3HO4MYYR12PDNBE3ZE7A7AD0FC96U9,"#29-5 Martin, best known for spreading multiple conspiracy theories concerning the birth and religion of U.S. President Barack Obama, previously ran for the Democratic Party presidential nomination in 1988, and unsuccessfully sought the backing of the Republican Party in 2000 and 2012.",39,47,multiple,3,0,3
3HO4MYYR12PDNBE3ZE7A7AD0FC96U9,"#29-5 Martin, best known for spreading multiple conspiracy theories concerning the birth and religion of U.S. President Barack Obama, previously ran for the Democratic Party presidential nomination in 1988, and unsuccessfully sought the backing of the Republican Party in 2000 and 2012.",39,67,multiple conspiracy theories,1,1,2
3HO4MYYR12PDNBE3ZE7A7AD0FC96U9,"#29-5 Martin, best known for spreading multiple conspiracy theories concerning the birth and religion of U.S. President Barack Obama, previously ran for the Democratic Party presidential nomination in 1988, and unsuccessfully sought the backing of the Republican Party in 2000 and 2012.",48,58,conspiracy,7,8,15
3HO4MYYR12PDNBE3ZE7A7AD0FC96U9,"#29-5 Martin, best known for spreading multiple conspiracy theories concerning the birth and religion of U.S. President Barack Obama, previously ran for the Democratic Party presidential nomination in 1988, and unsuccessfully sought the backing of the Republican Party in 2000 and 2012.",48,67,conspiracy theories,4,1,5
3HO4MYYR12PDNBE3ZE7A7AD0FC96U9,"#29-5 Martin, best known for spreading multiple conspiracy theories concerning the birth and religion of U.S. President Barack Obama, previously ran for the Democratic Party presidential nomination in 1988, and unsuccessfully sought the backing of the Republican Party in 2000 and 2012.",59,67,theories,3,0,3
3HO4MYYR12PDNBE3ZE7A7AD0FC96U9,"#29-5 Martin, best known for spreading multiple conspiracy theories concerning the birth and religion of U.S. President Barack Obama, previously ran for the Democratic Party presidential nomination in 1988, and unsuccessfully sought the backing of the Republican Party in 2000 and 2012.",68,78,concerning,3,1,4
3HO4MYYR12PDNBE3ZE7A7AD0FC96U9,"#29-5 Martin, best known for spreading multiple conspiracy theories concerning the birth and religion of U.S. President Barack Obama, previously ran for the Democratic Party presidential nomination in 1988, and unsuccessfully sought the backing of the Republican Party in 2000 and 2012.",110,119,President,1,0,1
3HO4MYYR12PDNBE3ZE7A7AD0FC96U9,"#29-5 Martin, best known for spreading multiple conspiracy theories concerning the birth and religion of U.S. President Barack Obama, previously ran for the Democratic Party presidential nomination in 1988, and unsuccessfully sought the backing of the Republican Party in 2000 and 2012.",110,132,President Barack Obama,0,1,1
3HO4MYYR12PDNBE3ZE7A7AD0FC96U9,"#29-5 Martin, best known for spreading multiple conspiracy theories concerning the birth and religion of U.S. President Barack Obama, previously ran for the Democratic Party presidential nomination in 1988, and unsuccessfully sought the backing of the Republican Party in 2000 and 2012.",134,144,previously,0,1,1
3HO4MYYR12PDNBE3ZE7A7AD0FC96U9,"#29-5 Martin, best known for spreading multiple conspiracy theories concerning the birth and religion of U.S. President Barack Obama, previously ran for the Democratic Party presidential nomination in 1988, and unsuccessfully sought the backing of the Republican Party in 2000 and 2012.",157,167,Democratic,1,0,1
3HO4MYYR12PDNBE3ZE7A7AD0FC96U9,"#29-5 Martin, best known for spreading multiple conspiracy theories concerning the birth and religion of U.S. President Barack Obama, previously ran for the Democratic Party presidential nomination in 1988, and unsuccessfully sought the backing of the Republican Party in 2000 and 2012.",174,186,presidential,3,1,4
3HO4MYYR12PDNBE3ZE7A7AD0FC96U9,"#29-5 Martin, best known for spreading multiple conspiracy theories concerning the birth and religion of U.S. President Barack Obama, previously ran for the Democratic Party presidential nomination in 1988, and unsuccessfully sought the backing of the Republican Party in 2000 and 2012.",174,197,presidential nomination,1,0,1
3HO4MYYR12PDNBE3ZE7A7AD0FC96U9,"#29-5 Martin, best known for spreading multiple conspiracy theories concerning the birth and religion of U.S. President Barack Obama, previously ran for the Democratic Party presidential nomination in 1988, and unsuccessfully sought the backing of the Republican Party in 2000 and 2012.",187,197,nomination,7,4,11
3HO4MYYR12PDNBE3ZE7A7AD0FC96U9,"#29-5 Martin, best known for spreading multiple conspiracy theories concerning the birth and religion of U.S. President Barack Obama, previously ran for the Democratic Party presidential nomination in 1988, and unsuccessfully sought the backing of the Republican Party in 2000 and 2012.",211,225,unsuccessfully,7,1,8
3HO4MYYR12PDNBE3ZE7A7AD0FC96U9,"#29-5 Martin, best known for spreading multiple conspiracy theories concerning the birth and religion of U.S. President Barack Obama, previously ran for the Democratic Party presidential nomination in 1988, and unsuccessfully sought the backing of the Republican Party in 2000 and 2012.",211,232,unsuccessfully sought,0,1,1
3HO4MYYR12PDNBE3ZE7A7AD0FC96U9,"#29-5 Martin, best known for spreading multiple conspiracy theories concerning the birth and religion of U.S. President Barack Obama, previously ran for the Democratic Party presidential nomination in 1988, and unsuccessfully sought the backing of the Republican Party in 2000 and 2012.",226,232,sought,5,5,10
3HO4MYYR12PDNBE3ZE7A7AD0FC96U9,"#29-5 Martin, best known for spreading multiple conspiracy theories concerning the birth and religion of U.S. President Barack Obama, previously ran for the Democratic Party presidential nomination in 1988, and unsuccessfully sought the backing of the Republican Party in 2000 and 2012.",252,262,Republican,1,1,2
3HO4MYYR12PDNBE3ZE7A7AD0FC96U9,"#29-5 Martin, best known for spreading multiple conspiracy theories concerning the birth and religion of U.S. President Barack Obama, previously ran for the Democratic Party presidential nomination in 1988, and unsuccessfully sought the backing of the Republican Party in 2000 and 2012.",252,268,Republican Party,0,1,1
3HO4MYYR12PDNBE3ZE7A7AD0FC96U9,"#29-6 In 2012, he received a total of 19 votes in the New Hampshire Primary, the only primary ballot on which he appeared.",68,75,Primary,0,1,1
3HO4MYYR12PDNBE3ZE7A7AD0FC96U9,"#29-6 In 2012, he received a total of 19 votes in the New Hampshire Primary, the only primary ballot on which he appeared.",86,93,primary,1,0,1
3HO4MYYR12PDNBE3ZE7A7AD0FC96U9,"#29-6 In 2012, he received a total of 19 votes in the New Hampshire Primary, the only primary ballot on which he appeared.",94,100,ballot,5,4,9
3HO4MYYR12PDNBE3ZE7A7AD0FC96U9,"#29-6 In 2012, he received a total of 19 votes in the New Hampshire Primary, the only primary ballot on which he appeared.",113,121,appeared,0,1,1
3HO4MYYR12PDNBE3ZE7A7AD0FC96U9,"#29-7 For 2016, Martin does not harbor high expectations of electoral success, though he hopes to receive an invitation to the debates.",32,38,harbor,3,6,9
3HO4MYYR12PDNBE3ZE7A7AD0FC96U9,"#29-7 For 2016, Martin does not harbor high expectations of electoral success, though he hopes to receive an invitation to the debates.",32,56,harbor high expectations,0,1,1
3HO4MYYR12PDNBE3ZE7A7AD0FC96U9,"#29-7 For 2016, Martin does not harbor high expectations of electoral success, though he hopes to receive an invitation to the debates.",44,56,expectations,4,1,5
3HO4MYYR12PDNBE3ZE7A7AD0FC96U9,"#29-7 For 2016, Martin does not harbor high expectations of electoral success, though he hopes to receive an invitation to the debates.",60,69,electoral,6,1,7
3HO4MYYR12PDNBE3ZE7A7AD0FC96U9,"#29-7 For 2016, Martin does not harbor high expectations of electoral success, though he hopes to receive an invitation to the debates.",60,77,electoral success,2,0,2
3HO4MYYR12PDNBE3ZE7A7AD0FC96U9,"#29-7 For 2016, Martin does not harbor high expectations of electoral success, though he hopes to receive an invitation to the debates.",127,134,debates,2,2,4
3HO4MYYR12PDNBE3ZE7A7AD0FC96U9,"#29-8 In reference to the seventeen candidates invited to the two August 6 Fox News debates, Martin casts himself as the ""eighteenth candidate,"" willing to participate in the second-tier debate.",9,18,reference,0,1,1
3HO4MYYR12PDNBE3ZE7A7AD0FC96U9,"#29-8 In reference to the seventeen candidates invited to the two August 6 Fox News debates, Martin casts himself as the ""eighteenth candidate,"" willing to participate in the second-tier debate.",26,46,seventeen candidates,0,1,1
3HO4MYYR12PDNBE3ZE7A7AD0FC96U9,"#29-8 In reference to the seventeen candidates invited to the two August 6 Fox News debates, Martin casts himself as the ""eighteenth candidate,"" willing to participate in the second-tier debate.",84,91,debates,2,0,2
3HO4MYYR12PDNBE3ZE7A7AD0FC96U9,"#29-8 In reference to the seventeen candidates invited to the two August 6 Fox News debates, Martin casts himself as the ""eighteenth candidate,"" willing to participate in the second-tier debate.",100,105,casts,0,4,4
3HO4MYYR12PDNBE3ZE7A7AD0FC96U9,"#29-8 In reference to the seventeen candidates invited to the two August 6 Fox News debates, Martin casts himself as the ""eighteenth candidate,"" willing to participate in the second-tier debate.",122,132,eighteenth,1,1,2
3HO4MYYR12PDNBE3ZE7A7AD0FC96U9,"#29-8 In reference to the seventeen candidates invited to the two August 6 Fox News debates, Martin casts himself as the ""eighteenth candidate,"" willing to participate in the second-tier debate.",122,142,eighteenth candidate,2,0,2
3HO4MYYR12PDNBE3ZE7A7AD0FC96U9,"#29-8 In reference to the seventeen candidates invited to the two August 6 Fox News debates, Martin casts himself as the ""eighteenth candidate,"" willing to participate in the second-tier debate.",145,152,willing,1,1,2
3HO4MYYR12PDNBE3ZE7A7AD0FC96U9,"#29-8 In reference to the seventeen candidates invited to the two August 6 Fox News debates, Martin casts himself as the ""eighteenth candidate,"" willing to participate in the second-tier debate.",156,167,participate,1,1,2
3HO4MYYR12PDNBE3ZE7A7AD0FC96U9,"#29-8 In reference to the seventeen candidates invited to the two August 6 Fox News debates, Martin casts himself as the ""eighteenth candidate,"" willing to participate in the second-tier debate.",175,186,second-tier,5,3,8
3HO4MYYR12PDNBE3ZE7A7AD0FC96U9,"#29-8 In reference to the seventeen candidates invited to the two August 6 Fox News debates, Martin casts himself as the ""eighteenth candidate,"" willing to participate in the second-tier debate.",175,193,second-tier debate,1,0,1
3HO4MYYR12PDNBE3ZE7A7AD0FC96U9,"#29-8 In reference to the seventeen candidates invited to the two August 6 Fox News debates, Martin casts himself as the ""eighteenth candidate,"" willing to participate in the second-tier debate.",187,193,debate,2,0,2
3HO4MYYR12PDNBE3ZE7A7AD0FC96U9,"#29-9 Moreover, he declares himself as the ""second-most exciting"" candidate, reserving first place for Trump, whom Martin praises throughout his announcement.",6,14,Moreover,1,0,1
3HO4MYYR12PDNBE3ZE7A7AD0FC96U9,"#29-9 Moreover, he declares himself as the ""second-most exciting"" candidate, reserving first place for Trump, whom Martin praises throughout his announcement.",44,55,second-most,0,1,1
3HO4MYYR12PDNBE3ZE7A7AD0FC96U9,"#29-9 Moreover, he declares himself as the ""second-most exciting"" candidate, reserving first place for Trump, whom Martin praises throughout his announcement.",56,64,exciting,2,0,2
3HO4MYYR12PDNBE3ZE7A7AD0FC96U9,"#29-9 Moreover, he declares himself as the ""second-most exciting"" candidate, reserving first place for Trump, whom Martin praises throughout his announcement.",77,86,reserving,1,0,1
3HO4MYYR12PDNBE3ZE7A7AD0FC96U9,"#29-9 Moreover, he declares himself as the ""second-most exciting"" candidate, reserving first place for Trump, whom Martin praises throughout his announcement.",122,129,praises,2,2,4
3HO4MYYR12PDNBE3ZE7A7AD0FC96U9,"#29-9 Moreover, he declares himself as the ""second-most exciting"" candidate, reserving first place for Trump, whom Martin praises throughout his announcement.",130,140,throughout,1,1,2
3HO4MYYR12PDNBE3ZE7A7AD0FC96U9,"#29-9 Moreover, he declares himself as the ""second-most exciting"" candidate, reserving first place for Trump, whom Martin praises throughout his announcement.",145,157,announcement,6,4,10
3KQC8JMJGCT9L6L1GD2DHSCQBD5H3D,"#19-5 According to Agus Supriatna, chief of the Air Force, the pilot reported technical problems and requested return to base.",6,18,According to,0,1,1
3KQC8JMJGCT9L6L1GD2DHSCQBD5H3D,"#19-5 According to Agus Supriatna, chief of the Air Force, the pilot reported technical problems and requested return to base.",19,23,Agus,1,0,1
3KQC8JMJGCT9L6L1GD2DHSCQBD5H3D,"#19-5 According to Agus Supriatna, chief of the Air Force, the pilot reported technical problems and requested return to base.",19,33,Agus Supriatna,1,0,1
3KQC8JMJGCT9L6L1GD2DHSCQBD5H3D,"#19-5 According to Agus Supriatna, chief of the Air Force, the pilot reported technical problems and requested return to base.",24,33,Supriatna,3,0,3
3KQC8JMJGCT9L6L1GD2DHSCQBD5H3D,"#19-5 According to Agus Supriatna, chief of the Air Force, the pilot reported technical problems and requested return to base.",35,40,chief,1,0,1
3KQC8JMJGCT9L6L1GD2DHSCQBD5H3D,"#19-5 According to Agus Supriatna, chief of the Air Force, the pilot reported technical problems and requested return to base.",63,68,pilot,1,0,1
3KQC8JMJGCT9L6L1GD2DHSCQBD5H3D,"#19-5 According to Agus Supriatna, chief of the Air Force, the pilot reported technical problems and requested return to base.",69,77,reported,1,1,2
3KQC8JMJGCT9L6L1GD2DHSCQBD5H3D,"#19-5 According to Agus Supriatna, chief of the Air Force, the pilot reported technical problems and requested return to base.",78,87,technical,4,2,6
3KQC8JMJGCT9L6L1GD2DHSCQBD5H3D,"#19-5 According to Agus Supriatna, chief of the Air Force, the pilot reported technical problems and requested return to base.",78,96,technical problems,2,1,3
3KQC8JMJGCT9L6L1GD2DHSCQBD5H3D,"#19-5 According to Agus Supriatna, chief of the Air Force, the pilot reported technical problems and requested return to base.",101,110,requested,1,2,3
3KQC8JMJGCT9L6L1GD2DHSCQBD5H3D,"#19-5 According to Agus Supriatna, chief of the Air Force, the pilot reported technical problems and requested return to base.",111,125,return to base,0,1,1
3KQC8JMJGCT9L6L1GD2DHSCQBD5H3D,"#19-5 According to Agus Supriatna, chief of the Air Force, the pilot reported technical problems and requested return to base.",121,125,base,0,1,1
3KQC8JMJGCT9L6L1GD2DHSCQBD5H3D,#19-6 The aircraft was en route from Soewondo Air Force Base to Natuna.,23,25,en,0,1,1
3KQC8JMJGCT9L6L1GD2DHSCQBD5H3D,#19-6 The aircraft was en route from Soewondo Air Force Base to Natuna.,23,31,en route,7,4,11
3KQC8JMJGCT9L6L1GD2DHSCQBD5H3D,#19-6 The aircraft was en route from Soewondo Air Force Base to Natuna.,26,31,route,1,0,1
3KQC8JMJGCT9L6L1GD2DHSCQBD5H3D,#19-6 The aircraft was en route from Soewondo Air Force Base to Natuna.,37,45,Soewondo,3,0,3
3KQC8JMJGCT9L6L1GD2DHSCQBD5H3D,#19-6 The aircraft was en route from Soewondo Air Force Base to Natuna.,64,70,Natuna,3,0,3
3KQC8JMJGCT9L6L1GD2DHSCQBD5H3D,"#19-7 The air force first said there were twelve crew members on board, but the total number of reported fatalities continued to change with later reports.",49,53,crew,3,2,5
3KQC8JMJGCT9L6L1GD2DHSCQBD5H3D,"#19-7 The air force first said there were twelve crew members on board, but the total number of reported fatalities continued to change with later reports.",49,61,crew members,0,1,1
3KQC8JMJGCT9L6L1GD2DHSCQBD5H3D,"#19-7 The air force first said there were twelve crew members on board, but the total number of reported fatalities continued to change with later reports.",62,70,on board,1,2,3
3KQC8JMJGCT9L6L1GD2DHSCQBD5H3D,"#19-7 The air force first said there were twelve crew members on board, but the total number of reported fatalities continued to change with later reports.",105,115,fatalities,10,9,19
3KQC8JMJGCT9L6L1GD2DHSCQBD5H3D,"#19-7 The air force first said there were twelve crew members on board, but the total number of reported fatalities continued to change with later reports.",116,125,continued,0,1,1
3KQC8JMJGCT9L6L1GD2DHSCQBD5H3D,"#19-8 Police found even more dead bodies from the crash on the ground, raising the reported death toll as high as 142 people.",83,91,reported,1,0,1
3KQC8JMJGCT9L6L1GD2DHSCQBD5H3D,"#19-8 Police found even more dead bodies from the crash on the ground, raising the reported death toll as high as 142 people.",92,102,death toll,2,0,2
3KQC8JMJGCT9L6L1GD2DHSCQBD5H3D,"#19-8 Police found even more dead bodies from the crash on the ground, raising the reported death toll as high as 142 people.",98,102,toll,1,1,2
3KQC8JMJGCT9L6L1GD2DHSCQBD5H3D,"#19-9 Some bodies have been identified by blood sampling, an official told newspaper Jakarta Globe.",28,38,identified,1,1,2
3KQC8JMJGCT9L6L1GD2DHSCQBD5H3D,"#19-9 Some bodies have been identified by blood sampling, an official told newspaper Jakarta Globe.",42,56,blood sampling,4,2,6
3KQC8JMJGCT9L6L1GD2DHSCQBD5H3D,"#19-9 Some bodies have been identified by blood sampling, an official told newspaper Jakarta Globe.",48,56,sampling,2,6,8
3KQC8JMJGCT9L6L1GD2DHSCQBD5H3D,"#19-9 Some bodies have been identified by blood sampling, an official told newspaper Jakarta Globe.",75,84,newspaper,1,0,1
3KQC8JMJGCT9L6L1GD2DHSCQBD5H3D,"#19-9 Some bodies have been identified by blood sampling, an official told newspaper Jakarta Globe.",85,92,Jakarta,1,0,1
3KQC8JMJGCT9L6L1GD2DHSCQBD5H3D,#19-10 There were some allegations that passengers on the aircraft were not limited to military families.,23,34,allegations,10,9,19
3KQC8JMJGCT9L6L1GD2DHSCQBD5H3D,#19-10 There were some allegations that passengers on the aircraft were not limited to military families.,40,50,passengers,1,0,1
3KQC8JMJGCT9L6L1GD2DHSCQBD5H3D,#19-10 There were some allegations that passengers on the aircraft were not limited to military families.,58,66,aircraft,0,1,1
3KQC8JMJGCT9L6L1GD2DHSCQBD5H3D,#19-10 There were some allegations that passengers on the aircraft were not limited to military families.,76,83,limited,0,1,1
3KQC8JMJGCT9L6L1GD2DHSCQBD5H3D,#19-10 There were some allegations that passengers on the aircraft were not limited to military families.,87,95,military,0,1,1
3KQC8JMJGCT9L6L1GD2DHSCQBD5H3D,"#19-11 The military is not allowed to fly civilian passengers, according to the air force chief, unless they are related to military personnel, or under some special circumstances.",42,50,civilian,5,1,6
3KQC8JMJGCT9L6L1GD2DHSCQBD5H3D,"#19-11 The military is not allowed to fly civilian passengers, according to the air force chief, unless they are related to military personnel, or under some special circumstances.",42,61,civilian passengers,1,1,2
3KQC8JMJGCT9L6L1GD2DHSCQBD5H3D,"#19-11 The military is not allowed to fly civilian passengers, according to the air force chief, unless they are related to military personnel, or under some special circumstances.",51,61,passengers,1,0,1
3KQC8JMJGCT9L6L1GD2DHSCQBD5H3D,"#19-11 The military is not allowed to fly civilian passengers, according to the air force chief, unless they are related to military personnel, or under some special circumstances.",113,132,related to military,0,1,1
3KQC8JMJGCT9L6L1GD2DHSCQBD5H3D,"#19-11 The military is not allowed to fly civilian passengers, according to the air force chief, unless they are related to military personnel, or under some special circumstances.",124,142,military personnel,1,0,1
3KQC8JMJGCT9L6L1GD2DHSCQBD5H3D,"#19-11 The military is not allowed to fly civilian passengers, according to the air force chief, unless they are related to military personnel, or under some special circumstances.",133,142,personnel,1,2,3
3KQC8JMJGCT9L6L1GD2DHSCQBD5H3D,"#19-11 The military is not allowed to fly civilian passengers, according to the air force chief, unless they are related to military personnel, or under some special circumstances.",158,179,special circumstances,4,0,4
3KQC8JMJGCT9L6L1GD2DHSCQBD5H3D,"#19-11 The military is not allowed to fly civilian passengers, according to the air force chief, unless they are related to military personnel, or under some special circumstances.",166,179,circumstances,7,9,16
308KJXFUJR7ZA0BHPMYCIJTKSHRTAU,"#24-33 I could even make out the doors on the plane clearly"", one resident was quoted as saying to the newspaper Haveeru Daily.",20,28,make out,0,1,1
308KJXFUJR7ZA0BHPMYCIJTKSHRTAU,"#24-33 I could even make out the doors on the plane clearly"", one resident was quoted as saying to the newspaper Haveeru Daily.",66,74,resident,3,3,6
308KJXFUJR7ZA0BHPMYCIJTKSHRTAU,"#24-33 I could even make out the doors on the plane clearly"", one resident was quoted as saying to the newspaper Haveeru Daily.",79,85,quoted,4,4,8
308KJXFUJR7ZA0BHPMYCIJTKSHRTAU,"#24-33 I could even make out the doors on the plane clearly"", one resident was quoted as saying to the newspaper Haveeru Daily.",103,112,newspaper,1,0,1
308KJXFUJR7ZA0BHPMYCIJTKSHRTAU,"#24-33 I could even make out the doors on the plane clearly"", one resident was quoted as saying to the newspaper Haveeru Daily.",113,126,Haveeru Daily,0,1,1
308KJXFUJR7ZA0BHPMYCIJTKSHRTAU,#24-34 Some claim the plane appeared to be headed in the direction of Diego Garcia.,28,36,appeared,2,1,3
308KJXFUJR7ZA0BHPMYCIJTKSHRTAU,#24-34 Some claim the plane appeared to be headed in the direction of Diego Garcia.,28,49,appeared to be headed,0,1,1
308KJXFUJR7ZA0BHPMYCIJTKSHRTAU,#24-34 Some claim the plane appeared to be headed in the direction of Diego Garcia.,43,49,headed,2,4,6
308KJXFUJR7ZA0BHPMYCIJTKSHRTAU,#24-34 Some claim the plane appeared to be headed in the direction of Diego Garcia.,70,75,Diego,1,0,1
308KJXFUJR7ZA0BHPMYCIJTKSHRTAU,#24-34 Some claim the plane appeared to be headed in the direction of Diego Garcia.,70,82,Diego Garcia,0,1,1
308KJXFUJR7ZA0BHPMYCIJTKSHRTAU,"#24-35 According to The Huffington Post, Haveeru reported the witnesses were interviewed by authorities who deemed their statements to be truthful, but Maldive military officials along with Malaysian officials say no such aircraft was in Maldive airspace at the time MH370 went missing.",7,16,According,1,0,1
308KJXFUJR7ZA0BHPMYCIJTKSHRTAU,"#24-35 According to The Huffington Post, Haveeru reported the witnesses were interviewed by authorities who deemed their statements to be truthful, but Maldive military officials along with Malaysian officials say no such aircraft was in Maldive airspace at the time MH370 went missing.",24,34,Huffington,0,1,1
308KJXFUJR7ZA0BHPMYCIJTKSHRTAU,"#24-35 According to The Huffington Post, Haveeru reported the witnesses were interviewed by authorities who deemed their statements to be truthful, but Maldive military officials along with Malaysian officials say no such aircraft was in Maldive airspace at the time MH370 went missing.",41,48,Haveeru,0,1,1
308KJXFUJR7ZA0BHPMYCIJTKSHRTAU,"#24-35 According to The Huffington Post, Haveeru reported the witnesses were interviewed by authorities who deemed their statements to be truthful, but Maldive military officials along with Malaysian officials say no such aircraft was in Maldive airspace at the time MH370 went missing.",49,57,reported,0,1,1
308KJXFUJR7ZA0BHPMYCIJTKSHRTAU,"#24-35 According to The Huffington Post, Haveeru reported the witnesses were interviewed by authorities who deemed their statements to be truthful, but Maldive military officials along with Malaysian officials say no such aircraft was in Maldive airspace at the time MH370 went missing.",62,71,witnesses,4,3,7
308KJXFUJR7ZA0BHPMYCIJTKSHRTAU,"#24-35 According to The Huffington Post, Haveeru reported the witnesses were interviewed by authorities who deemed their statements to be truthful, but Maldive military officials along with Malaysian officials say no such aircraft was in Maldive airspace at the time MH370 went missing.",77,88,interviewed,9,3,12
308KJXFUJR7ZA0BHPMYCIJTKSHRTAU,"#24-35 According to The Huffington Post, Haveeru reported the witnesses were interviewed by authorities who deemed their statements to be truthful, but Maldive military officials along with Malaysian officials say no such aircraft was in Maldive airspace at the time MH370 went missing.",92,103,authorities,5,2,7
308KJXFUJR7ZA0BHPMYCIJTKSHRTAU,"#24-35 According to The Huffington Post, Haveeru reported the witnesses were interviewed by authorities who deemed their statements to be truthful, but Maldive military officials along with Malaysian officials say no such aircraft was in Maldive airspace at the time MH370 went missing.",108,114,deemed,3,8,11
308KJXFUJR7ZA0BHPMYCIJTKSHRTAU,"#24-35 According to The Huffington Post, Haveeru reported the witnesses were interviewed by authorities who deemed their statements to be truthful, but Maldive military officials along with Malaysian officials say no such aircraft was in Maldive airspace at the time MH370 went missing.",138,146,truthful,0,1,1
308KJXFUJR7ZA0BHPMYCIJTKSHRTAU,"#24-35 According to The Huffington Post, Haveeru reported the witnesses were interviewed by authorities who deemed their statements to be truthful, but Maldive military officials along with Malaysian officials say no such aircraft was in Maldive airspace at the time MH370 went missing.",152,178,Maldive military officials,1,0,1
308KJXFUJR7ZA0BHPMYCIJTKSHRTAU,"#24-35 According to The Huffington Post, Haveeru reported the witnesses were interviewed by authorities who deemed their statements to be truthful, but Maldive military officials along with Malaysian officials say no such aircraft was in Maldive airspace at the time MH370 went missing.",190,199,Malaysian,0,1,1
308KJXFUJR7ZA0BHPMYCIJTKSHRTAU,"#24-35 According to The Huffington Post, Haveeru reported the witnesses were interviewed by authorities who deemed their statements to be truthful, but Maldive military officials along with Malaysian officials say no such aircraft was in Maldive airspace at the time MH370 went missing.",200,209,officials,1,0,1
308KJXFUJR7ZA0BHPMYCIJTKSHRTAU,"#24-35 According to The Huffington Post, Haveeru reported the witnesses were interviewed by authorities who deemed their statements to be truthful, but Maldive military officials along with Malaysian officials say no such aircraft was in Maldive airspace at the time MH370 went missing.",222,230,aircraft,0,2,2
308KJXFUJR7ZA0BHPMYCIJTKSHRTAU,"#24-35 According to The Huffington Post, Haveeru reported the witnesses were interviewed by authorities who deemed their statements to be truthful, but Maldive military officials along with Malaysian officials say no such aircraft was in Maldive airspace at the time MH370 went missing.",246,254,airspace,2,4,6
308KJXFUJR7ZA0BHPMYCIJTKSHRTAU,"#24-35 According to The Huffington Post, Haveeru reported the witnesses were interviewed by authorities who deemed their statements to be truthful, but Maldive military officials along with Malaysian officials say no such aircraft was in Maldive airspace at the time MH370 went missing.",273,285,went missing,0,1,1
308KJXFUJR7ZA0BHPMYCIJTKSHRTAU,"#24-35 According to The Huffington Post, Haveeru reported the witnesses were interviewed by authorities who deemed their statements to be truthful, but Maldive military officials along with Malaysian officials say no such aircraft was in Maldive airspace at the time MH370 went missing.",278,285,missing,0,1,1
308KJXFUJR7ZA0BHPMYCIJTKSHRTAU,"#24-36 ""Based on the monitoring up to date, no indication of Flight MH370 has been observed on any military radars in the country [Maldives].",21,31,monitoring,8,8,16
308KJXFUJR7ZA0BHPMYCIJTKSHRTAU,"#24-36 ""Based on the monitoring up to date, no indication of Flight MH370 has been observed on any military radars in the country [Maldives].",47,57,indication,4,4,8
308KJXFUJR7ZA0BHPMYCIJTKSHRTAU,"#24-36 ""Based on the monitoring up to date, no indication of Flight MH370 has been observed on any military radars in the country [Maldives].",83,91,observed,3,1,4
308KJXFUJR7ZA0BHPMYCIJTKSHRTAU,"#24-36 ""Based on the monitoring up to date, no indication of Flight MH370 has been observed on any military radars in the country [Maldives].",99,114,military radars,3,2,5
308KJXFUJR7ZA0BHPMYCIJTKSHRTAU,"#24-36 ""Based on the monitoring up to date, no indication of Flight MH370 has been observed on any military radars in the country [Maldives].",108,114,radars,1,3,4
308KJXFUJR7ZA0BHPMYCIJTKSHRTAU,"#24-37 Furthermore, the data of radars at Maldives airports have also been analysed and shows no indication of the said flight"", said Malaysian Transport Minister Hishamuddin Hussein.",7,18,Furthermore,4,0,4
308KJXFUJR7ZA0BHPMYCIJTKSHRTAU,"#24-37 Furthermore, the data of radars at Maldives airports have also been analysed and shows no indication of the said flight"", said Malaysian Transport Minister Hishamuddin Hussein.",24,28,data,1,0,1
308KJXFUJR7ZA0BHPMYCIJTKSHRTAU,"#24-37 Furthermore, the data of radars at Maldives airports have also been analysed and shows no indication of the said flight"", said Malaysian Transport Minister Hishamuddin Hussein.",32,38,radars,0,2,2
308KJXFUJR7ZA0BHPMYCIJTKSHRTAU,"#24-37 Furthermore, the data of radars at Maldives airports have also been analysed and shows no indication of the said flight"", said Malaysian Transport Minister Hishamuddin Hussein.",75,83,analysed,10,5,15
308KJXFUJR7ZA0BHPMYCIJTKSHRTAU,"#24-37 Furthermore, the data of radars at Maldives airports have also been analysed and shows no indication of the said flight"", said Malaysian Transport Minister Hishamuddin Hussein.",97,107,indication,4,4,8
308KJXFUJR7ZA0BHPMYCIJTKSHRTAU,"#24-37 Furthermore, the data of radars at Maldives airports have also been analysed and shows no indication of the said flight"", said Malaysian Transport Minister Hishamuddin Hussein.",115,126,said flight,0,1,1
308KJXFUJR7ZA0BHPMYCIJTKSHRTAU,"#24-37 Furthermore, the data of radars at Maldives airports have also been analysed and shows no indication of the said flight"", said Malaysian Transport Minister Hishamuddin Hussein.",120,126,flight,1,0,1
308KJXFUJR7ZA0BHPMYCIJTKSHRTAU,"#24-37 Furthermore, the data of radars at Maldives airports have also been analysed and shows no indication of the said flight"", said Malaysian Transport Minister Hishamuddin Hussein.",144,162,Transport Minister,1,0,1
308KJXFUJR7ZA0BHPMYCIJTKSHRTAU,"#24-37 Furthermore, the data of radars at Maldives airports have also been analysed and shows no indication of the said flight"", said Malaysian Transport Minister Hishamuddin Hussein.",163,174,Hishamuddin,0,1,1
308KJXFUJR7ZA0BHPMYCIJTKSHRTAU,"#24-37 Furthermore, the data of radars at Maldives airports have also been analysed and shows no indication of the said flight"", said Malaysian Transport Minister Hishamuddin Hussein.",163,182,Hishamuddin Hussein,1,1,2
3S8A4GJRD34D0Q3344HF3WFJTJI6VY,#30-3 She was located and fined within two days of posting the photograph.,14,21,located,0,3,3
3S8A4GJRD34D0Q3344HF3WFJTJI6VY,#30-3 She was located and fined within two days of posting the photograph.,26,31,fined,4,5,9
3S8A4GJRD34D0Q3344HF3WFJTJI6VY,#30-3 She was located and fined within two days of posting the photograph.,51,58,posting,0,1,1
3S8A4GJRD34D0Q3344HF3WFJTJI6VY,#30-3 She was located and fined within two days of posting the photograph.,63,73,photograph,2,0,2
3S8A4GJRD34D0Q3344HF3WFJTJI6VY,#30-4 The incident has now gained international attention.,10,18,incident,2,1,3
3S8A4GJRD34D0Q3344HF3WFJTJI6VY,#30-4 The incident has now gained international attention.,27,33,gained,1,3,4
3S8A4GJRD34D0Q3344HF3WFJTJI6VY,#30-4 The incident has now gained international attention.,27,57,gained international attention,0,1,1
3S8A4GJRD34D0Q3344HF3WFJTJI6VY,#30-4 The incident has now gained international attention.,34,47,international,3,1,4
3S8A4GJRD34D0Q3344HF3WFJTJI6VY,#30-4 The incident has now gained international attention.,34,57,international attention,0,1,1
3S8A4GJRD34D0Q3344HF3WFJTJI6VY,#30-4 The incident has now gained international attention.,48,57,attention,1,0,1
3S8A4GJRD34D0Q3344HF3WFJTJI6VY,"#30-5 The woman, who has not been named, saw the police vehicle parked in a reserved spot in Petrer and snapped a photo.",64,70,parked,1,1,2
3S8A4GJRD34D0Q3344HF3WFJTJI6VY,"#30-5 The woman, who has not been named, saw the police vehicle parked in a reserved spot in Petrer and snapped a photo.",76,84,reserved,3,2,5
3S8A4GJRD34D0Q3344HF3WFJTJI6VY,"#30-5 The woman, who has not been named, saw the police vehicle parked in a reserved spot in Petrer and snapped a photo.",76,89,reserved spot,1,2,3
3S8A4GJRD34D0Q3344HF3WFJTJI6VY,"#30-5 The woman, who has not been named, saw the police vehicle parked in a reserved spot in Petrer and snapped a photo.",85,89,spot,0,1,1
3S8A4GJRD34D0Q3344HF3WFJTJI6VY,"#30-5 The woman, who has not been named, saw the police vehicle parked in a reserved spot in Petrer and snapped a photo.",93,99,Petrer,2,1,3
3S8A4GJRD34D0Q3344HF3WFJTJI6VY,"#30-5 The woman, who has not been named, saw the police vehicle parked in a reserved spot in Petrer and snapped a photo.",104,111,snapped,4,9,13
3S8A4GJRD34D0Q3344HF3WFJTJI6VY,"#30-5 The woman, who has not been named, saw the police vehicle parked in a reserved spot in Petrer and snapped a photo.",104,119,snapped a photo,1,1,2
3S8A4GJRD34D0Q3344HF3WFJTJI6VY,"#30-6 She posted the photo with the caption: ""Park where you bloody well please and you won't even be fined.",36,43,caption,0,1,1
3S8A4GJRD34D0Q3344HF3WFJTJI6VY,"#30-6 She posted the photo with the caption: ""Park where you bloody well please and you won't even be fined.",61,67,bloody,3,0,3
3S8A4GJRD34D0Q3344HF3WFJTJI6VY,"#30-6 She posted the photo with the caption: ""Park where you bloody well please and you won't even be fined.",61,79,bloody well please,2,1,3
3S8A4GJRD34D0Q3344HF3WFJTJI6VY,"#30-6 She posted the photo with the caption: ""Park where you bloody well please and you won't even be fined.",102,107,fined,0,1,1
3S8A4GJRD34D0Q3344HF3WFJTJI6VY,"#30-7 Fernando Portillo, a local police spokesperson, told local media the vehicle was parked there because police were responding to an emergency.",15,23,Portillo,0,1,1
3S8A4GJRD34D0Q3344HF3WFJTJI6VY,"#30-7 Fernando Portillo, a local police spokesperson, told local media the vehicle was parked there because police were responding to an emergency.",40,52,spokesperson,4,4,8
3S8A4GJRD34D0Q3344HF3WFJTJI6VY,"#30-7 Fernando Portillo, a local police spokesperson, told local media the vehicle was parked there because police were responding to an emergency.",75,82,vehicle,1,0,1
3S8A4GJRD34D0Q3344HF3WFJTJI6VY,"#30-7 Fernando Portillo, a local police spokesperson, told local media the vehicle was parked there because police were responding to an emergency.",120,130,responding,4,6,10
3S8A4GJRD34D0Q3344HF3WFJTJI6VY,"#30-7 Fernando Portillo, a local police spokesperson, told local media the vehicle was parked there because police were responding to an emergency.",137,146,emergency,3,1,4
3S8A4GJRD34D0Q3344HF3WFJTJI6VY,"#30-8 After the story was reported on a local news website, it began to be reported internationally.",26,34,reported,1,0,1
3S8A4GJRD34D0Q3344HF3WFJTJI6VY,"#30-8 After the story was reported on a local news website, it began to be reported internationally.",84,99,internationally,5,3,8
3S8A4GJRD34D0Q3344HF3WFJTJI6VY,"#30-9 On July 1, the ""Citizens' Security law"" went into effect.",22,30,Citizens,1,0,1
3S8A4GJRD34D0Q3344HF3WFJTJI6VY,"#30-9 On July 1, the ""Citizens' Security law"" went into effect.",22,43,Citizens Security law,4,1,5
3S8A4GJRD34D0Q3344HF3WFJTJI6VY,"#30-9 On July 1, the ""Citizens' Security law"" went into effect.",46,62,went into effect,0,1,1
3S8A4GJRD34D0Q3344HF3WFJTJI6VY,#30-10 The law was written in response to violent protests.,30,38,response,1,0,1
3S8A4GJRD34D0Q3344HF3WFJTJI6VY,#30-10 The law was written in response to violent protests.,42,49,violent,2,2,4
3S8A4GJRD34D0Q3344HF3WFJTJI6VY,#30-10 The law was written in response to violent protests.,42,58,violent protests,1,2,3
3S8A4GJRD34D0Q3344HF3WFJTJI6VY,#30-10 The law was written in response to violent protests.,50,58,protests,3,2,5
3S8A4GJRD34D0Q3344HF3WFJTJI6VY,#30-11 Even before its enactment it saw widespread criticism.,23,32,enactment,10,10,20
3S8A4GJRD34D0Q3344HF3WFJTJI6VY,#30-11 Even before its enactment it saw widespread criticism.,40,50,widespread,2,5,7
3S8A4GJRD34D0Q3344HF3WFJTJI6VY,#30-11 Even before its enactment it saw widespread criticism.,40,60,widespread criticism,5,2,7
3S8A4GJRD34D0Q3344HF3WFJTJI6VY,#30-11 Even before its enactment it saw widespread criticism.,51,60,criticism,5,6,11
3QO7EE372OOR1UOHEW4D8P23QSEBQU,#10-7 It was agreed at a NATO summit in Warsaw last year.,25,29,NATO,1,0,1
3QO7EE372OOR1UOHEW4D8P23QSEBQU,#10-7 It was agreed at a NATO summit in Warsaw last year.,25,36,NATO summit,1,1,2
3QO7EE372OOR1UOHEW4D8P23QSEBQU,#10-7 It was agreed at a NATO summit in Warsaw last year.,30,36,summit,8,6,14
3QO7EE372OOR1UOHEW4D8P23QSEBQU,#10-7 It was agreed at a NATO summit in Warsaw last year.,40,46,Warsaw,0,1,1
3QO7EE372OOR1UOHEW4D8P23QSEBQU,#10-8 Defence Minister Antoni Macierewicz was also at the ceremony.,6,13,Defence,1,0,1
3QO7EE372OOR1UOHEW4D8P23QSEBQU,#10-8 Defence Minister Antoni Macierewicz was also at the ceremony.,30,41,Macierewicz,2,0,2
3QO7EE372OOR1UOHEW4D8P23QSEBQU,#10-8 Defence Minister Antoni Macierewicz was also at the ceremony.,58,66,ceremony,4,8,12
3QO7EE372OOR1UOHEW4D8P23QSEBQU,"#10-9 ""We have waited for you for a very long time,"" he told the troops.",65,71,troops,0,2,2
3QO7EE372OOR1UOHEW4D8P23QSEBQU,"#10-10 ""We waited for decades, sometimes feeling we had been left alone, sometimes almost losing hope, sometimes feeling that we were the only one who protected civilization from aggression that came from the east.""",22,29,decades,5,6,11
3QO7EE372OOR1UOHEW4D8P23QSEBQU,"#10-10 ""We waited for decades, sometimes feeling we had been left alone, sometimes almost losing hope, sometimes feeling that we were the only one who protected civilization from aggression that came from the east.""",103,112,sometimes,1,0,1
3QO7EE372OOR1UOHEW4D8P23QSEBQU,"#10-10 ""We waited for decades, sometimes feeling we had been left alone, sometimes almost losing hope, sometimes feeling that we were the only one who protected civilization from aggression that came from the east.""",151,173,protected civilization,3,0,3
3QO7EE372OOR1UOHEW4D8P23QSEBQU,"#10-10 ""We waited for decades, sometimes feeling we had been left alone, sometimes almost losing hope, sometimes feeling that we were the only one who protected civilization from aggression that came from the east.""",161,173,civilization,6,3,9
3QO7EE372OOR1UOHEW4D8P23QSEBQU,"#10-10 ""We waited for decades, sometimes feeling we had been left alone, sometimes almost losing hope, sometimes feeling that we were the only one who protected civilization from aggression that came from the east.""",179,189,aggression,10,7,17
3QO7EE372OOR1UOHEW4D8P23QSEBQU,"#10-11 Hundreds of members of the public attended the ceremony, near the German border; the soldiers crossed in from Germany.",41,49,attended,1,2,3
3QO7EE372OOR1UOHEW4D8P23QSEBQU,"#10-11 Hundreds of members of the public attended the ceremony, near the German border; the soldiers crossed in from Germany.",54,62,ceremony,3,0,3
3QO7EE372OOR1UOHEW4D8P23QSEBQU,"#10-11 Hundreds of members of the public attended the ceremony, near the German border; the soldiers crossed in from Germany.",101,108,crossed,0,2,2
3QO7EE372OOR1UOHEW4D8P23QSEBQU,"#10-11 Hundreds of members of the public attended the ceremony, near the German border; the soldiers crossed in from Germany.",101,111,crossed in,0,1,1
3QO7EE372OOR1UOHEW4D8P23QSEBQU,"#10-12 Part of Operation Atlantic Resolve, the deployment is set to include Abrams tanks, Bradley Fighting Vehicles, and Paladin artillery.",15,24,Operation,1,0,1
3QO7EE372OOR1UOHEW4D8P23QSEBQU,"#10-12 Part of Operation Atlantic Resolve, the deployment is set to include Abrams tanks, Bradley Fighting Vehicles, and Paladin artillery.",15,41,Operation Atlantic Resolve,0,2,2
3QO7EE372OOR1UOHEW4D8P23QSEBQU,"#10-12 Part of Operation Atlantic Resolve, the deployment is set to include Abrams tanks, Bradley Fighting Vehicles, and Paladin artillery.",25,33,Atlantic,1,0,1
3QO7EE372OOR1UOHEW4D8P23QSEBQU,"#10-12 Part of Operation Atlantic Resolve, the deployment is set to include Abrams tanks, Bradley Fighting Vehicles, and Paladin artillery.",34,41,Resolve,5,1,6
3QO7EE372OOR1UOHEW4D8P23QSEBQU,"#10-12 Part of Operation Atlantic Resolve, the deployment is set to include Abrams tanks, Bradley Fighting Vehicles, and Paladin artillery.",47,57,deployment,8,9,17
3QO7EE372OOR1UOHEW4D8P23QSEBQU,"#10-12 Part of Operation Atlantic Resolve, the deployment is set to include Abrams tanks, Bradley Fighting Vehicles, and Paladin artillery.",76,88,Abrams tanks,1,0,1
3QO7EE372OOR1UOHEW4D8P23QSEBQU,"#10-12 Part of Operation Atlantic Resolve, the deployment is set to include Abrams tanks, Bradley Fighting Vehicles, and Paladin artillery.",90,115,Bradley Fighting Vehicles,1,0,1
3QO7EE372OOR1UOHEW4D8P23QSEBQU,"#10-12 Part of Operation Atlantic Resolve, the deployment is set to include Abrams tanks, Bradley Fighting Vehicles, and Paladin artillery.",107,115,Vehicles,2,0,2
3QO7EE372OOR1UOHEW4D8P23QSEBQU,"#10-12 Part of Operation Atlantic Resolve, the deployment is set to include Abrams tanks, Bradley Fighting Vehicles, and Paladin artillery.",121,128,Paladin,1,0,1
3QO7EE372OOR1UOHEW4D8P23QSEBQU,"#10-12 Part of Operation Atlantic Resolve, the deployment is set to include Abrams tanks, Bradley Fighting Vehicles, and Paladin artillery.",121,138,Paladin artillery,2,0,2
3QO7EE372OOR1UOHEW4D8P23QSEBQU,"#10-12 Part of Operation Atlantic Resolve, the deployment is set to include Abrams tanks, Bradley Fighting Vehicles, and Paladin artillery.",129,138,artillery,10,7,17
3QO7EE372OOR1UOHEW4D8P23QSEBQU,#10-13 It is the largest deployment of US troops to Europe since the Cold War ended.,25,35,deployment,5,3,8
3QO7EE372OOR1UOHEW4D8P23QSEBQU,#10-13 It is the largest deployment of US troops to Europe since the Cold War ended.,69,77,Cold War,0,2,2
3T8DUCXY0N7L5H1CXGKCMOI0MZ9T9F,#12-2 The unidentified man has been summonsed to appear at Maidstone Magistrates' Court on February 17.,10,22,unidentified,7,3,10
3T8DUCXY0N7L5H1CXGKCMOI0MZ9T9F,#12-2 The unidentified man has been summonsed to appear at Maidstone Magistrates' Court on February 17.,10,26,unidentified man,0,1,1
3T8DUCXY0N7L5H1CXGKCMOI0MZ9T9F,#12-2 The unidentified man has been summonsed to appear at Maidstone Magistrates' Court on February 17.,36,45,summonsed,10,10,20
3T8DUCXY0N7L5H1CXGKCMOI0MZ9T9F,#12-2 The unidentified man has been summonsed to appear at Maidstone Magistrates' Court on February 17.,49,55,appear,1,0,1
3T8DUCXY0N7L5H1CXGKCMOI0MZ9T9F,#12-2 The unidentified man has been summonsed to appear at Maidstone Magistrates' Court on February 17.,59,80,Maidstone Magistrates,0,1,1
3T8DUCXY0N7L5H1CXGKCMOI0MZ9T9F,#12-2 The unidentified man has been summonsed to appear at Maidstone Magistrates' Court on February 17.,59,86,Maidstone Magistrates Court,1,0,1
3T8DUCXY0N7L5H1CXGKCMOI0MZ9T9F,#12-2 The unidentified man has been summonsed to appear at Maidstone Magistrates' Court on February 17.,69,80,Magistrates,1,0,1
3T8DUCXY0N7L5H1CXGKCMOI0MZ9T9F,#12-3 As well as dangerous driving and causing serious injury by dangerous driving he also faces three counts of criminal damage covering the bridge and damaged vehicles.,17,34,dangerous driving,0,1,1
3T8DUCXY0N7L5H1CXGKCMOI0MZ9T9F,#12-3 As well as dangerous driving and causing serious injury by dangerous driving he also faces three counts of criminal damage covering the bridge and damaged vehicles.,55,61,injury,2,1,3
3T8DUCXY0N7L5H1CXGKCMOI0MZ9T9F,#12-3 As well as dangerous driving and causing serious injury by dangerous driving he also faces three counts of criminal damage covering the bridge and damaged vehicles.,65,82,dangerous driving,1,0,1
3T8DUCXY0N7L5H1CXGKCMOI0MZ9T9F,#12-3 As well as dangerous driving and causing serious injury by dangerous driving he also faces three counts of criminal damage covering the bridge and damaged vehicles.,113,121,criminal,1,1,2
3T8DUCXY0N7L5H1CXGKCMOI0MZ9T9F,#12-3 As well as dangerous driving and causing serious injury by dangerous driving he also faces three counts of criminal damage covering the bridge and damaged vehicles.,113,128,criminal damage,1,1,2
3T8DUCXY0N7L5H1CXGKCMOI0MZ9T9F,#12-3 As well as dangerous driving and causing serious injury by dangerous driving he also faces three counts of criminal damage covering the bridge and damaged vehicles.,122,128,damage,1,0,1
3T8DUCXY0N7L5H1CXGKCMOI0MZ9T9F,#12-3 As well as dangerous driving and causing serious injury by dangerous driving he also faces three counts of criminal damage covering the bridge and damaged vehicles.,153,160,damaged,1,0,1
3T8DUCXY0N7L5H1CXGKCMOI0MZ9T9F,#12-4 The nonfatal accident left an elderly motorcyclist with broken ribs after he came off his bike avoiding the 170 tonnes of falling debris.,10,18,nonfatal,7,6,13
3T8DUCXY0N7L5H1CXGKCMOI0MZ9T9F,#12-4 The nonfatal accident left an elderly motorcyclist with broken ribs after he came off his bike avoiding the 170 tonnes of falling debris.,10,27,nonfatal accident,0,2,2
3T8DUCXY0N7L5H1CXGKCMOI0MZ9T9F,#12-4 The nonfatal accident left an elderly motorcyclist with broken ribs after he came off his bike avoiding the 170 tonnes of falling debris.,36,43,elderly,0,2,2
3T8DUCXY0N7L5H1CXGKCMOI0MZ9T9F,#12-4 The nonfatal accident left an elderly motorcyclist with broken ribs after he came off his bike avoiding the 170 tonnes of falling debris.,36,56,elderly motorcyclist,1,0,1
3T8DUCXY0N7L5H1CXGKCMOI0MZ9T9F,#12-4 The nonfatal accident left an elderly motorcyclist with broken ribs after he came off his bike avoiding the 170 tonnes of falling debris.,44,56,motorcyclist,2,1,3
3T8DUCXY0N7L5H1CXGKCMOI0MZ9T9F,#12-4 The nonfatal accident left an elderly motorcyclist with broken ribs after he came off his bike avoiding the 170 tonnes of falling debris.,44,68,motorcyclist with broken,0,1,1
3T8DUCXY0N7L5H1CXGKCMOI0MZ9T9F,#12-4 The nonfatal accident left an elderly motorcyclist with broken ribs after he came off his bike avoiding the 170 tonnes of falling debris.,69,73,ribs,1,2,3
3T8DUCXY0N7L5H1CXGKCMOI0MZ9T9F,#12-4 The nonfatal accident left an elderly motorcyclist with broken ribs after he came off his bike avoiding the 170 tonnes of falling debris.,101,109,avoiding,2,1,3
3T8DUCXY0N7L5H1CXGKCMOI0MZ9T9F,#12-4 The nonfatal accident left an elderly motorcyclist with broken ribs after he came off his bike avoiding the 170 tonnes of falling debris.,118,124,tonnes,3,0,3
3T8DUCXY0N7L5H1CXGKCMOI0MZ9T9F,#12-4 The nonfatal accident left an elderly motorcyclist with broken ribs after he came off his bike avoiding the 170 tonnes of falling debris.,128,142,falling debris,0,2,2
3T8DUCXY0N7L5H1CXGKCMOI0MZ9T9F,#12-4 The nonfatal accident left an elderly motorcyclist with broken ribs after he came off his bike avoiding the 170 tonnes of falling debris.,136,142,debris,8,9,17
3T8DUCXY0N7L5H1CXGKCMOI0MZ9T9F,"#12-5 Two lorries were partially crushed by the collapse, which was triggered when a digger on the back of a lorry struck the concrete bridge.",10,17,lorries,3,2,5
3T8DUCXY0N7L5H1CXGKCMOI0MZ9T9F,"#12-5 Two lorries were partially crushed by the collapse, which was triggered when a digger on the back of a lorry struck the concrete bridge.",23,32,partially,5,0,5
3T8DUCXY0N7L5H1CXGKCMOI0MZ9T9F,"#12-5 Two lorries were partially crushed by the collapse, which was triggered when a digger on the back of a lorry struck the concrete bridge.",33,40,crushed,0,1,1
3T8DUCXY0N7L5H1CXGKCMOI0MZ9T9F,"#12-5 Two lorries were partially crushed by the collapse, which was triggered when a digger on the back of a lorry struck the concrete bridge.",48,56,collapse,4,2,6
3T8DUCXY0N7L5H1CXGKCMOI0MZ9T9F,"#12-5 Two lorries were partially crushed by the collapse, which was triggered when a digger on the back of a lorry struck the concrete bridge.",68,77,triggered,3,9,12
3T8DUCXY0N7L5H1CXGKCMOI0MZ9T9F,"#12-5 Two lorries were partially crushed by the collapse, which was triggered when a digger on the back of a lorry struck the concrete bridge.",68,91,triggered when a digger,0,1,1
3T8DUCXY0N7L5H1CXGKCMOI0MZ9T9F,"#12-5 Two lorries were partially crushed by the collapse, which was triggered when a digger on the back of a lorry struck the concrete bridge.",85,91,digger,2,5,7
3T8DUCXY0N7L5H1CXGKCMOI0MZ9T9F,"#12-5 Two lorries were partially crushed by the collapse, which was triggered when a digger on the back of a lorry struck the concrete bridge.",109,114,lorry,1,1,2
3T8DUCXY0N7L5H1CXGKCMOI0MZ9T9F,"#12-5 Two lorries were partially crushed by the collapse, which was triggered when a digger on the back of a lorry struck the concrete bridge.",109,121,lorry struck,1,0,1
3T8DUCXY0N7L5H1CXGKCMOI0MZ9T9F,"#12-5 Two lorries were partially crushed by the collapse, which was triggered when a digger on the back of a lorry struck the concrete bridge.",115,121,struck,0,1,1
3T8DUCXY0N7L5H1CXGKCMOI0MZ9T9F,"#12-5 Two lorries were partially crushed by the collapse, which was triggered when a digger on the back of a lorry struck the concrete bridge.",126,134,concrete,4,0,4
3T8DUCXY0N7L5H1CXGKCMOI0MZ9T9F,#12-6 Kent Police continue to investigate; Highways England have said they will await that probe's results before deciding if they will launch their own.,30,41,investigate,6,3,9
3T8DUCXY0N7L5H1CXGKCMOI0MZ9T9F,#12-6 Kent Police continue to investigate; Highways England have said they will await that probe's results before deciding if they will launch their own.,80,85,await,2,1,3
3T8DUCXY0N7L5H1CXGKCMOI0MZ9T9F,#12-6 Kent Police continue to investigate; Highways England have said they will await that probe's results before deciding if they will launch their own.,91,96,probe,0,1,1
3T8DUCXY0N7L5H1CXGKCMOI0MZ9T9F,#12-6 Kent Police continue to investigate; Highways England have said they will await that probe's results before deciding if they will launch their own.,91,97,probes,1,4,5
3T8DUCXY0N7L5H1CXGKCMOI0MZ9T9F,#12-6 Kent Police continue to investigate; Highways England have said they will await that probe's results before deciding if they will launch their own.,114,122,deciding,0,2,2
3T8DUCXY0N7L5H1CXGKCMOI0MZ9T9F,#12-6 Kent Police continue to investigate; Highways England have said they will await that probe's results before deciding if they will launch their own.,136,142,launch,3,2,5
3T8DUCXY0N7L5H1CXGKCMOI0MZ9T9F,"#12-7 The August 27 collapse caused millions of pounds of damage, and closed a major route for more than 24 hours.",20,28,collapse,1,2,3
3T8DUCXY0N7L5H1CXGKCMOI0MZ9T9F,"#12-7 The August 27 collapse caused millions of pounds of damage, and closed a major route for more than 24 hours.",36,44,millions,1,0,1
3T8DUCXY0N7L5H1CXGKCMOI0MZ9T9F,"#12-7 The August 27 collapse caused millions of pounds of damage, and closed a major route for more than 24 hours.",48,54,pounds,1,0,1
3T8DUCXY0N7L5H1CXGKCMOI0MZ9T9F,"#12-7 The August 27 collapse caused millions of pounds of damage, and closed a major route for more than 24 hours.",58,76,"damage, and closed",0,1,1
3T8DUCXY0N7L5H1CXGKCMOI0MZ9T9F,"#12-7 The August 27 collapse caused millions of pounds of damage, and closed a major route for more than 24 hours.",79,90,major route,0,1,1
3T8DUCXY0N7L5H1CXGKCMOI0MZ9T9F,"#12-7 The August 27 collapse caused millions of pounds of damage, and closed a major route for more than 24 hours.",85,90,route,2,1,3
3CMV9YRYP32MSG6GAJ9YPRMMOR0LJ0,#36-13 The accident led to discussions regarding the safety of the cars.,11,19,accident,1,0,1
3CMV9YRYP32MSG6GAJ9YPRMMOR0LJ0,#36-13 The accident led to discussions regarding the safety of the cars.,20,23,led,0,2,2
3CMV9YRYP32MSG6GAJ9YPRMMOR0LJ0,#36-13 The accident led to discussions regarding the safety of the cars.,27,38,discussions,6,3,9
3CMV9YRYP32MSG6GAJ9YPRMMOR0LJ0,#36-13 The accident led to discussions regarding the safety of the cars.,27,48,discussions regarding,0,1,1
3CMV9YRYP32MSG6GAJ9YPRMMOR0LJ0,#36-13 The accident led to discussions regarding the safety of the cars.,39,48,regarding,1,2,3
3CMV9YRYP32MSG6GAJ9YPRMMOR0LJ0,#36-14 A suggestion had been the addition of a canopy over the car's cockpit.,9,19,suggestion,2,4,6
3CMV9YRYP32MSG6GAJ9YPRMMOR0LJ0,#36-14 A suggestion had been the addition of a canopy over the car's cockpit.,33,41,addition,1,0,1
3CMV9YRYP32MSG6GAJ9YPRMMOR0LJ0,#36-14 A suggestion had been the addition of a canopy over the car's cockpit.,47,53,canopy,7,10,17
3CMV9YRYP32MSG6GAJ9YPRMMOR0LJ0,#36-14 A suggestion had been the addition of a canopy over the car's cockpit.,63,75,cars cockpit,1,0,1
3CMV9YRYP32MSG6GAJ9YPRMMOR0LJ0,#36-14 A suggestion had been the addition of a canopy over the car's cockpit.,69,76,cockpit,9,9,18
3CMV9YRYP32MSG6GAJ9YPRMMOR0LJ0,"#36-15 The topic had been controversial: while some supported it for safety reasons, others opposed it because of history, possibly affecting the aerodynamics of the car, limiting one's peripheral vision and movement inside the car, and worry about escaping an upside-down or burning car.",26,39,controversial,8,3,11
3CMV9YRYP32MSG6GAJ9YPRMMOR0LJ0,"#36-15 The topic had been controversial: while some supported it for safety reasons, others opposed it because of history, possibly affecting the aerodynamics of the car, limiting one's peripheral vision and movement inside the car, and worry about escaping an upside-down or burning car.",92,99,opposed,1,1,2
3CMV9YRYP32MSG6GAJ9YPRMMOR0LJ0,"#36-15 The topic had been controversial: while some supported it for safety reasons, others opposed it because of history, possibly affecting the aerodynamics of the car, limiting one's peripheral vision and movement inside the car, and worry about escaping an upside-down or burning car.",132,141,affecting,1,0,1
3CMV9YRYP32MSG6GAJ9YPRMMOR0LJ0,"#36-15 The topic had been controversial: while some supported it for safety reasons, others opposed it because of history, possibly affecting the aerodynamics of the car, limiting one's peripheral vision and movement inside the car, and worry about escaping an upside-down or burning car.",146,158,aerodynamics,10,10,20
3CMV9YRYP32MSG6GAJ9YPRMMOR0LJ0,"#36-15 The topic had been controversial: while some supported it for safety reasons, others opposed it because of history, possibly affecting the aerodynamics of the car, limiting one's peripheral vision and movement inside the car, and worry about escaping an upside-down or burning car.",184,196,s peripheral,1,0,1
3CMV9YRYP32MSG6GAJ9YPRMMOR0LJ0,"#36-15 The topic had been controversial: while some supported it for safety reasons, others opposed it because of history, possibly affecting the aerodynamics of the car, limiting one's peripheral vision and movement inside the car, and worry about escaping an upside-down or burning car.",186,196,peripheral,5,6,11
3CMV9YRYP32MSG6GAJ9YPRMMOR0LJ0,"#36-15 The topic had been controversial: while some supported it for safety reasons, others opposed it because of history, possibly affecting the aerodynamics of the car, limiting one's peripheral vision and movement inside the car, and worry about escaping an upside-down or burning car.",186,203,peripheral vision,5,2,7
3CMV9YRYP32MSG6GAJ9YPRMMOR0LJ0,"#36-15 The topic had been controversial: while some supported it for safety reasons, others opposed it because of history, possibly affecting the aerodynamics of the car, limiting one's peripheral vision and movement inside the car, and worry about escaping an upside-down or burning car.",197,203,vision,0,1,1
3CMV9YRYP32MSG6GAJ9YPRMMOR0LJ0,"#36-15 The topic had been controversial: while some supported it for safety reasons, others opposed it because of history, possibly affecting the aerodynamics of the car, limiting one's peripheral vision and movement inside the car, and worry about escaping an upside-down or burning car.",208,216,movement,1,0,1
3CMV9YRYP32MSG6GAJ9YPRMMOR0LJ0,"#36-15 The topic had been controversial: while some supported it for safety reasons, others opposed it because of history, possibly affecting the aerodynamics of the car, limiting one's peripheral vision and movement inside the car, and worry about escaping an upside-down or burning car.",249,257,escaping,0,1,1
3CMV9YRYP32MSG6GAJ9YPRMMOR0LJ0,"#36-15 The topic had been controversial: while some supported it for safety reasons, others opposed it because of history, possibly affecting the aerodynamics of the car, limiting one's peripheral vision and movement inside the car, and worry about escaping an upside-down or burning car.",261,272,upside-down,0,1,1
3CMV9YRYP32MSG6GAJ9YPRMMOR0LJ0,#36-16 Another had been to tether the nose cone to the car; Hunter-Reay mentioned renderings developed of a boomerang-like debris-deflector positioned in front of the driver.,27,33,tether,4,6,10
3CMV9YRYP32MSG6GAJ9YPRMMOR0LJ0,#36-16 Another had been to tether the nose cone to the car; Hunter-Reay mentioned renderings developed of a boomerang-like debris-deflector positioned in front of the driver.,38,47,nose cone,0,1,1
3CMV9YRYP32MSG6GAJ9YPRMMOR0LJ0,#36-16 Another had been to tether the nose cone to the car; Hunter-Reay mentioned renderings developed of a boomerang-like debris-deflector positioned in front of the driver.,43,47,cone,0,2,2
3CMV9YRYP32MSG6GAJ9YPRMMOR0LJ0,#36-16 Another had been to tether the nose cone to the car; Hunter-Reay mentioned renderings developed of a boomerang-like debris-deflector positioned in front of the driver.,60,71,Hunter-Reay,0,1,1
3CMV9YRYP32MSG6GAJ9YPRMMOR0LJ0,#36-16 Another had been to tether the nose cone to the car; Hunter-Reay mentioned renderings developed of a boomerang-like debris-deflector positioned in front of the driver.,72,92,mentioned renderings,1,0,1
3CMV9YRYP32MSG6GAJ9YPRMMOR0LJ0,#36-16 Another had been to tether the nose cone to the car; Hunter-Reay mentioned renderings developed of a boomerang-like debris-deflector positioned in front of the driver.,82,92,renderings,6,10,16
3CMV9YRYP32MSG6GAJ9YPRMMOR0LJ0,#36-16 Another had been to tether the nose cone to the car; Hunter-Reay mentioned renderings developed of a boomerang-like debris-deflector positioned in front of the driver.,82,102,renderings developed,1,0,1
3CMV9YRYP32MSG6GAJ9YPRMMOR0LJ0,#36-16 Another had been to tether the nose cone to the car; Hunter-Reay mentioned renderings developed of a boomerang-like debris-deflector positioned in front of the driver.,108,122,boomerang-like,5,4,9
3CMV9YRYP32MSG6GAJ9YPRMMOR0LJ0,#36-16 Another had been to tether the nose cone to the car; Hunter-Reay mentioned renderings developed of a boomerang-like debris-deflector positioned in front of the driver.,108,139,boomerang-like debris-deflector,4,2,6
3CMV9YRYP32MSG6GAJ9YPRMMOR0LJ0,#36-16 Another had been to tether the nose cone to the car; Hunter-Reay mentioned renderings developed of a boomerang-like debris-deflector positioned in front of the driver.,123,139,debris-deflector,6,6,12
3CMV9YRYP32MSG6GAJ9YPRMMOR0LJ0,#36-16 Another had been to tether the nose cone to the car; Hunter-Reay mentioned renderings developed of a boomerang-like debris-deflector positioned in front of the driver.,140,150,positioned,2,1,3
3CMV9YRYP32MSG6GAJ9YPRMMOR0LJ0,"#36-17 A further question raised had been regarding Wilson's height: at 6 feet, 3.5 inches (1.92 m) tall, Wilson was the tallest IndyCar Series driver; however, driver Josef Newgarden refuted the statement, saying, ""They make a regulation for how tall you can be inside the car sitting compared to the roll hoop [...] It's safe for any height for any driver that gets in the car.""",121,128,tallest,0,1,1
3CMV9YRYP32MSG6GAJ9YPRMMOR0LJ0,"#36-17 A further question raised had been regarding Wilson's height: at 6 feet, 3.5 inches (1.92 m) tall, Wilson was the tallest IndyCar Series driver; however, driver Josef Newgarden refuted the statement, saying, ""They make a regulation for how tall you can be inside the car sitting compared to the roll hoop [...] It's safe for any height for any driver that gets in the car.""",129,136,IndyCar,1,1,2
3CMV9YRYP32MSG6GAJ9YPRMMOR0LJ0,"#36-17 A further question raised had been regarding Wilson's height: at 6 feet, 3.5 inches (1.92 m) tall, Wilson was the tallest IndyCar Series driver; however, driver Josef Newgarden refuted the statement, saying, ""They make a regulation for how tall you can be inside the car sitting compared to the roll hoop [...] It's safe for any height for any driver that gets in the car.""",174,183,Newgarden,0,1,1
3CMV9YRYP32MSG6GAJ9YPRMMOR0LJ0,"#36-17 A further question raised had been regarding Wilson's height: at 6 feet, 3.5 inches (1.92 m) tall, Wilson was the tallest IndyCar Series driver; however, driver Josef Newgarden refuted the statement, saying, ""They make a regulation for how tall you can be inside the car sitting compared to the roll hoop [...] It's safe for any height for any driver that gets in the car.""",184,191,refuted,7,6,13
3CMV9YRYP32MSG6GAJ9YPRMMOR0LJ0,"#36-17 A further question raised had been regarding Wilson's height: at 6 feet, 3.5 inches (1.92 m) tall, Wilson was the tallest IndyCar Series driver; however, driver Josef Newgarden refuted the statement, saying, ""They make a regulation for how tall you can be inside the car sitting compared to the roll hoop [...] It's safe for any height for any driver that gets in the car.""",184,205,refuted the statement,0,1,1
3CMV9YRYP32MSG6GAJ9YPRMMOR0LJ0,"#36-17 A further question raised had been regarding Wilson's height: at 6 feet, 3.5 inches (1.92 m) tall, Wilson was the tallest IndyCar Series driver; however, driver Josef Newgarden refuted the statement, saying, ""They make a regulation for how tall you can be inside the car sitting compared to the roll hoop [...] It's safe for any height for any driver that gets in the car.""",196,205,statement,1,0,1
3CMV9YRYP32MSG6GAJ9YPRMMOR0LJ0,"#36-17 A further question raised had been regarding Wilson's height: at 6 feet, 3.5 inches (1.92 m) tall, Wilson was the tallest IndyCar Series driver; however, driver Josef Newgarden refuted the statement, saying, ""They make a regulation for how tall you can be inside the car sitting compared to the roll hoop [...] It's safe for any height for any driver that gets in the car.""",228,238,regulation,3,1,4
3CMV9YRYP32MSG6GAJ9YPRMMOR0LJ0,"#36-17 A further question raised had been regarding Wilson's height: at 6 feet, 3.5 inches (1.92 m) tall, Wilson was the tallest IndyCar Series driver; however, driver Josef Newgarden refuted the statement, saying, ""They make a regulation for how tall you can be inside the car sitting compared to the roll hoop [...] It's safe for any height for any driver that gets in the car.""",302,306,roll,0,1,1
3CMV9YRYP32MSG6GAJ9YPRMMOR0LJ0,"#36-17 A further question raised had been regarding Wilson's height: at 6 feet, 3.5 inches (1.92 m) tall, Wilson was the tallest IndyCar Series driver; however, driver Josef Newgarden refuted the statement, saying, ""They make a regulation for how tall you can be inside the car sitting compared to the roll hoop [...] It's safe for any height for any driver that gets in the car.""",302,311,roll hoop,1,1,2
3CMV9YRYP32MSG6GAJ9YPRMMOR0LJ0,"#36-17 A further question raised had been regarding Wilson's height: at 6 feet, 3.5 inches (1.92 m) tall, Wilson was the tallest IndyCar Series driver; however, driver Josef Newgarden refuted the statement, saying, ""They make a regulation for how tall you can be inside the car sitting compared to the roll hoop [...] It's safe for any height for any driver that gets in the car.""",307,311,hoop,0,1,1
3XU80RHWHZH0RQGA1KNDX8VSK8F44Z,"#18-12 As a result of his activity, since 1997 Adnan has been arrested reportedly around ten times, and has gone on several hunger strikes, one of which lasted 28 days, while another lasted 66 days and after his release he went on strike for another 12 days as a token of sympathy for the remaining Palestinian detainees in Israeli prisons.",26,34,activity,0,2,2
3XU80RHWHZH0RQGA1KNDX8VSK8F44Z,"#18-12 As a result of his activity, since 1997 Adnan has been arrested reportedly around ten times, and has gone on several hunger strikes, one of which lasted 28 days, while another lasted 66 days and after his release he went on strike for another 12 days as a token of sympathy for the remaining Palestinian detainees in Israeli prisons.",47,52,Adnan,1,0,1
3XU80RHWHZH0RQGA1KNDX8VSK8F44Z,"#18-12 As a result of his activity, since 1997 Adnan has been arrested reportedly around ten times, and has gone on several hunger strikes, one of which lasted 28 days, while another lasted 66 days and after his release he went on strike for another 12 days as a token of sympathy for the remaining Palestinian detainees in Israeli prisons.",62,70,arrested,3,1,4
3XU80RHWHZH0RQGA1KNDX8VSK8F44Z,"#18-12 As a result of his activity, since 1997 Adnan has been arrested reportedly around ten times, and has gone on several hunger strikes, one of which lasted 28 days, while another lasted 66 days and after his release he went on strike for another 12 days as a token of sympathy for the remaining Palestinian detainees in Israeli prisons.",62,81,arrested reportedly,1,1,2
3XU80RHWHZH0RQGA1KNDX8VSK8F44Z,"#18-12 As a result of his activity, since 1997 Adnan has been arrested reportedly around ten times, and has gone on several hunger strikes, one of which lasted 28 days, while another lasted 66 days and after his release he went on strike for another 12 days as a token of sympathy for the remaining Palestinian detainees in Israeli prisons.",71,81,reportedly,1,3,4
3XU80RHWHZH0RQGA1KNDX8VSK8F44Z,"#18-12 As a result of his activity, since 1997 Adnan has been arrested reportedly around ten times, and has gone on several hunger strikes, one of which lasted 28 days, while another lasted 66 days and after his release he went on strike for another 12 days as a token of sympathy for the remaining Palestinian detainees in Israeli prisons.",124,138,hunger strikes,4,4,8
3XU80RHWHZH0RQGA1KNDX8VSK8F44Z,"#18-12 As a result of his activity, since 1997 Adnan has been arrested reportedly around ten times, and has gone on several hunger strikes, one of which lasted 28 days, while another lasted 66 days and after his release he went on strike for another 12 days as a token of sympathy for the remaining Palestinian detainees in Israeli prisons.",131,138,strikes,2,0,2
3XU80RHWHZH0RQGA1KNDX8VSK8F44Z,"#18-12 As a result of his activity, since 1997 Adnan has been arrested reportedly around ten times, and has gone on several hunger strikes, one of which lasted 28 days, while another lasted 66 days and after his release he went on strike for another 12 days as a token of sympathy for the remaining Palestinian detainees in Israeli prisons.",153,159,lasted,0,1,1
3XU80RHWHZH0RQGA1KNDX8VSK8F44Z,"#18-12 As a result of his activity, since 1997 Adnan has been arrested reportedly around ten times, and has gone on several hunger strikes, one of which lasted 28 days, while another lasted 66 days and after his release he went on strike for another 12 days as a token of sympathy for the remaining Palestinian detainees in Israeli prisons.",183,189,lasted,0,2,2
3XU80RHWHZH0RQGA1KNDX8VSK8F44Z,"#18-12 As a result of his activity, since 1997 Adnan has been arrested reportedly around ten times, and has gone on several hunger strikes, one of which lasted 28 days, while another lasted 66 days and after his release he went on strike for another 12 days as a token of sympathy for the remaining Palestinian detainees in Israeli prisons.",212,219,release,1,2,3
3XU80RHWHZH0RQGA1KNDX8VSK8F44Z,"#18-12 As a result of his activity, since 1997 Adnan has been arrested reportedly around ten times, and has gone on several hunger strikes, one of which lasted 28 days, while another lasted 66 days and after his release he went on strike for another 12 days as a token of sympathy for the remaining Palestinian detainees in Israeli prisons.",263,268,token,4,1,5
3XU80RHWHZH0RQGA1KNDX8VSK8F44Z,"#18-12 As a result of his activity, since 1997 Adnan has been arrested reportedly around ten times, and has gone on several hunger strikes, one of which lasted 28 days, while another lasted 66 days and after his release he went on strike for another 12 days as a token of sympathy for the remaining Palestinian detainees in Israeli prisons.",263,280,token of sympathy,4,1,5
3XU80RHWHZH0RQGA1KNDX8VSK8F44Z,"#18-12 As a result of his activity, since 1997 Adnan has been arrested reportedly around ten times, and has gone on several hunger strikes, one of which lasted 28 days, while another lasted 66 days and after his release he went on strike for another 12 days as a token of sympathy for the remaining Palestinian detainees in Israeli prisons.",272,280,sympathy,6,5,11
3XU80RHWHZH0RQGA1KNDX8VSK8F44Z,"#18-12 As a result of his activity, since 1997 Adnan has been arrested reportedly around ten times, and has gone on several hunger strikes, one of which lasted 28 days, while another lasted 66 days and after his release he went on strike for another 12 days as a token of sympathy for the remaining Palestinian detainees in Israeli prisons.",289,298,remaining,2,1,3
3XU80RHWHZH0RQGA1KNDX8VSK8F44Z,"#18-12 As a result of his activity, since 1997 Adnan has been arrested reportedly around ten times, and has gone on several hunger strikes, one of which lasted 28 days, while another lasted 66 days and after his release he went on strike for another 12 days as a token of sympathy for the remaining Palestinian detainees in Israeli prisons.",289,320,remaining Palestinian detainees,1,0,1
3XU80RHWHZH0RQGA1KNDX8VSK8F44Z,"#18-12 As a result of his activity, since 1997 Adnan has been arrested reportedly around ten times, and has gone on several hunger strikes, one of which lasted 28 days, while another lasted 66 days and after his release he went on strike for another 12 days as a token of sympathy for the remaining Palestinian detainees in Israeli prisons.",299,320,Palestinian detainees,1,1,2
3XU80RHWHZH0RQGA1KNDX8VSK8F44Z,"#18-12 As a result of his activity, since 1997 Adnan has been arrested reportedly around ten times, and has gone on several hunger strikes, one of which lasted 28 days, while another lasted 66 days and after his release he went on strike for another 12 days as a token of sympathy for the remaining Palestinian detainees in Israeli prisons.",311,320,detainees,10,10,20
3XU80RHWHZH0RQGA1KNDX8VSK8F44Z,"#19-1 C-130 Hercules crashes in Medan, Indonesia On Tuesday, an Indonesian Air Force C-130 Hercules crashed in the city of Medan, Indonesia.",21,28,crashes,2,0,2
3XU80RHWHZH0RQGA1KNDX8VSK8F44Z,"#19-1 C-130 Hercules crashes in Medan, Indonesia On Tuesday, an Indonesian Air Force C-130 Hercules crashed in the city of Medan, Indonesia.",64,74,Indonesian,1,0,1
3XU80RHWHZH0RQGA1KNDX8VSK8F44Z,"#19-1 C-130 Hercules crashes in Medan, Indonesia On Tuesday, an Indonesian Air Force C-130 Hercules crashed in the city of Medan, Indonesia.",100,107,crashed,1,5,6
3XU80RHWHZH0RQGA1KNDX8VSK8F44Z,"#19-2 All 122 people on board were killed as well as people on the ground in the city in North Sumatra, according to North Sumatra police Major A. Tarigan.",24,29,board,0,1,1
3XU80RHWHZH0RQGA1KNDX8VSK8F44Z,"#19-2 All 122 people on board were killed as well as people on the ground in the city in North Sumatra, according to North Sumatra police Major A. Tarigan.",95,102,Sumatra,1,0,1
3XU80RHWHZH0RQGA1KNDX8VSK8F44Z,"#19-2 All 122 people on board were killed as well as people on the ground in the city in North Sumatra, according to North Sumatra police Major A. Tarigan.",104,113,according,0,1,1
3XU80RHWHZH0RQGA1KNDX8VSK8F44Z,"#19-2 All 122 people on board were killed as well as people on the ground in the city in North Sumatra, according to North Sumatra police Major A. Tarigan.",117,130,North Sumatra,1,0,1
3XU80RHWHZH0RQGA1KNDX8VSK8F44Z,"#19-2 All 122 people on board were killed as well as people on the ground in the city in North Sumatra, according to North Sumatra police Major A. Tarigan.",147,154,Tarigan,1,0,1
3XU80RHWHZH0RQGA1KNDX8VSK8F44Z,#19-3 Officials said the plane exploded on impact into a big fireball.,6,15,Officials,1,0,1
3XU80RHWHZH0RQGA1KNDX8VSK8F44Z,#19-3 Officials said the plane exploded on impact into a big fireball.,31,39,exploded,4,7,11
3XU80RHWHZH0RQGA1KNDX8VSK8F44Z,#19-3 Officials said the plane exploded on impact into a big fireball.,43,49,impact,2,6,8
3XU80RHWHZH0RQGA1KNDX8VSK8F44Z,#19-3 Officials said the plane exploded on impact into a big fireball.,57,69,big fireball,1,0,1
3XU80RHWHZH0RQGA1KNDX8VSK8F44Z,#19-3 Officials said the plane exploded on impact into a big fireball.,61,69,fireball,2,5,7
3XU80RHWHZH0RQGA1KNDX8VSK8F44Z,#19-4 The military said the plane took off at 12:08 pm local time (0508 UTC) and crashed five kilometers away a couple of minutes later.,10,18,military,1,0,1
3XU80RHWHZH0RQGA1KNDX8VSK8F44Z,#19-4 The military said the plane took off at 12:08 pm local time (0508 UTC) and crashed five kilometers away a couple of minutes later.,34,42,took off,0,2,2
3XU80RHWHZH0RQGA1KNDX8VSK8F44Z,#19-4 The military said the plane took off at 12:08 pm local time (0508 UTC) and crashed five kilometers away a couple of minutes later.,81,88,crashed,0,3,3
3XU80RHWHZH0RQGA1KNDX8VSK8F44Z,#19-4 The military said the plane took off at 12:08 pm local time (0508 UTC) and crashed five kilometers away a couple of minutes later.,94,104,kilometers,3,0,3
3XU80RHWHZH0RQGA1KNDX8VSK8F44Z,#19-4 The military said the plane took off at 12:08 pm local time (0508 UTC) and crashed five kilometers away a couple of minutes later.,110,121,a couple of,0,1,1
3C8QQOM6JP2QX5MAS1OYDQ7MBCBLIO,#35-19 That decision was the one challenged unsuccessfully in the High Court.,12,20,decision,4,0,4
3C8QQOM6JP2QX5MAS1OYDQ7MBCBLIO,#35-19 That decision was the one challenged unsuccessfully in the High Court.,33,43,challenged,4,3,7
3C8QQOM6JP2QX5MAS1OYDQ7MBCBLIO,#35-19 That decision was the one challenged unsuccessfully in the High Court.,44,58,unsuccessfully,7,3,10
3C8QQOM6JP2QX5MAS1OYDQ7MBCBLIO,#35-19 That decision was the one challenged unsuccessfully in the High Court.,66,76,High Court,1,0,1
3C8QQOM6JP2QX5MAS1OYDQ7MBCBLIO,"#35-20 The case pits the two accused trying to defend a death penalty case against the possibility of jeopardising international relations; Thai police co-operated, but only in light of an agreement the report would be confidential.",16,20,pits,0,6,6
3C8QQOM6JP2QX5MAS1OYDQ7MBCBLIO,"#35-20 The case pits the two accused trying to defend a death penalty case against the possibility of jeopardising international relations; Thai police co-operated, but only in light of an agreement the report would be confidential.",16,36,pits the two accused,1,0,1
3C8QQOM6JP2QX5MAS1OYDQ7MBCBLIO,"#35-20 The case pits the two accused trying to defend a death penalty case against the possibility of jeopardising international relations; Thai police co-operated, but only in light of an agreement the report would be confidential.",29,36,accused,4,3,7
3C8QQOM6JP2QX5MAS1OYDQ7MBCBLIO,"#35-20 The case pits the two accused trying to defend a death penalty case against the possibility of jeopardising international relations; Thai police co-operated, but only in light of an agreement the report would be confidential.",47,53,defend,0,1,1
3C8QQOM6JP2QX5MAS1OYDQ7MBCBLIO,"#35-20 The case pits the two accused trying to defend a death penalty case against the possibility of jeopardising international relations; Thai police co-operated, but only in light of an agreement the report would be confidential.",56,69,death penalty,0,1,1
3C8QQOM6JP2QX5MAS1OYDQ7MBCBLIO,"#35-20 The case pits the two accused trying to defend a death penalty case against the possibility of jeopardising international relations; Thai police co-operated, but only in light of an agreement the report would be confidential.",87,98,possibility,1,1,2
3C8QQOM6JP2QX5MAS1OYDQ7MBCBLIO,"#35-20 The case pits the two accused trying to defend a death penalty case against the possibility of jeopardising international relations; Thai police co-operated, but only in light of an agreement the report would be confidential.",102,114,jeopardising,10,10,20
3C8QQOM6JP2QX5MAS1OYDQ7MBCBLIO,"#35-20 The case pits the two accused trying to defend a death penalty case against the possibility of jeopardising international relations; Thai police co-operated, but only in light of an agreement the report would be confidential.",115,128,international,2,0,2
3C8QQOM6JP2QX5MAS1OYDQ7MBCBLIO,"#35-20 The case pits the two accused trying to defend a death penalty case against the possibility of jeopardising international relations; Thai police co-operated, but only in light of an agreement the report would be confidential.",115,138,international relations,1,0,1
3C8QQOM6JP2QX5MAS1OYDQ7MBCBLIO,"#35-20 The case pits the two accused trying to defend a death penalty case against the possibility of jeopardising international relations; Thai police co-operated, but only in light of an agreement the report would be confidential.",129,138,relations,1,0,1
3C8QQOM6JP2QX5MAS1OYDQ7MBCBLIO,"#35-20 The case pits the two accused trying to defend a death penalty case against the possibility of jeopardising international relations; Thai police co-operated, but only in light of an agreement the report would be confidential.",152,163,co-operated,2,0,2
3C8QQOM6JP2QX5MAS1OYDQ7MBCBLIO,"#35-20 The case pits the two accused trying to defend a death penalty case against the possibility of jeopardising international relations; Thai police co-operated, but only in light of an agreement the report would be confidential.",177,182,light,0,1,1
3C8QQOM6JP2QX5MAS1OYDQ7MBCBLIO,"#35-20 The case pits the two accused trying to defend a death penalty case against the possibility of jeopardising international relations; Thai police co-operated, but only in light of an agreement the report would be confidential.",219,231,confidential,7,7,14
3C8QQOM6JP2QX5MAS1OYDQ7MBCBLIO,"#35-21 Legal charity Reprieve, who assisted the two men, said in a statement ""Concerns about the conduct of the Thai investigation and the safety of any convictions resulting have been raised from the very beginning[...] only the defence lawyers in Thailand are in a position to judge whether the information could be of assistance.""",13,20,charity,2,1,3
3C8QQOM6JP2QX5MAS1OYDQ7MBCBLIO,"#35-21 Legal charity Reprieve, who assisted the two men, said in a statement ""Concerns about the conduct of the Thai investigation and the safety of any convictions resulting have been raised from the very beginning[...] only the defence lawyers in Thailand are in a position to judge whether the information could be of assistance.""",21,29,Reprieve,4,4,8
3C8QQOM6JP2QX5MAS1OYDQ7MBCBLIO,"#35-21 Legal charity Reprieve, who assisted the two men, said in a statement ""Concerns about the conduct of the Thai investigation and the safety of any convictions resulting have been raised from the very beginning[...] only the defence lawyers in Thailand are in a position to judge whether the information could be of assistance.""",78,86,Concerns,1,1,2
3C8QQOM6JP2QX5MAS1OYDQ7MBCBLIO,"#35-21 Legal charity Reprieve, who assisted the two men, said in a statement ""Concerns about the conduct of the Thai investigation and the safety of any convictions resulting have been raised from the very beginning[...] only the defence lawyers in Thailand are in a position to judge whether the information could be of assistance.""",97,104,conduct,1,0,1
3C8QQOM6JP2QX5MAS1OYDQ7MBCBLIO,"#35-21 Legal charity Reprieve, who assisted the two men, said in a statement ""Concerns about the conduct of the Thai investigation and the safety of any convictions resulting have been raised from the very beginning[...] only the defence lawyers in Thailand are in a position to judge whether the information could be of assistance.""",117,130,investigation,3,0,3
3C8QQOM6JP2QX5MAS1OYDQ7MBCBLIO,"#35-21 Legal charity Reprieve, who assisted the two men, said in a statement ""Concerns about the conduct of the Thai investigation and the safety of any convictions resulting have been raised from the very beginning[...] only the defence lawyers in Thailand are in a position to judge whether the information could be of assistance.""",153,164,convictions,7,7,14
3C8QQOM6JP2QX5MAS1OYDQ7MBCBLIO,"#35-21 Legal charity Reprieve, who assisted the two men, said in a statement ""Concerns about the conduct of the Thai investigation and the safety of any convictions resulting have been raised from the very beginning[...] only the defence lawyers in Thailand are in a position to judge whether the information could be of assistance.""",185,191,raised,0,1,1
3C8QQOM6JP2QX5MAS1OYDQ7MBCBLIO,"#35-21 Legal charity Reprieve, who assisted the two men, said in a statement ""Concerns about the conduct of the Thai investigation and the safety of any convictions resulting have been raised from the very beginning[...] only the defence lawyers in Thailand are in a position to judge whether the information could be of assistance.""",230,237,defence,3,1,4
3C8QQOM6JP2QX5MAS1OYDQ7MBCBLIO,"#35-21 Legal charity Reprieve, who assisted the two men, said in a statement ""Concerns about the conduct of the Thai investigation and the safety of any convictions resulting have been raised from the very beginning[...] only the defence lawyers in Thailand are in a position to judge whether the information could be of assistance.""",230,245,defence lawyers,1,0,1
3C8QQOM6JP2QX5MAS1OYDQ7MBCBLIO,"#35-21 Legal charity Reprieve, who assisted the two men, said in a statement ""Concerns about the conduct of the Thai investigation and the safety of any convictions resulting have been raised from the very beginning[...] only the defence lawyers in Thailand are in a position to judge whether the information could be of assistance.""",249,257,Thailand,0,1,1
3C8QQOM6JP2QX5MAS1OYDQ7MBCBLIO,"#35-21 Legal charity Reprieve, who assisted the two men, said in a statement ""Concerns about the conduct of the Thai investigation and the safety of any convictions resulting have been raised from the very beginning[...] only the defence lawyers in Thailand are in a position to judge whether the information could be of assistance.""",279,284,judge,0,1,1
3C8QQOM6JP2QX5MAS1OYDQ7MBCBLIO,"#35-21 Legal charity Reprieve, who assisted the two men, said in a statement ""Concerns about the conduct of the Thai investigation and the safety of any convictions resulting have been raised from the very beginning[...] only the defence lawyers in Thailand are in a position to judge whether the information could be of assistance.""",321,331,assistance,1,2,3
3C8QQOM6JP2QX5MAS1OYDQ7MBCBLIO,"#35-22 Mr Justice Green's judgement acknowledges he did not know ""how the accused might structure their defences"" or details about what evidence had been or would be involved.",36,48,acknowledges,9,5,14
3C8QQOM6JP2QX5MAS1OYDQ7MBCBLIO,"#35-22 Mr Justice Green's judgement acknowledges he did not know ""how the accused might structure their defences"" or details about what evidence had been or would be involved.",66,112,how the accused might structure their defences,1,0,1
3C8QQOM6JP2QX5MAS1OYDQ7MBCBLIO,"#35-22 Mr Justice Green's judgement acknowledges he did not know ""how the accused might structure their defences"" or details about what evidence had been or would be involved.",74,81,accused,3,1,4
3C8QQOM6JP2QX5MAS1OYDQ7MBCBLIO,"#35-22 Mr Justice Green's judgement acknowledges he did not know ""how the accused might structure their defences"" or details about what evidence had been or would be involved.",88,97,structure,1,1,2
3C8QQOM6JP2QX5MAS1OYDQ7MBCBLIO,"#35-22 Mr Justice Green's judgement acknowledges he did not know ""how the accused might structure their defences"" or details about what evidence had been or would be involved.",104,112,defences,1,1,2
3C8QQOM6JP2QX5MAS1OYDQ7MBCBLIO,"#35-22 Mr Justice Green's judgement acknowledges he did not know ""how the accused might structure their defences"" or details about what evidence had been or would be involved.",136,144,evidence,4,4,8
3C8QQOM6JP2QX5MAS1OYDQ7MBCBLIO,"#35-22 Mr Justice Green's judgement acknowledges he did not know ""how the accused might structure their defences"" or details about what evidence had been or would be involved.",166,174,involved,0,2,2
3BPP3MA3TCLEH0KOWIY7SB9UJJ4EL8,"#35-12 Cameron and Chan-o-cha arranged for an observer team from the Metropolitan Police to conduct an inspection of the Thai probe, based on powers in the Police Act 1996.",19,29,Chan-o-cha,0,1,1
3BPP3MA3TCLEH0KOWIY7SB9UJJ4EL8,"#35-12 Cameron and Chan-o-cha arranged for an observer team from the Metropolitan Police to conduct an inspection of the Thai probe, based on powers in the Police Act 1996.",30,38,arranged,2,3,5
3BPP3MA3TCLEH0KOWIY7SB9UJJ4EL8,"#35-12 Cameron and Chan-o-cha arranged for an observer team from the Metropolitan Police to conduct an inspection of the Thai probe, based on powers in the Police Act 1996.",46,54,observer,6,0,6
3BPP3MA3TCLEH0KOWIY7SB9UJJ4EL8,"#35-12 Cameron and Chan-o-cha arranged for an observer team from the Metropolitan Police to conduct an inspection of the Thai probe, based on powers in the Police Act 1996.",46,59,observer team,1,0,1
3BPP3MA3TCLEH0KOWIY7SB9UJJ4EL8,"#35-12 Cameron and Chan-o-cha arranged for an observer team from the Metropolitan Police to conduct an inspection of the Thai probe, based on powers in the Police Act 1996.",69,81,Metropolitan,1,0,1
3BPP3MA3TCLEH0KOWIY7SB9UJJ4EL8,"#35-12 Cameron and Chan-o-cha arranged for an observer team from the Metropolitan Police to conduct an inspection of the Thai probe, based on powers in the Police Act 1996.",69,88,Metropolitan Police,1,0,1
3BPP3MA3TCLEH0KOWIY7SB9UJJ4EL8,"#35-12 Cameron and Chan-o-cha arranged for an observer team from the Metropolitan Police to conduct an inspection of the Thai probe, based on powers in the Police Act 1996.",92,99,conduct,2,1,3
3BPP3MA3TCLEH0KOWIY7SB9UJJ4EL8,"#35-12 Cameron and Chan-o-cha arranged for an observer team from the Metropolitan Police to conduct an inspection of the Thai probe, based on powers in the Police Act 1996.",92,113,conduct an inspection,1,0,1
3BPP3MA3TCLEH0KOWIY7SB9UJJ4EL8,"#35-12 Cameron and Chan-o-cha arranged for an observer team from the Metropolitan Police to conduct an inspection of the Thai probe, based on powers in the Police Act 1996.",103,113,inspection,4,2,6
3BPP3MA3TCLEH0KOWIY7SB9UJJ4EL8,"#35-12 Cameron and Chan-o-cha arranged for an observer team from the Metropolitan Police to conduct an inspection of the Thai probe, based on powers in the Police Act 1996.",121,131,Thai probe,1,1,2
3BPP3MA3TCLEH0KOWIY7SB9UJJ4EL8,"#35-12 Cameron and Chan-o-cha arranged for an observer team from the Metropolitan Police to conduct an inspection of the Thai probe, based on powers in the Police Act 1996.",126,131,probe,4,6,10
3BPP3MA3TCLEH0KOWIY7SB9UJJ4EL8,#35-13 A team was duly dispatched and prepared a report with the intent to use it for assisting the victims' families.,18,22,duly,0,1,1
3BPP3MA3TCLEH0KOWIY7SB9UJJ4EL8,#35-13 A team was duly dispatched and prepared a report with the intent to use it for assisting the victims' families.,18,33,duly dispatched,2,1,3
3BPP3MA3TCLEH0KOWIY7SB9UJJ4EL8,#35-13 A team was duly dispatched and prepared a report with the intent to use it for assisting the victims' families.,23,33,dispatched,10,6,16
3BPP3MA3TCLEH0KOWIY7SB9UJJ4EL8,#35-13 A team was duly dispatched and prepared a report with the intent to use it for assisting the victims' families.,65,71,intent,4,4,8
3BPP3MA3TCLEH0KOWIY7SB9UJJ4EL8,#35-13 A team was duly dispatched and prepared a report with the intent to use it for assisting the victims' families.,86,95,assisting,1,1,2
3BPP3MA3TCLEH0KOWIY7SB9UJJ4EL8,#35-13 A team was duly dispatched and prepared a report with the intent to use it for assisting the victims' families.,86,107,assisting the victims,0,1,1
3BPP3MA3TCLEH0KOWIY7SB9UJJ4EL8,#35-13 A team was duly dispatched and prepared a report with the intent to use it for assisting the victims' families.,100,107,victims,2,1,3
3BPP3MA3TCLEH0KOWIY7SB9UJJ4EL8,"#35-14 UK police were expressly forbidden, at a ministerial level, to provide any assistance to Thai authorities as the case involves the death penalty.",22,31,expressly,5,2,7
3BPP3MA3TCLEH0KOWIY7SB9UJJ4EL8,"#35-14 UK police were expressly forbidden, at a ministerial level, to provide any assistance to Thai authorities as the case involves the death penalty.",22,41,expressly forbidden,2,2,4
3BPP3MA3TCLEH0KOWIY7SB9UJJ4EL8,"#35-14 UK police were expressly forbidden, at a ministerial level, to provide any assistance to Thai authorities as the case involves the death penalty.",32,41,forbidden,5,6,11
3BPP3MA3TCLEH0KOWIY7SB9UJJ4EL8,"#35-14 UK police were expressly forbidden, at a ministerial level, to provide any assistance to Thai authorities as the case involves the death penalty.",48,59,ministerial,10,1,11
3BPP3MA3TCLEH0KOWIY7SB9UJJ4EL8,"#35-14 UK police were expressly forbidden, at a ministerial level, to provide any assistance to Thai authorities as the case involves the death penalty.",48,65,ministerial level,1,0,1
3BPP3MA3TCLEH0KOWIY7SB9UJJ4EL8,"#35-14 UK police were expressly forbidden, at a ministerial level, to provide any assistance to Thai authorities as the case involves the death penalty.",82,92,assistance,1,1,2
3BPP3MA3TCLEH0KOWIY7SB9UJJ4EL8,"#35-14 UK police were expressly forbidden, at a ministerial level, to provide any assistance to Thai authorities as the case involves the death penalty.",101,112,authorities,6,2,8
3BPP3MA3TCLEH0KOWIY7SB9UJJ4EL8,"#35-14 UK police were expressly forbidden, at a ministerial level, to provide any assistance to Thai authorities as the case involves the death penalty.",125,133,involves,0,1,1
3BPP3MA3TCLEH0KOWIY7SB9UJJ4EL8,"#35-14 UK police were expressly forbidden, at a ministerial level, to provide any assistance to Thai authorities as the case involves the death penalty.",138,151,death penalty,0,1,1
3BPP3MA3TCLEH0KOWIY7SB9UJJ4EL8,"#35-14 UK police were expressly forbidden, at a ministerial level, to provide any assistance to Thai authorities as the case involves the death penalty.",144,151,penalty,0,1,1
3BPP3MA3TCLEH0KOWIY7SB9UJJ4EL8,"#35-15 Due to established UK policy on foreign death penalty cases, the report was also not shared with Thailand.",14,25,established,2,0,2
3BPP3MA3TCLEH0KOWIY7SB9UJJ4EL8,"#35-15 Due to established UK policy on foreign death penalty cases, the report was also not shared with Thailand.",39,46,foreign,2,0,2
3BPP3MA3TCLEH0KOWIY7SB9UJJ4EL8,"#35-15 Due to established UK policy on foreign death penalty cases, the report was also not shared with Thailand.",39,60,foreign death penalty,0,1,1
3BPP3MA3TCLEH0KOWIY7SB9UJJ4EL8,"#35-15 Due to established UK policy on foreign death penalty cases, the report was also not shared with Thailand.",53,60,penalty,1,1,2
3BPP3MA3TCLEH0KOWIY7SB9UJJ4EL8,#35-16 It is this report that Lin and Phyo were seeking.,38,42,Phyo,1,0,1
3BPP3MA3TCLEH0KOWIY7SB9UJJ4EL8,#35-16 It is this report that Lin and Phyo were seeking.,48,55,seeking,0,3,3
3BPP3MA3TCLEH0KOWIY7SB9UJJ4EL8,"#35-17 The Royal Courts of Justice complex in London, where the case was heard.",35,42,complex,1,0,1
3BPP3MA3TCLEH0KOWIY7SB9UJJ4EL8,"#35-17 The Royal Courts of Justice complex in London, where the case was heard.",73,78,heard,0,1,1
3BPP3MA3TCLEH0KOWIY7SB9UJJ4EL8,"#35-18 Using the Data Protection Act 1998 the defendants asked police for this report to assist their defence, and were denied.",46,56,defendants,6,8,14
3BPP3MA3TCLEH0KOWIY7SB9UJJ4EL8,"#35-18 Using the Data Protection Act 1998 the defendants asked police for this report to assist their defence, and were denied.",89,95,assist,0,1,1
3BPP3MA3TCLEH0KOWIY7SB9UJJ4EL8,"#35-18 Using the Data Protection Act 1998 the defendants asked police for this report to assist their defence, and were denied.",89,109,assist their defence,1,0,1
3BPP3MA3TCLEH0KOWIY7SB9UJJ4EL8,"#35-18 Using the Data Protection Act 1998 the defendants asked police for this report to assist their defence, and were denied.",102,109,defence,5,0,5
3BPP3MA3TCLEH0KOWIY7SB9UJJ4EL8,"#35-18 Using the Data Protection Act 1998 the defendants asked police for this report to assist their defence, and were denied.",120,126,denied,1,3,4
39I4RL8QGJIU3245GR7WRX4WPD1H4Y,"#20-9 This means it must be a very young surface"".",35,48,young surface,0,2,2
39I4RL8QGJIU3245GR7WRX4WPD1H4Y,"#20-9 This means it must be a very young surface"".",41,48,surface,2,1,3
39I4RL8QGJIU3245GR7WRX4WPD1H4Y,#20-10 He put the age of the current surface at no more than 100 million years.,29,36,current,1,2,3
39I4RL8QGJIU3245GR7WRX4WPD1H4Y,#20-10 He put the age of the current surface at no more than 100 million years.,37,44,surface,1,0,1
39I4RL8QGJIU3245GR7WRX4WPD1H4Y,#20-10 He put the age of the current surface at no more than 100 million years.,65,72,million,1,0,1
39I4RL8QGJIU3245GR7WRX4WPD1H4Y,"#20-11 The images also did not show craters on its natural satellite, Charon.",36,43,craters,6,9,15
39I4RL8QGJIU3245GR7WRX4WPD1H4Y,"#20-11 The images also did not show craters on its natural satellite, Charon.",51,68,natural satellite,2,1,3
39I4RL8QGJIU3245GR7WRX4WPD1H4Y,"#20-11 The images also did not show craters on its natural satellite, Charon.",59,68,satellite,8,1,9
39I4RL8QGJIU3245GR7WRX4WPD1H4Y,"#20-11 The images also did not show craters on its natural satellite, Charon.",70,76,Charon,0,1,1
39I4RL8QGJIU3245GR7WRX4WPD1H4Y,#20-12 NASA said mountains on the planet may be made of water-ice.,17,26,mountains,1,0,1
39I4RL8QGJIU3245GR7WRX4WPD1H4Y,#20-12 NASA said mountains on the planet may be made of water-ice.,56,65,water-ice,3,3,6
39I4RL8QGJIU3245GR7WRX4WPD1H4Y,#20-13 In February 2007 the space probe flew by Jupiter.,28,39,space probe,1,0,1
39I4RL8QGJIU3245GR7WRX4WPD1H4Y,#20-13 In February 2007 the space probe flew by Jupiter.,34,39,probe,6,8,14
39I4RL8QGJIU3245GR7WRX4WPD1H4Y,#20-13 In February 2007 the space probe flew by Jupiter.,40,44,flew,0,1,1
39I4RL8QGJIU3245GR7WRX4WPD1H4Y,#20-13 In February 2007 the space probe flew by Jupiter.,48,55,Jupiter,3,0,3
39I4RL8QGJIU3245GR7WRX4WPD1H4Y,#20-14 The future mission is to explore the Kuiper Belt.,11,25,future mission,0,1,1
39I4RL8QGJIU3245GR7WRX4WPD1H4Y,#20-14 The future mission is to explore the Kuiper Belt.,18,25,mission,2,2,4
39I4RL8QGJIU3245GR7WRX4WPD1H4Y,#20-14 The future mission is to explore the Kuiper Belt.,32,39,explore,3,5,8
39I4RL8QGJIU3245GR7WRX4WPD1H4Y,#20-14 The future mission is to explore the Kuiper Belt.,44,50,Kuiper,1,0,1
39I4RL8QGJIU3245GR7WRX4WPD1H4Y,#20-14 The future mission is to explore the Kuiper Belt.,44,55,Kuiper Belt,3,1,4
39I4RL8QGJIU3245GR7WRX4WPD1H4Y,#21-1 Formula One driver Jules Bianchi dies aged 25 Bianchi at the Nürburgring's World Series by Renault race in 2012.,31,38,Bianchi,1,0,1
39I4RL8QGJIU3245GR7WRX4WPD1H4Y,#21-1 Formula One driver Jules Bianchi dies aged 25 Bianchi at the Nürburgring's World Series by Renault race in 2012.,52,59,Bianchi,0,1,1
39I4RL8QGJIU3245GR7WRX4WPD1H4Y,#21-1 Formula One driver Jules Bianchi dies aged 25 Bianchi at the Nürburgring's World Series by Renault race in 2012.,67,79,Nürburgrings,1,1,2
39I4RL8QGJIU3245GR7WRX4WPD1H4Y,#21-1 Formula One driver Jules Bianchi dies aged 25 Bianchi at the Nürburgring's World Series by Renault race in 2012.,67,92,Nürburgrings World Series,2,0,2
39I4RL8QGJIU3245GR7WRX4WPD1H4Y,#21-1 Formula One driver Jules Bianchi dies aged 25 Bianchi at the Nürburgring's World Series by Renault race in 2012.,67,103,Nürburgrings World Series by Renault,1,0,1
39I4RL8QGJIU3245GR7WRX4WPD1H4Y,#21-1 Formula One driver Jules Bianchi dies aged 25 Bianchi at the Nürburgring's World Series by Renault race in 2012.,97,104,Renault,0,1,1
39I4RL8QGJIU3245GR7WRX4WPD1H4Y,"#21-2 French Formula One (F1) driver Jules Bianchi died on Friday night at age 25, nine months after his serious accident at the 2014 Japanese Grand Prix.",105,112,serious,1,0,1
39I4RL8QGJIU3245GR7WRX4WPD1H4Y,"#21-2 French Formula One (F1) driver Jules Bianchi died on Friday night at age 25, nine months after his serious accident at the 2014 Japanese Grand Prix.",113,121,accident,2,1,3
39I4RL8QGJIU3245GR7WRX4WPD1H4Y,"#21-2 French Formula One (F1) driver Jules Bianchi died on Friday night at age 25, nine months after his serious accident at the 2014 Japanese Grand Prix.",134,142,Japanese,1,0,1
39I4RL8QGJIU3245GR7WRX4WPD1H4Y,"#21-2 French Formula One (F1) driver Jules Bianchi died on Friday night at age 25, nine months after his serious accident at the 2014 Japanese Grand Prix.",134,153,Japanese Grand Prix,1,0,1
39I4RL8QGJIU3245GR7WRX4WPD1H4Y,"#21-3 News of his death was announced by his family the following morning: Cquote1.svg It is with deep sadness that the parents of Jules Bianchi, Philippe and Christine, his brother Tom and sister Mélanie, wish to make it known that Jules passed away last night at the Centre Hospitalier Universitaire (CHU) in Nice, (France) where he was admitted following the accident of 5th October 2014 at Suzuka Circuit during the Japanese Formula 1 Grand Prix.",28,37,announced,3,2,5
39I4RL8QGJIU3245GR7WRX4WPD1H4Y,"#21-3 News of his death was announced by his family the following morning: Cquote1.svg It is with deep sadness that the parents of Jules Bianchi, Philippe and Christine, his brother Tom and sister Mélanie, wish to make it known that Jules passed away last night at the Centre Hospitalier Universitaire (CHU) in Nice, (France) where he was admitted following the accident of 5th October 2014 at Suzuka Circuit during the Japanese Formula 1 Grand Prix.",98,110,deep sadness,0,1,1
39I4RL8QGJIU3245GR7WRX4WPD1H4Y,"#21-3 News of his death was announced by his family the following morning: Cquote1.svg It is with deep sadness that the parents of Jules Bianchi, Philippe and Christine, his brother Tom and sister Mélanie, wish to make it known that Jules passed away last night at the Centre Hospitalier Universitaire (CHU) in Nice, (France) where he was admitted following the accident of 5th October 2014 at Suzuka Circuit during the Japanese Formula 1 Grand Prix.",103,110,sadness,0,2,2
39I4RL8QGJIU3245GR7WRX4WPD1H4Y,"#21-3 News of his death was announced by his family the following morning: Cquote1.svg It is with deep sadness that the parents of Jules Bianchi, Philippe and Christine, his brother Tom and sister Mélanie, wish to make it known that Jules passed away last night at the Centre Hospitalier Universitaire (CHU) in Nice, (France) where he was admitted following the accident of 5th October 2014 at Suzuka Circuit during the Japanese Formula 1 Grand Prix.",146,154,Philippe,0,1,1
39I4RL8QGJIU3245GR7WRX4WPD1H4Y,"#21-3 News of his death was announced by his family the following morning: Cquote1.svg It is with deep sadness that the parents of Jules Bianchi, Philippe and Christine, his brother Tom and sister Mélanie, wish to make it known that Jules passed away last night at the Centre Hospitalier Universitaire (CHU) in Nice, (France) where he was admitted following the accident of 5th October 2014 at Suzuka Circuit during the Japanese Formula 1 Grand Prix.",159,168,Christine,0,1,1
39I4RL8QGJIU3245GR7WRX4WPD1H4Y,"#21-3 News of his death was announced by his family the following morning: Cquote1.svg It is with deep sadness that the parents of Jules Bianchi, Philippe and Christine, his brother Tom and sister Mélanie, wish to make it known that Jules passed away last night at the Centre Hospitalier Universitaire (CHU) in Nice, (France) where he was admitted following the accident of 5th October 2014 at Suzuka Circuit during the Japanese Formula 1 Grand Prix.",197,204,Mélanie,1,1,2
39I4RL8QGJIU3245GR7WRX4WPD1H4Y,"#21-3 News of his death was announced by his family the following morning: Cquote1.svg It is with deep sadness that the parents of Jules Bianchi, Philippe and Christine, his brother Tom and sister Mélanie, wish to make it known that Jules passed away last night at the Centre Hospitalier Universitaire (CHU) in Nice, (France) where he was admitted following the accident of 5th October 2014 at Suzuka Circuit during the Japanese Formula 1 Grand Prix.",239,245,passed,1,0,1
39I4RL8QGJIU3245GR7WRX4WPD1H4Y,"#21-3 News of his death was announced by his family the following morning: Cquote1.svg It is with deep sadness that the parents of Jules Bianchi, Philippe and Christine, his brother Tom and sister Mélanie, wish to make it known that Jules passed away last night at the Centre Hospitalier Universitaire (CHU) in Nice, (France) where he was admitted following the accident of 5th October 2014 at Suzuka Circuit during the Japanese Formula 1 Grand Prix.",239,250,passed away,4,2,6
39I4RL8QGJIU3245GR7WRX4WPD1H4Y,"#21-3 News of his death was announced by his family the following morning: Cquote1.svg It is with deep sadness that the parents of Jules Bianchi, Philippe and Christine, his brother Tom and sister Mélanie, wish to make it known that Jules passed away last night at the Centre Hospitalier Universitaire (CHU) in Nice, (France) where he was admitted following the accident of 5th October 2014 at Suzuka Circuit during the Japanese Formula 1 Grand Prix.",339,347,admitted,5,2,7
39I4RL8QGJIU3245GR7WRX4WPD1H4Y,"#21-3 News of his death was announced by his family the following morning: Cquote1.svg It is with deep sadness that the parents of Jules Bianchi, Philippe and Christine, his brother Tom and sister Mélanie, wish to make it known that Jules passed away last night at the Centre Hospitalier Universitaire (CHU) in Nice, (France) where he was admitted following the accident of 5th October 2014 at Suzuka Circuit during the Japanese Formula 1 Grand Prix.",348,357,following,1,0,1
39I4RL8QGJIU3245GR7WRX4WPD1H4Y,"#21-3 News of his death was announced by his family the following morning: Cquote1.svg It is with deep sadness that the parents of Jules Bianchi, Philippe and Christine, his brother Tom and sister Mélanie, wish to make it known that Jules passed away last night at the Centre Hospitalier Universitaire (CHU) in Nice, (France) where he was admitted following the accident of 5th October 2014 at Suzuka Circuit during the Japanese Formula 1 Grand Prix.",394,408,Suzuka Circuit,1,1,2
39I4RL8QGJIU3245GR7WRX4WPD1H4Y,"#21-3 News of his death was announced by his family the following morning: Cquote1.svg It is with deep sadness that the parents of Jules Bianchi, Philippe and Christine, his brother Tom and sister Mélanie, wish to make it known that Jules passed away last night at the Centre Hospitalier Universitaire (CHU) in Nice, (France) where he was admitted following the accident of 5th October 2014 at Suzuka Circuit during the Japanese Formula 1 Grand Prix.",401,408,Circuit,1,0,1
39I4RL8QGJIU3245GR7WRX4WPD1H4Y,"#21-3 News of his death was announced by his family the following morning: Cquote1.svg It is with deep sadness that the parents of Jules Bianchi, Philippe and Christine, his brother Tom and sister Mélanie, wish to make it known that Jules passed away last night at the Centre Hospitalier Universitaire (CHU) in Nice, (France) where he was admitted following the accident of 5th October 2014 at Suzuka Circuit during the Japanese Formula 1 Grand Prix.",420,428,Japanese,0,1,1
39I4RL8QGJIU3245GR7WRX4WPD1H4Y,"#21-3 News of his death was announced by his family the following morning: Cquote1.svg It is with deep sadness that the parents of Jules Bianchi, Philippe and Christine, his brother Tom and sister Mélanie, wish to make it known that Jules passed away last night at the Centre Hospitalier Universitaire (CHU) in Nice, (France) where he was admitted following the accident of 5th October 2014 at Suzuka Circuit during the Japanese Formula 1 Grand Prix.",439,449,Grand Prix,1,0,1
3L60IFZKF3JOFES0VYRFLMD0UINHHK,#35-4 The court has expedited the case.,20,29,expedited,10,10,20
3L60IFZKF3JOFES0VYRFLMD0UINHHK,"#35-5 Burmese nationals Zaw Lin and Wai Phyo, both 22, are currently on trial accused of murdering David Miller, 24, from Jersey, and Hannah Witheridge, 23, from England.",6,13,Burmese,1,0,1
3L60IFZKF3JOFES0VYRFLMD0UINHHK,"#35-5 Burmese nationals Zaw Lin and Wai Phyo, both 22, are currently on trial accused of murdering David Miller, 24, from Jersey, and Hannah Witheridge, 23, from England.",14,23,nationals,1,1,2
3L60IFZKF3JOFES0VYRFLMD0UINHHK,"#35-5 Burmese nationals Zaw Lin and Wai Phyo, both 22, are currently on trial accused of murdering David Miller, 24, from Jersey, and Hannah Witheridge, 23, from England.",72,85,trial accused,1,0,1
3L60IFZKF3JOFES0VYRFLMD0UINHHK,"#35-5 Burmese nationals Zaw Lin and Wai Phyo, both 22, are currently on trial accused of murdering David Miller, 24, from Jersey, and Hannah Witheridge, 23, from England.",78,85,accused,2,4,6
3L60IFZKF3JOFES0VYRFLMD0UINHHK,"#35-5 Burmese nationals Zaw Lin and Wai Phyo, both 22, are currently on trial accused of murdering David Miller, 24, from Jersey, and Hannah Witheridge, 23, from England.",78,98,accused of murdering,0,1,1
3L60IFZKF3JOFES0VYRFLMD0UINHHK,"#35-5 Burmese nationals Zaw Lin and Wai Phyo, both 22, are currently on trial accused of murdering David Miller, 24, from Jersey, and Hannah Witheridge, 23, from England.",89,98,murdering,1,2,3
3L60IFZKF3JOFES0VYRFLMD0UINHHK,"#35-5 Burmese nationals Zaw Lin and Wai Phyo, both 22, are currently on trial accused of murdering David Miller, 24, from Jersey, and Hannah Witheridge, 23, from England.",141,151,Witheridge,1,0,1
3L60IFZKF3JOFES0VYRFLMD0UINHHK,#35-6 With the defence case due to begin shortly and continue until mid- or late September the court has issued its judgement today following a hearing on Friday.,15,22,defence,5,2,7
3L60IFZKF3JOFES0VYRFLMD0UINHHK,#35-6 With the defence case due to begin shortly and continue until mid- or late September the court has issued its judgement today following a hearing on Friday.,15,27,defence case,0,1,1
3L60IFZKF3JOFES0VYRFLMD0UINHHK,#35-6 With the defence case due to begin shortly and continue until mid- or late September the court has issued its judgement today following a hearing on Friday.,105,111,issued,1,1,2
3L60IFZKF3JOFES0VYRFLMD0UINHHK,#35-6 With the defence case due to begin shortly and continue until mid- or late September the court has issued its judgement today following a hearing on Friday.,105,125,issued its judgement,0,1,1
3L60IFZKF3JOFES0VYRFLMD0UINHHK,#35-6 With the defence case due to begin shortly and continue until mid- or late September the court has issued its judgement today following a hearing on Friday.,116,125,judgement,6,4,10
3L60IFZKF3JOFES0VYRFLMD0UINHHK,#35-6 With the defence case due to begin shortly and continue until mid- or late September the court has issued its judgement today following a hearing on Friday.,132,141,following,1,0,1
3L60IFZKF3JOFES0VYRFLMD0UINHHK,#35-6 With the defence case due to begin shortly and continue until mid- or late September the court has issued its judgement today following a hearing on Friday.,144,151,hearing,1,1,2
3L60IFZKF3JOFES0VYRFLMD0UINHHK,#35-7 The case dates to September last year when the victims were found murdered on a Koh Tao beach.,53,60,victims,3,4,7
3L60IFZKF3JOFES0VYRFLMD0UINHHK,#35-7 The case dates to September last year when the victims were found murdered on a Koh Tao beach.,72,80,murdered,1,0,1
3L60IFZKF3JOFES0VYRFLMD0UINHHK,#35-7 The case dates to September last year when the victims were found murdered on a Koh Tao beach.,86,89,Koh,1,0,1
3L60IFZKF3JOFES0VYRFLMD0UINHHK,#35-7 The case dates to September last year when the victims were found murdered on a Koh Tao beach.,90,93,Tao,1,0,1
3L60IFZKF3JOFES0VYRFLMD0UINHHK,#35-8 Witheridge had been raped.,6,16,Witheridge,1,3,4
3L60IFZKF3JOFES0VYRFLMD0UINHHK,#35-8 Witheridge had been raped.,26,31,raped,1,0,1
3L60IFZKF3JOFES0VYRFLMD0UINHHK,"#35-9 The case attracted worldwide attention with Lin and Phyo confessing, before re-enacting the killing in front of the press.",15,24,attracted,0,1,1
3L60IFZKF3JOFES0VYRFLMD0UINHHK,"#35-9 The case attracted worldwide attention with Lin and Phyo confessing, before re-enacting the killing in front of the press.",25,34,worldwide,1,1,2
3L60IFZKF3JOFES0VYRFLMD0UINHHK,"#35-9 The case attracted worldwide attention with Lin and Phyo confessing, before re-enacting the killing in front of the press.",25,44,worldwide attention,1,0,1
3L60IFZKF3JOFES0VYRFLMD0UINHHK,"#35-9 The case attracted worldwide attention with Lin and Phyo confessing, before re-enacting the killing in front of the press.",63,73,confessing,8,3,11
3L60IFZKF3JOFES0VYRFLMD0UINHHK,"#35-9 The case attracted worldwide attention with Lin and Phyo confessing, before re-enacting the killing in front of the press.",82,93,re-enacting,10,8,18
3L60IFZKF3JOFES0VYRFLMD0UINHHK,#35-10 The accused claim the confessions were tortured out of them and the ongoing trial is unfair.,11,18,accused,2,0,2
3L60IFZKF3JOFES0VYRFLMD0UINHHK,#35-10 The accused claim the confessions were tortured out of them and the ongoing trial is unfair.,29,40,confessions,5,5,10
3L60IFZKF3JOFES0VYRFLMD0UINHHK,#35-10 The accused claim the confessions were tortured out of them and the ongoing trial is unfair.,46,54,tortured,5,6,11
3L60IFZKF3JOFES0VYRFLMD0UINHHK,#35-10 The accused claim the confessions were tortured out of them and the ongoing trial is unfair.,75,82,ongoing,2,6,8
3L60IFZKF3JOFES0VYRFLMD0UINHHK,#35-10 The accused claim the confessions were tortured out of them and the ongoing trial is unfair.,83,88,trial,1,1,2
3L60IFZKF3JOFES0VYRFLMD0UINHHK,"#35-11 UK Prime Minister David Cameron intervened, speaking to Thai Prime Minister Prayut Chan-o-cha.",39,49,intervened,8,9,17
3L60IFZKF3JOFES0VYRFLMD0UINHHK,"#35-11 UK Prime Minister David Cameron intervened, speaking to Thai Prime Minister Prayut Chan-o-cha.",83,89,Prayut,2,0,2
3L60IFZKF3JOFES0VYRFLMD0UINHHK,"#35-11 UK Prime Minister David Cameron intervened, speaking to Thai Prime Minister Prayut Chan-o-cha.",90,100,Chan-o-cha,1,0,1
3LCXHSGDLT71LDFEGRV84XNPBDCESM,"#42-97 So basically it seems like they collect it in order to keep diseases out of the nest, so they stop the disease before it can actually infect them.",10,19,basically,3,1,4
3LCXHSGDLT71LDFEGRV84XNPBDCESM,"#42-97 So basically it seems like they collect it in order to keep diseases out of the nest, so they stop the disease before it can actually infect them.",67,75,diseases,3,4,7
3LCXHSGDLT71LDFEGRV84XNPBDCESM,"#42-97 So basically it seems like they collect it in order to keep diseases out of the nest, so they stop the disease before it can actually infect them.",87,91,nest,0,1,1
3LCXHSGDLT71LDFEGRV84XNPBDCESM,"#42-97 So basically it seems like they collect it in order to keep diseases out of the nest, so they stop the disease before it can actually infect them.",110,117,disease,0,1,1
3LCXHSGDLT71LDFEGRV84XNPBDCESM,"#42-97 So basically it seems like they collect it in order to keep diseases out of the nest, so they stop the disease before it can actually infect them.",132,140,actually,1,1,2
3LCXHSGDLT71LDFEGRV84XNPBDCESM,"#42-97 So basically it seems like they collect it in order to keep diseases out of the nest, so they stop the disease before it can actually infect them.",141,147,infect,4,4,8
3LCXHSGDLT71LDFEGRV84XNPBDCESM,#42-98 Wikinews: Are there plans to follow this research up?,7,15,Wikinews,1,1,2
3LCXHSGDLT71LDFEGRV84XNPBDCESM,#42-98 Wikinews: Are there plans to follow this research up?,48,56,research,2,5,7
3LCXHSGDLT71LDFEGRV84XNPBDCESM,#42-99 Might you research other species?,17,25,research,2,0,2
3LCXHSGDLT71LDFEGRV84XNPBDCESM,#42-102 There might be many sources of medicine (recent evidence suggests that tobacco plays a similar role for bumble bees).,28,35,sources,1,4,5
3LCXHSGDLT71LDFEGRV84XNPBDCESM,#42-102 There might be many sources of medicine (recent evidence suggests that tobacco plays a similar role for bumble bees).,39,47,medicine,1,0,1
3LCXHSGDLT71LDFEGRV84XNPBDCESM,#42-102 There might be many sources of medicine (recent evidence suggests that tobacco plays a similar role for bumble bees).,56,64,evidence,3,6,9
3LCXHSGDLT71LDFEGRV84XNPBDCESM,#42-102 There might be many sources of medicine (recent evidence suggests that tobacco plays a similar role for bumble bees).,79,86,tobacco,5,0,5
3LCXHSGDLT71LDFEGRV84XNPBDCESM,#42-102 There might be many sources of medicine (recent evidence suggests that tobacco plays a similar role for bumble bees).,112,118,bumble,0,3,3
3LCXHSGDLT71LDFEGRV84XNPBDCESM,#42-102 There might be many sources of medicine (recent evidence suggests that tobacco plays a similar role for bumble bees).,112,123,bumble bees,0,1,1
3LCXHSGDLT71LDFEGRV84XNPBDCESM,"#42-103 Dalial Freitak, who is also on this paper is currently running tests with Ph.D. student Siiri Fuchs (who is also on the paper) with other substances to see if any have the same effect as H2O2 [hydrogen peroxide].",8,22,Dalial Freitak,1,0,1
3LCXHSGDLT71LDFEGRV84XNPBDCESM,"#42-103 Dalial Freitak, who is also on this paper is currently running tests with Ph.D. student Siiri Fuchs (who is also on the paper) with other substances to see if any have the same effect as H2O2 [hydrogen peroxide].",53,76,currently running tests,0,1,1
3LCXHSGDLT71LDFEGRV84XNPBDCESM,"#42-103 Dalial Freitak, who is also on this paper is currently running tests with Ph.D. student Siiri Fuchs (who is also on the paper) with other substances to see if any have the same effect as H2O2 [hydrogen peroxide].",63,70,running,0,1,1
3LCXHSGDLT71LDFEGRV84XNPBDCESM,"#42-103 Dalial Freitak, who is also on this paper is currently running tests with Ph.D. student Siiri Fuchs (who is also on the paper) with other substances to see if any have the same effect as H2O2 [hydrogen peroxide].",63,76,running tests,0,1,1
3LCXHSGDLT71LDFEGRV84XNPBDCESM,"#42-103 Dalial Freitak, who is also on this paper is currently running tests with Ph.D. student Siiri Fuchs (who is also on the paper) with other substances to see if any have the same effect as H2O2 [hydrogen peroxide].",82,86,Ph.D,1,1,2
3LCXHSGDLT71LDFEGRV84XNPBDCESM,"#42-103 Dalial Freitak, who is also on this paper is currently running tests with Ph.D. student Siiri Fuchs (who is also on the paper) with other substances to see if any have the same effect as H2O2 [hydrogen peroxide].",96,107,Siiri Fuchs,1,0,1
3LCXHSGDLT71LDFEGRV84XNPBDCESM,"#42-103 Dalial Freitak, who is also on this paper is currently running tests with Ph.D. student Siiri Fuchs (who is also on the paper) with other substances to see if any have the same effect as H2O2 [hydrogen peroxide].",146,156,substances,7,7,14
3LCXHSGDLT71LDFEGRV84XNPBDCESM,"#42-104 Once the behaviour has been well described in this species of ant, I might do a comparison with other species.",17,26,behaviour,7,7,14
3LCXHSGDLT71LDFEGRV84XNPBDCESM,"#42-104 Once the behaviour has been well described in this species of ant, I might do a comparison with other species.",41,50,described,2,2,4
3LCXHSGDLT71LDFEGRV84XNPBDCESM,"#42-104 Once the behaviour has been well described in this species of ant, I might do a comparison with other species.",59,66,species,3,6,9
3LCXHSGDLT71LDFEGRV84XNPBDCESM,"#42-104 Once the behaviour has been well described in this species of ant, I might do a comparison with other species.",88,98,comparison,5,7,12
3LCXHSGDLT71LDFEGRV84XNPBDCESM,"#42-104 Once the behaviour has been well described in this species of ant, I might do a comparison with other species.",110,117,species,5,5,10
3E24UO25QZRIA6U63SV184LBXQL6OW,"#13-3 ""We're working with legislative leaders at this very moment to begin to craft legislation that will repeal the most corrosive elements of Obamacare — the individual mandate, the taxes, the penalties — but at the same time, moving separate legislation that will allow us to introduce the kind of reforms in American health care that'll lower the cost of health insurance without growing the size of government,"" said Vice President-elect Mike Pence.",26,37,legislative,8,5,13
3E24UO25QZRIA6U63SV184LBXQL6OW,"#13-3 ""We're working with legislative leaders at this very moment to begin to craft legislation that will repeal the most corrosive elements of Obamacare — the individual mandate, the taxes, the penalties — but at the same time, moving separate legislation that will allow us to introduce the kind of reforms in American health care that'll lower the cost of health insurance without growing the size of government,"" said Vice President-elect Mike Pence.",26,45,legislative leaders,1,0,1
3E24UO25QZRIA6U63SV184LBXQL6OW,"#13-3 ""We're working with legislative leaders at this very moment to begin to craft legislation that will repeal the most corrosive elements of Obamacare — the individual mandate, the taxes, the penalties — but at the same time, moving separate legislation that will allow us to introduce the kind of reforms in American health care that'll lower the cost of health insurance without growing the size of government,"" said Vice President-elect Mike Pence.",59,65,moment,0,1,1
3E24UO25QZRIA6U63SV184LBXQL6OW,"#13-3 ""We're working with legislative leaders at this very moment to begin to craft legislation that will repeal the most corrosive elements of Obamacare — the individual mandate, the taxes, the penalties — but at the same time, moving separate legislation that will allow us to introduce the kind of reforms in American health care that'll lower the cost of health insurance without growing the size of government,"" said Vice President-elect Mike Pence.",78,83,craft,0,3,3
3E24UO25QZRIA6U63SV184LBXQL6OW,"#13-3 ""We're working with legislative leaders at this very moment to begin to craft legislation that will repeal the most corrosive elements of Obamacare — the individual mandate, the taxes, the penalties — but at the same time, moving separate legislation that will allow us to introduce the kind of reforms in American health care that'll lower the cost of health insurance without growing the size of government,"" said Vice President-elect Mike Pence.",78,95,craft legislation,2,3,5
3E24UO25QZRIA6U63SV184LBXQL6OW,"#13-3 ""We're working with legislative leaders at this very moment to begin to craft legislation that will repeal the most corrosive elements of Obamacare — the individual mandate, the taxes, the penalties — but at the same time, moving separate legislation that will allow us to introduce the kind of reforms in American health care that'll lower the cost of health insurance without growing the size of government,"" said Vice President-elect Mike Pence.",84,95,legislation,5,1,6
3E24UO25QZRIA6U63SV184LBXQL6OW,"#13-3 ""We're working with legislative leaders at this very moment to begin to craft legislation that will repeal the most corrosive elements of Obamacare — the individual mandate, the taxes, the penalties — but at the same time, moving separate legislation that will allow us to introduce the kind of reforms in American health care that'll lower the cost of health insurance without growing the size of government,"" said Vice President-elect Mike Pence.",106,112,repeal,3,6,9
3E24UO25QZRIA6U63SV184LBXQL6OW,"#13-3 ""We're working with legislative leaders at this very moment to begin to craft legislation that will repeal the most corrosive elements of Obamacare — the individual mandate, the taxes, the penalties — but at the same time, moving separate legislation that will allow us to introduce the kind of reforms in American health care that'll lower the cost of health insurance without growing the size of government,"" said Vice President-elect Mike Pence.",122,131,corrosive,9,10,19
3E24UO25QZRIA6U63SV184LBXQL6OW,"#13-3 ""We're working with legislative leaders at this very moment to begin to craft legislation that will repeal the most corrosive elements of Obamacare — the individual mandate, the taxes, the penalties — but at the same time, moving separate legislation that will allow us to introduce the kind of reforms in American health care that'll lower the cost of health insurance without growing the size of government,"" said Vice President-elect Mike Pence.",122,140,corrosive elements,3,2,5
3E24UO25QZRIA6U63SV184LBXQL6OW,"#13-3 ""We're working with legislative leaders at this very moment to begin to craft legislation that will repeal the most corrosive elements of Obamacare — the individual mandate, the taxes, the penalties — but at the same time, moving separate legislation that will allow us to introduce the kind of reforms in American health care that'll lower the cost of health insurance without growing the size of government,"" said Vice President-elect Mike Pence.",132,140,elements,1,0,1
3E24UO25QZRIA6U63SV184LBXQL6OW,"#13-3 ""We're working with legislative leaders at this very moment to begin to craft legislation that will repeal the most corrosive elements of Obamacare — the individual mandate, the taxes, the penalties — but at the same time, moving separate legislation that will allow us to introduce the kind of reforms in American health care that'll lower the cost of health insurance without growing the size of government,"" said Vice President-elect Mike Pence.",144,153,Obamacare,0,3,3
3E24UO25QZRIA6U63SV184LBXQL6OW,"#13-3 ""We're working with legislative leaders at this very moment to begin to craft legislation that will repeal the most corrosive elements of Obamacare — the individual mandate, the taxes, the penalties — but at the same time, moving separate legislation that will allow us to introduce the kind of reforms in American health care that'll lower the cost of health insurance without growing the size of government,"" said Vice President-elect Mike Pence.",160,170,individual,2,0,2
3E24UO25QZRIA6U63SV184LBXQL6OW,"#13-3 ""We're working with legislative leaders at this very moment to begin to craft legislation that will repeal the most corrosive elements of Obamacare — the individual mandate, the taxes, the penalties — but at the same time, moving separate legislation that will allow us to introduce the kind of reforms in American health care that'll lower the cost of health insurance without growing the size of government,"" said Vice President-elect Mike Pence.",160,178,individual mandate,1,0,1
3E24UO25QZRIA6U63SV184LBXQL6OW,"#13-3 ""We're working with legislative leaders at this very moment to begin to craft legislation that will repeal the most corrosive elements of Obamacare — the individual mandate, the taxes, the penalties — but at the same time, moving separate legislation that will allow us to introduce the kind of reforms in American health care that'll lower the cost of health insurance without growing the size of government,"" said Vice President-elect Mike Pence.",171,178,mandate,8,5,13
3E24UO25QZRIA6U63SV184LBXQL6OW,"#13-3 ""We're working with legislative leaders at this very moment to begin to craft legislation that will repeal the most corrosive elements of Obamacare — the individual mandate, the taxes, the penalties — but at the same time, moving separate legislation that will allow us to introduce the kind of reforms in American health care that'll lower the cost of health insurance without growing the size of government,"" said Vice President-elect Mike Pence.",195,204,penalties,4,2,6
3E24UO25QZRIA6U63SV184LBXQL6OW,"#13-3 ""We're working with legislative leaders at this very moment to begin to craft legislation that will repeal the most corrosive elements of Obamacare — the individual mandate, the taxes, the penalties — but at the same time, moving separate legislation that will allow us to introduce the kind of reforms in American health care that'll lower the cost of health insurance without growing the size of government,"" said Vice President-elect Mike Pence.",245,256,legislation,5,2,7
3E24UO25QZRIA6U63SV184LBXQL6OW,"#13-3 ""We're working with legislative leaders at this very moment to begin to craft legislation that will repeal the most corrosive elements of Obamacare — the individual mandate, the taxes, the penalties — but at the same time, moving separate legislation that will allow us to introduce the kind of reforms in American health care that'll lower the cost of health insurance without growing the size of government,"" said Vice President-elect Mike Pence.",301,308,reforms,2,3,5
3E24UO25QZRIA6U63SV184LBXQL6OW,"#13-3 ""We're working with legislative leaders at this very moment to begin to craft legislation that will repeal the most corrosive elements of Obamacare — the individual mandate, the taxes, the penalties — but at the same time, moving separate legislation that will allow us to introduce the kind of reforms in American health care that'll lower the cost of health insurance without growing the size of government,"" said Vice President-elect Mike Pence.",366,375,insurance,2,0,2
3E24UO25QZRIA6U63SV184LBXQL6OW,"#13-3 ""We're working with legislative leaders at this very moment to begin to craft legislation that will repeal the most corrosive elements of Obamacare — the individual mandate, the taxes, the penalties — but at the same time, moving separate legislation that will allow us to introduce the kind of reforms in American health care that'll lower the cost of health insurance without growing the size of government,"" said Vice President-elect Mike Pence.",384,414,growing the size of government,1,0,1
3E24UO25QZRIA6U63SV184LBXQL6OW,"#13-3 ""We're working with legislative leaders at this very moment to begin to craft legislation that will repeal the most corrosive elements of Obamacare — the individual mandate, the taxes, the penalties — but at the same time, moving separate legislation that will allow us to introduce the kind of reforms in American health care that'll lower the cost of health insurance without growing the size of government,"" said Vice President-elect Mike Pence.",404,414,government,1,1,2
3E24UO25QZRIA6U63SV184LBXQL6OW,"#13-3 ""We're working with legislative leaders at this very moment to begin to craft legislation that will repeal the most corrosive elements of Obamacare — the individual mandate, the taxes, the penalties — but at the same time, moving separate legislation that will allow us to introduce the kind of reforms in American health care that'll lower the cost of health insurance without growing the size of government,"" said Vice President-elect Mike Pence.",422,442,Vice President-elect,1,1,2
3E24UO25QZRIA6U63SV184LBXQL6OW,"#13-4 Democratic Senator Maria Cantwell of Washington had a different view, going so far as to call this ""stealing health care from Americans.""",17,24,Senator,1,0,1
3E24UO25QZRIA6U63SV184LBXQL6OW,"#13-4 Democratic Senator Maria Cantwell of Washington had a different view, going so far as to call this ""stealing health care from Americans.""",31,39,Cantwell,1,1,2
3E24UO25QZRIA6U63SV184LBXQL6OW,"#13-4 Democratic Senator Maria Cantwell of Washington had a different view, going so far as to call this ""stealing health care from Americans.""",106,114,stealing,2,4,6
3E24UO25QZRIA6U63SV184LBXQL6OW,"#13-4 Democratic Senator Maria Cantwell of Washington had a different view, going so far as to call this ""stealing health care from Americans.""",106,126,stealing health care,0,1,1
3E24UO25QZRIA6U63SV184LBXQL6OW,#13-5 The filibuster is a last-ditch tactic in which parties opposed to a certain motion refuse to relinquish the floor until their opponents give in or compromise.,10,20,filibuster,10,10,20
3E24UO25QZRIA6U63SV184LBXQL6OW,#13-5 The filibuster is a last-ditch tactic in which parties opposed to a certain motion refuse to relinquish the floor until their opponents give in or compromise.,26,36,last-ditch,2,6,8
3E24UO25QZRIA6U63SV184LBXQL6OW,#13-5 The filibuster is a last-ditch tactic in which parties opposed to a certain motion refuse to relinquish the floor until their opponents give in or compromise.,26,43,last-ditch tactic,3,2,5
3E24UO25QZRIA6U63SV184LBXQL6OW,#13-5 The filibuster is a last-ditch tactic in which parties opposed to a certain motion refuse to relinquish the floor until their opponents give in or compromise.,37,43,tactic,3,4,7
3E24UO25QZRIA6U63SV184LBXQL6OW,#13-5 The filibuster is a last-ditch tactic in which parties opposed to a certain motion refuse to relinquish the floor until their opponents give in or compromise.,61,68,opposed,1,1,2
3E24UO25QZRIA6U63SV184LBXQL6OW,#13-5 The filibuster is a last-ditch tactic in which parties opposed to a certain motion refuse to relinquish the floor until their opponents give in or compromise.,82,88,motion,1,2,3
3E24UO25QZRIA6U63SV184LBXQL6OW,#13-5 The filibuster is a last-ditch tactic in which parties opposed to a certain motion refuse to relinquish the floor until their opponents give in or compromise.,89,95,refuse,0,1,1
3E24UO25QZRIA6U63SV184LBXQL6OW,#13-5 The filibuster is a last-ditch tactic in which parties opposed to a certain motion refuse to relinquish the floor until their opponents give in or compromise.,99,109,relinquish,9,10,19
3E24UO25QZRIA6U63SV184LBXQL6OW,#13-5 The filibuster is a last-ditch tactic in which parties opposed to a certain motion refuse to relinquish the floor until their opponents give in or compromise.,132,141,opponents,2,1,3
3E24UO25QZRIA6U63SV184LBXQL6OW,#13-5 The filibuster is a last-ditch tactic in which parties opposed to a certain motion refuse to relinquish the floor until their opponents give in or compromise.,142,149,give in,0,2,2
3E24UO25QZRIA6U63SV184LBXQL6OW,#13-5 The filibuster is a last-ditch tactic in which parties opposed to a certain motion refuse to relinquish the floor until their opponents give in or compromise.,153,163,compromise,4,4,8
3LXX8KJXPWA5SPW41ZYDSECDNRTO9P,"#42-8 Infected ants chose food laced with toxic hydrogen peroxide, whereas healthy ants avoided it.",6,14,Infected,3,2,5
3LXX8KJXPWA5SPW41ZYDSECDNRTO9P,"#42-8 Infected ants chose food laced with toxic hydrogen peroxide, whereas healthy ants avoided it.",26,36,food laced,1,0,1
3LXX8KJXPWA5SPW41ZYDSECDNRTO9P,"#42-8 Infected ants chose food laced with toxic hydrogen peroxide, whereas healthy ants avoided it.",31,36,laced,0,6,6
3LXX8KJXPWA5SPW41ZYDSECDNRTO9P,"#42-8 Infected ants chose food laced with toxic hydrogen peroxide, whereas healthy ants avoided it.",31,41,laced with,0,2,2
3LXX8KJXPWA5SPW41ZYDSECDNRTO9P,"#42-8 Infected ants chose food laced with toxic hydrogen peroxide, whereas healthy ants avoided it.",42,47,toxic,1,4,5
3LXX8KJXPWA5SPW41ZYDSECDNRTO9P,"#42-8 Infected ants chose food laced with toxic hydrogen peroxide, whereas healthy ants avoided it.",42,65,toxic hydrogen peroxide,4,1,5
3LXX8KJXPWA5SPW41ZYDSECDNRTO9P,"#42-8 Infected ants chose food laced with toxic hydrogen peroxide, whereas healthy ants avoided it.",48,56,hydrogen,2,0,2
3LXX8KJXPWA5SPW41ZYDSECDNRTO9P,"#42-8 Infected ants chose food laced with toxic hydrogen peroxide, whereas healthy ants avoided it.",48,65,hydrogen peroxide,7,0,7
3LXX8KJXPWA5SPW41ZYDSECDNRTO9P,"#42-8 Infected ants chose food laced with toxic hydrogen peroxide, whereas healthy ants avoided it.",57,65,peroxide,2,0,2
3LXX8KJXPWA5SPW41ZYDSECDNRTO9P,"#42-8 Infected ants chose food laced with toxic hydrogen peroxide, whereas healthy ants avoided it.",67,74,whereas,3,0,3
3LXX8KJXPWA5SPW41ZYDSECDNRTO9P,"#42-9 Hydrogen peroxide reduced infected ant fatalities by 15%, and the ants varied their intake depending upon how high the peroxide concentration was.",6,14,Hydrogen,1,0,1
3LXX8KJXPWA5SPW41ZYDSECDNRTO9P,"#42-9 Hydrogen peroxide reduced infected ant fatalities by 15%, and the ants varied their intake depending upon how high the peroxide concentration was.",6,23,Hydrogen peroxide,2,0,2
3LXX8KJXPWA5SPW41ZYDSECDNRTO9P,"#42-9 Hydrogen peroxide reduced infected ant fatalities by 15%, and the ants varied their intake depending upon how high the peroxide concentration was.",32,40,infected,2,0,2
3LXX8KJXPWA5SPW41ZYDSECDNRTO9P,"#42-9 Hydrogen peroxide reduced infected ant fatalities by 15%, and the ants varied their intake depending upon how high the peroxide concentration was.",45,55,fatalities,3,8,11
3LXX8KJXPWA5SPW41ZYDSECDNRTO9P,"#42-9 Hydrogen peroxide reduced infected ant fatalities by 15%, and the ants varied their intake depending upon how high the peroxide concentration was.",77,83,varied,0,1,1
3LXX8KJXPWA5SPW41ZYDSECDNRTO9P,"#42-9 Hydrogen peroxide reduced infected ant fatalities by 15%, and the ants varied their intake depending upon how high the peroxide concentration was.",77,96,varied their intake,0,1,1
3LXX8KJXPWA5SPW41ZYDSECDNRTO9P,"#42-9 Hydrogen peroxide reduced infected ant fatalities by 15%, and the ants varied their intake depending upon how high the peroxide concentration was.",90,96,intake,2,3,5
3LXX8KJXPWA5SPW41ZYDSECDNRTO9P,"#42-9 Hydrogen peroxide reduced infected ant fatalities by 15%, and the ants varied their intake depending upon how high the peroxide concentration was.",97,106,depending,1,0,1
3LXX8KJXPWA5SPW41ZYDSECDNRTO9P,"#42-9 Hydrogen peroxide reduced infected ant fatalities by 15%, and the ants varied their intake depending upon how high the peroxide concentration was.",125,133,peroxide,2,0,2
3LXX8KJXPWA5SPW41ZYDSECDNRTO9P,"#42-9 Hydrogen peroxide reduced infected ant fatalities by 15%, and the ants varied their intake depending upon how high the peroxide concentration was.",125,147,peroxide concentration,1,1,2
3LXX8KJXPWA5SPW41ZYDSECDNRTO9P,"#42-9 Hydrogen peroxide reduced infected ant fatalities by 15%, and the ants varied their intake depending upon how high the peroxide concentration was.",134,147,concentration,7,0,7
3LXX8KJXPWA5SPW41ZYDSECDNRTO9P,"#42-10 In the wild, Formica fusca can encounter similar chemicals in aphids and dead ants.",20,27,Formica,0,1,1
3LXX8KJXPWA5SPW41ZYDSECDNRTO9P,"#42-10 In the wild, Formica fusca can encounter similar chemicals in aphids and dead ants.",20,33,Formica fusca,5,2,7
3LXX8KJXPWA5SPW41ZYDSECDNRTO9P,"#42-10 In the wild, Formica fusca can encounter similar chemicals in aphids and dead ants.",28,33,fusca,0,2,2
3LXX8KJXPWA5SPW41ZYDSECDNRTO9P,"#42-10 In the wild, Formica fusca can encounter similar chemicals in aphids and dead ants.",38,47,encounter,1,4,5
3LXX8KJXPWA5SPW41ZYDSECDNRTO9P,"#42-10 In the wild, Formica fusca can encounter similar chemicals in aphids and dead ants.",56,65,chemicals,2,0,2
3LXX8KJXPWA5SPW41ZYDSECDNRTO9P,"#42-10 In the wild, Formica fusca can encounter similar chemicals in aphids and dead ants.",69,75,aphids,8,7,15
3LXX8KJXPWA5SPW41ZYDSECDNRTO9P,#42-11 The Independent reported self-medicating ants a first among insects.,11,22,Independent,1,0,1
3LXX8KJXPWA5SPW41ZYDSECDNRTO9P,#42-11 The Independent reported self-medicating ants a first among insects.,32,47,self-medicating,5,5,10
3LXX8KJXPWA5SPW41ZYDSECDNRTO9P,#42-12 Bos obtained his doctorate from the University of Copenhagen.,7,10,Bos,0,1,1
3LXX8KJXPWA5SPW41ZYDSECDNRTO9P,#42-12 Bos obtained his doctorate from the University of Copenhagen.,11,19,obtained,0,1,1
3LXX8KJXPWA5SPW41ZYDSECDNRTO9P,#42-12 Bos obtained his doctorate from the University of Copenhagen.,24,33,doctorate,10,2,12
3LXX8KJXPWA5SPW41ZYDSECDNRTO9P,#42-12 Bos obtained his doctorate from the University of Copenhagen.,57,67,Copenhagen,1,1,2
3LXX8KJXPWA5SPW41ZYDSECDNRTO9P,#42-13 He began postdoctoral research at Helsinki in 2012.,16,28,postdoctoral,10,3,13
3LXX8KJXPWA5SPW41ZYDSECDNRTO9P,#42-13 He began postdoctoral research at Helsinki in 2012.,16,37,postdoctoral research,0,3,3
3LXX8KJXPWA5SPW41ZYDSECDNRTO9P,#42-13 He began postdoctoral research at Helsinki in 2012.,29,37,research,1,1,2
3LXX8KJXPWA5SPW41ZYDSECDNRTO9P,#42-13 He began postdoctoral research at Helsinki in 2012.,41,49,Helsinki,2,1,3
3LXX8KJXPWA5SPW41ZYDSECDNRTO9P,#42-14 He also runs the AntyScience blog.,24,35,AntyScience,1,4,5
3LXX8KJXPWA5SPW41ZYDSECDNRTO9P,#42-14 He also runs the AntyScience blog.,36,40,blog,1,0,1
3LXX8KJXPWA5SPW41ZYDSECDNRTO9P,"#42-15 The blog aims to help address ""a gap between scientists and 'the general public'.""",11,15,blog,1,0,1
3LXX8KJXPWA5SPW41ZYDSECDNRTO9P,"#42-15 The blog aims to help address ""a gap between scientists and 'the general public'.""",38,62,a gap between scientists,0,1,1
3LXX8KJXPWA5SPW41ZYDSECDNRTO9P,"#42-15 The blog aims to help address ""a gap between scientists and 'the general public'.""",40,43,gap,0,1,1
3LXX8KJXPWA5SPW41ZYDSECDNRTO9P,"#42-15 The blog aims to help address ""a gap between scientists and 'the general public'.""",52,62,scientists,2,0,2
3LXX8KJXPWA5SPW41ZYDSECDNRTO9P,"#42-16 The name is a pun referencing ants, its primary topic, science, and ""non-scientific"" jargon-free communication.",21,24,pun,2,4,6
3LXX8KJXPWA5SPW41ZYDSECDNRTO9P,"#42-16 The name is a pun referencing ants, its primary topic, science, and ""non-scientific"" jargon-free communication.",21,36,pun referencing,0,1,1
3LXX8KJXPWA5SPW41ZYDSECDNRTO9P,"#42-16 The name is a pun referencing ants, its primary topic, science, and ""non-scientific"" jargon-free communication.",25,36,referencing,1,2,3
3LXX8KJXPWA5SPW41ZYDSECDNRTO9P,"#42-16 The name is a pun referencing ants, its primary topic, science, and ""non-scientific"" jargon-free communication.",75,115,non-scientific jargon-free communication,1,0,1
3LXX8KJXPWA5SPW41ZYDSECDNRTO9P,"#42-16 The name is a pun referencing ants, its primary topic, science, and ""non-scientific"" jargon-free communication.",76,90,non-scientific,1,1,2
3LXX8KJXPWA5SPW41ZYDSECDNRTO9P,"#42-16 The name is a pun referencing ants, its primary topic, science, and ""non-scientific"" jargon-free communication.",92,103,jargon-free,5,6,11
3LXX8KJXPWA5SPW41ZYDSECDNRTO9P,"#42-16 The name is a pun referencing ants, its primary topic, science, and ""non-scientific"" jargon-free communication.",92,117,jargon-free communication,3,1,4
3LXX8KJXPWA5SPW41ZYDSECDNRTO9P,"#42-16 The name is a pun referencing ants, its primary topic, science, and ""non-scientific"" jargon-free communication.",104,117,communication,2,0,2
3LXX8KJXPWA5SPW41ZYDSECDNRTO9P,#42-17 He now discusses his work with Wikinews.,14,23,discusses,0,1,1
3LXX8KJXPWA5SPW41ZYDSECDNRTO9P,#42-17 He now discusses his work with Wikinews.,38,46,Wikinews,1,0,1
3LXX8KJXPWA5SPW41ZYDSECDNRTO9P,#42-18 Wikinews: What first attracted you to researching ants?,28,37,attracted,1,0,1
3LXX8KJXPWA5SPW41ZYDSECDNRTO9P,#42-18 Wikinews: What first attracted you to researching ants?,45,56,researching,1,0,1
371QPA24C2P3GCYHT35J7I0HONM1TF,#19-12 The chief is looking into these allegations to see if there were paying passengers.,11,16,chief,1,0,1
371QPA24C2P3GCYHT35J7I0HONM1TF,#19-12 The chief is looking into these allegations to see if there were paying passengers.,39,50,allegations,10,10,20
371QPA24C2P3GCYHT35J7I0HONM1TF,#19-12 The chief is looking into these allegations to see if there were paying passengers.,79,89,passengers,4,1,5
371QPA24C2P3GCYHT35J7I0HONM1TF,"#19-13 An AirAsia jet crashed in the Java Sea last December, killing everyone aboard.",10,17,AirAsia,1,1,2
371QPA24C2P3GCYHT35J7I0HONM1TF,"#19-13 An AirAsia jet crashed in the Java Sea last December, killing everyone aboard.",22,29,crashed,1,2,3
371QPA24C2P3GCYHT35J7I0HONM1TF,"#19-13 An AirAsia jet crashed in the Java Sea last December, killing everyone aboard.",78,84,aboard,1,6,7
371QPA24C2P3GCYHT35J7I0HONM1TF,#19-14 The cause of this C-130 crash has yet to be determined.,51,61,determined,3,4,7
371QPA24C2P3GCYHT35J7I0HONM1TF,"#2-1 Nigerian jet attacks refugee camp, killing dozens A Nigerian Air Force jet fighter mistook refugees for rebels yesterday, Nigerian military said, firing on a camp in Rann, Borno State.",5,13,Nigerian,0,1,1
371QPA24C2P3GCYHT35J7I0HONM1TF,"#2-1 Nigerian jet attacks refugee camp, killing dozens A Nigerian Air Force jet fighter mistook refugees for rebels yesterday, Nigerian military said, firing on a camp in Rann, Borno State.",26,33,refugee,5,5,10
371QPA24C2P3GCYHT35J7I0HONM1TF,"#2-1 Nigerian jet attacks refugee camp, killing dozens A Nigerian Air Force jet fighter mistook refugees for rebels yesterday, Nigerian military said, firing on a camp in Rann, Borno State.",26,38,refugee camp,2,0,2
371QPA24C2P3GCYHT35J7I0HONM1TF,"#2-1 Nigerian jet attacks refugee camp, killing dozens A Nigerian Air Force jet fighter mistook refugees for rebels yesterday, Nigerian military said, firing on a camp in Rann, Borno State.",88,95,mistook,5,6,11
371QPA24C2P3GCYHT35J7I0HONM1TF,"#2-1 Nigerian jet attacks refugee camp, killing dozens A Nigerian Air Force jet fighter mistook refugees for rebels yesterday, Nigerian military said, firing on a camp in Rann, Borno State.",96,104,refugees,3,3,6
371QPA24C2P3GCYHT35J7I0HONM1TF,"#2-1 Nigerian jet attacks refugee camp, killing dozens A Nigerian Air Force jet fighter mistook refugees for rebels yesterday, Nigerian military said, firing on a camp in Rann, Borno State.",109,115,rebels,3,3,6
371QPA24C2P3GCYHT35J7I0HONM1TF,"#2-1 Nigerian jet attacks refugee camp, killing dozens A Nigerian Air Force jet fighter mistook refugees for rebels yesterday, Nigerian military said, firing on a camp in Rann, Borno State.",136,144,military,1,0,1
371QPA24C2P3GCYHT35J7I0HONM1TF,"#2-1 Nigerian jet attacks refugee camp, killing dozens A Nigerian Air Force jet fighter mistook refugees for rebels yesterday, Nigerian military said, firing on a camp in Rann, Borno State.",151,157,firing,1,1,2
371QPA24C2P3GCYHT35J7I0HONM1TF,"#2-1 Nigerian jet attacks refugee camp, killing dozens A Nigerian Air Force jet fighter mistook refugees for rebels yesterday, Nigerian military said, firing on a camp in Rann, Borno State.",171,175,Rann,1,1,2
371QPA24C2P3GCYHT35J7I0HONM1TF,"#2-1 Nigerian jet attacks refugee camp, killing dozens A Nigerian Air Force jet fighter mistook refugees for rebels yesterday, Nigerian military said, firing on a camp in Rann, Borno State.",177,188,Borno State,1,1,2
371QPA24C2P3GCYHT35J7I0HONM1TF,#2-2 Dozens of refugees and aid workers died.,5,11,Dozens,1,1,2
371QPA24C2P3GCYHT35J7I0HONM1TF,#2-2 Dozens of refugees and aid workers died.,15,23,refugees,5,2,7
371QPA24C2P3GCYHT35J7I0HONM1TF,#2-2 Dozens of refugees and aid workers died.,28,39,aid workers,0,1,1
371QPA24C2P3GCYHT35J7I0HONM1TF,#2-3 The lowest estimate from Médecins Sans Frontières (MSF) is of 50 dead.,16,24,estimate,6,2,8
371QPA24C2P3GCYHT35J7I0HONM1TF,#2-3 The lowest estimate from Médecins Sans Frontières (MSF) is of 50 dead.,30,38,Médecins,1,1,2
371QPA24C2P3GCYHT35J7I0HONM1TF,#2-3 The lowest estimate from Médecins Sans Frontières (MSF) is of 50 dead.,30,54,Médecins Sans Frontières,2,0,2
371QPA24C2P3GCYHT35J7I0HONM1TF,#2-3 The lowest estimate from Médecins Sans Frontières (MSF) is of 50 dead.,39,54,Sans Frontières,0,1,1
371QPA24C2P3GCYHT35J7I0HONM1TF,#2-3 The lowest estimate from Médecins Sans Frontières (MSF) is of 50 dead.,44,54,Frontières,1,0,1
371QPA24C2P3GCYHT35J7I0HONM1TF,"#2-4 The BBC estimates at least 52 dead, while one Borno State official is attributed by AP as saying over 100 are dead.",13,22,estimates,1,1,2
371QPA24C2P3GCYHT35J7I0HONM1TF,"#2-4 The BBC estimates at least 52 dead, while one Borno State official is attributed by AP as saying over 100 are dead.",51,56,Borno,1,1,2
371QPA24C2P3GCYHT35J7I0HONM1TF,"#2-4 The BBC estimates at least 52 dead, while one Borno State official is attributed by AP as saying over 100 are dead.",75,85,attributed,10,9,19
371QPA24C2P3GCYHT35J7I0HONM1TF,"#2-4 The BBC estimates at least 52 dead, while one Borno State official is attributed by AP as saying over 100 are dead.",89,91,AP,1,0,1
371QPA24C2P3GCYHT35J7I0HONM1TF,#2-5 MSF say at least 200 were wounded.,31,38,wounded,2,5,7
371QPA24C2P3GCYHT35J7I0HONM1TF,#2-6 The Red Cross said at least six of its staff died and twelve more injured.,71,78,injured,3,3,6
3X2LT8FDHWJDJTMWNTJ99CUO6NA8WW,#10-23 US–Russian relations are also strained.,18,27,relations,1,0,1
3X2LT8FDHWJDJTMWNTJ99CUO6NA8WW,#10-23 US–Russian relations are also strained.,37,45,strained,8,10,18
3X2LT8FDHWJDJTMWNTJ99CUO6NA8WW,"#10-24 Last month the US expelled 35 Russian diplomats accused of espionage, and sanctioned Russian intelligence agencies.",25,33,expelled,5,6,11
3X2LT8FDHWJDJTMWNTJ99CUO6NA8WW,"#10-24 Last month the US expelled 35 Russian diplomats accused of espionage, and sanctioned Russian intelligence agencies.",45,54,diplomats,7,2,9
3X2LT8FDHWJDJTMWNTJ99CUO6NA8WW,"#10-24 Last month the US expelled 35 Russian diplomats accused of espionage, and sanctioned Russian intelligence agencies.",55,62,accused,2,1,3
3X2LT8FDHWJDJTMWNTJ99CUO6NA8WW,"#10-24 Last month the US expelled 35 Russian diplomats accused of espionage, and sanctioned Russian intelligence agencies.",66,75,espionage,10,10,20
3X2LT8FDHWJDJTMWNTJ99CUO6NA8WW,"#10-24 Last month the US expelled 35 Russian diplomats accused of espionage, and sanctioned Russian intelligence agencies.",81,91,sanctioned,10,3,13
3X2LT8FDHWJDJTMWNTJ99CUO6NA8WW,"#10-24 Last month the US expelled 35 Russian diplomats accused of espionage, and sanctioned Russian intelligence agencies.",100,112,intelligence,1,0,1
3X2LT8FDHWJDJTMWNTJ99CUO6NA8WW,"#10-24 Last month the US expelled 35 Russian diplomats accused of espionage, and sanctioned Russian intelligence agencies.",100,121,intelligence agencies,1,0,1
3X2LT8FDHWJDJTMWNTJ99CUO6NA8WW,"#10-24 Last month the US expelled 35 Russian diplomats accused of espionage, and sanctioned Russian intelligence agencies.",113,121,agencies,1,0,1
3X2LT8FDHWJDJTMWNTJ99CUO6NA8WW,#10-25 This was in response to a CIA report issued two weeks earlier that concluded the Russian government hacked servers belonging to the U.S. Republican and Democratic parties.,44,50,issued,0,1,1
3X2LT8FDHWJDJTMWNTJ99CUO6NA8WW,#10-25 This was in response to a CIA report issued two weeks earlier that concluded the Russian government hacked servers belonging to the U.S. Republican and Democratic parties.,74,83,concluded,3,2,5
3X2LT8FDHWJDJTMWNTJ99CUO6NA8WW,#10-25 This was in response to a CIA report issued two weeks earlier that concluded the Russian government hacked servers belonging to the U.S. Republican and Democratic parties.,107,113,hacked,2,6,8
3X2LT8FDHWJDJTMWNTJ99CUO6NA8WW,#10-25 This was in response to a CIA report issued two weeks earlier that concluded the Russian government hacked servers belonging to the U.S. Republican and Democratic parties.,107,121,hacked servers,1,1,2
3X2LT8FDHWJDJTMWNTJ99CUO6NA8WW,#10-25 This was in response to a CIA report issued two weeks earlier that concluded the Russian government hacked servers belonging to the U.S. Republican and Democratic parties.,170,177,parties,1,0,1
3X2LT8FDHWJDJTMWNTJ99CUO6NA8WW,#10-26 The CIA report said this was to turn the 2016 presidential election toward president-elect Donald Trump.,53,65,presidential,1,0,1
3X2LT8FDHWJDJTMWNTJ99CUO6NA8WW,#10-26 The CIA report said this was to turn the 2016 presidential election toward president-elect Donald Trump.,53,74,presidential election,1,0,1
3X2LT8FDHWJDJTMWNTJ99CUO6NA8WW,#10-26 The CIA report said this was to turn the 2016 presidential election toward president-elect Donald Trump.,82,97,president-elect,1,0,1
3X2LT8FDHWJDJTMWNTJ99CUO6NA8WW,#10-27 Trump has indicated he seeks closer ties with Russia.,17,26,indicated,2,1,3
3X2LT8FDHWJDJTMWNTJ99CUO6NA8WW,#10-27 Trump has indicated he seeks closer ties with Russia.,43,47,ties,1,2,3
3X2LT8FDHWJDJTMWNTJ99CUO6NA8WW,"#10-29 ""This is America's most capable fighting force: A combat-ready, highly trained US armoured brigade, with our most advanced equipment and weaponry,"" according to Paul James, US ambassador to Poland.",31,38,capable,1,1,2
3X2LT8FDHWJDJTMWNTJ99CUO6NA8WW,"#10-29 ""This is America's most capable fighting force: A combat-ready, highly trained US armoured brigade, with our most advanced equipment and weaponry,"" according to Paul James, US ambassador to Poland.",57,69,combat-ready,4,2,6
3X2LT8FDHWJDJTMWNTJ99CUO6NA8WW,"#10-29 ""This is America's most capable fighting force: A combat-ready, highly trained US armoured brigade, with our most advanced equipment and weaponry,"" according to Paul James, US ambassador to Poland.",86,105,US armoured brigade,0,1,1
3X2LT8FDHWJDJTMWNTJ99CUO6NA8WW,"#10-29 ""This is America's most capable fighting force: A combat-ready, highly trained US armoured brigade, with our most advanced equipment and weaponry,"" according to Paul James, US ambassador to Poland.",89,97,armoured,5,2,7
3X2LT8FDHWJDJTMWNTJ99CUO6NA8WW,"#10-29 ""This is America's most capable fighting force: A combat-ready, highly trained US armoured brigade, with our most advanced equipment and weaponry,"" according to Paul James, US ambassador to Poland.",89,105,armoured brigade,3,2,5
3X2LT8FDHWJDJTMWNTJ99CUO6NA8WW,"#10-29 ""This is America's most capable fighting force: A combat-ready, highly trained US armoured brigade, with our most advanced equipment and weaponry,"" according to Paul James, US ambassador to Poland.",98,105,brigade,4,2,6
3X2LT8FDHWJDJTMWNTJ99CUO6NA8WW,"#10-29 ""This is America's most capable fighting force: A combat-ready, highly trained US armoured brigade, with our most advanced equipment and weaponry,"" according to Paul James, US ambassador to Poland.",130,139,equipment,0,2,2
3X2LT8FDHWJDJTMWNTJ99CUO6NA8WW,"#10-29 ""This is America's most capable fighting force: A combat-ready, highly trained US armoured brigade, with our most advanced equipment and weaponry,"" according to Paul James, US ambassador to Poland.",144,152,weaponry,5,8,13
3X2LT8FDHWJDJTMWNTJ99CUO6NA8WW,"#10-29 ""This is America's most capable fighting force: A combat-ready, highly trained US armoured brigade, with our most advanced equipment and weaponry,"" according to Paul James, US ambassador to Poland.",183,193,ambassador,3,2,5
3X2LT8FDHWJDJTMWNTJ99CUO6NA8WW,"#10-30 James, who attended the ceremony, said the troops represent ""America's iron-clad commitment to honor our NATO treaty obligation to defend our NATO allies.""",31,39,ceremony,2,2,4
3X2LT8FDHWJDJTMWNTJ99CUO6NA8WW,"#10-30 James, who attended the ceremony, said the troops represent ""America's iron-clad commitment to honor our NATO treaty obligation to defend our NATO allies.""",78,87,iron-clad,4,4,8
3X2LT8FDHWJDJTMWNTJ99CUO6NA8WW,"#10-30 James, who attended the ceremony, said the troops represent ""America's iron-clad commitment to honor our NATO treaty obligation to defend our NATO allies.""",78,98,iron-clad commitment,1,1,2
3X2LT8FDHWJDJTMWNTJ99CUO6NA8WW,"#10-30 James, who attended the ceremony, said the troops represent ""America's iron-clad commitment to honor our NATO treaty obligation to defend our NATO allies.""",88,98,commitment,1,2,3
3X2LT8FDHWJDJTMWNTJ99CUO6NA8WW,"#10-30 James, who attended the ceremony, said the troops represent ""America's iron-clad commitment to honor our NATO treaty obligation to defend our NATO allies.""",112,134,NATO treaty obligation,1,0,1
3X2LT8FDHWJDJTMWNTJ99CUO6NA8WW,"#10-30 James, who attended the ceremony, said the troops represent ""America's iron-clad commitment to honor our NATO treaty obligation to defend our NATO allies.""",117,134,treaty obligation,1,0,1
3X2LT8FDHWJDJTMWNTJ99CUO6NA8WW,"#10-30 James, who attended the ceremony, said the troops represent ""America's iron-clad commitment to honor our NATO treaty obligation to defend our NATO allies.""",124,134,obligation,4,6,10
3X2LT8FDHWJDJTMWNTJ99CUO6NA8WW,"#10-30 James, who attended the ceremony, said the troops represent ""America's iron-clad commitment to honor our NATO treaty obligation to defend our NATO allies.""",149,160,NATO allies,1,2,3
382GHPVPHSSF9UX616IUN33M68J43E,"#15-31 Russia has refused to return wreckage, encouraging conspiracy theories about the crash.",18,25,refused,2,0,2
382GHPVPHSSF9UX616IUN33M68J43E,"#15-31 Russia has refused to return wreckage, encouraging conspiracy theories about the crash.",29,44,return wreckage,0,1,1
382GHPVPHSSF9UX616IUN33M68J43E,"#15-31 Russia has refused to return wreckage, encouraging conspiracy theories about the crash.",36,44,wreckage,10,10,20
382GHPVPHSSF9UX616IUN33M68J43E,"#15-31 Russia has refused to return wreckage, encouraging conspiracy theories about the crash.",46,57,encouraging,1,2,3
382GHPVPHSSF9UX616IUN33M68J43E,"#15-31 Russia has refused to return wreckage, encouraging conspiracy theories about the crash.",46,68,encouraging conspiracy,2,0,2
382GHPVPHSSF9UX616IUN33M68J43E,"#15-31 Russia has refused to return wreckage, encouraging conspiracy theories about the crash.",46,77,encouraging conspiracy theories,1,1,2
382GHPVPHSSF9UX616IUN33M68J43E,"#15-31 Russia has refused to return wreckage, encouraging conspiracy theories about the crash.",58,68,conspiracy,7,5,12
382GHPVPHSSF9UX616IUN33M68J43E,"#15-31 Russia has refused to return wreckage, encouraging conspiracy theories about the crash.",58,77,conspiracy theories,3,2,5
382GHPVPHSSF9UX616IUN33M68J43E,"#15-31 Russia has refused to return wreckage, encouraging conspiracy theories about the crash.",69,77,theories,3,0,3
382GHPVPHSSF9UX616IUN33M68J43E,"#15-32 In 2015 Szydło said in response to the vanishing investigatory findings ""the website has been closed and will simply remain closed.""",27,41,in response to,0,1,1
382GHPVPHSSF9UX616IUN33M68J43E,"#15-32 In 2015 Szydło said in response to the vanishing investigatory findings ""the website has been closed and will simply remain closed.""",46,55,vanishing,7,8,15
382GHPVPHSSF9UX616IUN33M68J43E,"#15-32 In 2015 Szydło said in response to the vanishing investigatory findings ""the website has been closed and will simply remain closed.""",46,78,vanishing investigatory findings,1,2,3
382GHPVPHSSF9UX616IUN33M68J43E,"#15-32 In 2015 Szydło said in response to the vanishing investigatory findings ""the website has been closed and will simply remain closed.""",56,69,investigatory,4,2,6
382GHPVPHSSF9UX616IUN33M68J43E,"#15-32 In 2015 Szydło said in response to the vanishing investigatory findings ""the website has been closed and will simply remain closed.""",56,78,investigatory findings,1,0,1
382GHPVPHSSF9UX616IUN33M68J43E,#15-33 In recent months tension has mounted further as Russia deployed missiles to Kalingrad.,24,31,tension,3,0,3
382GHPVPHSSF9UX616IUN33M68J43E,#15-33 In recent months tension has mounted further as Russia deployed missiles to Kalingrad.,36,43,mounted,3,2,5
382GHPVPHSSF9UX616IUN33M68J43E,#15-33 In recent months tension has mounted further as Russia deployed missiles to Kalingrad.,62,70,deployed,7,6,13
382GHPVPHSSF9UX616IUN33M68J43E,#15-33 In recent months tension has mounted further as Russia deployed missiles to Kalingrad.,71,79,missiles,1,0,1
382GHPVPHSSF9UX616IUN33M68J43E,#15-33 In recent months tension has mounted further as Russia deployed missiles to Kalingrad.,83,92,Kalingrad,1,0,1
382GHPVPHSSF9UX616IUN33M68J43E,"#15-34 The enclave, Russian territory lying between Poland and Lithuania, now has nuclear-capable Iskanders and anti-ship Bastion equipment.",11,18,enclave,6,5,11
382GHPVPHSSF9UX616IUN33M68J43E,"#15-34 The enclave, Russian territory lying between Poland and Lithuania, now has nuclear-capable Iskanders and anti-ship Bastion equipment.",28,37,territory,0,2,2
382GHPVPHSSF9UX616IUN33M68J43E,"#15-34 The enclave, Russian territory lying between Poland and Lithuania, now has nuclear-capable Iskanders and anti-ship Bastion equipment.",38,43,lying,0,1,1
382GHPVPHSSF9UX616IUN33M68J43E,"#15-34 The enclave, Russian territory lying between Poland and Lithuania, now has nuclear-capable Iskanders and anti-ship Bastion equipment.",82,97,nuclear-capable,8,2,10
382GHPVPHSSF9UX616IUN33M68J43E,"#15-34 The enclave, Russian territory lying between Poland and Lithuania, now has nuclear-capable Iskanders and anti-ship Bastion equipment.",98,107,Iskanders,2,1,3
382GHPVPHSSF9UX616IUN33M68J43E,"#15-34 The enclave, Russian territory lying between Poland and Lithuania, now has nuclear-capable Iskanders and anti-ship Bastion equipment.",112,121,anti-ship,2,1,3
382GHPVPHSSF9UX616IUN33M68J43E,"#15-34 The enclave, Russian territory lying between Poland and Lithuania, now has nuclear-capable Iskanders and anti-ship Bastion equipment.",112,129,anti-ship Bastion,1,0,1
382GHPVPHSSF9UX616IUN33M68J43E,"#15-34 The enclave, Russian territory lying between Poland and Lithuania, now has nuclear-capable Iskanders and anti-ship Bastion equipment.",112,139,anti-ship Bastion equipment,1,0,1
382GHPVPHSSF9UX616IUN33M68J43E,"#15-34 The enclave, Russian territory lying between Poland and Lithuania, now has nuclear-capable Iskanders and anti-ship Bastion equipment.",122,139,Bastion equipment,1,0,1
382GHPVPHSSF9UX616IUN33M68J43E,"#15-34 The enclave, Russian territory lying between Poland and Lithuania, now has nuclear-capable Iskanders and anti-ship Bastion equipment.",130,139,equipment,2,0,2
382GHPVPHSSF9UX616IUN33M68J43E,#15-35 NATO considered these deployments a response to its own.,29,40,deployments,6,4,10
382GHPVPHSSF9UX616IUN33M68J43E,#15-36 The US troops are set to rotate around the Balkans every nine months.,14,20,troops,0,1,1
382GHPVPHSSF9UX616IUN33M68J43E,#15-36 The US troops are set to rotate around the Balkans every nine months.,32,38,rotate,1,0,1
382GHPVPHSSF9UX616IUN33M68J43E,"#15-37 Other planned host nations are Estonia, Latvia, Lithuania, Romania, Bulgaria, and Hungary.",21,25,host,0,1,1
382GHPVPHSSF9UX616IUN33M68J43E,#15-38 The rotation is due to a treaty with Russia preventing permanent deployment to any particular territory.,11,19,rotation,3,0,3
382GHPVPHSSF9UX616IUN33M68J43E,#15-38 The rotation is due to a treaty with Russia preventing permanent deployment to any particular territory.,32,38,treaty,5,4,9
382GHPVPHSSF9UX616IUN33M68J43E,#15-38 The rotation is due to a treaty with Russia preventing permanent deployment to any particular territory.,62,71,permanent,3,0,3
382GHPVPHSSF9UX616IUN33M68J43E,#15-38 The rotation is due to a treaty with Russia preventing permanent deployment to any particular territory.,72,82,deployment,3,3,6
382GHPVPHSSF9UX616IUN33M68J43E,#15-38 The rotation is due to a treaty with Russia preventing permanent deployment to any particular territory.,90,100,particular,3,0,3
382GHPVPHSSF9UX616IUN33M68J43E,#15-38 The rotation is due to a treaty with Russia preventing permanent deployment to any particular territory.,101,110,territory,4,1,5
382GHPVPHSSF9UX616IUN33M68J43E,"#15-39 Russia-US relations face a potential thaw, as President-Elect Donald Trump moves towards office on January 20.",34,43,potential,3,4,7
382GHPVPHSSF9UX616IUN33M68J43E,"#15-39 Russia-US relations face a potential thaw, as President-Elect Donald Trump moves towards office on January 20.",34,48,potential thaw,1,2,3
382GHPVPHSSF9UX616IUN33M68J43E,"#15-39 Russia-US relations face a potential thaw, as President-Elect Donald Trump moves towards office on January 20.",44,48,thaw,7,5,12
307FVKVSYRGXADYT3ILK0KF2BA547J,"#24-13 According to the resort's manager Mr. Naseem, the bigger pieces of debris and other waste were taken away and disposed of in the usual way.",7,16,According,1,0,1
307FVKVSYRGXADYT3ILK0KF2BA547J,"#24-13 According to the resort's manager Mr. Naseem, the bigger pieces of debris and other waste were taken away and disposed of in the usual way.",7,19,According to,1,0,1
307FVKVSYRGXADYT3ILK0KF2BA547J,"#24-13 According to the resort's manager Mr. Naseem, the bigger pieces of debris and other waste were taken away and disposed of in the usual way.",24,31,resorts,1,0,1
307FVKVSYRGXADYT3ILK0KF2BA547J,"#24-13 According to the resort's manager Mr. Naseem, the bigger pieces of debris and other waste were taken away and disposed of in the usual way.",64,70,pieces,0,1,1
307FVKVSYRGXADYT3ILK0KF2BA547J,"#24-13 According to the resort's manager Mr. Naseem, the bigger pieces of debris and other waste were taken away and disposed of in the usual way.",74,80,debris,10,10,20
307FVKVSYRGXADYT3ILK0KF2BA547J,"#24-13 According to the resort's manager Mr. Naseem, the bigger pieces of debris and other waste were taken away and disposed of in the usual way.",117,125,disposed,7,7,14
307FVKVSYRGXADYT3ILK0KF2BA547J,"#24-14 He added other forms of debris and trash with no value, such as buoys and suspected military waste, wash up on the islands all the time, especially during monsoon season.",31,37,debris,3,2,5
307FVKVSYRGXADYT3ILK0KF2BA547J,"#24-14 He added other forms of debris and trash with no value, such as buoys and suspected military waste, wash up on the islands all the time, especially during monsoon season.",42,47,trash,1,2,3
307FVKVSYRGXADYT3ILK0KF2BA547J,"#24-14 He added other forms of debris and trash with no value, such as buoys and suspected military waste, wash up on the islands all the time, especially during monsoon season.",71,76,buoys,10,6,16
307FVKVSYRGXADYT3ILK0KF2BA547J,"#24-14 He added other forms of debris and trash with no value, such as buoys and suspected military waste, wash up on the islands all the time, especially during monsoon season.",81,90,suspected,3,1,4
307FVKVSYRGXADYT3ILK0KF2BA547J,"#24-14 He added other forms of debris and trash with no value, such as buoys and suspected military waste, wash up on the islands all the time, especially during monsoon season.",81,99,suspected military,1,0,1
307FVKVSYRGXADYT3ILK0KF2BA547J,"#24-14 He added other forms of debris and trash with no value, such as buoys and suspected military waste, wash up on the islands all the time, especially during monsoon season.",81,105,suspected military waste,1,3,4
307FVKVSYRGXADYT3ILK0KF2BA547J,"#24-14 He added other forms of debris and trash with no value, such as buoys and suspected military waste, wash up on the islands all the time, especially during monsoon season.",107,114,wash up,0,1,1
307FVKVSYRGXADYT3ILK0KF2BA547J,"#24-14 He added other forms of debris and trash with no value, such as buoys and suspected military waste, wash up on the islands all the time, especially during monsoon season.",144,154,especially,1,2,3
307FVKVSYRGXADYT3ILK0KF2BA547J,"#24-14 He added other forms of debris and trash with no value, such as buoys and suspected military waste, wash up on the islands all the time, especially during monsoon season.",162,169,monsoon,9,3,12
307FVKVSYRGXADYT3ILK0KF2BA547J,"#24-14 He added other forms of debris and trash with no value, such as buoys and suspected military waste, wash up on the islands all the time, especially during monsoon season.",162,176,monsoon season,2,1,3
307FVKVSYRGXADYT3ILK0KF2BA547J,"#24-15 Local residents and resort workers regularly collect trash which is sent to the garbage island Thilafushi where it's sorted, exported for recycling, or burned.",13,22,residents,1,0,1
307FVKVSYRGXADYT3ILK0KF2BA547J,"#24-15 Local residents and resort workers regularly collect trash which is sent to the garbage island Thilafushi where it's sorted, exported for recycling, or burned.",27,33,resort,1,0,1
307FVKVSYRGXADYT3ILK0KF2BA547J,"#24-15 Local residents and resort workers regularly collect trash which is sent to the garbage island Thilafushi where it's sorted, exported for recycling, or burned.",42,51,regularly,1,0,1
307FVKVSYRGXADYT3ILK0KF2BA547J,"#24-15 Local residents and resort workers regularly collect trash which is sent to the garbage island Thilafushi where it's sorted, exported for recycling, or burned.",60,65,trash,1,0,1
307FVKVSYRGXADYT3ILK0KF2BA547J,"#24-15 Local residents and resort workers regularly collect trash which is sent to the garbage island Thilafushi where it's sorted, exported for recycling, or burned.",87,94,garbage,1,5,6
307FVKVSYRGXADYT3ILK0KF2BA547J,"#24-15 Local residents and resort workers regularly collect trash which is sent to the garbage island Thilafushi where it's sorted, exported for recycling, or burned.",87,101,garbage island,0,1,1
307FVKVSYRGXADYT3ILK0KF2BA547J,"#24-15 Local residents and resort workers regularly collect trash which is sent to the garbage island Thilafushi where it's sorted, exported for recycling, or burned.",102,112,Thilafushi,3,0,3
307FVKVSYRGXADYT3ILK0KF2BA547J,"#24-15 Local residents and resort workers regularly collect trash which is sent to the garbage island Thilafushi where it's sorted, exported for recycling, or burned.",124,130,sorted,2,4,6
307FVKVSYRGXADYT3ILK0KF2BA547J,"#24-15 Local residents and resort workers regularly collect trash which is sent to the garbage island Thilafushi where it's sorted, exported for recycling, or burned.",132,140,exported,3,2,5
307FVKVSYRGXADYT3ILK0KF2BA547J,"#24-15 Local residents and resort workers regularly collect trash which is sent to the garbage island Thilafushi where it's sorted, exported for recycling, or burned.",132,154,exported for recycling,1,0,1
307FVKVSYRGXADYT3ILK0KF2BA547J,"#24-15 Local residents and resort workers regularly collect trash which is sent to the garbage island Thilafushi where it's sorted, exported for recycling, or burned.",145,154,recycling,4,4,8
307FVKVSYRGXADYT3ILK0KF2BA547J,"#24-16 Reports say at the time the debris was collected, no one suspected it could be from MH370.",35,41,debris,1,1,2
307FVKVSYRGXADYT3ILK0KF2BA547J,"#24-16 Reports say at the time the debris was collected, no one suspected it could be from MH370.",64,73,suspected,2,1,3
307FVKVSYRGXADYT3ILK0KF2BA547J,"#24-17 ""Although some of it was taken to Thilafushi, there is still a five or a seven inch piece on the resort.",41,51,Thilafushi,2,0,2
307FVKVSYRGXADYT3ILK0KF2BA547J,"#24-17 ""Although some of it was taken to Thilafushi, there is still a five or a seven inch piece on the resort.",86,90,inch,0,1,1
307FVKVSYRGXADYT3ILK0KF2BA547J,"#24-17 ""Although some of it was taken to Thilafushi, there is still a five or a seven inch piece on the resort.",104,110,resort,2,1,3
3EKZL9T8Y8NXY6HK96DEAVGKHQIHCB,"#29-1 'Birther King' announces 2016 campaign for U.S. president Via press release on Friday, Andy Martin, a perennial candidate for political office and self-proclaimed ""Birther King"", announced he is seeking the U.S. Republican Party's 2016 presidential nomination, his fourth bid for the White House.",7,19,Birther King,1,1,2
3EKZL9T8Y8NXY6HK96DEAVGKHQIHCB,"#29-1 'Birther King' announces 2016 campaign for U.S. president Via press release on Friday, Andy Martin, a perennial candidate for political office and self-proclaimed ""Birther King"", announced he is seeking the U.S. Republican Party's 2016 presidential nomination, his fourth bid for the White House.",7,14,Birther,2,1,3
3EKZL9T8Y8NXY6HK96DEAVGKHQIHCB,"#29-1 'Birther King' announces 2016 campaign for U.S. president Via press release on Friday, Andy Martin, a perennial candidate for political office and self-proclaimed ""Birther King"", announced he is seeking the U.S. Republican Party's 2016 presidential nomination, his fourth bid for the White House.",21,30,announces,1,0,1
3EKZL9T8Y8NXY6HK96DEAVGKHQIHCB,"#29-1 'Birther King' announces 2016 campaign for U.S. president Via press release on Friday, Andy Martin, a perennial candidate for political office and self-proclaimed ""Birther King"", announced he is seeking the U.S. Republican Party's 2016 presidential nomination, his fourth bid for the White House.",36,44,campaign,2,3,5
3EKZL9T8Y8NXY6HK96DEAVGKHQIHCB,"#29-1 'Birther King' announces 2016 campaign for U.S. president Via press release on Friday, Andy Martin, a perennial candidate for political office and self-proclaimed ""Birther King"", announced he is seeking the U.S. Republican Party's 2016 presidential nomination, his fourth bid for the White House.",106,117,a perennial,1,0,1
3EKZL9T8Y8NXY6HK96DEAVGKHQIHCB,"#29-1 'Birther King' announces 2016 campaign for U.S. president Via press release on Friday, Andy Martin, a perennial candidate for political office and self-proclaimed ""Birther King"", announced he is seeking the U.S. Republican Party's 2016 presidential nomination, his fourth bid for the White House.",108,117,perennial,9,7,16
3EKZL9T8Y8NXY6HK96DEAVGKHQIHCB,"#29-1 'Birther King' announces 2016 campaign for U.S. president Via press release on Friday, Andy Martin, a perennial candidate for political office and self-proclaimed ""Birther King"", announced he is seeking the U.S. Republican Party's 2016 presidential nomination, his fourth bid for the White House.",108,127,perennial candidate,3,3,6
3EKZL9T8Y8NXY6HK96DEAVGKHQIHCB,"#29-1 'Birther King' announces 2016 campaign for U.S. president Via press release on Friday, Andy Martin, a perennial candidate for political office and self-proclaimed ""Birther King"", announced he is seeking the U.S. Republican Party's 2016 presidential nomination, his fourth bid for the White House.",118,127,candidate,0,1,1
3EKZL9T8Y8NXY6HK96DEAVGKHQIHCB,"#29-1 'Birther King' announces 2016 campaign for U.S. president Via press release on Friday, Andy Martin, a perennial candidate for political office and self-proclaimed ""Birther King"", announced he is seeking the U.S. Republican Party's 2016 presidential nomination, his fourth bid for the White House.",153,168,self-proclaimed,5,7,12
3EKZL9T8Y8NXY6HK96DEAVGKHQIHCB,"#29-1 'Birther King' announces 2016 campaign for U.S. president Via press release on Friday, Andy Martin, a perennial candidate for political office and self-proclaimed ""Birther King"", announced he is seeking the U.S. Republican Party's 2016 presidential nomination, his fourth bid for the White House.",153,181,self-proclaimed Birther King,0,1,1
3EKZL9T8Y8NXY6HK96DEAVGKHQIHCB,"#29-1 'Birther King' announces 2016 campaign for U.S. president Via press release on Friday, Andy Martin, a perennial candidate for political office and self-proclaimed ""Birther King"", announced he is seeking the U.S. Republican Party's 2016 presidential nomination, his fourth bid for the White House.",201,208,seeking,0,2,2
3EKZL9T8Y8NXY6HK96DEAVGKHQIHCB,"#29-1 'Birther King' announces 2016 campaign for U.S. president Via press release on Friday, Andy Martin, a perennial candidate for political office and self-proclaimed ""Birther King"", announced he is seeking the U.S. Republican Party's 2016 presidential nomination, his fourth bid for the White House.",242,265,presidential nomination,1,1,2
3EKZL9T8Y8NXY6HK96DEAVGKHQIHCB,"#29-1 'Birther King' announces 2016 campaign for U.S. president Via press release on Friday, Andy Martin, a perennial candidate for political office and self-proclaimed ""Birther King"", announced he is seeking the U.S. Republican Party's 2016 presidential nomination, his fourth bid for the White House.",255,265,nomination,2,3,5
3EKZL9T8Y8NXY6HK96DEAVGKHQIHCB,"#29-1 'Birther King' announces 2016 campaign for U.S. president Via press release on Friday, Andy Martin, a perennial candidate for political office and self-proclaimed ""Birther King"", announced he is seeking the U.S. Republican Party's 2016 presidential nomination, his fourth bid for the White House.",271,281,fourth bid,1,0,1
3EKZL9T8Y8NXY6HK96DEAVGKHQIHCB,"#29-1 'Birther King' announces 2016 campaign for U.S. president Via press release on Friday, Andy Martin, a perennial candidate for political office and self-proclaimed ""Birther King"", announced he is seeking the U.S. Republican Party's 2016 presidential nomination, his fourth bid for the White House.",278,281,bid,0,4,4
3EKZL9T8Y8NXY6HK96DEAVGKHQIHCB,"#29-2 In his announcement and subsequent release, Martin expresses a desire to participate in Republican presidential debates and aligns himself with fellow Republican presidential candidate Donald Trump.",13,25,announcement,1,1,2
3EKZL9T8Y8NXY6HK96DEAVGKHQIHCB,"#29-2 In his announcement and subsequent release, Martin expresses a desire to participate in Republican presidential debates and aligns himself with fellow Republican presidential candidate Donald Trump.",30,40,subsequent,9,9,18
3EKZL9T8Y8NXY6HK96DEAVGKHQIHCB,"#29-2 In his announcement and subsequent release, Martin expresses a desire to participate in Republican presidential debates and aligns himself with fellow Republican presidential candidate Donald Trump.",30,48,subsequent release,1,2,3
3EKZL9T8Y8NXY6HK96DEAVGKHQIHCB,"#29-2 In his announcement and subsequent release, Martin expresses a desire to participate in Republican presidential debates and aligns himself with fellow Republican presidential candidate Donald Trump.",57,66,expresses,0,3,3
3EKZL9T8Y8NXY6HK96DEAVGKHQIHCB,"#29-2 In his announcement and subsequent release, Martin expresses a desire to participate in Republican presidential debates and aligns himself with fellow Republican presidential candidate Donald Trump.",79,90,participate,1,0,1
3EKZL9T8Y8NXY6HK96DEAVGKHQIHCB,"#29-2 In his announcement and subsequent release, Martin expresses a desire to participate in Republican presidential debates and aligns himself with fellow Republican presidential candidate Donald Trump.",105,117,presidential,1,0,1
3EKZL9T8Y8NXY6HK96DEAVGKHQIHCB,"#29-2 In his announcement and subsequent release, Martin expresses a desire to participate in Republican presidential debates and aligns himself with fellow Republican presidential candidate Donald Trump.",118,125,debates,1,3,4
3EKZL9T8Y8NXY6HK96DEAVGKHQIHCB,"#29-2 In his announcement and subsequent release, Martin expresses a desire to participate in Republican presidential debates and aligns himself with fellow Republican presidential candidate Donald Trump.",130,136,aligns,7,7,14
3EKZL9T8Y8NXY6HK96DEAVGKHQIHCB,"#29-2 In his announcement and subsequent release, Martin expresses a desire to participate in Republican presidential debates and aligns himself with fellow Republican presidential candidate Donald Trump.",150,156,fellow,0,1,1
3EKZL9T8Y8NXY6HK96DEAVGKHQIHCB,"#29-2 In his announcement and subsequent release, Martin expresses a desire to participate in Republican presidential debates and aligns himself with fellow Republican presidential candidate Donald Trump.",181,190,candidate,0,1,1
3EKZL9T8Y8NXY6HK96DEAVGKHQIHCB,"#29-3 Additionally, he outlines six reasons for running, including degrading the candidacy of former Florida governor Jeb Bush, who is also seeking the Republican nomination.",6,18,Additionally,0,1,1
3EKZL9T8Y8NXY6HK96DEAVGKHQIHCB,"#29-3 Additionally, he outlines six reasons for running, including degrading the candidacy of former Florida governor Jeb Bush, who is also seeking the Republican nomination.",23,31,outlines,0,1,1
3EKZL9T8Y8NXY6HK96DEAVGKHQIHCB,"#29-3 Additionally, he outlines six reasons for running, including degrading the candidacy of former Florida governor Jeb Bush, who is also seeking the Republican nomination.",67,76,degrading,8,9,17
3EKZL9T8Y8NXY6HK96DEAVGKHQIHCB,"#29-3 Additionally, he outlines six reasons for running, including degrading the candidacy of former Florida governor Jeb Bush, who is also seeking the Republican nomination.",67,90,degrading the candidacy,1,1,2
3EKZL9T8Y8NXY6HK96DEAVGKHQIHCB,"#29-3 Additionally, he outlines six reasons for running, including degrading the candidacy of former Florida governor Jeb Bush, who is also seeking the Republican nomination.",81,90,candidacy,4,7,11
3EKZL9T8Y8NXY6HK96DEAVGKHQIHCB,"#29-3 Additionally, he outlines six reasons for running, including degrading the candidacy of former Florida governor Jeb Bush, who is also seeking the Republican nomination.",152,162,Republican,0,1,1
3EKZL9T8Y8NXY6HK96DEAVGKHQIHCB,"#29-3 Additionally, he outlines six reasons for running, including degrading the candidacy of former Florida governor Jeb Bush, who is also seeking the Republican nomination.",163,173,nomination,4,0,4
3EKZL9T8Y8NXY6HK96DEAVGKHQIHCB,"#29-4 ""I have been a loyal Republican,"" says Martin in his announcement, ""loyal to the principles of our party but not necessarily loyal to some of its failed leaders.""",27,37,Republican,1,0,1
3EKZL9T8Y8NXY6HK96DEAVGKHQIHCB,"#29-4 ""I have been a loyal Republican,"" says Martin in his announcement, ""loyal to the principles of our party but not necessarily loyal to some of its failed leaders.""",59,71,announcement,2,1,3
3EKZL9T8Y8NXY6HK96DEAVGKHQIHCB,"#29-4 ""I have been a loyal Republican,"" says Martin in his announcement, ""loyal to the principles of our party but not necessarily loyal to some of its failed leaders.""",74,79,loyal,2,0,2
3EKZL9T8Y8NXY6HK96DEAVGKHQIHCB,"#29-4 ""I have been a loyal Republican,"" says Martin in his announcement, ""loyal to the principles of our party but not necessarily loyal to some of its failed leaders.""",87,97,principles,1,1,2
3EKZL9T8Y8NXY6HK96DEAVGKHQIHCB,"#29-4 ""I have been a loyal Republican,"" says Martin in his announcement, ""loyal to the principles of our party but not necessarily loyal to some of its failed leaders.""",119,130,necessarily,3,2,5
3EKZL9T8Y8NXY6HK96DEAVGKHQIHCB,"#29-4 ""I have been a loyal Republican,"" says Martin in his announcement, ""loyal to the principles of our party but not necessarily loyal to some of its failed leaders.""",131,136,loyal,0,1,1
3EKZL9T8Y8NXY6HK96DEAVGKHQIHCB,"#29-4 ""I have been a loyal Republican,"" says Martin in his announcement, ""loyal to the principles of our party but not necessarily loyal to some of its failed leaders.""",152,166,failed leaders,0,1,1
3GS542CVJVOJKFQMWK2EJ8CM6WO955,"#34-7 Yesterday, North Korea fired artillery rounds aimed at a loudspeaker in South Korea that broadcasts anti-Pyongyang propaganda into the North.",29,44,fired artillery,1,0,1
3GS542CVJVOJKFQMWK2EJ8CM6WO955,"#34-7 Yesterday, North Korea fired artillery rounds aimed at a loudspeaker in South Korea that broadcasts anti-Pyongyang propaganda into the North.",35,44,artillery,6,7,13
3GS542CVJVOJKFQMWK2EJ8CM6WO955,"#34-7 Yesterday, North Korea fired artillery rounds aimed at a loudspeaker in South Korea that broadcasts anti-Pyongyang propaganda into the North.",35,51,artillery rounds,1,1,2
3GS542CVJVOJKFQMWK2EJ8CM6WO955,"#34-7 Yesterday, North Korea fired artillery rounds aimed at a loudspeaker in South Korea that broadcasts anti-Pyongyang propaganda into the North.",45,51,rounds,0,1,1
3GS542CVJVOJKFQMWK2EJ8CM6WO955,"#34-7 Yesterday, North Korea fired artillery rounds aimed at a loudspeaker in South Korea that broadcasts anti-Pyongyang propaganda into the North.",45,57,rounds aimed,0,1,1
3GS542CVJVOJKFQMWK2EJ8CM6WO955,"#34-7 Yesterday, North Korea fired artillery rounds aimed at a loudspeaker in South Korea that broadcasts anti-Pyongyang propaganda into the North.",52,57,aimed,0,1,1
3GS542CVJVOJKFQMWK2EJ8CM6WO955,"#34-7 Yesterday, North Korea fired artillery rounds aimed at a loudspeaker in South Korea that broadcasts anti-Pyongyang propaganda into the North.",63,74,loudspeaker,4,4,8
3GS542CVJVOJKFQMWK2EJ8CM6WO955,"#34-7 Yesterday, North Korea fired artillery rounds aimed at a loudspeaker in South Korea that broadcasts anti-Pyongyang propaganda into the North.",95,105,broadcasts,0,4,4
3GS542CVJVOJKFQMWK2EJ8CM6WO955,"#34-7 Yesterday, North Korea fired artillery rounds aimed at a loudspeaker in South Korea that broadcasts anti-Pyongyang propaganda into the North.",106,120,anti-Pyongyang,3,0,3
3GS542CVJVOJKFQMWK2EJ8CM6WO955,"#34-7 Yesterday, North Korea fired artillery rounds aimed at a loudspeaker in South Korea that broadcasts anti-Pyongyang propaganda into the North.",106,131,anti-Pyongyang propaganda,2,2,4
3GS542CVJVOJKFQMWK2EJ8CM6WO955,"#34-7 Yesterday, North Korea fired artillery rounds aimed at a loudspeaker in South Korea that broadcasts anti-Pyongyang propaganda into the North.",121,131,propaganda,9,6,15
3GS542CVJVOJKFQMWK2EJ8CM6WO955,"#34-8 ""Commanders of the Korean People's Army were hastily dispatched to the front-line troops to command military operations to destroy psychological warfare tools if the enemy does not stop the propaganda broadcast within 48 hours and prepare against the enemy's possible counteractions,"" added KCNA.",7,17,Commanders,1,0,1
3GS542CVJVOJKFQMWK2EJ8CM6WO955,"#34-8 ""Commanders of the Korean People's Army were hastily dispatched to the front-line troops to command military operations to destroy psychological warfare tools if the enemy does not stop the propaganda broadcast within 48 hours and prepare against the enemy's possible counteractions,"" added KCNA.",51,58,hastily,4,5,9
3GS542CVJVOJKFQMWK2EJ8CM6WO955,"#34-8 ""Commanders of the Korean People's Army were hastily dispatched to the front-line troops to command military operations to destroy psychological warfare tools if the enemy does not stop the propaganda broadcast within 48 hours and prepare against the enemy's possible counteractions,"" added KCNA.",51,69,hastily dispatched,2,3,5
3GS542CVJVOJKFQMWK2EJ8CM6WO955,"#34-8 ""Commanders of the Korean People's Army were hastily dispatched to the front-line troops to command military operations to destroy psychological warfare tools if the enemy does not stop the propaganda broadcast within 48 hours and prepare against the enemy's possible counteractions,"" added KCNA.",59,69,dispatched,4,1,5
3GS542CVJVOJKFQMWK2EJ8CM6WO955,"#34-8 ""Commanders of the Korean People's Army were hastily dispatched to the front-line troops to command military operations to destroy psychological warfare tools if the enemy does not stop the propaganda broadcast within 48 hours and prepare against the enemy's possible counteractions,"" added KCNA.",77,87,front-line,1,0,1
3GS542CVJVOJKFQMWK2EJ8CM6WO955,"#34-8 ""Commanders of the Korean People's Army were hastily dispatched to the front-line troops to command military operations to destroy psychological warfare tools if the enemy does not stop the propaganda broadcast within 48 hours and prepare against the enemy's possible counteractions,"" added KCNA.",129,136,destroy,1,0,1
3GS542CVJVOJKFQMWK2EJ8CM6WO955,"#34-8 ""Commanders of the Korean People's Army were hastily dispatched to the front-line troops to command military operations to destroy psychological warfare tools if the enemy does not stop the propaganda broadcast within 48 hours and prepare against the enemy's possible counteractions,"" added KCNA.",137,150,psychological,6,2,8
3GS542CVJVOJKFQMWK2EJ8CM6WO955,"#34-8 ""Commanders of the Korean People's Army were hastily dispatched to the front-line troops to command military operations to destroy psychological warfare tools if the enemy does not stop the propaganda broadcast within 48 hours and prepare against the enemy's possible counteractions,"" added KCNA.",137,158,psychological warfare,3,2,5
3GS542CVJVOJKFQMWK2EJ8CM6WO955,"#34-8 ""Commanders of the Korean People's Army were hastily dispatched to the front-line troops to command military operations to destroy psychological warfare tools if the enemy does not stop the propaganda broadcast within 48 hours and prepare against the enemy's possible counteractions,"" added KCNA.",137,164,psychological warfare tools,0,2,2
3GS542CVJVOJKFQMWK2EJ8CM6WO955,"#34-8 ""Commanders of the Korean People's Army were hastily dispatched to the front-line troops to command military operations to destroy psychological warfare tools if the enemy does not stop the propaganda broadcast within 48 hours and prepare against the enemy's possible counteractions,"" added KCNA.",151,158,warfare,0,2,2
3GS542CVJVOJKFQMWK2EJ8CM6WO955,"#34-8 ""Commanders of the Korean People's Army were hastily dispatched to the front-line troops to command military operations to destroy psychological warfare tools if the enemy does not stop the propaganda broadcast within 48 hours and prepare against the enemy's possible counteractions,"" added KCNA.",172,177,enemy,1,0,1
3GS542CVJVOJKFQMWK2EJ8CM6WO955,"#34-8 ""Commanders of the Korean People's Army were hastily dispatched to the front-line troops to command military operations to destroy psychological warfare tools if the enemy does not stop the propaganda broadcast within 48 hours and prepare against the enemy's possible counteractions,"" added KCNA.",196,206,propaganda,4,0,4
3GS542CVJVOJKFQMWK2EJ8CM6WO955,"#34-8 ""Commanders of the Korean People's Army were hastily dispatched to the front-line troops to command military operations to destroy psychological warfare tools if the enemy does not stop the propaganda broadcast within 48 hours and prepare against the enemy's possible counteractions,"" added KCNA.",196,216,propaganda broadcast,0,1,1
3GS542CVJVOJKFQMWK2EJ8CM6WO955,"#34-8 ""Commanders of the Korean People's Army were hastily dispatched to the front-line troops to command military operations to destroy psychological warfare tools if the enemy does not stop the propaganda broadcast within 48 hours and prepare against the enemy's possible counteractions,"" added KCNA.",274,288,counteractions,10,10,20
3GS542CVJVOJKFQMWK2EJ8CM6WO955,"#34-9 No injuries or deaths were reported in the attacks from either side, but South Korea evacuated about 80 people in the town of Yeoncheon after at least one shell landed near the area.",9,17,injuries,1,0,1
3GS542CVJVOJKFQMWK2EJ8CM6WO955,"#34-9 No injuries or deaths were reported in the attacks from either side, but South Korea evacuated about 80 people in the town of Yeoncheon after at least one shell landed near the area.",49,56,attacks,0,1,1
3GS542CVJVOJKFQMWK2EJ8CM6WO955,"#34-9 No injuries or deaths were reported in the attacks from either side, but South Korea evacuated about 80 people in the town of Yeoncheon after at least one shell landed near the area.",91,100,evacuated,5,8,13
3GS542CVJVOJKFQMWK2EJ8CM6WO955,"#34-9 No injuries or deaths were reported in the attacks from either side, but South Korea evacuated about 80 people in the town of Yeoncheon after at least one shell landed near the area.",132,141,Yeoncheon,2,2,4
3GS542CVJVOJKFQMWK2EJ8CM6WO955,"#34-9 No injuries or deaths were reported in the attacks from either side, but South Korea evacuated about 80 people in the town of Yeoncheon after at least one shell landed near the area.",161,166,shell,2,3,5
3GS542CVJVOJKFQMWK2EJ8CM6WO955,"#34-9 No injuries or deaths were reported in the attacks from either side, but South Korea evacuated about 80 people in the town of Yeoncheon after at least one shell landed near the area.",167,173,landed,0,1,1
3GS542CVJVOJKFQMWK2EJ8CM6WO955,#34-10 The South retaliated by firing dozens of rounds of artillery into the north.,7,27,The South retaliated,0,1,1
3GS542CVJVOJKFQMWK2EJ8CM6WO955,#34-10 The South retaliated by firing dozens of rounds of artillery into the north.,17,27,retaliated,7,8,15
3GS542CVJVOJKFQMWK2EJ8CM6WO955,#34-10 The South retaliated by firing dozens of rounds of artillery into the north.,48,67,rounds of artillery,1,0,1
3GS542CVJVOJKFQMWK2EJ8CM6WO955,#34-10 The South retaliated by firing dozens of rounds of artillery into the north.,58,67,artillery,3,1,4
3GS542CVJVOJKFQMWK2EJ8CM6WO955,#34-11 South Korea had recently started to broadcast propaganda from loudspeakers after an 11-year lull.,43,52,broadcast,1,0,1
3GS542CVJVOJKFQMWK2EJ8CM6WO955,#34-11 South Korea had recently started to broadcast propaganda from loudspeakers after an 11-year lull.,53,63,propaganda,3,2,5
3GS542CVJVOJKFQMWK2EJ8CM6WO955,#34-11 South Korea had recently started to broadcast propaganda from loudspeakers after an 11-year lull.,69,81,loudspeakers,2,3,5
3GS542CVJVOJKFQMWK2EJ8CM6WO955,#34-11 South Korea had recently started to broadcast propaganda from loudspeakers after an 11-year lull.,99,103,lull,1,2,3
3UZUVSO3P7WYNI29WUZMSOOJJOUEMA,"#35-37 Mr Justice Green also ruled the pair, in principal, ""have a perfectly proper right to seek access to the personal data for the purpose of using it subsequently in their defence in criminal proceedings"", calling the case one about ""fundamental rights"".",29,34,ruled,0,2,2
3UZUVSO3P7WYNI29WUZMSOOJJOUEMA,"#35-37 Mr Justice Green also ruled the pair, in principal, ""have a perfectly proper right to seek access to the personal data for the purpose of using it subsequently in their defence in criminal proceedings"", calling the case one about ""fundamental rights"".",29,43,ruled the pair,0,1,1
3UZUVSO3P7WYNI29WUZMSOOJJOUEMA,"#35-37 Mr Justice Green also ruled the pair, in principal, ""have a perfectly proper right to seek access to the personal data for the purpose of using it subsequently in their defence in criminal proceedings"", calling the case one about ""fundamental rights"".",45,57,in principal,1,0,1
3UZUVSO3P7WYNI29WUZMSOOJJOUEMA,"#35-37 Mr Justice Green also ruled the pair, in principal, ""have a perfectly proper right to seek access to the personal data for the purpose of using it subsequently in their defence in criminal proceedings"", calling the case one about ""fundamental rights"".",48,57,principal,4,0,4
3UZUVSO3P7WYNI29WUZMSOOJJOUEMA,"#35-37 Mr Justice Green also ruled the pair, in principal, ""have a perfectly proper right to seek access to the personal data for the purpose of using it subsequently in their defence in criminal proceedings"", calling the case one about ""fundamental rights"".",67,76,perfectly,0,2,2
3UZUVSO3P7WYNI29WUZMSOOJJOUEMA,"#35-37 Mr Justice Green also ruled the pair, in principal, ""have a perfectly proper right to seek access to the personal data for the purpose of using it subsequently in their defence in criminal proceedings"", calling the case one about ""fundamental rights"".",67,89,perfectly proper right,1,0,1
3UZUVSO3P7WYNI29WUZMSOOJJOUEMA,"#35-37 Mr Justice Green also ruled the pair, in principal, ""have a perfectly proper right to seek access to the personal data for the purpose of using it subsequently in their defence in criminal proceedings"", calling the case one about ""fundamental rights"".",77,83,proper,1,0,1
3UZUVSO3P7WYNI29WUZMSOOJJOUEMA,"#35-37 Mr Justice Green also ruled the pair, in principal, ""have a perfectly proper right to seek access to the personal data for the purpose of using it subsequently in their defence in criminal proceedings"", calling the case one about ""fundamental rights"".",93,104,seek access,0,1,1
3UZUVSO3P7WYNI29WUZMSOOJJOUEMA,"#35-37 Mr Justice Green also ruled the pair, in principal, ""have a perfectly proper right to seek access to the personal data for the purpose of using it subsequently in their defence in criminal proceedings"", calling the case one about ""fundamental rights"".",98,104,access,0,1,1
3UZUVSO3P7WYNI29WUZMSOOJJOUEMA,"#35-37 Mr Justice Green also ruled the pair, in principal, ""have a perfectly proper right to seek access to the personal data for the purpose of using it subsequently in their defence in criminal proceedings"", calling the case one about ""fundamental rights"".",134,141,purpose,0,2,2
3UZUVSO3P7WYNI29WUZMSOOJJOUEMA,"#35-37 Mr Justice Green also ruled the pair, in principal, ""have a perfectly proper right to seek access to the personal data for the purpose of using it subsequently in their defence in criminal proceedings"", calling the case one about ""fundamental rights"".",154,166,subsequently,10,9,19
3UZUVSO3P7WYNI29WUZMSOOJJOUEMA,"#35-37 Mr Justice Green also ruled the pair, in principal, ""have a perfectly proper right to seek access to the personal data for the purpose of using it subsequently in their defence in criminal proceedings"", calling the case one about ""fundamental rights"".",176,183,defence,4,1,5
3UZUVSO3P7WYNI29WUZMSOOJJOUEMA,"#35-37 Mr Justice Green also ruled the pair, in principal, ""have a perfectly proper right to seek access to the personal data for the purpose of using it subsequently in their defence in criminal proceedings"", calling the case one about ""fundamental rights"".",187,195,criminal,1,0,1
3UZUVSO3P7WYNI29WUZMSOOJJOUEMA,"#35-37 Mr Justice Green also ruled the pair, in principal, ""have a perfectly proper right to seek access to the personal data for the purpose of using it subsequently in their defence in criminal proceedings"", calling the case one about ""fundamental rights"".",187,207,criminal proceedings,5,1,6
3UZUVSO3P7WYNI29WUZMSOOJJOUEMA,"#35-37 Mr Justice Green also ruled the pair, in principal, ""have a perfectly proper right to seek access to the personal data for the purpose of using it subsequently in their defence in criminal proceedings"", calling the case one about ""fundamental rights"".",196,207,proceedings,3,6,9
3UZUVSO3P7WYNI29WUZMSOOJJOUEMA,"#35-37 Mr Justice Green also ruled the pair, in principal, ""have a perfectly proper right to seek access to the personal data for the purpose of using it subsequently in their defence in criminal proceedings"", calling the case one about ""fundamental rights"".",238,249,fundamental,5,3,8
3UZUVSO3P7WYNI29WUZMSOOJJOUEMA,"#35-37 Mr Justice Green also ruled the pair, in principal, ""have a perfectly proper right to seek access to the personal data for the purpose of using it subsequently in their defence in criminal proceedings"", calling the case one about ""fundamental rights"".",238,256,fundamental rights,4,2,6
3UZUVSO3P7WYNI29WUZMSOOJJOUEMA,"#35-38 Rosa Curling, who represented both men in the London court, has said they would not appeal.",12,19,Curling,0,1,1
3UZUVSO3P7WYNI29WUZMSOOJJOUEMA,"#35-38 Rosa Curling, who represented both men in the London court, has said they would not appeal.",25,36,represented,4,1,5
3UZUVSO3P7WYNI29WUZMSOOJJOUEMA,"#35-38 Rosa Curling, who represented both men in the London court, has said they would not appeal.",91,97,appeal,3,4,7
3UZUVSO3P7WYNI29WUZMSOOJJOUEMA,"#35-39 She said Lin and Phyo are ""disappointed"" but ""are reassured that at least a British judge has now looked at the information held by the Metropolitan Police, applying anxious scrutiny, and determined that it would not assist them in their ongoing proceedings in Thailand.""",24,28,Phyo,0,1,1
3UZUVSO3P7WYNI29WUZMSOOJJOUEMA,"#35-39 She said Lin and Phyo are ""disappointed"" but ""are reassured that at least a British judge has now looked at the information held by the Metropolitan Police, applying anxious scrutiny, and determined that it would not assist them in their ongoing proceedings in Thailand.""",34,46,disappointed,4,2,6
3UZUVSO3P7WYNI29WUZMSOOJJOUEMA,"#35-39 She said Lin and Phyo are ""disappointed"" but ""are reassured that at least a British judge has now looked at the information held by the Metropolitan Police, applying anxious scrutiny, and determined that it would not assist them in their ongoing proceedings in Thailand.""",57,66,reassured,1,10,11
3UZUVSO3P7WYNI29WUZMSOOJJOUEMA,"#35-39 She said Lin and Phyo are ""disappointed"" but ""are reassured that at least a British judge has now looked at the information held by the Metropolitan Police, applying anxious scrutiny, and determined that it would not assist them in their ongoing proceedings in Thailand.""",119,130,information,1,1,2
3UZUVSO3P7WYNI29WUZMSOOJJOUEMA,"#35-39 She said Lin and Phyo are ""disappointed"" but ""are reassured that at least a British judge has now looked at the information held by the Metropolitan Police, applying anxious scrutiny, and determined that it would not assist them in their ongoing proceedings in Thailand.""",143,155,Metropolitan,1,1,2
3UZUVSO3P7WYNI29WUZMSOOJJOUEMA,"#35-39 She said Lin and Phyo are ""disappointed"" but ""are reassured that at least a British judge has now looked at the information held by the Metropolitan Police, applying anxious scrutiny, and determined that it would not assist them in their ongoing proceedings in Thailand.""",164,189,applying anxious scrutiny,1,0,1
3UZUVSO3P7WYNI29WUZMSOOJJOUEMA,"#35-39 She said Lin and Phyo are ""disappointed"" but ""are reassured that at least a British judge has now looked at the information held by the Metropolitan Police, applying anxious scrutiny, and determined that it would not assist them in their ongoing proceedings in Thailand.""",173,180,anxious,2,2,4
3UZUVSO3P7WYNI29WUZMSOOJJOUEMA,"#35-39 She said Lin and Phyo are ""disappointed"" but ""are reassured that at least a British judge has now looked at the information held by the Metropolitan Police, applying anxious scrutiny, and determined that it would not assist them in their ongoing proceedings in Thailand.""",173,189,anxious scrutiny,3,1,4
3UZUVSO3P7WYNI29WUZMSOOJJOUEMA,"#35-39 She said Lin and Phyo are ""disappointed"" but ""are reassured that at least a British judge has now looked at the information held by the Metropolitan Police, applying anxious scrutiny, and determined that it would not assist them in their ongoing proceedings in Thailand.""",181,189,scrutiny,7,6,13
3UZUVSO3P7WYNI29WUZMSOOJJOUEMA,"#35-39 She said Lin and Phyo are ""disappointed"" but ""are reassured that at least a British judge has now looked at the information held by the Metropolitan Police, applying anxious scrutiny, and determined that it would not assist them in their ongoing proceedings in Thailand.""",195,205,determined,1,2,3
3UZUVSO3P7WYNI29WUZMSOOJJOUEMA,"#35-39 She said Lin and Phyo are ""disappointed"" but ""are reassured that at least a British judge has now looked at the information held by the Metropolitan Police, applying anxious scrutiny, and determined that it would not assist them in their ongoing proceedings in Thailand.""",245,252,ongoing,0,6,6
3UZUVSO3P7WYNI29WUZMSOOJJOUEMA,"#35-39 She said Lin and Phyo are ""disappointed"" but ""are reassured that at least a British judge has now looked at the information held by the Metropolitan Police, applying anxious scrutiny, and determined that it would not assist them in their ongoing proceedings in Thailand.""",253,264,proceedings,1,1,2
3UZUVSO3P7WYNI29WUZMSOOJJOUEMA,"#35-40 Wikinews has contacted the Metropolitan Police, usually responsible for policing London, for a statement and is awaiting a response.",20,29,contacted,1,1,2
3UZUVSO3P7WYNI29WUZMSOOJJOUEMA,"#35-40 Wikinews has contacted the Metropolitan Police, usually responsible for policing London, for a statement and is awaiting a response.",34,46,Metropolitan,1,0,1
3UZUVSO3P7WYNI29WUZMSOOJJOUEMA,"#35-40 Wikinews has contacted the Metropolitan Police, usually responsible for policing London, for a statement and is awaiting a response.",63,74,responsible,1,1,2
3UZUVSO3P7WYNI29WUZMSOOJJOUEMA,"#35-40 Wikinews has contacted the Metropolitan Police, usually responsible for policing London, for a statement and is awaiting a response.",79,87,policing,1,0,1
3UZUVSO3P7WYNI29WUZMSOOJJOUEMA,"#35-40 Wikinews has contacted the Metropolitan Police, usually responsible for policing London, for a statement and is awaiting a response.",102,111,statement,0,1,1
3UZUVSO3P7WYNI29WUZMSOOJJOUEMA,"#35-40 Wikinews has contacted the Metropolitan Police, usually responsible for policing London, for a statement and is awaiting a response.",119,127,awaiting,2,3,5
3UZUVSO3P7WYNI29WUZMSOOJJOUEMA,"#35-40 Wikinews has contacted the Metropolitan Police, usually responsible for policing London, for a statement and is awaiting a response.",130,138,response,0,1,1
38Z7YZ2SB331O22NK6WUUC6GLIYIQA,"#1-11 Next week, on January 24, the Supreme Court is due to deliver a decision in a case challenging the government's right to issue Article 50—which starts the Brexit negotiations—without the consultation of Parliament.",36,49,Supreme Court,1,0,1
38Z7YZ2SB331O22NK6WUUC6GLIYIQA,"#1-11 Next week, on January 24, the Supreme Court is due to deliver a decision in a case challenging the government's right to issue Article 50—which starts the Brexit negotiations—without the consultation of Parliament.",53,56,due,0,1,1
38Z7YZ2SB331O22NK6WUUC6GLIYIQA,"#1-11 Next week, on January 24, the Supreme Court is due to deliver a decision in a case challenging the government's right to issue Article 50—which starts the Brexit negotiations—without the consultation of Parliament.",60,67,deliver,0,3,3
38Z7YZ2SB331O22NK6WUUC6GLIYIQA,"#1-11 Next week, on January 24, the Supreme Court is due to deliver a decision in a case challenging the government's right to issue Article 50—which starts the Brexit negotiations—without the consultation of Parliament.",70,78,decision,4,0,4
38Z7YZ2SB331O22NK6WUUC6GLIYIQA,"#1-11 Next week, on January 24, the Supreme Court is due to deliver a decision in a case challenging the government's right to issue Article 50—which starts the Brexit negotiations—without the consultation of Parliament.",89,100,challenging,5,6,11
38Z7YZ2SB331O22NK6WUUC6GLIYIQA,"#1-11 Next week, on January 24, the Supreme Court is due to deliver a decision in a case challenging the government's right to issue Article 50—which starts the Brexit negotiations—without the consultation of Parliament.",127,132,issue,0,1,1
38Z7YZ2SB331O22NK6WUUC6GLIYIQA,"#1-11 Next week, on January 24, the Supreme Court is due to deliver a decision in a case challenging the government's right to issue Article 50—which starts the Brexit negotiations—without the consultation of Parliament.",127,140,issue Article,1,0,1
38Z7YZ2SB331O22NK6WUUC6GLIYIQA,"#1-11 Next week, on January 24, the Supreme Court is due to deliver a decision in a case challenging the government's right to issue Article 50—which starts the Brexit negotiations—without the consultation of Parliament.",133,140,Article,1,1,2
38Z7YZ2SB331O22NK6WUUC6GLIYIQA,"#1-11 Next week, on January 24, the Supreme Court is due to deliver a decision in a case challenging the government's right to issue Article 50—which starts the Brexit negotiations—without the consultation of Parliament.",161,167,Brexit,1,0,1
38Z7YZ2SB331O22NK6WUUC6GLIYIQA,"#1-11 Next week, on January 24, the Supreme Court is due to deliver a decision in a case challenging the government's right to issue Article 50—which starts the Brexit negotiations—without the consultation of Parliament.",161,188,Brexit negotiations—without,1,0,1
38Z7YZ2SB331O22NK6WUUC6GLIYIQA,"#1-11 Next week, on January 24, the Supreme Court is due to deliver a decision in a case challenging the government's right to issue Article 50—which starts the Brexit negotiations—without the consultation of Parliament.",193,205,consultation,10,5,15
38Z7YZ2SB331O22NK6WUUC6GLIYIQA,"#1-11 Next week, on January 24, the Supreme Court is due to deliver a decision in a case challenging the government's right to issue Article 50—which starts the Brexit negotiations—without the consultation of Parliament.",193,219,consultation of Parliament,1,0,1
38Z7YZ2SB331O22NK6WUUC6GLIYIQA,"#1-11 Next week, on January 24, the Supreme Court is due to deliver a decision in a case challenging the government's right to issue Article 50—which starts the Brexit negotiations—without the consultation of Parliament.",209,219,Parliament,4,0,4
38Z7YZ2SB331O22NK6WUUC6GLIYIQA,#10-1 Polish PM Beata Szydło welcomes US troops Polish Prime Minister Beata Szydło on Saturday headed a ceremony in the Western town of Żagań welcoming US troops.,6,28,Polish PM Beata Szydło,1,0,1
38Z7YZ2SB331O22NK6WUUC6GLIYIQA,#10-1 Polish PM Beata Szydło welcomes US troops Polish Prime Minister Beata Szydło on Saturday headed a ceremony in the Western town of Żagań welcoming US troops.,48,82,Polish Prime Minister Beata Szydło,1,0,1
38Z7YZ2SB331O22NK6WUUC6GLIYIQA,#10-1 Polish PM Beata Szydło welcomes US troops Polish Prime Minister Beata Szydło on Saturday headed a ceremony in the Western town of Żagań welcoming US troops.,95,101,headed,3,3,6
38Z7YZ2SB331O22NK6WUUC6GLIYIQA,#10-1 Polish PM Beata Szydło welcomes US troops Polish Prime Minister Beata Szydło on Saturday headed a ceremony in the Western town of Żagań welcoming US troops.,104,112,ceremony,4,3,7
38Z7YZ2SB331O22NK6WUUC6GLIYIQA,#10-1 Polish PM Beata Szydło welcomes US troops Polish Prime Minister Beata Szydło on Saturday headed a ceremony in the Western town of Żagań welcoming US troops.,136,141,Żagań,1,0,1
38Z7YZ2SB331O22NK6WUUC6GLIYIQA,#10-1 Polish PM Beata Szydło welcomes US troops Polish Prime Minister Beata Szydło on Saturday headed a ceremony in the Western town of Żagań welcoming US troops.,155,161,troops,0,2,2
38Z7YZ2SB331O22NK6WUUC6GLIYIQA,#10-2 The troops are in the region in response to Russian action in Ukraine and began arriving earlier this week.,28,34,region,1,0,1
38Z7YZ2SB331O22NK6WUUC6GLIYIQA,#10-2 The troops are in the region in response to Russian action in Ukraine and began arriving earlier this week.,38,46,response,3,2,5
38Z7YZ2SB331O22NK6WUUC6GLIYIQA,#10-2 The troops are in the region in response to Russian action in Ukraine and began arriving earlier this week.,86,94,arriving,1,0,1
38Z7YZ2SB331O22NK6WUUC6GLIYIQA,"#10-4 ""It is the duty of the Polish state, the government to provide security.",17,21,duty,1,1,2
38Z7YZ2SB331O22NK6WUUC6GLIYIQA,"#10-4 ""It is the duty of the Polish state, the government to provide security.",47,57,government,1,1,2
38Z7YZ2SB331O22NK6WUUC6GLIYIQA,"#10-4 ""It is the duty of the Polish state, the government to provide security.",61,68,provide,1,1,2
38Z7YZ2SB331O22NK6WUUC6GLIYIQA,"#10-4 ""It is the duty of the Polish state, the government to provide security.",61,77,provide security,0,1,1
38Z7YZ2SB331O22NK6WUUC6GLIYIQA,"#10-4 ""It is the duty of the Polish state, the government to provide security.",69,77,security,4,0,4
38Z7YZ2SB331O22NK6WUUC6GLIYIQA,"#10-5 Today we have made a big step in this direction"".",27,35,big step,1,0,1
38Z7YZ2SB331O22NK6WUUC6GLIYIQA,"#10-5 Today we have made a big step in this direction"".",44,53,direction,1,1,2
38Z7YZ2SB331O22NK6WUUC6GLIYIQA,"#10-6 Outgoing US President Barack Obama authorised the move in response to Russian intervention in Ukraine in 2014, in which Crimea was annexed.",6,14,Outgoing,1,5,6
38Z7YZ2SB331O22NK6WUUC6GLIYIQA,"#10-6 Outgoing US President Barack Obama authorised the move in response to Russian intervention in Ukraine in 2014, in which Crimea was annexed.",41,51,authorised,10,5,15
38Z7YZ2SB331O22NK6WUUC6GLIYIQA,"#10-6 Outgoing US President Barack Obama authorised the move in response to Russian intervention in Ukraine in 2014, in which Crimea was annexed.",84,96,intervention,10,7,17
38Z7YZ2SB331O22NK6WUUC6GLIYIQA,"#10-6 Outgoing US President Barack Obama authorised the move in response to Russian intervention in Ukraine in 2014, in which Crimea was annexed.",126,144,Crimea was annexed,1,0,1
38Z7YZ2SB331O22NK6WUUC6GLIYIQA,"#10-6 Outgoing US President Barack Obama authorised the move in response to Russian intervention in Ukraine in 2014, in which Crimea was annexed.",137,144,annexed,10,10,20
3U74KRR67MM6UJ56YQ3H4PDKROQTNE,"#37-9 The Social and Popular Assembly, formed during protests in recent months, allege violations of electoral law by many parties, and want an electoral commission crackdown.",6,37,The Social and Popular Assembly,1,0,1
3U74KRR67MM6UJ56YQ3H4PDKROQTNE,"#37-9 The Social and Popular Assembly, formed during protests in recent months, allege violations of electoral law by many parties, and want an electoral commission crackdown.",10,16,Social,1,0,1
3U74KRR67MM6UJ56YQ3H4PDKROQTNE,"#37-9 The Social and Popular Assembly, formed during protests in recent months, allege violations of electoral law by many parties, and want an electoral commission crackdown.",29,37,Assembly,5,1,6
3U74KRR67MM6UJ56YQ3H4PDKROQTNE,"#37-9 The Social and Popular Assembly, formed during protests in recent months, allege violations of electoral law by many parties, and want an electoral commission crackdown.",53,61,protests,1,2,3
3U74KRR67MM6UJ56YQ3H4PDKROQTNE,"#37-9 The Social and Popular Assembly, formed during protests in recent months, allege violations of electoral law by many parties, and want an electoral commission crackdown.",65,71,recent,1,0,1
3U74KRR67MM6UJ56YQ3H4PDKROQTNE,"#37-9 The Social and Popular Assembly, formed during protests in recent months, allege violations of electoral law by many parties, and want an electoral commission crackdown.",80,86,allege,7,3,10
3U74KRR67MM6UJ56YQ3H4PDKROQTNE,"#37-9 The Social and Popular Assembly, formed during protests in recent months, allege violations of electoral law by many parties, and want an electoral commission crackdown.",80,97,allege violations,3,1,4
3U74KRR67MM6UJ56YQ3H4PDKROQTNE,"#37-9 The Social and Popular Assembly, formed during protests in recent months, allege violations of electoral law by many parties, and want an electoral commission crackdown.",87,97,violations,6,5,11
3U74KRR67MM6UJ56YQ3H4PDKROQTNE,"#37-9 The Social and Popular Assembly, formed during protests in recent months, allege violations of electoral law by many parties, and want an electoral commission crackdown.",101,110,electoral,6,0,6
3U74KRR67MM6UJ56YQ3H4PDKROQTNE,"#37-9 The Social and Popular Assembly, formed during protests in recent months, allege violations of electoral law by many parties, and want an electoral commission crackdown.",101,114,electoral law,1,0,1
3U74KRR67MM6UJ56YQ3H4PDKROQTNE,"#37-9 The Social and Popular Assembly, formed during protests in recent months, allege violations of electoral law by many parties, and want an electoral commission crackdown.",144,153,electoral,5,0,5
3U74KRR67MM6UJ56YQ3H4PDKROQTNE,"#37-9 The Social and Popular Assembly, formed during protests in recent months, allege violations of electoral law by many parties, and want an electoral commission crackdown.",144,174,electoral commission crackdown,2,0,2
3U74KRR67MM6UJ56YQ3H4PDKROQTNE,"#37-9 The Social and Popular Assembly, formed during protests in recent months, allege violations of electoral law by many parties, and want an electoral commission crackdown.",154,164,commission,3,0,3
3U74KRR67MM6UJ56YQ3H4PDKROQTNE,"#37-9 The Social and Popular Assembly, formed during protests in recent months, allege violations of electoral law by many parties, and want an electoral commission crackdown.",154,174,commission crackdown,2,0,2
3U74KRR67MM6UJ56YQ3H4PDKROQTNE,"#37-9 The Social and Popular Assembly, formed during protests in recent months, allege violations of electoral law by many parties, and want an electoral commission crackdown.",165,174,crackdown,2,10,12
3U74KRR67MM6UJ56YQ3H4PDKROQTNE,"#37-10 One member organisation, the Committee for Campesino Unity, wants a delay until elections are reformed.",18,30,organisation,2,0,2
3U74KRR67MM6UJ56YQ3H4PDKROQTNE,"#37-10 One member organisation, the Committee for Campesino Unity, wants a delay until elections are reformed.",50,59,Campesino,3,2,5
3U74KRR67MM6UJ56YQ3H4PDKROQTNE,"#37-10 One member organisation, the Committee for Campesino Unity, wants a delay until elections are reformed.",75,80,delay,0,1,1
3U74KRR67MM6UJ56YQ3H4PDKROQTNE,"#37-10 One member organisation, the Committee for Campesino Unity, wants a delay until elections are reformed.",101,109,reformed,2,5,7
3U74KRR67MM6UJ56YQ3H4PDKROQTNE,#37-11 They also seek a new constitution.,28,40,constitution,6,0,6
3U74KRR67MM6UJ56YQ3H4PDKROQTNE,#37-12 Molina is accused of conspiring to corruptly divert customs funds.,17,24,accused,0,1,1
3U74KRR67MM6UJ56YQ3H4PDKROQTNE,#37-12 Molina is accused of conspiring to corruptly divert customs funds.,28,38,conspiring,10,6,16
3U74KRR67MM6UJ56YQ3H4PDKROQTNE,#37-12 Molina is accused of conspiring to corruptly divert customs funds.,28,58,conspiring to corruptly divert,1,0,1
3U74KRR67MM6UJ56YQ3H4PDKROQTNE,#37-12 Molina is accused of conspiring to corruptly divert customs funds.,42,51,corruptly,6,3,9
3U74KRR67MM6UJ56YQ3H4PDKROQTNE,#37-12 Molina is accused of conspiring to corruptly divert customs funds.,42,58,corruptly divert,2,2,4
3U74KRR67MM6UJ56YQ3H4PDKROQTNE,#37-12 Molina is accused of conspiring to corruptly divert customs funds.,52,58,divert,4,3,7
3U74KRR67MM6UJ56YQ3H4PDKROQTNE,#37-13 He denies any misconduct.,10,16,denies,1,1,2
3U74KRR67MM6UJ56YQ3H4PDKROQTNE,#37-13 He denies any misconduct.,21,31,misconduct,8,7,15
3U74KRR67MM6UJ56YQ3H4PDKROQTNE,"#38-1 Virginia reporter, cameraman killed on live TV, alleged shooter commits suicide Two members of a news crew for Roanoke, Virginia station WDBJ were shot and killed on live television this morning.",54,61,alleged,3,3,6
3U74KRR67MM6UJ56YQ3H4PDKROQTNE,"#38-1 Virginia reporter, cameraman killed on live TV, alleged shooter commits suicide Two members of a news crew for Roanoke, Virginia station WDBJ were shot and killed on live television this morning.",54,69,alleged shooter,0,1,1
3U74KRR67MM6UJ56YQ3H4PDKROQTNE,"#38-1 Virginia reporter, cameraman killed on live TV, alleged shooter commits suicide Two members of a news crew for Roanoke, Virginia station WDBJ were shot and killed on live television this morning.",70,77,commits,1,1,2
3U74KRR67MM6UJ56YQ3H4PDKROQTNE,"#38-1 Virginia reporter, cameraman killed on live TV, alleged shooter commits suicide Two members of a news crew for Roanoke, Virginia station WDBJ were shot and killed on live television this morning.",78,85,suicide,1,3,4
3U74KRR67MM6UJ56YQ3H4PDKROQTNE,"#38-1 Virginia reporter, cameraman killed on live TV, alleged shooter commits suicide Two members of a news crew for Roanoke, Virginia station WDBJ were shot and killed on live television this morning.",108,112,crew,1,0,1
3U74KRR67MM6UJ56YQ3H4PDKROQTNE,"#38-1 Virginia reporter, cameraman killed on live TV, alleged shooter commits suicide Two members of a news crew for Roanoke, Virginia station WDBJ were shot and killed on live television this morning.",117,124,Roanoke,1,0,1
3U74KRR67MM6UJ56YQ3H4PDKROQTNE,"#38-2 The suspect, a former reporter for the news station, later shot himself after a manhunt of several hours, authorities said.",10,17,suspect,0,1,1
3U74KRR67MM6UJ56YQ3H4PDKROQTNE,"#38-2 The suspect, a former reporter for the news station, later shot himself after a manhunt of several hours, authorities said.",86,93,manhunt,6,9,15
3U74KRR67MM6UJ56YQ3H4PDKROQTNE,"#38-2 The suspect, a former reporter for the news station, later shot himself after a manhunt of several hours, authorities said.",112,123,authorities,2,1,3
3U74KRR67MM6UJ56YQ3H4PDKROQTNE,"#38-3 Reporter Alison Parker, 24, and cameraman Adam Ward, 27, were conducting an interview at a local outdoor shopping mall when a gunman opened fire at approximately 6:45 AM local time (1045 UTC).",68,78,conducting,1,2,3
3U74KRR67MM6UJ56YQ3H4PDKROQTNE,"#38-3 Reporter Alison Parker, 24, and cameraman Adam Ward, 27, were conducting an interview at a local outdoor shopping mall when a gunman opened fire at approximately 6:45 AM local time (1045 UTC).",82,91,interview,1,0,1
3U74KRR67MM6UJ56YQ3H4PDKROQTNE,"#38-3 Reporter Alison Parker, 24, and cameraman Adam Ward, 27, were conducting an interview at a local outdoor shopping mall when a gunman opened fire at approximately 6:45 AM local time (1045 UTC).",132,138,gunman,1,1,2
3U74KRR67MM6UJ56YQ3H4PDKROQTNE,"#38-3 Reporter Alison Parker, 24, and cameraman Adam Ward, 27, were conducting an interview at a local outdoor shopping mall when a gunman opened fire at approximately 6:45 AM local time (1045 UTC).",154,167,approximately,6,4,10
3126F2F5F8448LZMOARE9SIEOT5EP6,#40-10 They feel they are under-represented in higher education and are suffering in a regional economic downturn.,26,43,under-represented,9,8,17
3126F2F5F8448LZMOARE9SIEOT5EP6,#40-10 They feel they are under-represented in higher education and are suffering in a regional economic downturn.,54,63,education,1,0,1
3126F2F5F8448LZMOARE9SIEOT5EP6,#40-10 They feel they are under-represented in higher education and are suffering in a regional economic downturn.,72,81,suffering,2,2,4
3126F2F5F8448LZMOARE9SIEOT5EP6,#40-10 They feel they are under-represented in higher education and are suffering in a regional economic downturn.,87,95,regional,1,0,1
3126F2F5F8448LZMOARE9SIEOT5EP6,#40-10 They feel they are under-represented in higher education and are suffering in a regional economic downturn.,87,113,regional economic downturn,4,1,5
3126F2F5F8448LZMOARE9SIEOT5EP6,#40-10 They feel they are under-represented in higher education and are suffering in a regional economic downturn.,96,104,economic,3,0,3
3126F2F5F8448LZMOARE9SIEOT5EP6,#40-10 They feel they are under-represented in higher education and are suffering in a regional economic downturn.,96,113,economic downturn,1,2,3
3126F2F5F8448LZMOARE9SIEOT5EP6,#40-10 They feel they are under-represented in higher education and are suffering in a regional economic downturn.,105,113,downturn,3,8,11
3126F2F5F8448LZMOARE9SIEOT5EP6,"#40-11 Amongst those calling for an end to the violence was Prime Minister Narendra Modi, who said ""each and every issue can be resolved through talks"" during a televised broadcast.",7,14,Amongst,3,2,5
3126F2F5F8448LZMOARE9SIEOT5EP6,"#40-11 Amongst those calling for an end to the violence was Prime Minister Narendra Modi, who said ""each and every issue can be resolved through talks"" during a televised broadcast.",47,55,violence,2,1,3
3126F2F5F8448LZMOARE9SIEOT5EP6,"#40-11 Amongst those calling for an end to the violence was Prime Minister Narendra Modi, who said ""each and every issue can be resolved through talks"" during a televised broadcast.",128,136,resolved,3,3,6
3126F2F5F8448LZMOARE9SIEOT5EP6,"#40-11 Amongst those calling for an end to the violence was Prime Minister Narendra Modi, who said ""each and every issue can be resolved through talks"" during a televised broadcast.",161,170,televised,1,1,2
3126F2F5F8448LZMOARE9SIEOT5EP6,"#40-11 Amongst those calling for an end to the violence was Prime Minister Narendra Modi, who said ""each and every issue can be resolved through talks"" during a televised broadcast.",161,180,televised broadcast,2,1,3
3126F2F5F8448LZMOARE9SIEOT5EP6,"#40-11 Amongst those calling for an end to the violence was Prime Minister Narendra Modi, who said ""each and every issue can be resolved through talks"" during a televised broadcast.",171,180,broadcast,1,3,4
3126F2F5F8448LZMOARE9SIEOT5EP6,#40-12 He was elected last year and was previously the Chief Minister of Gujarat for more than twelve years.,40,50,previously,4,1,5
3126F2F5F8448LZMOARE9SIEOT5EP6,#40-12 He was elected last year and was previously the Chief Minister of Gujarat for more than twelve years.,55,69,Chief Minister,1,0,1
3126F2F5F8448LZMOARE9SIEOT5EP6,#40-13 He was in power in Gujurat during sectarian violence in 2002 which resulted in about a thousand deaths.,41,50,sectarian,10,8,18
3126F2F5F8448LZMOARE9SIEOT5EP6,#40-13 He was in power in Gujurat during sectarian violence in 2002 which resulted in about a thousand deaths.,41,59,sectarian violence,1,3,4
3126F2F5F8448LZMOARE9SIEOT5EP6,#40-13 He was in power in Gujurat during sectarian violence in 2002 which resulted in about a thousand deaths.,51,59,violence,2,1,3
3126F2F5F8448LZMOARE9SIEOT5EP6,#40-13 He was in power in Gujurat during sectarian violence in 2002 which resulted in about a thousand deaths.,74,82,resulted,0,1,1
3126F2F5F8448LZMOARE9SIEOT5EP6,#40-13 He was in power in Gujurat during sectarian violence in 2002 which resulted in about a thousand deaths.,94,102,thousand,1,0,1
3126F2F5F8448LZMOARE9SIEOT5EP6,"#41-1 Four men go before Hungarian court after 71 found dead in lorry To write, edit, start or view other articles on Austria, see the Austria Portal Four foreign men have today gone before a court in Hungary on suspicion of people smuggling.",25,34,Hungarian,0,1,1
3126F2F5F8448LZMOARE9SIEOT5EP6,"#41-1 Four men go before Hungarian court after 71 found dead in lorry To write, edit, start or view other articles on Austria, see the Austria Portal Four foreign men have today gone before a court in Hungary on suspicion of people smuggling.",64,69,lorry,3,2,5
3126F2F5F8448LZMOARE9SIEOT5EP6,"#41-1 Four men go before Hungarian court after 71 found dead in lorry To write, edit, start or view other articles on Austria, see the Austria Portal Four foreign men have today gone before a court in Hungary on suspicion of people smuggling.",106,114,articles,0,1,1
3126F2F5F8448LZMOARE9SIEOT5EP6,"#41-1 Four men go before Hungarian court after 71 found dead in lorry To write, edit, start or view other articles on Austria, see the Austria Portal Four foreign men have today gone before a court in Hungary on suspicion of people smuggling.",118,125,Austria,0,1,1
3126F2F5F8448LZMOARE9SIEOT5EP6,"#41-1 Four men go before Hungarian court after 71 found dead in lorry To write, edit, start or view other articles on Austria, see the Austria Portal Four foreign men have today gone before a court in Hungary on suspicion of people smuggling.",143,149,Portal,0,2,2
3126F2F5F8448LZMOARE9SIEOT5EP6,"#41-1 Four men go before Hungarian court after 71 found dead in lorry To write, edit, start or view other articles on Austria, see the Austria Portal Four foreign men have today gone before a court in Hungary on suspicion of people smuggling.",155,162,foreign,4,1,5
3126F2F5F8448LZMOARE9SIEOT5EP6,"#41-1 Four men go before Hungarian court after 71 found dead in lorry To write, edit, start or view other articles on Austria, see the Austria Portal Four foreign men have today gone before a court in Hungary on suspicion of people smuggling.",212,221,suspicion,6,7,13
3126F2F5F8448LZMOARE9SIEOT5EP6,"#41-1 Four men go before Hungarian court after 71 found dead in lorry To write, edit, start or view other articles on Austria, see the Austria Portal Four foreign men have today gone before a court in Hungary on suspicion of people smuggling.",232,241,smuggling,10,10,20
3CESM1J3EI4QFF38UEMBPYYX0SK6W8,"#30-18 The part of the law which prohibits ""the unauthorized use of images of police officers that might jeopardize their or their family's safety"" is cited as the reason for the fine, however, police spokesperson Fernando Portillo said it was up to police officers involved and under the new law they could do this.",33,42,prohibits,9,10,19
3CESM1J3EI4QFF38UEMBPYYX0SK6W8,"#30-18 The part of the law which prohibits ""the unauthorized use of images of police officers that might jeopardize their or their family's safety"" is cited as the reason for the fine, however, police spokesperson Fernando Portillo said it was up to police officers involved and under the new law they could do this.",48,60,unauthorized,9,9,18
3CESM1J3EI4QFF38UEMBPYYX0SK6W8,"#30-18 The part of the law which prohibits ""the unauthorized use of images of police officers that might jeopardize their or their family's safety"" is cited as the reason for the fine, however, police spokesperson Fernando Portillo said it was up to police officers involved and under the new law they could do this.",105,115,jeopardize,10,10,20
3CESM1J3EI4QFF38UEMBPYYX0SK6W8,"#30-18 The part of the law which prohibits ""the unauthorized use of images of police officers that might jeopardize their or their family's safety"" is cited as the reason for the fine, however, police spokesperson Fernando Portillo said it was up to police officers involved and under the new law they could do this.",151,156,cited,1,3,4
3CESM1J3EI4QFF38UEMBPYYX0SK6W8,"#30-18 The part of the law which prohibits ""the unauthorized use of images of police officers that might jeopardize their or their family's safety"" is cited as the reason for the fine, however, police spokesperson Fernando Portillo said it was up to police officers involved and under the new law they could do this.",201,213,spokesperson,3,6,9
3CESM1J3EI4QFF38UEMBPYYX0SK6W8,"#30-18 The part of the law which prohibits ""the unauthorized use of images of police officers that might jeopardize their or their family's safety"" is cited as the reason for the fine, however, police spokesperson Fernando Portillo said it was up to police officers involved and under the new law they could do this.",223,231,Portillo,0,1,1
3CESM1J3EI4QFF38UEMBPYYX0SK6W8,"#30-18 The part of the law which prohibits ""the unauthorized use of images of police officers that might jeopardize their or their family's safety"" is cited as the reason for the fine, however, police spokesperson Fernando Portillo said it was up to police officers involved and under the new law they could do this.",266,274,involved,0,1,1
3CESM1J3EI4QFF38UEMBPYYX0SK6W8,"#30-19 ""We would have preferred a different solution but they have the legal right to impose the fine,” Portillo said, but the public posting of the photo impugned the officers' sense of honor.",22,31,preferred,3,4,7
3CESM1J3EI4QFF38UEMBPYYX0SK6W8,"#30-19 ""We would have preferred a different solution but they have the legal right to impose the fine,” Portillo said, but the public posting of the photo impugned the officers' sense of honor.",44,52,solution,2,1,3
3CESM1J3EI4QFF38UEMBPYYX0SK6W8,"#30-19 ""We would have preferred a different solution but they have the legal right to impose the fine,” Portillo said, but the public posting of the photo impugned the officers' sense of honor.",71,76,legal,0,1,1
3CESM1J3EI4QFF38UEMBPYYX0SK6W8,"#30-19 ""We would have preferred a different solution but they have the legal right to impose the fine,” Portillo said, but the public posting of the photo impugned the officers' sense of honor.",71,82,legal right,0,1,1
3CESM1J3EI4QFF38UEMBPYYX0SK6W8,"#30-19 ""We would have preferred a different solution but they have the legal right to impose the fine,” Portillo said, but the public posting of the photo impugned the officers' sense of honor.",86,92,impose,3,5,8
3CESM1J3EI4QFF38UEMBPYYX0SK6W8,"#30-19 ""We would have preferred a different solution but they have the legal right to impose the fine,” Portillo said, but the public posting of the photo impugned the officers' sense of honor.",86,101,impose the fine,1,0,1
3CESM1J3EI4QFF38UEMBPYYX0SK6W8,"#30-19 ""We would have preferred a different solution but they have the legal right to impose the fine,” Portillo said, but the public posting of the photo impugned the officers' sense of honor.",104,112,Portillo,1,0,1
3CESM1J3EI4QFF38UEMBPYYX0SK6W8,"#30-19 ""We would have preferred a different solution but they have the legal right to impose the fine,” Portillo said, but the public posting of the photo impugned the officers' sense of honor.",155,163,impugned,10,10,20
3CESM1J3EI4QFF38UEMBPYYX0SK6W8,"#30-19 ""We would have preferred a different solution but they have the legal right to impose the fine,” Portillo said, but the public posting of the photo impugned the officers' sense of honor.",178,192,sense of honor,0,1,1
3CESM1J3EI4QFF38UEMBPYYX0SK6W8,"#31-1 Explosion in central Bangkok: Thailand to hunt those responsible Thai authorities are searching for a man wearing a yellow T-shirt, recorded on video leaving a backpack shortly before a pipe-bomb exploded two days ago near Erawan Hindu Shrine, Bangkok.",6,15,Explosion,2,4,6
3CESM1J3EI4QFF38UEMBPYYX0SK6W8,"#31-1 Explosion in central Bangkok: Thailand to hunt those responsible Thai authorities are searching for a man wearing a yellow T-shirt, recorded on video leaving a backpack shortly before a pipe-bomb exploded two days ago near Erawan Hindu Shrine, Bangkok.",48,52,hunt,0,3,3
3CESM1J3EI4QFF38UEMBPYYX0SK6W8,"#31-1 Explosion in central Bangkok: Thailand to hunt those responsible Thai authorities are searching for a man wearing a yellow T-shirt, recorded on video leaving a backpack shortly before a pipe-bomb exploded two days ago near Erawan Hindu Shrine, Bangkok.",59,70,responsible,2,1,3
3CESM1J3EI4QFF38UEMBPYYX0SK6W8,"#31-1 Explosion in central Bangkok: Thailand to hunt those responsible Thai authorities are searching for a man wearing a yellow T-shirt, recorded on video leaving a backpack shortly before a pipe-bomb exploded two days ago near Erawan Hindu Shrine, Bangkok.",76,87,authorities,2,1,3
3CESM1J3EI4QFF38UEMBPYYX0SK6W8,"#31-1 Explosion in central Bangkok: Thailand to hunt those responsible Thai authorities are searching for a man wearing a yellow T-shirt, recorded on video leaving a backpack shortly before a pipe-bomb exploded two days ago near Erawan Hindu Shrine, Bangkok.",92,101,searching,1,0,1
3CESM1J3EI4QFF38UEMBPYYX0SK6W8,"#31-1 Explosion in central Bangkok: Thailand to hunt those responsible Thai authorities are searching for a man wearing a yellow T-shirt, recorded on video leaving a backpack shortly before a pipe-bomb exploded two days ago near Erawan Hindu Shrine, Bangkok.",166,174,backpack,2,4,6
3CESM1J3EI4QFF38UEMBPYYX0SK6W8,"#31-1 Explosion in central Bangkok: Thailand to hunt those responsible Thai authorities are searching for a man wearing a yellow T-shirt, recorded on video leaving a backpack shortly before a pipe-bomb exploded two days ago near Erawan Hindu Shrine, Bangkok.",192,201,pipe-bomb,2,3,5
3CESM1J3EI4QFF38UEMBPYYX0SK6W8,"#31-1 Explosion in central Bangkok: Thailand to hunt those responsible Thai authorities are searching for a man wearing a yellow T-shirt, recorded on video leaving a backpack shortly before a pipe-bomb exploded two days ago near Erawan Hindu Shrine, Bangkok.",202,210,exploded,4,4,8
3CESM1J3EI4QFF38UEMBPYYX0SK6W8,"#31-1 Explosion in central Bangkok: Thailand to hunt those responsible Thai authorities are searching for a man wearing a yellow T-shirt, recorded on video leaving a backpack shortly before a pipe-bomb exploded two days ago near Erawan Hindu Shrine, Bangkok.",229,235,Erawan,1,0,1
3CESM1J3EI4QFF38UEMBPYYX0SK6W8,"#31-1 Explosion in central Bangkok: Thailand to hunt those responsible Thai authorities are searching for a man wearing a yellow T-shirt, recorded on video leaving a backpack shortly before a pipe-bomb exploded two days ago near Erawan Hindu Shrine, Bangkok.",242,248,Shrine,0,1,1
3ACRLU860NF24RYC559DE8DP7PQEBL,#22-3 Abdul Kalam was taken to Bethany Hospital's intensive care unit and was declared dead about an hour and a half later.,31,38,Bethany,0,1,1
3ACRLU860NF24RYC559DE8DP7PQEBL,#22-3 Abdul Kalam was taken to Bethany Hospital's intensive care unit and was declared dead about an hour and a half later.,50,59,intensive,9,4,13
3ACRLU860NF24RYC559DE8DP7PQEBL,#22-3 Abdul Kalam was taken to Bethany Hospital's intensive care unit and was declared dead about an hour and a half later.,50,64,intensive care,0,1,1
3ACRLU860NF24RYC559DE8DP7PQEBL,#22-3 Abdul Kalam was taken to Bethany Hospital's intensive care unit and was declared dead about an hour and a half later.,50,69,intensive care unit,2,1,3
3ACRLU860NF24RYC559DE8DP7PQEBL,#22-3 Abdul Kalam was taken to Bethany Hospital's intensive care unit and was declared dead about an hour and a half later.,78,86,declared,4,4,8
3ACRLU860NF24RYC559DE8DP7PQEBL,"#22-5 According to doctors at Bethany Hospital, Kalam was dead by 7 p.m. but they waited for the arrival of Meghalaya chief minister V. Shanmuganathan, about an hour later, before announcing the death.",6,18,According to,0,1,1
3ACRLU860NF24RYC559DE8DP7PQEBL,"#22-5 According to doctors at Bethany Hospital, Kalam was dead by 7 p.m. but they waited for the arrival of Meghalaya chief minister V. Shanmuganathan, about an hour later, before announcing the death.",30,37,Bethany,0,1,1
3ACRLU860NF24RYC559DE8DP7PQEBL,"#22-5 According to doctors at Bethany Hospital, Kalam was dead by 7 p.m. but they waited for the arrival of Meghalaya chief minister V. Shanmuganathan, about an hour later, before announcing the death.",82,88,waited,0,1,1
3ACRLU860NF24RYC559DE8DP7PQEBL,"#22-5 According to doctors at Bethany Hospital, Kalam was dead by 7 p.m. but they waited for the arrival of Meghalaya chief minister V. Shanmuganathan, about an hour later, before announcing the death.",97,104,arrival,1,0,1
3ACRLU860NF24RYC559DE8DP7PQEBL,"#22-5 According to doctors at Bethany Hospital, Kalam was dead by 7 p.m. but they waited for the arrival of Meghalaya chief minister V. Shanmuganathan, about an hour later, before announcing the death.",108,117,Meghalaya,0,2,2
3ACRLU860NF24RYC559DE8DP7PQEBL,"#22-5 According to doctors at Bethany Hospital, Kalam was dead by 7 p.m. but they waited for the arrival of Meghalaya chief minister V. Shanmuganathan, about an hour later, before announcing the death.",108,150,Meghalaya chief minister V. Shanmuganathan,1,0,1
3ACRLU860NF24RYC559DE8DP7PQEBL,"#22-5 According to doctors at Bethany Hospital, Kalam was dead by 7 p.m. but they waited for the arrival of Meghalaya chief minister V. Shanmuganathan, about an hour later, before announcing the death.",124,132,minister,1,0,1
3ACRLU860NF24RYC559DE8DP7PQEBL,"#22-5 According to doctors at Bethany Hospital, Kalam was dead by 7 p.m. but they waited for the arrival of Meghalaya chief minister V. Shanmuganathan, about an hour later, before announcing the death.",136,150,Shanmuganathan,1,1,2
3ACRLU860NF24RYC559DE8DP7PQEBL,"#22-5 According to doctors at Bethany Hospital, Kalam was dead by 7 p.m. but they waited for the arrival of Meghalaya chief minister V. Shanmuganathan, about an hour later, before announcing the death.",180,190,announcing,2,3,5
3ACRLU860NF24RYC559DE8DP7PQEBL,"#22-6 LC Goyal, home secretary, said the Indian government will declare a seven day national mourning for Kalam.",16,30,home secretary,3,1,4
3ACRLU860NF24RYC559DE8DP7PQEBL,"#22-6 LC Goyal, home secretary, said the Indian government will declare a seven day national mourning for Kalam.",48,58,government,1,0,1
3ACRLU860NF24RYC559DE8DP7PQEBL,"#22-6 LC Goyal, home secretary, said the Indian government will declare a seven day national mourning for Kalam.",64,71,declare,0,4,4
3ACRLU860NF24RYC559DE8DP7PQEBL,"#22-6 LC Goyal, home secretary, said the Indian government will declare a seven day national mourning for Kalam.",84,101,national mourning,2,1,3
3ACRLU860NF24RYC559DE8DP7PQEBL,"#22-6 LC Goyal, home secretary, said the Indian government will declare a seven day national mourning for Kalam.",93,101,mourning,4,10,14
3ACRLU860NF24RYC559DE8DP7PQEBL,"#22-7 Home minister Rajnath Singh tweeted, ""He was an inspiration to an entire generation.""",20,33,Rajnath Singh,0,1,1
3ACRLU860NF24RYC559DE8DP7PQEBL,"#22-7 Home minister Rajnath Singh tweeted, ""He was an inspiration to an entire generation.""",34,41,tweeted,4,4,8
3ACRLU860NF24RYC559DE8DP7PQEBL,"#22-7 Home minister Rajnath Singh tweeted, ""He was an inspiration to an entire generation.""",54,65,inspiration,8,4,12
3ACRLU860NF24RYC559DE8DP7PQEBL,"#22-7 Home minister Rajnath Singh tweeted, ""He was an inspiration to an entire generation.""",72,89,entire generation,0,1,1
3ACRLU860NF24RYC559DE8DP7PQEBL,"#22-7 Home minister Rajnath Singh tweeted, ""He was an inspiration to an entire generation.""",79,89,generation,7,1,8
3ACRLU860NF24RYC559DE8DP7PQEBL,#22-8 Kalam's presidential term completed in July 2007.,14,26,presidential,0,2,2
3ACRLU860NF24RYC559DE8DP7PQEBL,#22-8 Kalam's presidential term completed in July 2007.,32,41,completed,0,1,1
3ACRLU860NF24RYC559DE8DP7PQEBL,"#23-1 U.S. presidential candidate Mark Everson challenges debate exclusion U.S. Republican Party presidential candidate Mark Everson, former commissioner of the Internal Revenue Service (IRS), filed a complaint on Monday with the Federal Election Commission (FEC) to challenge his exclusion from Thursday's first Fox News Republican Party presidential debate.",47,57,challenges,0,5,5
3ACRLU860NF24RYC559DE8DP7PQEBL,"#23-1 U.S. presidential candidate Mark Everson challenges debate exclusion U.S. Republican Party presidential candidate Mark Everson, former commissioner of the Internal Revenue Service (IRS), filed a complaint on Monday with the Federal Election Commission (FEC) to challenge his exclusion from Thursday's first Fox News Republican Party presidential debate.",58,64,debate,1,2,3
3ACRLU860NF24RYC559DE8DP7PQEBL,"#23-1 U.S. presidential candidate Mark Everson challenges debate exclusion U.S. Republican Party presidential candidate Mark Everson, former commissioner of the Internal Revenue Service (IRS), filed a complaint on Monday with the Federal Election Commission (FEC) to challenge his exclusion from Thursday's first Fox News Republican Party presidential debate.",58,74,debate exclusion,2,0,2
3ACRLU860NF24RYC559DE8DP7PQEBL,"#23-1 U.S. presidential candidate Mark Everson challenges debate exclusion U.S. Republican Party presidential candidate Mark Everson, former commissioner of the Internal Revenue Service (IRS), filed a complaint on Monday with the Federal Election Commission (FEC) to challenge his exclusion from Thursday's first Fox News Republican Party presidential debate.",65,74,exclusion,8,3,11
3ACRLU860NF24RYC559DE8DP7PQEBL,"#23-1 U.S. presidential candidate Mark Everson challenges debate exclusion U.S. Republican Party presidential candidate Mark Everson, former commissioner of the Internal Revenue Service (IRS), filed a complaint on Monday with the Federal Election Commission (FEC) to challenge his exclusion from Thursday's first Fox News Republican Party presidential debate.",97,119,presidential candidate,0,1,1
3ACRLU860NF24RYC559DE8DP7PQEBL,"#23-1 U.S. presidential candidate Mark Everson challenges debate exclusion U.S. Republican Party presidential candidate Mark Everson, former commissioner of the Internal Revenue Service (IRS), filed a complaint on Monday with the Federal Election Commission (FEC) to challenge his exclusion from Thursday's first Fox News Republican Party presidential debate.",110,119,candidate,1,0,1
3ACRLU860NF24RYC559DE8DP7PQEBL,"#23-1 U.S. presidential candidate Mark Everson challenges debate exclusion U.S. Republican Party presidential candidate Mark Everson, former commissioner of the Internal Revenue Service (IRS), filed a complaint on Monday with the Federal Election Commission (FEC) to challenge his exclusion from Thursday's first Fox News Republican Party presidential debate.",141,153,commissioner,7,2,9
3ACRLU860NF24RYC559DE8DP7PQEBL,"#23-1 U.S. presidential candidate Mark Everson challenges debate exclusion U.S. Republican Party presidential candidate Mark Everson, former commissioner of the Internal Revenue Service (IRS), filed a complaint on Monday with the Federal Election Commission (FEC) to challenge his exclusion from Thursday's first Fox News Republican Party presidential debate.",141,185,commissioner of the Internal Revenue Service,1,0,1
3ACRLU860NF24RYC559DE8DP7PQEBL,"#23-1 U.S. presidential candidate Mark Everson challenges debate exclusion U.S. Republican Party presidential candidate Mark Everson, former commissioner of the Internal Revenue Service (IRS), filed a complaint on Monday with the Federal Election Commission (FEC) to challenge his exclusion from Thursday's first Fox News Republican Party presidential debate.",161,185,Internal Revenue Service,1,0,1
3ACRLU860NF24RYC559DE8DP7PQEBL,"#23-1 U.S. presidential candidate Mark Everson challenges debate exclusion U.S. Republican Party presidential candidate Mark Everson, former commissioner of the Internal Revenue Service (IRS), filed a complaint on Monday with the Federal Election Commission (FEC) to challenge his exclusion from Thursday's first Fox News Republican Party presidential debate.",161,190,Internal Revenue Service (IRS,1,0,1
3ACRLU860NF24RYC559DE8DP7PQEBL,"#23-1 U.S. presidential candidate Mark Everson challenges debate exclusion U.S. Republican Party presidential candidate Mark Everson, former commissioner of the Internal Revenue Service (IRS), filed a complaint on Monday with the Federal Election Commission (FEC) to challenge his exclusion from Thursday's first Fox News Republican Party presidential debate.",170,177,Revenue,2,0,2
3ACRLU860NF24RYC559DE8DP7PQEBL,"#23-1 U.S. presidential candidate Mark Everson challenges debate exclusion U.S. Republican Party presidential candidate Mark Everson, former commissioner of the Internal Revenue Service (IRS), filed a complaint on Monday with the Federal Election Commission (FEC) to challenge his exclusion from Thursday's first Fox News Republican Party presidential debate.",193,198,filed,0,1,1
3ACRLU860NF24RYC559DE8DP7PQEBL,"#23-1 U.S. presidential candidate Mark Everson challenges debate exclusion U.S. Republican Party presidential candidate Mark Everson, former commissioner of the Internal Revenue Service (IRS), filed a complaint on Monday with the Federal Election Commission (FEC) to challenge his exclusion from Thursday's first Fox News Republican Party presidential debate.",201,210,complaint,2,1,3
3ACRLU860NF24RYC559DE8DP7PQEBL,"#23-1 U.S. presidential candidate Mark Everson challenges debate exclusion U.S. Republican Party presidential candidate Mark Everson, former commissioner of the Internal Revenue Service (IRS), filed a complaint on Monday with the Federal Election Commission (FEC) to challenge his exclusion from Thursday's first Fox News Republican Party presidential debate.",230,237,Federal,0,1,1
3ACRLU860NF24RYC559DE8DP7PQEBL,"#23-1 U.S. presidential candidate Mark Everson challenges debate exclusion U.S. Republican Party presidential candidate Mark Everson, former commissioner of the Internal Revenue Service (IRS), filed a complaint on Monday with the Federal Election Commission (FEC) to challenge his exclusion from Thursday's first Fox News Republican Party presidential debate.",230,257,Federal Election Commission,5,0,5
3ACRLU860NF24RYC559DE8DP7PQEBL,"#23-1 U.S. presidential candidate Mark Everson challenges debate exclusion U.S. Republican Party presidential candidate Mark Everson, former commissioner of the Internal Revenue Service (IRS), filed a complaint on Monday with the Federal Election Commission (FEC) to challenge his exclusion from Thursday's first Fox News Republican Party presidential debate.",238,246,Election,1,0,1
3ACRLU860NF24RYC559DE8DP7PQEBL,"#23-1 U.S. presidential candidate Mark Everson challenges debate exclusion U.S. Republican Party presidential candidate Mark Everson, former commissioner of the Internal Revenue Service (IRS), filed a complaint on Monday with the Federal Election Commission (FEC) to challenge his exclusion from Thursday's first Fox News Republican Party presidential debate.",238,257,Election Commission,1,0,1
3ACRLU860NF24RYC559DE8DP7PQEBL,"#23-1 U.S. presidential candidate Mark Everson challenges debate exclusion U.S. Republican Party presidential candidate Mark Everson, former commissioner of the Internal Revenue Service (IRS), filed a complaint on Monday with the Federal Election Commission (FEC) to challenge his exclusion from Thursday's first Fox News Republican Party presidential debate.",267,276,challenge,0,2,2
3ACRLU860NF24RYC559DE8DP7PQEBL,"#23-1 U.S. presidential candidate Mark Everson challenges debate exclusion U.S. Republican Party presidential candidate Mark Everson, former commissioner of the Internal Revenue Service (IRS), filed a complaint on Monday with the Federal Election Commission (FEC) to challenge his exclusion from Thursday's first Fox News Republican Party presidential debate.",267,290,challenge his exclusion,1,0,1
3ACRLU860NF24RYC559DE8DP7PQEBL,"#23-1 U.S. presidential candidate Mark Everson challenges debate exclusion U.S. Republican Party presidential candidate Mark Everson, former commissioner of the Internal Revenue Service (IRS), filed a complaint on Monday with the Federal Election Commission (FEC) to challenge his exclusion from Thursday's first Fox News Republican Party presidential debate.",281,290,exclusion,2,6,8
3ACRLU860NF24RYC559DE8DP7PQEBL,"#23-1 U.S. presidential candidate Mark Everson challenges debate exclusion U.S. Republican Party presidential candidate Mark Everson, former commissioner of the Internal Revenue Service (IRS), filed a complaint on Monday with the Federal Election Commission (FEC) to challenge his exclusion from Thursday's first Fox News Republican Party presidential debate.",322,332,Republican,1,0,1
3ACRLU860NF24RYC559DE8DP7PQEBL,"#23-1 U.S. presidential candidate Mark Everson challenges debate exclusion U.S. Republican Party presidential candidate Mark Everson, former commissioner of the Internal Revenue Service (IRS), filed a complaint on Monday with the Federal Election Commission (FEC) to challenge his exclusion from Thursday's first Fox News Republican Party presidential debate.",322,338,Republican Party,1,0,1
3ACRLU860NF24RYC559DE8DP7PQEBL,"#23-1 U.S. presidential candidate Mark Everson challenges debate exclusion U.S. Republican Party presidential candidate Mark Everson, former commissioner of the Internal Revenue Service (IRS), filed a complaint on Monday with the Federal Election Commission (FEC) to challenge his exclusion from Thursday's first Fox News Republican Party presidential debate.",339,351,presidential,2,0,2
3ACRLU860NF24RYC559DE8DP7PQEBL,"#23-1 U.S. presidential candidate Mark Everson challenges debate exclusion U.S. Republican Party presidential candidate Mark Everson, former commissioner of the Internal Revenue Service (IRS), filed a complaint on Monday with the Federal Election Commission (FEC) to challenge his exclusion from Thursday's first Fox News Republican Party presidential debate.",339,358,presidential debate,0,1,1
3ACRLU860NF24RYC559DE8DP7PQEBL,"#23-1 U.S. presidential candidate Mark Everson challenges debate exclusion U.S. Republican Party presidential candidate Mark Everson, former commissioner of the Internal Revenue Service (IRS), filed a complaint on Monday with the Federal Election Commission (FEC) to challenge his exclusion from Thursday's first Fox News Republican Party presidential debate.",352,358,debate,1,4,5
31ANT7FQN83CZL85UWQ6WPAAP9WH53,#23-6 Fox News claims Everson fails to meet the criteria it established for Thursday's two debates.,15,21,claims,1,1,2
31ANT7FQN83CZL85UWQ6WPAAP9WH53,#23-6 Fox News claims Everson fails to meet the criteria it established for Thursday's two debates.,22,29,Everson,0,1,1
31ANT7FQN83CZL85UWQ6WPAAP9WH53,#23-6 Fox News claims Everson fails to meet the criteria it established for Thursday's two debates.,39,56,meet the criteria,1,0,1
31ANT7FQN83CZL85UWQ6WPAAP9WH53,#23-6 Fox News claims Everson fails to meet the criteria it established for Thursday's two debates.,48,56,criteria,7,7,14
31ANT7FQN83CZL85UWQ6WPAAP9WH53,#23-6 Fox News claims Everson fails to meet the criteria it established for Thursday's two debates.,60,71,established,8,2,10
31ANT7FQN83CZL85UWQ6WPAAP9WH53,#23-6 Fox News claims Everson fails to meet the criteria it established for Thursday's two debates.,91,98,debates,1,3,4
31ANT7FQN83CZL85UWQ6WPAAP9WH53,"#23-7 Only seventeen candidates meet the criteria, which require a candidate ""consistently"" be included in ""recognized"" opinion polls.",11,31,seventeen candidates,1,0,1
31ANT7FQN83CZL85UWQ6WPAAP9WH53,"#23-7 Only seventeen candidates meet the criteria, which require a candidate ""consistently"" be included in ""recognized"" opinion polls.",21,31,candidates,1,1,2
31ANT7FQN83CZL85UWQ6WPAAP9WH53,"#23-7 Only seventeen candidates meet the criteria, which require a candidate ""consistently"" be included in ""recognized"" opinion polls.",41,49,criteria,3,0,3
31ANT7FQN83CZL85UWQ6WPAAP9WH53,"#23-7 Only seventeen candidates meet the criteria, which require a candidate ""consistently"" be included in ""recognized"" opinion polls.",78,90,consistently,8,9,17
31ANT7FQN83CZL85UWQ6WPAAP9WH53,"#23-7 Only seventeen candidates meet the criteria, which require a candidate ""consistently"" be included in ""recognized"" opinion polls.",107,131,recognized opinion polls,1,0,1
31ANT7FQN83CZL85UWQ6WPAAP9WH53,"#23-7 Only seventeen candidates meet the criteria, which require a candidate ""consistently"" be included in ""recognized"" opinion polls.",108,118,recognized,3,5,8
31ANT7FQN83CZL85UWQ6WPAAP9WH53,"#23-7 Only seventeen candidates meet the criteria, which require a candidate ""consistently"" be included in ""recognized"" opinion polls.",120,127,opinion,2,0,2
31ANT7FQN83CZL85UWQ6WPAAP9WH53,"#23-7 Only seventeen candidates meet the criteria, which require a candidate ""consistently"" be included in ""recognized"" opinion polls.",120,133,opinion polls,0,1,1
31ANT7FQN83CZL85UWQ6WPAAP9WH53,"#23-7 Only seventeen candidates meet the criteria, which require a candidate ""consistently"" be included in ""recognized"" opinion polls.",128,133,polls,0,2,2
31ANT7FQN83CZL85UWQ6WPAAP9WH53,#23-8 The prime-time event features the top ten candidates by average polling percentage.,10,20,prime-time,1,5,6
31ANT7FQN83CZL85UWQ6WPAAP9WH53,#23-8 The prime-time event features the top ten candidates by average polling percentage.,10,26,prime-time event,1,1,2
31ANT7FQN83CZL85UWQ6WPAAP9WH53,#23-8 The prime-time event features the top ten candidates by average polling percentage.,27,35,features,1,1,2
31ANT7FQN83CZL85UWQ6WPAAP9WH53,#23-8 The prime-time event features the top ten candidates by average polling percentage.,62,69,average,1,0,1
31ANT7FQN83CZL85UWQ6WPAAP9WH53,#23-8 The prime-time event features the top ten candidates by average polling percentage.,62,77,average polling,0,1,1
31ANT7FQN83CZL85UWQ6WPAAP9WH53,#23-8 The prime-time event features the top ten candidates by average polling percentage.,62,88,average polling percentage,2,0,2
31ANT7FQN83CZL85UWQ6WPAAP9WH53,#23-8 The prime-time event features the top ten candidates by average polling percentage.,70,77,polling,1,1,2
31ANT7FQN83CZL85UWQ6WPAAP9WH53,#23-8 The prime-time event features the top ten candidates by average polling percentage.,78,88,percentage,2,1,3
31ANT7FQN83CZL85UWQ6WPAAP9WH53,#23-9 The other seven participate in a separate debate just before the prime time event.,22,33,participate,3,1,4
31ANT7FQN83CZL85UWQ6WPAAP9WH53,#23-9 The other seven participate in a separate debate just before the prime time event.,39,47,separate,1,0,1
31ANT7FQN83CZL85UWQ6WPAAP9WH53,#23-9 The other seven participate in a separate debate just before the prime time event.,48,54,debate,1,0,1
31ANT7FQN83CZL85UWQ6WPAAP9WH53,#23-9 The other seven participate in a separate debate just before the prime time event.,71,87,prime time event,0,1,1
31ANT7FQN83CZL85UWQ6WPAAP9WH53,"#23-10 In his complaint, Everson urges the FEC to compel Fox News to include him in the second tier debate as the eighth participant.",14,23,complaint,3,1,4
31ANT7FQN83CZL85UWQ6WPAAP9WH53,"#23-10 In his complaint, Everson urges the FEC to compel Fox News to include him in the second tier debate as the eighth participant.",25,32,Everson,0,1,1
31ANT7FQN83CZL85UWQ6WPAAP9WH53,"#23-10 In his complaint, Everson urges the FEC to compel Fox News to include him in the second tier debate as the eighth participant.",33,38,urges,2,1,3
31ANT7FQN83CZL85UWQ6WPAAP9WH53,"#23-10 In his complaint, Everson urges the FEC to compel Fox News to include him in the second tier debate as the eighth participant.",50,56,compel,3,3,6
31ANT7FQN83CZL85UWQ6WPAAP9WH53,"#23-10 In his complaint, Everson urges the FEC to compel Fox News to include him in the second tier debate as the eighth participant.",57,65,Fox News,1,0,1
31ANT7FQN83CZL85UWQ6WPAAP9WH53,"#23-10 In his complaint, Everson urges the FEC to compel Fox News to include him in the second tier debate as the eighth participant.",88,99,second tier,1,0,1
31ANT7FQN83CZL85UWQ6WPAAP9WH53,"#23-10 In his complaint, Everson urges the FEC to compel Fox News to include him in the second tier debate as the eighth participant.",88,106,second tier debate,2,1,3
31ANT7FQN83CZL85UWQ6WPAAP9WH53,"#23-10 In his complaint, Everson urges the FEC to compel Fox News to include him in the second tier debate as the eighth participant.",95,99,tier,3,1,4
31ANT7FQN83CZL85UWQ6WPAAP9WH53,"#23-10 In his complaint, Everson urges the FEC to compel Fox News to include him in the second tier debate as the eighth participant.",114,132,eighth participant,1,0,1
31ANT7FQN83CZL85UWQ6WPAAP9WH53,"#23-10 In his complaint, Everson urges the FEC to compel Fox News to include him in the second tier debate as the eighth participant.",121,132,participant,4,0,4
31ANT7FQN83CZL85UWQ6WPAAP9WH53,"#23-11 Everson argues Fox News, in violation of Title 11, ""structure[d] the debates to promote or advance one candidate over another"" through a July 27 change to its criteria that replaced a pre-existing one percent polling threshold with a threshold admitting those ""consistently"" included in ""recognized"" polls.",15,21,argues,1,1,2
31ANT7FQN83CZL85UWQ6WPAAP9WH53,"#23-11 Everson argues Fox News, in violation of Title 11, ""structure[d] the debates to promote or advance one candidate over another"" through a July 27 change to its criteria that replaced a pre-existing one percent polling threshold with a threshold admitting those ""consistently"" included in ""recognized"" polls.",35,44,violation,3,1,4
31ANT7FQN83CZL85UWQ6WPAAP9WH53,"#23-11 Everson argues Fox News, in violation of Title 11, ""structure[d] the debates to promote or advance one candidate over another"" through a July 27 change to its criteria that replaced a pre-existing one percent polling threshold with a threshold admitting those ""consistently"" included in ""recognized"" polls.",59,83,structure[d] the debates,1,0,1
31ANT7FQN83CZL85UWQ6WPAAP9WH53,"#23-11 Everson argues Fox News, in violation of Title 11, ""structure[d] the debates to promote or advance one candidate over another"" through a July 27 change to its criteria that replaced a pre-existing one percent polling threshold with a threshold admitting those ""consistently"" included in ""recognized"" polls.",76,83,debates,0,1,1
31ANT7FQN83CZL85UWQ6WPAAP9WH53,"#23-11 Everson argues Fox News, in violation of Title 11, ""structure[d] the debates to promote or advance one candidate over another"" through a July 27 change to its criteria that replaced a pre-existing one percent polling threshold with a threshold admitting those ""consistently"" included in ""recognized"" polls.",110,119,candidate,2,0,2
31ANT7FQN83CZL85UWQ6WPAAP9WH53,"#23-11 Everson argues Fox News, in violation of Title 11, ""structure[d] the debates to promote or advance one candidate over another"" through a July 27 change to its criteria that replaced a pre-existing one percent polling threshold with a threshold admitting those ""consistently"" included in ""recognized"" polls.",166,174,criteria,2,0,2
31ANT7FQN83CZL85UWQ6WPAAP9WH53,"#23-11 Everson argues Fox News, in violation of Title 11, ""structure[d] the debates to promote or advance one candidate over another"" through a July 27 change to its criteria that replaced a pre-existing one percent polling threshold with a threshold admitting those ""consistently"" included in ""recognized"" polls.",166,188,criteria that replaced,0,1,1
31ANT7FQN83CZL85UWQ6WPAAP9WH53,"#23-11 Everson argues Fox News, in violation of Title 11, ""structure[d] the debates to promote or advance one candidate over another"" through a July 27 change to its criteria that replaced a pre-existing one percent polling threshold with a threshold admitting those ""consistently"" included in ""recognized"" polls.",191,203,pre-existing,7,2,9
31ANT7FQN83CZL85UWQ6WPAAP9WH53,"#23-11 Everson argues Fox News, in violation of Title 11, ""structure[d] the debates to promote or advance one candidate over another"" through a July 27 change to its criteria that replaced a pre-existing one percent polling threshold with a threshold admitting those ""consistently"" included in ""recognized"" polls.",208,223,percent polling,0,1,1
31ANT7FQN83CZL85UWQ6WPAAP9WH53,"#23-11 Everson argues Fox News, in violation of Title 11, ""structure[d] the debates to promote or advance one candidate over another"" through a July 27 change to its criteria that replaced a pre-existing one percent polling threshold with a threshold admitting those ""consistently"" included in ""recognized"" polls.",216,223,polling,1,0,1
31ANT7FQN83CZL85UWQ6WPAAP9WH53,"#23-11 Everson argues Fox News, in violation of Title 11, ""structure[d] the debates to promote or advance one candidate over another"" through a July 27 change to its criteria that replaced a pre-existing one percent polling threshold with a threshold admitting those ""consistently"" included in ""recognized"" polls.",216,233,polling threshold,1,1,2
31ANT7FQN83CZL85UWQ6WPAAP9WH53,"#23-11 Everson argues Fox News, in violation of Title 11, ""structure[d] the debates to promote or advance one candidate over another"" through a July 27 change to its criteria that replaced a pre-existing one percent polling threshold with a threshold admitting those ""consistently"" included in ""recognized"" polls.",224,233,threshold,7,4,11
31ANT7FQN83CZL85UWQ6WPAAP9WH53,"#23-11 Everson argues Fox News, in violation of Title 11, ""structure[d] the debates to promote or advance one candidate over another"" through a July 27 change to its criteria that replaced a pre-existing one percent polling threshold with a threshold admitting those ""consistently"" included in ""recognized"" polls.",241,260,threshold admitting,1,0,1
31ANT7FQN83CZL85UWQ6WPAAP9WH53,"#23-11 Everson argues Fox News, in violation of Title 11, ""structure[d] the debates to promote or advance one candidate over another"" through a July 27 change to its criteria that replaced a pre-existing one percent polling threshold with a threshold admitting those ""consistently"" included in ""recognized"" polls.",268,280,consistently,3,3,6
31ANT7FQN83CZL85UWQ6WPAAP9WH53,"#23-11 Everson argues Fox News, in violation of Title 11, ""structure[d] the debates to promote or advance one candidate over another"" through a July 27 change to its criteria that replaced a pre-existing one percent polling threshold with a threshold admitting those ""consistently"" included in ""recognized"" polls.",294,310,recognized polls,1,0,1
31ANT7FQN83CZL85UWQ6WPAAP9WH53,"#23-11 Everson argues Fox News, in violation of Title 11, ""structure[d] the debates to promote or advance one candidate over another"" through a July 27 change to its criteria that replaced a pre-existing one percent polling threshold with a threshold admitting those ""consistently"" included in ""recognized"" polls.",295,305,recognized,4,2,6
3ZQA3IO31BSN3KT9XMJKD8UUPF51OT,"#1-1 Theresa May's Brexit speech rules out single market membership UK Prime Minister Theresa May yesterday announced the government's plans for how to proceed with the United Kingdom's exit, or ""Brexit"" (British exit), from the European Union.",19,25,Brexit,4,3,7
3ZQA3IO31BSN3KT9XMJKD8UUPF51OT,"#1-1 Theresa May's Brexit speech rules out single market membership UK Prime Minister Theresa May yesterday announced the government's plans for how to proceed with the United Kingdom's exit, or ""Brexit"" (British exit), from the European Union.",33,42,rules out,0,4,4
3ZQA3IO31BSN3KT9XMJKD8UUPF51OT,"#1-1 Theresa May's Brexit speech rules out single market membership UK Prime Minister Theresa May yesterday announced the government's plans for how to proceed with the United Kingdom's exit, or ""Brexit"" (British exit), from the European Union.",43,56,single market,1,0,1
3ZQA3IO31BSN3KT9XMJKD8UUPF51OT,"#1-1 Theresa May's Brexit speech rules out single market membership UK Prime Minister Theresa May yesterday announced the government's plans for how to proceed with the United Kingdom's exit, or ""Brexit"" (British exit), from the European Union.",43,67,single market membership,0,3,3
3ZQA3IO31BSN3KT9XMJKD8UUPF51OT,"#1-1 Theresa May's Brexit speech rules out single market membership UK Prime Minister Theresa May yesterday announced the government's plans for how to proceed with the United Kingdom's exit, or ""Brexit"" (British exit), from the European Union.",50,56,market,1,0,1
3ZQA3IO31BSN3KT9XMJKD8UUPF51OT,"#1-1 Theresa May's Brexit speech rules out single market membership UK Prime Minister Theresa May yesterday announced the government's plans for how to proceed with the United Kingdom's exit, or ""Brexit"" (British exit), from the European Union.",57,67,membership,1,0,1
3ZQA3IO31BSN3KT9XMJKD8UUPF51OT,"#1-1 Theresa May's Brexit speech rules out single market membership UK Prime Minister Theresa May yesterday announced the government's plans for how to proceed with the United Kingdom's exit, or ""Brexit"" (British exit), from the European Union.",108,117,announced,2,2,4
3ZQA3IO31BSN3KT9XMJKD8UUPF51OT,"#1-1 Theresa May's Brexit speech rules out single market membership UK Prime Minister Theresa May yesterday announced the government's plans for how to proceed with the United Kingdom's exit, or ""Brexit"" (British exit), from the European Union.",122,133,governments,1,0,1
3ZQA3IO31BSN3KT9XMJKD8UUPF51OT,"#1-1 Theresa May's Brexit speech rules out single market membership UK Prime Minister Theresa May yesterday announced the government's plans for how to proceed with the United Kingdom's exit, or ""Brexit"" (British exit), from the European Union.",152,159,proceed,2,3,5
3ZQA3IO31BSN3KT9XMJKD8UUPF51OT,"#1-1 Theresa May's Brexit speech rules out single market membership UK Prime Minister Theresa May yesterday announced the government's plans for how to proceed with the United Kingdom's exit, or ""Brexit"" (British exit), from the European Union.",196,202,Brexit,2,0,2
3ZQA3IO31BSN3KT9XMJKD8UUPF51OT,#1-2 May stated the government would not seek to be a member of the European single market and would instead seek a new trade relationship.,9,15,stated,0,1,1
3ZQA3IO31BSN3KT9XMJKD8UUPF51OT,#1-2 May stated the government would not seek to be a member of the European single market and would instead seek a new trade relationship.,20,30,government,1,0,1
3ZQA3IO31BSN3KT9XMJKD8UUPF51OT,#1-2 May stated the government would not seek to be a member of the European single market and would instead seek a new trade relationship.,41,45,seek,0,1,1
3ZQA3IO31BSN3KT9XMJKD8UUPF51OT,#1-2 May stated the government would not seek to be a member of the European single market and would instead seek a new trade relationship.,77,90,single market,0,2,2
3ZQA3IO31BSN3KT9XMJKD8UUPF51OT,#1-2 May stated the government would not seek to be a member of the European single market and would instead seek a new trade relationship.,101,108,instead,0,3,3
3ZQA3IO31BSN3KT9XMJKD8UUPF51OT,#1-2 May stated the government would not seek to be a member of the European single market and would instead seek a new trade relationship.,109,113,seek,2,1,3
3ZQA3IO31BSN3KT9XMJKD8UUPF51OT,#1-2 May stated the government would not seek to be a member of the European single market and would instead seek a new trade relationship.,120,125,trade,0,1,1
3ZQA3IO31BSN3KT9XMJKD8UUPF51OT,#1-2 May stated the government would not seek to be a member of the European single market and would instead seek a new trade relationship.,120,138,trade relationship,0,2,2
3ZQA3IO31BSN3KT9XMJKD8UUPF51OT,#1-2 May stated the government would not seek to be a member of the European single market and would instead seek a new trade relationship.,126,138,relationship,2,0,2
3ZQA3IO31BSN3KT9XMJKD8UUPF51OT,#1-3 May said the UK government would seek access to the single market without retaining formal membership in it.,21,31,government,1,0,1
3ZQA3IO31BSN3KT9XMJKD8UUPF51OT,#1-3 May said the UK government would seek access to the single market without retaining formal membership in it.,38,42,seek,0,1,1
3ZQA3IO31BSN3KT9XMJKD8UUPF51OT,#1-3 May said the UK government would seek access to the single market without retaining formal membership in it.,38,49,seek access,0,1,1
3ZQA3IO31BSN3KT9XMJKD8UUPF51OT,#1-3 May said the UK government would seek access to the single market without retaining formal membership in it.,43,49,access,4,0,4
3ZQA3IO31BSN3KT9XMJKD8UUPF51OT,#1-3 May said the UK government would seek access to the single market without retaining formal membership in it.,57,70,single market,0,1,1
3ZQA3IO31BSN3KT9XMJKD8UUPF51OT,#1-3 May said the UK government would seek access to the single market without retaining formal membership in it.,79,88,retaining,10,9,19
3ZQA3IO31BSN3KT9XMJKD8UUPF51OT,#1-3 May said the UK government would seek access to the single market without retaining formal membership in it.,89,95,formal,0,1,1
3ZQA3IO31BSN3KT9XMJKD8UUPF51OT,#1-3 May said the UK government would seek access to the single market without retaining formal membership in it.,96,106,membership,1,0,1
3ZQA3IO31BSN3KT9XMJKD8UUPF51OT,"#1-4 May's speech stressed the need for friendliness between Britain and the EU but also ruled out any deal that did not allow the British government to control immigration, or which would require Britain to continue being bound by decisions of the European Court of Justice.",18,26,stressed,2,6,8
3ZQA3IO31BSN3KT9XMJKD8UUPF51OT,"#1-4 May's speech stressed the need for friendliness between Britain and the EU but also ruled out any deal that did not allow the British government to control immigration, or which would require Britain to continue being bound by decisions of the European Court of Justice.",31,52,need for friendliness,0,1,1
3ZQA3IO31BSN3KT9XMJKD8UUPF51OT,"#1-4 May's speech stressed the need for friendliness between Britain and the EU but also ruled out any deal that did not allow the British government to control immigration, or which would require Britain to continue being bound by decisions of the European Court of Justice.",40,52,friendliness,5,2,7
3ZQA3IO31BSN3KT9XMJKD8UUPF51OT,"#1-4 May's speech stressed the need for friendliness between Britain and the EU but also ruled out any deal that did not allow the British government to control immigration, or which would require Britain to continue being bound by decisions of the European Court of Justice.",77,79,EU,1,0,1
3ZQA3IO31BSN3KT9XMJKD8UUPF51OT,"#1-4 May's speech stressed the need for friendliness between Britain and the EU but also ruled out any deal that did not allow the British government to control immigration, or which would require Britain to continue being bound by decisions of the European Court of Justice.",153,172,control immigration,1,1,2
3ZQA3IO31BSN3KT9XMJKD8UUPF51OT,"#1-4 May's speech stressed the need for friendliness between Britain and the EU but also ruled out any deal that did not allow the British government to control immigration, or which would require Britain to continue being bound by decisions of the European Court of Justice.",161,172,immigration,10,6,16
3ZQA3IO31BSN3KT9XMJKD8UUPF51OT,"#1-4 May's speech stressed the need for friendliness between Britain and the EU but also ruled out any deal that did not allow the British government to control immigration, or which would require Britain to continue being bound by decisions of the European Court of Justice.",189,196,require,1,0,1
3ZQA3IO31BSN3KT9XMJKD8UUPF51OT,"#1-4 May's speech stressed the need for friendliness between Britain and the EU but also ruled out any deal that did not allow the British government to control immigration, or which would require Britain to continue being bound by decisions of the European Court of Justice.",223,228,bound,3,6,9
3ZQA3IO31BSN3KT9XMJKD8UUPF51OT,"#1-4 May's speech stressed the need for friendliness between Britain and the EU but also ruled out any deal that did not allow the British government to control immigration, or which would require Britain to continue being bound by decisions of the European Court of Justice.",223,241,bound by decisions,0,2,2
3ZQA3IO31BSN3KT9XMJKD8UUPF51OT,"#1-4 May's speech stressed the need for friendliness between Britain and the EU but also ruled out any deal that did not allow the British government to control immigration, or which would require Britain to continue being bound by decisions of the European Court of Justice.",232,241,decisions,3,1,4
3ZQA3IO31BSN3KT9XMJKD8UUPF51OT,"#1-4 May's speech stressed the need for friendliness between Britain and the EU but also ruled out any deal that did not allow the British government to control immigration, or which would require Britain to continue being bound by decisions of the European Court of Justice.",249,257,European,1,0,1
3ZQA3IO31BSN3KT9XMJKD8UUPF51OT,"#1-4 May's speech stressed the need for friendliness between Britain and the EU but also ruled out any deal that did not allow the British government to control immigration, or which would require Britain to continue being bound by decisions of the European Court of Justice.",249,274,European Court of Justice,1,0,1
3ZQA3IO31BSN3KT9XMJKD8UUPF51OT,"#1-4 May's speech stressed the need for friendliness between Britain and the EU but also ruled out any deal that did not allow the British government to control immigration, or which would require Britain to continue being bound by decisions of the European Court of Justice.",258,263,Court,1,0,1
3ZQA3IO31BSN3KT9XMJKD8UUPF51OT,"#1-4 May's speech stressed the need for friendliness between Britain and the EU but also ruled out any deal that did not allow the British government to control immigration, or which would require Britain to continue being bound by decisions of the European Court of Justice.",267,274,Justice,2,0,2
3WRKFXQBOB8AX4T9BGDO7Y9IKRFIYD,"#29-15 In addition to preventing Bush from gaining the Republican nomination, Martin intends to focus his campaign on protecting the prestige of the New Hampshire Primary and Iowa Caucus, defending the economic legacy of Founding Father Alexander Hamilton, combating political correctness, emphasizing U.S. relations with Greece, and fighting political corruption.",22,32,preventing,1,2,3
3WRKFXQBOB8AX4T9BGDO7Y9IKRFIYD,"#29-15 In addition to preventing Bush from gaining the Republican nomination, Martin intends to focus his campaign on protecting the prestige of the New Hampshire Primary and Iowa Caucus, defending the economic legacy of Founding Father Alexander Hamilton, combating political correctness, emphasizing U.S. relations with Greece, and fighting political corruption.",43,50,gaining,0,1,1
3WRKFXQBOB8AX4T9BGDO7Y9IKRFIYD,"#29-15 In addition to preventing Bush from gaining the Republican nomination, Martin intends to focus his campaign on protecting the prestige of the New Hampshire Primary and Iowa Caucus, defending the economic legacy of Founding Father Alexander Hamilton, combating political correctness, emphasizing U.S. relations with Greece, and fighting political corruption.",55,76,Republican nomination,3,0,3
3WRKFXQBOB8AX4T9BGDO7Y9IKRFIYD,"#29-15 In addition to preventing Bush from gaining the Republican nomination, Martin intends to focus his campaign on protecting the prestige of the New Hampshire Primary and Iowa Caucus, defending the economic legacy of Founding Father Alexander Hamilton, combating political correctness, emphasizing U.S. relations with Greece, and fighting political corruption.",66,76,nomination,10,3,13
3WRKFXQBOB8AX4T9BGDO7Y9IKRFIYD,"#29-15 In addition to preventing Bush from gaining the Republican nomination, Martin intends to focus his campaign on protecting the prestige of the New Hampshire Primary and Iowa Caucus, defending the economic legacy of Founding Father Alexander Hamilton, combating political correctness, emphasizing U.S. relations with Greece, and fighting political corruption.",85,92,intends,0,3,3
3WRKFXQBOB8AX4T9BGDO7Y9IKRFIYD,"#29-15 In addition to preventing Bush from gaining the Republican nomination, Martin intends to focus his campaign on protecting the prestige of the New Hampshire Primary and Iowa Caucus, defending the economic legacy of Founding Father Alexander Hamilton, combating political correctness, emphasizing U.S. relations with Greece, and fighting political corruption.",96,101,focus,2,1,3
3WRKFXQBOB8AX4T9BGDO7Y9IKRFIYD,"#29-15 In addition to preventing Bush from gaining the Republican nomination, Martin intends to focus his campaign on protecting the prestige of the New Hampshire Primary and Iowa Caucus, defending the economic legacy of Founding Father Alexander Hamilton, combating political correctness, emphasizing U.S. relations with Greece, and fighting political corruption.",106,114,campaign,4,4,8
3WRKFXQBOB8AX4T9BGDO7Y9IKRFIYD,"#29-15 In addition to preventing Bush from gaining the Republican nomination, Martin intends to focus his campaign on protecting the prestige of the New Hampshire Primary and Iowa Caucus, defending the economic legacy of Founding Father Alexander Hamilton, combating political correctness, emphasizing U.S. relations with Greece, and fighting political corruption.",118,128,protecting,1,0,1
3WRKFXQBOB8AX4T9BGDO7Y9IKRFIYD,"#29-15 In addition to preventing Bush from gaining the Republican nomination, Martin intends to focus his campaign on protecting the prestige of the New Hampshire Primary and Iowa Caucus, defending the economic legacy of Founding Father Alexander Hamilton, combating political correctness, emphasizing U.S. relations with Greece, and fighting political corruption.",133,141,prestige,9,7,16
3WRKFXQBOB8AX4T9BGDO7Y9IKRFIYD,"#29-15 In addition to preventing Bush from gaining the Republican nomination, Martin intends to focus his campaign on protecting the prestige of the New Hampshire Primary and Iowa Caucus, defending the economic legacy of Founding Father Alexander Hamilton, combating political correctness, emphasizing U.S. relations with Greece, and fighting political corruption.",153,162,Hampshire,0,1,1
3WRKFXQBOB8AX4T9BGDO7Y9IKRFIYD,"#29-15 In addition to preventing Bush from gaining the Republican nomination, Martin intends to focus his campaign on protecting the prestige of the New Hampshire Primary and Iowa Caucus, defending the economic legacy of Founding Father Alexander Hamilton, combating political correctness, emphasizing U.S. relations with Greece, and fighting political corruption.",163,170,Primary,2,0,2
3WRKFXQBOB8AX4T9BGDO7Y9IKRFIYD,"#29-15 In addition to preventing Bush from gaining the Republican nomination, Martin intends to focus his campaign on protecting the prestige of the New Hampshire Primary and Iowa Caucus, defending the economic legacy of Founding Father Alexander Hamilton, combating political correctness, emphasizing U.S. relations with Greece, and fighting political corruption.",180,186,Caucus,4,2,6
3WRKFXQBOB8AX4T9BGDO7Y9IKRFIYD,"#29-15 In addition to preventing Bush from gaining the Republican nomination, Martin intends to focus his campaign on protecting the prestige of the New Hampshire Primary and Iowa Caucus, defending the economic legacy of Founding Father Alexander Hamilton, combating political correctness, emphasizing U.S. relations with Greece, and fighting political corruption.",188,217,defending the economic legacy,1,0,1
3WRKFXQBOB8AX4T9BGDO7Y9IKRFIYD,"#29-15 In addition to preventing Bush from gaining the Republican nomination, Martin intends to focus his campaign on protecting the prestige of the New Hampshire Primary and Iowa Caucus, defending the economic legacy of Founding Father Alexander Hamilton, combating political correctness, emphasizing U.S. relations with Greece, and fighting political corruption.",202,217,economic legacy,2,1,3
3WRKFXQBOB8AX4T9BGDO7Y9IKRFIYD,"#29-15 In addition to preventing Bush from gaining the Republican nomination, Martin intends to focus his campaign on protecting the prestige of the New Hampshire Primary and Iowa Caucus, defending the economic legacy of Founding Father Alexander Hamilton, combating political correctness, emphasizing U.S. relations with Greece, and fighting political corruption.",211,217,legacy,3,5,8
3WRKFXQBOB8AX4T9BGDO7Y9IKRFIYD,"#29-15 In addition to preventing Bush from gaining the Republican nomination, Martin intends to focus his campaign on protecting the prestige of the New Hampshire Primary and Iowa Caucus, defending the economic legacy of Founding Father Alexander Hamilton, combating political correctness, emphasizing U.S. relations with Greece, and fighting political corruption.",237,255,Alexander Hamilton,0,1,1
3WRKFXQBOB8AX4T9BGDO7Y9IKRFIYD,"#29-15 In addition to preventing Bush from gaining the Republican nomination, Martin intends to focus his campaign on protecting the prestige of the New Hampshire Primary and Iowa Caucus, defending the economic legacy of Founding Father Alexander Hamilton, combating political correctness, emphasizing U.S. relations with Greece, and fighting political corruption.",257,266,combating,2,6,8
3WRKFXQBOB8AX4T9BGDO7Y9IKRFIYD,"#29-15 In addition to preventing Bush from gaining the Republican nomination, Martin intends to focus his campaign on protecting the prestige of the New Hampshire Primary and Iowa Caucus, defending the economic legacy of Founding Father Alexander Hamilton, combating political correctness, emphasizing U.S. relations with Greece, and fighting political corruption.",257,288,combating political correctness,1,1,2
3WRKFXQBOB8AX4T9BGDO7Y9IKRFIYD,"#29-15 In addition to preventing Bush from gaining the Republican nomination, Martin intends to focus his campaign on protecting the prestige of the New Hampshire Primary and Iowa Caucus, defending the economic legacy of Founding Father Alexander Hamilton, combating political correctness, emphasizing U.S. relations with Greece, and fighting political corruption.",267,288,political correctness,1,0,1
3WRKFXQBOB8AX4T9BGDO7Y9IKRFIYD,"#29-15 In addition to preventing Bush from gaining the Republican nomination, Martin intends to focus his campaign on protecting the prestige of the New Hampshire Primary and Iowa Caucus, defending the economic legacy of Founding Father Alexander Hamilton, combating political correctness, emphasizing U.S. relations with Greece, and fighting political corruption.",277,288,correctness,1,0,1
3WRKFXQBOB8AX4T9BGDO7Y9IKRFIYD,"#29-15 In addition to preventing Bush from gaining the Republican nomination, Martin intends to focus his campaign on protecting the prestige of the New Hampshire Primary and Iowa Caucus, defending the economic legacy of Founding Father Alexander Hamilton, combating political correctness, emphasizing U.S. relations with Greece, and fighting political corruption.",290,301,emphasizing,7,5,12
3WRKFXQBOB8AX4T9BGDO7Y9IKRFIYD,"#29-15 In addition to preventing Bush from gaining the Republican nomination, Martin intends to focus his campaign on protecting the prestige of the New Hampshire Primary and Iowa Caucus, defending the economic legacy of Founding Father Alexander Hamilton, combating political correctness, emphasizing U.S. relations with Greece, and fighting political corruption.",307,316,relations,1,0,1
3WRKFXQBOB8AX4T9BGDO7Y9IKRFIYD,"#29-15 In addition to preventing Bush from gaining the Republican nomination, Martin intends to focus his campaign on protecting the prestige of the New Hampshire Primary and Iowa Caucus, defending the economic legacy of Founding Father Alexander Hamilton, combating political correctness, emphasizing U.S. relations with Greece, and fighting political corruption.",343,352,political,1,0,1
3WRKFXQBOB8AX4T9BGDO7Y9IKRFIYD,"#29-15 In addition to preventing Bush from gaining the Republican nomination, Martin intends to focus his campaign on protecting the prestige of the New Hampshire Primary and Iowa Caucus, defending the economic legacy of Founding Father Alexander Hamilton, combating political correctness, emphasizing U.S. relations with Greece, and fighting political corruption.",343,363,political corruption,0,2,2
3WRKFXQBOB8AX4T9BGDO7Y9IKRFIYD,"#29-15 In addition to preventing Bush from gaining the Republican nomination, Martin intends to focus his campaign on protecting the prestige of the New Hampshire Primary and Iowa Caucus, defending the economic legacy of Founding Father Alexander Hamilton, combating political correctness, emphasizing U.S. relations with Greece, and fighting political corruption.",353,363,corruption,4,4,8
3WRKFXQBOB8AX4T9BGDO7Y9IKRFIYD,#29-16 Martin filed paperwork with the Federal Election Commission last month to run for president in 2016 officially.,14,29,filed paperwork,0,1,1
3WRKFXQBOB8AX4T9BGDO7Y9IKRFIYD,#29-16 Martin filed paperwork with the Federal Election Commission last month to run for president in 2016 officially.,20,29,paperwork,0,4,4
3WRKFXQBOB8AX4T9BGDO7Y9IKRFIYD,#29-16 Martin filed paperwork with the Federal Election Commission last month to run for president in 2016 officially.,39,46,Federal,1,0,1
3WRKFXQBOB8AX4T9BGDO7Y9IKRFIYD,#29-16 Martin filed paperwork with the Federal Election Commission last month to run for president in 2016 officially.,81,88,run for,1,0,1
3WRKFXQBOB8AX4T9BGDO7Y9IKRFIYD,#29-16 Martin filed paperwork with the Federal Election Commission last month to run for president in 2016 officially.,107,117,officially,0,1,1
3WRKFXQBOB8AX4T9BGDO7Y9IKRFIYD,#29-17 He joins 139 other Republican Party presidential candidates who have done likewise.,43,55,presidential,1,2,3
3WRKFXQBOB8AX4T9BGDO7Y9IKRFIYD,#29-17 He joins 139 other Republican Party presidential candidates who have done likewise.,43,66,presidential candidates,1,0,1
3WRKFXQBOB8AX4T9BGDO7Y9IKRFIYD,#29-17 He joins 139 other Republican Party presidential candidates who have done likewise.,81,89,likewise,2,4,6
3WRKFXQBOB8AX4T9BGDO7Y9IKRFIYD,"#3-1 Rape-accused Russian political artist Pyotr Pavlensky to seek asylum in France On Monday, controversial Russian political artist Pyotr Pavlensky, currently in Paris, informed media that he and his family are to seek political asylum in France.",5,17,Rape-accused,2,2,4
3WRKFXQBOB8AX4T9BGDO7Y9IKRFIYD,"#3-1 Rape-accused Russian political artist Pyotr Pavlensky to seek asylum in France On Monday, controversial Russian political artist Pyotr Pavlensky, currently in Paris, informed media that he and his family are to seek political asylum in France.",43,58,Pyotr Pavlensky,1,1,2
3WRKFXQBOB8AX4T9BGDO7Y9IKRFIYD,"#3-1 Rape-accused Russian political artist Pyotr Pavlensky to seek asylum in France On Monday, controversial Russian political artist Pyotr Pavlensky, currently in Paris, informed media that he and his family are to seek political asylum in France.",62,73,seek asylum,0,1,1
3WRKFXQBOB8AX4T9BGDO7Y9IKRFIYD,"#3-1 Rape-accused Russian political artist Pyotr Pavlensky to seek asylum in France On Monday, controversial Russian political artist Pyotr Pavlensky, currently in Paris, informed media that he and his family are to seek political asylum in France.",67,73,asylum,5,5,10
3WRKFXQBOB8AX4T9BGDO7Y9IKRFIYD,"#3-1 Rape-accused Russian political artist Pyotr Pavlensky to seek asylum in France On Monday, controversial Russian political artist Pyotr Pavlensky, currently in Paris, informed media that he and his family are to seek political asylum in France.",95,108,controversial,10,8,18
3WRKFXQBOB8AX4T9BGDO7Y9IKRFIYD,"#3-1 Rape-accused Russian political artist Pyotr Pavlensky to seek asylum in France On Monday, controversial Russian political artist Pyotr Pavlensky, currently in Paris, informed media that he and his family are to seek political asylum in France.",117,126,political,1,0,1
3WRKFXQBOB8AX4T9BGDO7Y9IKRFIYD,"#3-1 Rape-accused Russian political artist Pyotr Pavlensky to seek asylum in France On Monday, controversial Russian political artist Pyotr Pavlensky, currently in Paris, informed media that he and his family are to seek political asylum in France.",221,237,political asylum,0,2,2
3WRKFXQBOB8AX4T9BGDO7Y9IKRFIYD,"#3-1 Rape-accused Russian political artist Pyotr Pavlensky to seek asylum in France On Monday, controversial Russian political artist Pyotr Pavlensky, currently in Paris, informed media that he and his family are to seek political asylum in France.",231,237,asylum,6,2,8
3WRKFXQBOB8AX4T9BGDO7Y9IKRFIYD,#3-2 Pavlensky said he and his partner Oksana Shalygina were falsely accused under Section 132 of the Criminal law for rape.,39,55,Oksana Shalygina,0,1,1
3WRKFXQBOB8AX4T9BGDO7Y9IKRFIYD,#3-2 Pavlensky said he and his partner Oksana Shalygina were falsely accused under Section 132 of the Criminal law for rape.,46,55,Shalygina,1,0,1
3WRKFXQBOB8AX4T9BGDO7Y9IKRFIYD,#3-2 Pavlensky said he and his partner Oksana Shalygina were falsely accused under Section 132 of the Criminal law for rape.,61,68,falsely,1,1,2
3WRKFXQBOB8AX4T9BGDO7Y9IKRFIYD,#3-2 Pavlensky said he and his partner Oksana Shalygina were falsely accused under Section 132 of the Criminal law for rape.,61,76,falsely accused,1,1,2
3WRKFXQBOB8AX4T9BGDO7Y9IKRFIYD,#3-2 Pavlensky said he and his partner Oksana Shalygina were falsely accused under Section 132 of the Criminal law for rape.,69,76,accused,1,3,4
3WRKFXQBOB8AX4T9BGDO7Y9IKRFIYD,#3-2 Pavlensky said he and his partner Oksana Shalygina were falsely accused under Section 132 of the Criminal law for rape.,102,110,Criminal,1,0,1
3WRKFXQBOB8AX4T9BGDO7Y9IKRFIYD,#3-2 Pavlensky said he and his partner Oksana Shalygina were falsely accused under Section 132 of the Criminal law for rape.,102,114,Criminal law,0,1,1
3WRKFXQBOB8AX4T9BGDO7Y9IKRFIYD,#3-2 Pavlensky said he and his partner Oksana Shalygina were falsely accused under Section 132 of the Criminal law for rape.,119,123,rape,1,0,1
3VQTAXTYN3MJTNVYV5OIIQZSTDKBUZ,"#15-16 Russian Presidential spokesperson Dmitry Peskov echoed Putin, saying the troops are ""a threat.",15,27,Presidential,1,0,1
3VQTAXTYN3MJTNVYV5OIIQZSTDKBUZ,"#15-16 Russian Presidential spokesperson Dmitry Peskov echoed Putin, saying the troops are ""a threat.",15,40,Presidential spokesperson,1,0,1
3VQTAXTYN3MJTNVYV5OIIQZSTDKBUZ,"#15-16 Russian Presidential spokesperson Dmitry Peskov echoed Putin, saying the troops are ""a threat.",28,40,spokesperson,6,7,13
3VQTAXTYN3MJTNVYV5OIIQZSTDKBUZ,"#15-16 Russian Presidential spokesperson Dmitry Peskov echoed Putin, saying the troops are ""a threat.",41,47,Dmitry,0,1,1
3VQTAXTYN3MJTNVYV5OIIQZSTDKBUZ,"#15-16 Russian Presidential spokesperson Dmitry Peskov echoed Putin, saying the troops are ""a threat.",41,54,Dmitry Peskov,1,1,2
3VQTAXTYN3MJTNVYV5OIIQZSTDKBUZ,"#15-16 Russian Presidential spokesperson Dmitry Peskov echoed Putin, saying the troops are ""a threat.",55,61,echoed,4,6,10
3VQTAXTYN3MJTNVYV5OIIQZSTDKBUZ,"#15-16 Russian Presidential spokesperson Dmitry Peskov echoed Putin, saying the troops are ""a threat.",55,67,echoed Putin,0,1,1
3VQTAXTYN3MJTNVYV5OIIQZSTDKBUZ,"#15-16 Russian Presidential spokesperson Dmitry Peskov echoed Putin, saying the troops are ""a threat.",80,86,troops,0,3,3
3VQTAXTYN3MJTNVYV5OIIQZSTDKBUZ,"#15-16 Russian Presidential spokesperson Dmitry Peskov echoed Putin, saying the troops are ""a threat.",94,100,threat,2,1,3
3VQTAXTYN3MJTNVYV5OIIQZSTDKBUZ,"#15-17 These actions threaten our interests, our security.",21,29,threaten,4,8,12
3VQTAXTYN3MJTNVYV5OIIQZSTDKBUZ,"#15-17 These actions threaten our interests, our security.",21,43,threaten our interests,1,0,1
3VQTAXTYN3MJTNVYV5OIIQZSTDKBUZ,#15-18 Especially as it concerns a third party building up its military presence near our borders.,7,17,Especially,3,0,3
3VQTAXTYN3MJTNVYV5OIIQZSTDKBUZ,#15-18 Especially as it concerns a third party building up its military presence near our borders.,24,32,concerns,1,3,4
3VQTAXTYN3MJTNVYV5OIIQZSTDKBUZ,#15-18 Especially as it concerns a third party building up its military presence near our borders.,35,46,third party,1,0,1
3VQTAXTYN3MJTNVYV5OIIQZSTDKBUZ,#15-18 Especially as it concerns a third party building up its military presence near our borders.,63,71,military,1,0,1
3VQTAXTYN3MJTNVYV5OIIQZSTDKBUZ,#15-18 Especially as it concerns a third party building up its military presence near our borders.,63,80,military presence,2,0,2
3VQTAXTYN3MJTNVYV5OIIQZSTDKBUZ,#15-18 Especially as it concerns a third party building up its military presence near our borders.,72,80,presence,3,1,4
3VQTAXTYN3MJTNVYV5OIIQZSTDKBUZ,#15-18 Especially as it concerns a third party building up its military presence near our borders.,90,97,borders,0,1,1
3VQTAXTYN3MJTNVYV5OIIQZSTDKBUZ,"#15-19 It's [the US], not even a European state.""",33,47,European state,1,0,1
3VQTAXTYN3MJTNVYV5OIIQZSTDKBUZ,#15-20 Ties between Russia and the US are strained.,7,11,Ties,0,2,2
3VQTAXTYN3MJTNVYV5OIIQZSTDKBUZ,#15-20 Ties between Russia and the US are strained.,42,50,strained,4,10,14
3VQTAXTYN3MJTNVYV5OIIQZSTDKBUZ,"#15-21 Last month the US expelled 35 Russian diplomats accused of espionage, and sanctioned Russian intelligence agencies.",25,33,expelled,2,6,8
3VQTAXTYN3MJTNVYV5OIIQZSTDKBUZ,"#15-21 Last month the US expelled 35 Russian diplomats accused of espionage, and sanctioned Russian intelligence agencies.",45,54,diplomats,4,4,8
3VQTAXTYN3MJTNVYV5OIIQZSTDKBUZ,"#15-21 Last month the US expelled 35 Russian diplomats accused of espionage, and sanctioned Russian intelligence agencies.",45,62,diplomats accused,2,0,2
3VQTAXTYN3MJTNVYV5OIIQZSTDKBUZ,"#15-21 Last month the US expelled 35 Russian diplomats accused of espionage, and sanctioned Russian intelligence agencies.",55,62,accused,2,1,3
3VQTAXTYN3MJTNVYV5OIIQZSTDKBUZ,"#15-21 Last month the US expelled 35 Russian diplomats accused of espionage, and sanctioned Russian intelligence agencies.",66,75,espionage,10,10,20
3VQTAXTYN3MJTNVYV5OIIQZSTDKBUZ,"#15-21 Last month the US expelled 35 Russian diplomats accused of espionage, and sanctioned Russian intelligence agencies.",81,91,sanctioned,9,5,14
3VQTAXTYN3MJTNVYV5OIIQZSTDKBUZ,"#15-21 Last month the US expelled 35 Russian diplomats accused of espionage, and sanctioned Russian intelligence agencies.",100,112,intelligence,4,0,4
3VQTAXTYN3MJTNVYV5OIIQZSTDKBUZ,"#15-21 Last month the US expelled 35 Russian diplomats accused of espionage, and sanctioned Russian intelligence agencies.",100,121,intelligence agencies,1,1,2
3VQTAXTYN3MJTNVYV5OIIQZSTDKBUZ,#15-22 This was in response to a CIA report issued two weeks earlier that concluded the Russian government hacked servers belonging to the U.S. Republican and Democratic parties.,19,27,response,0,1,1
3VQTAXTYN3MJTNVYV5OIIQZSTDKBUZ,#15-22 This was in response to a CIA report issued two weeks earlier that concluded the Russian government hacked servers belonging to the U.S. Republican and Democratic parties.,107,113,hacked,5,6,11
3VQTAXTYN3MJTNVYV5OIIQZSTDKBUZ,#15-22 This was in response to a CIA report issued two weeks earlier that concluded the Russian government hacked servers belonging to the U.S. Republican and Democratic parties.,107,121,hacked servers,0,1,1
3VQTAXTYN3MJTNVYV5OIIQZSTDKBUZ,#15-22 This was in response to a CIA report issued two weeks earlier that concluded the Russian government hacked servers belonging to the U.S. Republican and Democratic parties.,114,121,servers,1,0,1
3VQTAXTYN3MJTNVYV5OIIQZSTDKBUZ,#15-22 This was in response to a CIA report issued two weeks earlier that concluded the Russian government hacked servers belonging to the U.S. Republican and Democratic parties.,144,154,Republican,1,1,2
3VQTAXTYN3MJTNVYV5OIIQZSTDKBUZ,#15-22 This was in response to a CIA report issued two weeks earlier that concluded the Russian government hacked servers belonging to the U.S. Republican and Democratic parties.,159,177,Democratic parties,0,1,1
3VQTAXTYN3MJTNVYV5OIIQZSTDKBUZ,#15-23 The CIA report said this was to turn the 2016 presidential election toward president-elect Donald Trump.,53,65,presidential,0,1,1
3VQTAXTYN3MJTNVYV5OIIQZSTDKBUZ,#15-23 The CIA report said this was to turn the 2016 presidential election toward president-elect Donald Trump.,82,97,president-elect,2,0,2
3VQTAXTYN3MJTNVYV5OIIQZSTDKBUZ,#15-23 The CIA report said this was to turn the 2016 presidential election toward president-elect Donald Trump.,82,104,president-elect Donald,0,1,1
3VQTAXTYN3MJTNVYV5OIIQZSTDKBUZ,"#15-24 Since Szydło took office in 2015, Poland has also suffered a decline in relations with Russia.",13,19,Szydło,1,2,3
3VQTAXTYN3MJTNVYV5OIIQZSTDKBUZ,"#15-24 Since Szydło took office in 2015, Poland has also suffered a decline in relations with Russia.",41,47,Poland,0,1,1
3VQTAXTYN3MJTNVYV5OIIQZSTDKBUZ,"#15-24 Since Szydło took office in 2015, Poland has also suffered a decline in relations with Russia.",57,65,suffered,5,3,8
3VQTAXTYN3MJTNVYV5OIIQZSTDKBUZ,"#15-24 Since Szydło took office in 2015, Poland has also suffered a decline in relations with Russia.",57,75,suffered a decline,0,1,1
3VQTAXTYN3MJTNVYV5OIIQZSTDKBUZ,"#15-24 Since Szydło took office in 2015, Poland has also suffered a decline in relations with Russia.",68,75,decline,4,4,8
36AZSFEYZ41J62KY0VYNEC1B7KTBVO,"#17-9 [...] Of course, the opinion’s showy profundities are often profoundly incoherent.""",27,36,opinion’s,1,0,1
36AZSFEYZ41J62KY0VYNEC1B7KTBVO,"#17-9 [...] Of course, the opinion’s showy profundities are often profoundly incoherent.""",37,42,showy,0,2,2
36AZSFEYZ41J62KY0VYNEC1B7KTBVO,"#17-9 [...] Of course, the opinion’s showy profundities are often profoundly incoherent.""",37,55,showy profundities,1,0,1
36AZSFEYZ41J62KY0VYNEC1B7KTBVO,"#17-9 [...] Of course, the opinion’s showy profundities are often profoundly incoherent.""",43,55,profundities,10,10,20
36AZSFEYZ41J62KY0VYNEC1B7KTBVO,"#17-9 [...] Of course, the opinion’s showy profundities are often profoundly incoherent.""",66,76,profoundly,1,3,4
36AZSFEYZ41J62KY0VYNEC1B7KTBVO,"#17-9 [...] Of course, the opinion’s showy profundities are often profoundly incoherent.""",66,87,profoundly incoherent,10,3,13
36AZSFEYZ41J62KY0VYNEC1B7KTBVO,"#17-9 [...] Of course, the opinion’s showy profundities are often profoundly incoherent.""",77,87,incoherent,5,8,13
36AZSFEYZ41J62KY0VYNEC1B7KTBVO,"#17-10 When the decision was made, police allowed people outside the court to wave the rainbow flag on the court plaza.",16,24,decision,1,0,1
36AZSFEYZ41J62KY0VYNEC1B7KTBVO,"#17-10 When the decision was made, police allowed people outside the court to wave the rainbow flag on the court plaza.",78,82,wave,0,1,1
36AZSFEYZ41J62KY0VYNEC1B7KTBVO,"#17-10 When the decision was made, police allowed people outside the court to wave the rainbow flag on the court plaza.",87,99,rainbow flag,0,1,1
36AZSFEYZ41J62KY0VYNEC1B7KTBVO,"#17-10 When the decision was made, police allowed people outside the court to wave the rainbow flag on the court plaza.",107,112,court,0,1,1
36AZSFEYZ41J62KY0VYNEC1B7KTBVO,"#17-10 When the decision was made, police allowed people outside the court to wave the rainbow flag on the court plaza.",107,118,court plaza,1,0,1
36AZSFEYZ41J62KY0VYNEC1B7KTBVO,"#17-10 When the decision was made, police allowed people outside the court to wave the rainbow flag on the court plaza.",113,118,plaza,1,0,1
36AZSFEYZ41J62KY0VYNEC1B7KTBVO,"#17-11 Demonstrators outside the court chanted ""Love has won"".",7,20,Demonstrators,10,4,14
36AZSFEYZ41J62KY0VYNEC1B7KTBVO,"#17-11 Demonstrators outside the court chanted ""Love has won"".",33,38,court,0,1,1
36AZSFEYZ41J62KY0VYNEC1B7KTBVO,"#17-11 Demonstrators outside the court chanted ""Love has won"".",39,46,chanted,1,5,6
36AZSFEYZ41J62KY0VYNEC1B7KTBVO,#17-12 This decision made the United States the 21st country to legalise same-sex marriage.,64,72,legalise,10,4,14
36AZSFEYZ41J62KY0VYNEC1B7KTBVO,#17-12 This decision made the United States the 21st country to legalise same-sex marriage.,64,81,legalise same-sex,1,0,1
36AZSFEYZ41J62KY0VYNEC1B7KTBVO,#17-12 This decision made the United States the 21st country to legalise same-sex marriage.,73,90,same-sex marriage,2,0,2
36AZSFEYZ41J62KY0VYNEC1B7KTBVO,#17-12 This decision made the United States the 21st country to legalise same-sex marriage.,82,90,marriage,1,0,1
36AZSFEYZ41J62KY0VYNEC1B7KTBVO,"#17-13 President Barack Obama responded to the decision: ""Today we can say, in no uncertain terms, that we have made our union a little more perfect.""",30,39,responded,1,2,3
36AZSFEYZ41J62KY0VYNEC1B7KTBVO,"#17-13 President Barack Obama responded to the decision: ""Today we can say, in no uncertain terms, that we have made our union a little more perfect.""",47,55,decision,1,0,1
36AZSFEYZ41J62KY0VYNEC1B7KTBVO,"#17-13 President Barack Obama responded to the decision: ""Today we can say, in no uncertain terms, that we have made our union a little more perfect.""",82,91,uncertain,3,2,5
36AZSFEYZ41J62KY0VYNEC1B7KTBVO,"#17-13 President Barack Obama responded to the decision: ""Today we can say, in no uncertain terms, that we have made our union a little more perfect.""",82,97,uncertain terms,0,1,1
36AZSFEYZ41J62KY0VYNEC1B7KTBVO,"#17-13 President Barack Obama responded to the decision: ""Today we can say, in no uncertain terms, that we have made our union a little more perfect.""",121,126,union,1,0,1
36AZSFEYZ41J62KY0VYNEC1B7KTBVO,"#17-14 After this decision, Facebook introduced a new tool to add rainbow coloring to one's profile picture to celebrate this victory.",37,47,introduced,0,1,1
36AZSFEYZ41J62KY0VYNEC1B7KTBVO,"#17-14 After this decision, Facebook introduced a new tool to add rainbow coloring to one's profile picture to celebrate this victory.",92,99,profile,1,1,2
36AZSFEYZ41J62KY0VYNEC1B7KTBVO,"#17-14 After this decision, Facebook introduced a new tool to add rainbow coloring to one's profile picture to celebrate this victory.",92,107,profile picture,1,0,1
36AZSFEYZ41J62KY0VYNEC1B7KTBVO,"#17-14 After this decision, Facebook introduced a new tool to add rainbow coloring to one's profile picture to celebrate this victory.",126,133,victory,2,0,2
36AZSFEYZ41J62KY0VYNEC1B7KTBVO,"#17-15 Mark Zuckerberg posted on Facebook ""I'm so happy for all of my friends and everyone in our community who can finally celebrate their love and be recognized as equal couples under the law"".",12,22,Zuckerberg,1,0,1
36AZSFEYZ41J62KY0VYNEC1B7KTBVO,"#17-15 Mark Zuckerberg posted on Facebook ""I'm so happy for all of my friends and everyone in our community who can finally celebrate their love and be recognized as equal couples under the law"".",98,107,community,4,1,5
36AZSFEYZ41J62KY0VYNEC1B7KTBVO,"#17-15 Mark Zuckerberg posted on Facebook ""I'm so happy for all of my friends and everyone in our community who can finally celebrate their love and be recognized as equal couples under the law"".",152,162,recognized,10,2,12
36AZSFEYZ41J62KY0VYNEC1B7KTBVO,"#17-15 Mark Zuckerberg posted on Facebook ""I'm so happy for all of my friends and everyone in our community who can finally celebrate their love and be recognized as equal couples under the law"".",166,179,equal couples,1,0,1
32CAVSKPCEQIGPD6T8VTCEMJ71T1U6,"#23-2 Everson argues his exclusion violates Title 11 of the U.S. Code of Federal Regulations in that debate hosts must not ""structure the debates to promote or advance one candidate over another"", and must ""use pre-established objective criteria to determine which candidates may participate in a debate.""",14,20,argues,2,3,5
32CAVSKPCEQIGPD6T8VTCEMJ71T1U6,"#23-2 Everson argues his exclusion violates Title 11 of the U.S. Code of Federal Regulations in that debate hosts must not ""structure the debates to promote or advance one candidate over another"", and must ""use pre-established objective criteria to determine which candidates may participate in a debate.""",21,34,his exclusion,1,0,1
32CAVSKPCEQIGPD6T8VTCEMJ71T1U6,"#23-2 Everson argues his exclusion violates Title 11 of the U.S. Code of Federal Regulations in that debate hosts must not ""structure the debates to promote or advance one candidate over another"", and must ""use pre-established objective criteria to determine which candidates may participate in a debate.""",25,34,exclusion,8,6,14
32CAVSKPCEQIGPD6T8VTCEMJ71T1U6,"#23-2 Everson argues his exclusion violates Title 11 of the U.S. Code of Federal Regulations in that debate hosts must not ""structure the debates to promote or advance one candidate over another"", and must ""use pre-established objective criteria to determine which candidates may participate in a debate.""",25,43,exclusion violates,1,1,2
32CAVSKPCEQIGPD6T8VTCEMJ71T1U6,"#23-2 Everson argues his exclusion violates Title 11 of the U.S. Code of Federal Regulations in that debate hosts must not ""structure the debates to promote or advance one candidate over another"", and must ""use pre-established objective criteria to determine which candidates may participate in a debate.""",35,43,violates,3,2,5
32CAVSKPCEQIGPD6T8VTCEMJ71T1U6,"#23-2 Everson argues his exclusion violates Title 11 of the U.S. Code of Federal Regulations in that debate hosts must not ""structure the debates to promote or advance one candidate over another"", and must ""use pre-established objective criteria to determine which candidates may participate in a debate.""",60,92,U.S. Code of Federal Regulations,1,0,1
32CAVSKPCEQIGPD6T8VTCEMJ71T1U6,"#23-2 Everson argues his exclusion violates Title 11 of the U.S. Code of Federal Regulations in that debate hosts must not ""structure the debates to promote or advance one candidate over another"", and must ""use pre-established objective criteria to determine which candidates may participate in a debate.""",73,80,Federal,0,1,1
32CAVSKPCEQIGPD6T8VTCEMJ71T1U6,"#23-2 Everson argues his exclusion violates Title 11 of the U.S. Code of Federal Regulations in that debate hosts must not ""structure the debates to promote or advance one candidate over another"", and must ""use pre-established objective criteria to determine which candidates may participate in a debate.""",73,92,Federal Regulations,0,1,1
32CAVSKPCEQIGPD6T8VTCEMJ71T1U6,"#23-2 Everson argues his exclusion violates Title 11 of the U.S. Code of Federal Regulations in that debate hosts must not ""structure the debates to promote or advance one candidate over another"", and must ""use pre-established objective criteria to determine which candidates may participate in a debate.""",81,92,Regulations,1,1,2
32CAVSKPCEQIGPD6T8VTCEMJ71T1U6,"#23-2 Everson argues his exclusion violates Title 11 of the U.S. Code of Federal Regulations in that debate hosts must not ""structure the debates to promote or advance one candidate over another"", and must ""use pre-established objective criteria to determine which candidates may participate in a debate.""",101,107,debate,1,2,3
32CAVSKPCEQIGPD6T8VTCEMJ71T1U6,"#23-2 Everson argues his exclusion violates Title 11 of the U.S. Code of Federal Regulations in that debate hosts must not ""structure the debates to promote or advance one candidate over another"", and must ""use pre-established objective criteria to determine which candidates may participate in a debate.""",124,133,structure,0,2,2
32CAVSKPCEQIGPD6T8VTCEMJ71T1U6,"#23-2 Everson argues his exclusion violates Title 11 of the U.S. Code of Federal Regulations in that debate hosts must not ""structure the debates to promote or advance one candidate over another"", and must ""use pre-established objective criteria to determine which candidates may participate in a debate.""",138,145,debates,1,0,1
32CAVSKPCEQIGPD6T8VTCEMJ71T1U6,"#23-2 Everson argues his exclusion violates Title 11 of the U.S. Code of Federal Regulations in that debate hosts must not ""structure the debates to promote or advance one candidate over another"", and must ""use pre-established objective criteria to determine which candidates may participate in a debate.""",149,156,promote,1,0,1
32CAVSKPCEQIGPD6T8VTCEMJ71T1U6,"#23-2 Everson argues his exclusion violates Title 11 of the U.S. Code of Federal Regulations in that debate hosts must not ""structure the debates to promote or advance one candidate over another"", and must ""use pre-established objective criteria to determine which candidates may participate in a debate.""",160,167,advance,0,1,1
32CAVSKPCEQIGPD6T8VTCEMJ71T1U6,"#23-2 Everson argues his exclusion violates Title 11 of the U.S. Code of Federal Regulations in that debate hosts must not ""structure the debates to promote or advance one candidate over another"", and must ""use pre-established objective criteria to determine which candidates may participate in a debate.""",160,194,advance one candidate over another,1,0,1
32CAVSKPCEQIGPD6T8VTCEMJ71T1U6,"#23-2 Everson argues his exclusion violates Title 11 of the U.S. Code of Federal Regulations in that debate hosts must not ""structure the debates to promote or advance one candidate over another"", and must ""use pre-established objective criteria to determine which candidates may participate in a debate.""",172,181,candidate,2,0,2
32CAVSKPCEQIGPD6T8VTCEMJ71T1U6,"#23-2 Everson argues his exclusion violates Title 11 of the U.S. Code of Federal Regulations in that debate hosts must not ""structure the debates to promote or advance one candidate over another"", and must ""use pre-established objective criteria to determine which candidates may participate in a debate.""",211,226,pre-established,3,3,6
32CAVSKPCEQIGPD6T8VTCEMJ71T1U6,"#23-2 Everson argues his exclusion violates Title 11 of the U.S. Code of Federal Regulations in that debate hosts must not ""structure the debates to promote or advance one candidate over another"", and must ""use pre-established objective criteria to determine which candidates may participate in a debate.""",211,245,pre-established objective criteria,3,0,3
32CAVSKPCEQIGPD6T8VTCEMJ71T1U6,"#23-2 Everson argues his exclusion violates Title 11 of the U.S. Code of Federal Regulations in that debate hosts must not ""structure the debates to promote or advance one candidate over another"", and must ""use pre-established objective criteria to determine which candidates may participate in a debate.""",227,236,objective,1,2,3
32CAVSKPCEQIGPD6T8VTCEMJ71T1U6,"#23-2 Everson argues his exclusion violates Title 11 of the U.S. Code of Federal Regulations in that debate hosts must not ""structure the debates to promote or advance one candidate over another"", and must ""use pre-established objective criteria to determine which candidates may participate in a debate.""",227,245,objective criteria,1,2,3
32CAVSKPCEQIGPD6T8VTCEMJ71T1U6,"#23-2 Everson argues his exclusion violates Title 11 of the U.S. Code of Federal Regulations in that debate hosts must not ""structure the debates to promote or advance one candidate over another"", and must ""use pre-established objective criteria to determine which candidates may participate in a debate.""",237,245,criteria,4,4,8
32CAVSKPCEQIGPD6T8VTCEMJ71T1U6,"#23-2 Everson argues his exclusion violates Title 11 of the U.S. Code of Federal Regulations in that debate hosts must not ""structure the debates to promote or advance one candidate over another"", and must ""use pre-established objective criteria to determine which candidates may participate in a debate.""",249,258,determine,1,1,2
32CAVSKPCEQIGPD6T8VTCEMJ71T1U6,"#23-2 Everson argues his exclusion violates Title 11 of the U.S. Code of Federal Regulations in that debate hosts must not ""structure the debates to promote or advance one candidate over another"", and must ""use pre-established objective criteria to determine which candidates may participate in a debate.""",265,275,candidates,1,0,1
32CAVSKPCEQIGPD6T8VTCEMJ71T1U6,"#23-2 Everson argues his exclusion violates Title 11 of the U.S. Code of Federal Regulations in that debate hosts must not ""structure the debates to promote or advance one candidate over another"", and must ""use pre-established objective criteria to determine which candidates may participate in a debate.""",280,291,participate,1,1,2
32CAVSKPCEQIGPD6T8VTCEMJ71T1U6,"#23-2 Everson argues his exclusion violates Title 11 of the U.S. Code of Federal Regulations in that debate hosts must not ""structure the debates to promote or advance one candidate over another"", and must ""use pre-established objective criteria to determine which candidates may participate in a debate.""",297,303,debate,0,1,1
32CAVSKPCEQIGPD6T8VTCEMJ71T1U6,"#23-3 Everson served as Commissioner of the IRS from 2003 to 2007, during the George W. Bush administration.",24,36,Commissioner,2,1,3
32CAVSKPCEQIGPD6T8VTCEMJ71T1U6,"#23-3 Everson served as Commissioner of the IRS from 2003 to 2007, during the George W. Bush administration.",44,47,IRS,1,0,1
32CAVSKPCEQIGPD6T8VTCEMJ71T1U6,"#23-3 Everson served as Commissioner of the IRS from 2003 to 2007, during the George W. Bush administration.",93,107,administration,4,1,5
32CAVSKPCEQIGPD6T8VTCEMJ71T1U6,"#23-4 After his departure, he briefly served as CEO of the American Red Cross, worked in the cabinet of Indiana governor Mitch Daniels, and worked for the tax consulting firm alliantgroup.",16,25,departure,2,3,5
32CAVSKPCEQIGPD6T8VTCEMJ71T1U6,"#23-4 After his departure, he briefly served as CEO of the American Red Cross, worked in the cabinet of Indiana governor Mitch Daniels, and worked for the tax consulting firm alliantgroup.",93,100,cabinet,2,0,2
32CAVSKPCEQIGPD6T8VTCEMJ71T1U6,"#23-4 After his departure, he briefly served as CEO of the American Red Cross, worked in the cabinet of Indiana governor Mitch Daniels, and worked for the tax consulting firm alliantgroup.",112,120,governor,1,0,1
32CAVSKPCEQIGPD6T8VTCEMJ71T1U6,"#23-4 After his departure, he briefly served as CEO of the American Red Cross, worked in the cabinet of Indiana governor Mitch Daniels, and worked for the tax consulting firm alliantgroup.",121,134,Mitch Daniels,0,1,1
32CAVSKPCEQIGPD6T8VTCEMJ71T1U6,"#23-4 After his departure, he briefly served as CEO of the American Red Cross, worked in the cabinet of Indiana governor Mitch Daniels, and worked for the tax consulting firm alliantgroup.",155,169,tax consulting,1,1,2
32CAVSKPCEQIGPD6T8VTCEMJ71T1U6,"#23-4 After his departure, he briefly served as CEO of the American Red Cross, worked in the cabinet of Indiana governor Mitch Daniels, and worked for the tax consulting firm alliantgroup.",159,169,consulting,3,1,4
32CAVSKPCEQIGPD6T8VTCEMJ71T1U6,"#23-4 After his departure, he briefly served as CEO of the American Red Cross, worked in the cabinet of Indiana governor Mitch Daniels, and worked for the tax consulting firm alliantgroup.",170,174,firm,0,1,1
32CAVSKPCEQIGPD6T8VTCEMJ71T1U6,"#23-4 After his departure, he briefly served as CEO of the American Red Cross, worked in the cabinet of Indiana governor Mitch Daniels, and worked for the tax consulting firm alliantgroup.",175,187,alliantgroup,6,5,11
32CAVSKPCEQIGPD6T8VTCEMJ71T1U6,"#23-5 He announced his candidacy this past March with a sixteen-page open letter in which he outlined the six pillars of his campaign: amnesty for illegal immigrants, reinstatement of the military draft, a promise to serve only a single presidential term, and calls for tax reform, deficit reduction, and corporate responsibility.",9,18,announced,2,1,3
32CAVSKPCEQIGPD6T8VTCEMJ71T1U6,"#23-5 He announced his candidacy this past March with a sixteen-page open letter in which he outlined the six pillars of his campaign: amnesty for illegal immigrants, reinstatement of the military draft, a promise to serve only a single presidential term, and calls for tax reform, deficit reduction, and corporate responsibility.",23,32,candidacy,6,5,11
32CAVSKPCEQIGPD6T8VTCEMJ71T1U6,"#23-5 He announced his candidacy this past March with a sixteen-page open letter in which he outlined the six pillars of his campaign: amnesty for illegal immigrants, reinstatement of the military draft, a promise to serve only a single presidential term, and calls for tax reform, deficit reduction, and corporate responsibility.",93,101,outlined,0,3,3
32CAVSKPCEQIGPD6T8VTCEMJ71T1U6,"#23-5 He announced his candidacy this past March with a sixteen-page open letter in which he outlined the six pillars of his campaign: amnesty for illegal immigrants, reinstatement of the military draft, a promise to serve only a single presidential term, and calls for tax reform, deficit reduction, and corporate responsibility.",110,117,pillars,2,2,4
32CAVSKPCEQIGPD6T8VTCEMJ71T1U6,"#23-5 He announced his candidacy this past March with a sixteen-page open letter in which he outlined the six pillars of his campaign: amnesty for illegal immigrants, reinstatement of the military draft, a promise to serve only a single presidential term, and calls for tax reform, deficit reduction, and corporate responsibility.",125,133,campaign,1,0,1
32CAVSKPCEQIGPD6T8VTCEMJ71T1U6,"#23-5 He announced his candidacy this past March with a sixteen-page open letter in which he outlined the six pillars of his campaign: amnesty for illegal immigrants, reinstatement of the military draft, a promise to serve only a single presidential term, and calls for tax reform, deficit reduction, and corporate responsibility.",135,142,amnesty,10,3,13
32CAVSKPCEQIGPD6T8VTCEMJ71T1U6,"#23-5 He announced his candidacy this past March with a sixteen-page open letter in which he outlined the six pillars of his campaign: amnesty for illegal immigrants, reinstatement of the military draft, a promise to serve only a single presidential term, and calls for tax reform, deficit reduction, and corporate responsibility.",135,165,amnesty for illegal immigrants,2,1,3
32CAVSKPCEQIGPD6T8VTCEMJ71T1U6,"#23-5 He announced his candidacy this past March with a sixteen-page open letter in which he outlined the six pillars of his campaign: amnesty for illegal immigrants, reinstatement of the military draft, a promise to serve only a single presidential term, and calls for tax reform, deficit reduction, and corporate responsibility.",147,165,illegal immigrants,0,1,1
32CAVSKPCEQIGPD6T8VTCEMJ71T1U6,"#23-5 He announced his candidacy this past March with a sixteen-page open letter in which he outlined the six pillars of his campaign: amnesty for illegal immigrants, reinstatement of the military draft, a promise to serve only a single presidential term, and calls for tax reform, deficit reduction, and corporate responsibility.",155,165,immigrants,2,4,6
32CAVSKPCEQIGPD6T8VTCEMJ71T1U6,"#23-5 He announced his candidacy this past March with a sixteen-page open letter in which he outlined the six pillars of his campaign: amnesty for illegal immigrants, reinstatement of the military draft, a promise to serve only a single presidential term, and calls for tax reform, deficit reduction, and corporate responsibility.",167,180,reinstatement,7,10,17
32CAVSKPCEQIGPD6T8VTCEMJ71T1U6,"#23-5 He announced his candidacy this past March with a sixteen-page open letter in which he outlined the six pillars of his campaign: amnesty for illegal immigrants, reinstatement of the military draft, a promise to serve only a single presidential term, and calls for tax reform, deficit reduction, and corporate responsibility.",167,202,reinstatement of the military draft,1,1,2
32CAVSKPCEQIGPD6T8VTCEMJ71T1U6,"#23-5 He announced his candidacy this past March with a sixteen-page open letter in which he outlined the six pillars of his campaign: amnesty for illegal immigrants, reinstatement of the military draft, a promise to serve only a single presidential term, and calls for tax reform, deficit reduction, and corporate responsibility.",197,202,draft,0,3,3
32CAVSKPCEQIGPD6T8VTCEMJ71T1U6,"#23-5 He announced his candidacy this past March with a sixteen-page open letter in which he outlined the six pillars of his campaign: amnesty for illegal immigrants, reinstatement of the military draft, a promise to serve only a single presidential term, and calls for tax reform, deficit reduction, and corporate responsibility.",237,249,presidential,0,1,1
32CAVSKPCEQIGPD6T8VTCEMJ71T1U6,"#23-5 He announced his candidacy this past March with a sixteen-page open letter in which he outlined the six pillars of his campaign: amnesty for illegal immigrants, reinstatement of the military draft, a promise to serve only a single presidential term, and calls for tax reform, deficit reduction, and corporate responsibility.",270,280,tax reform,0,1,1
32CAVSKPCEQIGPD6T8VTCEMJ71T1U6,"#23-5 He announced his candidacy this past March with a sixteen-page open letter in which he outlined the six pillars of his campaign: amnesty for illegal immigrants, reinstatement of the military draft, a promise to serve only a single presidential term, and calls for tax reform, deficit reduction, and corporate responsibility.",274,280,reform,0,1,1
32CAVSKPCEQIGPD6T8VTCEMJ71T1U6,"#23-5 He announced his candidacy this past March with a sixteen-page open letter in which he outlined the six pillars of his campaign: amnesty for illegal immigrants, reinstatement of the military draft, a promise to serve only a single presidential term, and calls for tax reform, deficit reduction, and corporate responsibility.",282,289,deficit,6,4,10
32CAVSKPCEQIGPD6T8VTCEMJ71T1U6,"#23-5 He announced his candidacy this past March with a sixteen-page open letter in which he outlined the six pillars of his campaign: amnesty for illegal immigrants, reinstatement of the military draft, a promise to serve only a single presidential term, and calls for tax reform, deficit reduction, and corporate responsibility.",282,299,deficit reduction,2,1,3
32CAVSKPCEQIGPD6T8VTCEMJ71T1U6,"#23-5 He announced his candidacy this past March with a sixteen-page open letter in which he outlined the six pillars of his campaign: amnesty for illegal immigrants, reinstatement of the military draft, a promise to serve only a single presidential term, and calls for tax reform, deficit reduction, and corporate responsibility.",305,314,corporate,1,1,2
32CAVSKPCEQIGPD6T8VTCEMJ71T1U6,"#23-5 He announced his candidacy this past March with a sixteen-page open letter in which he outlined the six pillars of his campaign: amnesty for illegal immigrants, reinstatement of the military draft, a promise to serve only a single presidential term, and calls for tax reform, deficit reduction, and corporate responsibility.",315,329,responsibility,0,1,1
32W3UF2EZOM3MUTPUZTVG67GCLW4CC,"#31-2 The shrine is a popular attraction in Thailand's capital, where at least 20 people, including at least eight foreigners, are reported dead with upwards of 100 injured.",10,16,shrine,6,9,15
32W3UF2EZOM3MUTPUZTVG67GCLW4CC,"#31-2 The shrine is a popular attraction in Thailand's capital, where at least 20 people, including at least eight foreigners, are reported dead with upwards of 100 injured.",22,40,popular attraction,1,1,2
32W3UF2EZOM3MUTPUZTVG67GCLW4CC,"#31-2 The shrine is a popular attraction in Thailand's capital, where at least 20 people, including at least eight foreigners, are reported dead with upwards of 100 injured.",30,40,attraction,3,2,5
32W3UF2EZOM3MUTPUZTVG67GCLW4CC,"#31-2 The shrine is a popular attraction in Thailand's capital, where at least 20 people, including at least eight foreigners, are reported dead with upwards of 100 injured.",44,61,Thailands capital,0,1,1
32W3UF2EZOM3MUTPUZTVG67GCLW4CC,"#31-2 The shrine is a popular attraction in Thailand's capital, where at least 20 people, including at least eight foreigners, are reported dead with upwards of 100 injured.",90,99,including,0,2,2
32W3UF2EZOM3MUTPUZTVG67GCLW4CC,"#31-2 The shrine is a popular attraction in Thailand's capital, where at least 20 people, including at least eight foreigners, are reported dead with upwards of 100 injured.",115,125,foreigners,4,2,6
32W3UF2EZOM3MUTPUZTVG67GCLW4CC,"#31-2 The shrine is a popular attraction in Thailand's capital, where at least 20 people, including at least eight foreigners, are reported dead with upwards of 100 injured.",131,139,reported,0,2,2
32W3UF2EZOM3MUTPUZTVG67GCLW4CC,"#31-2 The shrine is a popular attraction in Thailand's capital, where at least 20 people, including at least eight foreigners, are reported dead with upwards of 100 injured.",150,157,upwards,0,2,2
32W3UF2EZOM3MUTPUZTVG67GCLW4CC,"#31-2 The shrine is a popular attraction in Thailand's capital, where at least 20 people, including at least eight foreigners, are reported dead with upwards of 100 injured.",165,172,injured,0,1,1
32W3UF2EZOM3MUTPUZTVG67GCLW4CC,"#31-3 The blast occurred at approximately 7pm on Monday local time (1200 UTC), when central Bangkok was flooded with pedestrian activity.",10,15,blast,0,2,2
32W3UF2EZOM3MUTPUZTVG67GCLW4CC,"#31-3 The blast occurred at approximately 7pm on Monday local time (1200 UTC), when central Bangkok was flooded with pedestrian activity.",10,24,blast occurred,1,0,1
32W3UF2EZOM3MUTPUZTVG67GCLW4CC,"#31-3 The blast occurred at approximately 7pm on Monday local time (1200 UTC), when central Bangkok was flooded with pedestrian activity.",16,24,occurred,1,1,2
32W3UF2EZOM3MUTPUZTVG67GCLW4CC,"#31-3 The blast occurred at approximately 7pm on Monday local time (1200 UTC), when central Bangkok was flooded with pedestrian activity.",28,41,approximately,8,3,11
32W3UF2EZOM3MUTPUZTVG67GCLW4CC,"#31-3 The blast occurred at approximately 7pm on Monday local time (1200 UTC), when central Bangkok was flooded with pedestrian activity.",92,99,Bangkok,0,1,1
32W3UF2EZOM3MUTPUZTVG67GCLW4CC,"#31-3 The blast occurred at approximately 7pm on Monday local time (1200 UTC), when central Bangkok was flooded with pedestrian activity.",104,111,flooded,2,5,7
32W3UF2EZOM3MUTPUZTVG67GCLW4CC,"#31-3 The blast occurred at approximately 7pm on Monday local time (1200 UTC), when central Bangkok was flooded with pedestrian activity.",117,127,pedestrian,8,9,17
32W3UF2EZOM3MUTPUZTVG67GCLW4CC,"#31-3 The blast occurred at approximately 7pm on Monday local time (1200 UTC), when central Bangkok was flooded with pedestrian activity.",117,136,pedestrian activity,1,1,2
32W3UF2EZOM3MUTPUZTVG67GCLW4CC,#31-4 Authorities say the suspect may have already left Thailand and was assisted by others.,6,17,Authorities,1,2,3
32W3UF2EZOM3MUTPUZTVG67GCLW4CC,#31-4 Authorities say the suspect may have already left Thailand and was assisted by others.,26,33,suspect,2,1,3
32W3UF2EZOM3MUTPUZTVG67GCLW4CC,#31-4 Authorities say the suspect may have already left Thailand and was assisted by others.,73,81,assisted,1,0,1
32W3UF2EZOM3MUTPUZTVG67GCLW4CC,"#31-5 Following months of political unrest, since the explosion the Thai baht hit a six year low.",26,42,political unrest,2,1,3
32W3UF2EZOM3MUTPUZTVG67GCLW4CC,"#31-5 Following months of political unrest, since the explosion the Thai baht hit a six year low.",36,42,unrest,1,7,8
32W3UF2EZOM3MUTPUZTVG67GCLW4CC,"#31-5 Following months of political unrest, since the explosion the Thai baht hit a six year low.",54,63,explosion,4,2,6
32W3UF2EZOM3MUTPUZTVG67GCLW4CC,"#31-5 Following months of political unrest, since the explosion the Thai baht hit a six year low.",68,77,Thai baht,1,1,2
32W3UF2EZOM3MUTPUZTVG67GCLW4CC,"#31-5 Following months of political unrest, since the explosion the Thai baht hit a six year low.",68,81,Thai baht hit,1,0,1
32W3UF2EZOM3MUTPUZTVG67GCLW4CC,"#31-5 Following months of political unrest, since the explosion the Thai baht hit a six year low.",73,77,baht,1,2,3
32W3UF2EZOM3MUTPUZTVG67GCLW4CC,"#31-6 According to Defence Minister Prawit Wonguwan speaking to Reuters, the bombing was a deliberate attack on the country's economy and tourism industry.",19,26,Defence,1,1,2
32W3UF2EZOM3MUTPUZTVG67GCLW4CC,"#31-6 According to Defence Minister Prawit Wonguwan speaking to Reuters, the bombing was a deliberate attack on the country's economy and tourism industry.",19,35,Defence Minister,1,0,1
32W3UF2EZOM3MUTPUZTVG67GCLW4CC,"#31-6 According to Defence Minister Prawit Wonguwan speaking to Reuters, the bombing was a deliberate attack on the country's economy and tourism industry.",36,51,Prawit Wonguwan,0,2,2
32W3UF2EZOM3MUTPUZTVG67GCLW4CC,"#31-6 According to Defence Minister Prawit Wonguwan speaking to Reuters, the bombing was a deliberate attack on the country's economy and tourism industry.",64,71,Reuters,0,2,2
32W3UF2EZOM3MUTPUZTVG67GCLW4CC,"#31-6 According to Defence Minister Prawit Wonguwan speaking to Reuters, the bombing was a deliberate attack on the country's economy and tourism industry.",89,101,a deliberate,1,0,1
32W3UF2EZOM3MUTPUZTVG67GCLW4CC,"#31-6 According to Defence Minister Prawit Wonguwan speaking to Reuters, the bombing was a deliberate attack on the country's economy and tourism industry.",91,101,deliberate,9,8,17
32W3UF2EZOM3MUTPUZTVG67GCLW4CC,"#31-6 According to Defence Minister Prawit Wonguwan speaking to Reuters, the bombing was a deliberate attack on the country's economy and tourism industry.",91,108,deliberate attack,1,0,1
32W3UF2EZOM3MUTPUZTVG67GCLW4CC,"#31-6 According to Defence Minister Prawit Wonguwan speaking to Reuters, the bombing was a deliberate attack on the country's economy and tourism industry.",126,133,economy,2,0,2
32W3UF2EZOM3MUTPUZTVG67GCLW4CC,"#31-6 According to Defence Minister Prawit Wonguwan speaking to Reuters, the bombing was a deliberate attack on the country's economy and tourism industry.",138,145,tourism,1,0,1
32W3UF2EZOM3MUTPUZTVG67GCLW4CC,"#31-6 According to Defence Minister Prawit Wonguwan speaking to Reuters, the bombing was a deliberate attack on the country's economy and tourism industry.",138,154,tourism industry,1,0,1
32W3UF2EZOM3MUTPUZTVG67GCLW4CC,#31-7 Military authorities said Muslim insurgents from the country's southern provinces are unlikely to be behind the attack.,15,26,authorities,1,0,1
32W3UF2EZOM3MUTPUZTVG67GCLW4CC,#31-7 Military authorities said Muslim insurgents from the country's southern provinces are unlikely to be behind the attack.,32,49,Muslim insurgents,2,0,2
32W3UF2EZOM3MUTPUZTVG67GCLW4CC,#31-7 Military authorities said Muslim insurgents from the country's southern provinces are unlikely to be behind the attack.,39,49,insurgents,10,5,15
32W3UF2EZOM3MUTPUZTVG67GCLW4CC,#31-7 Military authorities said Muslim insurgents from the country's southern provinces are unlikely to be behind the attack.,69,87,southern provinces,0,1,1
32W3UF2EZOM3MUTPUZTVG67GCLW4CC,#31-7 Military authorities said Muslim insurgents from the country's southern provinces are unlikely to be behind the attack.,78,87,provinces,2,1,3
32W3UF2EZOM3MUTPUZTVG67GCLW4CC,"#32-1 Wikinews interviews Mark Everson, U.S. Republican Party presidential candidate Former U.S. Commissioner of Internal Revenue Mark Everson took some time to talk with Wikinews about his campaign for the U.S. Republican Party's 2016 presidential nomination.",6,14,Wikinews,0,1,1
32W3UF2EZOM3MUTPUZTVG67GCLW4CC,"#32-1 Wikinews interviews Mark Everson, U.S. Republican Party presidential candidate Former U.S. Commissioner of Internal Revenue Mark Everson took some time to talk with Wikinews about his campaign for the U.S. Republican Party's 2016 presidential nomination.",6,25,Wikinews interviews,0,1,1
32W3UF2EZOM3MUTPUZTVG67GCLW4CC,"#32-1 Wikinews interviews Mark Everson, U.S. Republican Party presidential candidate Former U.S. Commissioner of Internal Revenue Mark Everson took some time to talk with Wikinews about his campaign for the U.S. Republican Party's 2016 presidential nomination.",45,61,Republican Party,1,0,1
32W3UF2EZOM3MUTPUZTVG67GCLW4CC,"#32-1 Wikinews interviews Mark Everson, U.S. Republican Party presidential candidate Former U.S. Commissioner of Internal Revenue Mark Everson took some time to talk with Wikinews about his campaign for the U.S. Republican Party's 2016 presidential nomination.",75,84,candidate,0,1,1
32W3UF2EZOM3MUTPUZTVG67GCLW4CC,"#32-1 Wikinews interviews Mark Everson, U.S. Republican Party presidential candidate Former U.S. Commissioner of Internal Revenue Mark Everson took some time to talk with Wikinews about his campaign for the U.S. Republican Party's 2016 presidential nomination.",92,129,U.S. Commissioner of Internal Revenue,1,0,1
32W3UF2EZOM3MUTPUZTVG67GCLW4CC,"#32-1 Wikinews interviews Mark Everson, U.S. Republican Party presidential candidate Former U.S. Commissioner of Internal Revenue Mark Everson took some time to talk with Wikinews about his campaign for the U.S. Republican Party's 2016 presidential nomination.",97,109,Commissioner,0,1,1
32W3UF2EZOM3MUTPUZTVG67GCLW4CC,"#32-1 Wikinews interviews Mark Everson, U.S. Republican Party presidential candidate Former U.S. Commissioner of Internal Revenue Mark Everson took some time to talk with Wikinews about his campaign for the U.S. Republican Party's 2016 presidential nomination.",97,129,Commissioner of Internal Revenue,1,0,1
32W3UF2EZOM3MUTPUZTVG67GCLW4CC,"#32-1 Wikinews interviews Mark Everson, U.S. Republican Party presidential candidate Former U.S. Commissioner of Internal Revenue Mark Everson took some time to talk with Wikinews about his campaign for the U.S. Republican Party's 2016 presidential nomination.",113,129,Internal Revenue,0,1,1
32W3UF2EZOM3MUTPUZTVG67GCLW4CC,"#32-1 Wikinews interviews Mark Everson, U.S. Republican Party presidential candidate Former U.S. Commissioner of Internal Revenue Mark Everson took some time to talk with Wikinews about his campaign for the U.S. Republican Party's 2016 presidential nomination.",122,129,Revenue,2,0,2
32W3UF2EZOM3MUTPUZTVG67GCLW4CC,"#32-1 Wikinews interviews Mark Everson, U.S. Republican Party presidential candidate Former U.S. Commissioner of Internal Revenue Mark Everson took some time to talk with Wikinews about his campaign for the U.S. Republican Party's 2016 presidential nomination.",171,179,Wikinews,1,0,1
32W3UF2EZOM3MUTPUZTVG67GCLW4CC,"#32-1 Wikinews interviews Mark Everson, U.S. Republican Party presidential candidate Former U.S. Commissioner of Internal Revenue Mark Everson took some time to talk with Wikinews about his campaign for the U.S. Republican Party's 2016 presidential nomination.",190,198,campaign,2,5,7
32W3UF2EZOM3MUTPUZTVG67GCLW4CC,"#32-1 Wikinews interviews Mark Everson, U.S. Republican Party presidential candidate Former U.S. Commissioner of Internal Revenue Mark Everson took some time to talk with Wikinews about his campaign for the U.S. Republican Party's 2016 presidential nomination.",212,222,Republican,1,0,1
32W3UF2EZOM3MUTPUZTVG67GCLW4CC,"#32-1 Wikinews interviews Mark Everson, U.S. Republican Party presidential candidate Former U.S. Commissioner of Internal Revenue Mark Everson took some time to talk with Wikinews about his campaign for the U.S. Republican Party's 2016 presidential nomination.",236,259,presidential nomination,0,1,1
32W3UF2EZOM3MUTPUZTVG67GCLW4CC,"#32-1 Wikinews interviews Mark Everson, U.S. Republican Party presidential candidate Former U.S. Commissioner of Internal Revenue Mark Everson took some time to talk with Wikinews about his campaign for the U.S. Republican Party's 2016 presidential nomination.",249,259,nomination,4,2,6
36FFXPMST9PY7VENZBM55VA1641HO8,"#9-22 The Amazonas prison riot on January 1–2 resulted in at least 56 killed inmates, of whom many were beheaded and dismembered.",10,18,Amazonas,0,1,1
36FFXPMST9PY7VENZBM55VA1641HO8,"#9-22 The Amazonas prison riot on January 1–2 resulted in at least 56 killed inmates, of whom many were beheaded and dismembered.",19,25,prison,0,1,1
36FFXPMST9PY7VENZBM55VA1641HO8,"#9-22 The Amazonas prison riot on January 1–2 resulted in at least 56 killed inmates, of whom many were beheaded and dismembered.",19,30,prison riot,0,2,2
36FFXPMST9PY7VENZBM55VA1641HO8,"#9-22 The Amazonas prison riot on January 1–2 resulted in at least 56 killed inmates, of whom many were beheaded and dismembered.",26,30,riot,2,3,5
36FFXPMST9PY7VENZBM55VA1641HO8,"#9-22 The Amazonas prison riot on January 1–2 resulted in at least 56 killed inmates, of whom many were beheaded and dismembered.",77,84,inmates,2,4,6
36FFXPMST9PY7VENZBM55VA1641HO8,"#9-22 The Amazonas prison riot on January 1–2 resulted in at least 56 killed inmates, of whom many were beheaded and dismembered.",89,93,whom,1,0,1
36FFXPMST9PY7VENZBM55VA1641HO8,"#9-22 The Amazonas prison riot on January 1–2 resulted in at least 56 killed inmates, of whom many were beheaded and dismembered.",104,112,beheaded,9,10,19
36FFXPMST9PY7VENZBM55VA1641HO8,"#9-22 The Amazonas prison riot on January 1–2 resulted in at least 56 killed inmates, of whom many were beheaded and dismembered.",104,128,beheaded and dismembered,1,0,1
36FFXPMST9PY7VENZBM55VA1641HO8,"#9-22 The Amazonas prison riot on January 1–2 resulted in at least 56 killed inmates, of whom many were beheaded and dismembered.",117,128,dismembered,10,10,20
36FFXPMST9PY7VENZBM55VA1641HO8,"#9-23 The Roraima riot on January 6 resulted in at least 33 killed, of whom many were disembowelled.",10,17,Roraima,0,2,2
36FFXPMST9PY7VENZBM55VA1641HO8,"#9-23 The Roraima riot on January 6 resulted in at least 33 killed, of whom many were disembowelled.",18,22,riot,1,0,1
36FFXPMST9PY7VENZBM55VA1641HO8,"#9-23 The Roraima riot on January 6 resulted in at least 33 killed, of whom many were disembowelled.",86,99,disembowelled,10,10,20
36FFXPMST9PY7VENZBM55VA1641HO8,"#9-24 In the wake of this year's riots, the Brazilian President Michel Temer announced to Reuters yesterday a plan, under joint cooperation of state and federal governments, to build nearly thirty prisons by 2018, including ""five maximum security prisons to house the most violent convicts,"" and to create intelligence units in effort to counter the influence of powerful inmates.",13,17,wake,1,0,1
36FFXPMST9PY7VENZBM55VA1641HO8,"#9-24 In the wake of this year's riots, the Brazilian President Michel Temer announced to Reuters yesterday a plan, under joint cooperation of state and federal governments, to build nearly thirty prisons by 2018, including ""five maximum security prisons to house the most violent convicts,"" and to create intelligence units in effort to counter the influence of powerful inmates.",33,38,riots,2,1,3
36FFXPMST9PY7VENZBM55VA1641HO8,"#9-24 In the wake of this year's riots, the Brazilian President Michel Temer announced to Reuters yesterday a plan, under joint cooperation of state and federal governments, to build nearly thirty prisons by 2018, including ""five maximum security prisons to house the most violent convicts,"" and to create intelligence units in effort to counter the influence of powerful inmates.",64,76,Michel Temer,0,1,1
36FFXPMST9PY7VENZBM55VA1641HO8,"#9-24 In the wake of this year's riots, the Brazilian President Michel Temer announced to Reuters yesterday a plan, under joint cooperation of state and federal governments, to build nearly thirty prisons by 2018, including ""five maximum security prisons to house the most violent convicts,"" and to create intelligence units in effort to counter the influence of powerful inmates.",90,97,Reuters,0,1,1
36FFXPMST9PY7VENZBM55VA1641HO8,"#9-24 In the wake of this year's riots, the Brazilian President Michel Temer announced to Reuters yesterday a plan, under joint cooperation of state and federal governments, to build nearly thirty prisons by 2018, including ""five maximum security prisons to house the most violent convicts,"" and to create intelligence units in effort to counter the influence of powerful inmates.",122,139,joint cooperation,0,1,1
36FFXPMST9PY7VENZBM55VA1641HO8,"#9-24 In the wake of this year's riots, the Brazilian President Michel Temer announced to Reuters yesterday a plan, under joint cooperation of state and federal governments, to build nearly thirty prisons by 2018, including ""five maximum security prisons to house the most violent convicts,"" and to create intelligence units in effort to counter the influence of powerful inmates.",128,139,cooperation,1,0,1
36FFXPMST9PY7VENZBM55VA1641HO8,"#9-24 In the wake of this year's riots, the Brazilian President Michel Temer announced to Reuters yesterday a plan, under joint cooperation of state and federal governments, to build nearly thirty prisons by 2018, including ""five maximum security prisons to house the most violent convicts,"" and to create intelligence units in effort to counter the influence of powerful inmates.",153,160,federal,2,1,3
36FFXPMST9PY7VENZBM55VA1641HO8,"#9-24 In the wake of this year's riots, the Brazilian President Michel Temer announced to Reuters yesterday a plan, under joint cooperation of state and federal governments, to build nearly thirty prisons by 2018, including ""five maximum security prisons to house the most violent convicts,"" and to create intelligence units in effort to counter the influence of powerful inmates.",230,246,maximum security,2,0,2
36FFXPMST9PY7VENZBM55VA1641HO8,"#9-24 In the wake of this year's riots, the Brazilian President Michel Temer announced to Reuters yesterday a plan, under joint cooperation of state and federal governments, to build nearly thirty prisons by 2018, including ""five maximum security prisons to house the most violent convicts,"" and to create intelligence units in effort to counter the influence of powerful inmates.",238,254,security prisons,0,1,1
36FFXPMST9PY7VENZBM55VA1641HO8,"#9-24 In the wake of this year's riots, the Brazilian President Michel Temer announced to Reuters yesterday a plan, under joint cooperation of state and federal governments, to build nearly thirty prisons by 2018, including ""five maximum security prisons to house the most violent convicts,"" and to create intelligence units in effort to counter the influence of powerful inmates.",258,263,house,0,1,1
36FFXPMST9PY7VENZBM55VA1641HO8,"#9-24 In the wake of this year's riots, the Brazilian President Michel Temer announced to Reuters yesterday a plan, under joint cooperation of state and federal governments, to build nearly thirty prisons by 2018, including ""five maximum security prisons to house the most violent convicts,"" and to create intelligence units in effort to counter the influence of powerful inmates.",273,280,violent,3,0,3
36FFXPMST9PY7VENZBM55VA1641HO8,"#9-24 In the wake of this year's riots, the Brazilian President Michel Temer announced to Reuters yesterday a plan, under joint cooperation of state and federal governments, to build nearly thirty prisons by 2018, including ""five maximum security prisons to house the most violent convicts,"" and to create intelligence units in effort to counter the influence of powerful inmates.",273,289,violent convicts,1,2,3
36FFXPMST9PY7VENZBM55VA1641HO8,"#9-24 In the wake of this year's riots, the Brazilian President Michel Temer announced to Reuters yesterday a plan, under joint cooperation of state and federal governments, to build nearly thirty prisons by 2018, including ""five maximum security prisons to house the most violent convicts,"" and to create intelligence units in effort to counter the influence of powerful inmates.",281,289,convicts,4,3,7
36FFXPMST9PY7VENZBM55VA1641HO8,"#9-24 In the wake of this year's riots, the Brazilian President Michel Temer announced to Reuters yesterday a plan, under joint cooperation of state and federal governments, to build nearly thirty prisons by 2018, including ""five maximum security prisons to house the most violent convicts,"" and to create intelligence units in effort to counter the influence of powerful inmates.",306,318,intelligence,3,0,3
36FFXPMST9PY7VENZBM55VA1641HO8,"#9-24 In the wake of this year's riots, the Brazilian President Michel Temer announced to Reuters yesterday a plan, under joint cooperation of state and federal governments, to build nearly thirty prisons by 2018, including ""five maximum security prisons to house the most violent convicts,"" and to create intelligence units in effort to counter the influence of powerful inmates.",338,345,counter,0,2,2
36FFXPMST9PY7VENZBM55VA1641HO8,"#9-24 In the wake of this year's riots, the Brazilian President Michel Temer announced to Reuters yesterday a plan, under joint cooperation of state and federal governments, to build nearly thirty prisons by 2018, including ""five maximum security prisons to house the most violent convicts,"" and to create intelligence units in effort to counter the influence of powerful inmates.",350,359,influence,3,1,4
36FFXPMST9PY7VENZBM55VA1641HO8,"#9-24 In the wake of this year's riots, the Brazilian President Michel Temer announced to Reuters yesterday a plan, under joint cooperation of state and federal governments, to build nearly thirty prisons by 2018, including ""five maximum security prisons to house the most violent convicts,"" and to create intelligence units in effort to counter the influence of powerful inmates.",363,379,powerful inmates,1,0,1
36FFXPMST9PY7VENZBM55VA1641HO8,"#9-24 In the wake of this year's riots, the Brazilian President Michel Temer announced to Reuters yesterday a plan, under joint cooperation of state and federal governments, to build nearly thirty prisons by 2018, including ""five maximum security prisons to house the most violent convicts,"" and to create intelligence units in effort to counter the influence of powerful inmates.",372,379,inmates,2,2,4
36FFXPMST9PY7VENZBM55VA1641HO8,#9-25 Temer announced more than one billion Brazilian reals (US$309 million) as the budget of the plan.,6,11,Temer,0,1,1
36FFXPMST9PY7VENZBM55VA1641HO8,#9-25 Temer announced more than one billion Brazilian reals (US$309 million) as the budget of the plan.,12,21,announced,0,1,1
36FFXPMST9PY7VENZBM55VA1641HO8,#9-25 Temer announced more than one billion Brazilian reals (US$309 million) as the budget of the plan.,44,53,Brazilian,0,1,1
36FFXPMST9PY7VENZBM55VA1641HO8,#9-25 Temer announced more than one billion Brazilian reals (US$309 million) as the budget of the plan.,44,59,Brazilian reals,1,0,1
36FFXPMST9PY7VENZBM55VA1641HO8,#9-25 Temer announced more than one billion Brazilian reals (US$309 million) as the budget of the plan.,84,90,budget,2,0,2
36FFXPMST9PY7VENZBM55VA1641HO8,"#9-26 However, human rights activists and experts were skeptical about building more prisons.",28,37,activists,4,0,4
36FFXPMST9PY7VENZBM55VA1641HO8,"#9-26 However, human rights activists and experts were skeptical about building more prisons.",55,64,skeptical,10,9,19
3LG268AV387PKYF112V3ENITPBTERY,#42-40 For this we basically put colonies on a diet of either food with medicine or without for a while.,16,41,we basically put colonies,1,0,1
3LG268AV387PKYF112V3ENITPBTERY,#42-40 For this we basically put colonies on a diet of either food with medicine or without for a while.,19,28,basically,1,5,6
3LG268AV387PKYF112V3ENITPBTERY,#42-40 For this we basically put colonies on a diet of either food with medicine or without for a while.,33,41,colonies,10,4,14
3LG268AV387PKYF112V3ENITPBTERY,#42-40 For this we basically put colonies on a diet of either food with medicine or without for a while.,47,51,diet,1,0,1
3LG268AV387PKYF112V3ENITPBTERY,#42-41 And afterwards either infected them or not.,11,21,afterwards,0,4,4
3LG268AV387PKYF112V3ENITPBTERY,#42-41 And afterwards either infected them or not.,29,37,infected,4,4,8
3LG268AV387PKYF112V3ENITPBTERY,#42-43 This gives us the data to do a so-called survival analysis.,25,29,data,1,0,1
3LG268AV387PKYF112V3ENITPBTERY,#42-43 This gives us the data to do a so-called survival analysis.,38,47,so-called,2,3,5
3LG268AV387PKYF112V3ENITPBTERY,#42-43 This gives us the data to do a so-called survival analysis.,38,65,so-called survival analysis,1,0,1
3LG268AV387PKYF112V3ENITPBTERY,#42-43 This gives us the data to do a so-called survival analysis.,48,56,survival,0,3,3
3LG268AV387PKYF112V3ENITPBTERY,#42-43 This gives us the data to do a so-called survival analysis.,48,65,survival analysis,2,3,5
3LG268AV387PKYF112V3ENITPBTERY,#42-43 This gives us the data to do a so-called survival analysis.,57,65,analysis,7,2,9
3LG268AV387PKYF112V3ENITPBTERY,#42-44 We measured the ROS-concentration in the bodies of ants after they ingested the food with the medicine using a spectrophotometer.,10,18,measured,0,2,2
3LG268AV387PKYF112V3ENITPBTERY,#42-44 We measured the ROS-concentration in the bodies of ants after they ingested the food with the medicine using a spectrophotometer.,23,40,ROS-concentration,7,3,10
3LG268AV387PKYF112V3ENITPBTERY,#42-44 We measured the ROS-concentration in the bodies of ants after they ingested the food with the medicine using a spectrophotometer.,74,82,ingested,5,9,14
3LG268AV387PKYF112V3ENITPBTERY,#42-44 We measured the ROS-concentration in the bodies of ants after they ingested the food with the medicine using a spectrophotometer.,110,135,using a spectrophotometer,1,0,1
3LG268AV387PKYF112V3ENITPBTERY,#42-44 We measured the ROS-concentration in the bodies of ants after they ingested the food with the medicine using a spectrophotometer.,118,135,spectrophotometer,10,8,18
3LG268AV387PKYF112V3ENITPBTERY,"#42-45 By adding certain chemicals, the ROS can be measured using the emission of light of a certain wave-length.",25,34,chemicals,2,0,2
3LG268AV387PKYF112V3ENITPBTERY,"#42-45 By adding certain chemicals, the ROS can be measured using the emission of light of a certain wave-length.",70,78,emission,7,5,12
3LG268AV387PKYF112V3ENITPBTERY,"#42-45 By adding certain chemicals, the ROS can be measured using the emission of light of a certain wave-length.",70,112,emission of light of a certain wave-length,1,0,1
3LG268AV387PKYF112V3ENITPBTERY,"#42-45 By adding certain chemicals, the ROS can be measured using the emission of light of a certain wave-length.",101,112,wave-length,2,3,5
3LG268AV387PKYF112V3ENITPBTERY,#42-46 The detrimental effect of ROS on spores was easy to measure.,11,22,detrimental,8,9,17
3LG268AV387PKYF112V3ENITPBTERY,#42-46 The detrimental effect of ROS on spores was easy to measure.,11,29,detrimental effect,0,2,2
3LG268AV387PKYF112V3ENITPBTERY,#42-46 The detrimental effect of ROS on spores was easy to measure.,33,36,ROS,2,0,2
3LG268AV387PKYF112V3ENITPBTERY,#42-46 The detrimental effect of ROS on spores was easy to measure.,40,46,spores,4,3,7
3LG268AV387PKYF112V3ENITPBTERY,"#42-47 We mixed different concentrations of ROS with the spores, plated them out on petridishes with an agar-solution where fungus can grow on.",26,40,concentrations,3,3,6
3LG268AV387PKYF112V3ENITPBTERY,"#42-47 We mixed different concentrations of ROS with the spores, plated them out on petridishes with an agar-solution where fungus can grow on.",44,47,ROS,1,0,1
3LG268AV387PKYF112V3ENITPBTERY,"#42-47 We mixed different concentrations of ROS with the spores, plated them out on petridishes with an agar-solution where fungus can grow on.",57,63,spores,2,1,3
3LG268AV387PKYF112V3ENITPBTERY,"#42-47 We mixed different concentrations of ROS with the spores, plated them out on petridishes with an agar-solution where fungus can grow on.",65,71,plated,0,3,3
3LG268AV387PKYF112V3ENITPBTERY,"#42-47 We mixed different concentrations of ROS with the spores, plated them out on petridishes with an agar-solution where fungus can grow on.",65,95,plated them out on petridishes,1,0,1
3LG268AV387PKYF112V3ENITPBTERY,"#42-47 We mixed different concentrations of ROS with the spores, plated them out on petridishes with an agar-solution where fungus can grow on.",84,95,petridishes,10,10,20
3LG268AV387PKYF112V3ENITPBTERY,"#42-47 We mixed different concentrations of ROS with the spores, plated them out on petridishes with an agar-solution where fungus can grow on.",104,117,agar-solution,8,4,12
3LG268AV387PKYF112V3ENITPBTERY,"#42-47 We mixed different concentrations of ROS with the spores, plated them out on petridishes with an agar-solution where fungus can grow on.",124,130,fungus,4,4,8
3CMIQF80GNRLVI7MI5N5X9GBCR36Q4,"#17-16 Later, companies like Google, Yahoo, Tumblr and Vine tweeted with hashtag ""#LoveWins"".",44,50,Tumblr,0,1,1
3CMIQF80GNRLVI7MI5N5X9GBCR36Q4,"#17-16 Later, companies like Google, Yahoo, Tumblr and Vine tweeted with hashtag ""#LoveWins"".",60,67,tweeted,8,2,10
3CMIQF80GNRLVI7MI5N5X9GBCR36Q4,"#17-16 Later, companies like Google, Yahoo, Tumblr and Vine tweeted with hashtag ""#LoveWins"".",73,80,hashtag,6,5,11
3CMIQF80GNRLVI7MI5N5X9GBCR36Q4,"#17-17 That night, the White House had the rainbow projected on the outside of the building to celebrate the decision.",51,60,projected,5,3,8
3CMIQF80GNRLVI7MI5N5X9GBCR36Q4,"#17-17 That night, the White House had the rainbow projected on the outside of the building to celebrate the decision.",109,117,decision,1,0,1
3CMIQF80GNRLVI7MI5N5X9GBCR36Q4,"#18-1 Palestinian prisoner Khader Adnan stops hunger strike, due to be released Khader Adnan, a senior member of the Palestinian Islamic Jihad (PIJ) movement, has stopped his hunger strike.",6,17,Palestinian,3,1,4
3CMIQF80GNRLVI7MI5N5X9GBCR36Q4,"#18-1 Palestinian prisoner Khader Adnan stops hunger strike, due to be released Khader Adnan, a senior member of the Palestinian Islamic Jihad (PIJ) movement, has stopped his hunger strike.",18,26,prisoner,1,0,1
3CMIQF80GNRLVI7MI5N5X9GBCR36Q4,"#18-1 Palestinian prisoner Khader Adnan stops hunger strike, due to be released Khader Adnan, a senior member of the Palestinian Islamic Jihad (PIJ) movement, has stopped his hunger strike.",27,39,Khader Adnan,0,1,1
3CMIQF80GNRLVI7MI5N5X9GBCR36Q4,"#18-1 Palestinian prisoner Khader Adnan stops hunger strike, due to be released Khader Adnan, a senior member of the Palestinian Islamic Jihad (PIJ) movement, has stopped his hunger strike.",46,59,hunger strike,2,2,4
3CMIQF80GNRLVI7MI5N5X9GBCR36Q4,"#18-1 Palestinian prisoner Khader Adnan stops hunger strike, due to be released Khader Adnan, a senior member of the Palestinian Islamic Jihad (PIJ) movement, has stopped his hunger strike.",71,79,released,3,1,4
3CMIQF80GNRLVI7MI5N5X9GBCR36Q4,"#18-1 Palestinian prisoner Khader Adnan stops hunger strike, due to be released Khader Adnan, a senior member of the Palestinian Islamic Jihad (PIJ) movement, has stopped his hunger strike.",117,128,Palestinian,2,0,2
3CMIQF80GNRLVI7MI5N5X9GBCR36Q4,"#18-1 Palestinian prisoner Khader Adnan stops hunger strike, due to be released Khader Adnan, a senior member of the Palestinian Islamic Jihad (PIJ) movement, has stopped his hunger strike.",117,142,Palestinian Islamic Jihad,2,0,2
3CMIQF80GNRLVI7MI5N5X9GBCR36Q4,"#18-1 Palestinian prisoner Khader Adnan stops hunger strike, due to be released Khader Adnan, a senior member of the Palestinian Islamic Jihad (PIJ) movement, has stopped his hunger strike.",129,136,Islamic,1,0,1
3CMIQF80GNRLVI7MI5N5X9GBCR36Q4,"#18-1 Palestinian prisoner Khader Adnan stops hunger strike, due to be released Khader Adnan, a senior member of the Palestinian Islamic Jihad (PIJ) movement, has stopped his hunger strike.",129,142,Islamic Jihad,0,1,1
3CMIQF80GNRLVI7MI5N5X9GBCR36Q4,"#18-1 Palestinian prisoner Khader Adnan stops hunger strike, due to be released Khader Adnan, a senior member of the Palestinian Islamic Jihad (PIJ) movement, has stopped his hunger strike.",137,142,Jihad,1,0,1
3CMIQF80GNRLVI7MI5N5X9GBCR36Q4,"#18-1 Palestinian prisoner Khader Adnan stops hunger strike, due to be released Khader Adnan, a senior member of the Palestinian Islamic Jihad (PIJ) movement, has stopped his hunger strike.",149,157,movement,1,0,1
3CMIQF80GNRLVI7MI5N5X9GBCR36Q4,"#18-2 According to media reports on Monday, Adnan ceased his strike after achieving an agreement with Israel entailing his release from administrative detention.",19,24,media,1,0,1
3CMIQF80GNRLVI7MI5N5X9GBCR36Q4,"#18-2 According to media reports on Monday, Adnan ceased his strike after achieving an agreement with Israel entailing his release from administrative detention.",44,49,Adnan,0,1,1
3CMIQF80GNRLVI7MI5N5X9GBCR36Q4,"#18-2 According to media reports on Monday, Adnan ceased his strike after achieving an agreement with Israel entailing his release from administrative detention.",50,56,ceased,5,6,11
3CMIQF80GNRLVI7MI5N5X9GBCR36Q4,"#18-2 According to media reports on Monday, Adnan ceased his strike after achieving an agreement with Israel entailing his release from administrative detention.",74,83,achieving,4,3,7
3CMIQF80GNRLVI7MI5N5X9GBCR36Q4,"#18-2 According to media reports on Monday, Adnan ceased his strike after achieving an agreement with Israel entailing his release from administrative detention.",87,96,agreement,1,0,1
3CMIQF80GNRLVI7MI5N5X9GBCR36Q4,"#18-2 According to media reports on Monday, Adnan ceased his strike after achieving an agreement with Israel entailing his release from administrative detention.",109,118,entailing,6,9,15
3CMIQF80GNRLVI7MI5N5X9GBCR36Q4,"#18-2 According to media reports on Monday, Adnan ceased his strike after achieving an agreement with Israel entailing his release from administrative detention.",136,150,administrative,5,1,6
3CMIQF80GNRLVI7MI5N5X9GBCR36Q4,"#18-2 According to media reports on Monday, Adnan ceased his strike after achieving an agreement with Israel entailing his release from administrative detention.",136,160,administrative detention,4,1,5
3CMIQF80GNRLVI7MI5N5X9GBCR36Q4,"#18-2 According to media reports on Monday, Adnan ceased his strike after achieving an agreement with Israel entailing his release from administrative detention.",151,160,detention,6,4,10
3CMIQF80GNRLVI7MI5N5X9GBCR36Q4,"#18-3 Adnan's strike lasted over 50 days, and he was in mortal danger for the last couple of weeks.",21,27,lasted,0,1,1
3CMIQF80GNRLVI7MI5N5X9GBCR36Q4,"#18-3 Adnan's strike lasted over 50 days, and he was in mortal danger for the last couple of weeks.",56,62,mortal,4,4,8
3CMIQF80GNRLVI7MI5N5X9GBCR36Q4,"#18-3 Adnan's strike lasted over 50 days, and he was in mortal danger for the last couple of weeks.",56,69,mortal danger,1,1,2
3CMIQF80GNRLVI7MI5N5X9GBCR36Q4,"#18-4 Due to his severe deterioration, Israel was forced to hospitalize him, and placed him in Assaf Harofe hospital in Israel.",17,23,severe,2,0,2
3CMIQF80GNRLVI7MI5N5X9GBCR36Q4,"#18-4 Due to his severe deterioration, Israel was forced to hospitalize him, and placed him in Assaf Harofe hospital in Israel.",17,37,severe deterioration,1,1,2
3CMIQF80GNRLVI7MI5N5X9GBCR36Q4,"#18-4 Due to his severe deterioration, Israel was forced to hospitalize him, and placed him in Assaf Harofe hospital in Israel.",24,37,deterioration,10,9,19
3CMIQF80GNRLVI7MI5N5X9GBCR36Q4,"#18-4 Due to his severe deterioration, Israel was forced to hospitalize him, and placed him in Assaf Harofe hospital in Israel.",60,71,hospitalize,7,1,8
3CMIQF80GNRLVI7MI5N5X9GBCR36Q4,"#18-4 Due to his severe deterioration, Israel was forced to hospitalize him, and placed him in Assaf Harofe hospital in Israel.",95,107,Assaf Harofe,0,1,1
3CMIQF80GNRLVI7MI5N5X9GBCR36Q4,"#18-5 Jawd Boulos, Adnan's lawyer, said Adnan is due to be released on July 12.",6,17,Jawd Boulos,0,1,1
3CMIQF80GNRLVI7MI5N5X9GBCR36Q4,"#18-5 Jawd Boulos, Adnan's lawyer, said Adnan is due to be released on July 12.",59,67,released,1,0,1
3KA7IJSNW6661IN2EJPO8KCTLWSBP3,#1-5 In yesterday's speech May also ruled out continued membership of the customs union as this prevented Britain from negotiating trade deals with non-EU countries.,8,18,yesterdays,0,1,1
3KA7IJSNW6661IN2EJPO8KCTLWSBP3,#1-5 In yesterday's speech May also ruled out continued membership of the customs union as this prevented Britain from negotiating trade deals with non-EU countries.,36,41,ruled,0,1,1
3KA7IJSNW6661IN2EJPO8KCTLWSBP3,#1-5 In yesterday's speech May also ruled out continued membership of the customs union as this prevented Britain from negotiating trade deals with non-EU countries.,36,45,ruled out,0,4,4
3KA7IJSNW6661IN2EJPO8KCTLWSBP3,#1-5 In yesterday's speech May also ruled out continued membership of the customs union as this prevented Britain from negotiating trade deals with non-EU countries.,56,66,membership,1,1,2
3KA7IJSNW6661IN2EJPO8KCTLWSBP3,#1-5 In yesterday's speech May also ruled out continued membership of the customs union as this prevented Britain from negotiating trade deals with non-EU countries.,74,81,customs,1,0,1
3KA7IJSNW6661IN2EJPO8KCTLWSBP3,#1-5 In yesterday's speech May also ruled out continued membership of the customs union as this prevented Britain from negotiating trade deals with non-EU countries.,74,87,customs union,3,1,4
3KA7IJSNW6661IN2EJPO8KCTLWSBP3,#1-5 In yesterday's speech May also ruled out continued membership of the customs union as this prevented Britain from negotiating trade deals with non-EU countries.,82,87,union,1,0,1
3KA7IJSNW6661IN2EJPO8KCTLWSBP3,#1-5 In yesterday's speech May also ruled out continued membership of the customs union as this prevented Britain from negotiating trade deals with non-EU countries.,96,105,prevented,0,1,1
3KA7IJSNW6661IN2EJPO8KCTLWSBP3,#1-5 In yesterday's speech May also ruled out continued membership of the customs union as this prevented Britain from negotiating trade deals with non-EU countries.,119,130,negotiating,10,10,20
3KA7IJSNW6661IN2EJPO8KCTLWSBP3,#1-5 In yesterday's speech May also ruled out continued membership of the customs union as this prevented Britain from negotiating trade deals with non-EU countries.,119,142,negotiating trade deals,1,0,1
3KA7IJSNW6661IN2EJPO8KCTLWSBP3,#1-5 In yesterday's speech May also ruled out continued membership of the customs union as this prevented Britain from negotiating trade deals with non-EU countries.,137,142,deals,0,1,1
3KA7IJSNW6661IN2EJPO8KCTLWSBP3,#1-5 In yesterday's speech May also ruled out continued membership of the customs union as this prevented Britain from negotiating trade deals with non-EU countries.,148,164,non-EU countries,1,0,1
3KA7IJSNW6661IN2EJPO8KCTLWSBP3,"#1-6 Theresa May also said Britain's contributions to the EU budget would cease, although some contributions would be made to some pan-European schemes.",5,12,Theresa,0,1,1
3KA7IJSNW6661IN2EJPO8KCTLWSBP3,"#1-6 Theresa May also said Britain's contributions to the EU budget would cease, although some contributions would be made to some pan-European schemes.",37,50,contributions,4,6,10
3KA7IJSNW6661IN2EJPO8KCTLWSBP3,"#1-6 Theresa May also said Britain's contributions to the EU budget would cease, although some contributions would be made to some pan-European schemes.",58,67,EU budget,1,0,1
3KA7IJSNW6661IN2EJPO8KCTLWSBP3,"#1-6 Theresa May also said Britain's contributions to the EU budget would cease, although some contributions would be made to some pan-European schemes.",61,67,budget,1,0,1
3KA7IJSNW6661IN2EJPO8KCTLWSBP3,"#1-6 Theresa May also said Britain's contributions to the EU budget would cease, although some contributions would be made to some pan-European schemes.",74,79,cease,3,7,10
3KA7IJSNW6661IN2EJPO8KCTLWSBP3,"#1-6 Theresa May also said Britain's contributions to the EU budget would cease, although some contributions would be made to some pan-European schemes.",95,108,contributions,6,1,7
3KA7IJSNW6661IN2EJPO8KCTLWSBP3,"#1-6 Theresa May also said Britain's contributions to the EU budget would cease, although some contributions would be made to some pan-European schemes.",131,143,pan-European,3,1,4
3KA7IJSNW6661IN2EJPO8KCTLWSBP3,"#1-6 Theresa May also said Britain's contributions to the EU budget would cease, although some contributions would be made to some pan-European schemes.",131,151,pan-European schemes,3,2,5
3KA7IJSNW6661IN2EJPO8KCTLWSBP3,"#1-6 Theresa May also said Britain's contributions to the EU budget would cease, although some contributions would be made to some pan-European schemes.",144,151,schemes,4,3,7
3KA7IJSNW6661IN2EJPO8KCTLWSBP3,"#1-7 In her words, ""the days of Britain making vast contributions to the European Union every year will end"".",47,51,vast,1,2,3
3KA7IJSNW6661IN2EJPO8KCTLWSBP3,"#1-7 In her words, ""the days of Britain making vast contributions to the European Union every year will end"".",47,65,vast contributions,0,2,2
3KA7IJSNW6661IN2EJPO8KCTLWSBP3,"#1-7 In her words, ""the days of Britain making vast contributions to the European Union every year will end"".",52,65,contributions,3,0,3
3KA7IJSNW6661IN2EJPO8KCTLWSBP3,#1-8 The speech also covered the legal status of both UK citizens living abroad and EU citizens living in the UK.,33,45,legal status,1,2,3
3KA7IJSNW6661IN2EJPO8KCTLWSBP3,#1-8 The speech also covered the legal status of both UK citizens living abroad and EU citizens living in the UK.,73,79,abroad,1,2,3
3KA7IJSNW6661IN2EJPO8KCTLWSBP3,"#1-9 May said she wished to guarantee the status of both, but that she also sought ""reciprocity"" before doing so, and noted ""one or two"" other countries had not been willing to do so.",28,37,guarantee,4,6,10
3KA7IJSNW6661IN2EJPO8KCTLWSBP3,"#1-9 May said she wished to guarantee the status of both, but that she also sought ""reciprocity"" before doing so, and noted ""one or two"" other countries had not been willing to do so.",76,82,sought,1,1,2
3KA7IJSNW6661IN2EJPO8KCTLWSBP3,"#1-9 May said she wished to guarantee the status of both, but that she also sought ""reciprocity"" before doing so, and noted ""one or two"" other countries had not been willing to do so.",76,94,sought reciprocity,0,1,1
3KA7IJSNW6661IN2EJPO8KCTLWSBP3,"#1-9 May said she wished to guarantee the status of both, but that she also sought ""reciprocity"" before doing so, and noted ""one or two"" other countries had not been willing to do so.",84,95,reciprocity,10,8,18
3KA7IJSNW6661IN2EJPO8KCTLWSBP3,"#1-10 Following May's speech the Secretary of State for Exiting the European Union, David Davis, echoed the Prime Minister in a speech he gave to Parliament, adding ""the final deal agreed between the UK and the EU will be put to a vote in both Houses of Parliament before it takes effect"".",56,63,Exiting,3,3,6
3KA7IJSNW6661IN2EJPO8KCTLWSBP3,"#1-10 Following May's speech the Secretary of State for Exiting the European Union, David Davis, echoed the Prime Minister in a speech he gave to Parliament, adding ""the final deal agreed between the UK and the EU will be put to a vote in both Houses of Parliament before it takes effect"".",97,103,echoed,1,6,7
3KA7IJSNW6661IN2EJPO8KCTLWSBP3,"#1-10 Following May's speech the Secretary of State for Exiting the European Union, David Davis, echoed the Prime Minister in a speech he gave to Parliament, adding ""the final deal agreed between the UK and the EU will be put to a vote in both Houses of Parliament before it takes effect"".",146,156,Parliament,3,2,5
3KA7IJSNW6661IN2EJPO8KCTLWSBP3,"#1-10 Following May's speech the Secretary of State for Exiting the European Union, David Davis, echoed the Prime Minister in a speech he gave to Parliament, adding ""the final deal agreed between the UK and the EU will be put to a vote in both Houses of Parliament before it takes effect"".",244,264,Houses of Parliament,1,0,1
3KA7IJSNW6661IN2EJPO8KCTLWSBP3,"#1-10 Following May's speech the Secretary of State for Exiting the European Union, David Davis, echoed the Prime Minister in a speech he gave to Parliament, adding ""the final deal agreed between the UK and the EU will be put to a vote in both Houses of Parliament before it takes effect"".",254,264,Parliament,0,1,1
30F94FBDNRL4TAG9V0Y8DUDQAZCTBP,"#25-1 US economy adds 215,000 jobs in July; unemployment rate remains steady at 5.3% The Bureau of Labor Statistics reported that the US economy added 215,000 jobs in July.",9,16,economy,5,0,5
30F94FBDNRL4TAG9V0Y8DUDQAZCTBP,"#25-1 US economy adds 215,000 jobs in July; unemployment rate remains steady at 5.3% The Bureau of Labor Statistics reported that the US economy added 215,000 jobs in July.",44,56,unemployment,8,4,12
30F94FBDNRL4TAG9V0Y8DUDQAZCTBP,"#25-1 US economy adds 215,000 jobs in July; unemployment rate remains steady at 5.3% The Bureau of Labor Statistics reported that the US economy added 215,000 jobs in July.",44,61,unemployment rate,0,2,2
30F94FBDNRL4TAG9V0Y8DUDQAZCTBP,"#25-1 US economy adds 215,000 jobs in July; unemployment rate remains steady at 5.3% The Bureau of Labor Statistics reported that the US economy added 215,000 jobs in July.",62,69,remains,1,0,1
30F94FBDNRL4TAG9V0Y8DUDQAZCTBP,"#25-1 US economy adds 215,000 jobs in July; unemployment rate remains steady at 5.3% The Bureau of Labor Statistics reported that the US economy added 215,000 jobs in July.",62,76,remains steady,0,1,1
30F94FBDNRL4TAG9V0Y8DUDQAZCTBP,"#25-1 US economy adds 215,000 jobs in July; unemployment rate remains steady at 5.3% The Bureau of Labor Statistics reported that the US economy added 215,000 jobs in July.",70,76,steady,0,3,3
30F94FBDNRL4TAG9V0Y8DUDQAZCTBP,"#25-1 US economy adds 215,000 jobs in July; unemployment rate remains steady at 5.3% The Bureau of Labor Statistics reported that the US economy added 215,000 jobs in July.",89,95,Bureau,2,1,3
30F94FBDNRL4TAG9V0Y8DUDQAZCTBP,"#25-1 US economy adds 215,000 jobs in July; unemployment rate remains steady at 5.3% The Bureau of Labor Statistics reported that the US economy added 215,000 jobs in July.",89,115,Bureau of Labor Statistics,1,0,1
30F94FBDNRL4TAG9V0Y8DUDQAZCTBP,"#25-1 US economy adds 215,000 jobs in July; unemployment rate remains steady at 5.3% The Bureau of Labor Statistics reported that the US economy added 215,000 jobs in July.",105,115,Statistics,1,1,2
30F94FBDNRL4TAG9V0Y8DUDQAZCTBP,"#25-2 Job growth has averaged 242,000 per month for the past year.",10,16,growth,1,0,1
30F94FBDNRL4TAG9V0Y8DUDQAZCTBP,"#25-2 Job growth has averaged 242,000 per month for the past year.",21,29,averaged,3,2,5
30F94FBDNRL4TAG9V0Y8DUDQAZCTBP,"#25-3 Continuing a trend of steady employment growth, the United States economy added 215,000 jobs in July, the Bureau of Labor Statistics said on Friday.",6,16,Continuing,0,1,1
30F94FBDNRL4TAG9V0Y8DUDQAZCTBP,"#25-3 Continuing a trend of steady employment growth, the United States economy added 215,000 jobs in July, the Bureau of Labor Statistics said on Friday.",17,24,a trend,1,0,1
30F94FBDNRL4TAG9V0Y8DUDQAZCTBP,"#25-3 Continuing a trend of steady employment growth, the United States economy added 215,000 jobs in July, the Bureau of Labor Statistics said on Friday.",19,24,trend,2,4,6
30F94FBDNRL4TAG9V0Y8DUDQAZCTBP,"#25-3 Continuing a trend of steady employment growth, the United States economy added 215,000 jobs in July, the Bureau of Labor Statistics said on Friday.",28,34,steady,3,3,6
30F94FBDNRL4TAG9V0Y8DUDQAZCTBP,"#25-3 Continuing a trend of steady employment growth, the United States economy added 215,000 jobs in July, the Bureau of Labor Statistics said on Friday.",28,52,steady employment growth,0,1,1
30F94FBDNRL4TAG9V0Y8DUDQAZCTBP,"#25-3 Continuing a trend of steady employment growth, the United States economy added 215,000 jobs in July, the Bureau of Labor Statistics said on Friday.",35,45,employment,1,1,2
30F94FBDNRL4TAG9V0Y8DUDQAZCTBP,"#25-3 Continuing a trend of steady employment growth, the United States economy added 215,000 jobs in July, the Bureau of Labor Statistics said on Friday.",72,79,economy,1,1,2
30F94FBDNRL4TAG9V0Y8DUDQAZCTBP,"#25-3 Continuing a trend of steady employment growth, the United States economy added 215,000 jobs in July, the Bureau of Labor Statistics said on Friday.",128,138,Statistics,3,0,3
30F94FBDNRL4TAG9V0Y8DUDQAZCTBP,#25-4 The unemployment rate remained unchanged at 5.3%.,10,22,unemployment,0,1,1
30F94FBDNRL4TAG9V0Y8DUDQAZCTBP,#25-4 The unemployment rate remained unchanged at 5.3%.,28,36,remained,0,1,1
30F94FBDNRL4TAG9V0Y8DUDQAZCTBP,#25-4 The unemployment rate remained unchanged at 5.3%.,37,46,unchanged,0,1,1
30F94FBDNRL4TAG9V0Y8DUDQAZCTBP,"#25-5 ""Job growth is quite strong,"" stated Jim O'Sullivan, chief economist at High Frequency Economics, a data analysis firm in New York.",21,33,quite strong,1,0,1
30F94FBDNRL4TAG9V0Y8DUDQAZCTBP,"#25-5 ""Job growth is quite strong,"" stated Jim O'Sullivan, chief economist at High Frequency Economics, a data analysis firm in New York.",43,56,Jim OSullivan,0,1,1
30F94FBDNRL4TAG9V0Y8DUDQAZCTBP,"#25-5 ""Job growth is quite strong,"" stated Jim O'Sullivan, chief economist at High Frequency Economics, a data analysis firm in New York.",59,64,chief,2,0,2
30F94FBDNRL4TAG9V0Y8DUDQAZCTBP,"#25-5 ""Job growth is quite strong,"" stated Jim O'Sullivan, chief economist at High Frequency Economics, a data analysis firm in New York.",65,74,economist,7,3,10
30F94FBDNRL4TAG9V0Y8DUDQAZCTBP,"#25-5 ""Job growth is quite strong,"" stated Jim O'Sullivan, chief economist at High Frequency Economics, a data analysis firm in New York.",93,102,Economics,0,1,1
30F94FBDNRL4TAG9V0Y8DUDQAZCTBP,"#25-5 ""Job growth is quite strong,"" stated Jim O'Sullivan, chief economist at High Frequency Economics, a data analysis firm in New York.",106,110,data,1,0,1
30F94FBDNRL4TAG9V0Y8DUDQAZCTBP,"#25-5 ""Job growth is quite strong,"" stated Jim O'Sullivan, chief economist at High Frequency Economics, a data analysis firm in New York.",106,119,data analysis,1,1,2
30F94FBDNRL4TAG9V0Y8DUDQAZCTBP,"#25-5 ""Job growth is quite strong,"" stated Jim O'Sullivan, chief economist at High Frequency Economics, a data analysis firm in New York.",106,124,data analysis firm,2,1,3
30F94FBDNRL4TAG9V0Y8DUDQAZCTBP,"#25-5 ""Job growth is quite strong,"" stated Jim O'Sullivan, chief economist at High Frequency Economics, a data analysis firm in New York.",111,119,analysis,5,2,7
30F94FBDNRL4TAG9V0Y8DUDQAZCTBP,"#25-5 ""Job growth is quite strong,"" stated Jim O'Sullivan, chief economist at High Frequency Economics, a data analysis firm in New York.",120,124,firm,1,0,1
30F94FBDNRL4TAG9V0Y8DUDQAZCTBP,"#25-6 ""This pace of employment growth is clearly strong enough to keep the unemployment rate trending down.""",12,16,pace,1,1,2
30F94FBDNRL4TAG9V0Y8DUDQAZCTBP,"#25-6 ""This pace of employment growth is clearly strong enough to keep the unemployment rate trending down.""",20,37,employment growth,1,0,1
30F94FBDNRL4TAG9V0Y8DUDQAZCTBP,"#25-6 ""This pace of employment growth is clearly strong enough to keep the unemployment rate trending down.""",93,101,trending,1,5,6
30F94FBDNRL4TAG9V0Y8DUDQAZCTBP,"#25-6 ""This pace of employment growth is clearly strong enough to keep the unemployment rate trending down.""",93,106,trending down,1,1,2
30F94FBDNRL4TAG9V0Y8DUDQAZCTBP,"#25-7 Average hourly earnings rose 0.2%, marking a rebound after growth stalled in June.",21,29,earnings,2,1,3
30F94FBDNRL4TAG9V0Y8DUDQAZCTBP,"#25-7 Average hourly earnings rose 0.2%, marking a rebound after growth stalled in June.",30,34,rose,0,1,1
30F94FBDNRL4TAG9V0Y8DUDQAZCTBP,"#25-7 Average hourly earnings rose 0.2%, marking a rebound after growth stalled in June.",51,58,rebound,9,7,16
30F94FBDNRL4TAG9V0Y8DUDQAZCTBP,"#25-7 Average hourly earnings rose 0.2%, marking a rebound after growth stalled in June.",72,79,stalled,3,7,10
30F94FBDNRL4TAG9V0Y8DUDQAZCTBP,"#25-8 Wages have grown by 2.1% over the past year, below the Federal Reserve's target of 3.5% annual wage growth, and not much more than the underlying rate of inflation.",6,11,Wages,1,1,2
30F94FBDNRL4TAG9V0Y8DUDQAZCTBP,"#25-8 Wages have grown by 2.1% over the past year, below the Federal Reserve's target of 3.5% annual wage growth, and not much more than the underlying rate of inflation.",61,68,Federal,0,1,1
30F94FBDNRL4TAG9V0Y8DUDQAZCTBP,"#25-8 Wages have grown by 2.1% over the past year, below the Federal Reserve's target of 3.5% annual wage growth, and not much more than the underlying rate of inflation.",61,76,Federal Reserve,1,0,1
30F94FBDNRL4TAG9V0Y8DUDQAZCTBP,"#25-8 Wages have grown by 2.1% over the past year, below the Federal Reserve's target of 3.5% annual wage growth, and not much more than the underlying rate of inflation.",94,100,annual,2,1,3
30F94FBDNRL4TAG9V0Y8DUDQAZCTBP,"#25-8 Wages have grown by 2.1% over the past year, below the Federal Reserve's target of 3.5% annual wage growth, and not much more than the underlying rate of inflation.",94,112,annual wage growth,2,0,2
30F94FBDNRL4TAG9V0Y8DUDQAZCTBP,"#25-8 Wages have grown by 2.1% over the past year, below the Federal Reserve's target of 3.5% annual wage growth, and not much more than the underlying rate of inflation.",101,105,wage,0,1,1
30F94FBDNRL4TAG9V0Y8DUDQAZCTBP,"#25-8 Wages have grown by 2.1% over the past year, below the Federal Reserve's target of 3.5% annual wage growth, and not much more than the underlying rate of inflation.",141,151,underlying,9,7,16
30F94FBDNRL4TAG9V0Y8DUDQAZCTBP,"#25-8 Wages have grown by 2.1% over the past year, below the Federal Reserve's target of 3.5% annual wage growth, and not much more than the underlying rate of inflation.",141,156,underlying rate,0,1,1
30F94FBDNRL4TAG9V0Y8DUDQAZCTBP,"#25-8 Wages have grown by 2.1% over the past year, below the Federal Reserve's target of 3.5% annual wage growth, and not much more than the underlying rate of inflation.",141,169,underlying rate of inflation,1,0,1
30F94FBDNRL4TAG9V0Y8DUDQAZCTBP,"#25-8 Wages have grown by 2.1% over the past year, below the Federal Reserve's target of 3.5% annual wage growth, and not much more than the underlying rate of inflation.",160,169,inflation,8,7,15
3S1WOPCJFGU8MAWOTXMUCWW2FUZJEB,"#41-26 Found near the German border, the migrants were from Afghanistan, Syria, and Bangladesh.",29,35,border,1,0,1
3S1WOPCJFGU8MAWOTXMUCWW2FUZJEB,"#41-26 Found near the German border, the migrants were from Afghanistan, Syria, and Bangladesh.",41,49,migrants,7,9,16
3S1WOPCJFGU8MAWOTXMUCWW2FUZJEB,"#41-26 Found near the German border, the migrants were from Afghanistan, Syria, and Bangladesh.",60,94,"Afghanistan, Syria, and Bangladesh",1,0,1
3S1WOPCJFGU8MAWOTXMUCWW2FUZJEB,"#41-26 Found near the German border, the migrants were from Afghanistan, Syria, and Bangladesh.",73,78,Syria,0,1,1
3S1WOPCJFGU8MAWOTXMUCWW2FUZJEB,"#42-1 Biologist Nick Bos tells Wikinews about 'self-medicating' ants Nick Bos, of the University of Helsinki, studies ""the amazing adaptations social insects have evolved in order to fight the extreme parasite pressure they experience"".",6,15,Biologist,5,1,6
3S1WOPCJFGU8MAWOTXMUCWW2FUZJEB,"#42-1 Biologist Nick Bos tells Wikinews about 'self-medicating' ants Nick Bos, of the University of Helsinki, studies ""the amazing adaptations social insects have evolved in order to fight the extreme parasite pressure they experience"".",6,24,Biologist Nick Bos,0,1,1
3S1WOPCJFGU8MAWOTXMUCWW2FUZJEB,"#42-1 Biologist Nick Bos tells Wikinews about 'self-medicating' ants Nick Bos, of the University of Helsinki, studies ""the amazing adaptations social insects have evolved in order to fight the extreme parasite pressure they experience"".",31,39,Wikinews,1,0,1
3S1WOPCJFGU8MAWOTXMUCWW2FUZJEB,"#42-1 Biologist Nick Bos tells Wikinews about 'self-medicating' ants Nick Bos, of the University of Helsinki, studies ""the amazing adaptations social insects have evolved in order to fight the extreme parasite pressure they experience"".",47,62,self-medicating,7,1,8
3S1WOPCJFGU8MAWOTXMUCWW2FUZJEB,"#42-1 Biologist Nick Bos tells Wikinews about 'self-medicating' ants Nick Bos, of the University of Helsinki, studies ""the amazing adaptations social insects have evolved in order to fight the extreme parasite pressure they experience"".",64,68,ants,0,1,1
3S1WOPCJFGU8MAWOTXMUCWW2FUZJEB,"#42-1 Biologist Nick Bos tells Wikinews about 'self-medicating' ants Nick Bos, of the University of Helsinki, studies ""the amazing adaptations social insects have evolved in order to fight the extreme parasite pressure they experience"".",86,108,University of Helsinki,1,0,1
3S1WOPCJFGU8MAWOTXMUCWW2FUZJEB,"#42-1 Biologist Nick Bos tells Wikinews about 'self-medicating' ants Nick Bos, of the University of Helsinki, studies ""the amazing adaptations social insects have evolved in order to fight the extreme parasite pressure they experience"".",100,108,Helsinki,0,1,1
3S1WOPCJFGU8MAWOTXMUCWW2FUZJEB,"#42-1 Biologist Nick Bos tells Wikinews about 'self-medicating' ants Nick Bos, of the University of Helsinki, studies ""the amazing adaptations social insects have evolved in order to fight the extreme parasite pressure they experience"".",123,142,amazing adaptations,1,1,2
3S1WOPCJFGU8MAWOTXMUCWW2FUZJEB,"#42-1 Biologist Nick Bos tells Wikinews about 'self-medicating' ants Nick Bos, of the University of Helsinki, studies ""the amazing adaptations social insects have evolved in order to fight the extreme parasite pressure they experience"".",131,142,adaptations,9,9,18
3S1WOPCJFGU8MAWOTXMUCWW2FUZJEB,"#42-1 Biologist Nick Bos tells Wikinews about 'self-medicating' ants Nick Bos, of the University of Helsinki, studies ""the amazing adaptations social insects have evolved in order to fight the extreme parasite pressure they experience"".",143,157,social insects,1,2,3
3S1WOPCJFGU8MAWOTXMUCWW2FUZJEB,"#42-1 Biologist Nick Bos tells Wikinews about 'self-medicating' ants Nick Bos, of the University of Helsinki, studies ""the amazing adaptations social insects have evolved in order to fight the extreme parasite pressure they experience"".",163,170,evolved,2,3,5
3S1WOPCJFGU8MAWOTXMUCWW2FUZJEB,"#42-1 Biologist Nick Bos tells Wikinews about 'self-medicating' ants Nick Bos, of the University of Helsinki, studies ""the amazing adaptations social insects have evolved in order to fight the extreme parasite pressure they experience"".",193,200,extreme,1,0,1
3S1WOPCJFGU8MAWOTXMUCWW2FUZJEB,"#42-1 Biologist Nick Bos tells Wikinews about 'self-medicating' ants Nick Bos, of the University of Helsinki, studies ""the amazing adaptations social insects have evolved in order to fight the extreme parasite pressure they experience"".",193,218,extreme parasite pressure,0,1,1
3S1WOPCJFGU8MAWOTXMUCWW2FUZJEB,"#42-1 Biologist Nick Bos tells Wikinews about 'self-medicating' ants Nick Bos, of the University of Helsinki, studies ""the amazing adaptations social insects have evolved in order to fight the extreme parasite pressure they experience"".",201,209,parasite,9,5,14
3S1WOPCJFGU8MAWOTXMUCWW2FUZJEB,"#42-1 Biologist Nick Bos tells Wikinews about 'self-medicating' ants Nick Bos, of the University of Helsinki, studies ""the amazing adaptations social insects have evolved in order to fight the extreme parasite pressure they experience"".",201,218,parasite pressure,1,2,3
3S1WOPCJFGU8MAWOTXMUCWW2FUZJEB,"#42-1 Biologist Nick Bos tells Wikinews about 'self-medicating' ants Nick Bos, of the University of Helsinki, studies ""the amazing adaptations social insects have evolved in order to fight the extreme parasite pressure they experience"".",224,234,experience,0,1,1
3S1WOPCJFGU8MAWOTXMUCWW2FUZJEB,#42-2 In a recently-accepted Evolution paper Bos and colleagues describe ants appearing to self-medicate.,11,28,recently-accepted,1,1,2
3S1WOPCJFGU8MAWOTXMUCWW2FUZJEB,#42-2 In a recently-accepted Evolution paper Bos and colleagues describe ants appearing to self-medicate.,29,38,Evolution,4,2,6
3S1WOPCJFGU8MAWOTXMUCWW2FUZJEB,#42-2 In a recently-accepted Evolution paper Bos and colleagues describe ants appearing to self-medicate.,53,63,colleagues,4,3,7
3S1WOPCJFGU8MAWOTXMUCWW2FUZJEB,#42-2 In a recently-accepted Evolution paper Bos and colleagues describe ants appearing to self-medicate.,73,77,ants,0,1,1
3S1WOPCJFGU8MAWOTXMUCWW2FUZJEB,#42-2 In a recently-accepted Evolution paper Bos and colleagues describe ants appearing to self-medicate.,78,87,appearing,1,0,1
3S1WOPCJFGU8MAWOTXMUCWW2FUZJEB,#42-2 In a recently-accepted Evolution paper Bos and colleagues describe ants appearing to self-medicate.,91,104,self-medicate,3,3,6
3S1WOPCJFGU8MAWOTXMUCWW2FUZJEB,"#42-3 I have no doubt that as time goes on, there will be more and more cases documented.",78,88,documented,3,4,7
3S1WOPCJFGU8MAWOTXMUCWW2FUZJEB,"#42-4 The team used Formica fusca, an ant species that can form thousand-strong colonies.",20,27,Formica,1,0,1
3S1WOPCJFGU8MAWOTXMUCWW2FUZJEB,"#42-4 The team used Formica fusca, an ant species that can form thousand-strong colonies.",20,33,Formica fusca,2,1,3
3S1WOPCJFGU8MAWOTXMUCWW2FUZJEB,"#42-4 The team used Formica fusca, an ant species that can form thousand-strong colonies.",28,33,fusca,1,1,2
3S1WOPCJFGU8MAWOTXMUCWW2FUZJEB,"#42-4 The team used Formica fusca, an ant species that can form thousand-strong colonies.",38,41,ant,0,1,1
3S1WOPCJFGU8MAWOTXMUCWW2FUZJEB,"#42-4 The team used Formica fusca, an ant species that can form thousand-strong colonies.",42,49,species,1,0,1
3S1WOPCJFGU8MAWOTXMUCWW2FUZJEB,"#42-4 The team used Formica fusca, an ant species that can form thousand-strong colonies.",64,79,thousand-strong,1,3,4
3S1WOPCJFGU8MAWOTXMUCWW2FUZJEB,"#42-4 The team used Formica fusca, an ant species that can form thousand-strong colonies.",80,88,colonies,4,1,5
3S1WOPCJFGU8MAWOTXMUCWW2FUZJEB,"#42-5 This common black ant eats other insects, and also aphid honeydew.",57,62,aphid,6,2,8
3S1WOPCJFGU8MAWOTXMUCWW2FUZJEB,"#42-5 This common black ant eats other insects, and also aphid honeydew.",57,71,aphid honeydew,2,3,5
3S1WOPCJFGU8MAWOTXMUCWW2FUZJEB,"#42-5 This common black ant eats other insects, and also aphid honeydew.",63,71,honeydew,0,2,2
3S1WOPCJFGU8MAWOTXMUCWW2FUZJEB,#42-6 It often nests in tree stumps or under rocks and foraging workers can sometimes be spotted climbing trees.,15,20,nests,0,2,2
3S1WOPCJFGU8MAWOTXMUCWW2FUZJEB,#42-6 It often nests in tree stumps or under rocks and foraging workers can sometimes be spotted climbing trees.,24,35,tree stumps,1,1,2
3S1WOPCJFGU8MAWOTXMUCWW2FUZJEB,#42-6 It often nests in tree stumps or under rocks and foraging workers can sometimes be spotted climbing trees.,29,35,stumps,2,4,6
3S1WOPCJFGU8MAWOTXMUCWW2FUZJEB,#42-6 It often nests in tree stumps or under rocks and foraging workers can sometimes be spotted climbing trees.,55,63,foraging,6,6,12
3S1WOPCJFGU8MAWOTXMUCWW2FUZJEB,#42-6 It often nests in tree stumps or under rocks and foraging workers can sometimes be spotted climbing trees.,55,71,foraging workers,1,2,3
3S1WOPCJFGU8MAWOTXMUCWW2FUZJEB,#42-6 It often nests in tree stumps or under rocks and foraging workers can sometimes be spotted climbing trees.,89,96,spotted,0,6,6
3S1WOPCJFGU8MAWOTXMUCWW2FUZJEB,"#42-7 Some ants were infected with Beauveria bassiana, a fungus.",11,15,ants,0,1,1
3S1WOPCJFGU8MAWOTXMUCWW2FUZJEB,"#42-7 Some ants were infected with Beauveria bassiana, a fungus.",35,53,Beauveria bassiana,4,1,5
3S1WOPCJFGU8MAWOTXMUCWW2FUZJEB,"#42-7 Some ants were infected with Beauveria bassiana, a fungus.",45,53,bassiana,0,1,1
3S1WOPCJFGU8MAWOTXMUCWW2FUZJEB,"#42-7 Some ants were infected with Beauveria bassiana, a fungus.",55,63,a fungus,1,0,1
3S1WOPCJFGU8MAWOTXMUCWW2FUZJEB,"#42-7 Some ants were infected with Beauveria bassiana, a fungus.",57,63,fungus,6,1,7
3RWO3EJELHA5OK5ACMWZ28ZKZK11PA,"#15-1 Putin calls US troops in Poland 'a threat' Reports yesterday indicated Russian President Vladimir Putin views the arrival of US troops in Poland as ""a threat"".",21,27,troops,0,2,2
3RWO3EJELHA5OK5ACMWZ28ZKZK11PA,"#15-1 Putin calls US troops in Poland 'a threat' Reports yesterday indicated Russian President Vladimir Putin views the arrival of US troops in Poland as ""a threat"".",41,47,threat,2,2,4
3RWO3EJELHA5OK5ACMWZ28ZKZK11PA,"#15-1 Putin calls US troops in Poland 'a threat' Reports yesterday indicated Russian President Vladimir Putin views the arrival of US troops in Poland as ""a threat"".",57,66,yesterday,0,1,1
3RWO3EJELHA5OK5ACMWZ28ZKZK11PA,"#15-1 Putin calls US troops in Poland 'a threat' Reports yesterday indicated Russian President Vladimir Putin views the arrival of US troops in Poland as ""a threat"".",67,76,indicated,4,4,8
3RWO3EJELHA5OK5ACMWZ28ZKZK11PA,"#15-1 Putin calls US troops in Poland 'a threat' Reports yesterday indicated Russian President Vladimir Putin views the arrival of US troops in Poland as ""a threat"".",155,163,a threat,1,1,2
3RWO3EJELHA5OK5ACMWZ28ZKZK11PA,"#15-1 Putin calls US troops in Poland 'a threat' Reports yesterday indicated Russian President Vladimir Putin views the arrival of US troops in Poland as ""a threat"".",157,163,threat,1,3,4
3RWO3EJELHA5OK5ACMWZ28ZKZK11PA,"#15-2 US troops and tanks in Poland in 2015, as part of an earlier deployment under Operation Atlantic Resolve.",67,77,deployment,10,10,20
3RWO3EJELHA5OK5ACMWZ28ZKZK11PA,"#15-2 US troops and tanks in Poland in 2015, as part of an earlier deployment under Operation Atlantic Resolve.",84,93,Operation,1,0,1
3RWO3EJELHA5OK5ACMWZ28ZKZK11PA,"#15-2 US troops and tanks in Poland in 2015, as part of an earlier deployment under Operation Atlantic Resolve.",84,110,Operation Atlantic Resolve,1,2,3
3RWO3EJELHA5OK5ACMWZ28ZKZK11PA,"#15-2 US troops and tanks in Poland in 2015, as part of an earlier deployment under Operation Atlantic Resolve.",103,110,Resolve,3,1,4
3RWO3EJELHA5OK5ACMWZ28ZKZK11PA,"#15-3 Earlier this week around a quarter of 4,000 troops earmarked for Poland crossed into Poland from Germany.",33,40,quarter,2,2,4
3RWO3EJELHA5OK5ACMWZ28ZKZK11PA,"#15-3 Earlier this week around a quarter of 4,000 troops earmarked for Poland crossed into Poland from Germany.",50,56,troops,1,0,1
3RWO3EJELHA5OK5ACMWZ28ZKZK11PA,"#15-3 Earlier this week around a quarter of 4,000 troops earmarked for Poland crossed into Poland from Germany.",57,66,earmarked,8,10,18
3RWO3EJELHA5OK5ACMWZ28ZKZK11PA,"#15-4 Also included were trucks, tanks, and Humvees.",44,51,Humvees,8,3,11
3RWO3EJELHA5OK5ACMWZ28ZKZK11PA,"#15-5 Many are set to be based in Żagań, where Polish Prime Minister Beata Szydło and Defence Minister Antoni Macierewicz are scheduled to ceremonially welcome them tomorrow.",25,30,based,1,0,1
3RWO3EJELHA5OK5ACMWZ28ZKZK11PA,"#15-5 Many are set to be based in Żagań, where Polish Prime Minister Beata Szydło and Defence Minister Antoni Macierewicz are scheduled to ceremonially welcome them tomorrow.",34,39,Żagań,2,0,2
3RWO3EJELHA5OK5ACMWZ28ZKZK11PA,"#15-5 Many are set to be based in Żagań, where Polish Prime Minister Beata Szydło and Defence Minister Antoni Macierewicz are scheduled to ceremonially welcome them tomorrow.",47,68,Polish Prime Minister,1,0,1
3RWO3EJELHA5OK5ACMWZ28ZKZK11PA,"#15-5 Many are set to be based in Żagań, where Polish Prime Minister Beata Szydło and Defence Minister Antoni Macierewicz are scheduled to ceremonially welcome them tomorrow.",54,68,Prime Minister,1,0,1
3RWO3EJELHA5OK5ACMWZ28ZKZK11PA,"#15-5 Many are set to be based in Żagań, where Polish Prime Minister Beata Szydło and Defence Minister Antoni Macierewicz are scheduled to ceremonially welcome them tomorrow.",86,102,Defence Minister,1,0,1
3RWO3EJELHA5OK5ACMWZ28ZKZK11PA,"#15-5 Many are set to be based in Żagań, where Polish Prime Minister Beata Szydło and Defence Minister Antoni Macierewicz are scheduled to ceremonially welcome them tomorrow.",110,121,Macierewicz,1,0,1
3RWO3EJELHA5OK5ACMWZ28ZKZK11PA,"#15-5 Many are set to be based in Żagań, where Polish Prime Minister Beata Szydło and Defence Minister Antoni Macierewicz are scheduled to ceremonially welcome them tomorrow.",126,135,scheduled,4,3,7
3RWO3EJELHA5OK5ACMWZ28ZKZK11PA,"#15-5 Many are set to be based in Żagań, where Polish Prime Minister Beata Szydło and Defence Minister Antoni Macierewicz are scheduled to ceremonially welcome them tomorrow.",139,151,ceremonially,10,9,19
3RWO3EJELHA5OK5ACMWZ28ZKZK11PA,"#15-5 Many are set to be based in Żagań, where Polish Prime Minister Beata Szydło and Defence Minister Antoni Macierewicz are scheduled to ceremonially welcome them tomorrow.",165,173,tomorrow,0,1,1
3RWO3EJELHA5OK5ACMWZ28ZKZK11PA,"#15-6 Part of Operation Atlantic Resolve, the deployment is set to include Abrams tanks, Bradley Fighting Vehicles, and Paladin artillery.",46,56,deployment,3,4,7
3RWO3EJELHA5OK5ACMWZ28ZKZK11PA,"#15-6 Part of Operation Atlantic Resolve, the deployment is set to include Abrams tanks, Bradley Fighting Vehicles, and Paladin artillery.",75,87,Abrams tanks,0,1,1
3RWO3EJELHA5OK5ACMWZ28ZKZK11PA,"#15-6 Part of Operation Atlantic Resolve, the deployment is set to include Abrams tanks, Bradley Fighting Vehicles, and Paladin artillery.",89,114,Bradley Fighting Vehicles,1,1,2
3RWO3EJELHA5OK5ACMWZ28ZKZK11PA,"#15-6 Part of Operation Atlantic Resolve, the deployment is set to include Abrams tanks, Bradley Fighting Vehicles, and Paladin artillery.",106,114,Vehicles,1,0,1
3RWO3EJELHA5OK5ACMWZ28ZKZK11PA,"#15-6 Part of Operation Atlantic Resolve, the deployment is set to include Abrams tanks, Bradley Fighting Vehicles, and Paladin artillery.",120,127,Paladin,1,0,1
3RWO3EJELHA5OK5ACMWZ28ZKZK11PA,"#15-6 Part of Operation Atlantic Resolve, the deployment is set to include Abrams tanks, Bradley Fighting Vehicles, and Paladin artillery.",120,137,Paladin artillery,2,2,4
3RWO3EJELHA5OK5ACMWZ28ZKZK11PA,"#15-6 Part of Operation Atlantic Resolve, the deployment is set to include Abrams tanks, Bradley Fighting Vehicles, and Paladin artillery.",128,137,artillery,9,7,16
3RWO3EJELHA5OK5ACMWZ28ZKZK11PA,#15-7 It is the largest deployment of US troops to Europe since the Cold War ended.,24,34,deployment,4,2,6
3RWO3EJELHA5OK5ACMWZ28ZKZK11PA,#15-7 It is the largest deployment of US troops to Europe since the Cold War ended.,68,76,Cold War,1,2,3
3F6045TU7DP2L2SYZAFVVOHOSS799W,"#9-6 The Ministry of Justice and state-run news outlet Agência Brasil said the latest riot started at around 5:00 p.m., local time, on Saturday.",21,28,Justice,0,1,1
3F6045TU7DP2L2SYZAFVVOHOSS799W,"#9-6 The Ministry of Justice and state-run news outlet Agência Brasil said the latest riot started at around 5:00 p.m., local time, on Saturday.",33,42,state-run,3,3,6
3F6045TU7DP2L2SYZAFVVOHOSS799W,"#9-6 The Ministry of Justice and state-run news outlet Agência Brasil said the latest riot started at around 5:00 p.m., local time, on Saturday.",43,54,news outlet,1,0,1
3F6045TU7DP2L2SYZAFVVOHOSS799W,"#9-6 The Ministry of Justice and state-run news outlet Agência Brasil said the latest riot started at around 5:00 p.m., local time, on Saturday.",48,54,outlet,2,1,3
3F6045TU7DP2L2SYZAFVVOHOSS799W,"#9-6 The Ministry of Justice and state-run news outlet Agência Brasil said the latest riot started at around 5:00 p.m., local time, on Saturday.",55,62,Agência,1,0,1
3F6045TU7DP2L2SYZAFVVOHOSS799W,"#9-6 The Ministry of Justice and state-run news outlet Agência Brasil said the latest riot started at around 5:00 p.m., local time, on Saturday.",55,69,Agência Brasil,1,0,1
3F6045TU7DP2L2SYZAFVVOHOSS799W,"#9-6 The Ministry of Justice and state-run news outlet Agência Brasil said the latest riot started at around 5:00 p.m., local time, on Saturday.",86,90,riot,3,8,11
3F6045TU7DP2L2SYZAFVVOHOSS799W,#9-7 It continued until the security forces quelled the riot on Sunday at around 7:15 a.m..,8,17,continued,0,1,1
3F6045TU7DP2L2SYZAFVVOHOSS799W,#9-7 It continued until the security forces quelled the riot on Sunday at around 7:15 a.m..,28,36,security,1,0,1
3F6045TU7DP2L2SYZAFVVOHOSS799W,#9-7 It continued until the security forces quelled the riot on Sunday at around 7:15 a.m..,28,43,security forces,1,0,1
3F6045TU7DP2L2SYZAFVVOHOSS799W,#9-7 It continued until the security forces quelled the riot on Sunday at around 7:15 a.m..,28,51,security forces quelled,1,0,1
3F6045TU7DP2L2SYZAFVVOHOSS799W,#9-7 It continued until the security forces quelled the riot on Sunday at around 7:15 a.m..,44,51,quelled,10,10,20
3F6045TU7DP2L2SYZAFVVOHOSS799W,#9-7 It continued until the security forces quelled the riot on Sunday at around 7:15 a.m..,56,60,riot,0,2,2
3F6045TU7DP2L2SYZAFVVOHOSS799W,#9-8 Agence France Presse (AFP) and Rio de Janeiro newspaper O Globo report that the gang members of the Primeiro Comando da Capital (PCC) and Comando Vermelho were the latest riot's participants.,19,25,Presse,1,0,1
3F6045TU7DP2L2SYZAFVVOHOSS799W,#9-8 Agence France Presse (AFP) and Rio de Janeiro newspaper O Globo report that the gang members of the Primeiro Comando da Capital (PCC) and Comando Vermelho were the latest riot's participants.,43,50,Janeiro,2,0,2
3F6045TU7DP2L2SYZAFVVOHOSS799W,#9-8 Agence France Presse (AFP) and Rio de Janeiro newspaper O Globo report that the gang members of the Primeiro Comando da Capital (PCC) and Comando Vermelho were the latest riot's participants.,85,89,gang,0,2,2
3F6045TU7DP2L2SYZAFVVOHOSS799W,#9-8 Agence France Presse (AFP) and Rio de Janeiro newspaper O Globo report that the gang members of the Primeiro Comando da Capital (PCC) and Comando Vermelho were the latest riot's participants.,85,97,gang members,1,0,1
3F6045TU7DP2L2SYZAFVVOHOSS799W,#9-8 Agence France Presse (AFP) and Rio de Janeiro newspaper O Globo report that the gang members of the Primeiro Comando da Capital (PCC) and Comando Vermelho were the latest riot's participants.,105,113,Primeiro,2,1,3
3F6045TU7DP2L2SYZAFVVOHOSS799W,#9-8 Agence France Presse (AFP) and Rio de Janeiro newspaper O Globo report that the gang members of the Primeiro Comando da Capital (PCC) and Comando Vermelho were the latest riot's participants.,105,132,Primeiro Comando da Capital,1,0,1
3F6045TU7DP2L2SYZAFVVOHOSS799W,#9-8 Agence France Presse (AFP) and Rio de Janeiro newspaper O Globo report that the gang members of the Primeiro Comando da Capital (PCC) and Comando Vermelho were the latest riot's participants.,143,159,Comando Vermelho,2,0,2
3F6045TU7DP2L2SYZAFVVOHOSS799W,#9-8 Agence France Presse (AFP) and Rio de Janeiro newspaper O Globo report that the gang members of the Primeiro Comando da Capital (PCC) and Comando Vermelho were the latest riot's participants.,151,159,Vermelho,1,0,1
3F6045TU7DP2L2SYZAFVVOHOSS799W,#9-8 Agence France Presse (AFP) and Rio de Janeiro newspaper O Globo report that the gang members of the Primeiro Comando da Capital (PCC) and Comando Vermelho were the latest riot's participants.,176,181,riots,0,1,1
3F6045TU7DP2L2SYZAFVVOHOSS799W,#9-8 Agence France Presse (AFP) and Rio de Janeiro newspaper O Globo report that the gang members of the Primeiro Comando da Capital (PCC) and Comando Vermelho were the latest riot's participants.,183,195,participants,3,1,4
3F6045TU7DP2L2SYZAFVVOHOSS799W,#9-9 CNN reports that its participants were PCC and Sindicato do Crime do RN.,26,38,participants,2,1,3
3F6045TU7DP2L2SYZAFVVOHOSS799W,#9-9 CNN reports that its participants were PCC and Sindicato do Crime do RN.,52,70,Sindicato do Crime,1,0,1
3F6045TU7DP2L2SYZAFVVOHOSS799W,#9-10 The gangs had been housed in separate parts of the prison.,16,31,had been housed,0,1,1
3F6045TU7DP2L2SYZAFVVOHOSS799W,#9-10 The gangs had been housed in separate parts of the prison.,25,31,housed,1,3,4
3F6045TU7DP2L2SYZAFVVOHOSS799W,#9-10 The gangs had been housed in separate parts of the prison.,35,43,separate,1,2,3
3F6045TU7DP2L2SYZAFVVOHOSS799W,#9-10 The gangs had been housed in separate parts of the prison.,57,63,prison,1,1,2
3F6045TU7DP2L2SYZAFVVOHOSS799W,#9-11 Six of the ringleaders have been captured and sent to other facilities.,17,28,ringleaders,10,10,20
3F6045TU7DP2L2SYZAFVVOHOSS799W,#9-11 Six of the ringleaders have been captured and sent to other facilities.,39,47,captured,2,5,7
3F6045TU7DP2L2SYZAFVVOHOSS799W,#9-11 Six of the ringleaders have been captured and sent to other facilities.,66,76,facilities,4,5,9
3F6045TU7DP2L2SYZAFVVOHOSS799W,"#9-12 Like other riots this year, overcrowding may have contributed to the latest riot.",17,22,riots,0,1,1
3F6045TU7DP2L2SYZAFVVOHOSS799W,"#9-12 Like other riots this year, overcrowding may have contributed to the latest riot.",34,46,overcrowding,10,9,19
3F6045TU7DP2L2SYZAFVVOHOSS799W,"#9-12 Like other riots this year, overcrowding may have contributed to the latest riot.",56,67,contributed,3,4,7
3F6045TU7DP2L2SYZAFVVOHOSS799W,"#9-12 Like other riots this year, overcrowding may have contributed to the latest riot.",82,86,riot,0,1,1
3F6045TU7DP2L2SYZAFVVOHOSS799W,"#9-13 According to Brazil's justice department, the Alcaçuz prison houses more than 1,000 inmates on a capacity of 620.",36,46,department,1,0,1
3F6045TU7DP2L2SYZAFVVOHOSS799W,"#9-13 According to Brazil's justice department, the Alcaçuz prison houses more than 1,000 inmates on a capacity of 620.",52,59,Alcaçuz,1,1,2
3F6045TU7DP2L2SYZAFVVOHOSS799W,"#9-13 According to Brazil's justice department, the Alcaçuz prison houses more than 1,000 inmates on a capacity of 620.",90,97,inmates,3,6,9
3F6045TU7DP2L2SYZAFVVOHOSS799W,"#9-13 According to Brazil's justice department, the Alcaçuz prison houses more than 1,000 inmates on a capacity of 620.",103,111,capacity,3,1,4
3T2HW4QDUV84J0Z1BUPMXEIWYDAC9G,"#8-4 Robben has won five Bundesliga titles, and four DFB-Pokal titles.",25,35,Bundesliga,3,1,4
3T2HW4QDUV84J0Z1BUPMXEIWYDAC9G,"#8-4 Robben has won five Bundesliga titles, and four DFB-Pokal titles.",25,42,Bundesliga titles,1,1,2
3T2HW4QDUV84J0Z1BUPMXEIWYDAC9G,"#8-4 Robben has won five Bundesliga titles, and four DFB-Pokal titles.",36,42,titles,2,0,2
3T2HW4QDUV84J0Z1BUPMXEIWYDAC9G,"#8-4 Robben has won five Bundesliga titles, and four DFB-Pokal titles.",53,62,DFB-Pokal,0,1,1
3T2HW4QDUV84J0Z1BUPMXEIWYDAC9G,"#8-4 Robben has won five Bundesliga titles, and four DFB-Pokal titles.",53,69,DFB-Pokal titles,1,1,2
3T2HW4QDUV84J0Z1BUPMXEIWYDAC9G,"#8-4 Robben has won five Bundesliga titles, and four DFB-Pokal titles.",63,69,titles,1,2,3
3T2HW4QDUV84J0Z1BUPMXEIWYDAC9G,"#8-5 In 2013, Robben scored the winning goal in the UEFA Champions League final at Wembley Stadium against Bayern's arch rivals Borussia Dortmund.",21,27,scored,1,1,2
3T2HW4QDUV84J0Z1BUPMXEIWYDAC9G,"#8-5 In 2013, Robben scored the winning goal in the UEFA Champions League final at Wembley Stadium against Bayern's arch rivals Borussia Dortmund.",32,39,winning,0,1,1
3T2HW4QDUV84J0Z1BUPMXEIWYDAC9G,"#8-5 In 2013, Robben scored the winning goal in the UEFA Champions League final at Wembley Stadium against Bayern's arch rivals Borussia Dortmund.",32,44,winning goal,0,2,2
3T2HW4QDUV84J0Z1BUPMXEIWYDAC9G,"#8-5 In 2013, Robben scored the winning goal in the UEFA Champions League final at Wembley Stadium against Bayern's arch rivals Borussia Dortmund.",40,44,goal,1,0,1
3T2HW4QDUV84J0Z1BUPMXEIWYDAC9G,"#8-5 In 2013, Robben scored the winning goal in the UEFA Champions League final at Wembley Stadium against Bayern's arch rivals Borussia Dortmund.",52,73,UEFA Champions League,1,0,1
3T2HW4QDUV84J0Z1BUPMXEIWYDAC9G,"#8-5 In 2013, Robben scored the winning goal in the UEFA Champions League final at Wembley Stadium against Bayern's arch rivals Borussia Dortmund.",57,73,Champions League,1,0,1
3T2HW4QDUV84J0Z1BUPMXEIWYDAC9G,"#8-5 In 2013, Robben scored the winning goal in the UEFA Champions League final at Wembley Stadium against Bayern's arch rivals Borussia Dortmund.",67,73,League,4,1,5
3T2HW4QDUV84J0Z1BUPMXEIWYDAC9G,"#8-5 In 2013, Robben scored the winning goal in the UEFA Champions League final at Wembley Stadium against Bayern's arch rivals Borussia Dortmund.",83,98,Wembley Stadium,1,0,1
3T2HW4QDUV84J0Z1BUPMXEIWYDAC9G,"#8-5 In 2013, Robben scored the winning goal in the UEFA Champions League final at Wembley Stadium against Bayern's arch rivals Borussia Dortmund.",107,114,Bayerns,1,0,1
3T2HW4QDUV84J0Z1BUPMXEIWYDAC9G,"#8-5 In 2013, Robben scored the winning goal in the UEFA Champions League final at Wembley Stadium against Bayern's arch rivals Borussia Dortmund.",116,120,arch,2,0,2
3T2HW4QDUV84J0Z1BUPMXEIWYDAC9G,"#8-5 In 2013, Robben scored the winning goal in the UEFA Champions League final at Wembley Stadium against Bayern's arch rivals Borussia Dortmund.",116,127,arch rivals,5,6,11
3T2HW4QDUV84J0Z1BUPMXEIWYDAC9G,"#8-5 In 2013, Robben scored the winning goal in the UEFA Champions League final at Wembley Stadium against Bayern's arch rivals Borussia Dortmund.",121,127,rivals,1,2,3
3T2HW4QDUV84J0Z1BUPMXEIWYDAC9G,"#8-5 In 2013, Robben scored the winning goal in the UEFA Champions League final at Wembley Stadium against Bayern's arch rivals Borussia Dortmund.",128,145,Borussia Dortmund,1,0,1
3T2HW4QDUV84J0Z1BUPMXEIWYDAC9G,"#8-6 After signing the contract, Robben said, ""I'm very happy that I'll be playing a further year for FC Bayern.",11,18,signing,1,1,2
3T2HW4QDUV84J0Z1BUPMXEIWYDAC9G,"#8-6 After signing the contract, Robben said, ""I'm very happy that I'll be playing a further year for FC Bayern.",23,31,contract,1,3,4
3T2HW4QDUV84J0Z1BUPMXEIWYDAC9G,"#8-6 After signing the contract, Robben said, ""I'm very happy that I'll be playing a further year for FC Bayern.",75,82,playing,0,1,1
3T2HW4QDUV84J0Z1BUPMXEIWYDAC9G,"#8-6 After signing the contract, Robben said, ""I'm very happy that I'll be playing a further year for FC Bayern.",85,97,further year,0,1,1
3T2HW4QDUV84J0Z1BUPMXEIWYDAC9G,#8-7 The club is one of the best in the world and Munich has become a second home for me and my family.,9,13,club,0,1,1
3T2HW4QDUV84J0Z1BUPMXEIWYDAC9G,#8-7 The club is one of the best in the world and Munich has become a second home for me and my family.,50,56,Munich,1,0,1
3T2HW4QDUV84J0Z1BUPMXEIWYDAC9G,#8-7 The club is one of the best in the world and Munich has become a second home for me and my family.,70,81,second home,0,1,1
3T2HW4QDUV84J0Z1BUPMXEIWYDAC9G,"#8-8 I want to continue playing at the highest level and win as many trophies as possible.""",15,23,continue,1,1,2
3T2HW4QDUV84J0Z1BUPMXEIWYDAC9G,"#8-8 I want to continue playing at the highest level and win as many trophies as possible.""",39,52,highest level,0,1,1
3T2HW4QDUV84J0Z1BUPMXEIWYDAC9G,"#8-8 I want to continue playing at the highest level and win as many trophies as possible.""",69,77,trophies,9,6,15
3T2HW4QDUV84J0Z1BUPMXEIWYDAC9G,"#8-9 On Sunday, Bayern announced signings of 21-year-old Niklas Süle and 26-year-old Sebastian Rudy from TSG 1899 Hoffenheim who are to join the Bayern squad in July.",23,32,announced,2,3,5
3T2HW4QDUV84J0Z1BUPMXEIWYDAC9G,"#8-9 On Sunday, Bayern announced signings of 21-year-old Niklas Süle and 26-year-old Sebastian Rudy from TSG 1899 Hoffenheim who are to join the Bayern squad in July.",23,41,announced signings,0,1,1
3T2HW4QDUV84J0Z1BUPMXEIWYDAC9G,"#8-9 On Sunday, Bayern announced signings of 21-year-old Niklas Süle and 26-year-old Sebastian Rudy from TSG 1899 Hoffenheim who are to join the Bayern squad in July.",33,41,signings,2,4,6
3T2HW4QDUV84J0Z1BUPMXEIWYDAC9G,"#8-9 On Sunday, Bayern announced signings of 21-year-old Niklas Süle and 26-year-old Sebastian Rudy from TSG 1899 Hoffenheim who are to join the Bayern squad in July.",57,68,Niklas Süle,1,0,1
3T2HW4QDUV84J0Z1BUPMXEIWYDAC9G,"#8-9 On Sunday, Bayern announced signings of 21-year-old Niklas Süle and 26-year-old Sebastian Rudy from TSG 1899 Hoffenheim who are to join the Bayern squad in July.",114,124,Hoffenheim,2,0,2
3T2HW4QDUV84J0Z1BUPMXEIWYDAC9G,"#8-9 On Sunday, Bayern announced signings of 21-year-old Niklas Süle and 26-year-old Sebastian Rudy from TSG 1899 Hoffenheim who are to join the Bayern squad in July.",152,157,squad,3,4,7
3T2HW4QDUV84J0Z1BUPMXEIWYDAC9G,"#8-9 On Sunday, Bayern announced signings of 21-year-old Niklas Süle and 26-year-old Sebastian Rudy from TSG 1899 Hoffenheim who are to join the Bayern squad in July.",152,160,squad in,1,0,1
3T2HW4QDUV84J0Z1BUPMXEIWYDAC9G,#8-10 The German internationals have penned a five-year and a three-year contract respectively.,17,31,internationals,6,1,7
3T2HW4QDUV84J0Z1BUPMXEIWYDAC9G,#8-10 The German internationals have penned a five-year and a three-year contract respectively.,37,43,penned,6,10,16
3T2HW4QDUV84J0Z1BUPMXEIWYDAC9G,#8-10 The German internationals have penned a five-year and a three-year contract respectively.,82,94,respectively,10,5,15
3D1TUISJWI1TGV941FGZ4D35O34IUF,#21-16 This is the Bianchi family's second driver death.,19,26,Bianchi,1,0,1
3D1TUISJWI1TGV941FGZ4D35O34IUF,#21-16 This is the Bianchi family's second driver death.,19,54,Bianchi familys second driver death,1,0,1
3D1TUISJWI1TGV941FGZ4D35O34IUF,#21-16 This is the Bianchi family's second driver death.,43,55,driver death,1,0,1
3D1TUISJWI1TGV941FGZ4D35O34IUF,"#21-17 Lucien Bianchi, the 1968 24 Hours of Le Mans winner and Jules's great uncle, was killed in 1969 during testing at Circuit de la Sarthe, where the 24 Hours of Le Mans race is held.",44,51,Le Mans,1,0,1
3D1TUISJWI1TGV941FGZ4D35O34IUF,"#21-17 Lucien Bianchi, the 1968 24 Hours of Le Mans winner and Jules's great uncle, was killed in 1969 during testing at Circuit de la Sarthe, where the 24 Hours of Le Mans race is held.",71,82,great uncle,2,0,2
3D1TUISJWI1TGV941FGZ4D35O34IUF,"#21-17 Lucien Bianchi, the 1968 24 Hours of Le Mans winner and Jules's great uncle, was killed in 1969 during testing at Circuit de la Sarthe, where the 24 Hours of Le Mans race is held.",110,128,testing at Circuit,1,0,1
3D1TUISJWI1TGV941FGZ4D35O34IUF,"#21-17 Lucien Bianchi, the 1968 24 Hours of Le Mans winner and Jules's great uncle, was killed in 1969 during testing at Circuit de la Sarthe, where the 24 Hours of Le Mans race is held.",121,128,Circuit,2,0,2
3D1TUISJWI1TGV941FGZ4D35O34IUF,"#21-17 Lucien Bianchi, the 1968 24 Hours of Le Mans winner and Jules's great uncle, was killed in 1969 during testing at Circuit de la Sarthe, where the 24 Hours of Le Mans race is held.",121,141,Circuit de la Sarthe,4,0,4
3D1TUISJWI1TGV941FGZ4D35O34IUF,"#21-17 Lucien Bianchi, the 1968 24 Hours of Le Mans winner and Jules's great uncle, was killed in 1969 during testing at Circuit de la Sarthe, where the 24 Hours of Le Mans race is held.",135,141,Sarthe,2,0,2
3D1TUISJWI1TGV941FGZ4D35O34IUF,"#21-17 Lucien Bianchi, the 1968 24 Hours of Le Mans winner and Jules's great uncle, was killed in 1969 during testing at Circuit de la Sarthe, where the 24 Hours of Le Mans race is held.",165,172,Le Mans,1,0,1
3D1TUISJWI1TGV941FGZ4D35O34IUF,"#21-17 Lucien Bianchi, the 1968 24 Hours of Le Mans winner and Jules's great uncle, was killed in 1969 during testing at Circuit de la Sarthe, where the 24 Hours of Le Mans race is held.",165,177,Le Mans race,1,0,1
3D1TUISJWI1TGV941FGZ4D35O34IUF,"#21-17 Lucien Bianchi, the 1968 24 Hours of Le Mans winner and Jules's great uncle, was killed in 1969 during testing at Circuit de la Sarthe, where the 24 Hours of Le Mans race is held.",181,185,held,0,2,2
3D1TUISJWI1TGV941FGZ4D35O34IUF,"#21-18 Upon the news of his death, many drivers sent their condolences through social media.",59,70,condolences,10,10,20
3D1TUISJWI1TGV941FGZ4D35O34IUF,"#21-18 Upon the news of his death, many drivers sent their condolences through social media.",79,91,social media,2,1,3
3D1TUISJWI1TGV941FGZ4D35O34IUF,"#21-19 Bianchi's Marussia team mate Max Chilton tweeted, ""No words can describe what his family and the sport have lost.",17,25,Marussia,1,1,2
3D1TUISJWI1TGV941FGZ4D35O34IUF,"#21-19 Bianchi's Marussia team mate Max Chilton tweeted, ""No words can describe what his family and the sport have lost.",26,35,team mate,1,0,1
3D1TUISJWI1TGV941FGZ4D35O34IUF,"#21-19 Bianchi's Marussia team mate Max Chilton tweeted, ""No words can describe what his family and the sport have lost.",31,35,mate,0,1,1
3D1TUISJWI1TGV941FGZ4D35O34IUF,"#21-19 Bianchi's Marussia team mate Max Chilton tweeted, ""No words can describe what his family and the sport have lost.",48,55,tweeted,5,3,8
3D1TUISJWI1TGV941FGZ4D35O34IUF,"#21-19 Bianchi's Marussia team mate Max Chilton tweeted, ""No words can describe what his family and the sport have lost.",71,79,describe,0,1,1
3D1TUISJWI1TGV941FGZ4D35O34IUF,"#21-20 All I can say [is] it was a pleasure knowing and racing you.""",35,43,pleasure,2,1,3
3D1TUISJWI1TGV941FGZ4D35O34IUF,"#21-20 All I can say [is] it was a pleasure knowing and racing you.""",35,51,pleasure knowing,0,1,1
3D1TUISJWI1TGV941FGZ4D35O34IUF,"#21-20 All I can say [is] it was a pleasure knowing and racing you.""",44,66,knowing and racing you,1,0,1
3D1TUISJWI1TGV941FGZ4D35O34IUF,"#22-1 Former Indian president APJ Abdul Kalam dies at age 83 Portrait of former Indian president Dr. APJ Abdul Kalam, also known as the Missile Man of India; 2008.",61,69,Portrait,5,4,9
3D1TUISJWI1TGV941FGZ4D35O34IUF,"#22-1 Former Indian president APJ Abdul Kalam dies at age 83 Portrait of former Indian president Dr. APJ Abdul Kalam, also known as the Missile Man of India; 2008.",87,96,president,1,0,1
3D1TUISJWI1TGV941FGZ4D35O34IUF,"#22-1 Former Indian president APJ Abdul Kalam dies at age 83 Portrait of former Indian president Dr. APJ Abdul Kalam, also known as the Missile Man of India; 2008.",136,143,Missile,0,1,1
3D1TUISJWI1TGV941FGZ4D35O34IUF,"#22-1 Former Indian president APJ Abdul Kalam dies at age 83 Portrait of former Indian president Dr. APJ Abdul Kalam, also known as the Missile Man of India; 2008.",136,147,Missile Man,3,0,3
3D1TUISJWI1TGV941FGZ4D35O34IUF,"#22-1 Former Indian president APJ Abdul Kalam dies at age 83 Portrait of former Indian president Dr. APJ Abdul Kalam, also known as the Missile Man of India; 2008.",136,156,Missile Man of India,1,0,1
3D1TUISJWI1TGV941FGZ4D35O34IUF,"#22-2 Yesterday, former Indian president APJ Abdul Kalam died at the age of 83 after collapsing at about 6:30 p.m. local time (0000 today UTC) while delivering a speech about Livable Planet Earth at the Indian Institute of Management Shillong, in Meghalaya, India.",17,23,former,0,1,1
3D1TUISJWI1TGV941FGZ4D35O34IUF,"#22-2 Yesterday, former Indian president APJ Abdul Kalam died at the age of 83 after collapsing at about 6:30 p.m. local time (0000 today UTC) while delivering a speech about Livable Planet Earth at the Indian Institute of Management Shillong, in Meghalaya, India.",85,95,collapsing,10,10,20
3D1TUISJWI1TGV941FGZ4D35O34IUF,"#22-2 Yesterday, former Indian president APJ Abdul Kalam died at the age of 83 after collapsing at about 6:30 p.m. local time (0000 today UTC) while delivering a speech about Livable Planet Earth at the Indian Institute of Management Shillong, in Meghalaya, India.",85,98,collapsing at,1,0,1
3D1TUISJWI1TGV941FGZ4D35O34IUF,"#22-2 Yesterday, former Indian president APJ Abdul Kalam died at the age of 83 after collapsing at about 6:30 p.m. local time (0000 today UTC) while delivering a speech about Livable Planet Earth at the Indian Institute of Management Shillong, in Meghalaya, India.",149,159,delivering,6,5,11
3D1TUISJWI1TGV941FGZ4D35O34IUF,"#22-2 Yesterday, former Indian president APJ Abdul Kalam died at the age of 83 after collapsing at about 6:30 p.m. local time (0000 today UTC) while delivering a speech about Livable Planet Earth at the Indian Institute of Management Shillong, in Meghalaya, India.",149,168,delivering a speech,0,1,1
3D1TUISJWI1TGV941FGZ4D35O34IUF,"#22-2 Yesterday, former Indian president APJ Abdul Kalam died at the age of 83 after collapsing at about 6:30 p.m. local time (0000 today UTC) while delivering a speech about Livable Planet Earth at the Indian Institute of Management Shillong, in Meghalaya, India.",162,168,speech,0,1,1
3D1TUISJWI1TGV941FGZ4D35O34IUF,"#22-2 Yesterday, former Indian president APJ Abdul Kalam died at the age of 83 after collapsing at about 6:30 p.m. local time (0000 today UTC) while delivering a speech about Livable Planet Earth at the Indian Institute of Management Shillong, in Meghalaya, India.",175,182,Livable,2,0,2
3D1TUISJWI1TGV941FGZ4D35O34IUF,"#22-2 Yesterday, former Indian president APJ Abdul Kalam died at the age of 83 after collapsing at about 6:30 p.m. local time (0000 today UTC) while delivering a speech about Livable Planet Earth at the Indian Institute of Management Shillong, in Meghalaya, India.",175,195,Livable Planet Earth,1,0,1
3D1TUISJWI1TGV941FGZ4D35O34IUF,"#22-2 Yesterday, former Indian president APJ Abdul Kalam died at the age of 83 after collapsing at about 6:30 p.m. local time (0000 today UTC) while delivering a speech about Livable Planet Earth at the Indian Institute of Management Shillong, in Meghalaya, India.",203,242,Indian Institute of Management Shillong,2,0,2
3D1TUISJWI1TGV941FGZ4D35O34IUF,"#22-2 Yesterday, former Indian president APJ Abdul Kalam died at the age of 83 after collapsing at about 6:30 p.m. local time (0000 today UTC) while delivering a speech about Livable Planet Earth at the Indian Institute of Management Shillong, in Meghalaya, India.",210,219,Institute,1,0,1
3D1TUISJWI1TGV941FGZ4D35O34IUF,"#22-2 Yesterday, former Indian president APJ Abdul Kalam died at the age of 83 after collapsing at about 6:30 p.m. local time (0000 today UTC) while delivering a speech about Livable Planet Earth at the Indian Institute of Management Shillong, in Meghalaya, India.",210,233,Institute of Management,1,0,1
3D1TUISJWI1TGV941FGZ4D35O34IUF,"#22-2 Yesterday, former Indian president APJ Abdul Kalam died at the age of 83 after collapsing at about 6:30 p.m. local time (0000 today UTC) while delivering a speech about Livable Planet Earth at the Indian Institute of Management Shillong, in Meghalaya, India.",210,242,Institute of Management Shillong,1,0,1
3D1TUISJWI1TGV941FGZ4D35O34IUF,"#22-2 Yesterday, former Indian president APJ Abdul Kalam died at the age of 83 after collapsing at about 6:30 p.m. local time (0000 today UTC) while delivering a speech about Livable Planet Earth at the Indian Institute of Management Shillong, in Meghalaya, India.",223,263,"Management Shillong, in Meghalaya, India",1,0,1
3D1TUISJWI1TGV941FGZ4D35O34IUF,"#22-2 Yesterday, former Indian president APJ Abdul Kalam died at the age of 83 after collapsing at about 6:30 p.m. local time (0000 today UTC) while delivering a speech about Livable Planet Earth at the Indian Institute of Management Shillong, in Meghalaya, India.",247,256,Meghalaya,1,0,1
3WPCIUYH1A9X87ET9WPE8K1QDKOTDW,"#3-18 Earlier in 2013, he wrapped himself, half naked, in a cocoon of barbed wire.",26,33,wrapped,3,9,12
3WPCIUYH1A9X87ET9WPE8K1QDKOTDW,"#3-18 Earlier in 2013, he wrapped himself, half naked, in a cocoon of barbed wire.",26,41,wrapped himself,0,1,1
3WPCIUYH1A9X87ET9WPE8K1QDKOTDW,"#3-18 Earlier in 2013, he wrapped himself, half naked, in a cocoon of barbed wire.",43,53,half naked,1,0,1
3WPCIUYH1A9X87ET9WPE8K1QDKOTDW,"#3-18 Earlier in 2013, he wrapped himself, half naked, in a cocoon of barbed wire.",60,66,cocoon,10,6,16
3WPCIUYH1A9X87ET9WPE8K1QDKOTDW,"#3-18 Earlier in 2013, he wrapped himself, half naked, in a cocoon of barbed wire.",70,76,barbed,2,8,10
3WPCIUYH1A9X87ET9WPE8K1QDKOTDW,"#3-18 Earlier in 2013, he wrapped himself, half naked, in a cocoon of barbed wire.",70,81,barbed wire,5,1,6
3WPCIUYH1A9X87ET9WPE8K1QDKOTDW,"#3-19 The following year, he chopped off a part of his right ear lobe with a chef's knife sitting nude on a roof labelling the art as ""Segregation"".",10,19,following,1,0,1
3WPCIUYH1A9X87ET9WPE8K1QDKOTDW,"#3-19 The following year, he chopped off a part of his right ear lobe with a chef's knife sitting nude on a roof labelling the art as ""Segregation"".",29,36,chopped,2,2,4
3WPCIUYH1A9X87ET9WPE8K1QDKOTDW,"#3-19 The following year, he chopped off a part of his right ear lobe with a chef's knife sitting nude on a roof labelling the art as ""Segregation"".",29,40,chopped off,0,4,4
3WPCIUYH1A9X87ET9WPE8K1QDKOTDW,"#3-19 The following year, he chopped off a part of his right ear lobe with a chef's knife sitting nude on a roof labelling the art as ""Segregation"".",61,69,ear lobe,1,0,1
3WPCIUYH1A9X87ET9WPE8K1QDKOTDW,"#3-19 The following year, he chopped off a part of his right ear lobe with a chef's knife sitting nude on a roof labelling the art as ""Segregation"".",65,69,lobe,0,2,2
3WPCIUYH1A9X87ET9WPE8K1QDKOTDW,"#3-19 The following year, he chopped off a part of his right ear lobe with a chef's knife sitting nude on a roof labelling the art as ""Segregation"".",98,102,nude,2,2,4
3WPCIUYH1A9X87ET9WPE8K1QDKOTDW,"#3-19 The following year, he chopped off a part of his right ear lobe with a chef's knife sitting nude on a roof labelling the art as ""Segregation"".",113,122,labelling,3,2,5
3WPCIUYH1A9X87ET9WPE8K1QDKOTDW,"#3-19 The following year, he chopped off a part of his right ear lobe with a chef's knife sitting nude on a roof labelling the art as ""Segregation"".",135,146,Segregation,10,9,19
3WPCIUYH1A9X87ET9WPE8K1QDKOTDW,"#3-20 About returning to Russia, Pavlensky told BBC, ""I have no desire to return like a lamb to the slaughter, especially a slaughter that is desired, by the state.""",12,21,returning,1,0,1
3WPCIUYH1A9X87ET9WPE8K1QDKOTDW,"#3-20 About returning to Russia, Pavlensky told BBC, ""I have no desire to return like a lamb to the slaughter, especially a slaughter that is desired, by the state.""",33,42,Pavlensky,1,2,3
3WPCIUYH1A9X87ET9WPE8K1QDKOTDW,"#3-20 About returning to Russia, Pavlensky told BBC, ""I have no desire to return like a lamb to the slaughter, especially a slaughter that is desired, by the state.""",88,109,lamb to the slaughter,1,0,1
3WPCIUYH1A9X87ET9WPE8K1QDKOTDW,"#3-20 About returning to Russia, Pavlensky told BBC, ""I have no desire to return like a lamb to the slaughter, especially a slaughter that is desired, by the state.""",100,109,slaughter,10,9,19
3WPCIUYH1A9X87ET9WPE8K1QDKOTDW,"#3-20 About returning to Russia, Pavlensky told BBC, ""I have no desire to return like a lamb to the slaughter, especially a slaughter that is desired, by the state.""",111,121,especially,1,1,2
3WPCIUYH1A9X87ET9WPE8K1QDKOTDW,"#3-20 About returning to Russia, Pavlensky told BBC, ""I have no desire to return like a lamb to the slaughter, especially a slaughter that is desired, by the state.""",124,133,slaughter,4,3,7
3WPCIUYH1A9X87ET9WPE8K1QDKOTDW,"#3-20 About returning to Russia, Pavlensky told BBC, ""I have no desire to return like a lamb to the slaughter, especially a slaughter that is desired, by the state.""",142,149,desired,0,1,1
3WPCIUYH1A9X87ET9WPE8K1QDKOTDW,#3-21 Pavlensky and Oksana are liable to be sentenced to a ten-year jail term if found guilty.,20,26,Oksana,0,1,1
3WPCIUYH1A9X87ET9WPE8K1QDKOTDW,#3-21 Pavlensky and Oksana are liable to be sentenced to a ten-year jail term if found guilty.,31,37,liable,7,4,11
3WPCIUYH1A9X87ET9WPE8K1QDKOTDW,#3-21 Pavlensky and Oksana are liable to be sentenced to a ten-year jail term if found guilty.,44,53,sentenced,2,3,5
3WPCIUYH1A9X87ET9WPE8K1QDKOTDW,#3-21 Pavlensky and Oksana are liable to be sentenced to a ten-year jail term if found guilty.,87,93,guilty,5,3,8
3WPCIUYH1A9X87ET9WPE8K1QDKOTDW,"#30-1 Woman fined in Spain under new 'Gag Law' The posted photo of a police vehicle parked in handicapped bay in Petrer, Spain; license number removed.",12,17,fined,0,1,1
3WPCIUYH1A9X87ET9WPE8K1QDKOTDW,"#30-1 Woman fined in Spain under new 'Gag Law' The posted photo of a police vehicle parked in handicapped bay in Petrer, Spain; license number removed.",38,45,Gag Law,1,2,3
3WPCIUYH1A9X87ET9WPE8K1QDKOTDW,"#30-1 Woman fined in Spain under new 'Gag Law' The posted photo of a police vehicle parked in handicapped bay in Petrer, Spain; license number removed.",76,83,vehicle,0,1,1
3WPCIUYH1A9X87ET9WPE8K1QDKOTDW,"#30-1 Woman fined in Spain under new 'Gag Law' The posted photo of a police vehicle parked in handicapped bay in Petrer, Spain; license number removed.",94,105,handicapped,8,3,11
3WPCIUYH1A9X87ET9WPE8K1QDKOTDW,"#30-1 Woman fined in Spain under new 'Gag Law' The posted photo of a police vehicle parked in handicapped bay in Petrer, Spain; license number removed.",94,109,handicapped bay,0,2,2
3WPCIUYH1A9X87ET9WPE8K1QDKOTDW,"#30-1 Woman fined in Spain under new 'Gag Law' The posted photo of a police vehicle parked in handicapped bay in Petrer, Spain; license number removed.",113,119,Petrer,0,1,1
3WPCIUYH1A9X87ET9WPE8K1QDKOTDW,"#30-1 Woman fined in Spain under new 'Gag Law' The posted photo of a police vehicle parked in handicapped bay in Petrer, Spain; license number removed.",128,135,license,4,1,5
3WPCIUYH1A9X87ET9WPE8K1QDKOTDW,#30-2 A woman in Spain has been fined €800 after posting a photograph to her Facebook account of a police vehicle parked in space reserved for disabled/handicapped drivers.,32,37,fined,0,1,1
3WPCIUYH1A9X87ET9WPE8K1QDKOTDW,#30-2 A woman in Spain has been fined €800 after posting a photograph to her Facebook account of a police vehicle parked in space reserved for disabled/handicapped drivers.,49,56,posting,0,1,1
3WPCIUYH1A9X87ET9WPE8K1QDKOTDW,#30-2 A woman in Spain has been fined €800 after posting a photograph to her Facebook account of a police vehicle parked in space reserved for disabled/handicapped drivers.,59,69,photograph,1,0,1
3WPCIUYH1A9X87ET9WPE8K1QDKOTDW,#30-2 A woman in Spain has been fined €800 after posting a photograph to her Facebook account of a police vehicle parked in space reserved for disabled/handicapped drivers.,106,113,vehicle,1,1,2
3WPCIUYH1A9X87ET9WPE8K1QDKOTDW,#30-2 A woman in Spain has been fined €800 after posting a photograph to her Facebook account of a police vehicle parked in space reserved for disabled/handicapped drivers.,130,138,reserved,3,1,4
3WPCIUYH1A9X87ET9WPE8K1QDKOTDW,#30-2 A woman in Spain has been fined €800 after posting a photograph to her Facebook account of a police vehicle parked in space reserved for disabled/handicapped drivers.,143,163,disabled/handicapped,4,0,4
3DIIW4IV8PWUZXFPM9PHR95BPQG4IE,"#38-12 ""Eventually after many incidents of his anger coming to the fore, we dismissed him.",8,18,Eventually,4,4,8
3DIIW4IV8PWUZXFPM9PHR95BPQG4IE,"#38-12 ""Eventually after many incidents of his anger coming to the fore, we dismissed him.",30,39,incidents,8,3,11
3DIIW4IV8PWUZXFPM9PHR95BPQG4IE,"#38-12 ""Eventually after many incidents of his anger coming to the fore, we dismissed him.",47,52,anger,0,1,1
3DIIW4IV8PWUZXFPM9PHR95BPQG4IE,"#38-12 ""Eventually after many incidents of his anger coming to the fore, we dismissed him.",67,71,fore,5,5,10
3DIIW4IV8PWUZXFPM9PHR95BPQG4IE,"#38-12 ""Eventually after many incidents of his anger coming to the fore, we dismissed him.",76,85,dismissed,5,6,11
3DIIW4IV8PWUZXFPM9PHR95BPQG4IE,"#38-14 A video of the shooting, which appeared to have been captured from the point of view of the shooter, was posted on Bryce Williams' Twitter and Facebook pages several hours afterwards.",38,46,appeared,1,1,2
3DIIW4IV8PWUZXFPM9PHR95BPQG4IE,"#38-14 A video of the shooting, which appeared to have been captured from the point of view of the shooter, was posted on Bryce Williams' Twitter and Facebook pages several hours afterwards.",60,68,captured,4,3,7
3DIIW4IV8PWUZXFPM9PHR95BPQG4IE,"#38-14 A video of the shooting, which appeared to have been captured from the point of view of the shooter, was posted on Bryce Williams' Twitter and Facebook pages several hours afterwards.",138,164,Twitter and Facebook pages,1,0,1
3DIIW4IV8PWUZXFPM9PHR95BPQG4IE,"#38-14 A video of the shooting, which appeared to have been captured from the point of view of the shooter, was posted on Bryce Williams' Twitter and Facebook pages several hours afterwards.",179,189,afterwards,3,3,6
3DIIW4IV8PWUZXFPM9PHR95BPQG4IE,"#39-1 Austrian police find dozens dead inside lorry To write, edit, start or view other articles on Austria, see the Austria Portal Flag of Austria.svg The turning for Parndorf off the A4, from file.",27,33,dozens,0,1,1
3DIIW4IV8PWUZXFPM9PHR95BPQG4IE,"#39-1 Austrian police find dozens dead inside lorry To write, edit, start or view other articles on Austria, see the Austria Portal Flag of Austria.svg The turning for Parndorf off the A4, from file.",46,51,lorry,3,2,5
3DIIW4IV8PWUZXFPM9PHR95BPQG4IE,"#39-1 Austrian police find dozens dead inside lorry To write, edit, start or view other articles on Austria, see the Austria Portal Flag of Austria.svg The turning for Parndorf off the A4, from file.",46,55,lorry  To,1,0,1
3DIIW4IV8PWUZXFPM9PHR95BPQG4IE,"#39-1 Austrian police find dozens dead inside lorry To write, edit, start or view other articles on Austria, see the Austria Portal Flag of Austria.svg The turning for Parndorf off the A4, from file.",88,96,articles,0,1,1
3DIIW4IV8PWUZXFPM9PHR95BPQG4IE,"#39-1 Austrian police find dozens dead inside lorry To write, edit, start or view other articles on Austria, see the Austria Portal Flag of Austria.svg The turning for Parndorf off the A4, from file.",125,131,Portal,0,1,1
3DIIW4IV8PWUZXFPM9PHR95BPQG4IE,"#39-1 Austrian police find dozens dead inside lorry To write, edit, start or view other articles on Austria, see the Austria Portal Flag of Austria.svg The turning for Parndorf off the A4, from file.",125,137,Portal  Flag,2,0,2
3DIIW4IV8PWUZXFPM9PHR95BPQG4IE,"#39-1 Austrian police find dozens dead inside lorry To write, edit, start or view other articles on Austria, see the Austria Portal Flag of Austria.svg The turning for Parndorf off the A4, from file.",140,151,Austria.svg,1,0,1
3DIIW4IV8PWUZXFPM9PHR95BPQG4IE,"#39-1 Austrian police find dozens dead inside lorry To write, edit, start or view other articles on Austria, see the Austria Portal Flag of Austria.svg The turning for Parndorf off the A4, from file.",168,176,Parndorf,2,1,3
3DIIW4IV8PWUZXFPM9PHR95BPQG4IE,#39-2 The lorry was found on the road nearby.,10,15,lorry,6,1,7
3DIIW4IV8PWUZXFPM9PHR95BPQG4IE,#39-3 Austrian police today found an estimated 20–50 decomposing corpses in an apparently abandoned lorry.,37,46,estimated,3,5,8
3DIIW4IV8PWUZXFPM9PHR95BPQG4IE,#39-3 Austrian police today found an estimated 20–50 decomposing corpses in an apparently abandoned lorry.,53,64,decomposing,5,5,10
3DIIW4IV8PWUZXFPM9PHR95BPQG4IE,#39-3 Austrian police today found an estimated 20–50 decomposing corpses in an apparently abandoned lorry.,53,72,decomposing corpses,6,3,9
3DIIW4IV8PWUZXFPM9PHR95BPQG4IE,#39-3 Austrian police today found an estimated 20–50 decomposing corpses in an apparently abandoned lorry.,65,72,corpses,2,4,6
3DIIW4IV8PWUZXFPM9PHR95BPQG4IE,#39-3 Austrian police today found an estimated 20–50 decomposing corpses in an apparently abandoned lorry.,79,89,apparently,5,3,8
3DIIW4IV8PWUZXFPM9PHR95BPQG4IE,#39-3 Austrian police today found an estimated 20–50 decomposing corpses in an apparently abandoned lorry.,79,99,apparently abandoned,2,3,5
3DIIW4IV8PWUZXFPM9PHR95BPQG4IE,#39-3 Austrian police today found an estimated 20–50 decomposing corpses in an apparently abandoned lorry.,79,105,apparently abandoned lorry,1,0,1
3DIIW4IV8PWUZXFPM9PHR95BPQG4IE,#39-3 Austrian police today found an estimated 20–50 decomposing corpses in an apparently abandoned lorry.,90,99,abandoned,6,5,11
3DIIW4IV8PWUZXFPM9PHR95BPQG4IE,#39-3 Austrian police today found an estimated 20–50 decomposing corpses in an apparently abandoned lorry.,100,105,lorry,4,1,5
3DIIW4IV8PWUZXFPM9PHR95BPQG4IE,"#39-4 Roadworkers who spotted the vehicle, which had been there since yesterday at least, alerted police.",6,17,Roadworkers,3,2,5
3DIIW4IV8PWUZXFPM9PHR95BPQG4IE,"#39-4 Roadworkers who spotted the vehicle, which had been there since yesterday at least, alerted police.",22,29,spotted,0,3,3
3DIIW4IV8PWUZXFPM9PHR95BPQG4IE,"#39-4 Roadworkers who spotted the vehicle, which had been there since yesterday at least, alerted police.",34,41,vehicle,1,0,1
3DIIW4IV8PWUZXFPM9PHR95BPQG4IE,"#39-4 Roadworkers who spotted the vehicle, which had been there since yesterday at least, alerted police.",70,79,yesterday,1,0,1
3DIIW4IV8PWUZXFPM9PHR95BPQG4IE,"#39-4 Roadworkers who spotted the vehicle, which had been there since yesterday at least, alerted police.",90,97,alerted,0,3,3
3DIIW4IV8PWUZXFPM9PHR95BPQG4IE,#39-5 Responding officers found it full of corpses.,6,16,Responding,4,1,5
3DIIW4IV8PWUZXFPM9PHR95BPQG4IE,#39-5 Responding officers found it full of corpses.,43,50,corpses,2,3,5
30F94FBDNRL4TAG9V0Y8DUDQAZDBT8,#11-13 The researchers say this shows the amygdala is likely to control hunting and biting behavior across many or all jawed vertebrates.,11,22,researchers,2,1,3
30F94FBDNRL4TAG9V0Y8DUDQAZDBT8,#11-13 The researchers say this shows the amygdala is likely to control hunting and biting behavior across many or all jawed vertebrates.,42,50,amygdala,10,8,18
30F94FBDNRL4TAG9V0Y8DUDQAZDBT8,#11-13 The researchers say this shows the amygdala is likely to control hunting and biting behavior across many or all jawed vertebrates.,72,79,hunting,0,1,1
30F94FBDNRL4TAG9V0Y8DUDQAZDBT8,#11-13 The researchers say this shows the amygdala is likely to control hunting and biting behavior across many or all jawed vertebrates.,84,90,biting,1,1,2
30F94FBDNRL4TAG9V0Y8DUDQAZDBT8,#11-13 The researchers say this shows the amygdala is likely to control hunting and biting behavior across many or all jawed vertebrates.,84,99,biting behavior,1,0,1
30F94FBDNRL4TAG9V0Y8DUDQAZDBT8,#11-13 The researchers say this shows the amygdala is likely to control hunting and biting behavior across many or all jawed vertebrates.,119,124,jawed,0,3,3
30F94FBDNRL4TAG9V0Y8DUDQAZDBT8,#11-13 The researchers say this shows the amygdala is likely to control hunting and biting behavior across many or all jawed vertebrates.,119,136,jawed vertebrates,3,2,5
30F94FBDNRL4TAG9V0Y8DUDQAZDBT8,#11-13 The researchers say this shows the amygdala is likely to control hunting and biting behavior across many or all jawed vertebrates.,125,136,vertebrates,10,4,14
30F94FBDNRL4TAG9V0Y8DUDQAZDBT8,#11-14 The experiments were funded by national research organizations in the United States and China and the government of Brazil.,11,22,experiments,5,0,5
30F94FBDNRL4TAG9V0Y8DUDQAZDBT8,#11-14 The experiments were funded by national research organizations in the United States and China and the government of Brazil.,28,34,funded,0,2,2
30F94FBDNRL4TAG9V0Y8DUDQAZDBT8,#11-14 The experiments were funded by national research organizations in the United States and China and the government of Brazil.,56,69,organizations,5,1,6
30F94FBDNRL4TAG9V0Y8DUDQAZDBT8,"#11-15 The findings inspired comparisons by the research team and the press to zombies from The Walking Dead, especially since the behavior was more pronounced when the animals were hungry.",20,28,inspired,3,1,4
30F94FBDNRL4TAG9V0Y8DUDQAZDBT8,"#11-15 The findings inspired comparisons by the research team and the press to zombies from The Walking Dead, especially since the behavior was more pronounced when the animals were hungry.",20,40,inspired comparisons,1,1,2
30F94FBDNRL4TAG9V0Y8DUDQAZDBT8,"#11-15 The findings inspired comparisons by the research team and the press to zombies from The Walking Dead, especially since the behavior was more pronounced when the animals were hungry.",29,40,comparisons,0,1,1
30F94FBDNRL4TAG9V0Y8DUDQAZDBT8,"#11-15 The findings inspired comparisons by the research team and the press to zombies from The Walking Dead, especially since the behavior was more pronounced when the animals were hungry.",48,56,research,1,0,1
30F94FBDNRL4TAG9V0Y8DUDQAZDBT8,"#11-15 The findings inspired comparisons by the research team and the press to zombies from The Walking Dead, especially since the behavior was more pronounced when the animals were hungry.",79,86,zombies,4,5,9
30F94FBDNRL4TAG9V0Y8DUDQAZDBT8,"#11-15 The findings inspired comparisons by the research team and the press to zombies from The Walking Dead, especially since the behavior was more pronounced when the animals were hungry.",96,108,Walking Dead,0,1,1
30F94FBDNRL4TAG9V0Y8DUDQAZDBT8,"#11-15 The findings inspired comparisons by the research team and the press to zombies from The Walking Dead, especially since the behavior was more pronounced when the animals were hungry.",110,120,especially,1,0,1
30F94FBDNRL4TAG9V0Y8DUDQAZDBT8,"#11-15 The findings inspired comparisons by the research team and the press to zombies from The Walking Dead, especially since the behavior was more pronounced when the animals were hungry.",131,139,behavior,2,0,2
30F94FBDNRL4TAG9V0Y8DUDQAZDBT8,"#11-15 The findings inspired comparisons by the research team and the press to zombies from The Walking Dead, especially since the behavior was more pronounced when the animals were hungry.",149,159,pronounced,7,4,11
30F94FBDNRL4TAG9V0Y8DUDQAZDBT8,#11-16 Researchers noted the subjects did not attack any of the other mice.,29,37,subjects,0,1,1
30F94FBDNRL4TAG9V0Y8DUDQAZDBT8,#11-16 Researchers noted the subjects did not attack any of the other mice.,70,74,mice,1,1,2
30F94FBDNRL4TAG9V0Y8DUDQAZDBT8,#11-17 The scientists say this shows they were stimulating predatory behavior specifically and not making the animals generally more angry or aggressive.,47,58,stimulating,6,5,11
30F94FBDNRL4TAG9V0Y8DUDQAZDBT8,#11-17 The scientists say this shows they were stimulating predatory behavior specifically and not making the animals generally more angry or aggressive.,47,68,stimulating predatory,3,0,3
30F94FBDNRL4TAG9V0Y8DUDQAZDBT8,#11-17 The scientists say this shows they were stimulating predatory behavior specifically and not making the animals generally more angry or aggressive.,47,77,stimulating predatory behavior,0,1,1
30F94FBDNRL4TAG9V0Y8DUDQAZDBT8,#11-17 The scientists say this shows they were stimulating predatory behavior specifically and not making the animals generally more angry or aggressive.,59,68,predatory,8,4,12
30F94FBDNRL4TAG9V0Y8DUDQAZDBT8,#11-17 The scientists say this shows they were stimulating predatory behavior specifically and not making the animals generally more angry or aggressive.,59,77,predatory behavior,0,2,2
30F94FBDNRL4TAG9V0Y8DUDQAZDBT8,#11-17 The scientists say this shows they were stimulating predatory behavior specifically and not making the animals generally more angry or aggressive.,78,90,specifically,5,0,5
30F94FBDNRL4TAG9V0Y8DUDQAZDBT8,#11-17 The scientists say this shows they were stimulating predatory behavior specifically and not making the animals generally more angry or aggressive.,142,152,aggressive,4,4,8
30F94FBDNRL4TAG9V0Y8DUDQAZDBT8,"#11-18 However, the study did not state whether the laser resembled the light of a full moon.",52,57,laser,1,0,1
30F94FBDNRL4TAG9V0Y8DUDQAZDBT8,"#11-18 However, the study did not state whether the laser resembled the light of a full moon.",58,67,resembled,5,6,11
30F94FBDNRL4TAG9V0Y8DUDQAZDBT8,"#12-1 Man charged over motorway bridge collapse in Kent, England Reports yesterday indicated a 63-year-old man has been charged in connection with the collapse of a pedestrian bridge onto the M20 motorway in Kent, England last year.",23,31,motorway,1,1,2
30F94FBDNRL4TAG9V0Y8DUDQAZDBT8,"#12-1 Man charged over motorway bridge collapse in Kent, England Reports yesterday indicated a 63-year-old man has been charged in connection with the collapse of a pedestrian bridge onto the M20 motorway in Kent, England last year.",23,38,motorway bridge,0,1,1
30F94FBDNRL4TAG9V0Y8DUDQAZDBT8,"#12-1 Man charged over motorway bridge collapse in Kent, England Reports yesterday indicated a 63-year-old man has been charged in connection with the collapse of a pedestrian bridge onto the M20 motorway in Kent, England last year.",39,47,collapse,2,2,4
30F94FBDNRL4TAG9V0Y8DUDQAZDBT8,"#12-1 Man charged over motorway bridge collapse in Kent, England Reports yesterday indicated a 63-year-old man has been charged in connection with the collapse of a pedestrian bridge onto the M20 motorway in Kent, England last year.",83,92,indicated,1,3,4
30F94FBDNRL4TAG9V0Y8DUDQAZDBT8,"#12-1 Man charged over motorway bridge collapse in Kent, England Reports yesterday indicated a 63-year-old man has been charged in connection with the collapse of a pedestrian bridge onto the M20 motorway in Kent, England last year.",120,127,charged,0,1,1
30F94FBDNRL4TAG9V0Y8DUDQAZDBT8,"#12-1 Man charged over motorway bridge collapse in Kent, England Reports yesterday indicated a 63-year-old man has been charged in connection with the collapse of a pedestrian bridge onto the M20 motorway in Kent, England last year.",151,159,collapse,4,0,4
30F94FBDNRL4TAG9V0Y8DUDQAZDBT8,"#12-1 Man charged over motorway bridge collapse in Kent, England Reports yesterday indicated a 63-year-old man has been charged in connection with the collapse of a pedestrian bridge onto the M20 motorway in Kent, England last year.",165,175,pedestrian,9,5,14
30F94FBDNRL4TAG9V0Y8DUDQAZDBT8,"#12-1 Man charged over motorway bridge collapse in Kent, England Reports yesterday indicated a 63-year-old man has been charged in connection with the collapse of a pedestrian bridge onto the M20 motorway in Kent, England last year.",165,182,pedestrian bridge,0,2,2
30F94FBDNRL4TAG9V0Y8DUDQAZDBT8,"#12-1 Man charged over motorway bridge collapse in Kent, England Reports yesterday indicated a 63-year-old man has been charged in connection with the collapse of a pedestrian bridge onto the M20 motorway in Kent, England last year.",196,204,motorway,0,1,1
3UOMW19E6D7LIDXP84C5LYDUCHRC5P,"#42-48 A day after, we counted how many spores were still alive.",23,30,counted,0,1,1
3UOMW19E6D7LIDXP84C5LYDUCHRC5P,"#42-48 A day after, we counted how many spores were still alive.",40,46,spores,7,10,17
3UOMW19E6D7LIDXP84C5LYDUCHRC5P,#42-49 Wikinews: How reliable do you consider your results to be?,21,29,reliable,2,8,10
3UOMW19E6D7LIDXP84C5LYDUCHRC5P,#42-50 NB: The results we got are very reliable.,39,47,reliable,4,3,7
3UOMW19E6D7LIDXP84C5LYDUCHRC5P,"#42-51 We had a lot of colonies containing a lot of ants, and wherever possible we conducted the experiment blind.",23,31,colonies,6,6,12
3UOMW19E6D7LIDXP84C5LYDUCHRC5P,"#42-51 We had a lot of colonies containing a lot of ants, and wherever possible we conducted the experiment blind.",32,42,containing,1,0,1
3UOMW19E6D7LIDXP84C5LYDUCHRC5P,"#42-51 We had a lot of colonies containing a lot of ants, and wherever possible we conducted the experiment blind.",83,92,conducted,4,5,9
3UOMW19E6D7LIDXP84C5LYDUCHRC5P,"#42-51 We had a lot of colonies containing a lot of ants, and wherever possible we conducted the experiment blind.",83,113,conducted the experiment blind,1,0,1
3UOMW19E6D7LIDXP84C5LYDUCHRC5P,"#42-51 We had a lot of colonies containing a lot of ants, and wherever possible we conducted the experiment blind.",97,107,experiment,2,1,3
3UOMW19E6D7LIDXP84C5LYDUCHRC5P,"#42-51 We had a lot of colonies containing a lot of ants, and wherever possible we conducted the experiment blind.",97,113,experiment blind,0,1,1
3UOMW19E6D7LIDXP84C5LYDUCHRC5P,"#42-51 We had a lot of colonies containing a lot of ants, and wherever possible we conducted the experiment blind.",108,113,blind,1,2,3
3UOMW19E6D7LIDXP84C5LYDUCHRC5P,"#42-52 This means the experimenter doesn't know which ants belong to which treatment, so it's impossible to influence the results with 'observer bias'.",22,34,experimenter,4,4,8
3UOMW19E6D7LIDXP84C5LYDUCHRC5P,"#42-52 This means the experimenter doesn't know which ants belong to which treatment, so it's impossible to influence the results with 'observer bias'.",75,84,treatment,1,0,1
3UOMW19E6D7LIDXP84C5LYDUCHRC5P,"#42-52 This means the experimenter doesn't know which ants belong to which treatment, so it's impossible to influence the results with 'observer bias'.",94,104,impossible,1,0,1
3UOMW19E6D7LIDXP84C5LYDUCHRC5P,"#42-52 This means the experimenter doesn't know which ants belong to which treatment, so it's impossible to influence the results with 'observer bias'.",108,117,influence,3,5,8
3UOMW19E6D7LIDXP84C5LYDUCHRC5P,"#42-52 This means the experimenter doesn't know which ants belong to which treatment, so it's impossible to influence the results with 'observer bias'.",136,149,observer bias,7,7,14
3UOMW19E6D7LIDXP84C5LYDUCHRC5P,"#42-52 This means the experimenter doesn't know which ants belong to which treatment, so it's impossible to influence the results with 'observer bias'.",145,149,bias,4,4,8
3UOMW19E6D7LIDXP84C5LYDUCHRC5P,"#42-53 However, of course this is proof in just one species.",34,39,proof,0,2,2
3UOMW19E6D7LIDXP84C5LYDUCHRC5P,"#42-53 However, of course this is proof in just one species.",52,59,species,2,3,5
3UOMW19E6D7LIDXP84C5LYDUCHRC5P,"#42-54 It is hard to extrapolate to other ants, as different species lead very different lives.",21,32,extrapolate,10,10,20
3UOMW19E6D7LIDXP84C5LYDUCHRC5P,"#42-54 It is hard to extrapolate to other ants, as different species lead very different lives.",42,46,ants,0,1,1
3UOMW19E6D7LIDXP84C5LYDUCHRC5P,"#42-54 It is hard to extrapolate to other ants, as different species lead very different lives.",69,73,lead,0,1,1
3UOMW19E6D7LIDXP84C5LYDUCHRC5P,#42-55 Cquote1.svg At the moment it seems that sick ants mostly take care of the problem themselves Cquote2.svg Wikinews: Where did the ants and fungus you used come from?,145,151,fungus,3,4,7
37G6BXQPLQMP8X01ON639X8OTPREQX,"#41-19 Slovak chicken meat company Hyza, a previous owner, previously told Wikinews the lorry has changed hands several times in roughly the last year.",7,13,Slovak,2,2,4
37G6BXQPLQMP8X01ON639X8OTPREQX,"#41-19 Slovak chicken meat company Hyza, a previous owner, previously told Wikinews the lorry has changed hands several times in roughly the last year.",35,39,Hyza,1,1,2
37G6BXQPLQMP8X01ON639X8OTPREQX,"#41-19 Slovak chicken meat company Hyza, a previous owner, previously told Wikinews the lorry has changed hands several times in roughly the last year.",59,69,previously,2,2,4
37G6BXQPLQMP8X01ON639X8OTPREQX,"#41-19 Slovak chicken meat company Hyza, a previous owner, previously told Wikinews the lorry has changed hands several times in roughly the last year.",75,83,Wikinews,2,0,2
37G6BXQPLQMP8X01ON639X8OTPREQX,"#41-19 Slovak chicken meat company Hyza, a previous owner, previously told Wikinews the lorry has changed hands several times in roughly the last year.",84,93,the lorry,0,1,1
37G6BXQPLQMP8X01ON639X8OTPREQX,"#41-19 Slovak chicken meat company Hyza, a previous owner, previously told Wikinews the lorry has changed hands several times in roughly the last year.",88,93,lorry,5,3,8
37G6BXQPLQMP8X01ON639X8OTPREQX,"#41-19 Slovak chicken meat company Hyza, a previous owner, previously told Wikinews the lorry has changed hands several times in roughly the last year.",98,105,changed,0,1,1
37G6BXQPLQMP8X01ON639X8OTPREQX,"#41-19 Slovak chicken meat company Hyza, a previous owner, previously told Wikinews the lorry has changed hands several times in roughly the last year.",98,111,changed hands,1,0,1
37G6BXQPLQMP8X01ON639X8OTPREQX,"#41-19 Slovak chicken meat company Hyza, a previous owner, previously told Wikinews the lorry has changed hands several times in roughly the last year.",129,136,roughly,2,4,6
37G6BXQPLQMP8X01ON639X8OTPREQX,#41-20 After they sold it they say it was exported to Hungary; it now bears Hungarian plates but still features Hyza branding including pictures of meat.,42,50,exported,9,1,10
37G6BXQPLQMP8X01ON639X8OTPREQX,#41-20 After they sold it they say it was exported to Hungary; it now bears Hungarian plates but still features Hyza branding including pictures of meat.,70,75,bears,0,2,2
37G6BXQPLQMP8X01ON639X8OTPREQX,#41-20 After they sold it they say it was exported to Hungary; it now bears Hungarian plates but still features Hyza branding including pictures of meat.,76,85,Hungarian,1,0,1
37G6BXQPLQMP8X01ON639X8OTPREQX,#41-20 After they sold it they say it was exported to Hungary; it now bears Hungarian plates but still features Hyza branding including pictures of meat.,103,111,features,2,3,5
37G6BXQPLQMP8X01ON639X8OTPREQX,#41-20 After they sold it they say it was exported to Hungary; it now bears Hungarian plates but still features Hyza branding including pictures of meat.,117,125,branding,3,4,7
37G6BXQPLQMP8X01ON639X8OTPREQX,#41-20 After they sold it they say it was exported to Hungary; it now bears Hungarian plates but still features Hyza branding including pictures of meat.,126,135,including,1,1,2
37G6BXQPLQMP8X01ON639X8OTPREQX,#41-21 On the day of the discovery Hyza quickly removed a graphic from their homepage featuring cartoon chicken stowaways in a car being inspected at a customs post.,25,34,discovery,2,0,2
37G6BXQPLQMP8X01ON639X8OTPREQX,#41-21 On the day of the discovery Hyza quickly removed a graphic from their homepage featuring cartoon chicken stowaways in a car being inspected at a customs post.,48,55,removed,0,1,1
37G6BXQPLQMP8X01ON639X8OTPREQX,#41-21 On the day of the discovery Hyza quickly removed a graphic from their homepage featuring cartoon chicken stowaways in a car being inspected at a customs post.,58,65,graphic,5,2,7
37G6BXQPLQMP8X01ON639X8OTPREQX,#41-21 On the day of the discovery Hyza quickly removed a graphic from their homepage featuring cartoon chicken stowaways in a car being inspected at a customs post.,58,85,graphic from their homepage,1,0,1
37G6BXQPLQMP8X01ON639X8OTPREQX,#41-21 On the day of the discovery Hyza quickly removed a graphic from their homepage featuring cartoon chicken stowaways in a car being inspected at a customs post.,77,85,homepage,0,2,2
37G6BXQPLQMP8X01ON639X8OTPREQX,#41-21 On the day of the discovery Hyza quickly removed a graphic from their homepage featuring cartoon chicken stowaways in a car being inspected at a customs post.,86,95,featuring,2,0,2
37G6BXQPLQMP8X01ON639X8OTPREQX,#41-21 On the day of the discovery Hyza quickly removed a graphic from their homepage featuring cartoon chicken stowaways in a car being inspected at a customs post.,104,121,chicken stowaways,0,1,1
37G6BXQPLQMP8X01ON639X8OTPREQX,#41-21 On the day of the discovery Hyza quickly removed a graphic from their homepage featuring cartoon chicken stowaways in a car being inspected at a customs post.,112,121,stowaways,9,9,18
37G6BXQPLQMP8X01ON639X8OTPREQX,#41-21 On the day of the discovery Hyza quickly removed a graphic from their homepage featuring cartoon chicken stowaways in a car being inspected at a customs post.,137,146,inspected,3,2,5
37G6BXQPLQMP8X01ON639X8OTPREQX,#41-21 On the day of the discovery Hyza quickly removed a graphic from their homepage featuring cartoon chicken stowaways in a car being inspected at a customs post.,152,159,customs,2,2,4
37G6BXQPLQMP8X01ON639X8OTPREQX,"#41-22 The stowaways also appeared with a line through them alongside the word ""imigranti"".",11,20,stowaways,6,3,9
37G6BXQPLQMP8X01ON639X8OTPREQX,"#41-22 The stowaways also appeared with a line through them alongside the word ""imigranti"".",26,34,appeared,1,1,2
37G6BXQPLQMP8X01ON639X8OTPREQX,"#41-22 The stowaways also appeared with a line through them alongside the word ""imigranti"".",60,69,alongside,1,2,3
37G6BXQPLQMP8X01ON639X8OTPREQX,"#41-22 The stowaways also appeared with a line through them alongside the word ""imigranti"".",80,89,imigranti,8,4,12
37G6BXQPLQMP8X01ON639X8OTPREQX,"#41-23 Police today found 26 migrants in a lorry near Braunau am Inn, Austria.",29,37,migrants,3,4,7
37G6BXQPLQMP8X01ON639X8OTPREQX,"#41-23 Police today found 26 migrants in a lorry near Braunau am Inn, Austria.",43,48,lorry,1,1,2
37G6BXQPLQMP8X01ON639X8OTPREQX,"#41-23 Police today found 26 migrants in a lorry near Braunau am Inn, Austria.",54,61,Braunau,1,1,2
37G6BXQPLQMP8X01ON639X8OTPREQX,"#41-24 The driver, from Romania, refused to stop for police and was arrested following a chase.",33,40,refused,0,2,2
37G6BXQPLQMP8X01ON639X8OTPREQX,"#41-24 The driver, from Romania, refused to stop for police and was arrested following a chase.",68,76,arrested,0,1,1
37G6BXQPLQMP8X01ON639X8OTPREQX,"#41-24 The driver, from Romania, refused to stop for police and was arrested following a chase.",89,94,chase,0,1,1
37G6BXQPLQMP8X01ON639X8OTPREQX,"#41-25 Police said three children were hospitalised for ""severe dehydration"".",39,51,hospitalised,8,2,10
37G6BXQPLQMP8X01ON639X8OTPREQX,"#41-25 Police said three children were hospitalised for ""severe dehydration"".",57,63,severe,2,0,2
37G6BXQPLQMP8X01ON639X8OTPREQX,"#41-25 Police said three children were hospitalised for ""severe dehydration"".",57,75,severe dehydration,2,1,3
37G6BXQPLQMP8X01ON639X8OTPREQX,"#41-25 Police said three children were hospitalised for ""severe dehydration"".",64,75,dehydration,10,9,19
3TFJJUELSHQTJGE2QLA7NRAIS70C2O,"#32-2 Everson served as Commissioner of Internal Revenue, the administrative head of the Internal Revenue Service (IRS) from 2003 to 2007, during the George W. Bush administration.",14,20,served,1,2,3
3TFJJUELSHQTJGE2QLA7NRAIS70C2O,"#32-2 Everson served as Commissioner of Internal Revenue, the administrative head of the Internal Revenue Service (IRS) from 2003 to 2007, during the George W. Bush administration.",24,36,Commissioner,4,2,6
3TFJJUELSHQTJGE2QLA7NRAIS70C2O,"#32-2 Everson served as Commissioner of Internal Revenue, the administrative head of the Internal Revenue Service (IRS) from 2003 to 2007, during the George W. Bush administration.",24,56,Commissioner of Internal Revenue,1,0,1
3TFJJUELSHQTJGE2QLA7NRAIS70C2O,"#32-2 Everson served as Commissioner of Internal Revenue, the administrative head of the Internal Revenue Service (IRS) from 2003 to 2007, during the George W. Bush administration.",40,48,Internal,1,0,1
3TFJJUELSHQTJGE2QLA7NRAIS70C2O,"#32-2 Everson served as Commissioner of Internal Revenue, the administrative head of the Internal Revenue Service (IRS) from 2003 to 2007, during the George W. Bush administration.",40,56,Internal Revenue,2,2,4
3TFJJUELSHQTJGE2QLA7NRAIS70C2O,"#32-2 Everson served as Commissioner of Internal Revenue, the administrative head of the Internal Revenue Service (IRS) from 2003 to 2007, during the George W. Bush administration.",49,56,Revenue,3,2,5
3TFJJUELSHQTJGE2QLA7NRAIS70C2O,"#32-2 Everson served as Commissioner of Internal Revenue, the administrative head of the Internal Revenue Service (IRS) from 2003 to 2007, during the George W. Bush administration.",62,76,administrative,8,2,10
3TFJJUELSHQTJGE2QLA7NRAIS70C2O,"#32-2 Everson served as Commissioner of Internal Revenue, the administrative head of the Internal Revenue Service (IRS) from 2003 to 2007, during the George W. Bush administration.",89,113,Internal Revenue Service,1,0,1
3TFJJUELSHQTJGE2QLA7NRAIS70C2O,"#32-2 Everson served as Commissioner of Internal Revenue, the administrative head of the Internal Revenue Service (IRS) from 2003 to 2007, during the George W. Bush administration.",89,118,Internal Revenue Service (IRS,0,1,1
3TFJJUELSHQTJGE2QLA7NRAIS70C2O,"#32-2 Everson served as Commissioner of Internal Revenue, the administrative head of the Internal Revenue Service (IRS) from 2003 to 2007, during the George W. Bush administration.",165,179,administration,3,2,5
3TFJJUELSHQTJGE2QLA7NRAIS70C2O,"#32-3 After his departure, he briefly served as CEO of the American Red Cross, worked in the cabinet of Indiana governor Mitch Daniels, and worked for the tax consulting firm alliantgroup.",16,25,departure,7,7,14
3TFJJUELSHQTJGE2QLA7NRAIS70C2O,"#32-3 After his departure, he briefly served as CEO of the American Red Cross, worked in the cabinet of Indiana governor Mitch Daniels, and worked for the tax consulting firm alliantgroup.",30,37,briefly,1,3,4
3TFJJUELSHQTJGE2QLA7NRAIS70C2O,"#32-3 After his departure, he briefly served as CEO of the American Red Cross, worked in the cabinet of Indiana governor Mitch Daniels, and worked for the tax consulting firm alliantgroup.",93,100,cabinet,5,3,8
3TFJJUELSHQTJGE2QLA7NRAIS70C2O,"#32-3 After his departure, he briefly served as CEO of the American Red Cross, worked in the cabinet of Indiana governor Mitch Daniels, and worked for the tax consulting firm alliantgroup.",104,120,Indiana governor,1,0,1
3TFJJUELSHQTJGE2QLA7NRAIS70C2O,"#32-3 After his departure, he briefly served as CEO of the American Red Cross, worked in the cabinet of Indiana governor Mitch Daniels, and worked for the tax consulting firm alliantgroup.",121,134,Mitch Daniels,0,1,1
3TFJJUELSHQTJGE2QLA7NRAIS70C2O,"#32-3 After his departure, he briefly served as CEO of the American Red Cross, worked in the cabinet of Indiana governor Mitch Daniels, and worked for the tax consulting firm alliantgroup.",155,174,tax consulting firm,1,1,2
3TFJJUELSHQTJGE2QLA7NRAIS70C2O,"#32-3 After his departure, he briefly served as CEO of the American Red Cross, worked in the cabinet of Indiana governor Mitch Daniels, and worked for the tax consulting firm alliantgroup.",155,187,tax consulting firm alliantgroup,1,0,1
3TFJJUELSHQTJGE2QLA7NRAIS70C2O,"#32-3 After his departure, he briefly served as CEO of the American Red Cross, worked in the cabinet of Indiana governor Mitch Daniels, and worked for the tax consulting firm alliantgroup.",159,169,consulting,6,2,8
3TFJJUELSHQTJGE2QLA7NRAIS70C2O,"#32-3 After his departure, he briefly served as CEO of the American Red Cross, worked in the cabinet of Indiana governor Mitch Daniels, and worked for the tax consulting firm alliantgroup.",175,187,alliantgroup,6,2,8
3TFJJUELSHQTJGE2QLA7NRAIS70C2O,"#32-4 He announced his candidacy this past March with a sixteen-page open letter in which he outlined the six pillars of his campaign: amnesty for illegal immigrants, reinstatement of the military draft, a promise to serve only a single presidential term, and calls for tax reform, deficit reduction, and corporate responsibility.",9,18,announced,2,1,3
3TFJJUELSHQTJGE2QLA7NRAIS70C2O,"#32-4 He announced his candidacy this past March with a sixteen-page open letter in which he outlined the six pillars of his campaign: amnesty for illegal immigrants, reinstatement of the military draft, a promise to serve only a single presidential term, and calls for tax reform, deficit reduction, and corporate responsibility.",23,32,candidacy,7,7,14
3TFJJUELSHQTJGE2QLA7NRAIS70C2O,"#32-4 He announced his candidacy this past March with a sixteen-page open letter in which he outlined the six pillars of his campaign: amnesty for illegal immigrants, reinstatement of the military draft, a promise to serve only a single presidential term, and calls for tax reform, deficit reduction, and corporate responsibility.",93,101,outlined,0,5,5
3TFJJUELSHQTJGE2QLA7NRAIS70C2O,"#32-4 He announced his candidacy this past March with a sixteen-page open letter in which he outlined the six pillars of his campaign: amnesty for illegal immigrants, reinstatement of the military draft, a promise to serve only a single presidential term, and calls for tax reform, deficit reduction, and corporate responsibility.",110,117,pillars,5,2,7
3TFJJUELSHQTJGE2QLA7NRAIS70C2O,"#32-4 He announced his candidacy this past March with a sixteen-page open letter in which he outlined the six pillars of his campaign: amnesty for illegal immigrants, reinstatement of the military draft, a promise to serve only a single presidential term, and calls for tax reform, deficit reduction, and corporate responsibility.",125,133,campaign,2,1,3
3TFJJUELSHQTJGE2QLA7NRAIS70C2O,"#32-4 He announced his candidacy this past March with a sixteen-page open letter in which he outlined the six pillars of his campaign: amnesty for illegal immigrants, reinstatement of the military draft, a promise to serve only a single presidential term, and calls for tax reform, deficit reduction, and corporate responsibility.",135,142,amnesty,10,3,13
3TFJJUELSHQTJGE2QLA7NRAIS70C2O,"#32-4 He announced his candidacy this past March with a sixteen-page open letter in which he outlined the six pillars of his campaign: amnesty for illegal immigrants, reinstatement of the military draft, a promise to serve only a single presidential term, and calls for tax reform, deficit reduction, and corporate responsibility.",147,154,illegal,1,0,1
3TFJJUELSHQTJGE2QLA7NRAIS70C2O,"#32-4 He announced his candidacy this past March with a sixteen-page open letter in which he outlined the six pillars of his campaign: amnesty for illegal immigrants, reinstatement of the military draft, a promise to serve only a single presidential term, and calls for tax reform, deficit reduction, and corporate responsibility.",147,165,illegal immigrants,0,2,2
3TFJJUELSHQTJGE2QLA7NRAIS70C2O,"#32-4 He announced his candidacy this past March with a sixteen-page open letter in which he outlined the six pillars of his campaign: amnesty for illegal immigrants, reinstatement of the military draft, a promise to serve only a single presidential term, and calls for tax reform, deficit reduction, and corporate responsibility.",155,165,immigrants,6,5,11
3TFJJUELSHQTJGE2QLA7NRAIS70C2O,"#32-4 He announced his candidacy this past March with a sixteen-page open letter in which he outlined the six pillars of his campaign: amnesty for illegal immigrants, reinstatement of the military draft, a promise to serve only a single presidential term, and calls for tax reform, deficit reduction, and corporate responsibility.",167,180,reinstatement,10,10,20
3TFJJUELSHQTJGE2QLA7NRAIS70C2O,"#32-4 He announced his candidacy this past March with a sixteen-page open letter in which he outlined the six pillars of his campaign: amnesty for illegal immigrants, reinstatement of the military draft, a promise to serve only a single presidential term, and calls for tax reform, deficit reduction, and corporate responsibility.",167,202,reinstatement of the military draft,0,1,1
3TFJJUELSHQTJGE2QLA7NRAIS70C2O,"#32-4 He announced his candidacy this past March with a sixteen-page open letter in which he outlined the six pillars of his campaign: amnesty for illegal immigrants, reinstatement of the military draft, a promise to serve only a single presidential term, and calls for tax reform, deficit reduction, and corporate responsibility.",197,202,draft,1,4,5
3TFJJUELSHQTJGE2QLA7NRAIS70C2O,"#32-4 He announced his candidacy this past March with a sixteen-page open letter in which he outlined the six pillars of his campaign: amnesty for illegal immigrants, reinstatement of the military draft, a promise to serve only a single presidential term, and calls for tax reform, deficit reduction, and corporate responsibility.",237,254,presidential term,0,1,1
3TFJJUELSHQTJGE2QLA7NRAIS70C2O,"#32-4 He announced his candidacy this past March with a sixteen-page open letter in which he outlined the six pillars of his campaign: amnesty for illegal immigrants, reinstatement of the military draft, a promise to serve only a single presidential term, and calls for tax reform, deficit reduction, and corporate responsibility.",270,280,tax reform,0,1,1
3TFJJUELSHQTJGE2QLA7NRAIS70C2O,"#32-4 He announced his candidacy this past March with a sixteen-page open letter in which he outlined the six pillars of his campaign: amnesty for illegal immigrants, reinstatement of the military draft, a promise to serve only a single presidential term, and calls for tax reform, deficit reduction, and corporate responsibility.",282,289,deficit,5,2,7
3TFJJUELSHQTJGE2QLA7NRAIS70C2O,"#32-4 He announced his candidacy this past March with a sixteen-page open letter in which he outlined the six pillars of his campaign: amnesty for illegal immigrants, reinstatement of the military draft, a promise to serve only a single presidential term, and calls for tax reform, deficit reduction, and corporate responsibility.",282,299,deficit reduction,0,4,4
3TFJJUELSHQTJGE2QLA7NRAIS70C2O,"#32-4 He announced his candidacy this past March with a sixteen-page open letter in which he outlined the six pillars of his campaign: amnesty for illegal immigrants, reinstatement of the military draft, a promise to serve only a single presidential term, and calls for tax reform, deficit reduction, and corporate responsibility.",305,329,corporate responsibility,0,3,3
3TFJJUELSHQTJGE2QLA7NRAIS70C2O,"#32-4 He announced his candidacy this past March with a sixteen-page open letter in which he outlined the six pillars of his campaign: amnesty for illegal immigrants, reinstatement of the military draft, a promise to serve only a single presidential term, and calls for tax reform, deficit reduction, and corporate responsibility.",315,329,responsibility,0,1,1
3TFJJUELSHQTJGE2QLA7NRAIS70C2O,#32-5 He was excluded from the August 6 Fox News Republican presidential debate and has been excluded from most presidential polls.,13,21,excluded,3,2,5
3TFJJUELSHQTJGE2QLA7NRAIS70C2O,#32-5 He was excluded from the August 6 Fox News Republican presidential debate and has been excluded from most presidential polls.,60,72,presidential,1,1,2
3TFJJUELSHQTJGE2QLA7NRAIS70C2O,#32-5 He was excluded from the August 6 Fox News Republican presidential debate and has been excluded from most presidential polls.,73,79,debate,0,2,2
3TFJJUELSHQTJGE2QLA7NRAIS70C2O,#32-5 He was excluded from the August 6 Fox News Republican presidential debate and has been excluded from most presidential polls.,93,101,excluded,3,1,4
3TFJJUELSHQTJGE2QLA7NRAIS70C2O,#32-5 He was excluded from the August 6 Fox News Republican presidential debate and has been excluded from most presidential polls.,125,130,polls,0,1,1
32TMVRKDGNZ1AR3CDNDQEKBXMUB486,#27-6 He was appointed to the position in June of 2014.,13,22,appointed,10,5,15
32TMVRKDGNZ1AR3CDNDQEKBXMUB486,#27-6 He was appointed to the position in June of 2014.,30,38,position,1,1,2
32TMVRKDGNZ1AR3CDNDQEKBXMUB486,#27-7 Choe was involved with trade talks between the two Koreas in the mid-2000s.,6,10,Choe,0,1,1
32TMVRKDGNZ1AR3CDNDQEKBXMUB486,#27-7 Choe was involved with trade talks between the two Koreas in the mid-2000s.,15,23,involved,3,3,6
32TMVRKDGNZ1AR3CDNDQEKBXMUB486,#27-7 Choe was involved with trade talks between the two Koreas in the mid-2000s.,29,40,trade talks,2,1,3
32TMVRKDGNZ1AR3CDNDQEKBXMUB486,#27-7 Choe was involved with trade talks between the two Koreas in the mid-2000s.,35,40,talks,1,0,1
32TMVRKDGNZ1AR3CDNDQEKBXMUB486,#27-7 Choe was involved with trade talks between the two Koreas in the mid-2000s.,57,63,Koreas,0,1,1
32TMVRKDGNZ1AR3CDNDQEKBXMUB486,"#27-8 In 2004, he attended the opening of the Kaesong Industrial Region, a joint venture of the two nations.",18,26,attended,1,2,3
32TMVRKDGNZ1AR3CDNDQEKBXMUB486,"#27-8 In 2004, he attended the opening of the Kaesong Industrial Region, a joint venture of the two nations.",46,53,Kaesong,1,1,2
32TMVRKDGNZ1AR3CDNDQEKBXMUB486,"#27-8 In 2004, he attended the opening of the Kaesong Industrial Region, a joint venture of the two nations.",46,71,Kaesong Industrial Region,1,0,1
32TMVRKDGNZ1AR3CDNDQEKBXMUB486,"#27-8 In 2004, he attended the opening of the Kaesong Industrial Region, a joint venture of the two nations.",54,64,Industrial,2,1,3
32TMVRKDGNZ1AR3CDNDQEKBXMUB486,"#27-8 In 2004, he attended the opening of the Kaesong Industrial Region, a joint venture of the two nations.",75,80,joint,1,0,1
32TMVRKDGNZ1AR3CDNDQEKBXMUB486,"#27-8 In 2004, he attended the opening of the Kaesong Industrial Region, a joint venture of the two nations.",75,88,joint venture,5,5,10
32TMVRKDGNZ1AR3CDNDQEKBXMUB486,"#27-8 In 2004, he attended the opening of the Kaesong Industrial Region, a joint venture of the two nations.",81,88,venture,6,3,9
32TMVRKDGNZ1AR3CDNDQEKBXMUB486,#27-9 South Korea's Ministry of Unification told both Reuters and BBC it was monitoring the situation but Choe has not been seen publicly since December.,6,18,South Koreas,0,1,1
32TMVRKDGNZ1AR3CDNDQEKBXMUB486,#27-9 South Korea's Ministry of Unification told both Reuters and BBC it was monitoring the situation but Choe has not been seen publicly since December.,20,43,Ministry of Unification,1,0,1
32TMVRKDGNZ1AR3CDNDQEKBXMUB486,#27-9 South Korea's Ministry of Unification told both Reuters and BBC it was monitoring the situation but Choe has not been seen publicly since December.,32,43,Unification,2,4,6
32TMVRKDGNZ1AR3CDNDQEKBXMUB486,#27-9 South Korea's Ministry of Unification told both Reuters and BBC it was monitoring the situation but Choe has not been seen publicly since December.,54,61,Reuters,1,3,4
32TMVRKDGNZ1AR3CDNDQEKBXMUB486,#27-9 South Korea's Ministry of Unification told both Reuters and BBC it was monitoring the situation but Choe has not been seen publicly since December.,77,87,monitoring,7,5,12
32TMVRKDGNZ1AR3CDNDQEKBXMUB486,#27-9 South Korea's Ministry of Unification told both Reuters and BBC it was monitoring the situation but Choe has not been seen publicly since December.,129,137,publicly,3,1,4
32TMVRKDGNZ1AR3CDNDQEKBXMUB486,"#27-10 Back in April, South Korea's National Intelligence Service said executions had been ordered for fifteen officials including a ""forestry official"".",22,34,South Koreas,0,1,1
32TMVRKDGNZ1AR3CDNDQEKBXMUB486,"#27-10 Back in April, South Korea's National Intelligence Service said executions had been ordered for fifteen officials including a ""forestry official"".",71,81,executions,5,9,14
32TMVRKDGNZ1AR3CDNDQEKBXMUB486,"#27-10 Back in April, South Korea's National Intelligence Service said executions had been ordered for fifteen officials including a ""forestry official"".",111,120,officials,0,1,1
32TMVRKDGNZ1AR3CDNDQEKBXMUB486,"#27-10 Back in April, South Korea's National Intelligence Service said executions had been ordered for fifteen officials including a ""forestry official"".",121,130,including,0,1,1
32TMVRKDGNZ1AR3CDNDQEKBXMUB486,"#27-10 Back in April, South Korea's National Intelligence Service said executions had been ordered for fifteen officials including a ""forestry official"".",134,151,forestry official,1,1,2
32TMVRKDGNZ1AR3CDNDQEKBXMUB486,"#27-10 Back in April, South Korea's National Intelligence Service said executions had been ordered for fifteen officials including a ""forestry official"".",134,142,forestry,7,3,10
32TMVRKDGNZ1AR3CDNDQEKBXMUB486,"#27-11 Choe Yong-gon was not mentioned by name, nor is it known now if the report was referring to Choe.",7,20,Choe Yong-gon,0,1,1
32TMVRKDGNZ1AR3CDNDQEKBXMUB486,"#27-11 Choe Yong-gon was not mentioned by name, nor is it known now if the report was referring to Choe.",29,38,mentioned,2,2,4
32TMVRKDGNZ1AR3CDNDQEKBXMUB486,"#27-11 Choe Yong-gon was not mentioned by name, nor is it known now if the report was referring to Choe.",86,95,referring,2,3,5
32TMVRKDGNZ1AR3CDNDQEKBXMUB486,#27-12 Yonhap has attributed roughly 70 executions of officials to Kim Jong-un's rule which began after the death of his father Kim Jong-il in December 2011.,7,13,Yonhap,1,1,2
32TMVRKDGNZ1AR3CDNDQEKBXMUB486,#27-12 Yonhap has attributed roughly 70 executions of officials to Kim Jong-un's rule which began after the death of his father Kim Jong-il in December 2011.,18,28,attributed,8,7,15
32TMVRKDGNZ1AR3CDNDQEKBXMUB486,#27-12 Yonhap has attributed roughly 70 executions of officials to Kim Jong-un's rule which began after the death of his father Kim Jong-il in December 2011.,18,36,attributed roughly,1,0,1
32TMVRKDGNZ1AR3CDNDQEKBXMUB486,#27-12 Yonhap has attributed roughly 70 executions of officials to Kim Jong-un's rule which began after the death of his father Kim Jong-il in December 2011.,29,36,roughly,0,4,4
32TMVRKDGNZ1AR3CDNDQEKBXMUB486,#27-12 Yonhap has attributed roughly 70 executions of officials to Kim Jong-un's rule which began after the death of his father Kim Jong-il in December 2011.,40,50,executions,7,0,7
3DW3BNF1GHJ044MRXJEDNABAZE88VM,#10-14 The US troops are set to rotate around the region every nine months.,14,20,troops,1,0,1
3DW3BNF1GHJ044MRXJEDNABAZE88VM,#10-14 The US troops are set to rotate around the region every nine months.,21,31,are set to,0,1,1
3DW3BNF1GHJ044MRXJEDNABAZE88VM,#10-14 The US troops are set to rotate around the region every nine months.,32,38,rotate,3,3,6
3DW3BNF1GHJ044MRXJEDNABAZE88VM,#10-14 The US troops are set to rotate around the region every nine months.,32,45,rotate around,1,0,1
3DW3BNF1GHJ044MRXJEDNABAZE88VM,#10-14 The US troops are set to rotate around the region every nine months.,50,56,region,3,0,3
3DW3BNF1GHJ044MRXJEDNABAZE88VM,"#10-15 Other planned host nations are Estonia, Latvia, Lithuania, Romania, Bulgaria, and Hungary.",13,20,planned,0,1,1
3DW3BNF1GHJ044MRXJEDNABAZE88VM,"#10-15 Other planned host nations are Estonia, Latvia, Lithuania, Romania, Bulgaria, and Hungary.",21,25,host,2,4,6
3DW3BNF1GHJ044MRXJEDNABAZE88VM,"#10-15 Other planned host nations are Estonia, Latvia, Lithuania, Romania, Bulgaria, and Hungary.",26,33,nations,1,0,1
3DW3BNF1GHJ044MRXJEDNABAZE88VM,"#10-15 Other planned host nations are Estonia, Latvia, Lithuania, Romania, Bulgaria, and Hungary.",38,45,Estonia,1,1,2
3DW3BNF1GHJ044MRXJEDNABAZE88VM,"#10-15 Other planned host nations are Estonia, Latvia, Lithuania, Romania, Bulgaria, and Hungary.",38,83,"Estonia, Latvia, Lithuania, Romania, Bulgaria",1,0,1
3DW3BNF1GHJ044MRXJEDNABAZE88VM,"#10-15 Other planned host nations are Estonia, Latvia, Lithuania, Romania, Bulgaria, and Hungary.",47,53,Latvia,1,1,2
3DW3BNF1GHJ044MRXJEDNABAZE88VM,"#10-15 Other planned host nations are Estonia, Latvia, Lithuania, Romania, Bulgaria, and Hungary.",55,64,Lithuania,1,1,2
3DW3BNF1GHJ044MRXJEDNABAZE88VM,"#10-15 Other planned host nations are Estonia, Latvia, Lithuania, Romania, Bulgaria, and Hungary.",66,73,Romania,0,1,1
3DW3BNF1GHJ044MRXJEDNABAZE88VM,"#10-15 Other planned host nations are Estonia, Latvia, Lithuania, Romania, Bulgaria, and Hungary.",75,83,Bulgaria,0,1,1
3DW3BNF1GHJ044MRXJEDNABAZE88VM,"#10-15 Other planned host nations are Estonia, Latvia, Lithuania, Romania, Bulgaria, and Hungary.",89,96,Hungary,1,0,1
3DW3BNF1GHJ044MRXJEDNABAZE88VM,#10-16 The rotation is due to a treaty with Russia preventing permanent deployment to any particular territory.,11,19,rotation,1,0,1
3DW3BNF1GHJ044MRXJEDNABAZE88VM,#10-16 The rotation is due to a treaty with Russia preventing permanent deployment to any particular territory.,32,38,treaty,6,6,12
3DW3BNF1GHJ044MRXJEDNABAZE88VM,#10-16 The rotation is due to a treaty with Russia preventing permanent deployment to any particular territory.,51,61,preventing,3,2,5
3DW3BNF1GHJ044MRXJEDNABAZE88VM,#10-16 The rotation is due to a treaty with Russia preventing permanent deployment to any particular territory.,51,82,preventing permanent deployment,1,0,1
3DW3BNF1GHJ044MRXJEDNABAZE88VM,#10-16 The rotation is due to a treaty with Russia preventing permanent deployment to any particular territory.,62,71,permanent,1,0,1
3DW3BNF1GHJ044MRXJEDNABAZE88VM,#10-16 The rotation is due to a treaty with Russia preventing permanent deployment to any particular territory.,62,82,permanent deployment,2,0,2
3DW3BNF1GHJ044MRXJEDNABAZE88VM,#10-16 The rotation is due to a treaty with Russia preventing permanent deployment to any particular territory.,72,82,deployment,8,10,18
3DW3BNF1GHJ044MRXJEDNABAZE88VM,#10-16 The rotation is due to a treaty with Russia preventing permanent deployment to any particular territory.,90,110,particular territory,3,0,3
3DW3BNF1GHJ044MRXJEDNABAZE88VM,#10-16 The rotation is due to a treaty with Russia preventing permanent deployment to any particular territory.,101,110,territory,6,5,11
3DW3BNF1GHJ044MRXJEDNABAZE88VM,"#10-17 Russian Deputy Foreign Minister Alexei Mechkov said the incoming troops and vehicles were a ""factor destabilising European security"".",15,21,Deputy,0,1,1
3DW3BNF1GHJ044MRXJEDNABAZE88VM,"#10-17 Russian Deputy Foreign Minister Alexei Mechkov said the incoming troops and vehicles were a ""factor destabilising European security"".",22,29,Foreign,1,0,1
3DW3BNF1GHJ044MRXJEDNABAZE88VM,"#10-17 Russian Deputy Foreign Minister Alexei Mechkov said the incoming troops and vehicles were a ""factor destabilising European security"".",39,53,Alexei Mechkov,1,1,2
3DW3BNF1GHJ044MRXJEDNABAZE88VM,"#10-17 Russian Deputy Foreign Minister Alexei Mechkov said the incoming troops and vehicles were a ""factor destabilising European security"".",63,71,incoming,1,1,2
3DW3BNF1GHJ044MRXJEDNABAZE88VM,"#10-17 Russian Deputy Foreign Minister Alexei Mechkov said the incoming troops and vehicles were a ""factor destabilising European security"".",83,91,vehicles,1,0,1
3DW3BNF1GHJ044MRXJEDNABAZE88VM,"#10-17 Russian Deputy Foreign Minister Alexei Mechkov said the incoming troops and vehicles were a ""factor destabilising European security"".",100,106,factor,1,0,1
3DW3BNF1GHJ044MRXJEDNABAZE88VM,"#10-17 Russian Deputy Foreign Minister Alexei Mechkov said the incoming troops and vehicles were a ""factor destabilising European security"".",100,138,factor destabilising European security,1,0,1
3DW3BNF1GHJ044MRXJEDNABAZE88VM,"#10-17 Russian Deputy Foreign Minister Alexei Mechkov said the incoming troops and vehicles were a ""factor destabilising European security"".",107,120,destabilising,10,9,19
3DW3BNF1GHJ044MRXJEDNABAZE88VM,"#10-18 The presence of US assets ""threatens our interests and our security,"" according to Russian President Vladimir Putin.",11,19,presence,0,1,1
3DW3BNF1GHJ044MRXJEDNABAZE88VM,"#10-18 The presence of US assets ""threatens our interests and our security,"" according to Russian President Vladimir Putin.",23,32,US assets,0,1,1
3DW3BNF1GHJ044MRXJEDNABAZE88VM,"#10-18 The presence of US assets ""threatens our interests and our security,"" according to Russian President Vladimir Putin.",26,32,assets,1,1,2
3DW3BNF1GHJ044MRXJEDNABAZE88VM,"#10-18 The presence of US assets ""threatens our interests and our security,"" according to Russian President Vladimir Putin.",34,43,threatens,1,5,6
3DW3BNF1GHJ044MRXJEDNABAZE88VM,"#10-18 The presence of US assets ""threatens our interests and our security,"" according to Russian President Vladimir Putin.",34,74,threatens our interests and our security,1,0,1
3DW3BNF1GHJ044MRXJEDNABAZE88VM,"#10-18 The presence of US assets ""threatens our interests and our security,"" according to Russian President Vladimir Putin.",66,74,security,1,0,1
3DW3BNF1GHJ044MRXJEDNABAZE88VM,"#10-18 The presence of US assets ""threatens our interests and our security,"" according to Russian President Vladimir Putin.",108,122,Vladimir Putin,1,0,1
3DW3BNF1GHJ044MRXJEDNABAZE88VM,"#10-18 The presence of US assets ""threatens our interests and our security,"" according to Russian President Vladimir Putin.",117,122,Putin,0,1,1
3DW3BNF1GHJ044MRXJEDNABAZE88VM,"#10-19 Putin's administration described the deployment as ""a threat"".",15,29,administration,5,1,6
3DW3BNF1GHJ044MRXJEDNABAZE88VM,"#10-19 Putin's administration described the deployment as ""a threat"".",30,39,described,0,1,1
3DW3BNF1GHJ044MRXJEDNABAZE88VM,"#10-19 Putin's administration described the deployment as ""a threat"".",44,54,deployment,2,1,3
3DW3BNF1GHJ044MRXJEDNABAZE88VM,"#10-19 Putin's administration described the deployment as ""a threat"".",61,67,threat,0,2,2
3DW3BNF1GHJ044MRXJEDNABAZE88VM,#10-20 Polish relations with Russia are strained.,14,23,relations,1,0,1
3DW3BNF1GHJ044MRXJEDNABAZE88VM,#10-20 Polish relations with Russia are strained.,40,48,strained,2,9,11
3DW3BNF1GHJ044MRXJEDNABAZE88VM,"#10-21 Since the annexation of Crimea, Russia has recently been increasing its military presence in Kalingrad.",17,27,annexation,10,10,20
3DW3BNF1GHJ044MRXJEDNABAZE88VM,"#10-21 Since the annexation of Crimea, Russia has recently been increasing its military presence in Kalingrad.",31,37,Crimea,2,1,3
3DW3BNF1GHJ044MRXJEDNABAZE88VM,"#10-21 Since the annexation of Crimea, Russia has recently been increasing its military presence in Kalingrad.",64,74,increasing,1,0,1
3DW3BNF1GHJ044MRXJEDNABAZE88VM,"#10-21 Since the annexation of Crimea, Russia has recently been increasing its military presence in Kalingrad.",88,96,presence,2,0,2
3DW3BNF1GHJ044MRXJEDNABAZE88VM,"#10-21 Since the annexation of Crimea, Russia has recently been increasing its military presence in Kalingrad.",100,109,Kalingrad,1,1,2
3DW3BNF1GHJ044MRXJEDNABAZE88VM,"#10-22 The enclave, Russian territory lying between Poland and Lithuania, now has nuclear-capable Iskander missiles and anti-ship Bastion equipment.",11,18,enclave,4,3,7
3DW3BNF1GHJ044MRXJEDNABAZE88VM,"#10-22 The enclave, Russian territory lying between Poland and Lithuania, now has nuclear-capable Iskander missiles and anti-ship Bastion equipment.",28,37,territory,1,1,2
3DW3BNF1GHJ044MRXJEDNABAZE88VM,"#10-22 The enclave, Russian territory lying between Poland and Lithuania, now has nuclear-capable Iskander missiles and anti-ship Bastion equipment.",63,72,Lithuania,0,1,1
3DW3BNF1GHJ044MRXJEDNABAZE88VM,"#10-22 The enclave, Russian territory lying between Poland and Lithuania, now has nuclear-capable Iskander missiles and anti-ship Bastion equipment.",82,97,nuclear-capable,3,1,4
3DW3BNF1GHJ044MRXJEDNABAZE88VM,"#10-22 The enclave, Russian territory lying between Poland and Lithuania, now has nuclear-capable Iskander missiles and anti-ship Bastion equipment.",98,106,Iskander,2,0,2
3DW3BNF1GHJ044MRXJEDNABAZE88VM,"#10-22 The enclave, Russian territory lying between Poland and Lithuania, now has nuclear-capable Iskander missiles and anti-ship Bastion equipment.",107,115,missiles,1,0,1
3DW3BNF1GHJ044MRXJEDNABAZE88VM,"#10-22 The enclave, Russian territory lying between Poland and Lithuania, now has nuclear-capable Iskander missiles and anti-ship Bastion equipment.",120,129,anti-ship,0,1,1
3DW3BNF1GHJ044MRXJEDNABAZE88VM,"#10-22 The enclave, Russian territory lying between Poland and Lithuania, now has nuclear-capable Iskander missiles and anti-ship Bastion equipment.",130,137,Bastion,1,1,2
3DW3BNF1GHJ044MRXJEDNABAZE88VM,"#10-22 The enclave, Russian territory lying between Poland and Lithuania, now has nuclear-capable Iskander missiles and anti-ship Bastion equipment.",130,147,Bastion equipment,1,0,1
3DW3BNF1GHJ044MRXJEDNABAZE88VM,"#10-22 The enclave, Russian territory lying between Poland and Lithuania, now has nuclear-capable Iskander missiles and anti-ship Bastion equipment.",138,147,equipment,0,1,1
3PKJ68EHDNXK6KNQJYU0XZTF7ARJHR,#6-8 Not everyone has considered Manning's actions to be wrong.,22,32,considered,1,0,1
3PKJ68EHDNXK6KNQJYU0XZTF7ARJHR,#6-8 Not everyone has considered Manning's actions to be wrong.,33,41,Mannings,0,2,2
3PKJ68EHDNXK6KNQJYU0XZTF7ARJHR,#6-8 Not everyone has considered Manning's actions to be wrong.,33,49,Mannings actions,0,1,1
3PKJ68EHDNXK6KNQJYU0XZTF7ARJHR,"#6-9 ""Chelsea Manning exposed serious abuses,"" says Margaret Huang, executive director of the U.S. branch of Amnesty International, ""and as a result her own human rights have been violated.""",6,13,Chelsea,0,1,1
3PKJ68EHDNXK6KNQJYU0XZTF7ARJHR,"#6-9 ""Chelsea Manning exposed serious abuses,"" says Margaret Huang, executive director of the U.S. branch of Amnesty International, ""and as a result her own human rights have been violated.""",22,29,exposed,5,2,7
3PKJ68EHDNXK6KNQJYU0XZTF7ARJHR,"#6-9 ""Chelsea Manning exposed serious abuses,"" says Margaret Huang, executive director of the U.S. branch of Amnesty International, ""and as a result her own human rights have been violated.""",30,37,serious,1,0,1
3PKJ68EHDNXK6KNQJYU0XZTF7ARJHR,"#6-9 ""Chelsea Manning exposed serious abuses,"" says Margaret Huang, executive director of the U.S. branch of Amnesty International, ""and as a result her own human rights have been violated.""",30,44,serious abuses,0,1,1
3PKJ68EHDNXK6KNQJYU0XZTF7ARJHR,"#6-9 ""Chelsea Manning exposed serious abuses,"" says Margaret Huang, executive director of the U.S. branch of Amnesty International, ""and as a result her own human rights have been violated.""",38,44,abuses,1,5,6
3PKJ68EHDNXK6KNQJYU0XZTF7ARJHR,"#6-9 ""Chelsea Manning exposed serious abuses,"" says Margaret Huang, executive director of the U.S. branch of Amnesty International, ""and as a result her own human rights have been violated.""",68,77,executive,1,0,1
3PKJ68EHDNXK6KNQJYU0XZTF7ARJHR,"#6-9 ""Chelsea Manning exposed serious abuses,"" says Margaret Huang, executive director of the U.S. branch of Amnesty International, ""and as a result her own human rights have been violated.""",109,116,Amnesty,5,1,6
3PKJ68EHDNXK6KNQJYU0XZTF7ARJHR,"#6-9 ""Chelsea Manning exposed serious abuses,"" says Margaret Huang, executive director of the U.S. branch of Amnesty International, ""and as a result her own human rights have been violated.""",109,130,Amnesty International,1,0,1
3PKJ68EHDNXK6KNQJYU0XZTF7ARJHR,"#6-9 ""Chelsea Manning exposed serious abuses,"" says Margaret Huang, executive director of the U.S. branch of Amnesty International, ""and as a result her own human rights have been violated.""",117,130,International,2,0,2
3PKJ68EHDNXK6KNQJYU0XZTF7ARJHR,"#6-9 ""Chelsea Manning exposed serious abuses,"" says Margaret Huang, executive director of the U.S. branch of Amnesty International, ""and as a result her own human rights have been violated.""",180,188,violated,8,6,14
3PKJ68EHDNXK6KNQJYU0XZTF7ARJHR,"#6-10 Huang went on to call Obama's order for Manning's release ""long overdue.""",6,11,Huang,0,1,1
3PKJ68EHDNXK6KNQJYU0XZTF7ARJHR,"#6-10 Huang went on to call Obama's order for Manning's release ""long overdue.""",65,77,long overdue,2,3,5
3PKJ68EHDNXK6KNQJYU0XZTF7ARJHR,"#6-10 Huang went on to call Obama's order for Manning's release ""long overdue.""",70,77,overdue,3,4,7
3PKJ68EHDNXK6KNQJYU0XZTF7ARJHR,"#6-11 Despite being a trans woman, Manning was housed in a men's prison, the U.S. Disciplinary Barracks at Fort Leavenworth, Kansas.She spent a long period in solitary confinement and attempted suicide twice in 2016.",6,13,Despite,1,1,2
3PKJ68EHDNXK6KNQJYU0XZTF7ARJHR,"#6-11 Despite being a trans woman, Manning was housed in a men's prison, the U.S. Disciplinary Barracks at Fort Leavenworth, Kansas.She spent a long period in solitary confinement and attempted suicide twice in 2016.",22,27,trans,1,0,1
3PKJ68EHDNXK6KNQJYU0XZTF7ARJHR,"#6-11 Despite being a trans woman, Manning was housed in a men's prison, the U.S. Disciplinary Barracks at Fort Leavenworth, Kansas.She spent a long period in solitary confinement and attempted suicide twice in 2016.",22,33,trans woman,3,3,6
3PKJ68EHDNXK6KNQJYU0XZTF7ARJHR,"#6-11 Despite being a trans woman, Manning was housed in a men's prison, the U.S. Disciplinary Barracks at Fort Leavenworth, Kansas.She spent a long period in solitary confinement and attempted suicide twice in 2016.",47,53,housed,2,1,3
3PKJ68EHDNXK6KNQJYU0XZTF7ARJHR,"#6-11 Despite being a trans woman, Manning was housed in a men's prison, the U.S. Disciplinary Barracks at Fort Leavenworth, Kansas.She spent a long period in solitary confinement and attempted suicide twice in 2016.",82,94,Disciplinary,3,0,3
3PKJ68EHDNXK6KNQJYU0XZTF7ARJHR,"#6-11 Despite being a trans woman, Manning was housed in a men's prison, the U.S. Disciplinary Barracks at Fort Leavenworth, Kansas.She spent a long period in solitary confinement and attempted suicide twice in 2016.",82,103,Disciplinary Barracks,0,1,1
3PKJ68EHDNXK6KNQJYU0XZTF7ARJHR,"#6-11 Despite being a trans woman, Manning was housed in a men's prison, the U.S. Disciplinary Barracks at Fort Leavenworth, Kansas.She spent a long period in solitary confinement and attempted suicide twice in 2016.",82,131,"Disciplinary Barracks at Fort Leavenworth, Kansas",1,0,1
3PKJ68EHDNXK6KNQJYU0XZTF7ARJHR,"#6-11 Despite being a trans woman, Manning was housed in a men's prison, the U.S. Disciplinary Barracks at Fort Leavenworth, Kansas.She spent a long period in solitary confinement and attempted suicide twice in 2016.",95,103,Barracks,1,1,2
3PKJ68EHDNXK6KNQJYU0XZTF7ARJHR,"#6-11 Despite being a trans woman, Manning was housed in a men's prison, the U.S. Disciplinary Barracks at Fort Leavenworth, Kansas.She spent a long period in solitary confinement and attempted suicide twice in 2016.",112,123,Leavenworth,1,0,1
3PKJ68EHDNXK6KNQJYU0XZTF7ARJHR,"#6-11 Despite being a trans woman, Manning was housed in a men's prison, the U.S. Disciplinary Barracks at Fort Leavenworth, Kansas.She spent a long period in solitary confinement and attempted suicide twice in 2016.",159,167,solitary,4,2,6
3PKJ68EHDNXK6KNQJYU0XZTF7ARJHR,"#6-11 Despite being a trans woman, Manning was housed in a men's prison, the U.S. Disciplinary Barracks at Fort Leavenworth, Kansas.She spent a long period in solitary confinement and attempted suicide twice in 2016.",159,179,solitary confinement,6,3,9
3PKJ68EHDNXK6KNQJYU0XZTF7ARJHR,"#6-11 Despite being a trans woman, Manning was housed in a men's prison, the U.S. Disciplinary Barracks at Fort Leavenworth, Kansas.She spent a long period in solitary confinement and attempted suicide twice in 2016.",168,179,confinement,3,8,11
3PKJ68EHDNXK6KNQJYU0XZTF7ARJHR,"#6-11 Despite being a trans woman, Manning was housed in a men's prison, the U.S. Disciplinary Barracks at Fort Leavenworth, Kansas.She spent a long period in solitary confinement and attempted suicide twice in 2016.",184,193,attempted,2,0,2
3PKJ68EHDNXK6KNQJYU0XZTF7ARJHR,"#6-11 Despite being a trans woman, Manning was housed in a men's prison, the U.S. Disciplinary Barracks at Fort Leavenworth, Kansas.She spent a long period in solitary confinement and attempted suicide twice in 2016.",184,201,attempted suicide,1,0,1
3PKJ68EHDNXK6KNQJYU0XZTF7ARJHR,"#6-11 Despite being a trans woman, Manning was housed in a men's prison, the U.S. Disciplinary Barracks at Fort Leavenworth, Kansas.She spent a long period in solitary confinement and attempted suicide twice in 2016.",194,201,suicide,2,2,4
3PKJ68EHDNXK6KNQJYU0XZTF7ARJHR,#6-12 Obama's staff told the press WikiLeaks founder Julian Assange's promise to agree to U.S. extradition if Manning was granted clemency had nothing to do with the decision.,35,44,WikiLeaks,1,0,1
3PKJ68EHDNXK6KNQJYU0XZTF7ARJHR,#6-12 Obama's staff told the press WikiLeaks founder Julian Assange's promise to agree to U.S. extradition if Manning was granted clemency had nothing to do with the decision.,53,68,Julian Assanges,0,1,1
3PKJ68EHDNXK6KNQJYU0XZTF7ARJHR,#6-12 Obama's staff told the press WikiLeaks founder Julian Assange's promise to agree to U.S. extradition if Manning was granted clemency had nothing to do with the decision.,90,106,U.S. extradition,0,1,1
3PKJ68EHDNXK6KNQJYU0XZTF7ARJHR,#6-12 Obama's staff told the press WikiLeaks founder Julian Assange's promise to agree to U.S. extradition if Manning was granted clemency had nothing to do with the decision.,95,106,extradition,7,4,11
3PKJ68EHDNXK6KNQJYU0XZTF7ARJHR,#6-12 Obama's staff told the press WikiLeaks founder Julian Assange's promise to agree to U.S. extradition if Manning was granted clemency had nothing to do with the decision.,122,129,granted,0,1,1
3PKJ68EHDNXK6KNQJYU0XZTF7ARJHR,#6-12 Obama's staff told the press WikiLeaks founder Julian Assange's promise to agree to U.S. extradition if Manning was granted clemency had nothing to do with the decision.,122,138,granted clemency,2,0,2
3PKJ68EHDNXK6KNQJYU0XZTF7ARJHR,#6-12 Obama's staff told the press WikiLeaks founder Julian Assange's promise to agree to U.S. extradition if Manning was granted clemency had nothing to do with the decision.,130,138,clemency,9,9,18
3PKJ68EHDNXK6KNQJYU0XZTF7ARJHR,"#6-13 Assange is currently living in the Ecuadorian embassy in London, where he is claiming asylum.",6,13,Assange,1,2,3
3PKJ68EHDNXK6KNQJYU0XZTF7ARJHR,"#6-13 Assange is currently living in the Ecuadorian embassy in London, where he is claiming asylum.",41,51,Ecuadorian,1,1,2
3PKJ68EHDNXK6KNQJYU0XZTF7ARJHR,"#6-13 Assange is currently living in the Ecuadorian embassy in London, where he is claiming asylum.",52,59,embassy,3,0,3
3PKJ68EHDNXK6KNQJYU0XZTF7ARJHR,"#6-13 Assange is currently living in the Ecuadorian embassy in London, where he is claiming asylum.",83,91,claiming,0,1,1
3PKJ68EHDNXK6KNQJYU0XZTF7ARJHR,"#6-13 Assange is currently living in the Ecuadorian embassy in London, where he is claiming asylum.",83,98,claiming asylum,2,2,4
3PKJ68EHDNXK6KNQJYU0XZTF7ARJHR,"#6-13 Assange is currently living in the Ecuadorian embassy in London, where he is claiming asylum.",92,98,asylum,7,8,15
3H1C3QRA01KLEWQIJ558PSJ7PAQECS,#24-25 Nobody had thought twice about it then.,26,31,twice,0,1,1
3H1C3QRA01KLEWQIJ558PSJ7PAQECS,"#24-26 When he heard about the discovery in Vabbinfaru resort we immediately called the Police,"" said Mohamed Ibrahim, a councilman for Fehendhoo Island, to Haveeru Daily.",15,20,heard,0,1,1
3H1C3QRA01KLEWQIJ558PSJ7PAQECS,"#24-26 When he heard about the discovery in Vabbinfaru resort we immediately called the Police,"" said Mohamed Ibrahim, a councilman for Fehendhoo Island, to Haveeru Daily.",31,40,discovery,7,3,10
3H1C3QRA01KLEWQIJ558PSJ7PAQECS,"#24-26 When he heard about the discovery in Vabbinfaru resort we immediately called the Police,"" said Mohamed Ibrahim, a councilman for Fehendhoo Island, to Haveeru Daily.",44,54,Vabbinfaru,1,3,4
3H1C3QRA01KLEWQIJ558PSJ7PAQECS,"#24-26 When he heard about the discovery in Vabbinfaru resort we immediately called the Police,"" said Mohamed Ibrahim, a councilman for Fehendhoo Island, to Haveeru Daily.",44,61,Vabbinfaru resort,1,0,1
3H1C3QRA01KLEWQIJ558PSJ7PAQECS,"#24-26 When he heard about the discovery in Vabbinfaru resort we immediately called the Police,"" said Mohamed Ibrahim, a councilman for Fehendhoo Island, to Haveeru Daily.",55,61,resort,1,0,1
3H1C3QRA01KLEWQIJ558PSJ7PAQECS,"#24-26 When he heard about the discovery in Vabbinfaru resort we immediately called the Police,"" said Mohamed Ibrahim, a councilman for Fehendhoo Island, to Haveeru Daily.",65,76,immediately,3,0,3
3H1C3QRA01KLEWQIJ558PSJ7PAQECS,"#24-26 When he heard about the discovery in Vabbinfaru resort we immediately called the Police,"" said Mohamed Ibrahim, a councilman for Fehendhoo Island, to Haveeru Daily.",65,83,immediately called,0,1,1
3H1C3QRA01KLEWQIJ558PSJ7PAQECS,"#24-26 When he heard about the discovery in Vabbinfaru resort we immediately called the Police,"" said Mohamed Ibrahim, a councilman for Fehendhoo Island, to Haveeru Daily.",102,117,Mohamed Ibrahim,0,1,1
3H1C3QRA01KLEWQIJ558PSJ7PAQECS,"#24-26 When he heard about the discovery in Vabbinfaru resort we immediately called the Police,"" said Mohamed Ibrahim, a councilman for Fehendhoo Island, to Haveeru Daily.",121,131,councilman,9,6,15
3H1C3QRA01KLEWQIJ558PSJ7PAQECS,"#24-26 When he heard about the discovery in Vabbinfaru resort we immediately called the Police,"" said Mohamed Ibrahim, a councilman for Fehendhoo Island, to Haveeru Daily.",136,145,Fehendhoo,1,1,2
3H1C3QRA01KLEWQIJ558PSJ7PAQECS,"#24-26 When he heard about the discovery in Vabbinfaru resort we immediately called the Police,"" said Mohamed Ibrahim, a councilman for Fehendhoo Island, to Haveeru Daily.",136,152,Fehendhoo Island,2,0,2
3H1C3QRA01KLEWQIJ558PSJ7PAQECS,"#24-26 When he heard about the discovery in Vabbinfaru resort we immediately called the Police,"" said Mohamed Ibrahim, a councilman for Fehendhoo Island, to Haveeru Daily.",157,164,Haveeru,1,2,3
3H1C3QRA01KLEWQIJ558PSJ7PAQECS,"#24-27 MH370, while flying from Kuala Lumpur, Malaysia to Beijing, China, vanished without a trace on March 8, 2014.",32,44,Kuala Lumpur,1,1,2
3H1C3QRA01KLEWQIJ558PSJ7PAQECS,"#24-27 MH370, while flying from Kuala Lumpur, Malaysia to Beijing, China, vanished without a trace on March 8, 2014.",74,82,vanished,6,10,16
3H1C3QRA01KLEWQIJ558PSJ7PAQECS,"#24-27 MH370, while flying from Kuala Lumpur, Malaysia to Beijing, China, vanished without a trace on March 8, 2014.",83,98,without a trace,1,0,1
3H1C3QRA01KLEWQIJ558PSJ7PAQECS,"#24-27 MH370, while flying from Kuala Lumpur, Malaysia to Beijing, China, vanished without a trace on March 8, 2014.",93,98,trace,3,4,7
3H1C3QRA01KLEWQIJ558PSJ7PAQECS,#24-28 All 239 passengers and crew are believed to be dead.,15,25,passengers,3,1,4
3H1C3QRA01KLEWQIJ558PSJ7PAQECS,#24-28 All 239 passengers and crew are believed to be dead.,30,34,crew,1,3,4
3H1C3QRA01KLEWQIJ558PSJ7PAQECS,#24-28 All 239 passengers and crew are believed to be dead.,39,47,believed,1,0,1
3H1C3QRA01KLEWQIJ558PSJ7PAQECS,"#24-29 On the day the plane went missing, residents on the small Maldive island of Kudahuvadhoo claimed to have seen a very ""low flying jumbo jet"" crash into the Indian Ocean.",42,51,residents,2,2,4
3H1C3QRA01KLEWQIJ558PSJ7PAQECS,"#24-29 On the day the plane went missing, residents on the small Maldive island of Kudahuvadhoo claimed to have seen a very ""low flying jumbo jet"" crash into the Indian Ocean.",65,72,Maldive,0,1,1
3H1C3QRA01KLEWQIJ558PSJ7PAQECS,"#24-29 On the day the plane went missing, residents on the small Maldive island of Kudahuvadhoo claimed to have seen a very ""low flying jumbo jet"" crash into the Indian Ocean.",83,95,Kudahuvadhoo,3,2,5
3H1C3QRA01KLEWQIJ558PSJ7PAQECS,"#24-29 On the day the plane went missing, residents on the small Maldive island of Kudahuvadhoo claimed to have seen a very ""low flying jumbo jet"" crash into the Indian Ocean.",96,103,claimed,0,3,3
3H1C3QRA01KLEWQIJ558PSJ7PAQECS,"#24-29 On the day the plane went missing, residents on the small Maldive island of Kudahuvadhoo claimed to have seen a very ""low flying jumbo jet"" crash into the Indian Ocean.",125,145,low flying jumbo jet,1,1,2
3H1C3QRA01KLEWQIJ558PSJ7PAQECS,"#24-29 On the day the plane went missing, residents on the small Maldive island of Kudahuvadhoo claimed to have seen a very ""low flying jumbo jet"" crash into the Indian Ocean.",136,145,jumbo jet,1,0,1
3H1C3QRA01KLEWQIJ558PSJ7PAQECS,"#24-29 On the day the plane went missing, residents on the small Maldive island of Kudahuvadhoo claimed to have seen a very ""low flying jumbo jet"" crash into the Indian Ocean.",147,152,crash,0,1,1
3H1C3QRA01KLEWQIJ558PSJ7PAQECS,#24-30 Some also noted the colors appeared to resemble that of a Malaysia Airlines plane.,34,42,appeared,2,1,3
3H1C3QRA01KLEWQIJ558PSJ7PAQECS,#24-30 Some also noted the colors appeared to resemble that of a Malaysia Airlines plane.,46,54,resemble,10,9,19
3H1C3QRA01KLEWQIJ558PSJ7PAQECS,#24-30 Some also noted the colors appeared to resemble that of a Malaysia Airlines plane.,65,73,Malaysia,0,1,1
3H1C3QRA01KLEWQIJ558PSJ7PAQECS,#24-30 Some also noted the colors appeared to resemble that of a Malaysia Airlines plane.,65,82,Malaysia Airlines,1,0,1
3H1C3QRA01KLEWQIJ558PSJ7PAQECS,"#24-32 We've seen seaplanes, but I'm sure that this was not one of those.",18,27,seaplanes,8,7,15
38RHULDV9YG68ZY9WFV0M1O29JFIWE,"#26-14 IKEA spokesperson Anna Pilkrona-Godden told BBC News, ""Our thoughts are with those affected,"" and said the store is closed for the time being.",7,11,IKEA,0,1,1
38RHULDV9YG68ZY9WFV0M1O29JFIWE,"#26-14 IKEA spokesperson Anna Pilkrona-Godden told BBC News, ""Our thoughts are with those affected,"" and said the store is closed for the time being.",12,24,spokesperson,7,5,12
38RHULDV9YG68ZY9WFV0M1O29JFIWE,"#26-14 IKEA spokesperson Anna Pilkrona-Godden told BBC News, ""Our thoughts are with those affected,"" and said the store is closed for the time being.",30,45,Pilkrona-Godden,0,1,1
38RHULDV9YG68ZY9WFV0M1O29JFIWE,"#26-14 IKEA spokesperson Anna Pilkrona-Godden told BBC News, ""Our thoughts are with those affected,"" and said the store is closed for the time being.",90,98,affected,3,2,5
38RHULDV9YG68ZY9WFV0M1O29JFIWE,"#26-14 IKEA spokesperson Anna Pilkrona-Godden told BBC News, ""Our thoughts are with those affected,"" and said the store is closed for the time being.",138,148,time being,1,1,2
38RHULDV9YG68ZY9WFV0M1O29JFIWE,"#26-15 Västerås is in central Sweden, approximately 115 km (70 miles) west from the capital Stockholm.",7,15,Västerås,2,1,3
38RHULDV9YG68ZY9WFV0M1O29JFIWE,"#26-15 Västerås is in central Sweden, approximately 115 km (70 miles) west from the capital Stockholm.",38,51,approximately,8,3,11
38RHULDV9YG68ZY9WFV0M1O29JFIWE,"#26-15 Västerås is in central Sweden, approximately 115 km (70 miles) west from the capital Stockholm.",84,91,capital,1,0,1
38RHULDV9YG68ZY9WFV0M1O29JFIWE,"#26-15 Västerås is in central Sweden, approximately 115 km (70 miles) west from the capital Stockholm.",92,101,Stockholm,0,2,2
38RHULDV9YG68ZY9WFV0M1O29JFIWE,#26-16 The population is roughly 110 thousand.,11,21,population,2,2,4
38RHULDV9YG68ZY9WFV0M1O29JFIWE,#26-16 The population is roughly 110 thousand.,25,32,roughly,2,2,4
38RHULDV9YG68ZY9WFV0M1O29JFIWE,#27-1 Report: Vice-premier of North Korea executed A report published Wednesday by the Yonhap News Agency claims vice premier Choe Yong-gon of North Korea was executed in May.,14,26,Vice-premier,4,2,6
38RHULDV9YG68ZY9WFV0M1O29JFIWE,#27-1 Report: Vice-premier of North Korea executed A report published Wednesday by the Yonhap News Agency claims vice premier Choe Yong-gon of North Korea was executed in May.,42,50,executed,3,3,6
38RHULDV9YG68ZY9WFV0M1O29JFIWE,#27-1 Report: Vice-premier of North Korea executed A report published Wednesday by the Yonhap News Agency claims vice premier Choe Yong-gon of North Korea was executed in May.,60,69,published,2,0,2
38RHULDV9YG68ZY9WFV0M1O29JFIWE,#27-1 Report: Vice-premier of North Korea executed A report published Wednesday by the Yonhap News Agency claims vice premier Choe Yong-gon of North Korea was executed in May.,87,93,Yonhap,1,1,2
38RHULDV9YG68ZY9WFV0M1O29JFIWE,#27-1 Report: Vice-premier of North Korea executed A report published Wednesday by the Yonhap News Agency claims vice premier Choe Yong-gon of North Korea was executed in May.,87,105,Yonhap News Agency,1,0,1
38RHULDV9YG68ZY9WFV0M1O29JFIWE,#27-1 Report: Vice-premier of North Korea executed A report published Wednesday by the Yonhap News Agency claims vice premier Choe Yong-gon of North Korea was executed in May.,106,112,claims,0,1,1
38RHULDV9YG68ZY9WFV0M1O29JFIWE,#27-1 Report: Vice-premier of North Korea executed A report published Wednesday by the Yonhap News Agency claims vice premier Choe Yong-gon of North Korea was executed in May.,113,125,vice premier,2,0,2
38RHULDV9YG68ZY9WFV0M1O29JFIWE,#27-1 Report: Vice-premier of North Korea executed A report published Wednesday by the Yonhap News Agency claims vice premier Choe Yong-gon of North Korea was executed in May.,118,125,premier,3,0,3
38RHULDV9YG68ZY9WFV0M1O29JFIWE,#27-1 Report: Vice-premier of North Korea executed A report published Wednesday by the Yonhap News Agency claims vice premier Choe Yong-gon of North Korea was executed in May.,126,139,Choe Yong-gon,0,1,1
38RHULDV9YG68ZY9WFV0M1O29JFIWE,#27-1 Report: Vice-premier of North Korea executed A report published Wednesday by the Yonhap News Agency claims vice premier Choe Yong-gon of North Korea was executed in May.,131,139,Yong-gon,1,0,1
38RHULDV9YG68ZY9WFV0M1O29JFIWE,#27-1 Report: Vice-premier of North Korea executed A report published Wednesday by the Yonhap News Agency claims vice premier Choe Yong-gon of North Korea was executed in May.,159,167,executed,6,5,11
38RHULDV9YG68ZY9WFV0M1O29JFIWE,"#27-2 The report, which cites an unnamed source, has not been confirmed by Wikinews or other agencies.",24,29,cites,2,3,5
38RHULDV9YG68ZY9WFV0M1O29JFIWE,"#27-2 The report, which cites an unnamed source, has not been confirmed by Wikinews or other agencies.",33,40,unnamed,4,3,7
38RHULDV9YG68ZY9WFV0M1O29JFIWE,"#27-2 The report, which cites an unnamed source, has not been confirmed by Wikinews or other agencies.",33,47,unnamed source,1,2,3
38RHULDV9YG68ZY9WFV0M1O29JFIWE,"#27-2 The report, which cites an unnamed source, has not been confirmed by Wikinews or other agencies.",41,47,source,0,1,1
38RHULDV9YG68ZY9WFV0M1O29JFIWE,"#27-2 The report, which cites an unnamed source, has not been confirmed by Wikinews or other agencies.",62,71,confirmed,3,3,6
38RHULDV9YG68ZY9WFV0M1O29JFIWE,"#27-2 The report, which cites an unnamed source, has not been confirmed by Wikinews or other agencies.",75,83,Wikinews,2,0,2
38RHULDV9YG68ZY9WFV0M1O29JFIWE,#27-3 The government of North Korea rarely makes statements about its internal affairs.,36,42,rarely,0,1,1
38RHULDV9YG68ZY9WFV0M1O29JFIWE,#27-3 The government of North Korea rarely makes statements about its internal affairs.,49,59,statements,2,3,5
38RHULDV9YG68ZY9WFV0M1O29JFIWE,#27-3 The government of North Korea rarely makes statements about its internal affairs.,70,78,internal,3,0,3
38RHULDV9YG68ZY9WFV0M1O29JFIWE,#27-3 The government of North Korea rarely makes statements about its internal affairs.,70,86,internal affairs,1,5,6
38RHULDV9YG68ZY9WFV0M1O29JFIWE,#27-3 The government of North Korea rarely makes statements about its internal affairs.,79,86,affairs,1,2,3
38RHULDV9YG68ZY9WFV0M1O29JFIWE,"#27-4 According to the report, the 63-year-old Choe had disagreed with Supreme Leader Kim Jong-un's forestry policies.",47,51,Choe,1,0,1
38RHULDV9YG68ZY9WFV0M1O29JFIWE,"#27-4 According to the report, the 63-year-old Choe had disagreed with Supreme Leader Kim Jong-un's forestry policies.",56,65,disagreed,1,5,6
38RHULDV9YG68ZY9WFV0M1O29JFIWE,"#27-4 According to the report, the 63-year-old Choe had disagreed with Supreme Leader Kim Jong-un's forestry policies.",71,85,Supreme Leader,1,0,1
38RHULDV9YG68ZY9WFV0M1O29JFIWE,"#27-4 According to the report, the 63-year-old Choe had disagreed with Supreme Leader Kim Jong-un's forestry policies.",86,98,Kim Jong-uns,0,1,1
38RHULDV9YG68ZY9WFV0M1O29JFIWE,"#27-4 According to the report, the 63-year-old Choe had disagreed with Supreme Leader Kim Jong-un's forestry policies.",100,108,forestry,6,3,9
38RHULDV9YG68ZY9WFV0M1O29JFIWE,"#27-4 According to the report, the 63-year-old Choe had disagreed with Supreme Leader Kim Jong-un's forestry policies.",100,117,forestry policies,4,2,6
38RHULDV9YG68ZY9WFV0M1O29JFIWE,"#27-4 According to the report, the 63-year-old Choe had disagreed with Supreme Leader Kim Jong-un's forestry policies.",109,117,policies,1,0,1
38RHULDV9YG68ZY9WFV0M1O29JFIWE,"#27-5 Choe, one of seven vice premiers, was in charge of construction and building material industries.",6,10,Choe,1,1,2
38RHULDV9YG68ZY9WFV0M1O29JFIWE,"#27-5 Choe, one of seven vice premiers, was in charge of construction and building material industries.",25,38,vice premiers,4,0,4
38RHULDV9YG68ZY9WFV0M1O29JFIWE,"#27-5 Choe, one of seven vice premiers, was in charge of construction and building material industries.",30,38,premiers,4,1,5
38RHULDV9YG68ZY9WFV0M1O29JFIWE,"#27-5 Choe, one of seven vice premiers, was in charge of construction and building material industries.",47,53,charge,0,1,1
38RHULDV9YG68ZY9WFV0M1O29JFIWE,"#27-5 Choe, one of seven vice premiers, was in charge of construction and building material industries.",57,69,construction,1,0,1
38RHULDV9YG68ZY9WFV0M1O29JFIWE,"#27-5 Choe, one of seven vice premiers, was in charge of construction and building material industries.",74,82,building,0,1,1
38RHULDV9YG68ZY9WFV0M1O29JFIWE,"#27-5 Choe, one of seven vice premiers, was in charge of construction and building material industries.",83,91,material,1,0,1
38RHULDV9YG68ZY9WFV0M1O29JFIWE,"#27-5 Choe, one of seven vice premiers, was in charge of construction and building material industries.",83,102,material industries,1,0,1
38RHULDV9YG68ZY9WFV0M1O29JFIWE,"#27-5 Choe, one of seven vice premiers, was in charge of construction and building material industries.",92,102,industries,0,1,1
34KYK9TV2R93EA3U60TI3PH48GZBSJ,"#11-8 ""We'd turn the laser on and they'd jump on an object, hold it with their paws and intensively bite it as if they were trying to capture and kill it,"" says lead investigator and Yale Associated Professor of Psychiatry Ivan de Araujo.",21,26,laser,2,2,4
34KYK9TV2R93EA3U60TI3PH48GZBSJ,"#11-8 ""We'd turn the laser on and they'd jump on an object, hold it with their paws and intensively bite it as if they were trying to capture and kill it,"" says lead investigator and Yale Associated Professor of Psychiatry Ivan de Araujo.",52,58,object,2,1,3
34KYK9TV2R93EA3U60TI3PH48GZBSJ,"#11-8 ""We'd turn the laser on and they'd jump on an object, hold it with their paws and intensively bite it as if they were trying to capture and kill it,"" says lead investigator and Yale Associated Professor of Psychiatry Ivan de Araujo.",79,83,paws,2,6,8
34KYK9TV2R93EA3U60TI3PH48GZBSJ,"#11-8 ""We'd turn the laser on and they'd jump on an object, hold it with their paws and intensively bite it as if they were trying to capture and kill it,"" says lead investigator and Yale Associated Professor of Psychiatry Ivan de Araujo.",88,99,intensively,10,6,16
34KYK9TV2R93EA3U60TI3PH48GZBSJ,"#11-8 ""We'd turn the laser on and they'd jump on an object, hold it with their paws and intensively bite it as if they were trying to capture and kill it,"" says lead investigator and Yale Associated Professor of Psychiatry Ivan de Araujo.",88,104,intensively bite,0,1,1
34KYK9TV2R93EA3U60TI3PH48GZBSJ,"#11-8 ""We'd turn the laser on and they'd jump on an object, hold it with their paws and intensively bite it as if they were trying to capture and kill it,"" says lead investigator and Yale Associated Professor of Psychiatry Ivan de Araujo.",100,104,bite,0,1,1
34KYK9TV2R93EA3U60TI3PH48GZBSJ,"#11-8 ""We'd turn the laser on and they'd jump on an object, hold it with their paws and intensively bite it as if they were trying to capture and kill it,"" says lead investigator and Yale Associated Professor of Psychiatry Ivan de Araujo.",134,141,capture,0,3,3
34KYK9TV2R93EA3U60TI3PH48GZBSJ,"#11-8 ""We'd turn the laser on and they'd jump on an object, hold it with their paws and intensively bite it as if they were trying to capture and kill it,"" says lead investigator and Yale Associated Professor of Psychiatry Ivan de Araujo.",166,178,investigator,3,2,5
34KYK9TV2R93EA3U60TI3PH48GZBSJ,"#11-8 ""We'd turn the laser on and they'd jump on an object, hold it with their paws and intensively bite it as if they were trying to capture and kill it,"" says lead investigator and Yale Associated Professor of Psychiatry Ivan de Araujo.",188,198,Associated,1,0,1
34KYK9TV2R93EA3U60TI3PH48GZBSJ,"#11-8 ""We'd turn the laser on and they'd jump on an object, hold it with their paws and intensively bite it as if they were trying to capture and kill it,"" says lead investigator and Yale Associated Professor of Psychiatry Ivan de Araujo.",188,208,Associated Professor,0,1,1
34KYK9TV2R93EA3U60TI3PH48GZBSJ,"#11-8 ""We'd turn the laser on and they'd jump on an object, hold it with their paws and intensively bite it as if they were trying to capture and kill it,"" says lead investigator and Yale Associated Professor of Psychiatry Ivan de Araujo.",212,222,Psychiatry,4,2,6
34KYK9TV2R93EA3U60TI3PH48GZBSJ,"#11-8 ""We'd turn the laser on and they'd jump on an object, hold it with their paws and intensively bite it as if they were trying to capture and kill it,"" says lead investigator and Yale Associated Professor of Psychiatry Ivan de Araujo.",231,237,Araujo,1,0,1
34KYK9TV2R93EA3U60TI3PH48GZBSJ,#11-9 The mice behaved normally at all other times.,10,14,mice,0,1,1
34KYK9TV2R93EA3U60TI3PH48GZBSJ,#11-9 The mice behaved normally at all other times.,15,22,behaved,1,2,3
34KYK9TV2R93EA3U60TI3PH48GZBSJ,"#11-10 The work was inspired by Araujo's desire to study natural feeding behavior, as opposed to animals passively munching on food pellets.",20,28,inspired,2,3,5
34KYK9TV2R93EA3U60TI3PH48GZBSJ,"#11-10 The work was inspired by Araujo's desire to study natural feeding behavior, as opposed to animals passively munching on food pellets.",57,81,natural feeding behavior,1,1,2
34KYK9TV2R93EA3U60TI3PH48GZBSJ,"#11-10 The work was inspired by Araujo's desire to study natural feeding behavior, as opposed to animals passively munching on food pellets.",65,72,feeding,0,1,1
34KYK9TV2R93EA3U60TI3PH48GZBSJ,"#11-10 The work was inspired by Araujo's desire to study natural feeding behavior, as opposed to animals passively munching on food pellets.",73,81,behavior,1,0,1
34KYK9TV2R93EA3U60TI3PH48GZBSJ,"#11-10 The work was inspired by Araujo's desire to study natural feeding behavior, as opposed to animals passively munching on food pellets.",86,93,opposed,2,0,2
34KYK9TV2R93EA3U60TI3PH48GZBSJ,"#11-10 The work was inspired by Araujo's desire to study natural feeding behavior, as opposed to animals passively munching on food pellets.",105,114,passively,5,4,9
34KYK9TV2R93EA3U60TI3PH48GZBSJ,"#11-10 The work was inspired by Araujo's desire to study natural feeding behavior, as opposed to animals passively munching on food pellets.",105,123,passively munching,0,1,1
34KYK9TV2R93EA3U60TI3PH48GZBSJ,"#11-10 The work was inspired by Araujo's desire to study natural feeding behavior, as opposed to animals passively munching on food pellets.",115,123,munching,4,9,13
34KYK9TV2R93EA3U60TI3PH48GZBSJ,"#11-10 The work was inspired by Araujo's desire to study natural feeding behavior, as opposed to animals passively munching on food pellets.",127,139,food pellets,0,2,2
34KYK9TV2R93EA3U60TI3PH48GZBSJ,"#11-10 The work was inspired by Araujo's desire to study natural feeding behavior, as opposed to animals passively munching on food pellets.",132,139,pellets,1,4,5
34KYK9TV2R93EA3U60TI3PH48GZBSJ,"#11-11 The study covered many parts of the brain already known to be associated with feeding, and the results suggested some areas are associated with both hunting and feeding and others only with just one behavior.",69,79,associated,4,2,6
34KYK9TV2R93EA3U60TI3PH48GZBSJ,"#11-11 The study covered many parts of the brain already known to be associated with feeding, and the results suggested some areas are associated with both hunting and feeding and others only with just one behavior.",69,92,associated with feeding,0,1,1
34KYK9TV2R93EA3U60TI3PH48GZBSJ,"#11-11 The study covered many parts of the brain already known to be associated with feeding, and the results suggested some areas are associated with both hunting and feeding and others only with just one behavior.",85,92,feeding,0,1,1
34KYK9TV2R93EA3U60TI3PH48GZBSJ,"#11-11 The study covered many parts of the brain already known to be associated with feeding, and the results suggested some areas are associated with both hunting and feeding and others only with just one behavior.",110,119,suggested,0,2,2
34KYK9TV2R93EA3U60TI3PH48GZBSJ,"#11-11 The study covered many parts of the brain already known to be associated with feeding, and the results suggested some areas are associated with both hunting and feeding and others only with just one behavior.",135,145,associated,3,0,3
34KYK9TV2R93EA3U60TI3PH48GZBSJ,"#11-11 The study covered many parts of the brain already known to be associated with feeding, and the results suggested some areas are associated with both hunting and feeding and others only with just one behavior.",156,163,hunting,0,1,1
34KYK9TV2R93EA3U60TI3PH48GZBSJ,"#11-11 The study covered many parts of the brain already known to be associated with feeding, and the results suggested some areas are associated with both hunting and feeding and others only with just one behavior.",168,175,feeding,0,1,1
34KYK9TV2R93EA3U60TI3PH48GZBSJ,"#11-11 The study covered many parts of the brain already known to be associated with feeding, and the results suggested some areas are associated with both hunting and feeding and others only with just one behavior.",206,214,behavior,1,0,1
34KYK9TV2R93EA3U60TI3PH48GZBSJ,#11-12 Stimulation of the periaqueductal gray (PAG) portion of the brain controlled stalking and stimulation of the reticular formation controlled biting.,7,18,Stimulation,5,7,12
34KYK9TV2R93EA3U60TI3PH48GZBSJ,#11-12 Stimulation of the periaqueductal gray (PAG) portion of the brain controlled stalking and stimulation of the reticular formation controlled biting.,26,40,periaqueductal,8,3,11
34KYK9TV2R93EA3U60TI3PH48GZBSJ,#11-12 Stimulation of the periaqueductal gray (PAG) portion of the brain controlled stalking and stimulation of the reticular formation controlled biting.,26,45,periaqueductal gray,3,2,5
34KYK9TV2R93EA3U60TI3PH48GZBSJ,#11-12 Stimulation of the periaqueductal gray (PAG) portion of the brain controlled stalking and stimulation of the reticular formation controlled biting.,26,50,periaqueductal gray (PAG,1,0,1
34KYK9TV2R93EA3U60TI3PH48GZBSJ,#11-12 Stimulation of the periaqueductal gray (PAG) portion of the brain controlled stalking and stimulation of the reticular formation controlled biting.,73,83,controlled,1,0,1
34KYK9TV2R93EA3U60TI3PH48GZBSJ,#11-12 Stimulation of the periaqueductal gray (PAG) portion of the brain controlled stalking and stimulation of the reticular formation controlled biting.,73,92,controlled stalking,1,0,1
34KYK9TV2R93EA3U60TI3PH48GZBSJ,#11-12 Stimulation of the periaqueductal gray (PAG) portion of the brain controlled stalking and stimulation of the reticular formation controlled biting.,84,92,stalking,4,5,9
34KYK9TV2R93EA3U60TI3PH48GZBSJ,#11-12 Stimulation of the periaqueductal gray (PAG) portion of the brain controlled stalking and stimulation of the reticular formation controlled biting.,84,108,stalking and stimulation,0,2,2
34KYK9TV2R93EA3U60TI3PH48GZBSJ,#11-12 Stimulation of the periaqueductal gray (PAG) portion of the brain controlled stalking and stimulation of the reticular formation controlled biting.,97,108,stimulation,4,1,5
34KYK9TV2R93EA3U60TI3PH48GZBSJ,#11-12 Stimulation of the periaqueductal gray (PAG) portion of the brain controlled stalking and stimulation of the reticular formation controlled biting.,116,125,reticular,8,6,14
34KYK9TV2R93EA3U60TI3PH48GZBSJ,#11-12 Stimulation of the periaqueductal gray (PAG) portion of the brain controlled stalking and stimulation of the reticular formation controlled biting.,116,135,reticular formation,2,3,5
34KYK9TV2R93EA3U60TI3PH48GZBSJ,#11-12 Stimulation of the periaqueductal gray (PAG) portion of the brain controlled stalking and stimulation of the reticular formation controlled biting.,116,146,reticular formation controlled,1,0,1
34KYK9TV2R93EA3U60TI3PH48GZBSJ,#11-12 Stimulation of the periaqueductal gray (PAG) portion of the brain controlled stalking and stimulation of the reticular formation controlled biting.,116,153,reticular formation controlled biting,1,0,1
34KYK9TV2R93EA3U60TI3PH48GZBSJ,#11-12 Stimulation of the periaqueductal gray (PAG) portion of the brain controlled stalking and stimulation of the reticular formation controlled biting.,126,135,formation,2,0,2
34KYK9TV2R93EA3U60TI3PH48GZBSJ,#11-12 Stimulation of the periaqueductal gray (PAG) portion of the brain controlled stalking and stimulation of the reticular formation controlled biting.,136,146,controlled,1,0,1
34KYK9TV2R93EA3U60TI3PH48GZBSJ,#11-12 Stimulation of the periaqueductal gray (PAG) portion of the brain controlled stalking and stimulation of the reticular formation controlled biting.,147,153,biting,0,1,1
3M7OI89LVYPH1HX3DNMAD4RU8C2C65,#6-3 Artist's rendition of Manning as she views herself.,14,23,rendition,7,10,17
3M7OI89LVYPH1HX3DNMAD4RU8C2C65,#6-3 Artist's rendition of Manning as she views herself.,27,34,Manning,0,2,2
3M7OI89LVYPH1HX3DNMAD4RU8C2C65,"#6-4 The information Manning released to the public through WikiLeaks and The Guardian in 2010 included diplomatic accounts, videos, military incident logs, and battle plans, including footage of an American Apache helicopter firing on suspected Iraqi insurgents, reports of prisoners held in Guantanamo Bay without trial, and records of detainees abused by the Iraqi military.",9,20,information,1,1,2
3M7OI89LVYPH1HX3DNMAD4RU8C2C65,"#6-4 The information Manning released to the public through WikiLeaks and The Guardian in 2010 included diplomatic accounts, videos, military incident logs, and battle plans, including footage of an American Apache helicopter firing on suspected Iraqi insurgents, reports of prisoners held in Guantanamo Bay without trial, and records of detainees abused by the Iraqi military.",21,28,Manning,1,0,1
3M7OI89LVYPH1HX3DNMAD4RU8C2C65,"#6-4 The information Manning released to the public through WikiLeaks and The Guardian in 2010 included diplomatic accounts, videos, military incident logs, and battle plans, including footage of an American Apache helicopter firing on suspected Iraqi insurgents, reports of prisoners held in Guantanamo Bay without trial, and records of detainees abused by the Iraqi military.",29,37,released,1,1,2
3M7OI89LVYPH1HX3DNMAD4RU8C2C65,"#6-4 The information Manning released to the public through WikiLeaks and The Guardian in 2010 included diplomatic accounts, videos, military incident logs, and battle plans, including footage of an American Apache helicopter firing on suspected Iraqi insurgents, reports of prisoners held in Guantanamo Bay without trial, and records of detainees abused by the Iraqi military.",60,69,WikiLeaks,2,2,4
3M7OI89LVYPH1HX3DNMAD4RU8C2C65,"#6-4 The information Manning released to the public through WikiLeaks and The Guardian in 2010 included diplomatic accounts, videos, military incident logs, and battle plans, including footage of an American Apache helicopter firing on suspected Iraqi insurgents, reports of prisoners held in Guantanamo Bay without trial, and records of detainees abused by the Iraqi military.",104,114,diplomatic,8,3,11
3M7OI89LVYPH1HX3DNMAD4RU8C2C65,"#6-4 The information Manning released to the public through WikiLeaks and The Guardian in 2010 included diplomatic accounts, videos, military incident logs, and battle plans, including footage of an American Apache helicopter firing on suspected Iraqi insurgents, reports of prisoners held in Guantanamo Bay without trial, and records of detainees abused by the Iraqi military.",104,123,diplomatic accounts,0,2,2
3M7OI89LVYPH1HX3DNMAD4RU8C2C65,"#6-4 The information Manning released to the public through WikiLeaks and The Guardian in 2010 included diplomatic accounts, videos, military incident logs, and battle plans, including footage of an American Apache helicopter firing on suspected Iraqi insurgents, reports of prisoners held in Guantanamo Bay without trial, and records of detainees abused by the Iraqi military.",133,141,military,1,0,1
3M7OI89LVYPH1HX3DNMAD4RU8C2C65,"#6-4 The information Manning released to the public through WikiLeaks and The Guardian in 2010 included diplomatic accounts, videos, military incident logs, and battle plans, including footage of an American Apache helicopter firing on suspected Iraqi insurgents, reports of prisoners held in Guantanamo Bay without trial, and records of detainees abused by the Iraqi military.",133,155,military incident logs,1,0,1
3M7OI89LVYPH1HX3DNMAD4RU8C2C65,"#6-4 The information Manning released to the public through WikiLeaks and The Guardian in 2010 included diplomatic accounts, videos, military incident logs, and battle plans, including footage of an American Apache helicopter firing on suspected Iraqi insurgents, reports of prisoners held in Guantanamo Bay without trial, and records of detainees abused by the Iraqi military.",142,155,incident logs,0,2,2
3M7OI89LVYPH1HX3DNMAD4RU8C2C65,"#6-4 The information Manning released to the public through WikiLeaks and The Guardian in 2010 included diplomatic accounts, videos, military incident logs, and battle plans, including footage of an American Apache helicopter firing on suspected Iraqi insurgents, reports of prisoners held in Guantanamo Bay without trial, and records of detainees abused by the Iraqi military.",151,155,logs,1,1,2
3M7OI89LVYPH1HX3DNMAD4RU8C2C65,"#6-4 The information Manning released to the public through WikiLeaks and The Guardian in 2010 included diplomatic accounts, videos, military incident logs, and battle plans, including footage of an American Apache helicopter firing on suspected Iraqi insurgents, reports of prisoners held in Guantanamo Bay without trial, and records of detainees abused by the Iraqi military.",185,192,footage,2,5,7
3M7OI89LVYPH1HX3DNMAD4RU8C2C65,"#6-4 The information Manning released to the public through WikiLeaks and The Guardian in 2010 included diplomatic accounts, videos, military incident logs, and battle plans, including footage of an American Apache helicopter firing on suspected Iraqi insurgents, reports of prisoners held in Guantanamo Bay without trial, and records of detainees abused by the Iraqi military.",208,214,Apache,1,0,1
3M7OI89LVYPH1HX3DNMAD4RU8C2C65,"#6-4 The information Manning released to the public through WikiLeaks and The Guardian in 2010 included diplomatic accounts, videos, military incident logs, and battle plans, including footage of an American Apache helicopter firing on suspected Iraqi insurgents, reports of prisoners held in Guantanamo Bay without trial, and records of detainees abused by the Iraqi military.",208,225,Apache helicopter,1,0,1
3M7OI89LVYPH1HX3DNMAD4RU8C2C65,"#6-4 The information Manning released to the public through WikiLeaks and The Guardian in 2010 included diplomatic accounts, videos, military incident logs, and battle plans, including footage of an American Apache helicopter firing on suspected Iraqi insurgents, reports of prisoners held in Guantanamo Bay without trial, and records of detainees abused by the Iraqi military.",236,245,suspected,2,4,6
3M7OI89LVYPH1HX3DNMAD4RU8C2C65,"#6-4 The information Manning released to the public through WikiLeaks and The Guardian in 2010 included diplomatic accounts, videos, military incident logs, and battle plans, including footage of an American Apache helicopter firing on suspected Iraqi insurgents, reports of prisoners held in Guantanamo Bay without trial, and records of detainees abused by the Iraqi military.",246,251,Iraqi,0,1,1
3M7OI89LVYPH1HX3DNMAD4RU8C2C65,"#6-4 The information Manning released to the public through WikiLeaks and The Guardian in 2010 included diplomatic accounts, videos, military incident logs, and battle plans, including footage of an American Apache helicopter firing on suspected Iraqi insurgents, reports of prisoners held in Guantanamo Bay without trial, and records of detainees abused by the Iraqi military.",252,262,insurgents,7,7,14
3M7OI89LVYPH1HX3DNMAD4RU8C2C65,"#6-4 The information Manning released to the public through WikiLeaks and The Guardian in 2010 included diplomatic accounts, videos, military incident logs, and battle plans, including footage of an American Apache helicopter firing on suspected Iraqi insurgents, reports of prisoners held in Guantanamo Bay without trial, and records of detainees abused by the Iraqi military.",293,303,Guantanamo,1,1,2
3M7OI89LVYPH1HX3DNMAD4RU8C2C65,"#6-4 The information Manning released to the public through WikiLeaks and The Guardian in 2010 included diplomatic accounts, videos, military incident logs, and battle plans, including footage of an American Apache helicopter firing on suspected Iraqi insurgents, reports of prisoners held in Guantanamo Bay without trial, and records of detainees abused by the Iraqi military.",293,307,Guantanamo Bay,1,0,1
3M7OI89LVYPH1HX3DNMAD4RU8C2C65,"#6-4 The information Manning released to the public through WikiLeaks and The Guardian in 2010 included diplomatic accounts, videos, military incident logs, and battle plans, including footage of an American Apache helicopter firing on suspected Iraqi insurgents, reports of prisoners held in Guantanamo Bay without trial, and records of detainees abused by the Iraqi military.",316,321,trial,0,1,1
3M7OI89LVYPH1HX3DNMAD4RU8C2C65,"#6-4 The information Manning released to the public through WikiLeaks and The Guardian in 2010 included diplomatic accounts, videos, military incident logs, and battle plans, including footage of an American Apache helicopter firing on suspected Iraqi insurgents, reports of prisoners held in Guantanamo Bay without trial, and records of detainees abused by the Iraqi military.",338,347,detainees,10,8,18
3M7OI89LVYPH1HX3DNMAD4RU8C2C65,"#6-4 The information Manning released to the public through WikiLeaks and The Guardian in 2010 included diplomatic accounts, videos, military incident logs, and battle plans, including footage of an American Apache helicopter firing on suspected Iraqi insurgents, reports of prisoners held in Guantanamo Bay without trial, and records of detainees abused by the Iraqi military.",338,354,detainees abused,0,1,1
3M7OI89LVYPH1HX3DNMAD4RU8C2C65,"#6-4 The information Manning released to the public through WikiLeaks and The Guardian in 2010 included diplomatic accounts, videos, military incident logs, and battle plans, including footage of an American Apache helicopter firing on suspected Iraqi insurgents, reports of prisoners held in Guantanamo Bay without trial, and records of detainees abused by the Iraqi military.",348,354,abused,2,4,6
3M7OI89LVYPH1HX3DNMAD4RU8C2C65,"#6-5 Many in Congress have denounced Manning as a traitor, stating the breach endangered U.S. national security.",27,36,denounced,3,5,8
3M7OI89LVYPH1HX3DNMAD4RU8C2C65,"#6-5 Many in Congress have denounced Manning as a traitor, stating the breach endangered U.S. national security.",37,44,Manning,1,0,1
3M7OI89LVYPH1HX3DNMAD4RU8C2C65,"#6-5 Many in Congress have denounced Manning as a traitor, stating the breach endangered U.S. national security.",50,57,traitor,2,4,6
3M7OI89LVYPH1HX3DNMAD4RU8C2C65,"#6-5 Many in Congress have denounced Manning as a traitor, stating the breach endangered U.S. national security.",71,77,breach,2,1,3
3M7OI89LVYPH1HX3DNMAD4RU8C2C65,"#6-5 Many in Congress have denounced Manning as a traitor, stating the breach endangered U.S. national security.",78,88,endangered,4,5,9
3M7OI89LVYPH1HX3DNMAD4RU8C2C65,"#6-6 Manning was convicted in 2013 of 22 charges, including espionage, but acquitted of aiding the enemy.",17,26,convicted,2,1,3
3M7OI89LVYPH1HX3DNMAD4RU8C2C65,"#6-6 Manning was convicted in 2013 of 22 charges, including espionage, but acquitted of aiding the enemy.",60,69,espionage,5,9,14
3M7OI89LVYPH1HX3DNMAD4RU8C2C65,"#6-6 Manning was convicted in 2013 of 22 charges, including espionage, but acquitted of aiding the enemy.",75,84,acquitted,4,7,11
3M7OI89LVYPH1HX3DNMAD4RU8C2C65,"#6-6 Manning was convicted in 2013 of 22 charges, including espionage, but acquitted of aiding the enemy.",88,94,aiding,0,1,1
3M7OI89LVYPH1HX3DNMAD4RU8C2C65,"#6-7 Republican senator John McCain, who ran for president against Obama in 2008, said ""It is a sad, yet perhaps fitting commentary on President Obama's failed national security policies that he would commute the sentence of an individual that endangered the lives of American troops, diplomats, and intelligence sources by leaking hundreds of thousands of sensitive government documents to WikiLeaks, a virulently anti-American organization that was a tool of Russia's recent interference in our elections.""",113,120,fitting,0,1,1
3M7OI89LVYPH1HX3DNMAD4RU8C2C65,"#6-7 Republican senator John McCain, who ran for president against Obama in 2008, said ""It is a sad, yet perhaps fitting commentary on President Obama's failed national security policies that he would commute the sentence of an individual that endangered the lives of American troops, diplomats, and intelligence sources by leaking hundreds of thousands of sensitive government documents to WikiLeaks, a virulently anti-American organization that was a tool of Russia's recent interference in our elections.""",121,131,commentary,3,0,3
3M7OI89LVYPH1HX3DNMAD4RU8C2C65,"#6-7 Republican senator John McCain, who ran for president against Obama in 2008, said ""It is a sad, yet perhaps fitting commentary on President Obama's failed national security policies that he would commute the sentence of an individual that endangered the lives of American troops, diplomats, and intelligence sources by leaking hundreds of thousands of sensitive government documents to WikiLeaks, a virulently anti-American organization that was a tool of Russia's recent interference in our elections.""",201,208,commute,1,4,5
3M7OI89LVYPH1HX3DNMAD4RU8C2C65,"#6-7 Republican senator John McCain, who ran for president against Obama in 2008, said ""It is a sad, yet perhaps fitting commentary on President Obama's failed national security policies that he would commute the sentence of an individual that endangered the lives of American troops, diplomats, and intelligence sources by leaking hundreds of thousands of sensitive government documents to WikiLeaks, a virulently anti-American organization that was a tool of Russia's recent interference in our elections.""",244,254,endangered,3,5,8
3M7OI89LVYPH1HX3DNMAD4RU8C2C65,"#6-7 Republican senator John McCain, who ran for president against Obama in 2008, said ""It is a sad, yet perhaps fitting commentary on President Obama's failed national security policies that he would commute the sentence of an individual that endangered the lives of American troops, diplomats, and intelligence sources by leaking hundreds of thousands of sensitive government documents to WikiLeaks, a virulently anti-American organization that was a tool of Russia's recent interference in our elections.""",285,294,diplomats,1,0,1
3M7OI89LVYPH1HX3DNMAD4RU8C2C65,"#6-7 Republican senator John McCain, who ran for president against Obama in 2008, said ""It is a sad, yet perhaps fitting commentary on President Obama's failed national security policies that he would commute the sentence of an individual that endangered the lives of American troops, diplomats, and intelligence sources by leaking hundreds of thousands of sensitive government documents to WikiLeaks, a virulently anti-American organization that was a tool of Russia's recent interference in our elections.""",300,312,intelligence,1,0,1
3M7OI89LVYPH1HX3DNMAD4RU8C2C65,"#6-7 Republican senator John McCain, who ran for president against Obama in 2008, said ""It is a sad, yet perhaps fitting commentary on President Obama's failed national security policies that he would commute the sentence of an individual that endangered the lives of American troops, diplomats, and intelligence sources by leaking hundreds of thousands of sensitive government documents to WikiLeaks, a virulently anti-American organization that was a tool of Russia's recent interference in our elections.""",324,331,leaking,0,2,2
3M7OI89LVYPH1HX3DNMAD4RU8C2C65,"#6-7 Republican senator John McCain, who ran for president against Obama in 2008, said ""It is a sad, yet perhaps fitting commentary on President Obama's failed national security policies that he would commute the sentence of an individual that endangered the lives of American troops, diplomats, and intelligence sources by leaking hundreds of thousands of sensitive government documents to WikiLeaks, a virulently anti-American organization that was a tool of Russia's recent interference in our elections.""",357,366,sensitive,2,0,2
3M7OI89LVYPH1HX3DNMAD4RU8C2C65,"#6-7 Republican senator John McCain, who ran for president against Obama in 2008, said ""It is a sad, yet perhaps fitting commentary on President Obama's failed national security policies that he would commute the sentence of an individual that endangered the lives of American troops, diplomats, and intelligence sources by leaking hundreds of thousands of sensitive government documents to WikiLeaks, a virulently anti-American organization that was a tool of Russia's recent interference in our elections.""",367,377,government,1,0,1
3M7OI89LVYPH1HX3DNMAD4RU8C2C65,"#6-7 Republican senator John McCain, who ran for president against Obama in 2008, said ""It is a sad, yet perhaps fitting commentary on President Obama's failed national security policies that he would commute the sentence of an individual that endangered the lives of American troops, diplomats, and intelligence sources by leaking hundreds of thousands of sensitive government documents to WikiLeaks, a virulently anti-American organization that was a tool of Russia's recent interference in our elections.""",391,400,WikiLeaks,1,1,2
3M7OI89LVYPH1HX3DNMAD4RU8C2C65,"#6-7 Republican senator John McCain, who ran for president against Obama in 2008, said ""It is a sad, yet perhaps fitting commentary on President Obama's failed national security policies that he would commute the sentence of an individual that endangered the lives of American troops, diplomats, and intelligence sources by leaking hundreds of thousands of sensitive government documents to WikiLeaks, a virulently anti-American organization that was a tool of Russia's recent interference in our elections.""",404,414,virulently,5,9,14
3M7OI89LVYPH1HX3DNMAD4RU8C2C65,"#6-7 Republican senator John McCain, who ran for president against Obama in 2008, said ""It is a sad, yet perhaps fitting commentary on President Obama's failed national security policies that he would commute the sentence of an individual that endangered the lives of American troops, diplomats, and intelligence sources by leaking hundreds of thousands of sensitive government documents to WikiLeaks, a virulently anti-American organization that was a tool of Russia's recent interference in our elections.""",477,489,interference,8,4,12
3M7OI89LVYPH1HX3DNMAD4RU8C2C65,"#6-7 Republican senator John McCain, who ran for president against Obama in 2008, said ""It is a sad, yet perhaps fitting commentary on President Obama's failed national security policies that he would commute the sentence of an individual that endangered the lives of American troops, diplomats, and intelligence sources by leaking hundreds of thousands of sensitive government documents to WikiLeaks, a virulently anti-American organization that was a tool of Russia's recent interference in our elections.""",497,506,elections,1,0,1
3RIHDBQ1NEZA7STBMV7SDRLWB4MHMT,"#5-1 Bomb kills at least 50 in Gao, Mali A vehicle packed with explosives was detonated this morning in Gao, Mali.",5,9,Bomb,1,0,1
3RIHDBQ1NEZA7STBMV7SDRLWB4MHMT,"#5-1 Bomb kills at least 50 in Gao, Mali A vehicle packed with explosives was detonated this morning in Gao, Mali.",43,50,vehicle,1,0,1
3RIHDBQ1NEZA7STBMV7SDRLWB4MHMT,"#5-1 Bomb kills at least 50 in Gao, Mali A vehicle packed with explosives was detonated this morning in Gao, Mali.",51,57,packed,0,2,2
3RIHDBQ1NEZA7STBMV7SDRLWB4MHMT,"#5-1 Bomb kills at least 50 in Gao, Mali A vehicle packed with explosives was detonated this morning in Gao, Mali.",63,73,explosives,9,2,11
3RIHDBQ1NEZA7STBMV7SDRLWB4MHMT,"#5-1 Bomb kills at least 50 in Gao, Mali A vehicle packed with explosives was detonated this morning in Gao, Mali.",78,87,detonated,10,10,20
3RIHDBQ1NEZA7STBMV7SDRLWB4MHMT,"#5-3 The bombing targeted a camp housing government soldiers and rebels, some of whom were in a meeting at the time.",17,25,targeted,3,4,7
3RIHDBQ1NEZA7STBMV7SDRLWB4MHMT,"#5-3 The bombing targeted a camp housing government soldiers and rebels, some of whom were in a meeting at the time.",33,40,housing,0,1,1
3RIHDBQ1NEZA7STBMV7SDRLWB4MHMT,"#5-3 The bombing targeted a camp housing government soldiers and rebels, some of whom were in a meeting at the time.",41,51,government,1,0,1
3RIHDBQ1NEZA7STBMV7SDRLWB4MHMT,"#5-3 The bombing targeted a camp housing government soldiers and rebels, some of whom were in a meeting at the time.",65,71,rebels,0,4,4
3RIHDBQ1NEZA7STBMV7SDRLWB4MHMT,"#5-3 The bombing targeted a camp housing government soldiers and rebels, some of whom were in a meeting at the time.",81,85,whom,0,1,1
3RIHDBQ1NEZA7STBMV7SDRLWB4MHMT,"#5-4 Northern Mali was seized by Islamic militants in 2012, with France leading a military intervention the following year.",23,29,seized,7,6,13
3RIHDBQ1NEZA7STBMV7SDRLWB4MHMT,"#5-4 Northern Mali was seized by Islamic militants in 2012, with France leading a military intervention the following year.",33,40,Islamic,0,1,1
3RIHDBQ1NEZA7STBMV7SDRLWB4MHMT,"#5-4 Northern Mali was seized by Islamic militants in 2012, with France leading a military intervention the following year.",33,50,Islamic militants,2,1,3
3RIHDBQ1NEZA7STBMV7SDRLWB4MHMT,"#5-4 Northern Mali was seized by Islamic militants in 2012, with France leading a military intervention the following year.",41,50,militants,4,1,5
3RIHDBQ1NEZA7STBMV7SDRLWB4MHMT,"#5-4 Northern Mali was seized by Islamic militants in 2012, with France leading a military intervention the following year.",72,79,leading,0,1,1
3RIHDBQ1NEZA7STBMV7SDRLWB4MHMT,"#5-4 Northern Mali was seized by Islamic militants in 2012, with France leading a military intervention the following year.",82,103,military intervention,1,1,2
3RIHDBQ1NEZA7STBMV7SDRLWB4MHMT,"#5-4 Northern Mali was seized by Islamic militants in 2012, with France leading a military intervention the following year.",91,103,intervention,9,5,14
3RIHDBQ1NEZA7STBMV7SDRLWB4MHMT,#5-5 The camp was formed as part of a disputed ceasefire.,38,46,disputed,4,1,5
3RIHDBQ1NEZA7STBMV7SDRLWB4MHMT,#5-5 The camp was formed as part of a disputed ceasefire.,38,56,disputed ceasefire,4,2,6
3RIHDBQ1NEZA7STBMV7SDRLWB4MHMT,#5-5 The camp was formed as part of a disputed ceasefire.,47,56,ceasefire,7,7,14
3RIHDBQ1NEZA7STBMV7SDRLWB4MHMT,"#5-6 Occasional attacks continue, and the latest is the worst in years.",5,15,Occasional,2,1,3
3RIHDBQ1NEZA7STBMV7SDRLWB4MHMT,"#5-6 Occasional attacks continue, and the latest is the worst in years.",56,61,worst,0,2,2
3RIHDBQ1NEZA7STBMV7SDRLWB4MHMT,"#5-7 French Interior Minister Bruno Le Roux called the attack ""highly symbolic"".",30,43,Bruno Le Roux,0,1,1
3RIHDBQ1NEZA7STBMV7SDRLWB4MHMT,"#5-7 French Interior Minister Bruno Le Roux called the attack ""highly symbolic"".",63,78,highly symbolic,2,1,3
3RIHDBQ1NEZA7STBMV7SDRLWB4MHMT,"#5-7 French Interior Minister Bruno Le Roux called the attack ""highly symbolic"".",70,78,symbolic,9,5,14
3RIHDBQ1NEZA7STBMV7SDRLWB4MHMT,#5-8 French President François Hollande visited the scene last week.,22,30,François,0,1,1
3RIHDBQ1NEZA7STBMV7SDRLWB4MHMT,#5-8 French President François Hollande visited the scene last week.,31,39,Hollande,0,1,1
3RIHDBQ1NEZA7STBMV7SDRLWB4MHMT,"#5-9 Victims included people tasked with providing patrols, part of a United Nations-backed move to quell the violence.",5,12,Victims,1,1,2
3RIHDBQ1NEZA7STBMV7SDRLWB4MHMT,"#5-9 Victims included people tasked with providing patrols, part of a United Nations-backed move to quell the violence.",29,35,tasked,0,1,1
3RIHDBQ1NEZA7STBMV7SDRLWB4MHMT,"#5-9 Victims included people tasked with providing patrols, part of a United Nations-backed move to quell the violence.",41,50,providing,2,0,2
3RIHDBQ1NEZA7STBMV7SDRLWB4MHMT,"#5-9 Victims included people tasked with providing patrols, part of a United Nations-backed move to quell the violence.",41,58,providing patrols,1,0,1
3RIHDBQ1NEZA7STBMV7SDRLWB4MHMT,"#5-9 Victims included people tasked with providing patrols, part of a United Nations-backed move to quell the violence.",51,58,patrols,4,3,7
3RIHDBQ1NEZA7STBMV7SDRLWB4MHMT,"#5-9 Victims included people tasked with providing patrols, part of a United Nations-backed move to quell the violence.",97,105,to quell,0,1,1
3RIHDBQ1NEZA7STBMV7SDRLWB4MHMT,"#5-9 Victims included people tasked with providing patrols, part of a United Nations-backed move to quell the violence.",100,105,quell,6,8,14
3RIHDBQ1NEZA7STBMV7SDRLWB4MHMT,"#5-9 Victims included people tasked with providing patrols, part of a United Nations-backed move to quell the violence.",100,118,quell the violence,0,1,1
3RIHDBQ1NEZA7STBMV7SDRLWB4MHMT,"#5-9 Victims included people tasked with providing patrols, part of a United Nations-backed move to quell the violence.",110,118,violence,2,1,3
3RIHDBQ1NEZA7STBMV7SDRLWB4MHMT,#5-10 Malian President Ibrahim Boubacar Keita took to Twitter today to declare three days of mourning.,31,45,Boubacar Keita,0,1,1
3RIHDBQ1NEZA7STBMV7SDRLWB4MHMT,#5-10 Malian President Ibrahim Boubacar Keita took to Twitter today to declare three days of mourning.,71,78,declare,1,1,2
3RIHDBQ1NEZA7STBMV7SDRLWB4MHMT,#5-10 Malian President Ibrahim Boubacar Keita took to Twitter today to declare three days of mourning.,93,101,mourning,8,8,16
3OLZC0DJ8JGTTAY465Q40Z5O2ADIV4,"#25-9 While sluggish wage growth remains a pocket of weakness in the economic recovery, steady payroll gains averaging 242,000 per month over the past twelve months have led observers to consider a Federal Reserve interest rate hike as increasingly likely, according to The New York Times.",12,20,sluggish,10,10,20
3OLZC0DJ8JGTTAY465Q40Z5O2ADIV4,"#25-9 While sluggish wage growth remains a pocket of weakness in the economic recovery, steady payroll gains averaging 242,000 per month over the past twelve months have led observers to consider a Federal Reserve interest rate hike as increasingly likely, according to The New York Times.",12,32,sluggish wage growth,1,1,2
3OLZC0DJ8JGTTAY465Q40Z5O2ADIV4,"#25-9 While sluggish wage growth remains a pocket of weakness in the economic recovery, steady payroll gains averaging 242,000 per month over the past twelve months have led observers to consider a Federal Reserve interest rate hike as increasingly likely, according to The New York Times.",21,25,wage,0,1,1
3OLZC0DJ8JGTTAY465Q40Z5O2ADIV4,"#25-9 While sluggish wage growth remains a pocket of weakness in the economic recovery, steady payroll gains averaging 242,000 per month over the past twelve months have led observers to consider a Federal Reserve interest rate hike as increasingly likely, according to The New York Times.",43,61,pocket of weakness,2,1,3
3OLZC0DJ8JGTTAY465Q40Z5O2ADIV4,"#25-9 While sluggish wage growth remains a pocket of weakness in the economic recovery, steady payroll gains averaging 242,000 per month over the past twelve months have led observers to consider a Federal Reserve interest rate hike as increasingly likely, according to The New York Times.",53,61,weakness,1,1,2
3OLZC0DJ8JGTTAY465Q40Z5O2ADIV4,"#25-9 While sluggish wage growth remains a pocket of weakness in the economic recovery, steady payroll gains averaging 242,000 per month over the past twelve months have led observers to consider a Federal Reserve interest rate hike as increasingly likely, according to The New York Times.",69,77,economic,2,0,2
3OLZC0DJ8JGTTAY465Q40Z5O2ADIV4,"#25-9 While sluggish wage growth remains a pocket of weakness in the economic recovery, steady payroll gains averaging 242,000 per month over the past twelve months have led observers to consider a Federal Reserve interest rate hike as increasingly likely, according to The New York Times.",69,86,economic recovery,2,1,3
3OLZC0DJ8JGTTAY465Q40Z5O2ADIV4,"#25-9 While sluggish wage growth remains a pocket of weakness in the economic recovery, steady payroll gains averaging 242,000 per month over the past twelve months have led observers to consider a Federal Reserve interest rate hike as increasingly likely, according to The New York Times.",88,94,steady,1,1,2
3OLZC0DJ8JGTTAY465Q40Z5O2ADIV4,"#25-9 While sluggish wage growth remains a pocket of weakness in the economic recovery, steady payroll gains averaging 242,000 per month over the past twelve months have led observers to consider a Federal Reserve interest rate hike as increasingly likely, according to The New York Times.",88,102,steady payroll,0,1,1
3OLZC0DJ8JGTTAY465Q40Z5O2ADIV4,"#25-9 While sluggish wage growth remains a pocket of weakness in the economic recovery, steady payroll gains averaging 242,000 per month over the past twelve months have led observers to consider a Federal Reserve interest rate hike as increasingly likely, according to The New York Times.",95,102,payroll,2,9,11
3OLZC0DJ8JGTTAY465Q40Z5O2ADIV4,"#25-9 While sluggish wage growth remains a pocket of weakness in the economic recovery, steady payroll gains averaging 242,000 per month over the past twelve months have led observers to consider a Federal Reserve interest rate hike as increasingly likely, according to The New York Times.",95,108,payroll gains,1,0,1
3OLZC0DJ8JGTTAY465Q40Z5O2ADIV4,"#25-9 While sluggish wage growth remains a pocket of weakness in the economic recovery, steady payroll gains averaging 242,000 per month over the past twelve months have led observers to consider a Federal Reserve interest rate hike as increasingly likely, according to The New York Times.",109,118,averaging,4,0,4
3OLZC0DJ8JGTTAY465Q40Z5O2ADIV4,"#25-9 While sluggish wage growth remains a pocket of weakness in the economic recovery, steady payroll gains averaging 242,000 per month over the past twelve months have led observers to consider a Federal Reserve interest rate hike as increasingly likely, according to The New York Times.",170,173,led,0,1,1
3OLZC0DJ8JGTTAY465Q40Z5O2ADIV4,"#25-9 While sluggish wage growth remains a pocket of weakness in the economic recovery, steady payroll gains averaging 242,000 per month over the past twelve months have led observers to consider a Federal Reserve interest rate hike as increasingly likely, according to The New York Times.",174,183,observers,3,3,6
3OLZC0DJ8JGTTAY465Q40Z5O2ADIV4,"#25-9 While sluggish wage growth remains a pocket of weakness in the economic recovery, steady payroll gains averaging 242,000 per month over the past twelve months have led observers to consider a Federal Reserve interest rate hike as increasingly likely, according to The New York Times.",198,205,Federal,1,1,2
3OLZC0DJ8JGTTAY465Q40Z5O2ADIV4,"#25-9 While sluggish wage growth remains a pocket of weakness in the economic recovery, steady payroll gains averaging 242,000 per month over the past twelve months have led observers to consider a Federal Reserve interest rate hike as increasingly likely, according to The New York Times.",198,213,Federal Reserve,2,0,2
3OLZC0DJ8JGTTAY465Q40Z5O2ADIV4,"#25-9 While sluggish wage growth remains a pocket of weakness in the economic recovery, steady payroll gains averaging 242,000 per month over the past twelve months have led observers to consider a Federal Reserve interest rate hike as increasingly likely, according to The New York Times.",206,213,Reserve,1,0,1
3OLZC0DJ8JGTTAY465Q40Z5O2ADIV4,"#25-9 While sluggish wage growth remains a pocket of weakness in the economic recovery, steady payroll gains averaging 242,000 per month over the past twelve months have led observers to consider a Federal Reserve interest rate hike as increasingly likely, according to The New York Times.",228,232,hike,0,5,5
3OLZC0DJ8JGTTAY465Q40Z5O2ADIV4,"#25-9 While sluggish wage growth remains a pocket of weakness in the economic recovery, steady payroll gains averaging 242,000 per month over the past twelve months have led observers to consider a Federal Reserve interest rate hike as increasingly likely, according to The New York Times.",236,248,increasingly,2,1,3
3OLZC0DJ8JGTTAY465Q40Z5O2ADIV4,"#25-9 While sluggish wage growth remains a pocket of weakness in the economic recovery, steady payroll gains averaging 242,000 per month over the past twelve months have led observers to consider a Federal Reserve interest rate hike as increasingly likely, according to The New York Times.",257,269,according to,1,0,1
3OLZC0DJ8JGTTAY465Q40Z5O2ADIV4,"#25-10 ""We view this report as easily clearing the hurdle needed to keep the Fed on track for a September rate hike,"" said Rob Martin, an economist at Barclays in New York.",38,57,clearing the hurdle,1,0,1
3OLZC0DJ8JGTTAY465Q40Z5O2ADIV4,"#25-10 ""We view this report as easily clearing the hurdle needed to keep the Fed on track for a September rate hike,"" said Rob Martin, an economist at Barclays in New York.",51,57,hurdle,8,10,18
3OLZC0DJ8JGTTAY465Q40Z5O2ADIV4,"#25-10 ""We view this report as easily clearing the hurdle needed to keep the Fed on track for a September rate hike,"" said Rob Martin, an economist at Barclays in New York.",77,80,Fed,2,1,3
3OLZC0DJ8JGTTAY465Q40Z5O2ADIV4,"#25-10 ""We view this report as easily clearing the hurdle needed to keep the Fed on track for a September rate hike,"" said Rob Martin, an economist at Barclays in New York.",106,115,rate hike,2,0,2
3OLZC0DJ8JGTTAY465Q40Z5O2ADIV4,"#25-10 ""We view this report as easily clearing the hurdle needed to keep the Fed on track for a September rate hike,"" said Rob Martin, an economist at Barclays in New York.",111,115,hike,0,1,1
3OLZC0DJ8JGTTAY465Q40Z5O2ADIV4,"#25-10 ""We view this report as easily clearing the hurdle needed to keep the Fed on track for a September rate hike,"" said Rob Martin, an economist at Barclays in New York.",138,147,economist,9,1,10
3OLZC0DJ8JGTTAY465Q40Z5O2ADIV4,"#25-11 ""The bar for not moving now is much higher.""",12,15,bar,0,1,1
3OLZC0DJ8JGTTAY465Q40Z5O2ADIV4,"#25-12 Although the Federal Reserve has not explicitly stated that they plan to raise interest rates in the near future, the US central bank has stated that it would raise rates when it has seen ""some further improvement"" in the jobs market.",20,35,Federal Reserve,1,1,2
3OLZC0DJ8JGTTAY465Q40Z5O2ADIV4,"#25-12 Although the Federal Reserve has not explicitly stated that they plan to raise interest rates in the near future, the US central bank has stated that it would raise rates when it has seen ""some further improvement"" in the jobs market.",44,54,explicitly,8,10,18
3OLZC0DJ8JGTTAY465Q40Z5O2ADIV4,"#25-12 Although the Federal Reserve has not explicitly stated that they plan to raise interest rates in the near future, the US central bank has stated that it would raise rates when it has seen ""some further improvement"" in the jobs market.",44,61,explicitly stated,0,1,1
3OLZC0DJ8JGTTAY465Q40Z5O2ADIV4,"#25-12 Although the Federal Reserve has not explicitly stated that they plan to raise interest rates in the near future, the US central bank has stated that it would raise rates when it has seen ""some further improvement"" in the jobs market.",86,100,interest rates,1,0,1
3OLZC0DJ8JGTTAY465Q40Z5O2ADIV4,"#25-12 Although the Federal Reserve has not explicitly stated that they plan to raise interest rates in the near future, the US central bank has stated that it would raise rates when it has seen ""some further improvement"" in the jobs market.",145,151,stated,0,2,2
3OLZC0DJ8JGTTAY465Q40Z5O2ADIV4,"#25-12 Although the Federal Reserve has not explicitly stated that they plan to raise interest rates in the near future, the US central bank has stated that it would raise rates when it has seen ""some further improvement"" in the jobs market.",201,220,further improvement,0,1,1
3OLZC0DJ8JGTTAY465Q40Z5O2ADIV4,"#25-12 Although the Federal Reserve has not explicitly stated that they plan to raise interest rates in the near future, the US central bank has stated that it would raise rates when it has seen ""some further improvement"" in the jobs market.",209,220,improvement,3,2,5
3OLZC0DJ8JGTTAY465Q40Z5O2ADIV4,"#25-12 Although the Federal Reserve has not explicitly stated that they plan to raise interest rates in the near future, the US central bank has stated that it would raise rates when it has seen ""some further improvement"" in the jobs market.",229,240,jobs market,1,0,1
30OITAWPBQ4V08AHXM3N85FCB5FH9U,"#24-19 The management has decided to hand it over to the Police"", said an unnamed official to SunOnline, who said authorities don't know if any of the debris taken away has been destroyed.",11,21,management,5,4,9
30OITAWPBQ4V08AHXM3N85FCB5FH9U,"#24-19 The management has decided to hand it over to the Police"", said an unnamed official to SunOnline, who said authorities don't know if any of the debris taken away has been destroyed.",37,49,hand it over,0,1,1
30OITAWPBQ4V08AHXM3N85FCB5FH9U,"#24-19 The management has decided to hand it over to the Police"", said an unnamed official to SunOnline, who said authorities don't know if any of the debris taken away has been destroyed.",74,81,unnamed,2,1,3
30OITAWPBQ4V08AHXM3N85FCB5FH9U,"#24-19 The management has decided to hand it over to the Police"", said an unnamed official to SunOnline, who said authorities don't know if any of the debris taken away has been destroyed.",114,125,authorities,5,3,8
30OITAWPBQ4V08AHXM3N85FCB5FH9U,"#24-19 The management has decided to hand it over to the Police"", said an unnamed official to SunOnline, who said authorities don't know if any of the debris taken away has been destroyed.",151,157,debris,8,8,16
30OITAWPBQ4V08AHXM3N85FCB5FH9U,"#24-19 The management has decided to hand it over to the Police"", said an unnamed official to SunOnline, who said authorities don't know if any of the debris taken away has been destroyed.",178,187,destroyed,1,1,2
30OITAWPBQ4V08AHXM3N85FCB5FH9U,#24-20 The Serious and Organized Crime Unit of the Maldives Police Service and experts from the Maldives Civil Aviation Authority are heading the investigation.,7,43,The Serious and Organized Crime Unit,1,0,1
30OITAWPBQ4V08AHXM3N85FCB5FH9U,#24-20 The Serious and Organized Crime Unit of the Maldives Police Service and experts from the Maldives Civil Aviation Authority are heading the investigation.,11,43,Serious and Organized Crime Unit,1,0,1
30OITAWPBQ4V08AHXM3N85FCB5FH9U,#24-20 The Serious and Organized Crime Unit of the Maldives Police Service and experts from the Maldives Civil Aviation Authority are heading the investigation.,23,32,Organized,0,2,2
30OITAWPBQ4V08AHXM3N85FCB5FH9U,#24-20 The Serious and Organized Crime Unit of the Maldives Police Service and experts from the Maldives Civil Aviation Authority are heading the investigation.,51,59,Maldives,0,1,1
30OITAWPBQ4V08AHXM3N85FCB5FH9U,#24-20 The Serious and Organized Crime Unit of the Maldives Police Service and experts from the Maldives Civil Aviation Authority are heading the investigation.,79,86,experts,0,3,3
30OITAWPBQ4V08AHXM3N85FCB5FH9U,#24-20 The Serious and Organized Crime Unit of the Maldives Police Service and experts from the Maldives Civil Aviation Authority are heading the investigation.,96,129,Maldives Civil Aviation Authority,1,0,1
30OITAWPBQ4V08AHXM3N85FCB5FH9U,#24-20 The Serious and Organized Crime Unit of the Maldives Police Service and experts from the Maldives Civil Aviation Authority are heading the investigation.,105,110,Civil,3,0,3
30OITAWPBQ4V08AHXM3N85FCB5FH9U,#24-20 The Serious and Organized Crime Unit of the Maldives Police Service and experts from the Maldives Civil Aviation Authority are heading the investigation.,105,129,Civil Aviation Authority,1,0,1
30OITAWPBQ4V08AHXM3N85FCB5FH9U,#24-20 The Serious and Organized Crime Unit of the Maldives Police Service and experts from the Maldives Civil Aviation Authority are heading the investigation.,111,119,Aviation,3,4,7
30OITAWPBQ4V08AHXM3N85FCB5FH9U,#24-20 The Serious and Organized Crime Unit of the Maldives Police Service and experts from the Maldives Civil Aviation Authority are heading the investigation.,120,129,Authority,1,0,1
30OITAWPBQ4V08AHXM3N85FCB5FH9U,#24-20 The Serious and Organized Crime Unit of the Maldives Police Service and experts from the Maldives Civil Aviation Authority are heading the investigation.,134,141,heading,0,1,1
30OITAWPBQ4V08AHXM3N85FCB5FH9U,#24-20 The Serious and Organized Crime Unit of the Maldives Police Service and experts from the Maldives Civil Aviation Authority are heading the investigation.,146,159,investigation,8,4,12
30OITAWPBQ4V08AHXM3N85FCB5FH9U,"#24-21 Yesterday, reports stated several more pieces of debris, one piece measuring some eight feet by two feet (about 2.4 by 0.6 m), were found on Baa Atoll, Fehendhoo and Fulhahdhoo and washed ashore sometime in the past few days.",7,16,Yesterday,1,0,1
30OITAWPBQ4V08AHXM3N85FCB5FH9U,"#24-21 Yesterday, reports stated several more pieces of debris, one piece measuring some eight feet by two feet (about 2.4 by 0.6 m), were found on Baa Atoll, Fehendhoo and Fulhahdhoo and washed ashore sometime in the past few days.",56,62,debris,5,3,8
30OITAWPBQ4V08AHXM3N85FCB5FH9U,"#24-21 Yesterday, reports stated several more pieces of debris, one piece measuring some eight feet by two feet (about 2.4 by 0.6 m), were found on Baa Atoll, Fehendhoo and Fulhahdhoo and washed ashore sometime in the past few days.",74,83,measuring,3,4,7
30OITAWPBQ4V08AHXM3N85FCB5FH9U,"#24-21 Yesterday, reports stated several more pieces of debris, one piece measuring some eight feet by two feet (about 2.4 by 0.6 m), were found on Baa Atoll, Fehendhoo and Fulhahdhoo and washed ashore sometime in the past few days.",148,157,Baa Atoll,0,1,1
30OITAWPBQ4V08AHXM3N85FCB5FH9U,"#24-21 Yesterday, reports stated several more pieces of debris, one piece measuring some eight feet by two feet (about 2.4 by 0.6 m), were found on Baa Atoll, Fehendhoo and Fulhahdhoo and washed ashore sometime in the past few days.",159,168,Fehendhoo,2,1,3
30OITAWPBQ4V08AHXM3N85FCB5FH9U,"#24-21 Yesterday, reports stated several more pieces of debris, one piece measuring some eight feet by two feet (about 2.4 by 0.6 m), were found on Baa Atoll, Fehendhoo and Fulhahdhoo and washed ashore sometime in the past few days.",173,183,Fulhahdhoo,1,1,2
30OITAWPBQ4V08AHXM3N85FCB5FH9U,"#24-21 Yesterday, reports stated several more pieces of debris, one piece measuring some eight feet by two feet (about 2.4 by 0.6 m), were found on Baa Atoll, Fehendhoo and Fulhahdhoo and washed ashore sometime in the past few days.",195,201,ashore,4,7,11
30OITAWPBQ4V08AHXM3N85FCB5FH9U,"#24-22 One piece appears to have a serial number on the side, possibly reading '021411270507.'",11,16,piece,0,1,1
30OITAWPBQ4V08AHXM3N85FCB5FH9U,"#24-22 One piece appears to have a serial number on the side, possibly reading '021411270507.'",17,24,appears,1,0,1
30OITAWPBQ4V08AHXM3N85FCB5FH9U,"#24-22 One piece appears to have a serial number on the side, possibly reading '021411270507.'",35,41,serial,3,0,3
30OITAWPBQ4V08AHXM3N85FCB5FH9U,"#24-22 One piece appears to have a serial number on the side, possibly reading '021411270507.'",35,48,serial number,1,0,1
30OITAWPBQ4V08AHXM3N85FCB5FH9U,#24-23 Initially residents who found the debris took it home.,7,16,Initially,6,3,9
30OITAWPBQ4V08AHXM3N85FCB5FH9U,#24-23 Initially residents who found the debris took it home.,17,26,residents,3,2,5
30OITAWPBQ4V08AHXM3N85FCB5FH9U,#24-23 Initially residents who found the debris took it home.,41,47,debris,1,3,4
30OITAWPBQ4V08AHXM3N85FCB5FH9U,"#24-24 ""A resident had found the debris and taken it home.",10,18,resident,1,3,4
30OITAWPBQ4V08AHXM3N85FCB5FH9U,"#24-24 ""A resident had found the debris and taken it home.",33,39,debris,3,3,6
33KMQD9OFJFUT0GC5GJR3WZC2CV776,#6-14 He faces rape accusations from two Swedish women.,15,19,rape,1,0,1
33KMQD9OFJFUT0GC5GJR3WZC2CV776,#6-14 He faces rape accusations from two Swedish women.,15,31,rape accusations,0,1,1
33KMQD9OFJFUT0GC5GJR3WZC2CV776,#6-14 He faces rape accusations from two Swedish women.,20,31,accusations,10,10,20
33KMQD9OFJFUT0GC5GJR3WZC2CV776,#6-14 He faces rape accusations from two Swedish women.,41,48,Swedish,0,1,1
33KMQD9OFJFUT0GC5GJR3WZC2CV776,"#6-15 The Obama administration has seen what The New York Times calls an ""unprecedented crackdown on leaks of government secrets.""",16,30,administration,2,2,4
33KMQD9OFJFUT0GC5GJR3WZC2CV776,"#6-15 The Obama administration has seen what The New York Times calls an ""unprecedented crackdown on leaks of government secrets.""",74,87,unprecedented,10,9,19
33KMQD9OFJFUT0GC5GJR3WZC2CV776,"#6-15 The Obama administration has seen what The New York Times calls an ""unprecedented crackdown on leaks of government secrets.""",74,97,unprecedented crackdown,2,4,6
33KMQD9OFJFUT0GC5GJR3WZC2CV776,"#6-15 The Obama administration has seen what The New York Times calls an ""unprecedented crackdown on leaks of government secrets.""",88,97,crackdown,2,7,9
33KMQD9OFJFUT0GC5GJR3WZC2CV776,"#6-15 The Obama administration has seen what The New York Times calls an ""unprecedented crackdown on leaks of government secrets.""",101,106,leaks,1,2,3
33KMQD9OFJFUT0GC5GJR3WZC2CV776,"#6-15 The Obama administration has seen what The New York Times calls an ""unprecedented crackdown on leaks of government secrets.""",101,128,leaks of government secrets,1,0,1
33KMQD9OFJFUT0GC5GJR3WZC2CV776,"#6-15 The Obama administration has seen what The New York Times calls an ""unprecedented crackdown on leaks of government secrets.""",110,120,government,0,1,1
33KMQD9OFJFUT0GC5GJR3WZC2CV776,"#6-16 Manning is among more than 1,500 individuals whom President Obama has granted clemency during his tenure.",6,13,Manning,1,2,3
33KMQD9OFJFUT0GC5GJR3WZC2CV776,"#6-16 Manning is among more than 1,500 individuals whom President Obama has granted clemency during his tenure.",39,50,individuals,0,1,1
33KMQD9OFJFUT0GC5GJR3WZC2CV776,"#6-16 Manning is among more than 1,500 individuals whom President Obama has granted clemency during his tenure.",76,83,granted,0,1,1
33KMQD9OFJFUT0GC5GJR3WZC2CV776,"#6-16 Manning is among more than 1,500 individuals whom President Obama has granted clemency during his tenure.",84,92,clemency,10,9,19
33KMQD9OFJFUT0GC5GJR3WZC2CV776,"#6-16 Manning is among more than 1,500 individuals whom President Obama has granted clemency during his tenure.",104,110,tenure,4,7,11
33KMQD9OFJFUT0GC5GJR3WZC2CV776,#6-17 White House Press Secretary Josh Ernest was asked if NSA whistleblower Edward Snowden would also be pardoned.,34,45,Josh Ernest,0,1,1
33KMQD9OFJFUT0GC5GJR3WZC2CV776,#6-17 White House Press Secretary Josh Ernest was asked if NSA whistleblower Edward Snowden would also be pardoned.,63,76,whistleblower,8,9,17
33KMQD9OFJFUT0GC5GJR3WZC2CV776,#6-17 White House Press Secretary Josh Ernest was asked if NSA whistleblower Edward Snowden would also be pardoned.,77,83,Edward,0,1,1
33KMQD9OFJFUT0GC5GJR3WZC2CV776,#6-17 White House Press Secretary Josh Ernest was asked if NSA whistleblower Edward Snowden would also be pardoned.,84,91,Snowden,0,1,1
33KMQD9OFJFUT0GC5GJR3WZC2CV776,#6-17 White House Press Secretary Josh Ernest was asked if NSA whistleblower Edward Snowden would also be pardoned.,106,114,pardoned,5,10,15
33KMQD9OFJFUT0GC5GJR3WZC2CV776,"#6-18 Ernest said no, saying the information Snowden released was more dangerous to the U.S. public and pointed out that while Manning had gone through a formal trial and acknowledged wrongdoing, ""Mr. Snowden fled into the arms of an adversary and has sought refuge in a country that most recently made a concerted effort to undermine confidence in our democracy.""",71,80,dangerous,2,0,2
33KMQD9OFJFUT0GC5GJR3WZC2CV776,"#6-18 Ernest said no, saying the information Snowden released was more dangerous to the U.S. public and pointed out that while Manning had gone through a formal trial and acknowledged wrongdoing, ""Mr. Snowden fled into the arms of an adversary and has sought refuge in a country that most recently made a concerted effort to undermine confidence in our democracy.""",154,166,formal trial,0,1,1
33KMQD9OFJFUT0GC5GJR3WZC2CV776,"#6-18 Ernest said no, saying the information Snowden released was more dangerous to the U.S. public and pointed out that while Manning had gone through a formal trial and acknowledged wrongdoing, ""Mr. Snowden fled into the arms of an adversary and has sought refuge in a country that most recently made a concerted effort to undermine confidence in our democracy.""",171,183,acknowledged,2,0,2
33KMQD9OFJFUT0GC5GJR3WZC2CV776,"#6-18 Ernest said no, saying the information Snowden released was more dangerous to the U.S. public and pointed out that while Manning had gone through a formal trial and acknowledged wrongdoing, ""Mr. Snowden fled into the arms of an adversary and has sought refuge in a country that most recently made a concerted effort to undermine confidence in our democracy.""",171,194,acknowledged wrongdoing,2,2,4
33KMQD9OFJFUT0GC5GJR3WZC2CV776,"#6-18 Ernest said no, saying the information Snowden released was more dangerous to the U.S. public and pointed out that while Manning had gone through a formal trial and acknowledged wrongdoing, ""Mr. Snowden fled into the arms of an adversary and has sought refuge in a country that most recently made a concerted effort to undermine confidence in our democracy.""",184,194,wrongdoing,2,4,6
33KMQD9OFJFUT0GC5GJR3WZC2CV776,"#6-18 Ernest said no, saying the information Snowden released was more dangerous to the U.S. public and pointed out that while Manning had gone through a formal trial and acknowledged wrongdoing, ""Mr. Snowden fled into the arms of an adversary and has sought refuge in a country that most recently made a concerted effort to undermine confidence in our democracy.""",234,243,adversary,7,8,15
33KMQD9OFJFUT0GC5GJR3WZC2CV776,"#6-18 Ernest said no, saying the information Snowden released was more dangerous to the U.S. public and pointed out that while Manning had gone through a formal trial and acknowledged wrongdoing, ""Mr. Snowden fled into the arms of an adversary and has sought refuge in a country that most recently made a concerted effort to undermine confidence in our democracy.""",252,258,sought,3,2,5
33KMQD9OFJFUT0GC5GJR3WZC2CV776,"#6-18 Ernest said no, saying the information Snowden released was more dangerous to the U.S. public and pointed out that while Manning had gone through a formal trial and acknowledged wrongdoing, ""Mr. Snowden fled into the arms of an adversary and has sought refuge in a country that most recently made a concerted effort to undermine confidence in our democracy.""",252,265,sought refuge,0,2,2
33KMQD9OFJFUT0GC5GJR3WZC2CV776,"#6-18 Ernest said no, saying the information Snowden released was more dangerous to the U.S. public and pointed out that while Manning had gone through a formal trial and acknowledged wrongdoing, ""Mr. Snowden fled into the arms of an adversary and has sought refuge in a country that most recently made a concerted effort to undermine confidence in our democracy.""",259,265,refuge,2,3,5
33KMQD9OFJFUT0GC5GJR3WZC2CV776,"#6-18 Ernest said no, saying the information Snowden released was more dangerous to the U.S. public and pointed out that while Manning had gone through a formal trial and acknowledged wrongdoing, ""Mr. Snowden fled into the arms of an adversary and has sought refuge in a country that most recently made a concerted effort to undermine confidence in our democracy.""",305,314,concerted,6,4,10
33KMQD9OFJFUT0GC5GJR3WZC2CV776,"#6-18 Ernest said no, saying the information Snowden released was more dangerous to the U.S. public and pointed out that while Manning had gone through a formal trial and acknowledged wrongdoing, ""Mr. Snowden fled into the arms of an adversary and has sought refuge in a country that most recently made a concerted effort to undermine confidence in our democracy.""",305,321,concerted effort,0,2,2
33KMQD9OFJFUT0GC5GJR3WZC2CV776,"#6-18 Ernest said no, saying the information Snowden released was more dangerous to the U.S. public and pointed out that while Manning had gone through a formal trial and acknowledged wrongdoing, ""Mr. Snowden fled into the arms of an adversary and has sought refuge in a country that most recently made a concerted effort to undermine confidence in our democracy.""",325,334,undermine,4,4,8
33KMQD9OFJFUT0GC5GJR3WZC2CV776,"#6-18 Ernest said no, saying the information Snowden released was more dangerous to the U.S. public and pointed out that while Manning had gone through a formal trial and acknowledged wrongdoing, ""Mr. Snowden fled into the arms of an adversary and has sought refuge in a country that most recently made a concerted effort to undermine confidence in our democracy.""",325,345,undermine confidence,1,0,1
33KMQD9OFJFUT0GC5GJR3WZC2CV776,"#6-18 Ernest said no, saying the information Snowden released was more dangerous to the U.S. public and pointed out that while Manning had gone through a formal trial and acknowledged wrongdoing, ""Mr. Snowden fled into the arms of an adversary and has sought refuge in a country that most recently made a concerted effort to undermine confidence in our democracy.""",353,362,democracy,3,1,4
33KMQD9OFJFUT0GC5GJR3WZC2CV776,"#6-19 This week, Obama also commuted the sentences of Oscar Lopez Rivera, a Puerto Rican nationalist linked to bombings in the 1970s and 1980s, James E. Cartwright, a former Marine general and White House Chief of Staff convicted of lying to the FBI, and over two hundred other individuals, mostly drug offenders.",28,36,commuted,4,5,9
33KMQD9OFJFUT0GC5GJR3WZC2CV776,"#6-19 This week, Obama also commuted the sentences of Oscar Lopez Rivera, a Puerto Rican nationalist linked to bombings in the 1970s and 1980s, James E. Cartwright, a former Marine general and White House Chief of Staff convicted of lying to the FBI, and over two hundred other individuals, mostly drug offenders.",89,100,nationalist,3,1,4
33KMQD9OFJFUT0GC5GJR3WZC2CV776,"#6-19 This week, Obama also commuted the sentences of Oscar Lopez Rivera, a Puerto Rican nationalist linked to bombings in the 1970s and 1980s, James E. Cartwright, a former Marine general and White House Chief of Staff convicted of lying to the FBI, and over two hundred other individuals, mostly drug offenders.",220,229,convicted,0,1,1
3VAOOVPI3ZTSN6UGD4LB56ZESG5LL2,"#4-8 Following Apollo 17, Cernan worked on the Apollo-Soyuz project before retiring from NASA and the Navy in 1976.",15,21,Apollo,1,0,1
3VAOOVPI3ZTSN6UGD4LB56ZESG5LL2,"#4-8 Following Apollo 17, Cernan worked on the Apollo-Soyuz project before retiring from NASA and the Navy in 1976.",26,32,Cernan,0,1,1
3VAOOVPI3ZTSN6UGD4LB56ZESG5LL2,"#4-8 Following Apollo 17, Cernan worked on the Apollo-Soyuz project before retiring from NASA and the Navy in 1976.",26,39,Cernan worked,0,1,1
3VAOOVPI3ZTSN6UGD4LB56ZESG5LL2,"#4-8 Following Apollo 17, Cernan worked on the Apollo-Soyuz project before retiring from NASA and the Navy in 1976.",47,59,Apollo-Soyuz,1,1,2
3VAOOVPI3ZTSN6UGD4LB56ZESG5LL2,"#4-8 Following Apollo 17, Cernan worked on the Apollo-Soyuz project before retiring from NASA and the Navy in 1976.",47,67,Apollo-Soyuz project,1,0,1
3VAOOVPI3ZTSN6UGD4LB56ZESG5LL2,"#4-8 Following Apollo 17, Cernan worked on the Apollo-Soyuz project before retiring from NASA and the Navy in 1976.",60,67,project,0,1,1
3VAOOVPI3ZTSN6UGD4LB56ZESG5LL2,"#4-8 Following Apollo 17, Cernan worked on the Apollo-Soyuz project before retiring from NASA and the Navy in 1976.",75,83,retiring,4,3,7
3VAOOVPI3ZTSN6UGD4LB56ZESG5LL2,"#4-8 Following Apollo 17, Cernan worked on the Apollo-Soyuz project before retiring from NASA and the Navy in 1976.",89,93,NASA,2,0,2
3VAOOVPI3ZTSN6UGD4LB56ZESG5LL2,"#4-9 In his later years he became an executive and consultant, wrote an autobiography, and advocated for returning to the Moon along with Neil Armstrong, the first human to walk on the Moon, who died in 2012.",37,46,executive,7,3,10
3VAOOVPI3ZTSN6UGD4LB56ZESG5LL2,"#4-9 In his later years he became an executive and consultant, wrote an autobiography, and advocated for returning to the Moon along with Neil Armstrong, the first human to walk on the Moon, who died in 2012.",37,61,executive and consultant,1,0,1
3VAOOVPI3ZTSN6UGD4LB56ZESG5LL2,"#4-9 In his later years he became an executive and consultant, wrote an autobiography, and advocated for returning to the Moon along with Neil Armstrong, the first human to walk on the Moon, who died in 2012.",51,61,consultant,7,5,12
3VAOOVPI3ZTSN6UGD4LB56ZESG5LL2,"#4-9 In his later years he became an executive and consultant, wrote an autobiography, and advocated for returning to the Moon along with Neil Armstrong, the first human to walk on the Moon, who died in 2012.",72,85,autobiography,10,2,12
3VAOOVPI3ZTSN6UGD4LB56ZESG5LL2,"#4-9 In his later years he became an executive and consultant, wrote an autobiography, and advocated for returning to the Moon along with Neil Armstrong, the first human to walk on the Moon, who died in 2012.",91,100,advocated,10,7,17
3VAOOVPI3ZTSN6UGD4LB56ZESG5LL2,"#4-9 In his later years he became an executive and consultant, wrote an autobiography, and advocated for returning to the Moon along with Neil Armstrong, the first human to walk on the Moon, who died in 2012.",105,114,returning,1,0,1
3VAOOVPI3ZTSN6UGD4LB56ZESG5LL2,"#4-9 In his later years he became an executive and consultant, wrote an autobiography, and advocated for returning to the Moon along with Neil Armstrong, the first human to walk on the Moon, who died in 2012.",138,152,Neil Armstrong,0,1,1
3VAOOVPI3ZTSN6UGD4LB56ZESG5LL2,"#4-10 ""Truly, America has lost a patriot and pioneer who helped shape our country's bold ambitions to do things that humankind had never before achieved,"" NASA Administrator Charles Bolden said in a statement.",33,40,patriot,4,6,10
3VAOOVPI3ZTSN6UGD4LB56ZESG5LL2,"#4-10 ""Truly, America has lost a patriot and pioneer who helped shape our country's bold ambitions to do things that humankind had never before achieved,"" NASA Administrator Charles Bolden said in a statement.",45,52,pioneer,4,6,10
3VAOOVPI3ZTSN6UGD4LB56ZESG5LL2,"#4-10 ""Truly, America has lost a patriot and pioneer who helped shape our country's bold ambitions to do things that humankind had never before achieved,"" NASA Administrator Charles Bolden said in a statement.",64,69,shape,0,1,1
3VAOOVPI3ZTSN6UGD4LB56ZESG5LL2,"#4-10 ""Truly, America has lost a patriot and pioneer who helped shape our country's bold ambitions to do things that humankind had never before achieved,"" NASA Administrator Charles Bolden said in a statement.",74,97,countrys bold ambitions,0,1,1
3VAOOVPI3ZTSN6UGD4LB56ZESG5LL2,"#4-10 ""Truly, America has lost a patriot and pioneer who helped shape our country's bold ambitions to do things that humankind had never before achieved,"" NASA Administrator Charles Bolden said in a statement.",84,88,bold,0,1,1
3VAOOVPI3ZTSN6UGD4LB56ZESG5LL2,"#4-10 ""Truly, America has lost a patriot and pioneer who helped shape our country's bold ambitions to do things that humankind had never before achieved,"" NASA Administrator Charles Bolden said in a statement.",84,98,bold ambitions,0,1,1
3VAOOVPI3ZTSN6UGD4LB56ZESG5LL2,"#4-10 ""Truly, America has lost a patriot and pioneer who helped shape our country's bold ambitions to do things that humankind had never before achieved,"" NASA Administrator Charles Bolden said in a statement.",89,98,ambitions,4,8,12
3VAOOVPI3ZTSN6UGD4LB56ZESG5LL2,"#4-10 ""Truly, America has lost a patriot and pioneer who helped shape our country's bold ambitions to do things that humankind had never before achieved,"" NASA Administrator Charles Bolden said in a statement.",89,126,ambitions to do things that humankind,0,1,1
3VAOOVPI3ZTSN6UGD4LB56ZESG5LL2,"#4-10 ""Truly, America has lost a patriot and pioneer who helped shape our country's bold ambitions to do things that humankind had never before achieved,"" NASA Administrator Charles Bolden said in a statement.",117,126,humankind,3,6,9
3VAOOVPI3ZTSN6UGD4LB56ZESG5LL2,"#4-10 ""Truly, America has lost a patriot and pioneer who helped shape our country's bold ambitions to do things that humankind had never before achieved,"" NASA Administrator Charles Bolden said in a statement.",144,152,achieved,2,3,5
3VAOOVPI3ZTSN6UGD4LB56ZESG5LL2,"#4-10 ""Truly, America has lost a patriot and pioneer who helped shape our country's bold ambitions to do things that humankind had never before achieved,"" NASA Administrator Charles Bolden said in a statement.",160,173,Administrator,2,0,2
3VAOOVPI3ZTSN6UGD4LB56ZESG5LL2,"#4-10 ""Truly, America has lost a patriot and pioneer who helped shape our country's bold ambitions to do things that humankind had never before achieved,"" NASA Administrator Charles Bolden said in a statement.",160,188,Administrator Charles Bolden,0,1,1
3VAOOVPI3ZTSN6UGD4LB56ZESG5LL2,"#4-10 ""Truly, America has lost a patriot and pioneer who helped shape our country's bold ambitions to do things that humankind had never before achieved,"" NASA Administrator Charles Bolden said in a statement.",174,188,Charles Bolden,0,1,1
3VAOOVPI3ZTSN6UGD4LB56ZESG5LL2,#40-1 Gujarat quota protests turn violent Parts of the Indian state of Gujarat have been under curfew since Tuesday.,6,19,Gujarat quota,0,1,1
3VAOOVPI3ZTSN6UGD4LB56ZESG5LL2,#40-1 Gujarat quota protests turn violent Parts of the Indian state of Gujarat have been under curfew since Tuesday.,6,28,Gujarat quota protests,2,0,2
3VAOOVPI3ZTSN6UGD4LB56ZESG5LL2,#40-1 Gujarat quota protests turn violent Parts of the Indian state of Gujarat have been under curfew since Tuesday.,14,19,quota,5,1,6
3VAOOVPI3ZTSN6UGD4LB56ZESG5LL2,#40-1 Gujarat quota protests turn violent Parts of the Indian state of Gujarat have been under curfew since Tuesday.,14,28,quota protests,1,0,1
3VAOOVPI3ZTSN6UGD4LB56ZESG5LL2,#40-1 Gujarat quota protests turn violent Parts of the Indian state of Gujarat have been under curfew since Tuesday.,20,28,protests,1,2,3
3VAOOVPI3ZTSN6UGD4LB56ZESG5LL2,#40-1 Gujarat quota protests turn violent Parts of the Indian state of Gujarat have been under curfew since Tuesday.,34,41,violent,2,0,2
3VAOOVPI3ZTSN6UGD4LB56ZESG5LL2,#40-1 Gujarat quota protests turn violent Parts of the Indian state of Gujarat have been under curfew since Tuesday.,71,78,Gujarat,1,0,1
3VAOOVPI3ZTSN6UGD4LB56ZESG5LL2,#40-1 Gujarat quota protests turn violent Parts of the Indian state of Gujarat have been under curfew since Tuesday.,95,101,curfew,6,9,15
3VAOOVPI3ZTSN6UGD4LB56ZESG5LL2,"#40-2 At least seven are reported dead, with over 100 buses and dozens of police stations burned, after protests over job quotas turned violent in several major cities including Ahmedabad, Surat, and Rajkot.",64,70,dozens,0,1,1
3VAOOVPI3ZTSN6UGD4LB56ZESG5LL2,"#40-2 At least seven are reported dead, with over 100 buses and dozens of police stations burned, after protests over job quotas turned violent in several major cities including Ahmedabad, Surat, and Rajkot.",104,112,protests,2,1,3
3VAOOVPI3ZTSN6UGD4LB56ZESG5LL2,"#40-2 At least seven are reported dead, with over 100 buses and dozens of police stations burned, after protests over job quotas turned violent in several major cities including Ahmedabad, Surat, and Rajkot.",118,128,job quotas,1,0,1
3VAOOVPI3ZTSN6UGD4LB56ZESG5LL2,"#40-2 At least seven are reported dead, with over 100 buses and dozens of police stations burned, after protests over job quotas turned violent in several major cities including Ahmedabad, Surat, and Rajkot.",122,128,quotas,3,2,5
3VAOOVPI3ZTSN6UGD4LB56ZESG5LL2,"#40-2 At least seven are reported dead, with over 100 buses and dozens of police stations burned, after protests over job quotas turned violent in several major cities including Ahmedabad, Surat, and Rajkot.",178,187,Ahmedabad,0,1,1
3OPLMF3EU5OIB6X1PH1QIY33XB5LN4,"#42-34 We then drilled a tunnel to a pot (the foraging arena), where the ants got the choice between the food with medicine and the food without.",15,22,drilled,1,7,8
3OPLMF3EU5OIB6X1PH1QIY33XB5LN4,"#42-34 We then drilled a tunnel to a pot (the foraging arena), where the ants got the choice between the food with medicine and the food without.",15,31,drilled a tunnel,1,0,1
3OPLMF3EU5OIB6X1PH1QIY33XB5LN4,"#42-34 We then drilled a tunnel to a pot (the foraging arena), where the ants got the choice between the food with medicine and the food without.",25,31,tunnel,2,4,6
3OPLMF3EU5OIB6X1PH1QIY33XB5LN4,"#42-34 We then drilled a tunnel to a pot (the foraging arena), where the ants got the choice between the food with medicine and the food without.",37,40,pot,1,0,1
3OPLMF3EU5OIB6X1PH1QIY33XB5LN4,"#42-34 We then drilled a tunnel to a pot (the foraging arena), where the ants got the choice between the food with medicine and the food without.",42,60,the foraging arena,1,0,1
3OPLMF3EU5OIB6X1PH1QIY33XB5LN4,"#42-34 We then drilled a tunnel to a pot (the foraging arena), where the ants got the choice between the food with medicine and the food without.",46,54,foraging,6,3,9
3OPLMF3EU5OIB6X1PH1QIY33XB5LN4,"#42-34 We then drilled a tunnel to a pot (the foraging arena), where the ants got the choice between the food with medicine and the food without.",46,60,foraging arena,1,1,2
3OPLMF3EU5OIB6X1PH1QIY33XB5LN4,"#42-34 We then drilled a tunnel to a pot (the foraging arena), where the ants got the choice between the food with medicine and the food without.",115,123,medicine,2,0,2
3OPLMF3EU5OIB6X1PH1QIY33XB5LN4,#42-35 We infected the ants by preparing a solution of the fungus Beauveria bassiana.,10,18,infected,2,4,6
3OPLMF3EU5OIB6X1PH1QIY33XB5LN4,#42-35 We infected the ants by preparing a solution of the fungus Beauveria bassiana.,31,40,preparing,0,1,1
3OPLMF3EU5OIB6X1PH1QIY33XB5LN4,#42-35 We infected the ants by preparing a solution of the fungus Beauveria bassiana.,43,51,solution,2,1,3
3OPLMF3EU5OIB6X1PH1QIY33XB5LN4,#42-35 We infected the ants by preparing a solution of the fungus Beauveria bassiana.,59,65,fungus,6,2,8
3OPLMF3EU5OIB6X1PH1QIY33XB5LN4,#42-35 We infected the ants by preparing a solution of the fungus Beauveria bassiana.,59,84,fungus Beauveria bassiana,2,0,2
3OPLMF3EU5OIB6X1PH1QIY33XB5LN4,#42-35 We infected the ants by preparing a solution of the fungus Beauveria bassiana.,66,75,Beauveria,3,0,3
3OPLMF3EU5OIB6X1PH1QIY33XB5LN4,#42-35 We infected the ants by preparing a solution of the fungus Beauveria bassiana.,66,84,Beauveria bassiana,5,2,7
3OPLMF3EU5OIB6X1PH1QIY33XB5LN4,#42-35 We infected the ants by preparing a solution of the fungus Beauveria bassiana.,76,84,bassiana,4,2,6
3OPLMF3EU5OIB6X1PH1QIY33XB5LN4,"#42-36 Afterwards, each ant was dipped in the solution for a couple of seconds, dried on a cloth and put in the nest.",7,17,Afterwards,1,0,1
3OPLMF3EU5OIB6X1PH1QIY33XB5LN4,"#42-36 Afterwards, each ant was dipped in the solution for a couple of seconds, dried on a cloth and put in the nest.",32,38,dipped,0,5,5
3OPLMF3EU5OIB6X1PH1QIY33XB5LN4,"#42-36 Afterwards, each ant was dipped in the solution for a couple of seconds, dried on a cloth and put in the nest.",46,54,solution,1,0,1
3OPLMF3EU5OIB6X1PH1QIY33XB5LN4,"#42-36 Afterwards, each ant was dipped in the solution for a couple of seconds, dried on a cloth and put in the nest.",80,85,dried,0,2,2
3OPLMF3EU5OIB6X1PH1QIY33XB5LN4,"#42-37 After exposing the ants to the fungus, we took pictures of each foraging arena three times per day, and counted how many ants were present on each food-source.",13,21,exposing,4,6,10
3OPLMF3EU5OIB6X1PH1QIY33XB5LN4,"#42-37 After exposing the ants to the fungus, we took pictures of each foraging arena three times per day, and counted how many ants were present on each food-source.",38,44,fungus,3,1,4
3OPLMF3EU5OIB6X1PH1QIY33XB5LN4,"#42-37 After exposing the ants to the fungus, we took pictures of each foraging arena three times per day, and counted how many ants were present on each food-source.",71,79,foraging,3,7,10
3OPLMF3EU5OIB6X1PH1QIY33XB5LN4,"#42-37 After exposing the ants to the fungus, we took pictures of each foraging arena three times per day, and counted how many ants were present on each food-source.",71,85,foraging arena,4,2,6
3OPLMF3EU5OIB6X1PH1QIY33XB5LN4,"#42-37 After exposing the ants to the fungus, we took pictures of each foraging arena three times per day, and counted how many ants were present on each food-source.",80,85,arena,0,2,2
3OPLMF3EU5OIB6X1PH1QIY33XB5LN4,"#42-37 After exposing the ants to the fungus, we took pictures of each foraging arena three times per day, and counted how many ants were present on each food-source.",111,118,counted,0,1,1
3OPLMF3EU5OIB6X1PH1QIY33XB5LN4,"#42-37 After exposing the ants to the fungus, we took pictures of each foraging arena three times per day, and counted how many ants were present on each food-source.",154,165,food-source,1,1,2
3OPLMF3EU5OIB6X1PH1QIY33XB5LN4,#42-38 This gave us the data that ants choose more medicine after they have been infected.,81,89,infected,1,1,2
3OPLMF3EU5OIB6X1PH1QIY33XB5LN4,"#42-39 The result that healthy ants die sooner when ingesting ROS [Reactive Oxygen Species, the group of chemicals that includes hydrogen peroxide] but infected ants die less was obtained in another way (as you have to 'force feed' the ROS, as healthy ants, when given the choice, ignore that food-source.)",40,46,sooner,0,2,2
3OPLMF3EU5OIB6X1PH1QIY33XB5LN4,"#42-39 The result that healthy ants die sooner when ingesting ROS [Reactive Oxygen Species, the group of chemicals that includes hydrogen peroxide] but infected ants die less was obtained in another way (as you have to 'force feed' the ROS, as healthy ants, when given the choice, ignore that food-source.)",52,61,ingesting,3,10,13
3OPLMF3EU5OIB6X1PH1QIY33XB5LN4,"#42-39 The result that healthy ants die sooner when ingesting ROS [Reactive Oxygen Species, the group of chemicals that includes hydrogen peroxide] but infected ants die less was obtained in another way (as you have to 'force feed' the ROS, as healthy ants, when given the choice, ignore that food-source.)",62,65,ROS,2,0,2
3OPLMF3EU5OIB6X1PH1QIY33XB5LN4,"#42-39 The result that healthy ants die sooner when ingesting ROS [Reactive Oxygen Species, the group of chemicals that includes hydrogen peroxide] but infected ants die less was obtained in another way (as you have to 'force feed' the ROS, as healthy ants, when given the choice, ignore that food-source.)",62,90,ROS [Reactive Oxygen Species,1,0,1
3OPLMF3EU5OIB6X1PH1QIY33XB5LN4,"#42-39 The result that healthy ants die sooner when ingesting ROS [Reactive Oxygen Species, the group of chemicals that includes hydrogen peroxide] but infected ants die less was obtained in another way (as you have to 'force feed' the ROS, as healthy ants, when given the choice, ignore that food-source.)",67,75,Reactive,1,0,1
3OPLMF3EU5OIB6X1PH1QIY33XB5LN4,"#42-39 The result that healthy ants die sooner when ingesting ROS [Reactive Oxygen Species, the group of chemicals that includes hydrogen peroxide] but infected ants die less was obtained in another way (as you have to 'force feed' the ROS, as healthy ants, when given the choice, ignore that food-source.)",67,90,Reactive Oxygen Species,2,0,2
3OPLMF3EU5OIB6X1PH1QIY33XB5LN4,"#42-39 The result that healthy ants die sooner when ingesting ROS [Reactive Oxygen Species, the group of chemicals that includes hydrogen peroxide] but infected ants die less was obtained in another way (as you have to 'force feed' the ROS, as healthy ants, when given the choice, ignore that food-source.)",76,82,Oxygen,1,0,1
3OPLMF3EU5OIB6X1PH1QIY33XB5LN4,"#42-39 The result that healthy ants die sooner when ingesting ROS [Reactive Oxygen Species, the group of chemicals that includes hydrogen peroxide] but infected ants die less was obtained in another way (as you have to 'force feed' the ROS, as healthy ants, when given the choice, ignore that food-source.)",83,90,Species,2,2,4
3OPLMF3EU5OIB6X1PH1QIY33XB5LN4,"#42-39 The result that healthy ants die sooner when ingesting ROS [Reactive Oxygen Species, the group of chemicals that includes hydrogen peroxide] but infected ants die less was obtained in another way (as you have to 'force feed' the ROS, as healthy ants, when given the choice, ignore that food-source.)",105,114,chemicals,1,0,1
3OPLMF3EU5OIB6X1PH1QIY33XB5LN4,"#42-39 The result that healthy ants die sooner when ingesting ROS [Reactive Oxygen Species, the group of chemicals that includes hydrogen peroxide] but infected ants die less was obtained in another way (as you have to 'force feed' the ROS, as healthy ants, when given the choice, ignore that food-source.)",129,137,hydrogen,4,0,4
3OPLMF3EU5OIB6X1PH1QIY33XB5LN4,"#42-39 The result that healthy ants die sooner when ingesting ROS [Reactive Oxygen Species, the group of chemicals that includes hydrogen peroxide] but infected ants die less was obtained in another way (as you have to 'force feed' the ROS, as healthy ants, when given the choice, ignore that food-source.)",129,146,hydrogen peroxide,2,0,2
3OPLMF3EU5OIB6X1PH1QIY33XB5LN4,"#42-39 The result that healthy ants die sooner when ingesting ROS [Reactive Oxygen Species, the group of chemicals that includes hydrogen peroxide] but infected ants die less was obtained in another way (as you have to 'force feed' the ROS, as healthy ants, when given the choice, ignore that food-source.)",138,146,peroxide,1,0,1
3OPLMF3EU5OIB6X1PH1QIY33XB5LN4,"#42-39 The result that healthy ants die sooner when ingesting ROS [Reactive Oxygen Species, the group of chemicals that includes hydrogen peroxide] but infected ants die less was obtained in another way (as you have to 'force feed' the ROS, as healthy ants, when given the choice, ignore that food-source.)",152,160,infected,1,0,1
3OPLMF3EU5OIB6X1PH1QIY33XB5LN4,"#42-39 The result that healthy ants die sooner when ingesting ROS [Reactive Oxygen Species, the group of chemicals that includes hydrogen peroxide] but infected ants die less was obtained in another way (as you have to 'force feed' the ROS, as healthy ants, when given the choice, ignore that food-source.)",179,187,obtained,3,3,6
3OPLMF3EU5OIB6X1PH1QIY33XB5LN4,"#42-39 The result that healthy ants die sooner when ingesting ROS [Reactive Oxygen Species, the group of chemicals that includes hydrogen peroxide] but infected ants die less was obtained in another way (as you have to 'force feed' the ROS, as healthy ants, when given the choice, ignore that food-source.)",220,230,force feed,0,2,2
3OPLMF3EU5OIB6X1PH1QIY33XB5LN4,"#42-39 The result that healthy ants die sooner when ingesting ROS [Reactive Oxygen Species, the group of chemicals that includes hydrogen peroxide] but infected ants die less was obtained in another way (as you have to 'force feed' the ROS, as healthy ants, when given the choice, ignore that food-source.)",281,287,ignore,2,1,3
36GJS3V78VR66OSFZSCICZHESAEJGS,"#42-80 If they would only do it in the lab, the behaviour wouldn't be very interesting.",48,57,behaviour,9,3,12
36GJS3V78VR66OSFZSCICZHESAEJGS,"#42-81 We have some guesses where they might get it from, but at the moment we don't know yet.",20,27,guesses,2,5,7
36GJS3V78VR66OSFZSCICZHESAEJGS,"#42-81 We have some guesses where they might get it from, but at the moment we don't know yet.",69,75,moment,1,1,2
36GJS3V78VR66OSFZSCICZHESAEJGS,"#42-82 That said, I plan to investigate this question (among others) further [in] the next couple of years.",28,39,investigate,8,6,14
36GJS3V78VR66OSFZSCICZHESAEJGS,"#42-82 That said, I plan to investigate this question (among others) further [in] the next couple of years.",91,97,couple,1,1,2
36GJS3V78VR66OSFZSCICZHESAEJGS,#42-83 Wikinews: For your PhD you researched ants' scent-based communications.,7,15,Wikinews,1,0,1
36GJS3V78VR66OSFZSCICZHESAEJGS,#42-83 Wikinews: For your PhD you researched ants' scent-based communications.,26,29,PhD,1,0,1
36GJS3V78VR66OSFZSCICZHESAEJGS,#42-83 Wikinews: For your PhD you researched ants' scent-based communications.,34,44,researched,2,0,2
36GJS3V78VR66OSFZSCICZHESAEJGS,#42-83 Wikinews: For your PhD you researched ants' scent-based communications.,45,76,ants scent-based communications,0,1,1
36GJS3V78VR66OSFZSCICZHESAEJGS,#42-83 Wikinews: For your PhD you researched ants' scent-based communications.,51,62,scent-based,2,5,7
36GJS3V78VR66OSFZSCICZHESAEJGS,#42-83 Wikinews: For your PhD you researched ants' scent-based communications.,51,77,scent-based communications,5,2,7
36GJS3V78VR66OSFZSCICZHESAEJGS,#42-83 Wikinews: For your PhD you researched ants' scent-based communications.,63,77,communications,4,1,5
36GJS3V78VR66OSFZSCICZHESAEJGS,#42-84 Could healthy ants perhaps tell other ants are infected and encourage this behaviour?,54,62,infected,1,5,6
36GJS3V78VR66OSFZSCICZHESAEJGS,#42-84 Could healthy ants perhaps tell other ants are infected and encourage this behaviour?,67,76,encourage,2,4,6
36GJS3V78VR66OSFZSCICZHESAEJGS,#42-86 There's conflicting evidence about whether sick ants actually smell different from healthy ones or not.,15,26,conflicting,6,8,14
36GJS3V78VR66OSFZSCICZHESAEJGS,#42-86 There's conflicting evidence about whether sick ants actually smell different from healthy ones or not.,15,35,conflicting evidence,3,0,3
36GJS3V78VR66OSFZSCICZHESAEJGS,#42-86 There's conflicting evidence about whether sick ants actually smell different from healthy ones or not.,27,35,evidence,0,3,3
36GJS3V78VR66OSFZSCICZHESAEJGS,#42-86 There's conflicting evidence about whether sick ants actually smell different from healthy ones or not.,60,68,actually,1,0,1
36GJS3V78VR66OSFZSCICZHESAEJGS,#42-86 There's conflicting evidence about whether sick ants actually smell different from healthy ones or not.,69,74,smell,0,1,1
36GJS3V78VR66OSFZSCICZHESAEJGS,"#42-88 Sick ants stop most interaction with nestmates and especially brood, and leave the nest to die in isolation.",27,38,interaction,5,3,8
36GJS3V78VR66OSFZSCICZHESAEJGS,"#42-88 Sick ants stop most interaction with nestmates and especially brood, and leave the nest to die in isolation.",44,53,nestmates,10,10,20
36GJS3V78VR66OSFZSCICZHESAEJGS,"#42-88 Sick ants stop most interaction with nestmates and especially brood, and leave the nest to die in isolation.",44,74,nestmates and especially brood,1,0,1
36GJS3V78VR66OSFZSCICZHESAEJGS,"#42-88 Sick ants stop most interaction with nestmates and especially brood, and leave the nest to die in isolation.",69,74,brood,2,7,9
36GJS3V78VR66OSFZSCICZHESAEJGS,"#42-88 Sick ants stop most interaction with nestmates and especially brood, and leave the nest to die in isolation.",90,94,nest,0,1,1
36GJS3V78VR66OSFZSCICZHESAEJGS,"#42-88 Sick ants stop most interaction with nestmates and especially brood, and leave the nest to die in isolation.",98,114,die in isolation,0,1,1
36GJS3V78VR66OSFZSCICZHESAEJGS,"#42-88 Sick ants stop most interaction with nestmates and especially brood, and leave the nest to die in isolation.",105,114,isolation,10,8,18
3ZTE0JGGCET7QN37DJ84U4DLTCWOC6,#42-56 How common are they in the wild?,11,17,common,1,0,1
3ZTE0JGGCET7QN37DJ84U4DLTCWOC6,"#42-57 NB: For ants, see above about the collection.",41,51,collection,3,4,7
3ZTE0JGGCET7QN37DJ84U4DLTCWOC6,"#42-58 This species of fungus does appear in Finland, but we chose to use a different strain from Denmark (with thanks to Prof. J. Eilenberg and the laboratory technician Louise Lee Munch Larsen from the University of Copenhagen).",12,19,species,6,7,13
3ZTE0JGGCET7QN37DJ84U4DLTCWOC6,"#42-58 This species of fungus does appear in Finland, but we chose to use a different strain from Denmark (with thanks to Prof. J. Eilenberg and the laboratory technician Louise Lee Munch Larsen from the University of Copenhagen).",12,29,species of fungus,1,0,1
3ZTE0JGGCET7QN37DJ84U4DLTCWOC6,"#42-58 This species of fungus does appear in Finland, but we chose to use a different strain from Denmark (with thanks to Prof. J. Eilenberg and the laboratory technician Louise Lee Munch Larsen from the University of Copenhagen).",23,29,fungus,7,2,9
3ZTE0JGGCET7QN37DJ84U4DLTCWOC6,"#42-58 This species of fungus does appear in Finland, but we chose to use a different strain from Denmark (with thanks to Prof. J. Eilenberg and the laboratory technician Louise Lee Munch Larsen from the University of Copenhagen).",35,41,appear,1,1,2
3ZTE0JGGCET7QN37DJ84U4DLTCWOC6,"#42-58 This species of fungus does appear in Finland, but we chose to use a different strain from Denmark (with thanks to Prof. J. Eilenberg and the laboratory technician Louise Lee Munch Larsen from the University of Copenhagen).",76,92,different strain,1,1,2
3ZTE0JGGCET7QN37DJ84U4DLTCWOC6,"#42-58 This species of fungus does appear in Finland, but we chose to use a different strain from Denmark (with thanks to Prof. J. Eilenberg and the laboratory technician Louise Lee Munch Larsen from the University of Copenhagen).",86,92,strain,7,7,14
3ZTE0JGGCET7QN37DJ84U4DLTCWOC6,"#42-58 This species of fungus does appear in Finland, but we chose to use a different strain from Denmark (with thanks to Prof. J. Eilenberg and the laboratory technician Louise Lee Munch Larsen from the University of Copenhagen).",149,159,laboratory,5,0,5
3ZTE0JGGCET7QN37DJ84U4DLTCWOC6,"#42-58 This species of fungus does appear in Finland, but we chose to use a different strain from Denmark (with thanks to Prof. J. Eilenberg and the laboratory technician Louise Lee Munch Larsen from the University of Copenhagen).",149,170,laboratory technician,1,0,1
3ZTE0JGGCET7QN37DJ84U4DLTCWOC6,"#42-58 This species of fungus does appear in Finland, but we chose to use a different strain from Denmark (with thanks to Prof. J. Eilenberg and the laboratory technician Louise Lee Munch Larsen from the University of Copenhagen).",160,170,technician,3,1,4
3ZTE0JGGCET7QN37DJ84U4DLTCWOC6,"#42-59 Animals can adapt to local strains ('local adaptation'), and just to make sure we thought it would be good to use a strain of fungus that the ants definitely did not evolve specific resistances against.",19,24,adapt,5,2,7
3ZTE0JGGCET7QN37DJ84U4DLTCWOC6,"#42-59 Animals can adapt to local strains ('local adaptation'), and just to make sure we thought it would be good to use a strain of fungus that the ants definitely did not evolve specific resistances against.",28,41,local strains,2,1,3
3ZTE0JGGCET7QN37DJ84U4DLTCWOC6,"#42-59 Animals can adapt to local strains ('local adaptation'), and just to make sure we thought it would be good to use a strain of fungus that the ants definitely did not evolve specific resistances against.",34,41,strains,3,4,7
3ZTE0JGGCET7QN37DJ84U4DLTCWOC6,"#42-59 Animals can adapt to local strains ('local adaptation'), and just to make sure we thought it would be good to use a strain of fungus that the ants definitely did not evolve specific resistances against.",44,60,local adaptation,2,0,2
3ZTE0JGGCET7QN37DJ84U4DLTCWOC6,"#42-59 Animals can adapt to local strains ('local adaptation'), and just to make sure we thought it would be good to use a strain of fungus that the ants definitely did not evolve specific resistances against.",50,60,adaptation,3,5,8
3ZTE0JGGCET7QN37DJ84U4DLTCWOC6,"#42-59 Animals can adapt to local strains ('local adaptation'), and just to make sure we thought it would be good to use a strain of fungus that the ants definitely did not evolve specific resistances against.",123,129,strain,2,2,4
3ZTE0JGGCET7QN37DJ84U4DLTCWOC6,"#42-59 Animals can adapt to local strains ('local adaptation'), and just to make sure we thought it would be good to use a strain of fungus that the ants definitely did not evolve specific resistances against.",123,139,strain of fungus,2,0,2
3ZTE0JGGCET7QN37DJ84U4DLTCWOC6,"#42-59 Animals can adapt to local strains ('local adaptation'), and just to make sure we thought it would be good to use a strain of fungus that the ants definitely did not evolve specific resistances against.",133,139,fungus,1,1,2
3ZTE0JGGCET7QN37DJ84U4DLTCWOC6,"#42-59 Animals can adapt to local strains ('local adaptation'), and just to make sure we thought it would be good to use a strain of fungus that the ants definitely did not evolve specific resistances against.",154,164,definitely,1,3,4
3ZTE0JGGCET7QN37DJ84U4DLTCWOC6,"#42-59 Animals can adapt to local strains ('local adaptation'), and just to make sure we thought it would be good to use a strain of fungus that the ants definitely did not evolve specific resistances against.",173,179,evolve,4,5,9
3ZTE0JGGCET7QN37DJ84U4DLTCWOC6,"#42-59 Animals can adapt to local strains ('local adaptation'), and just to make sure we thought it would be good to use a strain of fungus that the ants definitely did not evolve specific resistances against.",173,200,evolve specific resistances,1,0,1
3ZTE0JGGCET7QN37DJ84U4DLTCWOC6,"#42-59 Animals can adapt to local strains ('local adaptation'), and just to make sure we thought it would be good to use a strain of fungus that the ants definitely did not evolve specific resistances against.",180,188,specific,1,0,1
3ZTE0JGGCET7QN37DJ84U4DLTCWOC6,"#42-59 Animals can adapt to local strains ('local adaptation'), and just to make sure we thought it would be good to use a strain of fungus that the ants definitely did not evolve specific resistances against.",180,200,specific resistances,2,1,3
3ZTE0JGGCET7QN37DJ84U4DLTCWOC6,"#42-59 Animals can adapt to local strains ('local adaptation'), and just to make sure we thought it would be good to use a strain of fungus that the ants definitely did not evolve specific resistances against.",189,200,resistances,9,5,14
3ZTE0JGGCET7QN37DJ84U4DLTCWOC6,"#42-60 This means that the reaction of the ants (to self-medicate) is very likely to be a general response, and not just against their local fungal enemies.",27,35,reaction,0,1,1
3ZTE0JGGCET7QN37DJ84U4DLTCWOC6,"#42-60 This means that the reaction of the ants (to self-medicate) is very likely to be a general response, and not just against their local fungal enemies.",49,65,to self-medicate,1,0,1
3ZTE0JGGCET7QN37DJ84U4DLTCWOC6,"#42-60 This means that the reaction of the ants (to self-medicate) is very likely to be a general response, and not just against their local fungal enemies.",52,65,self-medicate,1,0,1
3ZTE0JGGCET7QN37DJ84U4DLTCWOC6,"#42-60 This means that the reaction of the ants (to self-medicate) is very likely to be a general response, and not just against their local fungal enemies.",90,106,general response,1,2,3
3ZTE0JGGCET7QN37DJ84U4DLTCWOC6,"#42-60 This means that the reaction of the ants (to self-medicate) is very likely to be a general response, and not just against their local fungal enemies.",98,106,response,1,0,1
3ZTE0JGGCET7QN37DJ84U4DLTCWOC6,"#42-60 This means that the reaction of the ants (to self-medicate) is very likely to be a general response, and not just against their local fungal enemies.",141,147,fungal,0,1,1
3ZTE0JGGCET7QN37DJ84U4DLTCWOC6,"#42-60 This means that the reaction of the ants (to self-medicate) is very likely to be a general response, and not just against their local fungal enemies.",141,155,fungal enemies,2,0,2
3ZTE0JGGCET7QN37DJ84U4DLTCWOC6,"#42-60 This means that the reaction of the ants (to self-medicate) is very likely to be a general response, and not just against their local fungal enemies.",148,155,enemies,2,1,3
3ZTE0JGGCET7QN37DJ84U4DLTCWOC6,#42-61 Wikinews: Are there any ethical considerations around exposing ants to toxins and parasites?,31,38,ethical,5,3,8
3ZTE0JGGCET7QN37DJ84U4DLTCWOC6,#42-61 Wikinews: Are there any ethical considerations around exposing ants to toxins and parasites?,31,53,ethical considerations,3,1,4
3ZTE0JGGCET7QN37DJ84U4DLTCWOC6,#42-61 Wikinews: Are there any ethical considerations around exposing ants to toxins and parasites?,39,53,considerations,2,1,3
3ZTE0JGGCET7QN37DJ84U4DLTCWOC6,#42-61 Wikinews: Are there any ethical considerations around exposing ants to toxins and parasites?,61,69,exposing,2,2,4
3ZTE0JGGCET7QN37DJ84U4DLTCWOC6,#42-61 Wikinews: Are there any ethical considerations around exposing ants to toxins and parasites?,78,84,toxins,7,6,13
3ZTE0JGGCET7QN37DJ84U4DLTCWOC6,#42-61 Wikinews: Are there any ethical considerations around exposing ants to toxins and parasites?,89,98,parasites,1,1,2
3TTPFEFXCTL8IP8JZF0BOVOAL47H6J,"#23-12 He alleges this was done to ensure the inclusion of the low-polling candidates former Hewlett-Packard CEO Carly Fiorina, former New York governor George Pataki, Senator Lindsey Graham, and former Virginia governor Jim Gilmore, because Fox News recognizes these candidates as ""major players.""",10,17,alleges,7,9,16
3TTPFEFXCTL8IP8JZF0BOVOAL47H6J,"#23-12 He alleges this was done to ensure the inclusion of the low-polling candidates former Hewlett-Packard CEO Carly Fiorina, former New York governor George Pataki, Senator Lindsey Graham, and former Virginia governor Jim Gilmore, because Fox News recognizes these candidates as ""major players.""",35,41,ensure,2,5,7
3TTPFEFXCTL8IP8JZF0BOVOAL47H6J,"#23-12 He alleges this was done to ensure the inclusion of the low-polling candidates former Hewlett-Packard CEO Carly Fiorina, former New York governor George Pataki, Senator Lindsey Graham, and former Virginia governor Jim Gilmore, because Fox News recognizes these candidates as ""major players.""",46,55,inclusion,6,3,9
3TTPFEFXCTL8IP8JZF0BOVOAL47H6J,"#23-12 He alleges this was done to ensure the inclusion of the low-polling candidates former Hewlett-Packard CEO Carly Fiorina, former New York governor George Pataki, Senator Lindsey Graham, and former Virginia governor Jim Gilmore, because Fox News recognizes these candidates as ""major players.""",46,85,inclusion of the low-polling candidates,1,0,1
3TTPFEFXCTL8IP8JZF0BOVOAL47H6J,"#23-12 He alleges this was done to ensure the inclusion of the low-polling candidates former Hewlett-Packard CEO Carly Fiorina, former New York governor George Pataki, Senator Lindsey Graham, and former Virginia governor Jim Gilmore, because Fox News recognizes these candidates as ""major players.""",63,74,low-polling,3,1,4
3TTPFEFXCTL8IP8JZF0BOVOAL47H6J,"#23-12 He alleges this was done to ensure the inclusion of the low-polling candidates former Hewlett-Packard CEO Carly Fiorina, former New York governor George Pataki, Senator Lindsey Graham, and former Virginia governor Jim Gilmore, because Fox News recognizes these candidates as ""major players.""",63,85,low-polling candidates,2,2,4
3TTPFEFXCTL8IP8JZF0BOVOAL47H6J,"#23-12 He alleges this was done to ensure the inclusion of the low-polling candidates former Hewlett-Packard CEO Carly Fiorina, former New York governor George Pataki, Senator Lindsey Graham, and former Virginia governor Jim Gilmore, because Fox News recognizes these candidates as ""major players.""",75,85,candidates,0,1,1
3TTPFEFXCTL8IP8JZF0BOVOAL47H6J,"#23-12 He alleges this was done to ensure the inclusion of the low-polling candidates former Hewlett-Packard CEO Carly Fiorina, former New York governor George Pataki, Senator Lindsey Graham, and former Virginia governor Jim Gilmore, because Fox News recognizes these candidates as ""major players.""",93,108,Hewlett-Packard,0,1,1
3TTPFEFXCTL8IP8JZF0BOVOAL47H6J,"#23-12 He alleges this was done to ensure the inclusion of the low-polling candidates former Hewlett-Packard CEO Carly Fiorina, former New York governor George Pataki, Senator Lindsey Graham, and former Virginia governor Jim Gilmore, because Fox News recognizes these candidates as ""major players.""",113,118,Carly,0,1,1
3TTPFEFXCTL8IP8JZF0BOVOAL47H6J,"#23-12 He alleges this was done to ensure the inclusion of the low-polling candidates former Hewlett-Packard CEO Carly Fiorina, former New York governor George Pataki, Senator Lindsey Graham, and former Virginia governor Jim Gilmore, because Fox News recognizes these candidates as ""major players.""",119,126,Fiorina,0,1,1
3TTPFEFXCTL8IP8JZF0BOVOAL47H6J,"#23-12 He alleges this was done to ensure the inclusion of the low-polling candidates former Hewlett-Packard CEO Carly Fiorina, former New York governor George Pataki, Senator Lindsey Graham, and former Virginia governor Jim Gilmore, because Fox News recognizes these candidates as ""major players.""",153,166,George Pataki,0,1,1
3TTPFEFXCTL8IP8JZF0BOVOAL47H6J,"#23-12 He alleges this was done to ensure the inclusion of the low-polling candidates former Hewlett-Packard CEO Carly Fiorina, former New York governor George Pataki, Senator Lindsey Graham, and former Virginia governor Jim Gilmore, because Fox News recognizes these candidates as ""major players.""",176,183,Lindsey,0,1,1
3TTPFEFXCTL8IP8JZF0BOVOAL47H6J,"#23-12 He alleges this was done to ensure the inclusion of the low-polling candidates former Hewlett-Packard CEO Carly Fiorina, former New York governor George Pataki, Senator Lindsey Graham, and former Virginia governor Jim Gilmore, because Fox News recognizes these candidates as ""major players.""",184,190,Graham,0,1,1
3TTPFEFXCTL8IP8JZF0BOVOAL47H6J,"#23-12 He alleges this was done to ensure the inclusion of the low-polling candidates former Hewlett-Packard CEO Carly Fiorina, former New York governor George Pataki, Senator Lindsey Graham, and former Virginia governor Jim Gilmore, because Fox News recognizes these candidates as ""major players.""",225,232,Gilmore,0,1,1
3TTPFEFXCTL8IP8JZF0BOVOAL47H6J,"#23-12 He alleges this was done to ensure the inclusion of the low-polling candidates former Hewlett-Packard CEO Carly Fiorina, former New York governor George Pataki, Senator Lindsey Graham, and former Virginia governor Jim Gilmore, because Fox News recognizes these candidates as ""major players.""",251,261,recognizes,4,4,8
3TTPFEFXCTL8IP8JZF0BOVOAL47H6J,"#23-12 He alleges this was done to ensure the inclusion of the low-polling candidates former Hewlett-Packard CEO Carly Fiorina, former New York governor George Pataki, Senator Lindsey Graham, and former Virginia governor Jim Gilmore, because Fox News recognizes these candidates as ""major players.""",283,296,major players,2,1,3
3TTPFEFXCTL8IP8JZF0BOVOAL47H6J,"#23-13 Furthermore, Everson argues the Fox News criteria are not ""objective,"" as Title 11 requires, because they fail to define the terms ""consistently"" and ""recognized"" when referring to polls.",7,18,Furthermore,0,3,3
3TTPFEFXCTL8IP8JZF0BOVOAL47H6J,"#23-13 Furthermore, Everson argues the Fox News criteria are not ""objective,"" as Title 11 requires, because they fail to define the terms ""consistently"" and ""recognized"" when referring to polls.",28,34,argues,2,2,4
3TTPFEFXCTL8IP8JZF0BOVOAL47H6J,"#23-13 Furthermore, Everson argues the Fox News criteria are not ""objective,"" as Title 11 requires, because they fail to define the terms ""consistently"" and ""recognized"" when referring to polls.",48,56,criteria,4,3,7
3TTPFEFXCTL8IP8JZF0BOVOAL47H6J,"#23-13 Furthermore, Everson argues the Fox News criteria are not ""objective,"" as Title 11 requires, because they fail to define the terms ""consistently"" and ""recognized"" when referring to polls.",66,75,objective,3,4,7
3TTPFEFXCTL8IP8JZF0BOVOAL47H6J,"#23-13 Furthermore, Everson argues the Fox News criteria are not ""objective,"" as Title 11 requires, because they fail to define the terms ""consistently"" and ""recognized"" when referring to polls.",121,127,define,0,1,1
3TTPFEFXCTL8IP8JZF0BOVOAL47H6J,"#23-13 Furthermore, Everson argues the Fox News criteria are not ""objective,"" as Title 11 requires, because they fail to define the terms ""consistently"" and ""recognized"" when referring to polls.",139,151,consistently,8,9,17
3TTPFEFXCTL8IP8JZF0BOVOAL47H6J,"#23-13 Furthermore, Everson argues the Fox News criteria are not ""objective,"" as Title 11 requires, because they fail to define the terms ""consistently"" and ""recognized"" when referring to polls.",158,168,recognized,2,5,7
3TTPFEFXCTL8IP8JZF0BOVOAL47H6J,"#23-13 Furthermore, Everson argues the Fox News criteria are not ""objective,"" as Title 11 requires, because they fail to define the terms ""consistently"" and ""recognized"" when referring to polls.",175,184,referring,0,2,2
3TTPFEFXCTL8IP8JZF0BOVOAL47H6J,#23-14 He asserts he was included in the Republican Party's online straw poll in May and is the only candidate still listed on that poll who has been excluded from Thursday's debate.,10,17,asserts,3,5,8
3TTPFEFXCTL8IP8JZF0BOVOAL47H6J,#23-14 He asserts he was included in the Republican Party's online straw poll in May and is the only candidate still listed on that poll who has been excluded from Thursday's debate.,41,51,Republican,1,0,1
3TTPFEFXCTL8IP8JZF0BOVOAL47H6J,#23-14 He asserts he was included in the Republican Party's online straw poll in May and is the only candidate still listed on that poll who has been excluded from Thursday's debate.,60,77,online straw poll,1,2,3
3TTPFEFXCTL8IP8JZF0BOVOAL47H6J,#23-14 He asserts he was included in the Republican Party's online straw poll in May and is the only candidate still listed on that poll who has been excluded from Thursday's debate.,67,72,straw,0,1,1
3TTPFEFXCTL8IP8JZF0BOVOAL47H6J,#23-14 He asserts he was included in the Republican Party's online straw poll in May and is the only candidate still listed on that poll who has been excluded from Thursday's debate.,67,77,straw poll,3,3,6
3TTPFEFXCTL8IP8JZF0BOVOAL47H6J,#23-14 He asserts he was included in the Republican Party's online straw poll in May and is the only candidate still listed on that poll who has been excluded from Thursday's debate.,150,158,excluded,4,2,6
3TTPFEFXCTL8IP8JZF0BOVOAL47H6J,#23-14 He asserts he was included in the Republican Party's online straw poll in May and is the only candidate still listed on that poll who has been excluded from Thursday's debate.,175,181,debate,1,2,3
3TTPFEFXCTL8IP8JZF0BOVOAL47H6J,"#23-15 Election law expert Richard Winger, publisher of Ballot Access News, says Everson is ""completely correct"" in his challenge.",20,26,expert,0,1,1
3TTPFEFXCTL8IP8JZF0BOVOAL47H6J,"#23-15 Election law expert Richard Winger, publisher of Ballot Access News, says Everson is ""completely correct"" in his challenge.",43,52,publisher,1,0,1
3TTPFEFXCTL8IP8JZF0BOVOAL47H6J,"#23-15 Election law expert Richard Winger, publisher of Ballot Access News, says Everson is ""completely correct"" in his challenge.",56,74,Ballot Access News,0,1,1
3TTPFEFXCTL8IP8JZF0BOVOAL47H6J,"#23-15 Election law expert Richard Winger, publisher of Ballot Access News, says Everson is ""completely correct"" in his challenge.",120,129,challenge,0,2,2
3TTPFEFXCTL8IP8JZF0BOVOAL47H6J,"#23-16 However, he believes Everson only has a chance of success if he actually files a lawsuit rather than simply complaining to the FEC.",47,64,chance of success,0,1,1
3TTPFEFXCTL8IP8JZF0BOVOAL47H6J,"#23-16 However, he believes Everson only has a chance of success if he actually files a lawsuit rather than simply complaining to the FEC.",71,79,actually,1,0,1
3TTPFEFXCTL8IP8JZF0BOVOAL47H6J,"#23-16 However, he believes Everson only has a chance of success if he actually files a lawsuit rather than simply complaining to the FEC.",88,95,lawsuit,2,10,12
3TTPFEFXCTL8IP8JZF0BOVOAL47H6J,"#23-16 However, he believes Everson only has a chance of success if he actually files a lawsuit rather than simply complaining to the FEC.",115,126,complaining,1,3,4
3TTPFEFXCTL8IP8JZF0BOVOAL47H6J,"#23-16 However, he believes Everson only has a chance of success if he actually files a lawsuit rather than simply complaining to the FEC.",134,137,FEC,0,1,1
37VE3DA4YUIEO1PEV6HJZBA2Z5IHB4,"#28-15 ""We're here today on a very sad day,"" said Tim Cannon, deputy chief of the HCSO.",62,68,deputy,5,2,7
37VE3DA4YUIEO1PEV6HJZBA2Z5IHB4,"#28-15 ""We're here today on a very sad day,"" said Tim Cannon, deputy chief of the HCSO.",62,74,deputy chief,2,0,2
37VE3DA4YUIEO1PEV6HJZBA2Z5IHB4,"#28-15 ""We're here today on a very sad day,"" said Tim Cannon, deputy chief of the HCSO.",62,86,deputy chief of the HCSO,1,0,1
37VE3DA4YUIEO1PEV6HJZBA2Z5IHB4,"#28-16 ""We're here with our brothers in arms standing behind us because we're all hurting.",28,44,brothers in arms,2,0,2
37VE3DA4YUIEO1PEV6HJZBA2Z5IHB4,"#28-16 ""We're here with our brothers in arms standing behind us because we're all hurting.",40,44,arms,1,1,2
37VE3DA4YUIEO1PEV6HJZBA2Z5IHB4,"#28-16 ""We're here with our brothers in arms standing behind us because we're all hurting.",82,89,hurting,3,6,9
37VE3DA4YUIEO1PEV6HJZBA2Z5IHB4,#28-17 It's a difficult day for us at the sheriff's office.,14,23,difficult,3,0,3
37VE3DA4YUIEO1PEV6HJZBA2Z5IHB4,#28-17 It's a difficult day for us at the sheriff's office.,42,49,sheriff,2,0,2
37VE3DA4YUIEO1PEV6HJZBA2Z5IHB4,#28-17 It's a difficult day for us at the sheriff's office.,42,50,sheriffs,2,0,2
37VE3DA4YUIEO1PEV6HJZBA2Z5IHB4,"#28-18 Once again, a tragedy has struck…our city.",19,28,a tragedy,1,0,1
37VE3DA4YUIEO1PEV6HJZBA2Z5IHB4,"#28-18 Once again, a tragedy has struck…our city.",21,28,tragedy,8,6,14
37VE3DA4YUIEO1PEV6HJZBA2Z5IHB4,"#28-19 Our hearts go out to those…affected by this tragedy.""",28,42,those…affected,1,0,1
37VE3DA4YUIEO1PEV6HJZBA2Z5IHB4,"#28-19 Our hearts go out to those…affected by this tragedy.""",51,58,tragedy,1,0,1
37VE3DA4YUIEO1PEV6HJZBA2Z5IHB4,"#28-20 Tuesday, Conley was allowed to speak to reporters at an administrative segregation unit of the Harris County Jail.",47,56,reporters,2,0,2
37VE3DA4YUIEO1PEV6HJZBA2Z5IHB4,"#28-20 Tuesday, Conley was allowed to speak to reporters at an administrative segregation unit of the Harris County Jail.",63,77,administrative,6,2,8
37VE3DA4YUIEO1PEV6HJZBA2Z5IHB4,"#28-20 Tuesday, Conley was allowed to speak to reporters at an administrative segregation unit of the Harris County Jail.",63,89,administrative segregation,4,2,6
37VE3DA4YUIEO1PEV6HJZBA2Z5IHB4,"#28-20 Tuesday, Conley was allowed to speak to reporters at an administrative segregation unit of the Harris County Jail.",63,94,administrative segregation unit,1,0,1
37VE3DA4YUIEO1PEV6HJZBA2Z5IHB4,"#28-20 Tuesday, Conley was allowed to speak to reporters at an administrative segregation unit of the Harris County Jail.",78,89,segregation,10,7,17
37VE3DA4YUIEO1PEV6HJZBA2Z5IHB4,"#28-21 Conley said he had been living in the house and although he had promised to move out, he did not have elsewhere to go.",71,79,promised,1,1,2
37VE3DA4YUIEO1PEV6HJZBA2Z5IHB4,"#28-21 Conley said he had been living in the house and although he had promised to move out, he did not have elsewhere to go.",109,118,elsewhere,2,2,4
37VE3DA4YUIEO1PEV6HJZBA2Z5IHB4,#28-22 He was angered when he returned to find the door locks changed.,14,21,angered,1,4,5
37VE3DA4YUIEO1PEV6HJZBA2Z5IHB4,#28-23 Conley also felt all the victims disrespected and mistreated him.,32,39,victims,3,2,5
37VE3DA4YUIEO1PEV6HJZBA2Z5IHB4,#28-23 Conley also felt all the victims disrespected and mistreated him.,32,52,victims disrespected,0,1,1
37VE3DA4YUIEO1PEV6HJZBA2Z5IHB4,#28-23 Conley also felt all the victims disrespected and mistreated him.,40,52,disrespected,10,6,16
37VE3DA4YUIEO1PEV6HJZBA2Z5IHB4,#28-23 Conley also felt all the victims disrespected and mistreated him.,57,67,mistreated,10,9,19
3O0M2G5VC631OWMMIFJ4EG6860T940,"#33-4 Tom Williams, auxiliary bishop of Liverpool, conducted the Roman Catholic mass in St Mary's Roman Catholic Church in Liverpool's Woolton area.",20,29,auxiliary,10,8,18
3O0M2G5VC631OWMMIFJ4EG6860T940,"#33-4 Tom Williams, auxiliary bishop of Liverpool, conducted the Roman Catholic mass in St Mary's Roman Catholic Church in Liverpool's Woolton area.",20,36,auxiliary bishop,3,2,5
3O0M2G5VC631OWMMIFJ4EG6860T940,"#33-4 Tom Williams, auxiliary bishop of Liverpool, conducted the Roman Catholic mass in St Mary's Roman Catholic Church in Liverpool's Woolton area.",30,36,bishop,4,0,4
3O0M2G5VC631OWMMIFJ4EG6860T940,"#33-4 Tom Williams, auxiliary bishop of Liverpool, conducted the Roman Catholic mass in St Mary's Roman Catholic Church in Liverpool's Woolton area.",51,60,conducted,5,1,6
3O0M2G5VC631OWMMIFJ4EG6860T940,"#33-4 Tom Williams, auxiliary bishop of Liverpool, conducted the Roman Catholic mass in St Mary's Roman Catholic Church in Liverpool's Woolton area.",65,84,Roman Catholic mass,2,0,2
3O0M2G5VC631OWMMIFJ4EG6860T940,"#33-4 Tom Williams, auxiliary bishop of Liverpool, conducted the Roman Catholic mass in St Mary's Roman Catholic Church in Liverpool's Woolton area.",80,84,mass,1,1,2
3O0M2G5VC631OWMMIFJ4EG6860T940,"#33-4 Tom Williams, auxiliary bishop of Liverpool, conducted the Roman Catholic mass in St Mary's Roman Catholic Church in Liverpool's Woolton area.",88,118,St Marys Roman Catholic Church,1,0,1
3O0M2G5VC631OWMMIFJ4EG6860T940,"#33-4 Tom Williams, auxiliary bishop of Liverpool, conducted the Roman Catholic mass in St Mary's Roman Catholic Church in Liverpool's Woolton area.",104,112,Catholic,0,1,1
3O0M2G5VC631OWMMIFJ4EG6860T940,"#33-4 Tom Williams, auxiliary bishop of Liverpool, conducted the Roman Catholic mass in St Mary's Roman Catholic Church in Liverpool's Woolton area.",123,141,Liverpools Woolton,1,0,1
3O0M2G5VC631OWMMIFJ4EG6860T940,"#33-4 Tom Williams, auxiliary bishop of Liverpool, conducted the Roman Catholic mass in St Mary's Roman Catholic Church in Liverpool's Woolton area.",135,142,Woolton,0,2,2
3O0M2G5VC631OWMMIFJ4EG6860T940,"#33-5 This is the same church that Black got married in 1969 to Bobby Willis, who died in 1999 after 30 years of marriage.",23,29,church,1,0,1
3O0M2G5VC631OWMMIFJ4EG6860T940,"#33-5 This is the same church that Black got married in 1969 to Bobby Willis, who died in 1999 after 30 years of marriage.",64,76,Bobby Willis,0,1,1
3O0M2G5VC631OWMMIFJ4EG6860T940,"#33-5 This is the same church that Black got married in 1969 to Bobby Willis, who died in 1999 after 30 years of marriage.",113,121,marriage,1,0,1
3O0M2G5VC631OWMMIFJ4EG6860T940,#33-6 Eulogies were delivered by Cliff Richard and Paul O'Grady together with poems read by two of Black's sons.,6,14,Eulogies,8,7,15
3O0M2G5VC631OWMMIFJ4EG6860T940,#33-6 Eulogies were delivered by Cliff Richard and Paul O'Grady together with poems read by two of Black's sons.,20,29,delivered,1,2,3
3O0M2G5VC631OWMMIFJ4EG6860T940,#33-6 Eulogies were delivered by Cliff Richard and Paul O'Grady together with poems read by two of Black's sons.,33,46,Cliff Richard,0,1,1
3O0M2G5VC631OWMMIFJ4EG6860T940,#33-6 Eulogies were delivered by Cliff Richard and Paul O'Grady together with poems read by two of Black's sons.,56,62,OGrady,0,1,1
3O0M2G5VC631OWMMIFJ4EG6860T940,#33-6 Eulogies were delivered by Cliff Richard and Paul O'Grady together with poems read by two of Black's sons.,78,83,poems,1,0,1
3O0M2G5VC631OWMMIFJ4EG6860T940,"#33-7 Further tributes were paid by Tom Jones, who flew in specially for the funeral.",14,22,tributes,9,8,17
3O0M2G5VC631OWMMIFJ4EG6860T940,"#33-7 Further tributes were paid by Tom Jones, who flew in specially for the funeral.",51,55,flew,0,3,3
3O0M2G5VC631OWMMIFJ4EG6860T940,"#33-7 Further tributes were paid by Tom Jones, who flew in specially for the funeral.",59,68,specially,3,0,3
3O0M2G5VC631OWMMIFJ4EG6860T940,"#33-7 Further tributes were paid by Tom Jones, who flew in specially for the funeral.",77,84,funeral,3,4,7
3O0M2G5VC631OWMMIFJ4EG6860T940,"#33-8 After the service, Black was to be interred in a private ceremony, next to the graves of her parents at the Allerton cemetery.",41,49,interred,9,7,16
3O0M2G5VC631OWMMIFJ4EG6860T940,"#33-8 After the service, Black was to be interred in a private ceremony, next to the graves of her parents at the Allerton cemetery.",63,71,ceremony,5,0,5
3O0M2G5VC631OWMMIFJ4EG6860T940,"#33-8 After the service, Black was to be interred in a private ceremony, next to the graves of her parents at the Allerton cemetery.",85,91,graves,1,2,3
3O0M2G5VC631OWMMIFJ4EG6860T940,"#33-8 After the service, Black was to be interred in a private ceremony, next to the graves of her parents at the Allerton cemetery.",114,122,Allerton,0,2,2
3O0M2G5VC631OWMMIFJ4EG6860T940,"#33-8 After the service, Black was to be interred in a private ceremony, next to the graves of her parents at the Allerton cemetery.",123,131,cemetery,7,2,9
3O0M2G5VC631OWMMIFJ4EG6860T940,"#33-9 She died early this month, aged 72, after she fell at her home in Spain and suffered a stroke.",82,90,suffered,1,2,3
3O0M2G5VC631OWMMIFJ4EG6860T940,"#33-9 She died early this month, aged 72, after she fell at her home in Spain and suffered a stroke.",93,99,stroke,4,2,6
3O0M2G5VC631OWMMIFJ4EG6860T940,"#34-1 North Korea puts military in 'quasi-state of war' According to Yonhap news agency, quoting North Korea's main news agency Korean Central News Agency (KCNA), the country's military has been placed on high alert and has been told to prepare a ""quasi-state of war"".",23,31,military,1,1,2
3O0M2G5VC631OWMMIFJ4EG6860T940,"#34-1 North Korea puts military in 'quasi-state of war' According to Yonhap news agency, quoting North Korea's main news agency Korean Central News Agency (KCNA), the country's military has been placed on high alert and has been told to prepare a ""quasi-state of war"".",36,54,quasi-state of war,3,1,4
3O0M2G5VC631OWMMIFJ4EG6860T940,"#34-1 North Korea puts military in 'quasi-state of war' According to Yonhap news agency, quoting North Korea's main news agency Korean Central News Agency (KCNA), the country's military has been placed on high alert and has been told to prepare a ""quasi-state of war"".",36,47,quasi-state,4,3,7
3O0M2G5VC631OWMMIFJ4EG6860T940,"#34-1 North Korea puts military in 'quasi-state of war' According to Yonhap news agency, quoting North Korea's main news agency Korean Central News Agency (KCNA), the country's military has been placed on high alert and has been told to prepare a ""quasi-state of war"".",56,65,According,1,0,1
3O0M2G5VC631OWMMIFJ4EG6860T940,"#34-1 North Korea puts military in 'quasi-state of war' According to Yonhap news agency, quoting North Korea's main news agency Korean Central News Agency (KCNA), the country's military has been placed on high alert and has been told to prepare a ""quasi-state of war"".",69,75,Yonhap,0,2,2
3O0M2G5VC631OWMMIFJ4EG6860T940,"#34-1 North Korea puts military in 'quasi-state of war' According to Yonhap news agency, quoting North Korea's main news agency Korean Central News Agency (KCNA), the country's military has been placed on high alert and has been told to prepare a ""quasi-state of war"".",89,96,quoting,3,2,5
3O0M2G5VC631OWMMIFJ4EG6860T940,"#34-1 North Korea puts military in 'quasi-state of war' According to Yonhap news agency, quoting North Korea's main news agency Korean Central News Agency (KCNA), the country's military has been placed on high alert and has been told to prepare a ""quasi-state of war"".",121,127,agency,1,0,1
3O0M2G5VC631OWMMIFJ4EG6860T940,"#34-1 North Korea puts military in 'quasi-state of war' According to Yonhap news agency, quoting North Korea's main news agency Korean Central News Agency (KCNA), the country's military has been placed on high alert and has been told to prepare a ""quasi-state of war"".",177,185,military,0,1,1
3O0M2G5VC631OWMMIFJ4EG6860T940,"#34-1 North Korea puts military in 'quasi-state of war' According to Yonhap news agency, quoting North Korea's main news agency Korean Central News Agency (KCNA), the country's military has been placed on high alert and has been told to prepare a ""quasi-state of war"".",205,215,high alert,0,1,1
3O0M2G5VC631OWMMIFJ4EG6860T940,"#34-1 North Korea puts military in 'quasi-state of war' According to Yonhap news agency, quoting North Korea's main news agency Korean Central News Agency (KCNA), the country's military has been placed on high alert and has been told to prepare a ""quasi-state of war"".",210,215,alert,1,0,1
3O0M2G5VC631OWMMIFJ4EG6860T940,"#34-1 North Korea puts military in 'quasi-state of war' According to Yonhap news agency, quoting North Korea's main news agency Korean Central News Agency (KCNA), the country's military has been placed on high alert and has been told to prepare a ""quasi-state of war"".",237,244,prepare,2,0,2
3O0M2G5VC631OWMMIFJ4EG6860T940,"#34-1 North Korea puts military in 'quasi-state of war' According to Yonhap news agency, quoting North Korea's main news agency Korean Central News Agency (KCNA), the country's military has been placed on high alert and has been told to prepare a ""quasi-state of war"".",248,259,quasi-state,1,1,2
3O0M2G5VC631OWMMIFJ4EG6860T940,"#34-1 North Korea puts military in 'quasi-state of war' According to Yonhap news agency, quoting North Korea's main news agency Korean Central News Agency (KCNA), the country's military has been placed on high alert and has been told to prepare a ""quasi-state of war"".",248,266,quasi-state of war,2,2,4
3FVBZG9CLJFD4EM4XQKUFUEJ81LH0I,"#13-6 Although the 51-48 vote was mostly along party lines, some Republicans have expressed uncertainty about repealing Obamacare before a replacement system is worked out.",41,58,along party lines,0,1,1
3FVBZG9CLJFD4EM4XQKUFUEJ81LH0I,"#13-6 Although the 51-48 vote was mostly along party lines, some Republicans have expressed uncertainty about repealing Obamacare before a replacement system is worked out.",47,58,party lines,0,1,1
3FVBZG9CLJFD4EM4XQKUFUEJ81LH0I,"#13-6 Although the 51-48 vote was mostly along party lines, some Republicans have expressed uncertainty about repealing Obamacare before a replacement system is worked out.",65,76,Republicans,4,0,4
3FVBZG9CLJFD4EM4XQKUFUEJ81LH0I,"#13-6 Although the 51-48 vote was mostly along party lines, some Republicans have expressed uncertainty about repealing Obamacare before a replacement system is worked out.",82,91,expressed,1,3,4
3FVBZG9CLJFD4EM4XQKUFUEJ81LH0I,"#13-6 Although the 51-48 vote was mostly along party lines, some Republicans have expressed uncertainty about repealing Obamacare before a replacement system is worked out.",92,103,uncertainty,7,5,12
3FVBZG9CLJFD4EM4XQKUFUEJ81LH0I,"#13-6 Although the 51-48 vote was mostly along party lines, some Republicans have expressed uncertainty about repealing Obamacare before a replacement system is worked out.",110,119,repealing,8,10,18
3FVBZG9CLJFD4EM4XQKUFUEJ81LH0I,"#13-6 Although the 51-48 vote was mostly along party lines, some Republicans have expressed uncertainty about repealing Obamacare before a replacement system is worked out.",110,129,repealing Obamacare,1,0,1
3FVBZG9CLJFD4EM4XQKUFUEJ81LH0I,"#13-6 Although the 51-48 vote was mostly along party lines, some Republicans have expressed uncertainty about repealing Obamacare before a replacement system is worked out.",120,129,Obamacare,2,1,3
3FVBZG9CLJFD4EM4XQKUFUEJ81LH0I,"#13-6 Although the 51-48 vote was mostly along party lines, some Republicans have expressed uncertainty about repealing Obamacare before a replacement system is worked out.",139,150,replacement,2,3,5
3FVBZG9CLJFD4EM4XQKUFUEJ81LH0I,"#13-6 Although the 51-48 vote was mostly along party lines, some Republicans have expressed uncertainty about repealing Obamacare before a replacement system is worked out.",139,157,replacement system,1,0,1
3FVBZG9CLJFD4EM4XQKUFUEJ81LH0I,"#13-7 Although president-elect Donald Trump has called for a ""repeal and replace"" plan, saying that a new health care system would be enacted ""almost simultaneously,"" many in government and the press have expressed doubts about whether this would actually happen.",15,30,president-elect,1,1,2
3FVBZG9CLJFD4EM4XQKUFUEJ81LH0I,"#13-7 Although president-elect Donald Trump has called for a ""repeal and replace"" plan, saying that a new health care system would be enacted ""almost simultaneously,"" many in government and the press have expressed doubts about whether this would actually happen.",31,43,Donald Trump,0,1,1
3FVBZG9CLJFD4EM4XQKUFUEJ81LH0I,"#13-7 Although president-elect Donald Trump has called for a ""repeal and replace"" plan, saying that a new health care system would be enacted ""almost simultaneously,"" many in government and the press have expressed doubts about whether this would actually happen.",62,80,repeal and replace,2,0,2
3FVBZG9CLJFD4EM4XQKUFUEJ81LH0I,"#13-7 Although president-elect Donald Trump has called for a ""repeal and replace"" plan, saying that a new health care system would be enacted ""almost simultaneously,"" many in government and the press have expressed doubts about whether this would actually happen.",62,68,repeal,0,3,3
3FVBZG9CLJFD4EM4XQKUFUEJ81LH0I,"#13-7 Although president-elect Donald Trump has called for a ""repeal and replace"" plan, saying that a new health care system would be enacted ""almost simultaneously,"" many in government and the press have expressed doubts about whether this would actually happen.",134,141,enacted,8,7,15
3FVBZG9CLJFD4EM4XQKUFUEJ81LH0I,"#13-7 Although president-elect Donald Trump has called for a ""repeal and replace"" plan, saying that a new health care system would be enacted ""almost simultaneously,"" many in government and the press have expressed doubts about whether this would actually happen.",150,164,simultaneously,10,8,18
3FVBZG9CLJFD4EM4XQKUFUEJ81LH0I,"#13-7 Although president-elect Donald Trump has called for a ""repeal and replace"" plan, saying that a new health care system would be enacted ""almost simultaneously,"" many in government and the press have expressed doubts about whether this would actually happen.",175,185,government,1,0,1
3FVBZG9CLJFD4EM4XQKUFUEJ81LH0I,"#13-7 Although president-elect Donald Trump has called for a ""repeal and replace"" plan, saying that a new health care system would be enacted ""almost simultaneously,"" many in government and the press have expressed doubts about whether this would actually happen.",205,214,expressed,1,1,2
3FVBZG9CLJFD4EM4XQKUFUEJ81LH0I,"#13-7 Although president-elect Donald Trump has called for a ""repeal and replace"" plan, saying that a new health care system would be enacted ""almost simultaneously,"" many in government and the press have expressed doubts about whether this would actually happen.",215,221,doubts,2,0,2
3FVBZG9CLJFD4EM4XQKUFUEJ81LH0I,"#13-8 Senator Susan Collins of Maine said she would like to at least see a well-constructed plan before voting and Senator Johnny Isakson of Georgia said repealing Obamacare without replacing it was ""unacceptable.""",75,91,well-constructed,3,1,4
3FVBZG9CLJFD4EM4XQKUFUEJ81LH0I,"#13-8 Senator Susan Collins of Maine said she would like to at least see a well-constructed plan before voting and Senator Johnny Isakson of Georgia said repealing Obamacare without replacing it was ""unacceptable.""",75,96,well-constructed plan,0,1,1
3FVBZG9CLJFD4EM4XQKUFUEJ81LH0I,"#13-8 Senator Susan Collins of Maine said she would like to at least see a well-constructed plan before voting and Senator Johnny Isakson of Georgia said repealing Obamacare without replacing it was ""unacceptable.""",104,110,voting,1,0,1
3FVBZG9CLJFD4EM4XQKUFUEJ81LH0I,"#13-8 Senator Susan Collins of Maine said she would like to at least see a well-constructed plan before voting and Senator Johnny Isakson of Georgia said repealing Obamacare without replacing it was ""unacceptable.""",115,122,Senator,1,0,1
3FVBZG9CLJFD4EM4XQKUFUEJ81LH0I,"#13-8 Senator Susan Collins of Maine said she would like to at least see a well-constructed plan before voting and Senator Johnny Isakson of Georgia said repealing Obamacare without replacing it was ""unacceptable.""",123,137,Johnny Isakson,0,1,1
3FVBZG9CLJFD4EM4XQKUFUEJ81LH0I,"#13-8 Senator Susan Collins of Maine said she would like to at least see a well-constructed plan before voting and Senator Johnny Isakson of Georgia said repealing Obamacare without replacing it was ""unacceptable.""",154,163,repealing,4,2,6
3FVBZG9CLJFD4EM4XQKUFUEJ81LH0I,"#13-8 Senator Susan Collins of Maine said she would like to at least see a well-constructed plan before voting and Senator Johnny Isakson of Georgia said repealing Obamacare without replacing it was ""unacceptable.""",164,173,Obamacare,0,1,1
3FVBZG9CLJFD4EM4XQKUFUEJ81LH0I,"#13-8 Senator Susan Collins of Maine said she would like to at least see a well-constructed plan before voting and Senator Johnny Isakson of Georgia said repealing Obamacare without replacing it was ""unacceptable.""",200,212,unacceptable,5,3,8
3FVBZG9CLJFD4EM4XQKUFUEJ81LH0I,#13-9 These concerns were shared by members of the House of Representatives.,12,20,concerns,5,3,8
3FVBZG9CLJFD4EM4XQKUFUEJ81LH0I,#13-9 These concerns were shared by members of the House of Representatives.,51,75,House of Representatives,2,0,2
3FVBZG9CLJFD4EM4XQKUFUEJ81LH0I,#13-9 These concerns were shared by members of the House of Representatives.,60,75,Representatives,2,0,2
3FVBZG9CLJFD4EM4XQKUFUEJ81LH0I,"#13-10 ""We need to be voting for a replacement plan at the same time that we vote for repeal,"" added Representative Mark Meadows of North Carolina.",35,46,replacement,0,2,2
3FVBZG9CLJFD4EM4XQKUFUEJ81LH0I,"#13-10 ""We need to be voting for a replacement plan at the same time that we vote for repeal,"" added Representative Mark Meadows of North Carolina.",86,92,repeal,3,1,4
3FVBZG9CLJFD4EM4XQKUFUEJ81LH0I,"#13-10 ""We need to be voting for a replacement plan at the same time that we vote for repeal,"" added Representative Mark Meadows of North Carolina.",101,115,Representative,3,1,4
3FVBZG9CLJFD4EM4XQKUFUEJ81LH0I,"#13-10 ""We need to be voting for a replacement plan at the same time that we vote for repeal,"" added Representative Mark Meadows of North Carolina.",116,128,Mark Meadows,0,1,1
3ZZAYRN1I6SOC45IZ53UJEDPHYVTOT,#39-24 Neighbouring Hungary is constructing a border fence across its entire frontier with Serbia.,7,19,Neighbouring,9,3,12
3ZZAYRN1I6SOC45IZ53UJEDPHYVTOT,#39-24 Neighbouring Hungary is constructing a border fence across its entire frontier with Serbia.,20,43,Hungary is constructing,0,1,1
3ZZAYRN1I6SOC45IZ53UJEDPHYVTOT,#39-24 Neighbouring Hungary is constructing a border fence across its entire frontier with Serbia.,31,43,constructing,5,2,7
3ZZAYRN1I6SOC45IZ53UJEDPHYVTOT,#39-24 Neighbouring Hungary is constructing a border fence across its entire frontier with Serbia.,31,58,constructing a border fence,1,0,1
3ZZAYRN1I6SOC45IZ53UJEDPHYVTOT,#39-24 Neighbouring Hungary is constructing a border fence across its entire frontier with Serbia.,46,58,border fence,0,3,3
3ZZAYRN1I6SOC45IZ53UJEDPHYVTOT,#39-24 Neighbouring Hungary is constructing a border fence across its entire frontier with Serbia.,53,58,fence,0,3,3
3ZZAYRN1I6SOC45IZ53UJEDPHYVTOT,#39-24 Neighbouring Hungary is constructing a border fence across its entire frontier with Serbia.,77,85,frontier,9,4,13
3ZZAYRN1I6SOC45IZ53UJEDPHYVTOT,"#39-25 Yesterday alone saw a record 3,241 attempts to enter Hungary illegally, according to authorities there.",42,50,attempts,1,0,1
3ZZAYRN1I6SOC45IZ53UJEDPHYVTOT,"#39-25 Yesterday alone saw a record 3,241 attempts to enter Hungary illegally, according to authorities there.",68,77,illegally,6,2,8
3ZZAYRN1I6SOC45IZ53UJEDPHYVTOT,"#39-25 Yesterday alone saw a record 3,241 attempts to enter Hungary illegally, according to authorities there.",79,103,according to authorities,1,0,1
3ZZAYRN1I6SOC45IZ53UJEDPHYVTOT,"#39-25 Yesterday alone saw a record 3,241 attempts to enter Hungary illegally, according to authorities there.",92,103,authorities,6,2,8
3ZZAYRN1I6SOC45IZ53UJEDPHYVTOT,#39-26 Conflict in Syria and other parts of the world has led refugees to Europe.,7,15,Conflict,3,3,6
3ZZAYRN1I6SOC45IZ53UJEDPHYVTOT,#39-26 Conflict in Syria and other parts of the world has led refugees to Europe.,62,70,refugees,9,6,15
3ZZAYRN1I6SOC45IZ53UJEDPHYVTOT,"#39-27 Once inside, they can move freely inside the Schengen Area, which covers most of the EU.",34,40,freely,0,1,1
3ZZAYRN1I6SOC45IZ53UJEDPHYVTOT,"#39-27 Once inside, they can move freely inside the Schengen Area, which covers most of the EU.",52,60,Schengen,1,1,2
3ZZAYRN1I6SOC45IZ53UJEDPHYVTOT,"#39-27 Once inside, they can move freely inside the Schengen Area, which covers most of the EU.",52,65,Schengen Area,0,1,1
3ZZAYRN1I6SOC45IZ53UJEDPHYVTOT,#39-28 Austrian police earlier this week arrested three motorists suspected of people smuggling.,41,49,arrested,2,0,2
3ZZAYRN1I6SOC45IZ53UJEDPHYVTOT,#39-28 Austrian police earlier this week arrested three motorists suspected of people smuggling.,56,65,motorists,2,2,4
3ZZAYRN1I6SOC45IZ53UJEDPHYVTOT,#39-28 Austrian police earlier this week arrested three motorists suspected of people smuggling.,56,95,motorists suspected of people smuggling,1,0,1
3ZZAYRN1I6SOC45IZ53UJEDPHYVTOT,#39-28 Austrian police earlier this week arrested three motorists suspected of people smuggling.,66,75,suspected,3,2,5
3ZZAYRN1I6SOC45IZ53UJEDPHYVTOT,#39-28 Austrian police earlier this week arrested three motorists suspected of people smuggling.,79,95,people smuggling,1,1,2
3ZZAYRN1I6SOC45IZ53UJEDPHYVTOT,#39-28 Austrian police earlier this week arrested three motorists suspected of people smuggling.,86,95,smuggling,10,9,19
3ZZAYRN1I6SOC45IZ53UJEDPHYVTOT,"#39-29 One driver is accused of moving 34 people, ten of them children, into Austria from Serbia.",21,28,accused,5,4,9
3ZZAYRN1I6SOC45IZ53UJEDPHYVTOT,#39-30 The group were left by the roadside near Bruck an der Leitha and reported struggling to breathe in the van.,34,42,roadside,1,1,2
3ZZAYRN1I6SOC45IZ53UJEDPHYVTOT,#39-30 The group were left by the roadside near Bruck an der Leitha and reported struggling to breathe in the van.,48,53,Bruck,0,1,1
3ZZAYRN1I6SOC45IZ53UJEDPHYVTOT,#39-30 The group were left by the roadside near Bruck an der Leitha and reported struggling to breathe in the van.,48,67,Bruck an der Leitha,1,0,1
3ZZAYRN1I6SOC45IZ53UJEDPHYVTOT,#39-30 The group were left by the roadside near Bruck an der Leitha and reported struggling to breathe in the van.,61,67,Leitha,0,1,1
3ZZAYRN1I6SOC45IZ53UJEDPHYVTOT,#39-30 The group were left by the roadside near Bruck an der Leitha and reported struggling to breathe in the van.,81,91,struggling,4,7,11
3ZZAYRN1I6SOC45IZ53UJEDPHYVTOT,#39-30 The group were left by the roadside near Bruck an der Leitha and reported struggling to breathe in the van.,81,102,struggling to breathe,1,1,2
3ZZAYRN1I6SOC45IZ53UJEDPHYVTOT,#39-30 The group were left by the roadside near Bruck an der Leitha and reported struggling to breathe in the van.,95,102,breathe,2,1,3
3ZZAYRN1I6SOC45IZ53UJEDPHYVTOT,"#4-1 Former NASA astronaut Eugene Cernan dies aged 82 Eugene Cernan, former NASA astronaut and the most recent human to walk on the Moon, died on Monday aged 82, according to a NASA statement.",17,26,astronaut,4,2,6
3ZZAYRN1I6SOC45IZ53UJEDPHYVTOT,"#4-1 Former NASA astronaut Eugene Cernan dies aged 82 Eugene Cernan, former NASA astronaut and the most recent human to walk on the Moon, died on Monday aged 82, according to a NASA statement.",17,33,astronaut Eugene,1,0,1
3ZZAYRN1I6SOC45IZ53UJEDPHYVTOT,"#4-1 Former NASA astronaut Eugene Cernan dies aged 82 Eugene Cernan, former NASA astronaut and the most recent human to walk on the Moon, died on Monday aged 82, according to a NASA statement.",61,67,Cernan,0,1,1
3ZZAYRN1I6SOC45IZ53UJEDPHYVTOT,"#4-1 Former NASA astronaut Eugene Cernan dies aged 82 Eugene Cernan, former NASA astronaut and the most recent human to walk on the Moon, died on Monday aged 82, according to a NASA statement.",76,90,NASA astronaut,1,1,2
3ZZAYRN1I6SOC45IZ53UJEDPHYVTOT,"#4-1 Former NASA astronaut Eugene Cernan dies aged 82 Eugene Cernan, former NASA astronaut and the most recent human to walk on the Moon, died on Monday aged 82, according to a NASA statement.",81,90,astronaut,7,2,9
3ZZAYRN1I6SOC45IZ53UJEDPHYVTOT,"#4-1 Former NASA astronaut Eugene Cernan dies aged 82 Eugene Cernan, former NASA astronaut and the most recent human to walk on the Moon, died on Monday aged 82, according to a NASA statement.",162,171,according,1,0,1
3ZZAYRN1I6SOC45IZ53UJEDPHYVTOT,"#4-1 Former NASA astronaut Eugene Cernan dies aged 82 Eugene Cernan, former NASA astronaut and the most recent human to walk on the Moon, died on Monday aged 82, according to a NASA statement.",177,181,NASA,1,0,1
3ZZAYRN1I6SOC45IZ53UJEDPHYVTOT,"#4-1 Former NASA astronaut Eugene Cernan dies aged 82 Eugene Cernan, former NASA astronaut and the most recent human to walk on the Moon, died on Monday aged 82, according to a NASA statement.",182,191,statement,1,0,1
3R4QIDVOJPD0BUAWFWB3FGJAAM3EEL,"#29-10 Although he described Trump's previous foray into politics as a ""charade"" during a 2011 interview with Wikinews, Martin now sees himself as Trump's ""tag team"" partner in attacking the Bush candidacy.",37,45,previous,1,0,1
3R4QIDVOJPD0BUAWFWB3FGJAAM3EEL,"#29-10 Although he described Trump's previous foray into politics as a ""charade"" during a 2011 interview with Wikinews, Martin now sees himself as Trump's ""tag team"" partner in attacking the Bush candidacy.",37,51,previous foray,0,1,1
3R4QIDVOJPD0BUAWFWB3FGJAAM3EEL,"#29-10 Although he described Trump's previous foray into politics as a ""charade"" during a 2011 interview with Wikinews, Martin now sees himself as Trump's ""tag team"" partner in attacking the Bush candidacy.",46,51,foray,10,7,17
3R4QIDVOJPD0BUAWFWB3FGJAAM3EEL,"#29-10 Although he described Trump's previous foray into politics as a ""charade"" during a 2011 interview with Wikinews, Martin now sees himself as Trump's ""tag team"" partner in attacking the Bush candidacy.",72,79,charade,10,8,18
3R4QIDVOJPD0BUAWFWB3FGJAAM3EEL,"#29-10 Although he described Trump's previous foray into politics as a ""charade"" during a 2011 interview with Wikinews, Martin now sees himself as Trump's ""tag team"" partner in attacking the Bush candidacy.",110,118,Wikinews,1,0,1
3R4QIDVOJPD0BUAWFWB3FGJAAM3EEL,"#29-10 Although he described Trump's previous foray into politics as a ""charade"" during a 2011 interview with Wikinews, Martin now sees himself as Trump's ""tag team"" partner in attacking the Bush candidacy.",156,164,tag team,5,2,7
3R4QIDVOJPD0BUAWFWB3FGJAAM3EEL,"#29-10 Although he described Trump's previous foray into politics as a ""charade"" during a 2011 interview with Wikinews, Martin now sees himself as Trump's ""tag team"" partner in attacking the Bush candidacy.",177,186,attacking,1,0,1
3R4QIDVOJPD0BUAWFWB3FGJAAM3EEL,"#29-10 Although he described Trump's previous foray into politics as a ""charade"" during a 2011 interview with Wikinews, Martin now sees himself as Trump's ""tag team"" partner in attacking the Bush candidacy.",196,205,candidacy,10,5,15
3R4QIDVOJPD0BUAWFWB3FGJAAM3EEL,"#29-11 ""Trump has the raw media power to weaken Bush,"" says Martin, ""I have the negative information and hardball media tactics to make Bush a toxic candidate for the Republican base.""",22,25,raw,1,1,2
3R4QIDVOJPD0BUAWFWB3FGJAAM3EEL,"#29-11 ""Trump has the raw media power to weaken Bush,"" says Martin, ""I have the negative information and hardball media tactics to make Bush a toxic candidate for the Republican base.""",22,31,raw media,1,0,1
3R4QIDVOJPD0BUAWFWB3FGJAAM3EEL,"#29-11 ""Trump has the raw media power to weaken Bush,"" says Martin, ""I have the negative information and hardball media tactics to make Bush a toxic candidate for the Republican base.""",22,37,raw media power,2,2,4
3R4QIDVOJPD0BUAWFWB3FGJAAM3EEL,"#29-11 ""Trump has the raw media power to weaken Bush,"" says Martin, ""I have the negative information and hardball media tactics to make Bush a toxic candidate for the Republican base.""",41,47,weaken,1,1,2
3R4QIDVOJPD0BUAWFWB3FGJAAM3EEL,"#29-11 ""Trump has the raw media power to weaken Bush,"" says Martin, ""I have the negative information and hardball media tactics to make Bush a toxic candidate for the Republican base.""",80,88,negative,1,0,1
3R4QIDVOJPD0BUAWFWB3FGJAAM3EEL,"#29-11 ""Trump has the raw media power to weaken Bush,"" says Martin, ""I have the negative information and hardball media tactics to make Bush a toxic candidate for the Republican base.""",80,100,negative information,0,1,1
3R4QIDVOJPD0BUAWFWB3FGJAAM3EEL,"#29-11 ""Trump has the raw media power to weaken Bush,"" says Martin, ""I have the negative information and hardball media tactics to make Bush a toxic candidate for the Republican base.""",105,113,hardball,6,5,11
3R4QIDVOJPD0BUAWFWB3FGJAAM3EEL,"#29-11 ""Trump has the raw media power to weaken Bush,"" says Martin, ""I have the negative information and hardball media tactics to make Bush a toxic candidate for the Republican base.""",105,127,hardball media tactics,1,3,4
3R4QIDVOJPD0BUAWFWB3FGJAAM3EEL,"#29-11 ""Trump has the raw media power to weaken Bush,"" says Martin, ""I have the negative information and hardball media tactics to make Bush a toxic candidate for the Republican base.""",120,127,tactics,6,4,10
3R4QIDVOJPD0BUAWFWB3FGJAAM3EEL,"#29-11 ""Trump has the raw media power to weaken Bush,"" says Martin, ""I have the negative information and hardball media tactics to make Bush a toxic candidate for the Republican base.""",143,148,toxic,4,2,6
3R4QIDVOJPD0BUAWFWB3FGJAAM3EEL,"#29-11 ""Trump has the raw media power to weaken Bush,"" says Martin, ""I have the negative information and hardball media tactics to make Bush a toxic candidate for the Republican base.""",143,158,toxic candidate,2,0,2
3R4QIDVOJPD0BUAWFWB3FGJAAM3EEL,"#29-11 ""Trump has the raw media power to weaken Bush,"" says Martin, ""I have the negative information and hardball media tactics to make Bush a toxic candidate for the Republican base.""",149,158,candidate,3,0,3
3R4QIDVOJPD0BUAWFWB3FGJAAM3EEL,"#29-12 Martin adamantly opposes Bush because of the foreign policy of the candidate's brother, former President George W. Bush.",14,23,adamantly,10,10,20
3R4QIDVOJPD0BUAWFWB3FGJAAM3EEL,"#29-12 Martin adamantly opposes Bush because of the foreign policy of the candidate's brother, former President George W. Bush.",14,31,adamantly opposes,1,1,2
3R4QIDVOJPD0BUAWFWB3FGJAAM3EEL,"#29-12 Martin adamantly opposes Bush because of the foreign policy of the candidate's brother, former President George W. Bush.",24,31,opposes,3,1,4
3R4QIDVOJPD0BUAWFWB3FGJAAM3EEL,"#29-13 He also criticizes Bush for his alleged economic benefit from the collapse of Lehman Brothers, labeling Bush as a ""front man for a handful of corrupt plutocrats that have raped [the nation's] economy.""",15,25,criticizes,4,1,5
3R4QIDVOJPD0BUAWFWB3FGJAAM3EEL,"#29-13 He also criticizes Bush for his alleged economic benefit from the collapse of Lehman Brothers, labeling Bush as a ""front man for a handful of corrupt plutocrats that have raped [the nation's] economy.""",39,46,alleged,3,6,9
3R4QIDVOJPD0BUAWFWB3FGJAAM3EEL,"#29-13 He also criticizes Bush for his alleged economic benefit from the collapse of Lehman Brothers, labeling Bush as a ""front man for a handful of corrupt plutocrats that have raped [the nation's] economy.""",47,55,economic,1,0,1
3R4QIDVOJPD0BUAWFWB3FGJAAM3EEL,"#29-13 He also criticizes Bush for his alleged economic benefit from the collapse of Lehman Brothers, labeling Bush as a ""front man for a handful of corrupt plutocrats that have raped [the nation's] economy.""",73,81,collapse,1,2,3
3R4QIDVOJPD0BUAWFWB3FGJAAM3EEL,"#29-13 He also criticizes Bush for his alleged economic benefit from the collapse of Lehman Brothers, labeling Bush as a ""front man for a handful of corrupt plutocrats that have raped [the nation's] economy.""",85,91,Lehman,0,1,1
3R4QIDVOJPD0BUAWFWB3FGJAAM3EEL,"#29-13 He also criticizes Bush for his alleged economic benefit from the collapse of Lehman Brothers, labeling Bush as a ""front man for a handful of corrupt plutocrats that have raped [the nation's] economy.""",102,110,labeling,0,1,1
3R4QIDVOJPD0BUAWFWB3FGJAAM3EEL,"#29-13 He also criticizes Bush for his alleged economic benefit from the collapse of Lehman Brothers, labeling Bush as a ""front man for a handful of corrupt plutocrats that have raped [the nation's] economy.""",138,145,handful,0,1,1
3R4QIDVOJPD0BUAWFWB3FGJAAM3EEL,"#29-13 He also criticizes Bush for his alleged economic benefit from the collapse of Lehman Brothers, labeling Bush as a ""front man for a handful of corrupt plutocrats that have raped [the nation's] economy.""",149,156,corrupt,2,0,2
3R4QIDVOJPD0BUAWFWB3FGJAAM3EEL,"#29-13 He also criticizes Bush for his alleged economic benefit from the collapse of Lehman Brothers, labeling Bush as a ""front man for a handful of corrupt plutocrats that have raped [the nation's] economy.""",149,167,corrupt plutocrats,3,2,5
3R4QIDVOJPD0BUAWFWB3FGJAAM3EEL,"#29-13 He also criticizes Bush for his alleged economic benefit from the collapse of Lehman Brothers, labeling Bush as a ""front man for a handful of corrupt plutocrats that have raped [the nation's] economy.""",157,167,plutocrats,10,8,18
3R4QIDVOJPD0BUAWFWB3FGJAAM3EEL,"#29-14 Martin has previously criticized the Bush family during his 2000 campaign, when he ran television ads accusing then-presidential candidate George W. Bush of abusing cocaine and alcohol.",18,28,previously,1,0,1
3R4QIDVOJPD0BUAWFWB3FGJAAM3EEL,"#29-14 Martin has previously criticized the Bush family during his 2000 campaign, when he ran television ads accusing then-presidential candidate George W. Bush of abusing cocaine and alcohol.",29,39,criticized,1,3,4
3R4QIDVOJPD0BUAWFWB3FGJAAM3EEL,"#29-14 Martin has previously criticized the Bush family during his 2000 campaign, when he ran television ads accusing then-presidential candidate George W. Bush of abusing cocaine and alcohol.",109,117,accusing,2,0,2
3R4QIDVOJPD0BUAWFWB3FGJAAM3EEL,"#29-14 Martin has previously criticized the Bush family during his 2000 campaign, when he ran television ads accusing then-presidential candidate George W. Bush of abusing cocaine and alcohol.",118,135,then-presidential,2,0,2
3R4QIDVOJPD0BUAWFWB3FGJAAM3EEL,"#29-14 Martin has previously criticized the Bush family during his 2000 campaign, when he ran television ads accusing then-presidential candidate George W. Bush of abusing cocaine and alcohol.",118,145,then-presidential candidate,1,0,1
3R4QIDVOJPD0BUAWFWB3FGJAAM3EEL,"#29-14 Martin has previously criticized the Bush family during his 2000 campaign, when he ran television ads accusing then-presidential candidate George W. Bush of abusing cocaine and alcohol.",164,171,abusing,1,3,4
3R4QIDVOJPD0BUAWFWB3FGJAAM3EEL,"#29-14 Martin has previously criticized the Bush family during his 2000 campaign, when he ran television ads accusing then-presidential candidate George W. Bush of abusing cocaine and alcohol.",172,179,cocaine,0,1,1
3ODOP6T3ASLQOC1NX64P4TYU0UJ423,"#15-8 The presence of US assets ""threatens our interests and our security,"" according to Putin.",10,18,presence,3,2,5
3ODOP6T3ASLQOC1NX64P4TYU0UJ423,"#15-8 The presence of US assets ""threatens our interests and our security,"" according to Putin.",10,31,presence of US assets,1,0,1
3ODOP6T3ASLQOC1NX64P4TYU0UJ423,"#15-8 The presence of US assets ""threatens our interests and our security,"" according to Putin.",22,31,US assets,1,0,1
3ODOP6T3ASLQOC1NX64P4TYU0UJ423,"#15-8 The presence of US assets ""threatens our interests and our security,"" according to Putin.",25,31,assets,1,3,4
3ODOP6T3ASLQOC1NX64P4TYU0UJ423,"#15-8 The presence of US assets ""threatens our interests and our security,"" according to Putin.",33,42,threatens,3,8,11
3ODOP6T3ASLQOC1NX64P4TYU0UJ423,"#15-8 The presence of US assets ""threatens our interests and our security,"" according to Putin.",33,73,threatens our interests and our security,1,1,2
3ODOP6T3ASLQOC1NX64P4TYU0UJ423,"#15-8 The presence of US assets ""threatens our interests and our security,"" according to Putin.",65,73,security,1,1,2
3ODOP6T3ASLQOC1NX64P4TYU0UJ423,"#15-9 ""It's a third country that is building up its military presence on our borders in Europe,"" he told the BBC.",52,69,military presence,0,1,1
3ODOP6T3ASLQOC1NX64P4TYU0UJ423,"#15-9 ""It's a third country that is building up its military presence on our borders in Europe,"" he told the BBC.",61,69,presence,2,1,3
3ODOP6T3ASLQOC1NX64P4TYU0UJ423,"#15-9 ""It's a third country that is building up its military presence on our borders in Europe,"" he told the BBC.",109,112,BBC,1,0,1
3ODOP6T3ASLQOC1NX64P4TYU0UJ423,"#15-11 Outgoing US President Barack Obama authorised the move in response to Russian intervention in Ukraine in 2014, in which Crimea was annexed.",7,15,Outgoing,1,3,4
3ODOP6T3ASLQOC1NX64P4TYU0UJ423,"#15-11 Outgoing US President Barack Obama authorised the move in response to Russian intervention in Ukraine in 2014, in which Crimea was annexed.",29,41,Barack Obama,0,1,1
3ODOP6T3ASLQOC1NX64P4TYU0UJ423,"#15-11 Outgoing US President Barack Obama authorised the move in response to Russian intervention in Ukraine in 2014, in which Crimea was annexed.",42,52,authorised,5,7,12
3ODOP6T3ASLQOC1NX64P4TYU0UJ423,"#15-11 Outgoing US President Barack Obama authorised the move in response to Russian intervention in Ukraine in 2014, in which Crimea was annexed.",65,73,response,0,1,1
3ODOP6T3ASLQOC1NX64P4TYU0UJ423,"#15-11 Outgoing US President Barack Obama authorised the move in response to Russian intervention in Ukraine in 2014, in which Crimea was annexed.",77,97,Russian intervention,1,0,1
3ODOP6T3ASLQOC1NX64P4TYU0UJ423,"#15-11 Outgoing US President Barack Obama authorised the move in response to Russian intervention in Ukraine in 2014, in which Crimea was annexed.",85,97,intervention,6,7,13
3ODOP6T3ASLQOC1NX64P4TYU0UJ423,"#15-11 Outgoing US President Barack Obama authorised the move in response to Russian intervention in Ukraine in 2014, in which Crimea was annexed.",101,108,Ukraine,1,1,2
3ODOP6T3ASLQOC1NX64P4TYU0UJ423,"#15-11 Outgoing US President Barack Obama authorised the move in response to Russian intervention in Ukraine in 2014, in which Crimea was annexed.",127,133,Crimea,0,2,2
3ODOP6T3ASLQOC1NX64P4TYU0UJ423,"#15-11 Outgoing US President Barack Obama authorised the move in response to Russian intervention in Ukraine in 2014, in which Crimea was annexed.",127,145,Crimea was annexed,1,0,1
3ODOP6T3ASLQOC1NX64P4TYU0UJ423,"#15-11 Outgoing US President Barack Obama authorised the move in response to Russian intervention in Ukraine in 2014, in which Crimea was annexed.",138,145,annexed,8,8,16
3ODOP6T3ASLQOC1NX64P4TYU0UJ423,#15-12 It was agreed at a NATO summit in Warsaw last year.,26,37,NATO summit,1,1,2
3ODOP6T3ASLQOC1NX64P4TYU0UJ423,#15-12 It was agreed at a NATO summit in Warsaw last year.,31,37,summit,1,3,4
3ODOP6T3ASLQOC1NX64P4TYU0UJ423,"#15-13 Tomasz Szatkowski, Polish Undersecretary of State for Defence, noted ""large exercises"" by Russia near the Polish border as another reason the troops were needed.",7,13,Tomasz,0,1,1
3ODOP6T3ASLQOC1NX64P4TYU0UJ423,"#15-13 Tomasz Szatkowski, Polish Undersecretary of State for Defence, noted ""large exercises"" by Russia near the Polish border as another reason the troops were needed.",7,24,Tomasz Szatkowski,1,1,2
3ODOP6T3ASLQOC1NX64P4TYU0UJ423,"#15-13 Tomasz Szatkowski, Polish Undersecretary of State for Defence, noted ""large exercises"" by Russia near the Polish border as another reason the troops were needed.",26,47,Polish Undersecretary,1,0,1
3ODOP6T3ASLQOC1NX64P4TYU0UJ423,"#15-13 Tomasz Szatkowski, Polish Undersecretary of State for Defence, noted ""large exercises"" by Russia near the Polish border as another reason the troops were needed.",33,47,Undersecretary,4,2,6
3ODOP6T3ASLQOC1NX64P4TYU0UJ423,"#15-13 Tomasz Szatkowski, Polish Undersecretary of State for Defence, noted ""large exercises"" by Russia near the Polish border as another reason the troops were needed.",33,56,Undersecretary of State,0,1,1
3ODOP6T3ASLQOC1NX64P4TYU0UJ423,"#15-13 Tomasz Szatkowski, Polish Undersecretary of State for Defence, noted ""large exercises"" by Russia near the Polish border as another reason the troops were needed.",33,68,Undersecretary of State for Defence,0,1,1
3ODOP6T3ASLQOC1NX64P4TYU0UJ423,"#15-13 Tomasz Szatkowski, Polish Undersecretary of State for Defence, noted ""large exercises"" by Russia near the Polish border as another reason the troops were needed.",77,92,large exercises,0,2,2
3ODOP6T3ASLQOC1NX64P4TYU0UJ423,"#15-13 Tomasz Szatkowski, Polish Undersecretary of State for Defence, noted ""large exercises"" by Russia near the Polish border as another reason the troops were needed.",83,92,exercises,1,2,3
3ODOP6T3ASLQOC1NX64P4TYU0UJ423,"#15-13 Tomasz Szatkowski, Polish Undersecretary of State for Defence, noted ""large exercises"" by Russia near the Polish border as another reason the troops were needed.",149,155,troops,0,2,2
3ODOP6T3ASLQOC1NX64P4TYU0UJ423,"#15-14 Szatkowski also mentioned Russian action in Ukraine, which he called ""aggressive actions in our vicinity"".",7,17,Szatkowski,0,1,1
3ODOP6T3ASLQOC1NX64P4TYU0UJ423,"#15-14 Szatkowski also mentioned Russian action in Ukraine, which he called ""aggressive actions in our vicinity"".",23,32,mentioned,2,1,3
3ODOP6T3ASLQOC1NX64P4TYU0UJ423,"#15-14 Szatkowski also mentioned Russian action in Ukraine, which he called ""aggressive actions in our vicinity"".",77,87,aggressive,5,5,10
3ODOP6T3ASLQOC1NX64P4TYU0UJ423,"#15-14 Szatkowski also mentioned Russian action in Ukraine, which he called ""aggressive actions in our vicinity"".",77,95,aggressive actions,1,0,1
3ODOP6T3ASLQOC1NX64P4TYU0UJ423,"#15-14 Szatkowski also mentioned Russian action in Ukraine, which he called ""aggressive actions in our vicinity"".",77,111,aggressive actions in our vicinity,1,1,2
3ODOP6T3ASLQOC1NX64P4TYU0UJ423,"#15-14 Szatkowski also mentioned Russian action in Ukraine, which he called ""aggressive actions in our vicinity"".",103,111,vicinity,6,10,16
3ODOP6T3ASLQOC1NX64P4TYU0UJ423,"#15-15 Russian Deputy Foreign Minister Alexei Mechkov, however, said the incoming troops and vehicles were a ""factor destabilising European security"".",15,21,Deputy,0,1,1
3ODOP6T3ASLQOC1NX64P4TYU0UJ423,"#15-15 Russian Deputy Foreign Minister Alexei Mechkov, however, said the incoming troops and vehicles were a ""factor destabilising European security"".",39,53,Alexei Mechkov,0,1,1
3ODOP6T3ASLQOC1NX64P4TYU0UJ423,"#15-15 Russian Deputy Foreign Minister Alexei Mechkov, however, said the incoming troops and vehicles were a ""factor destabilising European security"".",46,53,Mechkov,1,1,2
3ODOP6T3ASLQOC1NX64P4TYU0UJ423,"#15-15 Russian Deputy Foreign Minister Alexei Mechkov, however, said the incoming troops and vehicles were a ""factor destabilising European security"".",73,81,incoming,1,1,2
3ODOP6T3ASLQOC1NX64P4TYU0UJ423,"#15-15 Russian Deputy Foreign Minister Alexei Mechkov, however, said the incoming troops and vehicles were a ""factor destabilising European security"".",93,101,vehicles,1,1,2
3ODOP6T3ASLQOC1NX64P4TYU0UJ423,"#15-15 Russian Deputy Foreign Minister Alexei Mechkov, however, said the incoming troops and vehicles were a ""factor destabilising European security"".",110,148,factor destabilising European security,0,1,1
3ODOP6T3ASLQOC1NX64P4TYU0UJ423,"#15-15 Russian Deputy Foreign Minister Alexei Mechkov, however, said the incoming troops and vehicles were a ""factor destabilising European security"".",117,130,destabilising,10,8,18
3ODOP6T3ASLQOC1NX64P4TYU0UJ423,"#15-15 Russian Deputy Foreign Minister Alexei Mechkov, however, said the incoming troops and vehicles were a ""factor destabilising European security"".",117,148,destabilising European security,1,0,1
3O0M2G5VC631OWMMIFJ4EG6860T49V,"#28-9 His most recent stint behind bars came last month, when he was arrested for allegedly slamming his girlfriend's head into a refrigerator in the same home involved on Saturday.",15,27,recent stint,0,1,1
3O0M2G5VC631OWMMIFJ4EG6860T49V,"#28-9 His most recent stint behind bars came last month, when he was arrested for allegedly slamming his girlfriend's head into a refrigerator in the same home involved on Saturday.",22,27,stint,9,9,18
3O0M2G5VC631OWMMIFJ4EG6860T49V,"#28-9 His most recent stint behind bars came last month, when he was arrested for allegedly slamming his girlfriend's head into a refrigerator in the same home involved on Saturday.",69,77,arrested,3,2,5
3O0M2G5VC631OWMMIFJ4EG6860T49V,"#28-9 His most recent stint behind bars came last month, when he was arrested for allegedly slamming his girlfriend's head into a refrigerator in the same home involved on Saturday.",82,91,allegedly,10,7,17
3O0M2G5VC631OWMMIFJ4EG6860T49V,"#28-9 His most recent stint behind bars came last month, when he was arrested for allegedly slamming his girlfriend's head into a refrigerator in the same home involved on Saturday.",82,100,allegedly slamming,1,2,3
3O0M2G5VC631OWMMIFJ4EG6860T49V,"#28-9 His most recent stint behind bars came last month, when he was arrested for allegedly slamming his girlfriend's head into a refrigerator in the same home involved on Saturday.",92,100,slamming,3,8,11
3O0M2G5VC631OWMMIFJ4EG6860T49V,"#28-9 His most recent stint behind bars came last month, when he was arrested for allegedly slamming his girlfriend's head into a refrigerator in the same home involved on Saturday.",130,142,refrigerator,4,2,6
3O0M2G5VC631OWMMIFJ4EG6860T49V,"#28-9 His most recent stint behind bars came last month, when he was arrested for allegedly slamming his girlfriend's head into a refrigerator in the same home involved on Saturday.",160,168,involved,0,1,1
3O0M2G5VC631OWMMIFJ4EG6860T49V,"#28-10 At the time of the murders, Conley was wanted on an assault charge against a family member.",26,33,murders,0,1,1
3O0M2G5VC631OWMMIFJ4EG6860T49V,"#28-10 At the time of the murders, Conley was wanted on an assault charge against a family member.",59,66,assault,5,9,14
3O0M2G5VC631OWMMIFJ4EG6860T49V,"#28-10 At the time of the murders, Conley was wanted on an assault charge against a family member.",59,73,assault charge,1,2,3
3O0M2G5VC631OWMMIFJ4EG6860T49V,#28-11 All eight victims died at the scene.,17,24,victims,2,3,5
3O0M2G5VC631OWMMIFJ4EG6860T49V,#28-11 All eight victims died at the scene.,37,42,scene,0,1,1
3O0M2G5VC631OWMMIFJ4EG6860T49V,"#28-12 On Sunday, authorities released the names and ages of the victims: Valerie Jackson, 40, and Dwayne Jackson, her husband, 50; Nathaniel Jackson, 13; Honesty Jackson, 11; Dwayne Jackson, Jr., 10; Caleb Jackson, 9; Trinity Jackson, 7; and Jonah Jackson, 6.",18,29,authorities,5,4,9
3O0M2G5VC631OWMMIFJ4EG6860T49V,"#28-12 On Sunday, authorities released the names and ages of the victims: Valerie Jackson, 40, and Dwayne Jackson, her husband, 50; Nathaniel Jackson, 13; Honesty Jackson, 11; Dwayne Jackson, Jr., 10; Caleb Jackson, 9; Trinity Jackson, 7; and Jonah Jackson, 6.",30,38,released,1,2,3
3O0M2G5VC631OWMMIFJ4EG6860T49V,"#28-12 On Sunday, authorities released the names and ages of the victims: Valerie Jackson, 40, and Dwayne Jackson, her husband, 50; Nathaniel Jackson, 13; Honesty Jackson, 11; Dwayne Jackson, Jr., 10; Caleb Jackson, 9; Trinity Jackson, 7; and Jonah Jackson, 6.",99,105,Dwayne,1,0,1
3O0M2G5VC631OWMMIFJ4EG6860T49V,"#28-12 On Sunday, authorities released the names and ages of the victims: Valerie Jackson, 40, and Dwayne Jackson, her husband, 50; Nathaniel Jackson, 13; Honesty Jackson, 11; Dwayne Jackson, Jr., 10; Caleb Jackson, 9; Trinity Jackson, 7; and Jonah Jackson, 6.",155,162,Honesty,1,0,1
3O0M2G5VC631OWMMIFJ4EG6860T49V,#28-13 Conley was the father of Nathaniel (Nate) Jackson.,32,41,Nathaniel,1,0,1
3O0M2G5VC631OWMMIFJ4EG6860T49V,#28-14 Conley told investigators he used to live with Valerie Jackson and broke into the home after she had changed the locks.,19,32,investigators,7,5,12
3O0M2G5VC631OWMMIFJ4EG6860T49V,#28-14 Conley told investigators he used to live with Valerie Jackson and broke into the home after she had changed the locks.,54,61,Valerie,1,0,1
3O0M2G5VC631OWMMIFJ4EG6860T49V,#28-14 Conley told investigators he used to live with Valerie Jackson and broke into the home after she had changed the locks.,74,79,broke,0,1,1
37J05LC5AXK3U4IOX2BA6EEHFIYJDI,"#39-16 ""We are truly sorry about [the] tragedy"" they told us in a statement.",39,46,tragedy,10,8,18
37J05LC5AXK3U4IOX2BA6EEHFIYJDI,"#39-16 ""We are truly sorry about [the] tragedy"" they told us in a statement.",64,75,a statement,0,1,1
37J05LC5AXK3U4IOX2BA6EEHFIYJDI,"#39-16 ""We are truly sorry about [the] tragedy"" they told us in a statement.",66,75,statement,0,4,4
37J05LC5AXK3U4IOX2BA6EEHFIYJDI,#39-17 They said they have checked GPS trackers on their fleet and all their vehicles remain in Slovakia.,27,34,checked,0,2,2
37J05LC5AXK3U4IOX2BA6EEHFIYJDI,#39-17 They said they have checked GPS trackers on their fleet and all their vehicles remain in Slovakia.,35,47,GPS trackers,0,1,1
37J05LC5AXK3U4IOX2BA6EEHFIYJDI,#39-17 They said they have checked GPS trackers on their fleet and all their vehicles remain in Slovakia.,39,47,trackers,1,2,3
37J05LC5AXK3U4IOX2BA6EEHFIYJDI,#39-17 They said they have checked GPS trackers on their fleet and all their vehicles remain in Slovakia.,57,62,fleet,1,3,4
37J05LC5AXK3U4IOX2BA6EEHFIYJDI,#39-17 They said they have checked GPS trackers on their fleet and all their vehicles remain in Slovakia.,77,85,vehicles,1,0,1
37J05LC5AXK3U4IOX2BA6EEHFIYJDI,#39-17 They said they have checked GPS trackers on their fleet and all their vehicles remain in Slovakia.,96,104,Slovakia,2,1,3
37J05LC5AXK3U4IOX2BA6EEHFIYJDI,#39-18 The statement says the lorry in question was one of 21 Hyza vehicles sold on last year.,11,20,statement,1,0,1
37J05LC5AXK3U4IOX2BA6EEHFIYJDI,#39-18 The statement says the lorry in question was one of 21 Hyza vehicles sold on last year.,30,35,lorry,7,3,10
37J05LC5AXK3U4IOX2BA6EEHFIYJDI,#39-18 The statement says the lorry in question was one of 21 Hyza vehicles sold on last year.,62,66,Hyza,1,1,2
37J05LC5AXK3U4IOX2BA6EEHFIYJDI,#39-18 The statement says the lorry in question was one of 21 Hyza vehicles sold on last year.,62,75,Hyza vehicles,1,0,1
37J05LC5AXK3U4IOX2BA6EEHFIYJDI,"#39-19 It was then sold again and exported to Hungary, where it is now registered.",34,42,exported,5,2,7
37J05LC5AXK3U4IOX2BA6EEHFIYJDI,"#39-19 It was then sold again and exported to Hungary, where it is now registered.",71,81,registered,4,3,7
37J05LC5AXK3U4IOX2BA6EEHFIYJDI,#39-20 Hyza told us the new owners have not changed the branding on the vehicle.,52,64,the branding,0,1,1
37J05LC5AXK3U4IOX2BA6EEHFIYJDI,#39-20 Hyza told us the new owners have not changed the branding on the vehicle.,56,64,branding,1,4,5
37J05LC5AXK3U4IOX2BA6EEHFIYJDI,"#39-21 According to the Bild newspaper, Agrofert -- the parent company of Hyza -- said in a statement the new owners were required to do so.",24,28,Bild,1,1,2
37J05LC5AXK3U4IOX2BA6EEHFIYJDI,"#39-21 According to the Bild newspaper, Agrofert -- the parent company of Hyza -- said in a statement the new owners were required to do so.",24,38,Bild newspaper,1,0,1
37J05LC5AXK3U4IOX2BA6EEHFIYJDI,"#39-21 According to the Bild newspaper, Agrofert -- the parent company of Hyza -- said in a statement the new owners were required to do so.",40,48,Agrofert,3,0,3
37J05LC5AXK3U4IOX2BA6EEHFIYJDI,"#39-21 According to the Bild newspaper, Agrofert -- the parent company of Hyza -- said in a statement the new owners were required to do so.",56,62,parent,0,1,1
37J05LC5AXK3U4IOX2BA6EEHFIYJDI,"#39-21 According to the Bild newspaper, Agrofert -- the parent company of Hyza -- said in a statement the new owners were required to do so.",92,101,statement,1,0,1
37J05LC5AXK3U4IOX2BA6EEHFIYJDI,"#39-21 According to the Bild newspaper, Agrofert -- the parent company of Hyza -- said in a statement the new owners were required to do so.",110,116,owners,0,1,1
37J05LC5AXK3U4IOX2BA6EEHFIYJDI,"#39-21 According to the Bild newspaper, Agrofert -- the parent company of Hyza -- said in a statement the new owners were required to do so.",122,130,required,0,2,2
37J05LC5AXK3U4IOX2BA6EEHFIYJDI,"#39-22 Hyza says they will ""actively cooperate with Slovak police"", and ""express [their] sincere condolences to the bereaved families.""",37,46,cooperate,3,1,4
37J05LC5AXK3U4IOX2BA6EEHFIYJDI,"#39-22 Hyza says they will ""actively cooperate with Slovak police"", and ""express [their] sincere condolences to the bereaved families.""",52,58,Slovak,0,1,1
37J05LC5AXK3U4IOX2BA6EEHFIYJDI,"#39-22 Hyza says they will ""actively cooperate with Slovak police"", and ""express [their] sincere condolences to the bereaved families.""",73,80,express,0,2,2
37J05LC5AXK3U4IOX2BA6EEHFIYJDI,"#39-22 Hyza says they will ""actively cooperate with Slovak police"", and ""express [their] sincere condolences to the bereaved families.""",89,96,sincere,1,0,1
37J05LC5AXK3U4IOX2BA6EEHFIYJDI,"#39-22 Hyza says they will ""actively cooperate with Slovak police"", and ""express [their] sincere condolences to the bereaved families.""",97,108,condolences,10,8,18
37J05LC5AXK3U4IOX2BA6EEHFIYJDI,"#39-22 Hyza says they will ""actively cooperate with Slovak police"", and ""express [their] sincere condolences to the bereaved families.""",97,124,condolences to the bereaved,1,0,1
37J05LC5AXK3U4IOX2BA6EEHFIYJDI,"#39-22 Hyza says they will ""actively cooperate with Slovak police"", and ""express [their] sincere condolences to the bereaved families.""",116,124,bereaved,10,10,20
37J05LC5AXK3U4IOX2BA6EEHFIYJDI,"#39-23 Interior Minister Johanna Mikl-Leitner called it ""a dark day"" and called for European Union-wide measures to protect immigrant refugees and tackle human traffickers.",7,15,Interior,0,1,1
37J05LC5AXK3U4IOX2BA6EEHFIYJDI,"#39-23 Interior Minister Johanna Mikl-Leitner called it ""a dark day"" and called for European Union-wide measures to protect immigrant refugees and tackle human traffickers.",7,24,Interior Minister,1,1,2
37J05LC5AXK3U4IOX2BA6EEHFIYJDI,"#39-23 Interior Minister Johanna Mikl-Leitner called it ""a dark day"" and called for European Union-wide measures to protect immigrant refugees and tackle human traffickers.",25,32,Johanna,0,1,1
37J05LC5AXK3U4IOX2BA6EEHFIYJDI,"#39-23 Interior Minister Johanna Mikl-Leitner called it ""a dark day"" and called for European Union-wide measures to protect immigrant refugees and tackle human traffickers.",33,45,Mikl-Leitner,0,1,1
37J05LC5AXK3U4IOX2BA6EEHFIYJDI,"#39-23 Interior Minister Johanna Mikl-Leitner called it ""a dark day"" and called for European Union-wide measures to protect immigrant refugees and tackle human traffickers.",93,103,Union-wide,1,0,1
37J05LC5AXK3U4IOX2BA6EEHFIYJDI,"#39-23 Interior Minister Johanna Mikl-Leitner called it ""a dark day"" and called for European Union-wide measures to protect immigrant refugees and tackle human traffickers.",104,112,measures,0,1,1
37J05LC5AXK3U4IOX2BA6EEHFIYJDI,"#39-23 Interior Minister Johanna Mikl-Leitner called it ""a dark day"" and called for European Union-wide measures to protect immigrant refugees and tackle human traffickers.",124,133,immigrant,4,5,9
37J05LC5AXK3U4IOX2BA6EEHFIYJDI,"#39-23 Interior Minister Johanna Mikl-Leitner called it ""a dark day"" and called for European Union-wide measures to protect immigrant refugees and tackle human traffickers.",124,142,immigrant refugees,1,2,3
37J05LC5AXK3U4IOX2BA6EEHFIYJDI,"#39-23 Interior Minister Johanna Mikl-Leitner called it ""a dark day"" and called for European Union-wide measures to protect immigrant refugees and tackle human traffickers.",134,142,refugees,5,3,8
37J05LC5AXK3U4IOX2BA6EEHFIYJDI,"#39-23 Interior Minister Johanna Mikl-Leitner called it ""a dark day"" and called for European Union-wide measures to protect immigrant refugees and tackle human traffickers.",147,153,tackle,2,6,8
37J05LC5AXK3U4IOX2BA6EEHFIYJDI,"#39-23 Interior Minister Johanna Mikl-Leitner called it ""a dark day"" and called for European Union-wide measures to protect immigrant refugees and tackle human traffickers.",154,171,human traffickers,2,0,2
37J05LC5AXK3U4IOX2BA6EEHFIYJDI,"#39-23 Interior Minister Johanna Mikl-Leitner called it ""a dark day"" and called for European Union-wide measures to protect immigrant refugees and tackle human traffickers.",160,171,traffickers,7,8,15
344M16OZKIG450N98VEM53DJOE4ENA,"#36-1 IndyCar driver Justin Wilson dies aged 37 Yesterday, 37-year old IndyCar Series driver Justin Wilson died of injuries sustained on Sunday during the ABC Supply 500 at Pocono Raceway.",48,57,Yesterday,1,0,1
344M16OZKIG450N98VEM53DJOE4ENA,"#36-1 IndyCar driver Justin Wilson dies aged 37 Yesterday, 37-year old IndyCar Series driver Justin Wilson died of injuries sustained on Sunday during the ABC Supply 500 at Pocono Raceway.",71,78,IndyCar,1,1,2
344M16OZKIG450N98VEM53DJOE4ENA,"#36-1 IndyCar driver Justin Wilson dies aged 37 Yesterday, 37-year old IndyCar Series driver Justin Wilson died of injuries sustained on Sunday during the ABC Supply 500 at Pocono Raceway.",115,123,injuries,4,0,4
344M16OZKIG450N98VEM53DJOE4ENA,"#36-1 IndyCar driver Justin Wilson dies aged 37 Yesterday, 37-year old IndyCar Series driver Justin Wilson died of injuries sustained on Sunday during the ABC Supply 500 at Pocono Raceway.",124,133,sustained,10,8,18
344M16OZKIG450N98VEM53DJOE4ENA,"#36-1 IndyCar driver Justin Wilson dies aged 37 Yesterday, 37-year old IndyCar Series driver Justin Wilson died of injuries sustained on Sunday during the ABC Supply 500 at Pocono Raceway.",173,179,Pocono,1,0,1
344M16OZKIG450N98VEM53DJOE4ENA,"#36-2 With about twenty laps remaining in the race, Sage Karam, who had been leading the event, crashed into the turn 1 wall.",17,28,twenty laps,0,1,1
344M16OZKIG450N98VEM53DJOE4ENA,"#36-2 With about twenty laps remaining in the race, Sage Karam, who had been leading the event, crashed into the turn 1 wall.",24,28,laps,0,3,3
344M16OZKIG450N98VEM53DJOE4ENA,"#36-2 With about twenty laps remaining in the race, Sage Karam, who had been leading the event, crashed into the turn 1 wall.",29,38,remaining,1,0,1
344M16OZKIG450N98VEM53DJOE4ENA,"#36-2 With about twenty laps remaining in the race, Sage Karam, who had been leading the event, crashed into the turn 1 wall.",77,84,leading,0,1,1
344M16OZKIG450N98VEM53DJOE4ENA,"#36-2 With about twenty laps remaining in the race, Sage Karam, who had been leading the event, crashed into the turn 1 wall.",96,103,crashed,0,3,3
344M16OZKIG450N98VEM53DJOE4ENA,"#36-3 As Wilson approached the site of the crash, reportedly the nose cone from Karam's car that had been airborne struck Wilson in the helmet; Wilson's car steered to the left and collided with the inside SAFER barrier.",16,26,approached,5,3,8
344M16OZKIG450N98VEM53DJOE4ENA,"#36-3 As Wilson approached the site of the crash, reportedly the nose cone from Karam's car that had been airborne struck Wilson in the helmet; Wilson's car steered to the left and collided with the inside SAFER barrier.",31,35,site,0,1,1
344M16OZKIG450N98VEM53DJOE4ENA,"#36-3 As Wilson approached the site of the crash, reportedly the nose cone from Karam's car that had been airborne struck Wilson in the helmet; Wilson's car steered to the left and collided with the inside SAFER barrier.",43,48,crash,0,1,1
344M16OZKIG450N98VEM53DJOE4ENA,"#36-3 As Wilson approached the site of the crash, reportedly the nose cone from Karam's car that had been airborne struck Wilson in the helmet; Wilson's car steered to the left and collided with the inside SAFER barrier.",50,60,reportedly,2,2,4
344M16OZKIG450N98VEM53DJOE4ENA,"#36-3 As Wilson approached the site of the crash, reportedly the nose cone from Karam's car that had been airborne struck Wilson in the helmet; Wilson's car steered to the left and collided with the inside SAFER barrier.",65,74,nose cone,0,1,1
344M16OZKIG450N98VEM53DJOE4ENA,"#36-3 As Wilson approached the site of the crash, reportedly the nose cone from Karam's car that had been airborne struck Wilson in the helmet; Wilson's car steered to the left and collided with the inside SAFER barrier.",70,74,cone,0,1,1
344M16OZKIG450N98VEM53DJOE4ENA,"#36-3 As Wilson approached the site of the crash, reportedly the nose cone from Karam's car that had been airborne struck Wilson in the helmet; Wilson's car steered to the left and collided with the inside SAFER barrier.",106,114,airborne,6,7,13
344M16OZKIG450N98VEM53DJOE4ENA,"#36-3 As Wilson approached the site of the crash, reportedly the nose cone from Karam's car that had been airborne struck Wilson in the helmet; Wilson's car steered to the left and collided with the inside SAFER barrier.",115,121,struck,0,1,1
344M16OZKIG450N98VEM53DJOE4ENA,"#36-3 As Wilson approached the site of the crash, reportedly the nose cone from Karam's car that had been airborne struck Wilson in the helmet; Wilson's car steered to the left and collided with the inside SAFER barrier.",136,142,helmet,1,0,1
344M16OZKIG450N98VEM53DJOE4ENA,"#36-3 As Wilson approached the site of the crash, reportedly the nose cone from Karam's car that had been airborne struck Wilson in the helmet; Wilson's car steered to the left and collided with the inside SAFER barrier.",157,164,steered,4,9,13
344M16OZKIG450N98VEM53DJOE4ENA,"#36-3 As Wilson approached the site of the crash, reportedly the nose cone from Karam's car that had been airborne struck Wilson in the helmet; Wilson's car steered to the left and collided with the inside SAFER barrier.",181,189,collided,8,5,13
344M16OZKIG450N98VEM53DJOE4ENA,"#36-3 As Wilson approached the site of the crash, reportedly the nose cone from Karam's car that had been airborne struck Wilson in the helmet; Wilson's car steered to the left and collided with the inside SAFER barrier.",212,219,barrier,3,4,7
344M16OZKIG450N98VEM53DJOE4ENA,#36-4 The event was placed under the caution flag as safety workers extracted Wilson from his car.,37,44,caution,3,0,3
344M16OZKIG450N98VEM53DJOE4ENA,#36-4 The event was placed under the caution flag as safety workers extracted Wilson from his car.,37,49,caution flag,1,2,3
344M16OZKIG450N98VEM53DJOE4ENA,#36-4 The event was placed under the caution flag as safety workers extracted Wilson from his car.,68,77,extracted,10,7,17
344M16OZKIG450N98VEM53DJOE4ENA,"#36-5 Wilson was airlifted to Lehigh Valley Hospital in Allentown, Pennsylvania.",17,26,airlifted,7,8,15
344M16OZKIG450N98VEM53DJOE4ENA,"#36-6 At 9 P.M. EST, INDYCAR released a statement, announcing that Wilson had suffered a severe head injury, was in critical condition and had fallen into a coma.",29,49,released a statement,1,0,1
344M16OZKIG450N98VEM53DJOE4ENA,"#36-6 At 9 P.M. EST, INDYCAR released a statement, announcing that Wilson had suffered a severe head injury, was in critical condition and had fallen into a coma.",40,49,statement,0,1,1
344M16OZKIG450N98VEM53DJOE4ENA,"#36-6 At 9 P.M. EST, INDYCAR released a statement, announcing that Wilson had suffered a severe head injury, was in critical condition and had fallen into a coma.",40,61,"statement, announcing",1,0,1
344M16OZKIG450N98VEM53DJOE4ENA,"#36-6 At 9 P.M. EST, INDYCAR released a statement, announcing that Wilson had suffered a severe head injury, was in critical condition and had fallen into a coma.",51,61,announcing,2,1,3
344M16OZKIG450N98VEM53DJOE4ENA,"#36-6 At 9 P.M. EST, INDYCAR released a statement, announcing that Wilson had suffered a severe head injury, was in critical condition and had fallen into a coma.",78,86,suffered,3,1,4
344M16OZKIG450N98VEM53DJOE4ENA,"#36-6 At 9 P.M. EST, INDYCAR released a statement, announcing that Wilson had suffered a severe head injury, was in critical condition and had fallen into a coma.",89,95,severe,5,0,5
344M16OZKIG450N98VEM53DJOE4ENA,"#36-6 At 9 P.M. EST, INDYCAR released a statement, announcing that Wilson had suffered a severe head injury, was in critical condition and had fallen into a coma.",116,124,critical,4,0,4
344M16OZKIG450N98VEM53DJOE4ENA,"#36-6 At 9 P.M. EST, INDYCAR released a statement, announcing that Wilson had suffered a severe head injury, was in critical condition and had fallen into a coma.",116,134,critical condition,2,0,2
344M16OZKIG450N98VEM53DJOE4ENA,"#36-6 At 9 P.M. EST, INDYCAR released a statement, announcing that Wilson had suffered a severe head injury, was in critical condition and had fallen into a coma.",125,134,condition,1,0,1
344M16OZKIG450N98VEM53DJOE4ENA,"#36-6 At 9 P.M. EST, INDYCAR released a statement, announcing that Wilson had suffered a severe head injury, was in critical condition and had fallen into a coma.",139,154,had fallen into,0,1,1
344M16OZKIG450N98VEM53DJOE4ENA,"#36-6 At 9 P.M. EST, INDYCAR released a statement, announcing that Wilson had suffered a severe head injury, was in critical condition and had fallen into a coma.",157,161,coma,3,5,8
374UMBUHN5QN3F8F90U3OEJ8SKCTCW,"#26-7 Initially, all three were considered victims, but the status of one has been changed to suspect.",6,15,Initially,7,2,9
374UMBUHN5QN3F8F90U3OEJ8SKCTCW,"#26-7 Initially, all three were considered victims, but the status of one has been changed to suspect.",32,42,considered,3,3,6
374UMBUHN5QN3F8F90U3OEJ8SKCTCW,"#26-7 Initially, all three were considered victims, but the status of one has been changed to suspect.",43,50,victims,4,2,6
374UMBUHN5QN3F8F90U3OEJ8SKCTCW,"#26-7 Initially, all three were considered victims, but the status of one has been changed to suspect.",60,66,status,4,1,5
374UMBUHN5QN3F8F90U3OEJ8SKCTCW,"#26-7 Initially, all three were considered victims, but the status of one has been changed to suspect.",83,90,changed,0,2,2
374UMBUHN5QN3F8F90U3OEJ8SKCTCW,"#26-7 Initially, all three were considered victims, but the status of one has been changed to suspect.",94,101,suspect,3,3,6
374UMBUHN5QN3F8F90U3OEJ8SKCTCW,"#26-8 The other two, a man and a woman, subsequently died from their wounds.",40,52,subsequently,10,9,19
374UMBUHN5QN3F8F90U3OEJ8SKCTCW,"#26-8 The other two, a man and a woman, subsequently died from their wounds.",69,75,wounds,2,1,3
374UMBUHN5QN3F8F90U3OEJ8SKCTCW,#26-9 Police have said CCTV is helping in the investigation.,23,27,CCTV,1,0,1
374UMBUHN5QN3F8F90U3OEJ8SKCTCW,#26-9 Police have said CCTV is helping in the investigation.,46,59,investigation,6,5,11
374UMBUHN5QN3F8F90U3OEJ8SKCTCW,#26-10 Local newspaper Vestmanlands Läns Tidning (VLT) has reportedly posted footage of one of the suspects being tackled by police.,7,53,Local newspaper Vestmanlands Läns Tidning (VLT,1,0,1
374UMBUHN5QN3F8F90U3OEJ8SKCTCW,#26-10 Local newspaper Vestmanlands Läns Tidning (VLT) has reportedly posted footage of one of the suspects being tackled by police.,13,22,newspaper,1,0,1
374UMBUHN5QN3F8F90U3OEJ8SKCTCW,#26-10 Local newspaper Vestmanlands Läns Tidning (VLT) has reportedly posted footage of one of the suspects being tackled by police.,23,48,Vestmanlands Läns Tidning,1,1,2
374UMBUHN5QN3F8F90U3OEJ8SKCTCW,#26-10 Local newspaper Vestmanlands Läns Tidning (VLT) has reportedly posted footage of one of the suspects being tackled by police.,59,69,reportedly,1,3,4
374UMBUHN5QN3F8F90U3OEJ8SKCTCW,#26-10 Local newspaper Vestmanlands Läns Tidning (VLT) has reportedly posted footage of one of the suspects being tackled by police.,77,84,footage,4,4,8
374UMBUHN5QN3F8F90U3OEJ8SKCTCW,#26-10 Local newspaper Vestmanlands Läns Tidning (VLT) has reportedly posted footage of one of the suspects being tackled by police.,99,107,suspects,2,1,3
374UMBUHN5QN3F8F90U3OEJ8SKCTCW,#26-10 Local newspaper Vestmanlands Läns Tidning (VLT) has reportedly posted footage of one of the suspects being tackled by police.,114,121,tackled,8,9,17
374UMBUHN5QN3F8F90U3OEJ8SKCTCW,"#26-11 VLT has further claimed to have identified the two victims as a mother and son, aged 55 and 28 respectively.",23,30,claimed,1,0,1
374UMBUHN5QN3F8F90U3OEJ8SKCTCW,"#26-11 VLT has further claimed to have identified the two victims as a mother and son, aged 55 and 28 respectively.",39,49,identified,3,0,3
374UMBUHN5QN3F8F90U3OEJ8SKCTCW,"#26-11 VLT has further claimed to have identified the two victims as a mother and son, aged 55 and 28 respectively.",102,114,respectively,10,2,12
374UMBUHN5QN3F8F90U3OEJ8SKCTCW,"#26-12 According to the paper, the victims were not local residents, but did have a connection with Västerås, where they were vacationing at the time of the attack, which a police spokesperson has called ""an act of madness""((sv)).",35,42,victims,0,1,1
374UMBUHN5QN3F8F90U3OEJ8SKCTCW,"#26-12 According to the paper, the victims were not local residents, but did have a connection with Västerås, where they were vacationing at the time of the attack, which a police spokesperson has called ""an act of madness""((sv)).",58,67,residents,1,1,2
374UMBUHN5QN3F8F90U3OEJ8SKCTCW,"#26-12 According to the paper, the victims were not local residents, but did have a connection with Västerås, where they were vacationing at the time of the attack, which a police spokesperson has called ""an act of madness""((sv)).",84,94,connection,1,0,1
374UMBUHN5QN3F8F90U3OEJ8SKCTCW,"#26-12 According to the paper, the victims were not local residents, but did have a connection with Västerås, where they were vacationing at the time of the attack, which a police spokesperson has called ""an act of madness""((sv)).",100,108,Västerås,1,1,2
374UMBUHN5QN3F8F90U3OEJ8SKCTCW,"#26-12 According to the paper, the victims were not local residents, but did have a connection with Västerås, where they were vacationing at the time of the attack, which a police spokesperson has called ""an act of madness""((sv)).",126,137,vacationing,9,8,17
374UMBUHN5QN3F8F90U3OEJ8SKCTCW,"#26-12 According to the paper, the victims were not local residents, but did have a connection with Västerås, where they were vacationing at the time of the attack, which a police spokesperson has called ""an act of madness""((sv)).",180,192,spokesperson,6,5,11
374UMBUHN5QN3F8F90U3OEJ8SKCTCW,"#26-12 According to the paper, the victims were not local residents, but did have a connection with Västerås, where they were vacationing at the time of the attack, which a police spokesperson has called ""an act of madness""((sv)).",205,222,an act of madness,1,0,1
374UMBUHN5QN3F8F90U3OEJ8SKCTCW,"#26-12 According to the paper, the victims were not local residents, but did have a connection with Västerås, where they were vacationing at the time of the attack, which a police spokesperson has called ""an act of madness""((sv)).",208,222,act of madness,0,1,1
374UMBUHN5QN3F8F90U3OEJ8SKCTCW,"#26-12 According to the paper, the victims were not local residents, but did have a connection with Västerås, where they were vacationing at the time of the attack, which a police spokesperson has called ""an act of madness""((sv)).",215,222,madness,2,0,2
374UMBUHN5QN3F8F90U3OEJ8SKCTCW,"#26-13 ""This is the worst working day of my life""((sv)), said Mattias Johansson, the store manager of IKEA in Västerås, to Sveriges Television.",20,25,worst,1,2,3
374UMBUHN5QN3F8F90U3OEJ8SKCTCW,"#26-13 ""This is the worst working day of my life""((sv)), said Mattias Johansson, the store manager of IKEA in Västerås, to Sveriges Television.",62,69,Mattias,1,0,1
374UMBUHN5QN3F8F90U3OEJ8SKCTCW,"#26-13 ""This is the worst working day of my life""((sv)), said Mattias Johansson, the store manager of IKEA in Västerås, to Sveriges Television.",62,79,Mattias Johansson,0,1,1
374UMBUHN5QN3F8F90U3OEJ8SKCTCW,"#26-13 ""This is the worst working day of my life""((sv)), said Mattias Johansson, the store manager of IKEA in Västerås, to Sveriges Television.",110,118,Västerås,1,0,1
374UMBUHN5QN3F8F90U3OEJ8SKCTCW,"#26-13 ""This is the worst working day of my life""((sv)), said Mattias Johansson, the store manager of IKEA in Västerås, to Sveriges Television.",123,131,Sveriges,1,1,2
301KG0KX9CMK0OPICDO8YI7Y5Z5H22,"#15-25 Within a week of the Law and Justice Party coming to power in Poland, it removed web pages featuring the results of an investigation into the Smolensk air disaster in Russia in 2010.",28,49,Law and Justice Party,1,0,1
301KG0KX9CMK0OPICDO8YI7Y5Z5H22,"#15-25 Within a week of the Law and Justice Party coming to power in Poland, it removed web pages featuring the results of an investigation into the Smolensk air disaster in Russia in 2010.",80,87,removed,0,1,1
301KG0KX9CMK0OPICDO8YI7Y5Z5H22,"#15-25 Within a week of the Law and Justice Party coming to power in Poland, it removed web pages featuring the results of an investigation into the Smolensk air disaster in Russia in 2010.",88,91,web,0,1,1
301KG0KX9CMK0OPICDO8YI7Y5Z5H22,"#15-25 Within a week of the Law and Justice Party coming to power in Poland, it removed web pages featuring the results of an investigation into the Smolensk air disaster in Russia in 2010.",98,107,featuring,3,5,8
301KG0KX9CMK0OPICDO8YI7Y5Z5H22,"#15-25 Within a week of the Law and Justice Party coming to power in Poland, it removed web pages featuring the results of an investigation into the Smolensk air disaster in Russia in 2010.",126,139,investigation,5,6,11
301KG0KX9CMK0OPICDO8YI7Y5Z5H22,"#15-25 Within a week of the Law and Justice Party coming to power in Poland, it removed web pages featuring the results of an investigation into the Smolensk air disaster in Russia in 2010.",149,157,Smolensk,2,1,3
301KG0KX9CMK0OPICDO8YI7Y5Z5H22,"#15-25 Within a week of the Law and Justice Party coming to power in Poland, it removed web pages featuring the results of an investigation into the Smolensk air disaster in Russia in 2010.",149,170,Smolensk air disaster,3,0,3
301KG0KX9CMK0OPICDO8YI7Y5Z5H22,"#15-25 Within a week of the Law and Justice Party coming to power in Poland, it removed web pages featuring the results of an investigation into the Smolensk air disaster in Russia in 2010.",158,161,air,1,0,1
301KG0KX9CMK0OPICDO8YI7Y5Z5H22,"#15-25 Within a week of the Law and Justice Party coming to power in Poland, it removed web pages featuring the results of an investigation into the Smolensk air disaster in Russia in 2010.",162,170,disaster,2,8,10
301KG0KX9CMK0OPICDO8YI7Y5Z5H22,"#15-26 The cause of the crash, which killed dignitaries including Polish President Lech Kaczynski, is disputed.",44,55,dignitaries,10,10,20
301KG0KX9CMK0OPICDO8YI7Y5Z5H22,"#15-26 The cause of the crash, which killed dignitaries including Polish President Lech Kaczynski, is disputed.",88,97,Kaczynski,1,1,2
301KG0KX9CMK0OPICDO8YI7Y5Z5H22,"#15-26 The cause of the crash, which killed dignitaries including Polish President Lech Kaczynski, is disputed.",102,110,disputed,5,8,13
301KG0KX9CMK0OPICDO8YI7Y5Z5H22,#15-27 A Polish probe concluded the Polish pilots put safety second in their determination to get their passengers through dense fog.,16,21,probe,3,1,4
301KG0KX9CMK0OPICDO8YI7Y5Z5H22,#15-27 A Polish probe concluded the Polish pilots put safety second in their determination to get their passengers through dense fog.,22,31,concluded,2,1,3
301KG0KX9CMK0OPICDO8YI7Y5Z5H22,#15-27 A Polish probe concluded the Polish pilots put safety second in their determination to get their passengers through dense fog.,43,49,pilots,2,0,2
301KG0KX9CMK0OPICDO8YI7Y5Z5H22,#15-27 A Polish probe concluded the Polish pilots put safety second in their determination to get their passengers through dense fog.,77,90,determination,8,7,15
301KG0KX9CMK0OPICDO8YI7Y5Z5H22,#15-27 A Polish probe concluded the Polish pilots put safety second in their determination to get their passengers through dense fog.,123,128,dense,3,2,5
301KG0KX9CMK0OPICDO8YI7Y5Z5H22,#15-27 A Polish probe concluded the Polish pilots put safety second in their determination to get their passengers through dense fog.,123,132,dense fog,0,2,2
301KG0KX9CMK0OPICDO8YI7Y5Z5H22,#15-27 A Polish probe concluded the Polish pilots put safety second in their determination to get their passengers through dense fog.,129,132,fog,0,1,1
301KG0KX9CMK0OPICDO8YI7Y5Z5H22,#15-28 It also placed blame on Russian controllers for failing to divert the aircraft.,22,27,blame,0,4,4
301KG0KX9CMK0OPICDO8YI7Y5Z5H22,#15-28 It also placed blame on Russian controllers for failing to divert the aircraft.,31,50,Russian controllers,1,1,2
301KG0KX9CMK0OPICDO8YI7Y5Z5H22,#15-28 It also placed blame on Russian controllers for failing to divert the aircraft.,55,62,failing,0,2,2
301KG0KX9CMK0OPICDO8YI7Y5Z5H22,#15-28 It also placed blame on Russian controllers for failing to divert the aircraft.,55,72,failing to divert,0,1,1
301KG0KX9CMK0OPICDO8YI7Y5Z5H22,#15-28 It also placed blame on Russian controllers for failing to divert the aircraft.,66,72,divert,2,5,7
301KG0KX9CMK0OPICDO8YI7Y5Z5H22,#15-29 Russian investigators blamed the pilots alone.,15,28,investigators,2,0,2
301KG0KX9CMK0OPICDO8YI7Y5Z5H22,#15-29 Russian investigators blamed the pilots alone.,29,35,blamed,0,2,2
301KG0KX9CMK0OPICDO8YI7Y5Z5H22,#15-29 Russian investigators blamed the pilots alone.,40,46,pilots,1,0,1
301KG0KX9CMK0OPICDO8YI7Y5Z5H22,"#15-30 The flight was carrying high-profile political figures to attend a ceremony commemorating the 70th anniversary of the Katyn massacre, when thousands of Polish prisoners of war and civilians were killed by the Soviets.",31,43,high-profile,2,3,5
301KG0KX9CMK0OPICDO8YI7Y5Z5H22,"#15-30 The flight was carrying high-profile political figures to attend a ceremony commemorating the 70th anniversary of the Katyn massacre, when thousands of Polish prisoners of war and civilians were killed by the Soviets.",31,61,high-profile political figures,1,1,2
301KG0KX9CMK0OPICDO8YI7Y5Z5H22,"#15-30 The flight was carrying high-profile political figures to attend a ceremony commemorating the 70th anniversary of the Katyn massacre, when thousands of Polish prisoners of war and civilians were killed by the Soviets.",44,53,political,0,1,1
301KG0KX9CMK0OPICDO8YI7Y5Z5H22,"#15-30 The flight was carrying high-profile political figures to attend a ceremony commemorating the 70th anniversary of the Katyn massacre, when thousands of Polish prisoners of war and civilians were killed by the Soviets.",74,82,ceremony,1,1,2
301KG0KX9CMK0OPICDO8YI7Y5Z5H22,"#15-30 The flight was carrying high-profile political figures to attend a ceremony commemorating the 70th anniversary of the Katyn massacre, when thousands of Polish prisoners of war and civilians were killed by the Soviets.",83,96,commemorating,10,9,19
301KG0KX9CMK0OPICDO8YI7Y5Z5H22,"#15-30 The flight was carrying high-profile political figures to attend a ceremony commemorating the 70th anniversary of the Katyn massacre, when thousands of Polish prisoners of war and civilians were killed by the Soviets.",106,117,anniversary,1,0,1
301KG0KX9CMK0OPICDO8YI7Y5Z5H22,"#15-30 The flight was carrying high-profile political figures to attend a ceremony commemorating the 70th anniversary of the Katyn massacre, when thousands of Polish prisoners of war and civilians were killed by the Soviets.",125,130,Katyn,0,1,1
301KG0KX9CMK0OPICDO8YI7Y5Z5H22,"#15-30 The flight was carrying high-profile political figures to attend a ceremony commemorating the 70th anniversary of the Katyn massacre, when thousands of Polish prisoners of war and civilians were killed by the Soviets.",131,139,massacre,8,5,13
301KG0KX9CMK0OPICDO8YI7Y5Z5H22,"#15-30 The flight was carrying high-profile political figures to attend a ceremony commemorating the 70th anniversary of the Katyn massacre, when thousands of Polish prisoners of war and civilians were killed by the Soviets.",187,196,civilians,2,0,2
301KG0KX9CMK0OPICDO8YI7Y5Z5H22,"#15-30 The flight was carrying high-profile political figures to attend a ceremony commemorating the 70th anniversary of the Katyn massacre, when thousands of Polish prisoners of war and civilians were killed by the Soviets.",216,223,Soviets,1,0,1
