3P7RGTLO6EE07HLUVDKKHS6O7CCKA5,"The barren islands, reefs and coral outcrops are believed to be in rich in oil and gas and the overlapping claims have long been feared as Asia's next flashpoint for armed conflict.",4,10,barren,8,4.1,12
3P7RGTLO6EE07HLUVDKKHS6O7CCKA5,"The barren islands, reefs and coral outcrops are believed to be in rich in oil and gas and the overlapping claims have long been feared as Asia's next flashpoint for armed conflict.",4,18,barren islands,1,2,3
3P7RGTLO6EE07HLUVDKKHS6O7CCKA5,"The barren islands, reefs and coral outcrops are believed to be in rich in oil and gas and the overlapping claims have long been feared as Asia's next flashpoint for armed conflict.",20,25,reefs,2,4,6
3P7RGTLO6EE07HLUVDKKHS6O7CCKA5,"The barren islands, reefs and coral outcrops are believed to be in rich in oil and gas and the overlapping claims have long been feared as Asia's next flashpoint for armed conflict.",30,35,coral,1,0,1
3P7RGTLO6EE07HLUVDKKHS6O7CCKA5,"The barren islands, reefs and coral outcrops are believed to be in rich in oil and gas and the overlapping claims have long been feared as Asia's next flashpoint for armed conflict.",30,44,coral outcrops,3,0,3
3P7RGTLO6EE07HLUVDKKHS6O7CCKA5,"The barren islands, reefs and coral outcrops are believed to be in rich in oil and gas and the overlapping claims have long been feared as Asia's next flashpoint for armed conflict.",36,44,outcrops,6,7,13
3P7RGTLO6EE07HLUVDKKHS6O7CCKA5,"The barren islands, reefs and coral outcrops are believed to be in rich in oil and gas and the overlapping claims have long been feared as Asia's next flashpoint for armed conflict.",95,106,overlapping,4,6,10
3P7RGTLO6EE07HLUVDKKHS6O7CCKA5,"The barren islands, reefs and coral outcrops are believed to be in rich in oil and gas and the overlapping claims have long been feared as Asia's next flashpoint for armed conflict.",95,113,overlapping claims,2,2,4
3P7RGTLO6EE07HLUVDKKHS6O7CCKA5,"The barren islands, reefs and coral outcrops are believed to be in rich in oil and gas and the overlapping claims have long been feared as Asia's next flashpoint for armed conflict.",151,161,flashpoint,10,8,18
3P7RGTLO6EE07HLUVDKKHS6O7CCKA5,"The barren islands, reefs and coral outcrops are believed to be in rich in oil and gas and the overlapping claims have long been feared as Asia's next flashpoint for armed conflict.",166,180,armed conflict,1,1,2
3P7RGTLO6EE07HLUVDKKHS6O7CCKA5,"The barren islands, reefs and coral outcrops are believed to be in rich in oil and gas and the overlapping claims have long been feared as Asia's next flashpoint for armed conflict.",172,180,conflict,0,2,2
3P7RGTLO6EE07HLUVDKKHS6O7CCKA5,Both China and the Philippines flexed their muscles on Wednesday.,31,37,flexed,2,7,9
3P7RGTLO6EE07HLUVDKKHS6O7CCKA5,Both China and the Philippines flexed their muscles on Wednesday.,31,51,flexed their muscles,4,2,6
3P7RGTLO6EE07HLUVDKKHS6O7CCKA5,"Del Rosario said that he warned China's ambassador that ""if the Philippines is challenged, we are prepared to secure our sovereignty.""",40,50,ambassador,2,1,3
3P7RGTLO6EE07HLUVDKKHS6O7CCKA5,"Del Rosario said that he warned China's ambassador that ""if the Philippines is challenged, we are prepared to secure our sovereignty.""",79,89,challenged,1,2,3
3P7RGTLO6EE07HLUVDKKHS6O7CCKA5,"Del Rosario said that he warned China's ambassador that ""if the Philippines is challenged, we are prepared to secure our sovereignty.""",110,132,secure our sovereignty,1,0,1
3P7RGTLO6EE07HLUVDKKHS6O7CCKA5,"Del Rosario said that he warned China's ambassador that ""if the Philippines is challenged, we are prepared to secure our sovereignty.""",121,132,sovereignty,10,10,20
3P7RGTLO6EE07HLUVDKKHS6O7CCKA5,"The Philippine navy was sending additional vessels toward the shoal, which lies about 200 kilometers (124 miles) from the nearest Philippine coast, a Philippine navy official told The Associated Press.",43,50,vessels,4,4,8
3P7RGTLO6EE07HLUVDKKHS6O7CCKA5,"The Philippine navy was sending additional vessels toward the shoal, which lies about 200 kilometers (124 miles) from the nearest Philippine coast, a Philippine navy official told The Associated Press.",62,67,shoal,6,7,13
3P7RGTLO6EE07HLUVDKKHS6O7CCKA5,He spoke on condition of anonymity because of a lack of authority to discuss the situation with the media.,12,34,condition of anonymity,3,1,4
3P7RGTLO6EE07HLUVDKKHS6O7CCKA5,He spoke on condition of anonymity because of a lack of authority to discuss the situation with the media.,25,34,anonymity,8,9,17
3P7RGTLO6EE07HLUVDKKHS6O7CCKA5,He spoke on condition of anonymity because of a lack of authority to discuss the situation with the media.,48,65,lack of authority,1,1,2
3P7RGTLO6EE07HLUVDKKHS6O7CCKA5,He spoke on condition of anonymity because of a lack of authority to discuss the situation with the media.,56,65,authority,2,2,4
3P7RGTLO6EE07HLUVDKKHS6O7CCKA5,"The standoff began Sunday when a Philippine navy surveillance plane spotted eight Chinese fishing vessels anchored in a lagoon at Scarborough, the Philippine Foreign Affairs Department said.",4,12,standoff,6,6,12
3P7RGTLO6EE07HLUVDKKHS6O7CCKA5,"The standoff began Sunday when a Philippine navy surveillance plane spotted eight Chinese fishing vessels anchored in a lagoon at Scarborough, the Philippine Foreign Affairs Department said.",44,67,navy surveillance plane,0,1,1
3P7RGTLO6EE07HLUVDKKHS6O7CCKA5,"The standoff began Sunday when a Philippine navy surveillance plane spotted eight Chinese fishing vessels anchored in a lagoon at Scarborough, the Philippine Foreign Affairs Department said.",49,61,surveillance,7,8,15
3P7RGTLO6EE07HLUVDKKHS6O7CCKA5,"The standoff began Sunday when a Philippine navy surveillance plane spotted eight Chinese fishing vessels anchored in a lagoon at Scarborough, the Philippine Foreign Affairs Department said.",49,67,surveillance plane,0,1,1
3P7RGTLO6EE07HLUVDKKHS6O7CCKA5,"The standoff began Sunday when a Philippine navy surveillance plane spotted eight Chinese fishing vessels anchored in a lagoon at Scarborough, the Philippine Foreign Affairs Department said.",68,75,spotted,0,1,1
3P7RGTLO6EE07HLUVDKKHS6O7CCKA5,"The standoff began Sunday when a Philippine navy surveillance plane spotted eight Chinese fishing vessels anchored in a lagoon at Scarborough, the Philippine Foreign Affairs Department said.",90,114,fishing vessels anchored,1,0,1
3P7RGTLO6EE07HLUVDKKHS6O7CCKA5,"The standoff began Sunday when a Philippine navy surveillance plane spotted eight Chinese fishing vessels anchored in a lagoon at Scarborough, the Philippine Foreign Affairs Department said.",106,114,anchored,3,5,8
3P7RGTLO6EE07HLUVDKKHS6O7CCKA5,"The standoff began Sunday when a Philippine navy surveillance plane spotted eight Chinese fishing vessels anchored in a lagoon at Scarborough, the Philippine Foreign Affairs Department said.",120,126,lagoon,5,2,7
3JMQI2OLFZ6ZDU99C032ZLVYLXBNDL,"The market was bracing itself for at least 50 billion euros in new cash.	16	23	bracing	9	10	19
3JMQI2OLFZ6ZDU99C032ZLVYLXBNDL	The market was bracing itself for at least 50 billion euros in new cash.",16,30,bracing itself,1,2,3
3JMQI2OLFZ6ZDU99C032ZLVYLXBNDL,"The market was bracing itself for at least 50 billion euros in new cash.	64	72	new cash	0	1	1
3JMQI2OLFZ6ZDU99C032ZLVYLXBNDL	You can't put out a number as low as 15 billion without an explanation, said a London-based banking analyst who did not want to be named.",59,70,explanation,3,2,5
3JMQI2OLFZ6ZDU99C032ZLVYLXBNDL,"You can't put out a number as low as 15 billion without an explanation,"" said a London-based banking analyst who did not want to be named.",93,108,banking analyst,4,1,5
3JMQI2OLFZ6ZDU99C032ZLVYLXBNDL,"You can't put out a number as low as 15 billion without an explanation,"" said a London-based banking analyst who did not want to be named.",101,108,analyst,5,5,10
3JMQI2OLFZ6ZDU99C032ZLVYLXBNDL,"Spanish lenders must set aside 30 billion euros, on top of 54 billion euros ordered in February, as provisions against loans which are still performing as well as bad ones while defaults rise in an recession which has sent unemployment to 24 percent.",8,15,lenders,3,3,6
3JMQI2OLFZ6ZDU99C032ZLVYLXBNDL,"Spanish lenders must set aside 30 billion euros, on top of 54 billion euros ordered in February, as provisions against loans which are still performing as well as bad ones while defaults rise in an recession which has sent unemployment to 24 percent.",21,30,set aside,1,1,2
3JMQI2OLFZ6ZDU99C032ZLVYLXBNDL,"Spanish lenders must set aside 30 billion euros, on top of 54 billion euros ordered in February, as provisions against loans which are still performing as well as bad ones while defaults rise in an recession which has sent unemployment to 24 percent.",25,30,aside,0,1,1
3JMQI2OLFZ6ZDU99C032ZLVYLXBNDL,"Spanish lenders must set aside 30 billion euros, on top of 54 billion euros ordered in February, as provisions against loans which are still performing as well as bad ones while defaults rise in an recession which has sent unemployment to 24 percent.",100,110,provisions,10,6,16
3JMQI2OLFZ6ZDU99C032ZLVYLXBNDL,"Spanish lenders must set aside 30 billion euros, on top of 54 billion euros ordered in February, as provisions against loans which are still performing as well as bad ones while defaults rise in an recession which has sent unemployment to 24 percent.",100,124,provisions against loans,2,0,2
3JMQI2OLFZ6ZDU99C032ZLVYLXBNDL,"Spanish lenders must set aside 30 billion euros, on top of 54 billion euros ordered in February, as provisions against loans which are still performing as well as bad ones while defaults rise in an recession which has sent unemployment to 24 percent.",141,151,performing,2,2,4
3JMQI2OLFZ6ZDU99C032ZLVYLXBNDL,"Spanish lenders must set aside 30 billion euros, on top of 54 billion euros ordered in February, as provisions against loans which are still performing as well as bad ones while defaults rise in an recession which has sent unemployment to 24 percent.",178,186,defaults,7,7,14
3JMQI2OLFZ6ZDU99C032ZLVYLXBNDL,"Spanish lenders must set aside 30 billion euros, on top of 54 billion euros ordered in February, as provisions against loans which are still performing as well as bad ones while defaults rise in an recession which has sent unemployment to 24 percent.",178,191,defaults rise,1,0,1
3JMQI2OLFZ6ZDU99C032ZLVYLXBNDL,"Spanish lenders must set aside 30 billion euros, on top of 54 billion euros ordered in February, as provisions against loans which are still performing as well as bad ones while defaults rise in an recession which has sent unemployment to 24 percent.",198,207,recession,10,10,20
3JMQI2OLFZ6ZDU99C032ZLVYLXBNDL,"Spanish lenders must set aside 30 billion euros, on top of 54 billion euros ordered in February, as provisions against loans which are still performing as well as bad ones while defaults rise in an recession which has sent unemployment to 24 percent.",223,235,unemployment,4,2,6
3JMQI2OLFZ6ZDU99C032ZLVYLXBNDL,"The Spanish government source said the 30-billion euro provisions would have an impact in capital of about 20 billion which, added to another estimated 20 billion euros to rescue systemic lender Bankia SA and other smaller banks would make up the figure investors viewed as necessary.",12,22,government,1,0,1
3JMQI2OLFZ6ZDU99C032ZLVYLXBNDL,"The Spanish government source said the 30-billion euro provisions would have an impact in capital of about 20 billion which, added to another estimated 20 billion euros to rescue systemic lender Bankia SA and other smaller banks would make up the figure investors viewed as necessary.",23,29,source,2,0,2
3JMQI2OLFZ6ZDU99C032ZLVYLXBNDL,"The Spanish government source said the 30-billion euro provisions would have an impact in capital of about 20 billion which, added to another estimated 20 billion euros to rescue systemic lender Bankia SA and other smaller banks would make up the figure investors viewed as necessary.",55,65,provisions,5,5,10
3JMQI2OLFZ6ZDU99C032ZLVYLXBNDL,"The Spanish government source said the 30-billion euro provisions would have an impact in capital of about 20 billion which, added to another estimated 20 billion euros to rescue systemic lender Bankia SA and other smaller banks would make up the figure investors viewed as necessary.",80,86,impact,1,4,5
3JMQI2OLFZ6ZDU99C032ZLVYLXBNDL,"The Spanish government source said the 30-billion euro provisions would have an impact in capital of about 20 billion which, added to another estimated 20 billion euros to rescue systemic lender Bankia SA and other smaller banks would make up the figure investors viewed as necessary.",80,97,impact in capital,1,0,1
3JMQI2OLFZ6ZDU99C032ZLVYLXBNDL,"The Spanish government source said the 30-billion euro provisions would have an impact in capital of about 20 billion which, added to another estimated 20 billion euros to rescue systemic lender Bankia SA and other smaller banks would make up the figure investors viewed as necessary.",90,97,capital,2,0,2
3JMQI2OLFZ6ZDU99C032ZLVYLXBNDL,"The Spanish government source said the 30-billion euro provisions would have an impact in capital of about 20 billion which, added to another estimated 20 billion euros to rescue systemic lender Bankia SA and other smaller banks would make up the figure investors viewed as necessary.",142,151,estimated,0,3,3
3JMQI2OLFZ6ZDU99C032ZLVYLXBNDL,"The Spanish government source said the 30-billion euro provisions would have an impact in capital of about 20 billion which, added to another estimated 20 billion euros to rescue systemic lender Bankia SA and other smaller banks would make up the figure investors viewed as necessary.",172,178,rescue,3,6,9
3JMQI2OLFZ6ZDU99C032ZLVYLXBNDL,"The Spanish government source said the 30-billion euro provisions would have an impact in capital of about 20 billion which, added to another estimated 20 billion euros to rescue systemic lender Bankia SA and other smaller banks would make up the figure investors viewed as necessary.",172,194,rescue systemic lender,0,1,1
3JMQI2OLFZ6ZDU99C032ZLVYLXBNDL,"The Spanish government source said the 30-billion euro provisions would have an impact in capital of about 20 billion which, added to another estimated 20 billion euros to rescue systemic lender Bankia SA and other smaller banks would make up the figure investors viewed as necessary.",179,187,systemic,6,2,8
3JMQI2OLFZ6ZDU99C032ZLVYLXBNDL,"The Spanish government source said the 30-billion euro provisions would have an impact in capital of about 20 billion which, added to another estimated 20 billion euros to rescue systemic lender Bankia SA and other smaller banks would make up the figure investors viewed as necessary.",179,194,systemic lender,4,5,9
3JMQI2OLFZ6ZDU99C032ZLVYLXBNDL,"The Spanish government source said the 30-billion euro provisions would have an impact in capital of about 20 billion which, added to another estimated 20 billion euros to rescue systemic lender Bankia SA and other smaller banks would make up the figure investors viewed as necessary.",188,194,lender,0,1,1
3JMQI2OLFZ6ZDU99C032ZLVYLXBNDL,"The Spanish government source said the 30-billion euro provisions would have an impact in capital of about 20 billion which, added to another estimated 20 billion euros to rescue systemic lender Bankia SA and other smaller banks would make up the figure investors viewed as necessary.",247,263,figure investors,1,0,1
3JMQI2OLFZ6ZDU99C032ZLVYLXBNDL,"The Spanish government source said the 30-billion euro provisions would have an impact in capital of about 20 billion which, added to another estimated 20 billion euros to rescue systemic lender Bankia SA and other smaller banks would make up the figure investors viewed as necessary.",254,263,investors,2,2,4
3JMQI2OLFZ6ZDU99C032ZLVYLXBNDL,"The Spanish government source said the 30-billion euro provisions would have an impact in capital of about 20 billion which, added to another estimated 20 billion euros to rescue systemic lender Bankia SA and other smaller banks would make up the figure investors viewed as necessary.",264,270,viewed,0,1,1
3S8APUMBJXKUA5Y80GTJWQYPGLDBFV,"Western powers have no appetite for a repeat of the military intervention that helped Libyan rebels topple long-time ruler Moammar Gadhafi last year, and Moscow says arming Assad's opponents would only lead to years of inconclusive bloodshed.",23,31,appetite,8,8,16
3S8APUMBJXKUA5Y80GTJWQYPGLDBFV,"Western powers have no appetite for a repeat of the military intervention that helped Libyan rebels topple long-time ruler Moammar Gadhafi last year, and Moscow says arming Assad's opponents would only lead to years of inconclusive bloodshed.",52,73,military intervention,3,1,4
3S8APUMBJXKUA5Y80GTJWQYPGLDBFV,"Western powers have no appetite for a repeat of the military intervention that helped Libyan rebels topple long-time ruler Moammar Gadhafi last year, and Moscow says arming Assad's opponents would only lead to years of inconclusive bloodshed.",61,73,intervention,8,8,16
3S8APUMBJXKUA5Y80GTJWQYPGLDBFV,"Western powers have no appetite for a repeat of the military intervention that helped Libyan rebels topple long-time ruler Moammar Gadhafi last year, and Moscow says arming Assad's opponents would only lead to years of inconclusive bloodshed.",86,92,Libyan,1,0,1
3S8APUMBJXKUA5Y80GTJWQYPGLDBFV,"Western powers have no appetite for a repeat of the military intervention that helped Libyan rebels topple long-time ruler Moammar Gadhafi last year, and Moscow says arming Assad's opponents would only lead to years of inconclusive bloodshed.",93,99,rebels,0,1,1
3S8APUMBJXKUA5Y80GTJWQYPGLDBFV,"Western powers have no appetite for a repeat of the military intervention that helped Libyan rebels topple long-time ruler Moammar Gadhafi last year, and Moscow says arming Assad's opponents would only lead to years of inconclusive bloodshed.",100,106,topple,7,10,17
3S8APUMBJXKUA5Y80GTJWQYPGLDBFV,"Western powers have no appetite for a repeat of the military intervention that helped Libyan rebels topple long-time ruler Moammar Gadhafi last year, and Moscow says arming Assad's opponents would only lead to years of inconclusive bloodshed.",107,116,long-time,0,1,1
3S8APUMBJXKUA5Y80GTJWQYPGLDBFV,"Western powers have no appetite for a repeat of the military intervention that helped Libyan rebels topple long-time ruler Moammar Gadhafi last year, and Moscow says arming Assad's opponents would only lead to years of inconclusive bloodshed.",117,122,ruler,0,1,1
3S8APUMBJXKUA5Y80GTJWQYPGLDBFV,"Western powers have no appetite for a repeat of the military intervention that helped Libyan rebels topple long-time ruler Moammar Gadhafi last year, and Moscow says arming Assad's opponents would only lead to years of inconclusive bloodshed.",123,138,Moammar Gadhafi,1,0,1
3S8APUMBJXKUA5Y80GTJWQYPGLDBFV,"Western powers have no appetite for a repeat of the military intervention that helped Libyan rebels topple long-time ruler Moammar Gadhafi last year, and Moscow says arming Assad's opponents would only lead to years of inconclusive bloodshed.",166,172,arming,1,1,2
3S8APUMBJXKUA5Y80GTJWQYPGLDBFV,"Western powers have no appetite for a repeat of the military intervention that helped Libyan rebels topple long-time ruler Moammar Gadhafi last year, and Moscow says arming Assad's opponents would only lead to years of inconclusive bloodshed.",181,190,opponents,3,3,6
3S8APUMBJXKUA5Y80GTJWQYPGLDBFV,"Western powers have no appetite for a repeat of the military intervention that helped Libyan rebels topple long-time ruler Moammar Gadhafi last year, and Moscow says arming Assad's opponents would only lead to years of inconclusive bloodshed.",219,231,inconclusive,10,10,20
3S8APUMBJXKUA5Y80GTJWQYPGLDBFV,"Western powers have no appetite for a repeat of the military intervention that helped Libyan rebels topple long-time ruler Moammar Gadhafi last year, and Moscow says arming Assad's opponents would only lead to years of inconclusive bloodshed.",219,241,inconclusive bloodshed,2,2,4
3S8APUMBJXKUA5Y80GTJWQYPGLDBFV,"Western powers have no appetite for a repeat of the military intervention that helped Libyan rebels topple long-time ruler Moammar Gadhafi last year, and Moscow says arming Assad's opponents would only lead to years of inconclusive bloodshed.",232,241,bloodshed,0,5,5
3S8APUMBJXKUA5Y80GTJWQYPGLDBFV,"Fierce clashes between Syrian regime forces and armed rebels in the central city of Rastan on Monday left at least 23 soldiers dead and dozens wounded, the Syrian Observatory for Human Rights said.",0,6,Fierce,2,2,4
3S8APUMBJXKUA5Y80GTJWQYPGLDBFV,"Fierce clashes between Syrian regime forces and armed rebels in the central city of Rastan on Monday left at least 23 soldiers dead and dozens wounded, the Syrian Observatory for Human Rights said.",0,14,Fierce clashes,0,1,1
3S8APUMBJXKUA5Y80GTJWQYPGLDBFV,"Fierce clashes between Syrian regime forces and armed rebels in the central city of Rastan on Monday left at least 23 soldiers dead and dozens wounded, the Syrian Observatory for Human Rights said.",7,14,clashes,0,1,1
3S8APUMBJXKUA5Y80GTJWQYPGLDBFV,"Fierce clashes between Syrian regime forces and armed rebels in the central city of Rastan on Monday left at least 23 soldiers dead and dozens wounded, the Syrian Observatory for Human Rights said.",30,36,regime,0,3,3
3S8APUMBJXKUA5Y80GTJWQYPGLDBFV,"Fierce clashes between Syrian regime forces and armed rebels in the central city of Rastan on Monday left at least 23 soldiers dead and dozens wounded, the Syrian Observatory for Human Rights said.",54,60,rebels,0,1,1
3S8APUMBJXKUA5Y80GTJWQYPGLDBFV,"Fierce clashes between Syrian regime forces and armed rebels in the central city of Rastan on Monday left at least 23 soldiers dead and dozens wounded, the Syrian Observatory for Human Rights said.",143,150,wounded,0,1,1
3S8APUMBJXKUA5Y80GTJWQYPGLDBFV,"Fierce clashes between Syrian regime forces and armed rebels in the central city of Rastan on Monday left at least 23 soldiers dead and dozens wounded, the Syrian Observatory for Human Rights said.",156,191,Syrian Observatory for Human Rights,1,0,1
3S8APUMBJXKUA5Y80GTJWQYPGLDBFV,"Fierce clashes between Syrian regime forces and armed rebels in the central city of Rastan on Monday left at least 23 soldiers dead and dozens wounded, the Syrian Observatory for Human Rights said.",163,174,Observatory,1,2,3
3S8APUMBJXKUA5Y80GTJWQYPGLDBFV,"The Britain-based monitoring group said initial reports indicated that three troop carriers were destroyed in the clashes that began at dawn on the outskirts of the rebel-held city, located in Homs province.",4,34,Britain-based monitoring group,0,1,1
3S8APUMBJXKUA5Y80GTJWQYPGLDBFV,"The Britain-based monitoring group said initial reports indicated that three troop carriers were destroyed in the clashes that began at dawn on the outskirts of the rebel-held city, located in Homs province.",18,28,monitoring,6,3,9
3S8APUMBJXKUA5Y80GTJWQYPGLDBFV,"The Britain-based monitoring group said initial reports indicated that three troop carriers were destroyed in the clashes that began at dawn on the outskirts of the rebel-held city, located in Homs province.",18,34,monitoring group,2,0,2
3S8APUMBJXKUA5Y80GTJWQYPGLDBFV,"The Britain-based monitoring group said initial reports indicated that three troop carriers were destroyed in the clashes that began at dawn on the outskirts of the rebel-held city, located in Homs province.",56,65,indicated,0,2,2
3S8APUMBJXKUA5Y80GTJWQYPGLDBFV,"The Britain-based monitoring group said initial reports indicated that three troop carriers were destroyed in the clashes that began at dawn on the outskirts of the rebel-held city, located in Homs province.",77,82,troop,0,1,1
3S8APUMBJXKUA5Y80GTJWQYPGLDBFV,"The Britain-based monitoring group said initial reports indicated that three troop carriers were destroyed in the clashes that began at dawn on the outskirts of the rebel-held city, located in Homs province.",97,106,destroyed,1,1,2
3S8APUMBJXKUA5Y80GTJWQYPGLDBFV,"The Britain-based monitoring group said initial reports indicated that three troop carriers were destroyed in the clashes that began at dawn on the outskirts of the rebel-held city, located in Homs province.",114,121,clashes,2,0,2
3S8APUMBJXKUA5Y80GTJWQYPGLDBFV,"The Britain-based monitoring group said initial reports indicated that three troop carriers were destroyed in the clashes that began at dawn on the outskirts of the rebel-held city, located in Homs province.",136,140,dawn,0,2,2
3S8APUMBJXKUA5Y80GTJWQYPGLDBFV,"The Britain-based monitoring group said initial reports indicated that three troop carriers were destroyed in the clashes that began at dawn on the outskirts of the rebel-held city, located in Homs province.",148,157,outskirts,7,8,15
3S8APUMBJXKUA5Y80GTJWQYPGLDBFV,"The Britain-based monitoring group said initial reports indicated that three troop carriers were destroyed in the clashes that began at dawn on the outskirts of the rebel-held city, located in Homs province.",165,175,rebel-held,0,1,1
3S8APUMBJXKUA5Y80GTJWQYPGLDBFV,"The Britain-based monitoring group said initial reports indicated that three troop carriers were destroyed in the clashes that began at dawn on the outskirts of the rebel-held city, located in Homs province.",165,180,rebel-held city,1,1,2
3S8APUMBJXKUA5Y80GTJWQYPGLDBFV,"The Britain-based monitoring group said initial reports indicated that three troop carriers were destroyed in the clashes that began at dawn on the outskirts of the rebel-held city, located in Homs province.",198,206,province,2,3,5
3S8APUMBJXKUA5Y80GTJWQYPGLDBFV,A lieutenant who had defected was also killed in the clashes.,2,12,lieutenant,7,2,9
3S8APUMBJXKUA5Y80GTJWQYPGLDBFV,A lieutenant who had defected was also killed in the clashes.,21,29,defected,7,4,11
3S8APUMBJXKUA5Y80GTJWQYPGLDBFV,Regime forces launched an offensive on Rastan at the weekend but met with sharp resistance from rebels seeking the ouster of the regime of President Bashar al-Assad.,0,6,Regime,0,1,1
3S8APUMBJXKUA5Y80GTJWQYPGLDBFV,Regime forces launched an offensive on Rastan at the weekend but met with sharp resistance from rebels seeking the ouster of the regime of President Bashar al-Assad.,0,13,Regime forces,2,0,2
3S8APUMBJXKUA5Y80GTJWQYPGLDBFV,Regime forces launched an offensive on Rastan at the weekend but met with sharp resistance from rebels seeking the ouster of the regime of President Bashar al-Assad.,14,22,launched,1,2,3
3S8APUMBJXKUA5Y80GTJWQYPGLDBFV,Regime forces launched an offensive on Rastan at the weekend but met with sharp resistance from rebels seeking the ouster of the regime of President Bashar al-Assad.,26,35,offensive,1,1,2
3S8APUMBJXKUA5Y80GTJWQYPGLDBFV,Regime forces launched an offensive on Rastan at the weekend but met with sharp resistance from rebels seeking the ouster of the regime of President Bashar al-Assad.,74,79,sharp,0,2,2
3S8APUMBJXKUA5Y80GTJWQYPGLDBFV,Regime forces launched an offensive on Rastan at the weekend but met with sharp resistance from rebels seeking the ouster of the regime of President Bashar al-Assad.,74,90,sharp resistance,1,0,1
3S8APUMBJXKUA5Y80GTJWQYPGLDBFV,Regime forces launched an offensive on Rastan at the weekend but met with sharp resistance from rebels seeking the ouster of the regime of President Bashar al-Assad.,80,90,resistance,5,1,6
3S8APUMBJXKUA5Y80GTJWQYPGLDBFV,Regime forces launched an offensive on Rastan at the weekend but met with sharp resistance from rebels seeking the ouster of the regime of President Bashar al-Assad.,115,121,ouster,7,7,14
3S8APUMBJXKUA5Y80GTJWQYPGLDBFV,Regime forces launched an offensive on Rastan at the weekend but met with sharp resistance from rebels seeking the ouster of the regime of President Bashar al-Assad.,115,135,ouster of the regime,0,1,1
3S8APUMBJXKUA5Y80GTJWQYPGLDBFV,Regime forces launched an offensive on Rastan at the weekend but met with sharp resistance from rebels seeking the ouster of the regime of President Bashar al-Assad.,129,135,regime,3,0,3
3S8APUMBJXKUA5Y80GTJWQYPGLDBFV,Regime forces launched an offensive on Rastan at the weekend but met with sharp resistance from rebels seeking the ouster of the regime of President Bashar al-Assad.,149,164,Bashar al-Assad,1,0,1
3JY0Q5X05J7WFM2ERMRFFMPYXD5GGG,"However, after the trip, presumptive Republican presidential nominee Mitt Romney struck a somewhat somber tone in a press release.",25,36,presumptive,10,10,20
3JY0Q5X05J7WFM2ERMRFFMPYXD5GGG,"However, after the trip, presumptive Republican presidential nominee Mitt Romney struck a somewhat somber tone in a press release.",25,68,presumptive Republican presidential nominee,1,1,2
3JY0Q5X05J7WFM2ERMRFFMPYXD5GGG,"However, after the trip, presumptive Republican presidential nominee Mitt Romney struck a somewhat somber tone in a press release.",48,68,presidential nominee,0,1,1
3JY0Q5X05J7WFM2ERMRFFMPYXD5GGG,"However, after the trip, presumptive Republican presidential nominee Mitt Romney struck a somewhat somber tone in a press release.",61,68,nominee,9,3,12
3JY0Q5X05J7WFM2ERMRFFMPYXD5GGG,"However, after the trip, presumptive Republican presidential nominee Mitt Romney struck a somewhat somber tone in a press release.",81,87,struck,0,4,4
3JY0Q5X05J7WFM2ERMRFFMPYXD5GGG,"However, after the trip, presumptive Republican presidential nominee Mitt Romney struck a somewhat somber tone in a press release.",81,110,struck a somewhat somber tone,0,1,1
3JY0Q5X05J7WFM2ERMRFFMPYXD5GGG,"However, after the trip, presumptive Republican presidential nominee Mitt Romney struck a somewhat somber tone in a press release.",90,110,somewhat somber tone,1,0,1
3JY0Q5X05J7WFM2ERMRFFMPYXD5GGG,"However, after the trip, presumptive Republican presidential nominee Mitt Romney struck a somewhat somber tone in a press release.",99,105,somber,10,6,16
3JY0Q5X05J7WFM2ERMRFFMPYXD5GGG,"However, after the trip, presumptive Republican presidential nominee Mitt Romney struck a somewhat somber tone in a press release.",99,110,somber tone,2,3,5
3JY0Q5X05J7WFM2ERMRFFMPYXD5GGG,"However, after the trip, presumptive Republican presidential nominee Mitt Romney struck a somewhat somber tone in a press release.",116,129,press release,1,0,1
3JY0Q5X05J7WFM2ERMRFFMPYXD5GGG,Our troops and the American people deserve to hear from our President about what is at stake in this war.,35,42,deserve,0,2,2
3JY0Q5X05J7WFM2ERMRFFMPYXD5GGG,Our troops and the American people deserve to hear from our President about what is at stake in this war.,84,92,at stake,4,1,5
3JY0Q5X05J7WFM2ERMRFFMPYXD5GGG,Our troops and the American people deserve to hear from our President about what is at stake in this war.,87,92,stake,2,8,10
3JY0Q5X05J7WFM2ERMRFFMPYXD5GGG,Success in Afghanistan is vital to our nation's security.,26,31,vital,7,3,10
3JY0Q5X05J7WFM2ERMRFFMPYXD5GGG,Success in Afghanistan is vital to our nation's security.,39,55,nations security,0,1,1
3JY0Q5X05J7WFM2ERMRFFMPYXD5GGG,"It would be a tragedy for Afghanistan and a strategic setback for America if the Taliban returned to power and once again created a sanctuary for terrorists,"" Romney said in the release.",14,21,tragedy,3,7,10
3JY0Q5X05J7WFM2ERMRFFMPYXD5GGG,"It would be a tragedy for Afghanistan and a strategic setback for America if the Taliban returned to power and once again created a sanctuary for terrorists,"" Romney said in the release.",44,53,strategic,4,5,9
3JY0Q5X05J7WFM2ERMRFFMPYXD5GGG,"It would be a tragedy for Afghanistan and a strategic setback for America if the Taliban returned to power and once again created a sanctuary for terrorists,"" Romney said in the release.",44,61,strategic setback,6,4,10
3JY0Q5X05J7WFM2ERMRFFMPYXD5GGG,"It would be a tragedy for Afghanistan and a strategic setback for America if the Taliban returned to power and once again created a sanctuary for terrorists,"" Romney said in the release.",54,61,setback,1,3,4
3JY0Q5X05J7WFM2ERMRFFMPYXD5GGG,"It would be a tragedy for Afghanistan and a strategic setback for America if the Taliban returned to power and once again created a sanctuary for terrorists,"" Romney said in the release.",81,88,Taliban,1,0,1
3JY0Q5X05J7WFM2ERMRFFMPYXD5GGG,"It would be a tragedy for Afghanistan and a strategic setback for America if the Taliban returned to power and once again created a sanctuary for terrorists,"" Romney said in the release.",132,141,sanctuary,10,5,15
3JY0Q5X05J7WFM2ERMRFFMPYXD5GGG,"It would be a tragedy for Afghanistan and a strategic setback for America if the Taliban returned to power and once again created a sanctuary for terrorists,"" Romney said in the release.",132,156,sanctuary for terrorists,0,3,3
3JY0Q5X05J7WFM2ERMRFFMPYXD5GGG,"We tolerated such a sanctuary until we lost thousands on September 11, 2001.	4	13	tolerated	3	7	10
3JY0Q5X05J7WFM2ERMRFFMPYXD5GGG	We tolerated such a sanctuary until we lost thousands on September 11, 2001.",21,30,sanctuary,4,2,6
3JY0Q5X05J7WFM2ERMRFFMPYXD5GGG,Many brave Americans have sacrificed everything so that we could win this fight for a more secure future.,26,36,sacrificed,6,5,11
3JY0Q5X05J7WFM2ERMRFFMPYXD5GGG,Many brave Americans have sacrificed everything so that we could win this fight for a more secure future.,84,104,a more secure future,1,0,1
3JY0Q5X05J7WFM2ERMRFFMPYXD5GGG,Many brave Americans have sacrificed everything so that we could win this fight for a more secure future.,91,97,secure,0,2,2
3JY0Q5X05J7WFM2ERMRFFMPYXD5GGG,Many brave Americans have sacrificed everything so that we could win this fight for a more secure future.,91,104,secure future,1,1,2
3J94SKDEKIQVN533807G54VCVPED5F,The injured man was able to drive his car to Cloverhill Prison where he summoned assistance.,4,11,injured,0,2,2
3J94SKDEKIQVN533807G54VCVPED5F,The injured man was able to drive his car to Cloverhill Prison where he summoned assistance.,69,91,he summoned assistance,0,1,1
3J94SKDEKIQVN533807G54VCVPED5F,The injured man was able to drive his car to Cloverhill Prison where he summoned assistance.,72,80,summoned,10,10,20
3J94SKDEKIQVN533807G54VCVPED5F,The injured man was able to drive his car to Cloverhill Prison where he summoned assistance.,72,91,summoned assistance,3,1,4
3J94SKDEKIQVN533807G54VCVPED5F,The injured man was able to drive his car to Cloverhill Prison where he summoned assistance.,81,91,assistance,1,1,2
3J94SKDEKIQVN533807G54VCVPED5F,"He was taken to Tallaght General Hospital, his injuries are not thought to be life threatening.",60,94,not thought to be life threatening,0,1,1
3J94SKDEKIQVN533807G54VCVPED5F,"He was taken to Tallaght General Hospital, his injuries are not thought to be life threatening.",78,94,life threatening,5,6,11
3J94SKDEKIQVN533807G54VCVPED5F,"He was taken to Tallaght General Hospital, his injuries are not thought to be life threatening.",83,94,threatening,1,5,6
3J94SKDEKIQVN533807G54VCVPED5F,Witnesses at the scene of the shooting describe a silver saloon car leaving the area.,0,9,Witnesses,5,6,11
3J94SKDEKIQVN533807G54VCVPED5F,Witnesses at the scene of the shooting describe a silver saloon car leaving the area.,39,47,describe,0,1,1
3J94SKDEKIQVN533807G54VCVPED5F,Witnesses at the scene of the shooting describe a silver saloon car leaving the area.,50,63,silver saloon,1,0,1
3J94SKDEKIQVN533807G54VCVPED5F,Witnesses at the scene of the shooting describe a silver saloon car leaving the area.,50,67,silver saloon car,0,2,2
3J94SKDEKIQVN533807G54VCVPED5F,Witnesses at the scene of the shooting describe a silver saloon car leaving the area.,57,63,saloon,3,1,4
3J94SKDEKIQVN533807G54VCVPED5F,Witnesses at the scene of the shooting describe a silver saloon car leaving the area.,57,67,saloon car,3,1,4
3J94SKDEKIQVN533807G54VCVPED5F,"At about 11.30 pm a silver car was discovered on fire at Golden Bridge Terrace, Inchicore.",35,45,discovered,1,3,4
3J94SKDEKIQVN533807G54VCVPED5F,"At about 11.30 pm a silver car was discovered on fire at Golden Bridge Terrace, Inchicore.",80,89,Inchicore,1,1,2
3J94SKDEKIQVN533807G54VCVPED5F,The car has been removed from the scene for forensic technical examination.,17,24,removed,0,1,1
3J94SKDEKIQVN533807G54VCVPED5F,The car has been removed from the scene for forensic technical examination.,44,52,forensic,5,10,15
3J94SKDEKIQVN533807G54VCVPED5F,The car has been removed from the scene for forensic technical examination.,44,74,forensic technical examination,6,3,9
3J94SKDEKIQVN533807G54VCVPED5F,The car has been removed from the scene for forensic technical examination.,63,74,examination,2,0,2
3J94SKDEKIQVN533807G54VCVPED5F,Gardai are asking anyone who was in the Sarsfield Road area of Ballyfermot or in the Golden Bridge Terrace area to contact them on 01 666 7200.,0,6,Gardai,0,1,1
3J94SKDEKIQVN533807G54VCVPED5F,Ex-Soviet leader Mikhail Gorbachev says Russian authorities must annul the parliamentary vote results and hold a new election.,0,9,Ex-Soviet,2,0,2
3J94SKDEKIQVN533807G54VCVPED5F,Ex-Soviet leader Mikhail Gorbachev says Russian authorities must annul the parliamentary vote results and hold a new election.,48,59,authorities,1,3,4
3J94SKDEKIQVN533807G54VCVPED5F,Ex-Soviet leader Mikhail Gorbachev says Russian authorities must annul the parliamentary vote results and hold a new election.,65,70,annul,9,9,18
3J94SKDEKIQVN533807G54VCVPED5F,Ex-Soviet leader Mikhail Gorbachev says Russian authorities must annul the parliamentary vote results and hold a new election.,65,88,annul the parliamentary,0,1,1
3J94SKDEKIQVN533807G54VCVPED5F,Ex-Soviet leader Mikhail Gorbachev says Russian authorities must annul the parliamentary vote results and hold a new election.,75,88,parliamentary,9,2,11
3J94SKDEKIQVN533807G54VCVPED5F,Ex-Soviet leader Mikhail Gorbachev says Russian authorities must annul the parliamentary vote results and hold a new election.,75,101,parliamentary vote results,1,0,1
3J94SKDEKIQVN533807G54VCVPED5F,Ex-Soviet leader Mikhail Gorbachev says Russian authorities must annul the parliamentary vote results and hold a new election.,117,125,election,1,0,1
3WRBLBQ2GR9Z4IRTDK2CUU2IR9J0GR,He said most of the village's residents had fled and regime forces were setting fire to houses and looting shops.,40,48,had fled,0,1,1
3WRBLBQ2GR9Z4IRTDK2CUU2IR9J0GR,He said most of the village's residents had fled and regime forces were setting fire to houses and looting shops.,44,48,fled,1,5,6
3WRBLBQ2GR9Z4IRTDK2CUU2IR9J0GR,He said most of the village's residents had fled and regime forces were setting fire to houses and looting shops.,53,59,regime,8,3,11
3WRBLBQ2GR9Z4IRTDK2CUU2IR9J0GR,He said most of the village's residents had fled and regime forces were setting fire to houses and looting shops.,53,66,regime forces,5,1,6
3WRBLBQ2GR9Z4IRTDK2CUU2IR9J0GR,He said most of the village's residents had fled and regime forces were setting fire to houses and looting shops.,72,84,setting fire,0,1,1
3WRBLBQ2GR9Z4IRTDK2CUU2IR9J0GR,He said most of the village's residents had fled and regime forces were setting fire to houses and looting shops.,99,106,looting,6,6,12
3WRBLBQ2GR9Z4IRTDK2CUU2IR9J0GR,He said most of the village's residents had fled and regime forces were setting fire to houses and looting shops.,99,112,looting shops,3,2,5
3WRBLBQ2GR9Z4IRTDK2CUU2IR9J0GR,"He and the Observatory also reported shelling in a nearby village, Hayaleen.",11,22,Observatory,4,4,8
3WRBLBQ2GR9Z4IRTDK2CUU2IR9J0GR,"He and the Observatory also reported shelling in a nearby village, Hayaleen.",28,45,reported shelling,1,0,1
3WRBLBQ2GR9Z4IRTDK2CUU2IR9J0GR,"He and the Observatory also reported shelling in a nearby village, Hayaleen.",37,45,shelling,10,9,19
3WRBLBQ2GR9Z4IRTDK2CUU2IR9J0GR,"The regime is trying to punish these villages and to put an end to this revolution as quickly as it can, he said.",5,11,regime,6,2,8
3WRBLBQ2GR9Z4IRTDK2CUU2IR9J0GR,"The regime is trying to punish these villages and to put an end to this revolution as quickly as it can, he said.",73,83,revolution,6,6,12
3WRBLBQ2GR9Z4IRTDK2CUU2IR9J0GR,"In northern Lebanon, meanwhile, residents said running gunbattles broke out in the city Saturday and continued through Sunday morning, primarily between a neighborhood populated by Sunni Muslims opposed to Assad and another area with many Assad backers from his Alawite sect.",32,41,residents,1,0,1
3WRBLBQ2GR9Z4IRTDK2CUU2IR9J0GR,"In northern Lebanon, meanwhile, residents said running gunbattles broke out in the city Saturday and continued through Sunday morning, primarily between a neighborhood populated by Sunni Muslims opposed to Assad and another area with many Assad backers from his Alawite sect.",55,65,gunbattles,2,4,6
3WRBLBQ2GR9Z4IRTDK2CUU2IR9J0GR,"In northern Lebanon, meanwhile, residents said running gunbattles broke out in the city Saturday and continued through Sunday morning, primarily between a neighborhood populated by Sunni Muslims opposed to Assad and another area with many Assad backers from his Alawite sect.",135,144,primarily,2,0,2
3WRBLBQ2GR9Z4IRTDK2CUU2IR9J0GR,"In northern Lebanon, meanwhile, residents said running gunbattles broke out in the city Saturday and continued through Sunday morning, primarily between a neighborhood populated by Sunni Muslims opposed to Assad and another area with many Assad backers from his Alawite sect.",153,180,a neighborhood populated by,1,0,1
3WRBLBQ2GR9Z4IRTDK2CUU2IR9J0GR,"In northern Lebanon, meanwhile, residents said running gunbattles broke out in the city Saturday and continued through Sunday morning, primarily between a neighborhood populated by Sunni Muslims opposed to Assad and another area with many Assad backers from his Alawite sect.",168,177,populated,0,1,1
3WRBLBQ2GR9Z4IRTDK2CUU2IR9J0GR,"In northern Lebanon, meanwhile, residents said running gunbattles broke out in the city Saturday and continued through Sunday morning, primarily between a neighborhood populated by Sunni Muslims opposed to Assad and another area with many Assad backers from his Alawite sect.",181,186,Sunni,0,1,1
3WRBLBQ2GR9Z4IRTDK2CUU2IR9J0GR,"In northern Lebanon, meanwhile, residents said running gunbattles broke out in the city Saturday and continued through Sunday morning, primarily between a neighborhood populated by Sunni Muslims opposed to Assad and another area with many Assad backers from his Alawite sect.",181,194,Sunni Muslims,1,0,1
3WRBLBQ2GR9Z4IRTDK2CUU2IR9J0GR,"In northern Lebanon, meanwhile, residents said running gunbattles broke out in the city Saturday and continued through Sunday morning, primarily between a neighborhood populated by Sunni Muslims opposed to Assad and another area with many Assad backers from his Alawite sect.",239,252,Assad backers,0,1,1
3WRBLBQ2GR9Z4IRTDK2CUU2IR9J0GR,"In northern Lebanon, meanwhile, residents said running gunbattles broke out in the city Saturday and continued through Sunday morning, primarily between a neighborhood populated by Sunni Muslims opposed to Assad and another area with many Assad backers from his Alawite sect.",245,252,backers,2,3,5
3WRBLBQ2GR9Z4IRTDK2CUU2IR9J0GR,"In northern Lebanon, meanwhile, residents said running gunbattles broke out in the city Saturday and continued through Sunday morning, primarily between a neighborhood populated by Sunni Muslims opposed to Assad and another area with many Assad backers from his Alawite sect.",262,269,Alawite,1,2,3
3WRBLBQ2GR9Z4IRTDK2CUU2IR9J0GR,"In northern Lebanon, meanwhile, residents said running gunbattles broke out in the city Saturday and continued through Sunday morning, primarily between a neighborhood populated by Sunni Muslims opposed to Assad and another area with many Assad backers from his Alawite sect.",262,274,Alawite sect,2,1,3
3WRBLBQ2GR9Z4IRTDK2CUU2IR9J0GR,"In northern Lebanon, meanwhile, residents said running gunbattles broke out in the city Saturday and continued through Sunday morning, primarily between a neighborhood populated by Sunni Muslims opposed to Assad and another area with many Assad backers from his Alawite sect.",270,274,sect,3,1,4
3WRBLBQ2GR9Z4IRTDK2CUU2IR9J0GR,"The fighting highlights how easily trouble in Syria can raise tensions in neighboring Lebanon, with which it shares a complex web of political and sectarian ties and rivalries.",4,23,fighting highlights,0,1,1
3WRBLBQ2GR9Z4IRTDK2CUU2IR9J0GR,"The fighting highlights how easily trouble in Syria can raise tensions in neighboring Lebanon, with which it shares a complex web of political and sectarian ties and rivalries.",13,23,highlights,1,3,4
3WRBLBQ2GR9Z4IRTDK2CUU2IR9J0GR,"The fighting highlights how easily trouble in Syria can raise tensions in neighboring Lebanon, with which it shares a complex web of political and sectarian ties and rivalries.",28,42,easily trouble,1,0,1
3WRBLBQ2GR9Z4IRTDK2CUU2IR9J0GR,"The fighting highlights how easily trouble in Syria can raise tensions in neighboring Lebanon, with which it shares a complex web of political and sectarian ties and rivalries.",35,42,trouble,0,1,1
3WRBLBQ2GR9Z4IRTDK2CUU2IR9J0GR,"The fighting highlights how easily trouble in Syria can raise tensions in neighboring Lebanon, with which it shares a complex web of political and sectarian ties and rivalries.",56,70,raise tensions,0,2,2
3WRBLBQ2GR9Z4IRTDK2CUU2IR9J0GR,"The fighting highlights how easily trouble in Syria can raise tensions in neighboring Lebanon, with which it shares a complex web of political and sectarian ties and rivalries.",95,105,with which,1,0,1
3WRBLBQ2GR9Z4IRTDK2CUU2IR9J0GR,"The fighting highlights how easily trouble in Syria can raise tensions in neighboring Lebanon, with which it shares a complex web of political and sectarian ties and rivalries.",118,125,complex,1,0,1
3WRBLBQ2GR9Z4IRTDK2CUU2IR9J0GR,"The fighting highlights how easily trouble in Syria can raise tensions in neighboring Lebanon, with which it shares a complex web of political and sectarian ties and rivalries.",118,129,complex web,3,1,4
3WRBLBQ2GR9Z4IRTDK2CUU2IR9J0GR,"The fighting highlights how easily trouble in Syria can raise tensions in neighboring Lebanon, with which it shares a complex web of political and sectarian ties and rivalries.",118,161,complex web of political and sectarian ties,1,0,1
3WRBLBQ2GR9Z4IRTDK2CUU2IR9J0GR,"The fighting highlights how easily trouble in Syria can raise tensions in neighboring Lebanon, with which it shares a complex web of political and sectarian ties and rivalries.",126,175,web of political and sectarian ties and rivalries,1,0,1
3WRBLBQ2GR9Z4IRTDK2CUU2IR9J0GR,"The fighting highlights how easily trouble in Syria can raise tensions in neighboring Lebanon, with which it shares a complex web of political and sectarian ties and rivalries.",147,156,sectarian,9,6,15
3WRBLBQ2GR9Z4IRTDK2CUU2IR9J0GR,"The fighting highlights how easily trouble in Syria can raise tensions in neighboring Lebanon, with which it shares a complex web of political and sectarian ties and rivalries.",147,161,sectarian ties,4,0,4
3WRBLBQ2GR9Z4IRTDK2CUU2IR9J0GR,"The fighting highlights how easily trouble in Syria can raise tensions in neighboring Lebanon, with which it shares a complex web of political and sectarian ties and rivalries.",147,175,sectarian ties and rivalries,0,2,2
3WRBLBQ2GR9Z4IRTDK2CUU2IR9J0GR,"The fighting highlights how easily trouble in Syria can raise tensions in neighboring Lebanon, with which it shares a complex web of political and sectarian ties and rivalries.",166,175,rivalries,7,7,14
3B9J25CZ25EMOFV0K0PDE9NMN8MCSP,“Duck and cover here at the embassy.,0,5,“Duck,0,1,1
3B9J25CZ25EMOFV0K0PDE9NMN8MCSP,“Duck and cover here at the embassy.,0,15,“Duck and cover,7,2,9
3B9J25CZ25EMOFV0K0PDE9NMN8MCSP,“Duck and cover here at the embassy.,28,35,embassy,4,3,7
3B9J25CZ25EMOFV0K0PDE9NMN8MCSP,"Not a drill -- avoid the area,” the U.S. embassy said on Twitter.",0,11,Not a drill,0,1,1
3B9J25CZ25EMOFV0K0PDE9NMN8MCSP,"Not a drill -- avoid the area,” the U.S. embassy said on Twitter.",6,11,drill,2,8,10
3B9J25CZ25EMOFV0K0PDE9NMN8MCSP,"Not a drill -- avoid the area,” the U.S. embassy said on Twitter.",15,20,avoid,0,1,1
3B9J25CZ25EMOFV0K0PDE9NMN8MCSP,"Not a drill -- avoid the area,” the U.S. embassy said on Twitter.",41,48,embassy,1,0,1
3B9J25CZ25EMOFV0K0PDE9NMN8MCSP,"Not a drill -- avoid the area,” the U.S. embassy said on Twitter.",57,64,Twitter,0,1,1
3B9J25CZ25EMOFV0K0PDE9NMN8MCSP,"Karzai said the U.S. pact “is not threatening any third country, including the neighboring countries, but we are hoping that this leads to stability, prosperity and development in the region.”",0,6,Karzai,0,1,1
3B9J25CZ25EMOFV0K0PDE9NMN8MCSP,"Karzai said the U.S. pact “is not threatening any third country, including the neighboring countries, but we are hoping that this leads to stability, prosperity and development in the region.”",21,25,pact,4,1,5
3B9J25CZ25EMOFV0K0PDE9NMN8MCSP,"Karzai said the U.S. pact “is not threatening any third country, including the neighboring countries, but we are hoping that this leads to stability, prosperity and development in the region.”",34,45,threatening,1,6,7
3B9J25CZ25EMOFV0K0PDE9NMN8MCSP,"Karzai said the U.S. pact “is not threatening any third country, including the neighboring countries, but we are hoping that this leads to stability, prosperity and development in the region.”",50,63,third country,0,1,1
3B9J25CZ25EMOFV0K0PDE9NMN8MCSP,"Karzai said the U.S. pact “is not threatening any third country, including the neighboring countries, but we are hoping that this leads to stability, prosperity and development in the region.”",65,74,including,0,1,1
3B9J25CZ25EMOFV0K0PDE9NMN8MCSP,"Karzai said the U.S. pact “is not threatening any third country, including the neighboring countries, but we are hoping that this leads to stability, prosperity and development in the region.”",79,90,neighboring,2,0,2
3B9J25CZ25EMOFV0K0PDE9NMN8MCSP,"Karzai said the U.S. pact “is not threatening any third country, including the neighboring countries, but we are hoping that this leads to stability, prosperity and development in the region.”",130,135,leads,0,1,1
3B9J25CZ25EMOFV0K0PDE9NMN8MCSP,"Karzai said the U.S. pact “is not threatening any third country, including the neighboring countries, but we are hoping that this leads to stability, prosperity and development in the region.”",139,148,stability,8,4,12
3B9J25CZ25EMOFV0K0PDE9NMN8MCSP,"Karzai said the U.S. pact “is not threatening any third country, including the neighboring countries, but we are hoping that this leads to stability, prosperity and development in the region.”",139,176,"stability, prosperity and development",1,0,1
3B9J25CZ25EMOFV0K0PDE9NMN8MCSP,"Karzai said the U.S. pact “is not threatening any third country, including the neighboring countries, but we are hoping that this leads to stability, prosperity and development in the region.”",150,160,prosperity,10,6,16
3B9J25CZ25EMOFV0K0PDE9NMN8MCSP,"Karzai said the U.S. pact “is not threatening any third country, including the neighboring countries, but we are hoping that this leads to stability, prosperity and development in the region.”",165,176,development,2,1,3
3B9J25CZ25EMOFV0K0PDE9NMN8MCSP,"“Neither Americans nor the Afghan people asked for this war, yet for a decade we’ve stood together,” Obama said at the signing ceremony.",19,22,nor,0,1,1
3B9J25CZ25EMOFV0K0PDE9NMN8MCSP,"“Neither Americans nor the Afghan people asked for this war, yet for a decade we’ve stood together,” Obama said at the signing ceremony.",71,77,decade,0,4,4
3B9J25CZ25EMOFV0K0PDE9NMN8MCSP,"“Neither Americans nor the Afghan people asked for this war, yet for a decade we’ve stood together,” Obama said at the signing ceremony.",84,89,stood,0,2,2
3B9J25CZ25EMOFV0K0PDE9NMN8MCSP,"“Neither Americans nor the Afghan people asked for this war, yet for a decade we’ve stood together,” Obama said at the signing ceremony.",119,135,signing ceremony,4,3,7
3B9J25CZ25EMOFV0K0PDE9NMN8MCSP,"“Neither Americans nor the Afghan people asked for this war, yet for a decade we’ve stood together,” Obama said at the signing ceremony.",127,135,ceremony,3,2,5
3B9J25CZ25EMOFV0K0PDE9NMN8MCSP,“We look forward to a future of peace.,4,16,look forward,0,1,1
3B9J25CZ25EMOFV0K0PDE9NMN8MCSP,“We look forward to a future of peace.,22,37,future of peace,1,1,2
3B9J25CZ25EMOFV0K0PDE9NMN8MCSP,"We’re agreeing to be long-term partners,” said Obama, who later headed home aboard Air Force One after just six hours on the ground.",21,30,long-term,1,0,1
3B9J25CZ25EMOFV0K0PDE9NMN8MCSP,"We’re agreeing to be long-term partners,” said Obama, who later headed home aboard Air Force One after just six hours on the ground.",21,39,long-term partners,1,0,1
3B9J25CZ25EMOFV0K0PDE9NMN8MCSP,"We’re agreeing to be long-term partners,” said Obama, who later headed home aboard Air Force One after just six hours on the ground.",64,70,headed,1,1,2
3B9J25CZ25EMOFV0K0PDE9NMN8MCSP,"The pact, agreed last month, sees the possibility of American forces staying behind to train Afghan forces and pursue the remnants of al-Qaeda for 10 years after 2014.",4,8,pact,4,1,5
3B9J25CZ25EMOFV0K0PDE9NMN8MCSP,"The pact, agreed last month, sees the possibility of American forces staying behind to train Afghan forces and pursue the remnants of al-Qaeda for 10 years after 2014.",38,49,possibility,1,2,3
3B9J25CZ25EMOFV0K0PDE9NMN8MCSP,"The pact, agreed last month, sees the possibility of American forces staying behind to train Afghan forces and pursue the remnants of al-Qaeda for 10 years after 2014.",69,83,staying behind,0,1,1
3B9J25CZ25EMOFV0K0PDE9NMN8MCSP,"The pact, agreed last month, sees the possibility of American forces staying behind to train Afghan forces and pursue the remnants of al-Qaeda for 10 years after 2014.",111,117,pursue,6,8,14
3B9J25CZ25EMOFV0K0PDE9NMN8MCSP,"The pact, agreed last month, sees the possibility of American forces staying behind to train Afghan forces and pursue the remnants of al-Qaeda for 10 years after 2014.",122,130,remnants,10,10,20
3PZDSVZ3J5IMDYQGJP29WH1S9XLN42,"Putin officially registered on Wednesday to run for the presidency in March, but the unusually sustained protests of the past two days showed the indignation of the Russian opposition and suggested his drive to retake the job he held from 2000-2008 may not go as smoothly as expected.",6,16,officially,0,1,1
3PZDSVZ3J5IMDYQGJP29WH1S9XLN42,"Putin officially registered on Wednesday to run for the presidency in March, but the unusually sustained protests of the past two days showed the indignation of the Russian opposition and suggested his drive to retake the job he held from 2000-2008 may not go as smoothly as expected.",17,27,registered,0,1,1
3PZDSVZ3J5IMDYQGJP29WH1S9XLN42,"Putin officially registered on Wednesday to run for the presidency in March, but the unusually sustained protests of the past two days showed the indignation of the Russian opposition and suggested his drive to retake the job he held from 2000-2008 may not go as smoothly as expected.",56,66,presidency,0,1,1
3PZDSVZ3J5IMDYQGJP29WH1S9XLN42,"Putin officially registered on Wednesday to run for the presidency in March, but the unusually sustained protests of the past two days showed the indignation of the Russian opposition and suggested his drive to retake the job he held from 2000-2008 may not go as smoothly as expected.",85,94,unusually,1,0,1
3PZDSVZ3J5IMDYQGJP29WH1S9XLN42,"Putin officially registered on Wednesday to run for the presidency in March, but the unusually sustained protests of the past two days showed the indignation of the Russian opposition and suggested his drive to retake the job he held from 2000-2008 may not go as smoothly as expected.",85,104,unusually sustained,1,0,1
3PZDSVZ3J5IMDYQGJP29WH1S9XLN42,"Putin officially registered on Wednesday to run for the presidency in March, but the unusually sustained protests of the past two days showed the indignation of the Russian opposition and suggested his drive to retake the job he held from 2000-2008 may not go as smoothly as expected.",85,113,unusually sustained protests,1,0,1
3PZDSVZ3J5IMDYQGJP29WH1S9XLN42,"Putin officially registered on Wednesday to run for the presidency in March, but the unusually sustained protests of the past two days showed the indignation of the Russian opposition and suggested his drive to retake the job he held from 2000-2008 may not go as smoothly as expected.",95,104,sustained,9,6,15
3PZDSVZ3J5IMDYQGJP29WH1S9XLN42,"Putin officially registered on Wednesday to run for the presidency in March, but the unusually sustained protests of the past two days showed the indignation of the Russian opposition and suggested his drive to retake the job he held from 2000-2008 may not go as smoothly as expected.",95,113,sustained protests,1,3,4
3PZDSVZ3J5IMDYQGJP29WH1S9XLN42,"Putin officially registered on Wednesday to run for the presidency in March, but the unusually sustained protests of the past two days showed the indignation of the Russian opposition and suggested his drive to retake the job he held from 2000-2008 may not go as smoothly as expected.",105,113,protests,1,2,3
3PZDSVZ3J5IMDYQGJP29WH1S9XLN42,"Putin officially registered on Wednesday to run for the presidency in March, but the unusually sustained protests of the past two days showed the indignation of the Russian opposition and suggested his drive to retake the job he held from 2000-2008 may not go as smoothly as expected.",146,157,indignation,10,10,20
3PZDSVZ3J5IMDYQGJP29WH1S9XLN42,"Putin officially registered on Wednesday to run for the presidency in March, but the unusually sustained protests of the past two days showed the indignation of the Russian opposition and suggested his drive to retake the job he held from 2000-2008 may not go as smoothly as expected.",173,183,opposition,4,1,5
3PZDSVZ3J5IMDYQGJP29WH1S9XLN42,"Putin officially registered on Wednesday to run for the presidency in March, but the unusually sustained protests of the past two days showed the indignation of the Russian opposition and suggested his drive to retake the job he held from 2000-2008 may not go as smoothly as expected.",188,197,suggested,0,1,1
3PZDSVZ3J5IMDYQGJP29WH1S9XLN42,"Putin officially registered on Wednesday to run for the presidency in March, but the unusually sustained protests of the past two days showed the indignation of the Russian opposition and suggested his drive to retake the job he held from 2000-2008 may not go as smoothly as expected.",202,207,drive,0,1,1
3PZDSVZ3J5IMDYQGJP29WH1S9XLN42,"Putin officially registered on Wednesday to run for the presidency in March, but the unusually sustained protests of the past two days showed the indignation of the Russian opposition and suggested his drive to retake the job he held from 2000-2008 may not go as smoothly as expected.",211,217,retake,0,2,2
3PZDSVZ3J5IMDYQGJP29WH1S9XLN42,"Putin officially registered on Wednesday to run for the presidency in March, but the unusually sustained protests of the past two days showed the indignation of the Russian opposition and suggested his drive to retake the job he held from 2000-2008 may not go as smoothly as expected.",260,283,as smoothly as expected,1,0,1
3PZDSVZ3J5IMDYQGJP29WH1S9XLN42,"Putin officially registered on Wednesday to run for the presidency in March, but the unusually sustained protests of the past two days showed the indignation of the Russian opposition and suggested his drive to retake the job he held from 2000-2008 may not go as smoothly as expected.",263,271,smoothly,0,1,1
3PZDSVZ3J5IMDYQGJP29WH1S9XLN42,"Putin officially registered on Wednesday to run for the presidency in March, but the unusually sustained protests of the past two days showed the indignation of the Russian opposition and suggested his drive to retake the job he held from 2000-2008 may not go as smoothly as expected.",275,283,expected,0,1,1
3PZDSVZ3J5IMDYQGJP29WH1S9XLN42,"The Russian Union of Journalists on Wednesday condemned police violence and called for a probe into the dozens of attacks and arrests of journalists, describing them as ""an attempt to gag and intimidate society.""",46,55,condemned,9,10,19
3PZDSVZ3J5IMDYQGJP29WH1S9XLN42,"The Russian Union of Journalists on Wednesday condemned police violence and called for a probe into the dozens of attacks and arrests of journalists, describing them as ""an attempt to gag and intimidate society.""",63,71,violence,0,2,2
3PZDSVZ3J5IMDYQGJP29WH1S9XLN42,"The Russian Union of Journalists on Wednesday condemned police violence and called for a probe into the dozens of attacks and arrests of journalists, describing them as ""an attempt to gag and intimidate society.""",89,94,probe,2,8,10
3PZDSVZ3J5IMDYQGJP29WH1S9XLN42,"The Russian Union of Journalists on Wednesday condemned police violence and called for a probe into the dozens of attacks and arrests of journalists, describing them as ""an attempt to gag and intimidate society.""",104,110,dozens,0,1,1
3PZDSVZ3J5IMDYQGJP29WH1S9XLN42,"The Russian Union of Journalists on Wednesday condemned police violence and called for a probe into the dozens of attacks and arrests of journalists, describing them as ""an attempt to gag and intimidate society.""",150,160,describing,0,1,1
3PZDSVZ3J5IMDYQGJP29WH1S9XLN42,"The Russian Union of Journalists on Wednesday condemned police violence and called for a probe into the dozens of attacks and arrests of journalists, describing them as ""an attempt to gag and intimidate society.""",181,187,to gag,1,0,1
3PZDSVZ3J5IMDYQGJP29WH1S9XLN42,"The Russian Union of Journalists on Wednesday condemned police violence and called for a probe into the dozens of attacks and arrests of journalists, describing them as ""an attempt to gag and intimidate society.""",184,187,gag,6,10,16
3PZDSVZ3J5IMDYQGJP29WH1S9XLN42,"The Russian Union of Journalists on Wednesday condemned police violence and called for a probe into the dozens of attacks and arrests of journalists, describing them as ""an attempt to gag and intimidate society.""",184,202,gag and intimidate,1,0,1
3PZDSVZ3J5IMDYQGJP29WH1S9XLN42,"The Russian Union of Journalists on Wednesday condemned police violence and called for a probe into the dozens of attacks and arrests of journalists, describing them as ""an attempt to gag and intimidate society.""",192,202,intimidate,7,8,15
3PZDSVZ3J5IMDYQGJP29WH1S9XLN42,"The Russian Union of Journalists on Wednesday condemned police violence and called for a probe into the dozens of attacks and arrests of journalists, describing them as ""an attempt to gag and intimidate society.""",192,210,intimidate society,0,3,3
3PZDSVZ3J5IMDYQGJP29WH1S9XLN42,"More opposition rallies were expected Wednesday, along with a pro-Putin gathering in central Moscow that had attracted a few hundred people so far.",5,15,opposition,3,0,3
3PZDSVZ3J5IMDYQGJP29WH1S9XLN42,"More opposition rallies were expected Wednesday, along with a pro-Putin gathering in central Moscow that had attracted a few hundred people so far.",5,23,opposition rallies,5,0,5
3PZDSVZ3J5IMDYQGJP29WH1S9XLN42,"More opposition rallies were expected Wednesday, along with a pro-Putin gathering in central Moscow that had attracted a few hundred people so far.",16,23,rallies,0,4,4
3PZDSVZ3J5IMDYQGJP29WH1S9XLN42,"More opposition rallies were expected Wednesday, along with a pro-Putin gathering in central Moscow that had attracted a few hundred people so far.",62,71,pro-Putin,1,1,2
3PZDSVZ3J5IMDYQGJP29WH1S9XLN42,"More opposition rallies were expected Wednesday, along with a pro-Putin gathering in central Moscow that had attracted a few hundred people so far.",62,81,pro-Putin gathering,2,1,3
3PZDSVZ3J5IMDYQGJP29WH1S9XLN42,"More opposition rallies were expected Wednesday, along with a pro-Putin gathering in central Moscow that had attracted a few hundred people so far.",72,81,gathering,0,3,3
3PZDSVZ3J5IMDYQGJP29WH1S9XLN42,"Sunday's parliamentary vote suggested Russians are tiring of Putin and his United Russia party, which has strongly overshadowed all other political forces in Russia for the past dozen years and earned a reputation for corruption.",9,22,parliamentary,5,2,7
3PZDSVZ3J5IMDYQGJP29WH1S9XLN42,"Sunday's parliamentary vote suggested Russians are tiring of Putin and his United Russia party, which has strongly overshadowed all other political forces in Russia for the past dozen years and earned a reputation for corruption.",9,27,parliamentary vote,1,0,1
3PZDSVZ3J5IMDYQGJP29WH1S9XLN42,"Sunday's parliamentary vote suggested Russians are tiring of Putin and his United Russia party, which has strongly overshadowed all other political forces in Russia for the past dozen years and earned a reputation for corruption.",28,37,suggested,0,1,1
3PZDSVZ3J5IMDYQGJP29WH1S9XLN42,"Sunday's parliamentary vote suggested Russians are tiring of Putin and his United Russia party, which has strongly overshadowed all other political forces in Russia for the past dozen years and earned a reputation for corruption.",51,57,tiring,1,2,3
3PZDSVZ3J5IMDYQGJP29WH1S9XLN42,"Sunday's parliamentary vote suggested Russians are tiring of Putin and his United Russia party, which has strongly overshadowed all other political forces in Russia for the past dozen years and earned a reputation for corruption.",51,66,tiring of Putin,0,1,1
3PZDSVZ3J5IMDYQGJP29WH1S9XLN42,"Sunday's parliamentary vote suggested Russians are tiring of Putin and his United Russia party, which has strongly overshadowed all other political forces in Russia for the past dozen years and earned a reputation for corruption.",61,66,Putin,0,1,1
3PZDSVZ3J5IMDYQGJP29WH1S9XLN42,"Sunday's parliamentary vote suggested Russians are tiring of Putin and his United Russia party, which has strongly overshadowed all other political forces in Russia for the past dozen years and earned a reputation for corruption.",75,94,United Russia party,1,0,1
3PZDSVZ3J5IMDYQGJP29WH1S9XLN42,"Sunday's parliamentary vote suggested Russians are tiring of Putin and his United Russia party, which has strongly overshadowed all other political forces in Russia for the past dozen years and earned a reputation for corruption.",106,127,strongly overshadowed,1,0,1
3PZDSVZ3J5IMDYQGJP29WH1S9XLN42,"Sunday's parliamentary vote suggested Russians are tiring of Putin and his United Russia party, which has strongly overshadowed all other political forces in Russia for the past dozen years and earned a reputation for corruption.",115,127,overshadowed,7,10,17
3PZDSVZ3J5IMDYQGJP29WH1S9XLN42,"Sunday's parliamentary vote suggested Russians are tiring of Putin and his United Russia party, which has strongly overshadowed all other political forces in Russia for the past dozen years and earned a reputation for corruption.",138,154,political forces,1,0,1
3PZDSVZ3J5IMDYQGJP29WH1S9XLN42,"Sunday's parliamentary vote suggested Russians are tiring of Putin and his United Russia party, which has strongly overshadowed all other political forces in Russia for the past dozen years and earned a reputation for corruption.",203,213,reputation,5,4,9
3PZDSVZ3J5IMDYQGJP29WH1S9XLN42,"Sunday's parliamentary vote suggested Russians are tiring of Putin and his United Russia party, which has strongly overshadowed all other political forces in Russia for the past dozen years and earned a reputation for corruption.",203,228,reputation for corruption,1,0,1
3PZDSVZ3J5IMDYQGJP29WH1S9XLN42,"Sunday's parliamentary vote suggested Russians are tiring of Putin and his United Russia party, which has strongly overshadowed all other political forces in Russia for the past dozen years and earned a reputation for corruption.",218,228,corruption,7,6,13
3Z33IC0JC0N0I9512BKRN66LGRD9VA,The assault raises fresh concern about the resilience of the insurgency on the anniversary of Osama bin Laden's death as NATO winds down its combat presence in the next two years and hands over responsibility for security to Afghan forces.,4,11,assault,2,6,8
3Z33IC0JC0N0I9512BKRN66LGRD9VA,The assault raises fresh concern about the resilience of the insurgency on the anniversary of Osama bin Laden's death as NATO winds down its combat presence in the next two years and hands over responsibility for security to Afghan forces.,12,18,raises,1,1,2
3Z33IC0JC0N0I9512BKRN66LGRD9VA,The assault raises fresh concern about the resilience of the insurgency on the anniversary of Osama bin Laden's death as NATO winds down its combat presence in the next two years and hands over responsibility for security to Afghan forces.,12,32,raises fresh concern,1,0,1
3Z33IC0JC0N0I9512BKRN66LGRD9VA,The assault raises fresh concern about the resilience of the insurgency on the anniversary of Osama bin Laden's death as NATO winds down its combat presence in the next two years and hands over responsibility for security to Afghan forces.,19,32,fresh concern,1,0,1
3Z33IC0JC0N0I9512BKRN66LGRD9VA,The assault raises fresh concern about the resilience of the insurgency on the anniversary of Osama bin Laden's death as NATO winds down its combat presence in the next two years and hands over responsibility for security to Afghan forces.,25,32,concern,0,3,3
3Z33IC0JC0N0I9512BKRN66LGRD9VA,The assault raises fresh concern about the resilience of the insurgency on the anniversary of Osama bin Laden's death as NATO winds down its combat presence in the next two years and hands over responsibility for security to Afghan forces.,43,53,resilience,10,10,20
3Z33IC0JC0N0I9512BKRN66LGRD9VA,The assault raises fresh concern about the resilience of the insurgency on the anniversary of Osama bin Laden's death as NATO winds down its combat presence in the next two years and hands over responsibility for security to Afghan forces.,61,71,insurgency,10,9,19
3Z33IC0JC0N0I9512BKRN66LGRD9VA,The assault raises fresh concern about the resilience of the insurgency on the anniversary of Osama bin Laden's death as NATO winds down its combat presence in the next two years and hands over responsibility for security to Afghan forces.,79,90,anniversary,2,2,4
3Z33IC0JC0N0I9512BKRN66LGRD9VA,The assault raises fresh concern about the resilience of the insurgency on the anniversary of Osama bin Laden's death as NATO winds down its combat presence in the next two years and hands over responsibility for security to Afghan forces.,94,135,Osama bin Ladens death as NATO winds down,1,0,1
3Z33IC0JC0N0I9512BKRN66LGRD9VA,The assault raises fresh concern about the resilience of the insurgency on the anniversary of Osama bin Laden's death as NATO winds down its combat presence in the next two years and hands over responsibility for security to Afghan forces.,121,125,NATO,1,0,1
3Z33IC0JC0N0I9512BKRN66LGRD9VA,The assault raises fresh concern about the resilience of the insurgency on the anniversary of Osama bin Laden's death as NATO winds down its combat presence in the next two years and hands over responsibility for security to Afghan forces.,126,131,winds,0,1,1
3Z33IC0JC0N0I9512BKRN66LGRD9VA,The assault raises fresh concern about the resilience of the insurgency on the anniversary of Osama bin Laden's death as NATO winds down its combat presence in the next two years and hands over responsibility for security to Afghan forces.,126,136,winds down,0,2,2
3Z33IC0JC0N0I9512BKRN66LGRD9VA,The assault raises fresh concern about the resilience of the insurgency on the anniversary of Osama bin Laden's death as NATO winds down its combat presence in the next two years and hands over responsibility for security to Afghan forces.,141,147,combat,0,3,3
3Z33IC0JC0N0I9512BKRN66LGRD9VA,The assault raises fresh concern about the resilience of the insurgency on the anniversary of Osama bin Laden's death as NATO winds down its combat presence in the next two years and hands over responsibility for security to Afghan forces.,141,156,combat presence,1,0,1
3Z33IC0JC0N0I9512BKRN66LGRD9VA,The assault raises fresh concern about the resilience of the insurgency on the anniversary of Osama bin Laden's death as NATO winds down its combat presence in the next two years and hands over responsibility for security to Afghan forces.,148,156,presence,1,0,1
3Z33IC0JC0N0I9512BKRN66LGRD9VA,The assault raises fresh concern about the resilience of the insurgency on the anniversary of Osama bin Laden's death as NATO winds down its combat presence in the next two years and hands over responsibility for security to Afghan forces.,183,193,hands over,0,1,1
3Z33IC0JC0N0I9512BKRN66LGRD9VA,The assault raises fresh concern about the resilience of the insurgency on the anniversary of Osama bin Laden's death as NATO winds down its combat presence in the next two years and hands over responsibility for security to Afghan forces.,194,208,responsibility,1,0,1
3Z33IC0JC0N0I9512BKRN66LGRD9VA,"The Taliban said the assault was a riposte to Obama, who just hours earlier signed a new partnership pact in Kabul to govern Afghan-US relations after 2014 -- a deal the insurgents dismissed as ""illegitimate"".",21,28,assault,2,0,2
3Z33IC0JC0N0I9512BKRN66LGRD9VA,"The Taliban said the assault was a riposte to Obama, who just hours earlier signed a new partnership pact in Kabul to govern Afghan-US relations after 2014 -- a deal the insurgents dismissed as ""illegitimate"".",35,42,riposte,10,8,18
3Z33IC0JC0N0I9512BKRN66LGRD9VA,"The Taliban said the assault was a riposte to Obama, who just hours earlier signed a new partnership pact in Kabul to govern Afghan-US relations after 2014 -- a deal the insurgents dismissed as ""illegitimate"".",89,105,partnership pact,2,0,2
3Z33IC0JC0N0I9512BKRN66LGRD9VA,"The Taliban said the assault was a riposte to Obama, who just hours earlier signed a new partnership pact in Kabul to govern Afghan-US relations after 2014 -- a deal the insurgents dismissed as ""illegitimate"".",101,105,pact,1,0,1
3Z33IC0JC0N0I9512BKRN66LGRD9VA,"The Taliban said the assault was a riposte to Obama, who just hours earlier signed a new partnership pact in Kabul to govern Afghan-US relations after 2014 -- a deal the insurgents dismissed as ""illegitimate"".",161,165,deal,0,1,1
3Z33IC0JC0N0I9512BKRN66LGRD9VA,"The Taliban said the assault was a riposte to Obama, who just hours earlier signed a new partnership pact in Kabul to govern Afghan-US relations after 2014 -- a deal the insurgents dismissed as ""illegitimate"".",170,180,insurgents,7,4,11
3Z33IC0JC0N0I9512BKRN66LGRD9VA,"The Taliban said the assault was a riposte to Obama, who just hours earlier signed a new partnership pact in Kabul to govern Afghan-US relations after 2014 -- a deal the insurgents dismissed as ""illegitimate"".",170,190,insurgents dismissed,0,1,1
3Z33IC0JC0N0I9512BKRN66LGRD9VA,"The Taliban said the assault was a riposte to Obama, who just hours earlier signed a new partnership pact in Kabul to govern Afghan-US relations after 2014 -- a deal the insurgents dismissed as ""illegitimate"".",181,190,dismissed,0,3,3
3Z33IC0JC0N0I9512BKRN66LGRD9VA,"The Taliban said the assault was a riposte to Obama, who just hours earlier signed a new partnership pact in Kabul to govern Afghan-US relations after 2014 -- a deal the insurgents dismissed as ""illegitimate"".",195,207,illegitimate,10,9,19
3Z33IC0JC0N0I9512BKRN66LGRD9VA,"In an election-year address, Obama presented himself as a commander-in-chief capable of ending two long wars, following the US withdrawal from Iraq, and crushing Al-Qaeda, and tried to conjure up a new dawn for a US public exhausted by conflict and recession.",58,76,commander-in-chief,3,4,7
3Z33IC0JC0N0I9512BKRN66LGRD9VA,"In an election-year address, Obama presented himself as a commander-in-chief capable of ending two long wars, following the US withdrawal from Iraq, and crushing Al-Qaeda, and tried to conjure up a new dawn for a US public exhausted by conflict and recession.",77,84,capable,1,0,1
3Z33IC0JC0N0I9512BKRN66LGRD9VA,"In an election-year address, Obama presented himself as a commander-in-chief capable of ending two long wars, following the US withdrawal from Iraq, and crushing Al-Qaeda, and tried to conjure up a new dawn for a US public exhausted by conflict and recession.",124,147,US withdrawal from Iraq,1,0,1
3Z33IC0JC0N0I9512BKRN66LGRD9VA,"In an election-year address, Obama presented himself as a commander-in-chief capable of ending two long wars, following the US withdrawal from Iraq, and crushing Al-Qaeda, and tried to conjure up a new dawn for a US public exhausted by conflict and recession.",127,137,withdrawal,2,5,7
3Z33IC0JC0N0I9512BKRN66LGRD9VA,"In an election-year address, Obama presented himself as a commander-in-chief capable of ending two long wars, following the US withdrawal from Iraq, and crushing Al-Qaeda, and tried to conjure up a new dawn for a US public exhausted by conflict and recession.",153,161,crushing,0,1,1
3Z33IC0JC0N0I9512BKRN66LGRD9VA,"In an election-year address, Obama presented himself as a commander-in-chief capable of ending two long wars, following the US withdrawal from Iraq, and crushing Al-Qaeda, and tried to conjure up a new dawn for a US public exhausted by conflict and recession.",153,170,crushing Al-Qaeda,1,1,2
3Z33IC0JC0N0I9512BKRN66LGRD9VA,"In an election-year address, Obama presented himself as a commander-in-chief capable of ending two long wars, following the US withdrawal from Iraq, and crushing Al-Qaeda, and tried to conjure up a new dawn for a US public exhausted by conflict and recession.",176,222,tried to conjure up a new dawn for a US public,1,0,1
3Z33IC0JC0N0I9512BKRN66LGRD9VA,"In an election-year address, Obama presented himself as a commander-in-chief capable of ending two long wars, following the US withdrawal from Iraq, and crushing Al-Qaeda, and tried to conjure up a new dawn for a US public exhausted by conflict and recession.",185,192,conjure,6,10,16
3Z33IC0JC0N0I9512BKRN66LGRD9VA,"In an election-year address, Obama presented himself as a commander-in-chief capable of ending two long wars, following the US withdrawal from Iraq, and crushing Al-Qaeda, and tried to conjure up a new dawn for a US public exhausted by conflict and recession.",185,195,conjure up,3,2,5
3Z33IC0JC0N0I9512BKRN66LGRD9VA,"In an election-year address, Obama presented himself as a commander-in-chief capable of ending two long wars, following the US withdrawal from Iraq, and crushing Al-Qaeda, and tried to conjure up a new dawn for a US public exhausted by conflict and recession.",198,206,new dawn,0,1,1
3Z33IC0JC0N0I9512BKRN66LGRD9VA,"In an election-year address, Obama presented himself as a commander-in-chief capable of ending two long wars, following the US withdrawal from Iraq, and crushing Al-Qaeda, and tried to conjure up a new dawn for a US public exhausted by conflict and recession.",202,206,dawn,0,1,1
3Z33IC0JC0N0I9512BKRN66LGRD9VA,"In an election-year address, Obama presented himself as a commander-in-chief capable of ending two long wars, following the US withdrawal from Iraq, and crushing Al-Qaeda, and tried to conjure up a new dawn for a US public exhausted by conflict and recession.",223,232,exhausted,1,5,6
3Z33IC0JC0N0I9512BKRN66LGRD9VA,"In an election-year address, Obama presented himself as a commander-in-chief capable of ending two long wars, following the US withdrawal from Iraq, and crushing Al-Qaeda, and tried to conjure up a new dawn for a US public exhausted by conflict and recession.",236,244,conflict,1,2,3
3Z33IC0JC0N0I9512BKRN66LGRD9VA,"In an election-year address, Obama presented himself as a commander-in-chief capable of ending two long wars, following the US withdrawal from Iraq, and crushing Al-Qaeda, and tried to conjure up a new dawn for a US public exhausted by conflict and recession.",249,258,recession,4,5,9
3Z33IC0JC0N0I9512BKRN66LGRD9VA,"This time of war began in Afghanistan, and this is where it will end, Obama said, recalling a decade-long ""dark cloud of war"" after bin Laden plotted the September 11 attacks in 2001.",84,93,recalling,2,2,4
3Z33IC0JC0N0I9512BKRN66LGRD9VA,"This time of war began in Afghanistan, and this is where it will end, Obama said, recalling a decade-long ""dark cloud of war"" after bin Laden plotted the September 11 attacks in 2001.",96,107,decade-long,0,1,1
3Z33IC0JC0N0I9512BKRN66LGRD9VA,"This time of war began in Afghanistan, and this is where it will end, Obama said, recalling a decade-long ""dark cloud of war"" after bin Laden plotted the September 11 attacks in 2001.",109,126,dark cloud of war,2,1,3
3Z33IC0JC0N0I9512BKRN66LGRD9VA,"This time of war began in Afghanistan, and this is where it will end, Obama said, recalling a decade-long ""dark cloud of war"" after bin Laden plotted the September 11 attacks in 2001.",144,151,plotted,3,3,6
3TKXBROM5TBK2FYAPGCLXBUU4IEIJE,"Dozens more were wounded in Monday's violence, the UK-based Syrian Observatory for Human Rights said.",0,6,Dozens,0,1,1
3TKXBROM5TBK2FYAPGCLXBUU4IEIJE,"Dozens more were wounded in Monday's violence, the UK-based Syrian Observatory for Human Rights said.",17,24,wounded,0,3,3
3TKXBROM5TBK2FYAPGCLXBUU4IEIJE,"Dozens more were wounded in Monday's violence, the UK-based Syrian Observatory for Human Rights said.",37,45,violence,0,1,1
3TKXBROM5TBK2FYAPGCLXBUU4IEIJE,"Dozens more were wounded in Monday's violence, the UK-based Syrian Observatory for Human Rights said.",60,78,Syrian Observatory,0,1,1
3TKXBROM5TBK2FYAPGCLXBUU4IEIJE,"Dozens more were wounded in Monday's violence, the UK-based Syrian Observatory for Human Rights said.",67,78,Observatory,3,6,9
3TKXBROM5TBK2FYAPGCLXBUU4IEIJE,"Opposition sources also said the army had shelled the town, which they say has been under rebel control since January.",0,10,Opposition,6,0,6
3TKXBROM5TBK2FYAPGCLXBUU4IEIJE,"Opposition sources also said the army had shelled the town, which they say has been under rebel control since January.",0,18,Opposition sources,2,0,2
3TKXBROM5TBK2FYAPGCLXBUU4IEIJE,"Opposition sources also said the army had shelled the town, which they say has been under rebel control since January.",42,49,shelled,10,10,20
3TKXBROM5TBK2FYAPGCLXBUU4IEIJE,"Opposition sources also said the army had shelled the town, which they say has been under rebel control since January.",42,58,shelled the town,0,1,1
3TKXBROM5TBK2FYAPGCLXBUU4IEIJE,"Opposition sources also said the army had shelled the town, which they say has been under rebel control since January.",90,95,rebel,0,3,3
3TKXBROM5TBK2FYAPGCLXBUU4IEIJE,"Opposition sources also said the army had shelled the town, which they say has been under rebel control since January.",90,103,rebel control,2,1,3
3TKXBROM5TBK2FYAPGCLXBUU4IEIJE,Nine people were reportedly killed in the bombardment.,17,27,reportedly,0,1,1
3TKXBROM5TBK2FYAPGCLXBUU4IEIJE,Nine people were reportedly killed in the bombardment.,42,53,bombardment,10,10,20
3TKXBROM5TBK2FYAPGCLXBUU4IEIJE,"Shells and rockets have been hitting the town since 3am (12:00 GMT) at a rate of one a minute.	1	7	Shells	3	2	5
3TKXBROM5TBK2FYAPGCLXBUU4IEIJE	Rastan has been destroyed, a member of the opposition Free Syrian Army in Rastan who declined to be named told Reuters news agency by satellite phone.",16,25,destroyed,0,1,1
3TKXBROM5TBK2FYAPGCLXBUU4IEIJE,"Rastan has been destroyed,"" a member of the opposition Free Syrian Army in Rastan who declined to be named told Reuters news agency by satellite phone.",44,54,opposition,2,1,3
3TKXBROM5TBK2FYAPGCLXBUU4IEIJE,"Rastan has been destroyed,"" a member of the opposition Free Syrian Army in Rastan who declined to be named told Reuters news agency by satellite phone.",86,94,declined,1,6,7
3TKXBROM5TBK2FYAPGCLXBUU4IEIJE,"Rastan has been destroyed,"" a member of the opposition Free Syrian Army in Rastan who declined to be named told Reuters news agency by satellite phone.",86,106,declined to be named,1,0,1
3TKXBROM5TBK2FYAPGCLXBUU4IEIJE,"Rastan has been destroyed,"" a member of the opposition Free Syrian Army in Rastan who declined to be named told Reuters news agency by satellite phone.",112,119,Reuters,1,0,1
3TKXBROM5TBK2FYAPGCLXBUU4IEIJE,"Rastan has been destroyed,"" a member of the opposition Free Syrian Army in Rastan who declined to be named told Reuters news agency by satellite phone.",120,131,news agency,1,0,1
3TKXBROM5TBK2FYAPGCLXBUU4IEIJE,"Rastan has been destroyed,"" a member of the opposition Free Syrian Army in Rastan who declined to be named told Reuters news agency by satellite phone.",135,144,satellite,3,1,4
3TKXBROM5TBK2FYAPGCLXBUU4IEIJE,"Rastan has been destroyed,"" a member of the opposition Free Syrian Army in Rastan who declined to be named told Reuters news agency by satellite phone.",135,150,satellite phone,5,1,6
3TKXBROM5TBK2FYAPGCLXBUU4IEIJE,"Al Jazeera's Rula Amin, reporting from Beirut in neighbouring Lebanon, said three armoured vehicles carrying government troops had been attacked as they were heading to Rastan, in Homs province.",49,61,neighbouring,1,1,2
3TKXBROM5TBK2FYAPGCLXBUU4IEIJE,"Al Jazeera's Rula Amin, reporting from Beirut in neighbouring Lebanon, said three armoured vehicles carrying government troops had been attacked as they were heading to Rastan, in Homs province.",82,90,armoured,6,6,12
3TKXBROM5TBK2FYAPGCLXBUU4IEIJE,"Al Jazeera's Rula Amin, reporting from Beirut in neighbouring Lebanon, said three armoured vehicles carrying government troops had been attacked as they were heading to Rastan, in Homs province.",82,99,armoured vehicles,2,2,4
3TKXBROM5TBK2FYAPGCLXBUU4IEIJE,"Al Jazeera's Rula Amin, reporting from Beirut in neighbouring Lebanon, said three armoured vehicles carrying government troops had been attacked as they were heading to Rastan, in Homs province.",109,119,government,1,0,1
3TKXBROM5TBK2FYAPGCLXBUU4IEIJE,"Al Jazeera's Rula Amin, reporting from Beirut in neighbouring Lebanon, said three armoured vehicles carrying government troops had been attacked as they were heading to Rastan, in Homs province.",120,126,troops,0,1,1
3TKXBROM5TBK2FYAPGCLXBUU4IEIJE,"Al Jazeera's Rula Amin, reporting from Beirut in neighbouring Lebanon, said three armoured vehicles carrying government troops had been attacked as they were heading to Rastan, in Homs province.",158,168,heading to,1,0,1
3TKXBROM5TBK2FYAPGCLXBUU4IEIJE,"Al Jazeera's Rula Amin, reporting from Beirut in neighbouring Lebanon, said three armoured vehicles carrying government troops had been attacked as they were heading to Rastan, in Homs province.",185,193,province,2,2,4
3TKXBROM5TBK2FYAPGCLXBUU4IEIJE,"Rastan is a strategic town and a stronghold of the Free Syrian Army, she said.",13,22,strategic,6,10,16
3TKXBROM5TBK2FYAPGCLXBUU4IEIJE,"Rastan is a strategic town and a stronghold of the Free Syrian Army, she said.",13,27,strategic town,2,0,2
3TKXBROM5TBK2FYAPGCLXBUU4IEIJE,"Rastan is a strategic town and a stronghold of the Free Syrian Army, she said.",34,44,stronghold,9,10,19
3PUOXASB574HRTAB389U8CJH5379Z1,Lebanon's national news agency NNA said one soldier was shot dead by a sniper in the city early Sunday.,10,18,national,1,0,1
3PUOXASB574HRTAB389U8CJH5379Z1,Lebanon's national news agency NNA said one soldier was shot dead by a sniper in the city early Sunday.,24,30,agency,2,0,2
3PUOXASB574HRTAB389U8CJH5379Z1,Lebanon's national news agency NNA said one soldier was shot dead by a sniper in the city early Sunday.,71,77,sniper,9,10,19
3PUOXASB574HRTAB389U8CJH5379Z1,Another man was found dead on the side of a road while a third died after a shell landed in a residential neighborhood.,76,81,shell,3,6,9
3PUOXASB574HRTAB389U8CJH5379Z1,Another man was found dead on the side of a road while a third died after a shell landed in a residential neighborhood.,94,105,residential,7,0,7
3PUOXASB574HRTAB389U8CJH5379Z1,Another man was found dead on the side of a road while a third died after a shell landed in a residential neighborhood.,94,118,residential neighborhood,2,1,3
3PUOXASB574HRTAB389U8CJH5379Z1,Another man was found dead on the side of a road while a third died after a shell landed in a residential neighborhood.,106,118,neighborhood,0,1,1
3PUOXASB574HRTAB389U8CJH5379Z1,"An Associated Press reporter in Tripoli said the Lebanese army sent reinforcements to the city, but that intermittent clashes continued Sunday with gunmen shooting at each other with automatic rifles.",3,13,Associated,1,0,1
3PUOXASB574HRTAB389U8CJH5379Z1,"An Associated Press reporter in Tripoli said the Lebanese army sent reinforcements to the city, but that intermittent clashes continued Sunday with gunmen shooting at each other with automatic rifles.",20,28,reporter,1,0,1
3PUOXASB574HRTAB389U8CJH5379Z1,"An Associated Press reporter in Tripoli said the Lebanese army sent reinforcements to the city, but that intermittent clashes continued Sunday with gunmen shooting at each other with automatic rifles.",68,82,reinforcements,10,10,20
3PUOXASB574HRTAB389U8CJH5379Z1,"An Associated Press reporter in Tripoli said the Lebanese army sent reinforcements to the city, but that intermittent clashes continued Sunday with gunmen shooting at each other with automatic rifles.",105,117,intermittent,8,10,18
3PUOXASB574HRTAB389U8CJH5379Z1,"An Associated Press reporter in Tripoli said the Lebanese army sent reinforcements to the city, but that intermittent clashes continued Sunday with gunmen shooting at each other with automatic rifles.",105,125,intermittent clashes,4,3,7
3PUOXASB574HRTAB389U8CJH5379Z1,"An Associated Press reporter in Tripoli said the Lebanese army sent reinforcements to the city, but that intermittent clashes continued Sunday with gunmen shooting at each other with automatic rifles.",118,125,clashes,0,2,2
3PUOXASB574HRTAB389U8CJH5379Z1,"An Associated Press reporter in Tripoli said the Lebanese army sent reinforcements to the city, but that intermittent clashes continued Sunday with gunmen shooting at each other with automatic rifles.",126,135,continued,1,0,1
3PUOXASB574HRTAB389U8CJH5379Z1,"An Associated Press reporter in Tripoli said the Lebanese army sent reinforcements to the city, but that intermittent clashes continued Sunday with gunmen shooting at each other with automatic rifles.",148,154,gunmen,2,1,3
3PUOXASB574HRTAB389U8CJH5379Z1,"An Associated Press reporter in Tripoli said the Lebanese army sent reinforcements to the city, but that intermittent clashes continued Sunday with gunmen shooting at each other with automatic rifles.",183,192,automatic,1,0,1
3PUOXASB574HRTAB389U8CJH5379Z1,"An Associated Press reporter in Tripoli said the Lebanese army sent reinforcements to the city, but that intermittent clashes continued Sunday with gunmen shooting at each other with automatic rifles.",183,199,automatic rifles,1,0,1
3PUOXASB574HRTAB389U8CJH5379Z1,"An Associated Press reporter in Tripoli said the Lebanese army sent reinforcements to the city, but that intermittent clashes continued Sunday with gunmen shooting at each other with automatic rifles.",193,199,rifles,0,2,2
3PUOXASB574HRTAB389U8CJH5379Z1,"Heavier weapons, like rocket-propelled grenades, have also been fired.",22,38,rocket-propelled,3,4,7
3PUOXASB574HRTAB389U8CJH5379Z1,"Heavier weapons, like rocket-propelled grenades, have also been fired.",22,47,rocket-propelled grenades,2,1,3
3PUOXASB574HRTAB389U8CJH5379Z1,"Heavier weapons, like rocket-propelled grenades, have also been fired.",39,47,grenades,6,2,8
3PUOXASB574HRTAB389U8CJH5379Z1,"Lebanon is sharply split along sectarian lines, with 18 religious sects.",11,18,sharply,0,1,1
3PUOXASB574HRTAB389U8CJH5379Z1,"Lebanon is sharply split along sectarian lines, with 18 religious sects.",31,40,sectarian,8,5,13
3PUOXASB574HRTAB389U8CJH5379Z1,"Lebanon is sharply split along sectarian lines, with 18 religious sects.",31,46,sectarian lines,3,4,7
3PUOXASB574HRTAB389U8CJH5379Z1,"Lebanon is sharply split along sectarian lines, with 18 religious sects.",56,71,religious sects,1,1,2
3PUOXASB574HRTAB389U8CJH5379Z1,"Lebanon is sharply split along sectarian lines, with 18 religious sects.",66,71,sects,3,3,6
3PUOXASB574HRTAB389U8CJH5379Z1,But it also has a fragile political fault line precisely over the issue of Syria.,18,25,fragile,7,10,17
3PUOXASB574HRTAB389U8CJH5379Z1,But it also has a fragile political fault line precisely over the issue of Syria.,18,35,fragile political,1,0,1
3PUOXASB574HRTAB389U8CJH5379Z1,But it also has a fragile political fault line precisely over the issue of Syria.,18,46,fragile political fault line,3,0,3
3PUOXASB574HRTAB389U8CJH5379Z1,But it also has a fragile political fault line precisely over the issue of Syria.,26,46,political fault line,1,1,2
3PUOXASB574HRTAB389U8CJH5379Z1,But it also has a fragile political fault line precisely over the issue of Syria.,36,46,fault line,2,0,2
3PUOXASB574HRTAB389U8CJH5379Z1,But it also has a fragile political fault line precisely over the issue of Syria.,47,56,precisely,4,3,7
3PUOXASB574HRTAB389U8CJH5379Z1,"An array of pro-Syrian parties support Assad's regime, as do many Lebanese citizens.",3,8,array,4,4,8
3PUOXASB574HRTAB389U8CJH5379Z1,"An array of pro-Syrian parties support Assad's regime, as do many Lebanese citizens.",12,30,pro-Syrian parties,1,0,1
3PUOXASB574HRTAB389U8CJH5379Z1,"An array of pro-Syrian parties support Assad's regime, as do many Lebanese citizens.",47,53,regime,6,5,11
3PUOXASB574HRTAB389U8CJH5379Z1,"An array of pro-Syrian parties support Assad's regime, as do many Lebanese citizens.",75,83,citizens,0,3,3
3KWGG5KP6J3JQKIV03TR20OGWKSCM4,"More opposition rallies were expected Wednesday, along with another new pro-Putin gathering in central Moscow.",5,15,opposition,3,0,3
3KWGG5KP6J3JQKIV03TR20OGWKSCM4,"More opposition rallies were expected Wednesday, along with another new pro-Putin gathering in central Moscow.",5,23,opposition rallies,9,0,9
3KWGG5KP6J3JQKIV03TR20OGWKSCM4,"More opposition rallies were expected Wednesday, along with another new pro-Putin gathering in central Moscow.",16,23,rallies,5,4,9
3KWGG5KP6J3JQKIV03TR20OGWKSCM4,"More opposition rallies were expected Wednesday, along with another new pro-Putin gathering in central Moscow.",29,37,expected,0,1,1
3KWGG5KP6J3JQKIV03TR20OGWKSCM4,"More opposition rallies were expected Wednesday, along with another new pro-Putin gathering in central Moscow.",72,81,pro-Putin,1,0,1
3KWGG5KP6J3JQKIV03TR20OGWKSCM4,"More opposition rallies were expected Wednesday, along with another new pro-Putin gathering in central Moscow.",72,91,pro-Putin gathering,2,0,2
3KWGG5KP6J3JQKIV03TR20OGWKSCM4,"More opposition rallies were expected Wednesday, along with another new pro-Putin gathering in central Moscow.",82,91,gathering,0,4,4
3KWGG5KP6J3JQKIV03TR20OGWKSCM4,"Thousands of security forces were out in the Russian capital and helicopters roamed the sky Wednesday, a show of force following two days of protest.",0,9,Thousands,1,0,1
3KWGG5KP6J3JQKIV03TR20OGWKSCM4,"Thousands of security forces were out in the Russian capital and helicopters roamed the sky Wednesday, a show of force following two days of protest.",13,21,security,1,0,1
3KWGG5KP6J3JQKIV03TR20OGWKSCM4,"Thousands of security forces were out in the Russian capital and helicopters roamed the sky Wednesday, a show of force following two days of protest.",13,28,security forces,4,0,4
3KWGG5KP6J3JQKIV03TR20OGWKSCM4,"Thousands of security forces were out in the Russian capital and helicopters roamed the sky Wednesday, a show of force following two days of protest.",65,76,helicopters,1,0,1
3KWGG5KP6J3JQKIV03TR20OGWKSCM4,"Thousands of security forces were out in the Russian capital and helicopters roamed the sky Wednesday, a show of force following two days of protest.",77,83,roamed,2,5,7
3KWGG5KP6J3JQKIV03TR20OGWKSCM4,"Thousands of security forces were out in the Russian capital and helicopters roamed the sky Wednesday, a show of force following two days of protest.",105,118,show of force,3,0,3
3KWGG5KP6J3JQKIV03TR20OGWKSCM4,"Thousands of security forces were out in the Russian capital and helicopters roamed the sky Wednesday, a show of force following two days of protest.",141,148,protest,0,2,2
3KWGG5KP6J3JQKIV03TR20OGWKSCM4,"Authorities said Tuesday at least 51,500 police officers and 2,000 Interior Ministry troops have been deployed in Moscow since the election.",0,11,Authorities,0,3,3
3KWGG5KP6J3JQKIV03TR20OGWKSCM4,"Authorities said Tuesday at least 51,500 police officers and 2,000 Interior Ministry troops have been deployed in Moscow since the election.",67,84,Interior Ministry,1,0,1
3KWGG5KP6J3JQKIV03TR20OGWKSCM4,"Authorities said Tuesday at least 51,500 police officers and 2,000 Interior Ministry troops have been deployed in Moscow since the election.",67,91,Interior Ministry troops,3,0,3
3KWGG5KP6J3JQKIV03TR20OGWKSCM4,"Authorities said Tuesday at least 51,500 police officers and 2,000 Interior Ministry troops have been deployed in Moscow since the election.",85,91,troops,0,1,1
3KWGG5KP6J3JQKIV03TR20OGWKSCM4,"Authorities said Tuesday at least 51,500 police officers and 2,000 Interior Ministry troops have been deployed in Moscow since the election.",102,110,deployed,9,10,19
3KWGG5KP6J3JQKIV03TR20OGWKSCM4,"Unlike the police, Interior Ministry troops are an armed force, largely manned by conscripts.",19,36,Interior Ministry,0,1,1
3KWGG5KP6J3JQKIV03TR20OGWKSCM4,"Unlike the police, Interior Ministry troops are an armed force, largely manned by conscripts.",19,43,Interior Ministry troops,2,0,2
3KWGG5KP6J3JQKIV03TR20OGWKSCM4,"Unlike the police, Interior Ministry troops are an armed force, largely manned by conscripts.",72,78,manned,3,6,9
3KWGG5KP6J3JQKIV03TR20OGWKSCM4,"Unlike the police, Interior Ministry troops are an armed force, largely manned by conscripts.",72,92,manned by conscripts,1,0,1
3KWGG5KP6J3JQKIV03TR20OGWKSCM4,"Unlike the police, Interior Ministry troops are an armed force, largely manned by conscripts.",82,92,conscripts,10,10,20
3KWGG5KP6J3JQKIV03TR20OGWKSCM4,"The Russian Union of Journalists condemned police violence and called for a probe into the dozens of attacks and arrests of journalists, describing them as ""an attempt to gag and intimidate society.""",33,42,condemned,10,8,18
3KWGG5KP6J3JQKIV03TR20OGWKSCM4,"The Russian Union of Journalists condemned police violence and called for a probe into the dozens of attacks and arrests of journalists, describing them as ""an attempt to gag and intimidate society.""",50,58,violence,0,1,1
3KWGG5KP6J3JQKIV03TR20OGWKSCM4,"The Russian Union of Journalists condemned police violence and called for a probe into the dozens of attacks and arrests of journalists, describing them as ""an attempt to gag and intimidate society.""",76,81,probe,6,6,12
3KWGG5KP6J3JQKIV03TR20OGWKSCM4,"The Russian Union of Journalists condemned police violence and called for a probe into the dozens of attacks and arrests of journalists, describing them as ""an attempt to gag and intimidate society.""",101,108,attacks,1,0,1
3KWGG5KP6J3JQKIV03TR20OGWKSCM4,"The Russian Union of Journalists condemned police violence and called for a probe into the dozens of attacks and arrests of journalists, describing them as ""an attempt to gag and intimidate society.""",124,135,journalists,1,0,1
3KWGG5KP6J3JQKIV03TR20OGWKSCM4,"The Russian Union of Journalists condemned police violence and called for a probe into the dozens of attacks and arrests of journalists, describing them as ""an attempt to gag and intimidate society.""",137,147,describing,0,1,1
3KWGG5KP6J3JQKIV03TR20OGWKSCM4,"The Russian Union of Journalists condemned police violence and called for a probe into the dozens of attacks and arrests of journalists, describing them as ""an attempt to gag and intimidate society.""",160,167,attempt,0,1,1
3KWGG5KP6J3JQKIV03TR20OGWKSCM4,"The Russian Union of Journalists condemned police violence and called for a probe into the dozens of attacks and arrests of journalists, describing them as ""an attempt to gag and intimidate society.""",160,174,attempt to gag,1,1,2
3KWGG5KP6J3JQKIV03TR20OGWKSCM4,"The Russian Union of Journalists condemned police violence and called for a probe into the dozens of attacks and arrests of journalists, describing them as ""an attempt to gag and intimidate society.""",160,197,attempt to gag and intimidate society,1,0,1
3KWGG5KP6J3JQKIV03TR20OGWKSCM4,"The Russian Union of Journalists condemned police violence and called for a probe into the dozens of attacks and arrests of journalists, describing them as ""an attempt to gag and intimidate society.""",171,174,gag,7,5,12
3KWGG5KP6J3JQKIV03TR20OGWKSCM4,"The Russian Union of Journalists condemned police violence and called for a probe into the dozens of attacks and arrests of journalists, describing them as ""an attempt to gag and intimidate society.""",171,189,gag and intimidate,1,1,2
3KWGG5KP6J3JQKIV03TR20OGWKSCM4,"The Russian Union of Journalists condemned police violence and called for a probe into the dozens of attacks and arrests of journalists, describing them as ""an attempt to gag and intimidate society.""",179,189,intimidate,7,6,13
3KWGG5KP6J3JQKIV03TR20OGWKSCM4,"The Russian Union of Journalists condemned police violence and called for a probe into the dozens of attacks and arrests of journalists, describing them as ""an attempt to gag and intimidate society.""",179,197,intimidate society,1,1,2
3KWGG5KP6J3JQKIV03TR20OGWKSCM4,"On Wednesday, two video journalists working for the state-owned RIA Novosti news agency were briefly detained outside the Election Commission building where Putin was handing in his application to run.",18,35,video journalists,1,0,1
3KWGG5KP6J3JQKIV03TR20OGWKSCM4,"On Wednesday, two video journalists working for the state-owned RIA Novosti news agency were briefly detained outside the Election Commission building where Putin was handing in his application to run.",24,35,journalists,1,0,1
3KWGG5KP6J3JQKIV03TR20OGWKSCM4,"On Wednesday, two video journalists working for the state-owned RIA Novosti news agency were briefly detained outside the Election Commission building where Putin was handing in his application to run.",52,63,state-owned,0,2,2
3KWGG5KP6J3JQKIV03TR20OGWKSCM4,"On Wednesday, two video journalists working for the state-owned RIA Novosti news agency were briefly detained outside the Election Commission building where Putin was handing in his application to run.",52,87,state-owned RIA Novosti news agency,1,0,1
3KWGG5KP6J3JQKIV03TR20OGWKSCM4,"On Wednesday, two video journalists working for the state-owned RIA Novosti news agency were briefly detained outside the Election Commission building where Putin was handing in his application to run.",64,75,RIA Novosti,1,0,1
3KWGG5KP6J3JQKIV03TR20OGWKSCM4,"On Wednesday, two video journalists working for the state-owned RIA Novosti news agency were briefly detained outside the Election Commission building where Putin was handing in his application to run.",93,109,briefly detained,1,1,2
3KWGG5KP6J3JQKIV03TR20OGWKSCM4,"On Wednesday, two video journalists working for the state-owned RIA Novosti news agency were briefly detained outside the Election Commission building where Putin was handing in his application to run.",101,109,detained,8,4,12
3KWGG5KP6J3JQKIV03TR20OGWKSCM4,"On Wednesday, two video journalists working for the state-owned RIA Novosti news agency were briefly detained outside the Election Commission building where Putin was handing in his application to run.",131,141,Commission,1,0,1
3KWGG5KP6J3JQKIV03TR20OGWKSCM4,"On Wednesday, two video journalists working for the state-owned RIA Novosti news agency were briefly detained outside the Election Commission building where Putin was handing in his application to run.",182,193,application,0,1,1
3JUDR1D0D6SXDHOLV3B27WZZTH9Q22,Hajar said his cousin was not affiliated with any terrorist group.,30,40,affiliated,10,9,19
3JUDR1D0D6SXDHOLV3B27WZZTH9Q22,Hajar said his cousin was not affiliated with any terrorist group.,50,59,terrorist,1,1,2
3JUDR1D0D6SXDHOLV3B27WZZTH9Q22,CNN cannot independently verify reports of deaths and violence because the Syrian government has severely restricted access to international media.,11,24,independently,2,1,3
3JUDR1D0D6SXDHOLV3B27WZZTH9Q22,CNN cannot independently verify reports of deaths and violence because the Syrian government has severely restricted access to international media.,11,31,independently verify,2,0,2
3JUDR1D0D6SXDHOLV3B27WZZTH9Q22,CNN cannot independently verify reports of deaths and violence because the Syrian government has severely restricted access to international media.,25,31,verify,2,0,2
3JUDR1D0D6SXDHOLV3B27WZZTH9Q22,CNN cannot independently verify reports of deaths and violence because the Syrian government has severely restricted access to international media.,54,62,violence,0,1,1
3JUDR1D0D6SXDHOLV3B27WZZTH9Q22,CNN cannot independently verify reports of deaths and violence because the Syrian government has severely restricted access to international media.,97,105,severely,0,1,1
3JUDR1D0D6SXDHOLV3B27WZZTH9Q22,CNN cannot independently verify reports of deaths and violence because the Syrian government has severely restricted access to international media.,97,116,severely restricted,2,1,3
3JUDR1D0D6SXDHOLV3B27WZZTH9Q22,CNN cannot independently verify reports of deaths and violence because the Syrian government has severely restricted access to international media.,97,123,severely restricted access,1,0,1
3JUDR1D0D6SXDHOLV3B27WZZTH9Q22,CNN cannot independently verify reports of deaths and violence because the Syrian government has severely restricted access to international media.,106,116,restricted,4,2,6
3JUDR1D0D6SXDHOLV3B27WZZTH9Q22,CNN cannot independently verify reports of deaths and violence because the Syrian government has severely restricted access to international media.,106,123,restricted access,2,0,2
3JUDR1D0D6SXDHOLV3B27WZZTH9Q22,CNN cannot independently verify reports of deaths and violence because the Syrian government has severely restricted access to international media.,117,123,access,1,2,3
3JUDR1D0D6SXDHOLV3B27WZZTH9Q22,A team of U.N. monitors is on the ground to observe the progress of a so-called cease-fire and encourage the implementation of the peace plan.,15,23,monitors,3,0,3
3JUDR1D0D6SXDHOLV3B27WZZTH9Q22,A team of U.N. monitors is on the ground to observe the progress of a so-called cease-fire and encourage the implementation of the peace plan.,70,79,so-called,1,1,2
3JUDR1D0D6SXDHOLV3B27WZZTH9Q22,A team of U.N. monitors is on the ground to observe the progress of a so-called cease-fire and encourage the implementation of the peace plan.,70,90,so-called cease-fire,2,1,3
3JUDR1D0D6SXDHOLV3B27WZZTH9Q22,A team of U.N. monitors is on the ground to observe the progress of a so-called cease-fire and encourage the implementation of the peace plan.,80,90,cease-fire,5,8,13
3JUDR1D0D6SXDHOLV3B27WZZTH9Q22,A team of U.N. monitors is on the ground to observe the progress of a so-called cease-fire and encourage the implementation of the peace plan.,95,104,encourage,1,2,3
3JUDR1D0D6SXDHOLV3B27WZZTH9Q22,A team of U.N. monitors is on the ground to observe the progress of a so-called cease-fire and encourage the implementation of the peace plan.,95,123,encourage the implementation,1,0,1
3JUDR1D0D6SXDHOLV3B27WZZTH9Q22,A team of U.N. monitors is on the ground to observe the progress of a so-called cease-fire and encourage the implementation of the peace plan.,109,123,implementation,10,7,17
3JUDR1D0D6SXDHOLV3B27WZZTH9Q22,A team of U.N. monitors is on the ground to observe the progress of a so-called cease-fire and encourage the implementation of the peace plan.,131,141,peace plan,1,0,1
3JUDR1D0D6SXDHOLV3B27WZZTH9Q22,"On Saturday, the head of the U.N. observer mission, Maj. Gen. Robert Mood, said 157 civilian and military monitors were in the provinces of Daraa, Idleb, Hama and Homs, the state-run Syrian Arab News Agency reported.",34,50,observer mission,1,1,2
3JUDR1D0D6SXDHOLV3B27WZZTH9Q22,"On Saturday, the head of the U.N. observer mission, Maj. Gen. Robert Mood, said 157 civilian and military monitors were in the provinces of Daraa, Idleb, Hama and Homs, the state-run Syrian Arab News Agency reported.",97,114,military monitors,2,1,3
3JUDR1D0D6SXDHOLV3B27WZZTH9Q22,"On Saturday, the head of the U.N. observer mission, Maj. Gen. Robert Mood, said 157 civilian and military monitors were in the provinces of Daraa, Idleb, Hama and Homs, the state-run Syrian Arab News Agency reported.",106,114,monitors,2,2,4
3JUDR1D0D6SXDHOLV3B27WZZTH9Q22,"On Saturday, the head of the U.N. observer mission, Maj. Gen. Robert Mood, said 157 civilian and military monitors were in the provinces of Daraa, Idleb, Hama and Homs, the state-run Syrian Arab News Agency reported.",127,136,provinces,5,2,7
3JUDR1D0D6SXDHOLV3B27WZZTH9Q22,"On Saturday, the head of the U.N. observer mission, Maj. Gen. Robert Mood, said 157 civilian and military monitors were in the provinces of Daraa, Idleb, Hama and Homs, the state-run Syrian Arab News Agency reported.",140,152,"Daraa, Idleb",1,0,1
3JUDR1D0D6SXDHOLV3B27WZZTH9Q22,"On Saturday, the head of the U.N. observer mission, Maj. Gen. Robert Mood, said 157 civilian and military monitors were in the provinces of Daraa, Idleb, Hama and Homs, the state-run Syrian Arab News Agency reported.",173,182,state-run,0,2,2
3JUDR1D0D6SXDHOLV3B27WZZTH9Q22,About 300 observers are expected within weeks.,10,19,observers,0,1,1
3JUDR1D0D6SXDHOLV3B27WZZTH9Q22,But the observers' presence hasn't stopped the bloodshed.,8,17,observers,0,1,1
3JUDR1D0D6SXDHOLV3B27WZZTH9Q22,But the observers' presence hasn't stopped the bloodshed.,19,27,presence,1,0,1
3JUDR1D0D6SXDHOLV3B27WZZTH9Q22,But the observers' presence hasn't stopped the bloodshed.,47,56,bloodshed,8,7,15
3JUDR1D0D6SXDHOLV3B27WZZTH9Q22,"More than 1,000 people have died in Syria since a cease-fire was supposed to go into effect on April 12, according to the LCC.",50,60,cease-fire,7,2,9
3JUDR1D0D6SXDHOLV3B27WZZTH9Q22,"More than 1,000 people have died in Syria since a cease-fire was supposed to go into effect on April 12, according to the LCC.",65,73,supposed,0,2,2
3JUDR1D0D6SXDHOLV3B27WZZTH9Q22,"More than 1,000 people have died in Syria since a cease-fire was supposed to go into effect on April 12, according to the LCC.",118,125,the LCC,1,0,1
3GL25Y6843V7TITQRZPEGD9QW1SMXP,"Obama's visit came a year after U.S. special forces troops killed al Qaeda leader Osama bin Laden, the architect of the September 11, 2001, attacks, in a raid in neighboring Pakistan.",37,51,special forces,1,0,1
3GL25Y6843V7TITQRZPEGD9QW1SMXP,"Obama's visit came a year after U.S. special forces troops killed al Qaeda leader Osama bin Laden, the architect of the September 11, 2001, attacks, in a raid in neighboring Pakistan.",37,58,special forces troops,2,0,2
3GL25Y6843V7TITQRZPEGD9QW1SMXP,"Obama's visit came a year after U.S. special forces troops killed al Qaeda leader Osama bin Laden, the architect of the September 11, 2001, attacks, in a raid in neighboring Pakistan.",66,74,al Qaeda,1,0,1
3GL25Y6843V7TITQRZPEGD9QW1SMXP,"Obama's visit came a year after U.S. special forces troops killed al Qaeda leader Osama bin Laden, the architect of the September 11, 2001, attacks, in a raid in neighboring Pakistan.",82,97,Osama bin Laden,1,0,1
3GL25Y6843V7TITQRZPEGD9QW1SMXP,"Obama's visit came a year after U.S. special forces troops killed al Qaeda leader Osama bin Laden, the architect of the September 11, 2001, attacks, in a raid in neighboring Pakistan.",103,112,architect,9,7,16
3GL25Y6843V7TITQRZPEGD9QW1SMXP,"Obama's visit came a year after U.S. special forces troops killed al Qaeda leader Osama bin Laden, the architect of the September 11, 2001, attacks, in a raid in neighboring Pakistan.",149,158,in a raid,0,1,1
3GL25Y6843V7TITQRZPEGD9QW1SMXP,"Obama's visit came a year after U.S. special forces troops killed al Qaeda leader Osama bin Laden, the architect of the September 11, 2001, attacks, in a raid in neighboring Pakistan.",154,158,raid,3,1,4
3GL25Y6843V7TITQRZPEGD9QW1SMXP,"Obama's visit came a year after U.S. special forces troops killed al Qaeda leader Osama bin Laden, the architect of the September 11, 2001, attacks, in a raid in neighboring Pakistan.",162,173,neighboring,1,2,3
3GL25Y6843V7TITQRZPEGD9QW1SMXP,"In a televised address to the American people from a base north of Kabul, he said the war in Afghanistan was winding down.",5,14,televised,1,1,2
3GL25Y6843V7TITQRZPEGD9QW1SMXP,"In a televised address to the American people from a base north of Kabul, he said the war in Afghanistan was winding down.",5,22,televised address,3,1,4
3GL25Y6843V7TITQRZPEGD9QW1SMXP,"In a televised address to the American people from a base north of Kabul, he said the war in Afghanistan was winding down.",53,57,base,2,0,2
3GL25Y6843V7TITQRZPEGD9QW1SMXP,"In a televised address to the American people from a base north of Kabul, he said the war in Afghanistan was winding down.",109,116,winding,0,3,3
3GL25Y6843V7TITQRZPEGD9QW1SMXP,"In a televised address to the American people from a base north of Kabul, he said the war in Afghanistan was winding down.",109,121,winding down,3,7,10
3GL25Y6843V7TITQRZPEGD9QW1SMXP,"As we emerge from a decade of conflict abroad and economic crisis at home, it's time to renew America, Obama said, speaking against a backdrop of armored vehicles and a U.S. flag.",7,13,emerge,7,6,13
3GL25Y6843V7TITQRZPEGD9QW1SMXP,"As we emerge from a decade of conflict abroad and economic crisis at home, it's time to renew America, Obama said, speaking against a backdrop of armored vehicles and a U.S. flag.",21,27,decade,1,3,4
3GL25Y6843V7TITQRZPEGD9QW1SMXP,"As we emerge from a decade of conflict abroad and economic crisis at home, it's time to renew America, Obama said, speaking against a backdrop of armored vehicles and a U.S. flag.",21,39,decade of conflict,0,1,1
3GL25Y6843V7TITQRZPEGD9QW1SMXP,"As we emerge from a decade of conflict abroad and economic crisis at home, it's time to renew America, Obama said, speaking against a backdrop of armored vehicles and a U.S. flag.",31,39,conflict,1,4,5
3GL25Y6843V7TITQRZPEGD9QW1SMXP,"As we emerge from a decade of conflict abroad and economic crisis at home, it's time to renew America, Obama said, speaking against a backdrop of armored vehicles and a U.S. flag.",40,46,abroad,1,2,3
3GL25Y6843V7TITQRZPEGD9QW1SMXP,"As we emerge from a decade of conflict abroad and economic crisis at home, it's time to renew America, Obama said, speaking against a backdrop of armored vehicles and a U.S. flag.",51,59,economic,2,0,2
3GL25Y6843V7TITQRZPEGD9QW1SMXP,"As we emerge from a decade of conflict abroad and economic crisis at home, it's time to renew America, Obama said, speaking against a backdrop of armored vehicles and a U.S. flag.",51,66,economic crisis,1,4,5
3GL25Y6843V7TITQRZPEGD9QW1SMXP,"As we emerge from a decade of conflict abroad and economic crisis at home, it's time to renew America, Obama said, speaking against a backdrop of armored vehicles and a U.S. flag.",60,66,crisis,1,1,2
3GL25Y6843V7TITQRZPEGD9QW1SMXP,"As we emerge from a decade of conflict abroad and economic crisis at home, it's time to renew America, Obama said, speaking against a backdrop of armored vehicles and a U.S. flag.",89,94,renew,2,1,3
3GL25Y6843V7TITQRZPEGD9QW1SMXP,"As we emerge from a decade of conflict abroad and economic crisis at home, it's time to renew America, Obama said, speaking against a backdrop of armored vehicles and a U.S. flag.",136,144,backdrop,6,10,16
3GL25Y6843V7TITQRZPEGD9QW1SMXP,"As we emerge from a decade of conflict abroad and economic crisis at home, it's time to renew America, Obama said, speaking against a backdrop of armored vehicles and a U.S. flag.",136,164,backdrop of armored vehicles,1,0,1
3GL25Y6843V7TITQRZPEGD9QW1SMXP,"As we emerge from a decade of conflict abroad and economic crisis at home, it's time to renew America, Obama said, speaking against a backdrop of armored vehicles and a U.S. flag.",148,155,armored,4,4,8
3GL25Y6843V7TITQRZPEGD9QW1SMXP,"As we emerge from a decade of conflict abroad and economic crisis at home, it's time to renew America, Obama said, speaking against a backdrop of armored vehicles and a U.S. flag.",148,164,armored vehicles,3,0,3
3GL25Y6843V7TITQRZPEGD9QW1SMXP,"Nearly 3,000 U.S. and NATO soldiers have been killed in Afghanistan since the Taliban rulers were ousted in 2001.",22,26,NATO,1,0,1
3GL25Y6843V7TITQRZPEGD9QW1SMXP,"Nearly 3,000 U.S. and NATO soldiers have been killed in Afghanistan since the Taliban rulers were ousted in 2001.",78,85,Taliban,2,0,2
3GL25Y6843V7TITQRZPEGD9QW1SMXP,"Nearly 3,000 U.S. and NATO soldiers have been killed in Afghanistan since the Taliban rulers were ousted in 2001.",86,92,rulers,0,1,1
3GL25Y6843V7TITQRZPEGD9QW1SMXP,"Nearly 3,000 U.S. and NATO soldiers have been killed in Afghanistan since the Taliban rulers were ousted in 2001.",98,104,ousted,5,10,15
3GL25Y6843V7TITQRZPEGD9QW1SMXP,"The Taliban, overthrown by U.S.-backed Afghan forces for harboring bin Laden and other militants, were quick to take credit for Wednesday's attack at Green Village, one of several compounds for Westerners on a main road out of the capital.",13,23,overthrown,5,10,15
3GL25Y6843V7TITQRZPEGD9QW1SMXP,"The Taliban, overthrown by U.S.-backed Afghan forces for harboring bin Laden and other militants, were quick to take credit for Wednesday's attack at Green Village, one of several compounds for Westerners on a main road out of the capital.",57,66,harboring,9,10,19
3GL25Y6843V7TITQRZPEGD9QW1SMXP,"The Taliban, overthrown by U.S.-backed Afghan forces for harboring bin Laden and other militants, were quick to take credit for Wednesday's attack at Green Village, one of several compounds for Westerners on a main road out of the capital.",87,96,militants,3,1,4
3GL25Y6843V7TITQRZPEGD9QW1SMXP,"The Taliban, overthrown by U.S.-backed Afghan forces for harboring bin Laden and other militants, were quick to take credit for Wednesday's attack at Green Village, one of several compounds for Westerners on a main road out of the capital.",112,123,take credit,0,2,2
3GL25Y6843V7TITQRZPEGD9QW1SMXP,"The Taliban, overthrown by U.S.-backed Afghan forces for harboring bin Laden and other militants, were quick to take credit for Wednesday's attack at Green Village, one of several compounds for Westerners on a main road out of the capital.",172,189,several compounds,1,0,1
3GL25Y6843V7TITQRZPEGD9QW1SMXP,"The Taliban, overthrown by U.S.-backed Afghan forces for harboring bin Laden and other militants, were quick to take credit for Wednesday's attack at Green Village, one of several compounds for Westerners on a main road out of the capital.",180,189,compounds,7,3,10
3DWGDA5POF5IT426YY5Y80O2JGDV1E,"Lauren O'Neill who had only recently celebrated her birthday was killed in a gun attack in the small Northern Ireland village of Bellaghy, Co Derry, on Saturday morning.",28,47,recently celebrated,1,1,2
3DWGDA5POF5IT426YY5Y80O2JGDV1E,"Lauren O'Neill who had only recently celebrated her birthday was killed in a gun attack in the small Northern Ireland village of Bellaghy, Co Derry, on Saturday morning.",37,47,celebrated,3,1,4
3DWGDA5POF5IT426YY5Y80O2JGDV1E,Her 21-year-old sister is in a critical condition in hospital after the shooting at a house in William Court which is now at the centre of a major police investigation.,31,39,critical,5,3,8
3DWGDA5POF5IT426YY5Y80O2JGDV1E,Her 21-year-old sister is in a critical condition in hospital after the shooting at a house in William Court which is now at the centre of a major police investigation.,31,49,critical condition,4,2,6
3DWGDA5POF5IT426YY5Y80O2JGDV1E,Her 21-year-old sister is in a critical condition in hospital after the shooting at a house in William Court which is now at the centre of a major police investigation.,40,49,condition,2,0,2
3DWGDA5POF5IT426YY5Y80O2JGDV1E,Her 21-year-old sister is in a critical condition in hospital after the shooting at a house in William Court which is now at the centre of a major police investigation.,129,135,centre,2,0,2
3DWGDA5POF5IT426YY5Y80O2JGDV1E,Her 21-year-old sister is in a critical condition in hospital after the shooting at a house in William Court which is now at the centre of a major police investigation.,147,167,police investigation,1,1,2
3DWGDA5POF5IT426YY5Y80O2JGDV1E,Her 21-year-old sister is in a critical condition in hospital after the shooting at a house in William Court which is now at the centre of a major police investigation.,154,167,investigation,5,4,9
3DWGDA5POF5IT426YY5Y80O2JGDV1E,A 26-year-old man was arrested in nearby Toomebridge on suspicion of murder within an hour of the shooting and is still being questioned by the Police Service of Northern Ireland (PSNI).,22,30,arrested,1,2,3
3DWGDA5POF5IT426YY5Y80O2JGDV1E,A 26-year-old man was arrested in nearby Toomebridge on suspicion of murder within an hour of the shooting and is still being questioned by the Police Service of Northern Ireland (PSNI).,34,40,nearby,0,1,1
3DWGDA5POF5IT426YY5Y80O2JGDV1E,A 26-year-old man was arrested in nearby Toomebridge on suspicion of murder within an hour of the shooting and is still being questioned by the Police Service of Northern Ireland (PSNI).,41,52,Toomebridge,1,1,2
3DWGDA5POF5IT426YY5Y80O2JGDV1E,A 26-year-old man was arrested in nearby Toomebridge on suspicion of murder within an hour of the shooting and is still being questioned by the Police Service of Northern Ireland (PSNI).,56,65,suspicion,6,5,11
3DWGDA5POF5IT426YY5Y80O2JGDV1E,A 26-year-old man was arrested in nearby Toomebridge on suspicion of murder within an hour of the shooting and is still being questioned by the Police Service of Northern Ireland (PSNI).,56,75,suspicion of murder,4,2,6
3DWGDA5POF5IT426YY5Y80O2JGDV1E,A 26-year-old man was arrested in nearby Toomebridge on suspicion of murder within an hour of the shooting and is still being questioned by the Police Service of Northern Ireland (PSNI).,69,75,murder,0,1,1
3DWGDA5POF5IT426YY5Y80O2JGDV1E,A 26-year-old man was arrested in nearby Toomebridge on suspicion of murder within an hour of the shooting and is still being questioned by the Police Service of Northern Ireland (PSNI).,126,136,questioned,1,1,2
3DWGDA5POF5IT426YY5Y80O2JGDV1E,"Another man and a woman, both aged 28, were arrested on suspicion of assisting an offender but were released unconditionally on Saturday night by detectives.",56,65,suspicion,4,2,6
3DWGDA5POF5IT426YY5Y80O2JGDV1E,"Another man and a woman, both aged 28, were arrested on suspicion of assisting an offender but were released unconditionally on Saturday night by detectives.",56,78,suspicion of assisting,1,0,1
3DWGDA5POF5IT426YY5Y80O2JGDV1E,"Another man and a woman, both aged 28, were arrested on suspicion of assisting an offender but were released unconditionally on Saturday night by detectives.",56,90,suspicion of assisting an offender,1,0,1
3DWGDA5POF5IT426YY5Y80O2JGDV1E,"Another man and a woman, both aged 28, were arrested on suspicion of assisting an offender but were released unconditionally on Saturday night by detectives.",69,78,assisting,2,1,3
3DWGDA5POF5IT426YY5Y80O2JGDV1E,"Another man and a woman, both aged 28, were arrested on suspicion of assisting an offender but were released unconditionally on Saturday night by detectives.",69,90,assisting an offender,1,0,1
3DWGDA5POF5IT426YY5Y80O2JGDV1E,"Another man and a woman, both aged 28, were arrested on suspicion of assisting an offender but were released unconditionally on Saturday night by detectives.",82,90,offender,5,5,10
3DWGDA5POF5IT426YY5Y80O2JGDV1E,"Another man and a woman, both aged 28, were arrested on suspicion of assisting an offender but were released unconditionally on Saturday night by detectives.",100,108,released,1,1,2
3DWGDA5POF5IT426YY5Y80O2JGDV1E,"Another man and a woman, both aged 28, were arrested on suspicion of assisting an offender but were released unconditionally on Saturday night by detectives.",100,124,released unconditionally,3,0,3
3DWGDA5POF5IT426YY5Y80O2JGDV1E,"Another man and a woman, both aged 28, were arrested on suspicion of assisting an offender but were released unconditionally on Saturday night by detectives.",109,124,unconditionally,10,9,19
3DWGDA5POF5IT426YY5Y80O2JGDV1E,"Another man and a woman, both aged 28, were arrested on suspicion of assisting an offender but were released unconditionally on Saturday night by detectives.",146,156,detectives,0,4,4
3DWGDA5POF5IT426YY5Y80O2JGDV1E,"Since then a priest said he believed Lauren died trying to protect her sister, while Stormont deputy First Minister Martin McGuinness visited the family and said they are in trauma.",13,19,priest,0,1,1
3DWGDA5POF5IT426YY5Y80O2JGDV1E,"Since then a priest said he believed Lauren died trying to protect her sister, while Stormont deputy First Minister Martin McGuinness visited the family and said they are in trauma.",28,36,believed,1,1,2
3DWGDA5POF5IT426YY5Y80O2JGDV1E,"Since then a priest said he believed Lauren died trying to protect her sister, while Stormont deputy First Minister Martin McGuinness visited the family and said they are in trauma.",59,66,protect,0,1,1
3DWGDA5POF5IT426YY5Y80O2JGDV1E,"Since then a priest said he believed Lauren died trying to protect her sister, while Stormont deputy First Minister Martin McGuinness visited the family and said they are in trauma.",94,100,deputy,1,2,3
3DWGDA5POF5IT426YY5Y80O2JGDV1E,"Since then a priest said he believed Lauren died trying to protect her sister, while Stormont deputy First Minister Martin McGuinness visited the family and said they are in trauma.",134,141,visited,0,1,1
3DWGDA5POF5IT426YY5Y80O2JGDV1E,"Since then a priest said he believed Lauren died trying to protect her sister, while Stormont deputy First Minister Martin McGuinness visited the family and said they are in trauma.",162,180,they are in trauma,1,0,1
3DWGDA5POF5IT426YY5Y80O2JGDV1E,"Since then a priest said he believed Lauren died trying to protect her sister, while Stormont deputy First Minister Martin McGuinness visited the family and said they are in trauma.",171,180,in trauma,1,0,1
3DWGDA5POF5IT426YY5Y80O2JGDV1E,"Since then a priest said he believed Lauren died trying to protect her sister, while Stormont deputy First Minister Martin McGuinness visited the family and said they are in trauma.",174,180,trauma,10,8,18
3VO4XFFP15N4ZILR1FSX3NG75AY7QT,Russian news agencies reported about 200 were arrested at a similar attempt to hold an unsanctioned rally in St. Petersburg and another 25 in the southern city of Rostov-on-Don.,8,21,news agencies,1,0,1
3VO4XFFP15N4ZILR1FSX3NG75AY7QT,Russian news agencies reported about 200 were arrested at a similar attempt to hold an unsanctioned rally in St. Petersburg and another 25 in the southern city of Rostov-on-Don.,13,21,agencies,1,0,1
3VO4XFFP15N4ZILR1FSX3NG75AY7QT,Russian news agencies reported about 200 were arrested at a similar attempt to hold an unsanctioned rally in St. Petersburg and another 25 in the southern city of Rostov-on-Don.,46,54,arrested,1,1,2
3VO4XFFP15N4ZILR1FSX3NG75AY7QT,Russian news agencies reported about 200 were arrested at a similar attempt to hold an unsanctioned rally in St. Petersburg and another 25 in the southern city of Rostov-on-Don.,68,75,attempt,0,2,2
3VO4XFFP15N4ZILR1FSX3NG75AY7QT,Russian news agencies reported about 200 were arrested at a similar attempt to hold an unsanctioned rally in St. Petersburg and another 25 in the southern city of Rostov-on-Don.,87,99,unsanctioned,8,10,18
3VO4XFFP15N4ZILR1FSX3NG75AY7QT,Russian news agencies reported about 200 were arrested at a similar attempt to hold an unsanctioned rally in St. Petersburg and another 25 in the southern city of Rostov-on-Don.,87,105,unsanctioned rally,6,2,8
3VO4XFFP15N4ZILR1FSX3NG75AY7QT,Russian news agencies reported about 200 were arrested at a similar attempt to hold an unsanctioned rally in St. Petersburg and another 25 in the southern city of Rostov-on-Don.,100,105,rally,0,4,4
3VO4XFFP15N4ZILR1FSX3NG75AY7QT,Russian news agencies reported about 200 were arrested at a similar attempt to hold an unsanctioned rally in St. Petersburg and another 25 in the southern city of Rostov-on-Don.,163,176,Rostov-on-Don,1,0,1
3VO4XFFP15N4ZILR1FSX3NG75AY7QT,The Moscow protest ended after around 3 ½ hours and the others were broken up by police.,11,18,protest,0,2,2
3VO4XFFP15N4ZILR1FSX3NG75AY7QT,The Moscow protest ended after around 3 ½ hours and the others were broken up by police.,68,77,broken up,0,2,2
3VO4XFFP15N4ZILR1FSX3NG75AY7QT,The protests Monday and Tuesday were an unusually sustained show of indignation for the Russian opposition.,40,49,unusually,0,1,1
3VO4XFFP15N4ZILR1FSX3NG75AY7QT,The protests Monday and Tuesday were an unusually sustained show of indignation for the Russian opposition.,40,59,unusually sustained,3,1,4
3VO4XFFP15N4ZILR1FSX3NG75AY7QT,The protests Monday and Tuesday were an unusually sustained show of indignation for the Russian opposition.,40,64,unusually sustained show,1,0,1
3VO4XFFP15N4ZILR1FSX3NG75AY7QT,The protests Monday and Tuesday were an unusually sustained show of indignation for the Russian opposition.,50,59,sustained,9,7,16
3VO4XFFP15N4ZILR1FSX3NG75AY7QT,The protests Monday and Tuesday were an unusually sustained show of indignation for the Russian opposition.,50,79,sustained show of indignation,1,0,1
3VO4XFFP15N4ZILR1FSX3NG75AY7QT,The protests Monday and Tuesday were an unusually sustained show of indignation for the Russian opposition.,68,79,indignation,10,10,20
3VO4XFFP15N4ZILR1FSX3NG75AY7QT,The protests Monday and Tuesday were an unusually sustained show of indignation for the Russian opposition.,96,106,opposition,7,0,7
3VO4XFFP15N4ZILR1FSX3NG75AY7QT,"The thousands of Russians who rallied in Moscow and St. Petersburg faced off with police and Interior Ministry troops, who detained hundreds of protesters.",30,37,rallied,3,6,9
3VO4XFFP15N4ZILR1FSX3NG75AY7QT,"The thousands of Russians who rallied in Moscow and St. Petersburg faced off with police and Interior Ministry troops, who detained hundreds of protesters.",67,76,faced off,1,4,5
3VO4XFFP15N4ZILR1FSX3NG75AY7QT,"The thousands of Russians who rallied in Moscow and St. Petersburg faced off with police and Interior Ministry troops, who detained hundreds of protesters.",93,101,Interior,0,1,1
3VO4XFFP15N4ZILR1FSX3NG75AY7QT,"The thousands of Russians who rallied in Moscow and St. Petersburg faced off with police and Interior Ministry troops, who detained hundreds of protesters.",93,117,Interior Ministry troops,2,0,2
3VO4XFFP15N4ZILR1FSX3NG75AY7QT,"The thousands of Russians who rallied in Moscow and St. Petersburg faced off with police and Interior Ministry troops, who detained hundreds of protesters.",123,131,detained,8,9,17
3VO4XFFP15N4ZILR1FSX3NG75AY7QT,"The thousands of Russians who rallied in Moscow and St. Petersburg faced off with police and Interior Ministry troops, who detained hundreds of protesters.",144,154,protesters,0,2,2
3VO4XFFP15N4ZILR1FSX3NG75AY7QT,"More opposition rallies were expected Wednesday, along with some pro-Putin gatherings.",5,15,opposition,3,1,4
3VO4XFFP15N4ZILR1FSX3NG75AY7QT,"More opposition rallies were expected Wednesday, along with some pro-Putin gatherings.",5,23,opposition rallies,3,0,3
3VO4XFFP15N4ZILR1FSX3NG75AY7QT,"More opposition rallies were expected Wednesday, along with some pro-Putin gatherings.",16,23,rallies,1,2,3
3VO4XFFP15N4ZILR1FSX3NG75AY7QT,"More opposition rallies were expected Wednesday, along with some pro-Putin gatherings.",29,37,expected,1,0,1
3VO4XFFP15N4ZILR1FSX3NG75AY7QT,"More opposition rallies were expected Wednesday, along with some pro-Putin gatherings.",65,85,pro-Putin gatherings,2,1,3
3VO4XFFP15N4ZILR1FSX3NG75AY7QT,"More opposition rallies were expected Wednesday, along with some pro-Putin gatherings.",75,85,gatherings,0,5,5
3VO4XFFP15N4ZILR1FSX3NG75AY7QT,"Putin was expected to formally register later in the day to run for president, a position he held from 2000-2008, a period in which he grew more authoritarian.",10,18,expected,1,0,1
3VO4XFFP15N4ZILR1FSX3NG75AY7QT,"Putin was expected to formally register later in the day to run for president, a position he held from 2000-2008, a period in which he grew more authoritarian.",22,39,formally register,1,0,1
3VO4XFFP15N4ZILR1FSX3NG75AY7QT,"Putin was expected to formally register later in the day to run for president, a position he held from 2000-2008, a period in which he grew more authoritarian.",31,39,register,0,1,1
3VO4XFFP15N4ZILR1FSX3NG75AY7QT,"Putin was expected to formally register later in the day to run for president, a position he held from 2000-2008, a period in which he grew more authoritarian.",93,97,held,0,1,1
3VO4XFFP15N4ZILR1FSX3NG75AY7QT,"Putin was expected to formally register later in the day to run for president, a position he held from 2000-2008, a period in which he grew more authoritarian.",135,139,grew,0,1,1
3VO4XFFP15N4ZILR1FSX3NG75AY7QT,"Putin was expected to formally register later in the day to run for president, a position he held from 2000-2008, a period in which he grew more authoritarian.",145,158,authoritarian,10,10,20
3NFWQRSHVEFQ1M6JG2LXX1PMXB8FGA,"A bad part of the investigation is that we may not get the why.	3	11	bad part	1	0	1
3NFWQRSHVEFQ1M6JG2LXX1PMXB8FGA	A bad part of the investigation is that we may not get the why.",19,32,investigation,10,9,19
3NFWQRSHVEFQ1M6JG2LXX1PMXB8FGA,"A bad part of the investigation is that we may not get the why.	52	63	get the why	1	1	2
3NFWQRSHVEFQ1M6JG2LXX1PMXB8FGA	Unless she left a note somewhere or told somebody, she may have taken it to the grave.",18,22,note,1,1,2
3NFWQRSHVEFQ1M6JG2LXX1PMXB8FGA,"Unless she left a note somewhere or told somebody, she may have taken it to the grave.""",64,85,taken it to the grave,3,0,3
3NFWQRSHVEFQ1M6JG2LXX1PMXB8FGA,"Unless she left a note somewhere or told somebody, she may have taken it to the grave.""",80,85,grave,3,6,9
3NFWQRSHVEFQ1M6JG2LXX1PMXB8FGA,"According to Goodyear, a neighbor heard gun shots.",0,9,According,2,0,2
3NFWQRSHVEFQ1M6JG2LXX1PMXB8FGA,"According to Goodyear, a neighbor heard gun shots.",0,12,According to,1,0,1
3NFWQRSHVEFQ1M6JG2LXX1PMXB8FGA,"According to Goodyear, a neighbor heard gun shots.",25,33,neighbor,0,2,2
3NFWQRSHVEFQ1M6JG2LXX1PMXB8FGA,"According to Goodyear, a neighbor heard gun shots.",34,39,heard,0,1,1
3NFWQRSHVEFQ1M6JG2LXX1PMXB8FGA,"According to Goodyear, a neighbor heard gun shots.",40,49,gun shots,0,1,1
3NFWQRSHVEFQ1M6JG2LXX1PMXB8FGA,Minutes later two of the children arrived on his doorstep.,34,41,arrived,1,0,1
3NFWQRSHVEFQ1M6JG2LXX1PMXB8FGA,Minutes later two of the children arrived on his doorstep.,49,57,doorstep,1,3,4
3NFWQRSHVEFQ1M6JG2LXX1PMXB8FGA,"One of the boys, police believe it was Joel, was covered in blood and told the neighbor his mom had shot them.",79,87,neighbor,1,0,1
3NFWQRSHVEFQ1M6JG2LXX1PMXB8FGA,"The oldest child, Pebbles, could be seen walking back towards the family home, Goodyear said.",18,25,Pebbles,0,2,2
3NFWQRSHVEFQ1M6JG2LXX1PMXB8FGA,"The oldest child, Pebbles, could be seen walking back towards the family home, Goodyear said.",41,61,walking back towards,1,0,1
3NFWQRSHVEFQ1M6JG2LXX1PMXB8FGA,"The oldest child, Pebbles, could be seen walking back towards the family home, Goodyear said.",54,61,towards,0,1,1
3NFWQRSHVEFQ1M6JG2LXX1PMXB8FGA,The children's mother came outside and lured the kids back into the house.,39,44,lured,10,10,20
3NFWQRSHVEFQ1M6JG2LXX1PMXB8FGA,"She was very calm, called them in, Goodyear said.",14,18,calm,1,2,3
3NFWQRSHVEFQ1M6JG2LXX1PMXB8FGA,"She didn't seem to be stressed or mad, just stepped out.	23	31	stressed	7	9	16
3NFWQRSHVEFQ1M6JG2LXX1PMXB8FGA	She didn't seem to be stressed or mad, just stepped out.",35,38,mad,0,2,2
3NFWQRSHVEFQ1M6JG2LXX1PMXB8FGA,"She didn't seem to be stressed or mad, just stepped out.	45	52	stepped	0	1	1
3NFWQRSHVEFQ1M6JG2LXX1PMXB8FGA	She didn't seem to be stressed or mad, just stepped out.",45,56,stepped out,2,4,6
38B7Q9C28G6F3JQ013CJBEQMZM769D,"Companies must raise £28 trillion Chinese sovereign wealth fund stops buying Euro debt Surprise weakening in China import and exports Spain nationalises Bankia as euro crisis escalates Germany warns Greece 'no bailout agreement, no aid' Bankia, in which the state is taking a 45pc stake as a crisis measure to save    it from crippling bad loans, had €37.5bn in exposure to the property sector    at the end of 2011.",25,33,trillion,1,0,1
38B7Q9C28G6F3JQ013CJBEQMZM769D,"Companies must raise £28 trillion Chinese sovereign wealth fund stops buying Euro debt Surprise weakening in China import and exports Spain nationalises Bankia as euro crisis escalates Germany warns Greece 'no bailout agreement, no aid' Bankia, in which the state is taking a 45pc stake as a crisis measure to save    it from crippling bad loans, had €37.5bn in exposure to the property sector    at the end of 2011.",34,63,Chinese sovereign wealth fund,1,1,2
38B7Q9C28G6F3JQ013CJBEQMZM769D,"Companies must raise £28 trillion Chinese sovereign wealth fund stops buying Euro debt Surprise weakening in China import and exports Spain nationalises Bankia as euro crisis escalates Germany warns Greece 'no bailout agreement, no aid' Bankia, in which the state is taking a 45pc stake as a crisis measure to save    it from crippling bad loans, had €37.5bn in exposure to the property sector    at the end of 2011.",42,51,sovereign,6,8,14
38B7Q9C28G6F3JQ013CJBEQMZM769D,"Companies must raise £28 trillion Chinese sovereign wealth fund stops buying Euro debt Surprise weakening in China import and exports Spain nationalises Bankia as euro crisis escalates Germany warns Greece 'no bailout agreement, no aid' Bankia, in which the state is taking a 45pc stake as a crisis measure to save    it from crippling bad loans, had €37.5bn in exposure to the property sector    at the end of 2011.",42,58,sovereign wealth,0,1,1
38B7Q9C28G6F3JQ013CJBEQMZM769D,"Companies must raise £28 trillion Chinese sovereign wealth fund stops buying Euro debt Surprise weakening in China import and exports Spain nationalises Bankia as euro crisis escalates Germany warns Greece 'no bailout agreement, no aid' Bankia, in which the state is taking a 45pc stake as a crisis measure to save    it from crippling bad loans, had €37.5bn in exposure to the property sector    at the end of 2011.",42,63,sovereign wealth fund,3,1,4
38B7Q9C28G6F3JQ013CJBEQMZM769D,"Companies must raise £28 trillion Chinese sovereign wealth fund stops buying Euro debt Surprise weakening in China import and exports Spain nationalises Bankia as euro crisis escalates Germany warns Greece 'no bailout agreement, no aid' Bankia, in which the state is taking a 45pc stake as a crisis measure to save    it from crippling bad loans, had €37.5bn in exposure to the property sector    at the end of 2011.",52,58,wealth,0,1,1
38B7Q9C28G6F3JQ013CJBEQMZM769D,"Companies must raise £28 trillion Chinese sovereign wealth fund stops buying Euro debt Surprise weakening in China import and exports Spain nationalises Bankia as euro crisis escalates Germany warns Greece 'no bailout agreement, no aid' Bankia, in which the state is taking a 45pc stake as a crisis measure to save    it from crippling bad loans, had €37.5bn in exposure to the property sector    at the end of 2011.",82,86,debt,0,1,1
38B7Q9C28G6F3JQ013CJBEQMZM769D,"Companies must raise £28 trillion Chinese sovereign wealth fund stops buying Euro debt Surprise weakening in China import and exports Spain nationalises Bankia as euro crisis escalates Germany warns Greece 'no bailout agreement, no aid' Bankia, in which the state is taking a 45pc stake as a crisis measure to save    it from crippling bad loans, had €37.5bn in exposure to the property sector    at the end of 2011.",82,96,debt  Surprise,1,0,1
38B7Q9C28G6F3JQ013CJBEQMZM769D,"Companies must raise £28 trillion Chinese sovereign wealth fund stops buying Euro debt Surprise weakening in China import and exports Spain nationalises Bankia as euro crisis escalates Germany warns Greece 'no bailout agreement, no aid' Bankia, in which the state is taking a 45pc stake as a crisis measure to save    it from crippling bad loans, had €37.5bn in exposure to the property sector    at the end of 2011.",96,105,weakening,1,3,4
38B7Q9C28G6F3JQ013CJBEQMZM769D,"Companies must raise £28 trillion Chinese sovereign wealth fund stops buying Euro debt Surprise weakening in China import and exports Spain nationalises Bankia as euro crisis escalates Germany warns Greece 'no bailout agreement, no aid' Bankia, in which the state is taking a 45pc stake as a crisis measure to save    it from crippling bad loans, had €37.5bn in exposure to the property sector    at the end of 2011.",115,133,import and exports,0,1,1
38B7Q9C28G6F3JQ013CJBEQMZM769D,"Companies must raise £28 trillion Chinese sovereign wealth fund stops buying Euro debt Surprise weakening in China import and exports Spain nationalises Bankia as euro crisis escalates Germany warns Greece 'no bailout agreement, no aid' Bankia, in which the state is taking a 45pc stake as a crisis measure to save    it from crippling bad loans, had €37.5bn in exposure to the property sector    at the end of 2011.",140,152,nationalises,6,1,7
38B7Q9C28G6F3JQ013CJBEQMZM769D,"Companies must raise £28 trillion Chinese sovereign wealth fund stops buying Euro debt Surprise weakening in China import and exports Spain nationalises Bankia as euro crisis escalates Germany warns Greece 'no bailout agreement, no aid' Bankia, in which the state is taking a 45pc stake as a crisis measure to save    it from crippling bad loans, had €37.5bn in exposure to the property sector    at the end of 2011.",163,174,euro crisis,2,0,2
38B7Q9C28G6F3JQ013CJBEQMZM769D,"Companies must raise £28 trillion Chinese sovereign wealth fund stops buying Euro debt Surprise weakening in China import and exports Spain nationalises Bankia as euro crisis escalates Germany warns Greece 'no bailout agreement, no aid' Bankia, in which the state is taking a 45pc stake as a crisis measure to save    it from crippling bad loans, had €37.5bn in exposure to the property sector    at the end of 2011.",163,184,euro crisis escalates,1,0,1
38B7Q9C28G6F3JQ013CJBEQMZM769D,"Companies must raise £28 trillion Chinese sovereign wealth fund stops buying Euro debt Surprise weakening in China import and exports Spain nationalises Bankia as euro crisis escalates Germany warns Greece 'no bailout agreement, no aid' Bankia, in which the state is taking a 45pc stake as a crisis measure to save    it from crippling bad loans, had €37.5bn in exposure to the property sector    at the end of 2011.",168,174,crisis,1,1,2
38B7Q9C28G6F3JQ013CJBEQMZM769D,"Companies must raise £28 trillion Chinese sovereign wealth fund stops buying Euro debt Surprise weakening in China import and exports Spain nationalises Bankia as euro crisis escalates Germany warns Greece 'no bailout agreement, no aid' Bankia, in which the state is taking a 45pc stake as a crisis measure to save    it from crippling bad loans, had €37.5bn in exposure to the property sector    at the end of 2011.",168,184,crisis escalates,1,0,1
38B7Q9C28G6F3JQ013CJBEQMZM769D,"Companies must raise £28 trillion Chinese sovereign wealth fund stops buying Euro debt Surprise weakening in China import and exports Spain nationalises Bankia as euro crisis escalates Germany warns Greece 'no bailout agreement, no aid' Bankia, in which the state is taking a 45pc stake as a crisis measure to save    it from crippling bad loans, had €37.5bn in exposure to the property sector    at the end of 2011.",175,184,escalates,6,7,13
38B7Q9C28G6F3JQ013CJBEQMZM769D,"Companies must raise £28 trillion Chinese sovereign wealth fund stops buying Euro debt Surprise weakening in China import and exports Spain nationalises Bankia as euro crisis escalates Germany warns Greece 'no bailout agreement, no aid' Bankia, in which the state is taking a 45pc stake as a crisis measure to save    it from crippling bad loans, had €37.5bn in exposure to the property sector    at the end of 2011.",207,217,no bailout,0,1,1
38B7Q9C28G6F3JQ013CJBEQMZM769D,"Companies must raise £28 trillion Chinese sovereign wealth fund stops buying Euro debt Surprise weakening in China import and exports Spain nationalises Bankia as euro crisis escalates Germany warns Greece 'no bailout agreement, no aid' Bankia, in which the state is taking a 45pc stake as a crisis measure to save    it from crippling bad loans, had €37.5bn in exposure to the property sector    at the end of 2011.",207,227,no bailout agreement,2,0,2
38B7Q9C28G6F3JQ013CJBEQMZM769D,"Companies must raise £28 trillion Chinese sovereign wealth fund stops buying Euro debt Surprise weakening in China import and exports Spain nationalises Bankia as euro crisis escalates Germany warns Greece 'no bailout agreement, no aid' Bankia, in which the state is taking a 45pc stake as a crisis measure to save    it from crippling bad loans, had €37.5bn in exposure to the property sector    at the end of 2011.",210,217,bailout,3,8,11
38B7Q9C28G6F3JQ013CJBEQMZM769D,"Companies must raise £28 trillion Chinese sovereign wealth fund stops buying Euro debt Surprise weakening in China import and exports Spain nationalises Bankia as euro crisis escalates Germany warns Greece 'no bailout agreement, no aid' Bankia, in which the state is taking a 45pc stake as a crisis measure to save    it from crippling bad loans, had €37.5bn in exposure to the property sector    at the end of 2011.",210,227,bailout agreement,1,3,4
38B7Q9C28G6F3JQ013CJBEQMZM769D,"Companies must raise £28 trillion Chinese sovereign wealth fund stops buying Euro debt Surprise weakening in China import and exports Spain nationalises Bankia as euro crisis escalates Germany warns Greece 'no bailout agreement, no aid' Bankia, in which the state is taking a 45pc stake as a crisis measure to save    it from crippling bad loans, had €37.5bn in exposure to the property sector    at the end of 2011.",281,286,stake,2,3,5
38B7Q9C28G6F3JQ013CJBEQMZM769D,"Companies must raise £28 trillion Chinese sovereign wealth fund stops buying Euro debt Surprise weakening in China import and exports Spain nationalises Bankia as euro crisis escalates Germany warns Greece 'no bailout agreement, no aid' Bankia, in which the state is taking a 45pc stake as a crisis measure to save    it from crippling bad loans, had €37.5bn in exposure to the property sector    at the end of 2011.",292,298,crisis,1,4,5
38B7Q9C28G6F3JQ013CJBEQMZM769D,"Companies must raise £28 trillion Chinese sovereign wealth fund stops buying Euro debt Surprise weakening in China import and exports Spain nationalises Bankia as euro crisis escalates Germany warns Greece 'no bailout agreement, no aid' Bankia, in which the state is taking a 45pc stake as a crisis measure to save    it from crippling bad loans, had €37.5bn in exposure to the property sector    at the end of 2011.",292,306,crisis measure,3,1,4
38B7Q9C28G6F3JQ013CJBEQMZM769D,"Companies must raise £28 trillion Chinese sovereign wealth fund stops buying Euro debt Surprise weakening in China import and exports Spain nationalises Bankia as euro crisis escalates Germany warns Greece 'no bailout agreement, no aid' Bankia, in which the state is taking a 45pc stake as a crisis measure to save    it from crippling bad loans, had €37.5bn in exposure to the property sector    at the end of 2011.",326,335,crippling,6,10,16
38B7Q9C28G6F3JQ013CJBEQMZM769D,"Companies must raise £28 trillion Chinese sovereign wealth fund stops buying Euro debt Surprise weakening in China import and exports Spain nationalises Bankia as euro crisis escalates Germany warns Greece 'no bailout agreement, no aid' Bankia, in which the state is taking a 45pc stake as a crisis measure to save    it from crippling bad loans, had €37.5bn in exposure to the property sector    at the end of 2011.",326,345,crippling bad loans,4,0,4
38B7Q9C28G6F3JQ013CJBEQMZM769D,"Companies must raise £28 trillion Chinese sovereign wealth fund stops buying Euro debt Surprise weakening in China import and exports Spain nationalises Bankia as euro crisis escalates Germany warns Greece 'no bailout agreement, no aid' Bankia, in which the state is taking a 45pc stake as a crisis measure to save    it from crippling bad loans, had €37.5bn in exposure to the property sector    at the end of 2011.",362,370,exposure,4,1,5
38B7Q9C28G6F3JQ013CJBEQMZM769D,Of that total €31.8bn were classed as problematic.,27,34,classed,1,1,2
38B7Q9C28G6F3JQ013CJBEQMZM769D,Of that total €31.8bn were classed as problematic.,38,49,problematic,6,4,10
38B7Q9C28G6F3JQ013CJBEQMZM769D,But the hangover from the property party extends across the financial sector.,8,16,hangover,5,3,8
38B7Q9C28G6F3JQ013CJBEQMZM769D,But the hangover from the property party extends across the financial sector.,8,40,hangover from the property party,1,0,1
38B7Q9C28G6F3JQ013CJBEQMZM769D,But the hangover from the property party extends across the financial sector.,41,48,extends,0,2,2
38B7Q9C28G6F3JQ013CJBEQMZM769D,But the hangover from the property party extends across the financial sector.,60,76,financial sector,3,1,4
38B7Q9C28G6F3JQ013CJBEQMZM769D,"Bank of Spain figures show commercial banks held problematic real estate    assets including loans and seized property of €184bn, 60pc of their property    portfolio at the end of 2011.",27,37,commercial,2,0,2
38B7Q9C28G6F3JQ013CJBEQMZM769D,"Bank of Spain figures show commercial banks held problematic real estate    assets including loans and seized property of €184bn, 60pc of their property    portfolio at the end of 2011.",49,60,problematic,3,0,3
38B7Q9C28G6F3JQ013CJBEQMZM769D,"Bank of Spain figures show commercial banks held problematic real estate    assets including loans and seized property of €184bn, 60pc of their property    portfolio at the end of 2011.",51,73,real estate     assets,2,1,3
38B7Q9C28G6F3JQ013CJBEQMZM769D,"Bank of Spain figures show commercial banks held problematic real estate    assets including loans and seized property of €184bn, 60pc of their property    portfolio at the end of 2011.",76,82,assets,1,2,3
38B7Q9C28G6F3JQ013CJBEQMZM769D,"Bank of Spain figures show commercial banks held problematic real estate    assets including loans and seized property of €184bn, 60pc of their property    portfolio at the end of 2011.",103,109,seized,4,2,6
38B7Q9C28G6F3JQ013CJBEQMZM769D,"Bank of Spain figures show commercial banks held problematic real estate    assets including loans and seized property of €184bn, 60pc of their property    portfolio at the end of 2011.",103,118,seized property,1,0,1
38B7Q9C28G6F3JQ013CJBEQMZM769D,"Bank of Spain figures show commercial banks held problematic real estate    assets including loans and seized property of €184bn, 60pc of their property    portfolio at the end of 2011.",133,155,property     portfolio,0,1,1
38B7Q9C28G6F3JQ013CJBEQMZM769D,"Bank of Spain figures show commercial banks held problematic real estate    assets including loans and seized property of €184bn, 60pc of their property    portfolio at the end of 2011.",135,157,property     portfolio,3,1,4
38B7Q9C28G6F3JQ013CJBEQMZM769D,"Bank of Spain figures show commercial banks held problematic real estate    assets including loans and seized property of €184bn, 60pc of their property    portfolio at the end of 2011.",156,165,portfolio,5,4,9
3NI0WFPPI9HX7P2N17TQI3PTXVG06P,"Regulators in the US and elsewhere have stressed that they will be watching to make sure that the Mountain View, California-based company does not use its acquisition of Motorola Mobility to obtain unfair advantage in the market.",0,10,Regulators,10,5,15
3NI0WFPPI9HX7P2N17TQI3PTXVG06P,"Regulators in the US and elsewhere have stressed that they will be watching to make sure that the Mountain View, California-based company does not use its acquisition of Motorola Mobility to obtain unfair advantage in the market.",25,34,elsewhere,0,2,2
3NI0WFPPI9HX7P2N17TQI3PTXVG06P,"Regulators in the US and elsewhere have stressed that they will be watching to make sure that the Mountain View, California-based company does not use its acquisition of Motorola Mobility to obtain unfair advantage in the market.",35,48,have stressed,0,1,1
3NI0WFPPI9HX7P2N17TQI3PTXVG06P,"Regulators in the US and elsewhere have stressed that they will be watching to make sure that the Mountain View, California-based company does not use its acquisition of Motorola Mobility to obtain unfair advantage in the market.",40,48,stressed,1,5,6
3NI0WFPPI9HX7P2N17TQI3PTXVG06P,"Regulators in the US and elsewhere have stressed that they will be watching to make sure that the Mountain View, California-based company does not use its acquisition of Motorola Mobility to obtain unfair advantage in the market.",155,166,acquisition,10,10,20
3NI0WFPPI9HX7P2N17TQI3PTXVG06P,"Regulators in the US and elsewhere have stressed that they will be watching to make sure that the Mountain View, California-based company does not use its acquisition of Motorola Mobility to obtain unfair advantage in the market.",191,197,obtain,3,0,3
3NI0WFPPI9HX7P2N17TQI3PTXVG06P,"Regulators in the US and elsewhere have stressed that they will be watching to make sure that the Mountain View, California-based company does not use its acquisition of Motorola Mobility to obtain unfair advantage in the market.",198,214,unfair advantage,3,2,5
3NI0WFPPI9HX7P2N17TQI3PTXVG06P,"Regulators in the US and elsewhere have stressed that they will be watching to make sure that the Mountain View, California-based company does not use its acquisition of Motorola Mobility to obtain unfair advantage in the market.",205,214,advantage,2,1,3
3NI0WFPPI9HX7P2N17TQI3PTXVG06P,"Police have arrested a man over the stabbing of a widower in Brighton Jeffrey Burrows was killed at his home in Norfolk Square in Brighton, East Sussex, on April 29.",36,44,stabbing,1,10,11
3NI0WFPPI9HX7P2N17TQI3PTXVG06P,"Police have arrested a man over the stabbing of a widower in Brighton Jeffrey Burrows was killed at his home in Norfolk Square in Brighton, East Sussex, on April 29.",50,57,widower,7,5,12
3NI0WFPPI9HX7P2N17TQI3PTXVG06P,A 22-year-old from Liverpool was arrested in the city on suspicion of murder on Saturday and he remains in custody.,57,66,suspicion,7,9,16
3NI0WFPPI9HX7P2N17TQI3PTXVG06P,A 22-year-old from Liverpool was arrested in the city on suspicion of murder on Saturday and he remains in custody.,57,76,suspicion of murder,3,1,4
3NI0WFPPI9HX7P2N17TQI3PTXVG06P,A 22-year-old from Liverpool was arrested in the city on suspicion of murder on Saturday and he remains in custody.,104,114,in custody,0,1,1
3NI0WFPPI9HX7P2N17TQI3PTXVG06P,A 22-year-old from Liverpool was arrested in the city on suspicion of murder on Saturday and he remains in custody.,107,114,custody,4,3,7
3NI0WFPPI9HX7P2N17TQI3PTXVG06P,"Joel Elliott, also 22, of North Road, Brighton, was charged on May 3 with murder.",52,59,charged,0,3,3
3NI0WFPPI9HX7P2N17TQI3PTXVG06P,He appeared at Lewes Crown Court on May 8 but did not enter a plea.,3,11,appeared,0,1,1
3NI0WFPPI9HX7P2N17TQI3PTXVG06P,He appeared at Lewes Crown Court on May 8 but did not enter a plea.,15,20,Lewes,0,1,1
3NI0WFPPI9HX7P2N17TQI3PTXVG06P,He appeared at Lewes Crown Court on May 8 but did not enter a plea.,54,66,enter a plea,1,0,1
3NI0WFPPI9HX7P2N17TQI3PTXVG06P,He appeared at Lewes Crown Court on May 8 but did not enter a plea.,62,66,plea,3,7,10
3NI0WFPPI9HX7P2N17TQI3PTXVG06P,Elliott was remanded in custody and will next appear at the same court for a plea and case management hearing on July 6.,12,20,remanded,9,8,17
3NI0WFPPI9HX7P2N17TQI3PTXVG06P,Elliott was remanded in custody and will next appear at the same court for a plea and case management hearing on July 6.,12,31,remanded in custody,1,1,2
3NI0WFPPI9HX7P2N17TQI3PTXVG06P,Elliott was remanded in custody and will next appear at the same court for a plea and case management hearing on July 6.,24,31,custody,0,1,1
3NI0WFPPI9HX7P2N17TQI3PTXVG06P,Elliott was remanded in custody and will next appear at the same court for a plea and case management hearing on July 6.,77,81,plea,3,6,9
3NI0WFPPI9HX7P2N17TQI3PTXVG06P,Elliott was remanded in custody and will next appear at the same court for a plea and case management hearing on July 6.,77,101,plea and case management,1,1,2
3NI0WFPPI9HX7P2N17TQI3PTXVG06P,Elliott was remanded in custody and will next appear at the same court for a plea and case management hearing on July 6.,86,101,case management,2,1,3
3NI0WFPPI9HX7P2N17TQI3PTXVG06P,Elliott was remanded in custody and will next appear at the same court for a plea and case management hearing on July 6.,86,109,case management hearing,2,1,3
3NI0WFPPI9HX7P2N17TQI3PTXVG06P,Elliott was remanded in custody and will next appear at the same court for a plea and case management hearing on July 6.,91,101,management,2,0,2
3T8DUCXY0N7L5H1CXGKCMOI0K7L9TL,"It appeared they had been shot, Goodyear said.",4,12,appeared,0,2,2
3T8DUCXY0N7L5H1CXGKCMOI0K7L9TL,"The mother of the children came out of the residence next door, called for the children to return home, at which time they left and went back to the house.",44,53,residence,10,4,14
3T8DUCXY0N7L5H1CXGKCMOI0K7L9TL,"The mother of the children came out of the residence next door, called for the children to return home, at which time they left and went back to the house.",92,98,return,0,1,1
3T8DUCXY0N7L5H1CXGKCMOI0K7L9TL,The neighbor then heard gunshots and called 911.,4,12,neighbor,0,3,3
3T8DUCXY0N7L5H1CXGKCMOI0K7L9TL,The neighbor then heard gunshots and called 911.,18,23,heard,0,1,1
3T8DUCXY0N7L5H1CXGKCMOI0K7L9TL,The neighbor then heard gunshots and called 911.,24,32,gunshots,0,3,3
3T8DUCXY0N7L5H1CXGKCMOI0K7L9TL,"Another neighbor told deputies that Thomas sent a text message in the middle of the night saying she wanted to be cremated with her children, Goodyear said.",8,16,neighbor,0,2,2
3T8DUCXY0N7L5H1CXGKCMOI0K7L9TL,"Another neighbor told deputies that Thomas sent a text message in the middle of the night saying she wanted to be cremated with her children, Goodyear said.",22,30,deputies,4,4,8
3T8DUCXY0N7L5H1CXGKCMOI0K7L9TL,"Another neighbor told deputies that Thomas sent a text message in the middle of the night saying she wanted to be cremated with her children, Goodyear said.",50,62,text message,1,0,1
3T8DUCXY0N7L5H1CXGKCMOI0K7L9TL,"Another neighbor told deputies that Thomas sent a text message in the middle of the night saying she wanted to be cremated with her children, Goodyear said.",114,122,cremated,10,10,20
3T8DUCXY0N7L5H1CXGKCMOI0K7L9TL,"The shooting happened in Port St. John, about 15 miles west of Cape Canaveral in an area known as the ""Space Coast"" because it is the home of NASA's Kennedy Space Center, the location of numerous famed shuttle launches.",4,12,shooting,1,0,1
3T8DUCXY0N7L5H1CXGKCMOI0K7L9TL,"The shooting happened in Port St. John, about 15 miles west of Cape Canaveral in an area known as the ""Space Coast"" because it is the home of NASA's Kennedy Space Center, the location of numerous famed shuttle launches.",13,21,happened,0,1,1
3T8DUCXY0N7L5H1CXGKCMOI0K7L9TL,"The shooting happened in Port St. John, about 15 miles west of Cape Canaveral in an area known as the ""Space Coast"" because it is the home of NASA's Kennedy Space Center, the location of numerous famed shuttle launches.",103,114,Space Coast,3,0,3
3T8DUCXY0N7L5H1CXGKCMOI0K7L9TL,"The shooting happened in Port St. John, about 15 miles west of Cape Canaveral in an area known as the ""Space Coast"" because it is the home of NASA's Kennedy Space Center, the location of numerous famed shuttle launches.",142,146,NASA,1,0,1
3T8DUCXY0N7L5H1CXGKCMOI0K7L9TL,"The shooting happened in Port St. John, about 15 miles west of Cape Canaveral in an area known as the ""Space Coast"" because it is the home of NASA's Kennedy Space Center, the location of numerous famed shuttle launches.",187,195,numerous,4,3,7
3T8DUCXY0N7L5H1CXGKCMOI0K7L9TL,"The shooting happened in Port St. John, about 15 miles west of Cape Canaveral in an area known as the ""Space Coast"" because it is the home of NASA's Kennedy Space Center, the location of numerous famed shuttle launches.",187,201,numerous famed,1,0,1
3T8DUCXY0N7L5H1CXGKCMOI0K7L9TL,"The shooting happened in Port St. John, about 15 miles west of Cape Canaveral in an area known as the ""Space Coast"" because it is the home of NASA's Kennedy Space Center, the location of numerous famed shuttle launches.",187,209,numerous famed shuttle,1,0,1
3T8DUCXY0N7L5H1CXGKCMOI0K7L9TL,"The shooting happened in Port St. John, about 15 miles west of Cape Canaveral in an area known as the ""Space Coast"" because it is the home of NASA's Kennedy Space Center, the location of numerous famed shuttle launches.",187,218,numerous famed shuttle launches,2,1,3
3T8DUCXY0N7L5H1CXGKCMOI0K7L9TL,"The shooting happened in Port St. John, about 15 miles west of Cape Canaveral in an area known as the ""Space Coast"" because it is the home of NASA's Kennedy Space Center, the location of numerous famed shuttle launches.",196,201,famed,2,4,6
3T8DUCXY0N7L5H1CXGKCMOI0K7L9TL,"The shooting happened in Port St. John, about 15 miles west of Cape Canaveral in an area known as the ""Space Coast"" because it is the home of NASA's Kennedy Space Center, the location of numerous famed shuttle launches.",202,209,shuttle,2,3,5
3T8DUCXY0N7L5H1CXGKCMOI0K7L9TL,"The shooting happened in Port St. John, about 15 miles west of Cape Canaveral in an area known as the ""Space Coast"" because it is the home of NASA's Kennedy Space Center, the location of numerous famed shuttle launches.",202,218,shuttle launches,2,1,3
3T8DUCXY0N7L5H1CXGKCMOI0K7L9TL,"The shooting happened in Port St. John, about 15 miles west of Cape Canaveral in an area known as the ""Space Coast"" because it is the home of NASA's Kennedy Space Center, the location of numerous famed shuttle launches.",210,218,launches,2,1,3
3T8DUCXY0N7L5H1CXGKCMOI0K7L9TL,"A Florida mother who fatally shot her four children before killing herself Tuesday called three of the kids who had sought help from a neighbor back to the house before firing the fatal shots, authorities said.",21,28,fatally,7,6,13
3T8DUCXY0N7L5H1CXGKCMOI0K7L9TL,"A Florida mother who fatally shot her four children before killing herself Tuesday called three of the kids who had sought help from a neighbor back to the house before firing the fatal shots, authorities said.",116,122,sought,7,3,10
3T8DUCXY0N7L5H1CXGKCMOI0K7L9TL,"A Florida mother who fatally shot her four children before killing herself Tuesday called three of the kids who had sought help from a neighbor back to the house before firing the fatal shots, authorities said.",116,127,sought help,0,1,1
3T8DUCXY0N7L5H1CXGKCMOI0K7L9TL,"A Florida mother who fatally shot her four children before killing herself Tuesday called three of the kids who had sought help from a neighbor back to the house before firing the fatal shots, authorities said.",169,175,firing,0,1,1
3T8DUCXY0N7L5H1CXGKCMOI0K7L9TL,"A Florida mother who fatally shot her four children before killing herself Tuesday called three of the kids who had sought help from a neighbor back to the house before firing the fatal shots, authorities said.",180,185,fatal,8,2,10
3T8DUCXY0N7L5H1CXGKCMOI0K7L9TL,"A Florida mother who fatally shot her four children before killing herself Tuesday called three of the kids who had sought help from a neighbor back to the house before firing the fatal shots, authorities said.",180,191,fatal shots,1,1,2
3T8DUCXY0N7L5H1CXGKCMOI0K7L9TL,"A Florida mother who fatally shot her four children before killing herself Tuesday called three of the kids who had sought help from a neighbor back to the house before firing the fatal shots, authorities said.",193,204,authorities,6,1,7
33J5JKFMK6ZMYZK4Z3P7Q64RZV9Q3D,"If confirmed, the attack would be one of the deadliest suffered by security forces in the 14-month-long uprising against President Bashar al-Assad.",3,12,confirmed,0,3,3
33J5JKFMK6ZMYZK4Z3P7Q64RZV9Q3D,"If confirmed, the attack would be one of the deadliest suffered by security forces in the 14-month-long uprising against President Bashar al-Assad.",45,54,deadliest,4,5,9
33J5JKFMK6ZMYZK4Z3P7Q64RZV9Q3D,"If confirmed, the attack would be one of the deadliest suffered by security forces in the 14-month-long uprising against President Bashar al-Assad.",45,63,deadliest suffered,1,0,1
33J5JKFMK6ZMYZK4Z3P7Q64RZV9Q3D,"If confirmed, the attack would be one of the deadliest suffered by security forces in the 14-month-long uprising against President Bashar al-Assad.",55,63,suffered,1,1,2
33J5JKFMK6ZMYZK4Z3P7Q64RZV9Q3D,"If confirmed, the attack would be one of the deadliest suffered by security forces in the 14-month-long uprising against President Bashar al-Assad.",67,82,security forces,3,0,3
33J5JKFMK6ZMYZK4Z3P7Q64RZV9Q3D,"If confirmed, the attack would be one of the deadliest suffered by security forces in the 14-month-long uprising against President Bashar al-Assad.",104,112,uprising,8,5,13
33J5JKFMK6ZMYZK4Z3P7Q64RZV9Q3D,"It comes after government forces launched a fresh assault on Rastan at the weekend, despite a UN-backed nominal ceasefire that was supposed to come into effect just over a month ago.",15,25,government,2,0,2
33J5JKFMK6ZMYZK4Z3P7Q64RZV9Q3D,"It comes after government forces launched a fresh assault on Rastan at the weekend, despite a UN-backed nominal ceasefire that was supposed to come into effect just over a month ago.",33,41,launched,3,2,5
33J5JKFMK6ZMYZK4Z3P7Q64RZV9Q3D,"It comes after government forces launched a fresh assault on Rastan at the weekend, despite a UN-backed nominal ceasefire that was supposed to come into effect just over a month ago.",44,49,fresh,0,1,1
33J5JKFMK6ZMYZK4Z3P7Q64RZV9Q3D,"It comes after government forces launched a fresh assault on Rastan at the weekend, despite a UN-backed nominal ceasefire that was supposed to come into effect just over a month ago.",44,57,fresh assault,4,1,5
33J5JKFMK6ZMYZK4Z3P7Q64RZV9Q3D,"It comes after government forces launched a fresh assault on Rastan at the weekend, despite a UN-backed nominal ceasefire that was supposed to come into effect just over a month ago.",50,57,assault,4,5,9
33J5JKFMK6ZMYZK4Z3P7Q64RZV9Q3D,"It comes after government forces launched a fresh assault on Rastan at the weekend, despite a UN-backed nominal ceasefire that was supposed to come into effect just over a month ago.",84,91,despite,1,1,2
33J5JKFMK6ZMYZK4Z3P7Q64RZV9Q3D,"It comes after government forces launched a fresh assault on Rastan at the weekend, despite a UN-backed nominal ceasefire that was supposed to come into effect just over a month ago.",94,103,UN-backed,1,0,1
33J5JKFMK6ZMYZK4Z3P7Q64RZV9Q3D,"It comes after government forces launched a fresh assault on Rastan at the weekend, despite a UN-backed nominal ceasefire that was supposed to come into effect just over a month ago.",94,121,UN-backed nominal ceasefire,0,2,2
33J5JKFMK6ZMYZK4Z3P7Q64RZV9Q3D,"It comes after government forces launched a fresh assault on Rastan at the weekend, despite a UN-backed nominal ceasefire that was supposed to come into effect just over a month ago.",104,111,nominal,2,1,3
33J5JKFMK6ZMYZK4Z3P7Q64RZV9Q3D,"It comes after government forces launched a fresh assault on Rastan at the weekend, despite a UN-backed nominal ceasefire that was supposed to come into effect just over a month ago.",104,121,nominal ceasefire,10,2,12
33J5JKFMK6ZMYZK4Z3P7Q64RZV9Q3D,"It comes after government forces launched a fresh assault on Rastan at the weekend, despite a UN-backed nominal ceasefire that was supposed to come into effect just over a month ago.",112,121,ceasefire,1,4,5
33J5JKFMK6ZMYZK4Z3P7Q64RZV9Q3D,"It comes after government forces launched a fresh assault on Rastan at the weekend, despite a UN-backed nominal ceasefire that was supposed to come into effect just over a month ago.",131,139,supposed,0,1,1
33J5JKFMK6ZMYZK4Z3P7Q64RZV9Q3D,"Meanwhile, the EU has imposed another round of sanctions on Syria - the 15th so far - in an effort to increase pressure on the government.",22,29,imposed,6,6,12
33J5JKFMK6ZMYZK4Z3P7Q64RZV9Q3D,"Meanwhile, the EU has imposed another round of sanctions on Syria - the 15th so far - in an effort to increase pressure on the government.",38,56,round of sanctions,1,1,2
33J5JKFMK6ZMYZK4Z3P7Q64RZV9Q3D,"Meanwhile, the EU has imposed another round of sanctions on Syria - the 15th so far - in an effort to increase pressure on the government.",47,56,sanctions,10,1,11
33J5JKFMK6ZMYZK4Z3P7Q64RZV9Q3D,"Meanwhile, the EU has imposed another round of sanctions on Syria - the 15th so far - in an effort to increase pressure on the government.",127,137,government,1,0,1
33J5JKFMK6ZMYZK4Z3P7Q64RZV9Q3D,"The Observatory said Rastan, which lies 180km (120 miles) north of Damascus, was subjected to sustained shelling overnight, leaving dozens of people injured.",4,15,Observatory,3,1,4
33J5JKFMK6ZMYZK4Z3P7Q64RZV9Q3D,"The Observatory said Rastan, which lies 180km (120 miles) north of Damascus, was subjected to sustained shelling overnight, leaving dozens of people injured.",67,75,Damascus,0,1,1
33J5JKFMK6ZMYZK4Z3P7Q64RZV9Q3D,"The Observatory said Rastan, which lies 180km (120 miles) north of Damascus, was subjected to sustained shelling overnight, leaving dozens of people injured.",81,90,subjected,1,2,3
33J5JKFMK6ZMYZK4Z3P7Q64RZV9Q3D,"The Observatory said Rastan, which lies 180km (120 miles) north of Damascus, was subjected to sustained shelling overnight, leaving dozens of people injured.",94,103,sustained,6,4,10
33J5JKFMK6ZMYZK4Z3P7Q64RZV9Q3D,"The Observatory said Rastan, which lies 180km (120 miles) north of Damascus, was subjected to sustained shelling overnight, leaving dozens of people injured.",94,112,sustained shelling,4,2,6
33J5JKFMK6ZMYZK4Z3P7Q64RZV9Q3D,"The Observatory said Rastan, which lies 180km (120 miles) north of Damascus, was subjected to sustained shelling overnight, leaving dozens of people injured.",104,112,shelling,7,4,11
33J5JKFMK6ZMYZK4Z3P7Q64RZV9Q3D,"The Observatory said Rastan, which lies 180km (120 miles) north of Damascus, was subjected to sustained shelling overnight, leaving dozens of people injured.",104,122,shelling overnight,0,1,1
33J5JKFMK6ZMYZK4Z3P7Q64RZV9Q3D,"The Observatory said Rastan, which lies 180km (120 miles) north of Damascus, was subjected to sustained shelling overnight, leaving dozens of people injured.",113,122,overnight,0,2,2
33J5JKFMK6ZMYZK4Z3P7Q64RZV9Q3D,"The city, currently an opposition stronghold, has been fiercely contested during the Syrian uprising and control of the town has changed several times.",23,33,opposition,4,0,4
33J5JKFMK6ZMYZK4Z3P7Q64RZV9Q3D,"The city, currently an opposition stronghold, has been fiercely contested during the Syrian uprising and control of the town has changed several times.",23,44,opposition stronghold,6,1,7
33J5JKFMK6ZMYZK4Z3P7Q64RZV9Q3D,"The city, currently an opposition stronghold, has been fiercely contested during the Syrian uprising and control of the town has changed several times.",34,44,stronghold,4,7,11
33J5JKFMK6ZMYZK4Z3P7Q64RZV9Q3D,"The city, currently an opposition stronghold, has been fiercely contested during the Syrian uprising and control of the town has changed several times.",55,63,fiercely,4,7,11
33J5JKFMK6ZMYZK4Z3P7Q64RZV9Q3D,"The city, currently an opposition stronghold, has been fiercely contested during the Syrian uprising and control of the town has changed several times.",55,73,fiercely contested,1,1,2
33J5JKFMK6ZMYZK4Z3P7Q64RZV9Q3D,"The city, currently an opposition stronghold, has been fiercely contested during the Syrian uprising and control of the town has changed several times.",64,73,contested,2,3,5
33J5JKFMK6ZMYZK4Z3P7Q64RZV9Q3D,"The city, currently an opposition stronghold, has been fiercely contested during the Syrian uprising and control of the town has changed several times.",92,100,uprising,4,3,7
3U18MJKL1UNP823VC48RFFDG1A2NCF,"Thomas's husband, the father of all of the children, moved out of the house a few months ago, he added.",53,62,moved out,0,1,1
3U18MJKL1UNP823VC48RFFDG1A2NCF,"It's hard to take in.	6	21	hard to take in	0	2	2
3U18MJKL1UNP823VC48RFFDG1A2NCF	It's hard to take in.",11,21,to take in,1,0,1
3U18MJKL1UNP823VC48RFFDG1A2NCF,"This is a pretty peaceful place, normally,"" he said.",10,25,pretty peaceful,0,1,1
3U18MJKL1UNP823VC48RFFDG1A2NCF,"This is a pretty peaceful place, normally,"" he said.",17,25,peaceful,6,1,7
3U18MJKL1UNP823VC48RFFDG1A2NCF,"This is a pretty peaceful place, normally,"" he said.",17,31,peaceful place,1,0,1
3U18MJKL1UNP823VC48RFFDG1A2NCF,"This is a pretty peaceful place, normally,"" he said.",33,41,normally,1,1,2
3U18MJKL1UNP823VC48RFFDG1A2NCF,Tuesday's incident was the second deadly shooting in Port St. John in the past week.,10,18,incident,9,6,15
3U18MJKL1UNP823VC48RFFDG1A2NCF,Tuesday's incident was the second deadly shooting in Port St. John in the past week.,34,40,deadly,0,1,1
3U18MJKL1UNP823VC48RFFDG1A2NCF,Tuesday's incident was the second deadly shooting in Port St. John in the past week.,34,49,deadly shooting,0,3,3
3U18MJKL1UNP823VC48RFFDG1A2NCF,Tuesday's incident was the second deadly shooting in Port St. John in the past week.,41,49,shooting,0,1,1
3U18MJKL1UNP823VC48RFFDG1A2NCF,"Brevard County was the scene of six homicides in 2011, Goodyear said.",23,28,scene,0,1,1
3U18MJKL1UNP823VC48RFFDG1A2NCF,"Brevard County was the scene of six homicides in 2011, Goodyear said.",36,45,homicides,10,10,20
3U18MJKL1UNP823VC48RFFDG1A2NCF,"Brevard County was the scene of six homicides in 2011, Goodyear said.",55,63,Goodyear,0,1,1
3U18MJKL1UNP823VC48RFFDG1A2NCF,Police said three of the four children ran to their next-door neighbour's house before their mother - identified as 33-year-old Tanya Thomas - called them back home and killed them.,39,42,ran,0,1,1
3U18MJKL1UNP823VC48RFFDG1A2NCF,Police said three of the four children ran to their next-door neighbour's house before their mother - identified as 33-year-old Tanya Thomas - called them back home and killed them.,52,61,next-door,0,1,1
3U18MJKL1UNP823VC48RFFDG1A2NCF,Police said three of the four children ran to their next-door neighbour's house before their mother - identified as 33-year-old Tanya Thomas - called them back home and killed them.,52,71,next-door neighbour,0,1,1
3U18MJKL1UNP823VC48RFFDG1A2NCF,Police said three of the four children ran to their next-door neighbour's house before their mother - identified as 33-year-old Tanya Thomas - called them back home and killed them.,52,72,next-door neighbours,0,1,1
3U18MJKL1UNP823VC48RFFDG1A2NCF,Police said three of the four children ran to their next-door neighbour's house before their mother - identified as 33-year-old Tanya Thomas - called them back home and killed them.,62,72,neighbours,1,4,5
3U18MJKL1UNP823VC48RFFDG1A2NCF,Police said three of the four children ran to their next-door neighbour's house before their mother - identified as 33-year-old Tanya Thomas - called them back home and killed them.,102,112,identified,4,5,9
3U18MJKL1UNP823VC48RFFDG1A2NCF,"Brevard County Sheriff's Lt Tod Goodyear said the neighbour called 911 after being awoken by gunshots coming from a home in Port St John, east of Orlando, at 4.50am local time.",8,14,County,0,2,2
3U18MJKL1UNP823VC48RFFDG1A2NCF,"Brevard County Sheriff's Lt Tod Goodyear said the neighbour called 911 after being awoken by gunshots coming from a home in Port St John, east of Orlando, at 4.50am local time.",15,22,Sheriff,1,0,1
3U18MJKL1UNP823VC48RFFDG1A2NCF,"Brevard County Sheriff's Lt Tod Goodyear said the neighbour called 911 after being awoken by gunshots coming from a home in Port St John, east of Orlando, at 4.50am local time.",50,59,neighbour,1,1,2
3U18MJKL1UNP823VC48RFFDG1A2NCF,"Brevard County Sheriff's Lt Tod Goodyear said the neighbour called 911 after being awoken by gunshots coming from a home in Port St John, east of Orlando, at 4.50am local time.",77,89,being awoken,1,1,2
3U18MJKL1UNP823VC48RFFDG1A2NCF,"Brevard County Sheriff's Lt Tod Goodyear said the neighbour called 911 after being awoken by gunshots coming from a home in Port St John, east of Orlando, at 4.50am local time.",83,89,awoken,9,6,15
3U18MJKL1UNP823VC48RFFDG1A2NCF,"Brevard County Sheriff's Lt Tod Goodyear said the neighbour called 911 after being awoken by gunshots coming from a home in Port St John, east of Orlando, at 4.50am local time.",93,101,gunshots,1,4,5
3U18MJKL1UNP823VC48RFFDG1A2NCF,"Brevard County Sheriff's Lt Tod Goodyear said the neighbour called 911 after being awoken by gunshots coming from a home in Port St John, east of Orlando, at 4.50am local time.",102,108,coming,0,1,1
3U18MJKL1UNP823VC48RFFDG1A2NCF,"Brevard County Sheriff's Lt Tod Goodyear said the neighbour called 911 after being awoken by gunshots coming from a home in Port St John, east of Orlando, at 4.50am local time.",165,175,local time,0,1,1
3NQUW096N69XM4T7O7IL0X8JQUZ9LI,"Two ""Chinese maritime surveillance ships"" then sailed to the shoal on Tuesday, the statement said.",5,40,Chinese maritime surveillance ships,1,0,1
3NQUW096N69XM4T7O7IL0X8JQUZ9LI,"Two ""Chinese maritime surveillance ships"" then sailed to the shoal on Tuesday, the statement said.",13,21,maritime,3,5,8
3NQUW096N69XM4T7O7IL0X8JQUZ9LI,"Two ""Chinese maritime surveillance ships"" then sailed to the shoal on Tuesday, the statement said.",13,34,maritime surveillance,7,1,8
3NQUW096N69XM4T7O7IL0X8JQUZ9LI,"Two ""Chinese maritime surveillance ships"" then sailed to the shoal on Tuesday, the statement said.",13,40,maritime surveillance ships,2,1,3
3NQUW096N69XM4T7O7IL0X8JQUZ9LI,"Two ""Chinese maritime surveillance ships"" then sailed to the shoal on Tuesday, the statement said.",22,34,surveillance,3,6,9
3NQUW096N69XM4T7O7IL0X8JQUZ9LI,"Two ""Chinese maritime surveillance ships"" then sailed to the shoal on Tuesday, the statement said.",22,40,surveillance ships,0,1,1
3NQUW096N69XM4T7O7IL0X8JQUZ9LI,"Two ""Chinese maritime surveillance ships"" then sailed to the shoal on Tuesday, the statement said.",61,66,shoal,7,5,12
3NQUW096N69XM4T7O7IL0X8JQUZ9LI,"The ships placed themselves between the Gregorio del Pilar and the fishing vessels, ""thus preventing the arrest of the erring Chinese fishermen"", the statement said.",40,58,Gregorio del Pilar,1,0,1
3NQUW096N69XM4T7O7IL0X8JQUZ9LI,"The ships placed themselves between the Gregorio del Pilar and the fishing vessels, ""thus preventing the arrest of the erring Chinese fishermen"", the statement said.",67,82,fishing vessels,1,2,3
3NQUW096N69XM4T7O7IL0X8JQUZ9LI,"The ships placed themselves between the Gregorio del Pilar and the fishing vessels, ""thus preventing the arrest of the erring Chinese fishermen"", the statement said.",75,82,vessels,4,1,5
3NQUW096N69XM4T7O7IL0X8JQUZ9LI,"The ships placed themselves between the Gregorio del Pilar and the fishing vessels, ""thus preventing the arrest of the erring Chinese fishermen"", the statement said.",90,100,preventing,1,1,2
3NQUW096N69XM4T7O7IL0X8JQUZ9LI,"The ships placed themselves between the Gregorio del Pilar and the fishing vessels, ""thus preventing the arrest of the erring Chinese fishermen"", the statement said.",119,125,erring,10,10,20
3NQUW096N69XM4T7O7IL0X8JQUZ9LI,"The ships placed themselves between the Gregorio del Pilar and the fishing vessels, ""thus preventing the arrest of the erring Chinese fishermen"", the statement said.",119,143,erring Chinese fishermen,1,0,1
3NQUW096N69XM4T7O7IL0X8JQUZ9LI,"The situation has remained unchanged as of this morning, it added.",5,14,situation,0,1,1
3NQUW096N69XM4T7O7IL0X8JQUZ9LI,"The situation has remained unchanged as of this morning, it added.",19,37,remained unchanged,0,1,1
3NQUW096N69XM4T7O7IL0X8JQUZ9LI,"The situation has remained unchanged as of this morning, it added.",28,37,unchanged,1,0,1
3NQUW096N69XM4T7O7IL0X8JQUZ9LI,"Del Rosario had contacted Ma to emphasise that the area was ""an integral part of Philippine territory"" and invite him for talks aimed at finding a diplomatic solution, according to the statement.",26,28,Ma,1,0,1
3NQUW096N69XM4T7O7IL0X8JQUZ9LI,"Del Rosario had contacted Ma to emphasise that the area was ""an integral part of Philippine territory"" and invite him for talks aimed at finding a diplomatic solution, according to the statement.",32,41,emphasise,10,8,18
3NQUW096N69XM4T7O7IL0X8JQUZ9LI,"Del Rosario had contacted Ma to emphasise that the area was ""an integral part of Philippine territory"" and invite him for talks aimed at finding a diplomatic solution, according to the statement.",61,77,an integral part,1,0,1
3NQUW096N69XM4T7O7IL0X8JQUZ9LI,"Del Rosario had contacted Ma to emphasise that the area was ""an integral part of Philippine territory"" and invite him for talks aimed at finding a diplomatic solution, according to the statement.",64,72,integral,9,1,10
3NQUW096N69XM4T7O7IL0X8JQUZ9LI,"Del Rosario had contacted Ma to emphasise that the area was ""an integral part of Philippine territory"" and invite him for talks aimed at finding a diplomatic solution, according to the statement.",64,77,integral part,1,4,5
3NQUW096N69XM4T7O7IL0X8JQUZ9LI,"Del Rosario had contacted Ma to emphasise that the area was ""an integral part of Philippine territory"" and invite him for talks aimed at finding a diplomatic solution, according to the statement.",92,101,territory,1,1,2
3NQUW096N69XM4T7O7IL0X8JQUZ9LI,"Del Rosario had contacted Ma to emphasise that the area was ""an integral part of Philippine territory"" and invite him for talks aimed at finding a diplomatic solution, according to the statement.",128,133,aimed,0,2,2
3NQUW096N69XM4T7O7IL0X8JQUZ9LI,"Del Rosario had contacted Ma to emphasise that the area was ""an integral part of Philippine territory"" and invite him for talks aimed at finding a diplomatic solution, according to the statement.",147,157,diplomatic,6,3,9
3NQUW096N69XM4T7O7IL0X8JQUZ9LI,"Del Rosario had contacted Ma to emphasise that the area was ""an integral part of Philippine territory"" and invite him for talks aimed at finding a diplomatic solution, according to the statement.",147,166,diplomatic solution,4,3,7
3NQUW096N69XM4T7O7IL0X8JQUZ9LI,"Zhang Hua, a spokesman for China's embassy in Manila, told AFP on Wednesday he had no comment on the latest standoff.",13,22,spokesman,1,3,4
3NQUW096N69XM4T7O7IL0X8JQUZ9LI,"Zhang Hua, a spokesman for China's embassy in Manila, told AFP on Wednesday he had no comment on the latest standoff.",35,42,embassy,3,1,4
3NQUW096N69XM4T7O7IL0X8JQUZ9LI,"Zhang Hua, a spokesman for China's embassy in Manila, told AFP on Wednesday he had no comment on the latest standoff.",59,62,AFP,1,0,1
3NQUW096N69XM4T7O7IL0X8JQUZ9LI,"Zhang Hua, a spokesman for China's embassy in Manila, told AFP on Wednesday he had no comment on the latest standoff.",108,116,standoff,5,10,15
3NQUW096N69XM4T7O7IL0X8JQUZ9LI,"The incident is the latest flare-up in tensions between the two countries over competing territorial claims to parts of the South China Sea, which is believed to sit atop vast oil and gas deposits.",4,12,incident,0,1,1
3NQUW096N69XM4T7O7IL0X8JQUZ9LI,"The incident is the latest flare-up in tensions between the two countries over competing territorial claims to parts of the South China Sea, which is believed to sit atop vast oil and gas deposits.",27,35,flare-up,5,9,14
3NQUW096N69XM4T7O7IL0X8JQUZ9LI,"The incident is the latest flare-up in tensions between the two countries over competing territorial claims to parts of the South China Sea, which is believed to sit atop vast oil and gas deposits.",39,47,tensions,2,1,3
3NQUW096N69XM4T7O7IL0X8JQUZ9LI,"The incident is the latest flare-up in tensions between the two countries over competing territorial claims to parts of the South China Sea, which is believed to sit atop vast oil and gas deposits.",79,88,competing,1,2,3
3NQUW096N69XM4T7O7IL0X8JQUZ9LI,"The incident is the latest flare-up in tensions between the two countries over competing territorial claims to parts of the South China Sea, which is believed to sit atop vast oil and gas deposits.",79,107,competing territorial claims,3,0,3
3NQUW096N69XM4T7O7IL0X8JQUZ9LI,"The incident is the latest flare-up in tensions between the two countries over competing territorial claims to parts of the South China Sea, which is believed to sit atop vast oil and gas deposits.",89,100,territorial,7,0,7
3NQUW096N69XM4T7O7IL0X8JQUZ9LI,"The incident is the latest flare-up in tensions between the two countries over competing territorial claims to parts of the South China Sea, which is believed to sit atop vast oil and gas deposits.",89,107,territorial claims,1,4,5
3NQUW096N69XM4T7O7IL0X8JQUZ9LI,"The incident is the latest flare-up in tensions between the two countries over competing territorial claims to parts of the South China Sea, which is believed to sit atop vast oil and gas deposits.",166,170,atop,2,5,7
3NQUW096N69XM4T7O7IL0X8JQUZ9LI,"The incident is the latest flare-up in tensions between the two countries over competing territorial claims to parts of the South China Sea, which is believed to sit atop vast oil and gas deposits.",171,175,vast,3,0,3
3NQUW096N69XM4T7O7IL0X8JQUZ9LI,"The incident is the latest flare-up in tensions between the two countries over competing territorial claims to parts of the South China Sea, which is believed to sit atop vast oil and gas deposits.",171,196,vast oil and gas deposits,1,0,1
33P2GD6NRNTFH4T81JUCYETSK72KHG,"This situation has remained unchanged as of Wednesday morning, the DFA said.",5,14,situation,1,1,2
33P2GD6NRNTFH4T81JUCYETSK72KHG,"This situation has remained unchanged as of Wednesday morning, the DFA said.",19,37,remained unchanged,0,1,1
33P2GD6NRNTFH4T81JUCYETSK72KHG,"This situation has remained unchanged as of Wednesday morning, the DFA said.",28,37,unchanged,1,2,3
33P2GD6NRNTFH4T81JUCYETSK72KHG,"This situation has remained unchanged as of Wednesday morning, the DFA said.",67,70,DFA,0,1,1
33P2GD6NRNTFH4T81JUCYETSK72KHG,"PHL soldiers harassed Chinese fishermen In a statement on Wednesday, the Chinese Embassy said the two Chinese Marine Surveillance ships were sent in the area to safeguard China's maritime rights and interests after Philippine soldiers harassed the Chinese fishermen.",0,3,PHL,0,1,1
33P2GD6NRNTFH4T81JUCYETSK72KHG,"PHL soldiers harassed Chinese fishermen In a statement on Wednesday, the Chinese Embassy said the two Chinese Marine Surveillance ships were sent in the area to safeguard China's maritime rights and interests after Philippine soldiers harassed the Chinese fishermen.",13,21,harassed,10,10,20
33P2GD6NRNTFH4T81JUCYETSK72KHG,"PHL soldiers harassed Chinese fishermen In a statement on Wednesday, the Chinese Embassy said the two Chinese Marine Surveillance ships were sent in the area to safeguard China's maritime rights and interests after Philippine soldiers harassed the Chinese fishermen.",81,88,Embassy,0,1,1
33P2GD6NRNTFH4T81JUCYETSK72KHG,"PHL soldiers harassed Chinese fishermen In a statement on Wednesday, the Chinese Embassy said the two Chinese Marine Surveillance ships were sent in the area to safeguard China's maritime rights and interests after Philippine soldiers harassed the Chinese fishermen.",110,116,Marine,1,0,1
33P2GD6NRNTFH4T81JUCYETSK72KHG,"PHL soldiers harassed Chinese fishermen In a statement on Wednesday, the Chinese Embassy said the two Chinese Marine Surveillance ships were sent in the area to safeguard China's maritime rights and interests after Philippine soldiers harassed the Chinese fishermen.",110,129,Marine Surveillance,0,1,1
33P2GD6NRNTFH4T81JUCYETSK72KHG,"PHL soldiers harassed Chinese fishermen In a statement on Wednesday, the Chinese Embassy said the two Chinese Marine Surveillance ships were sent in the area to safeguard China's maritime rights and interests after Philippine soldiers harassed the Chinese fishermen.",110,135,Marine Surveillance ships,1,1,2
33P2GD6NRNTFH4T81JUCYETSK72KHG,"PHL soldiers harassed Chinese fishermen In a statement on Wednesday, the Chinese Embassy said the two Chinese Marine Surveillance ships were sent in the area to safeguard China's maritime rights and interests after Philippine soldiers harassed the Chinese fishermen.",117,129,Surveillance,4,8,12
33P2GD6NRNTFH4T81JUCYETSK72KHG,"PHL soldiers harassed Chinese fishermen In a statement on Wednesday, the Chinese Embassy said the two Chinese Marine Surveillance ships were sent in the area to safeguard China's maritime rights and interests after Philippine soldiers harassed the Chinese fishermen.",117,135,Surveillance ships,0,1,1
33P2GD6NRNTFH4T81JUCYETSK72KHG,"PHL soldiers harassed Chinese fishermen In a statement on Wednesday, the Chinese Embassy said the two Chinese Marine Surveillance ships were sent in the area to safeguard China's maritime rights and interests after Philippine soldiers harassed the Chinese fishermen.",161,170,safeguard,5,7,12
33P2GD6NRNTFH4T81JUCYETSK72KHG,"PHL soldiers harassed Chinese fishermen In a statement on Wednesday, the Chinese Embassy said the two Chinese Marine Surveillance ships were sent in the area to safeguard China's maritime rights and interests after Philippine soldiers harassed the Chinese fishermen.",179,187,maritime,7,2,9
33P2GD6NRNTFH4T81JUCYETSK72KHG,"PHL soldiers harassed Chinese fishermen In a statement on Wednesday, the Chinese Embassy said the two Chinese Marine Surveillance ships were sent in the area to safeguard China's maritime rights and interests after Philippine soldiers harassed the Chinese fishermen.",179,194,maritime rights,2,2,4
33P2GD6NRNTFH4T81JUCYETSK72KHG,"PHL soldiers harassed Chinese fishermen In a statement on Wednesday, the Chinese Embassy said the two Chinese Marine Surveillance ships were sent in the area to safeguard China's maritime rights and interests after Philippine soldiers harassed the Chinese fishermen.",179,208,maritime rights and interests,1,1,2
33P2GD6NRNTFH4T81JUCYETSK72KHG,"PHL soldiers harassed Chinese fishermen In a statement on Wednesday, the Chinese Embassy said the two Chinese Marine Surveillance ships were sent in the area to safeguard China's maritime rights and interests after Philippine soldiers harassed the Chinese fishermen.",235,243,harassed,6,3,9
33P2GD6NRNTFH4T81JUCYETSK72KHG,"Also, the statement claims that the Huangyan Island (Panatag Shoal, its Philippine name) is an integral part of Chinese territory.",95,103,integral,10,2,12
33P2GD6NRNTFH4T81JUCYETSK72KHG,"Also, the statement claims that the Huangyan Island (Panatag Shoal, its Philippine name) is an integral part of Chinese territory.",95,108,integral part,1,3,4
33P2GD6NRNTFH4T81JUCYETSK72KHG,"Also, the statement claims that the Huangyan Island (Panatag Shoal, its Philippine name) is an integral part of Chinese territory.",120,129,territory,3,1,4
33P2GD6NRNTFH4T81JUCYETSK72KHG,"Moreover, it said that the Chinese fishermen were moving into the island when a Philippine Naval gunboat blocked the entrance of the Huangyan Island lagnoon, triggering the standoff.",0,8,Moreover,2,1,3
33P2GD6NRNTFH4T81JUCYETSK72KHG,"Moreover, it said that the Chinese fishermen were moving into the island when a Philippine Naval gunboat blocked the entrance of the Huangyan Island lagnoon, triggering the standoff.",66,72,island,0,1,1
33P2GD6NRNTFH4T81JUCYETSK72KHG,"Moreover, it said that the Chinese fishermen were moving into the island when a Philippine Naval gunboat blocked the entrance of the Huangyan Island lagnoon, triggering the standoff.",91,104,Naval gunboat,0,1,1
33P2GD6NRNTFH4T81JUCYETSK72KHG,"Moreover, it said that the Chinese fishermen were moving into the island when a Philippine Naval gunboat blocked the entrance of the Huangyan Island lagnoon, triggering the standoff.",97,104,gunboat,0,1,1
33P2GD6NRNTFH4T81JUCYETSK72KHG,"Moreover, it said that the Chinese fishermen were moving into the island when a Philippine Naval gunboat blocked the entrance of the Huangyan Island lagnoon, triggering the standoff.",105,112,blocked,0,1,1
33P2GD6NRNTFH4T81JUCYETSK72KHG,"Moreover, it said that the Chinese fishermen were moving into the island when a Philippine Naval gunboat blocked the entrance of the Huangyan Island lagnoon, triggering the standoff.",149,156,lagnoon,3,3,6
33P2GD6NRNTFH4T81JUCYETSK72KHG,"Moreover, it said that the Chinese fishermen were moving into the island when a Philippine Naval gunboat blocked the entrance of the Huangyan Island lagnoon, triggering the standoff.",158,168,triggering,8,3,11
33P2GD6NRNTFH4T81JUCYETSK72KHG,"Moreover, it said that the Chinese fishermen were moving into the island when a Philippine Naval gunboat blocked the entrance of the Huangyan Island lagnoon, triggering the standoff.",158,181,triggering the standoff,1,1,2
33P2GD6NRNTFH4T81JUCYETSK72KHG,"Moreover, it said that the Chinese fishermen were moving into the island when a Philippine Naval gunboat blocked the entrance of the Huangyan Island lagnoon, triggering the standoff.",173,181,standoff,7,10,17
33P2GD6NRNTFH4T81JUCYETSK72KHG,"A Florida mom went on a murderous rampage, killing her four children early today before turning the gun on herself.",24,33,murderous,3,1,4
33P2GD6NRNTFH4T81JUCYETSK72KHG,"A Florida mom went on a murderous rampage, killing her four children early today before turning the gun on herself.",24,41,murderous rampage,4,3,7
33P2GD6NRNTFH4T81JUCYETSK72KHG,"A Florida mom went on a murderous rampage, killing her four children early today before turning the gun on herself.",34,41,rampage,8,6,14
33P2GD6NRNTFH4T81JUCYETSK72KHG,"The murders happened around 4:30 a.m. in Port St. John, Fla.",12,20,happened,0,1,1
3NRZ1LDP7W72JGQIKX5RU2JW9UMPZI,"Prime Minister Mariano Rajoy's government took the sweeping action just two    days after it nationalised the fourth-biggest bank, Bankia, to salvage a    balance sheet dripping in red ink.",31,41,government,1,0,1
3NRZ1LDP7W72JGQIKX5RU2JW9UMPZI,"Prime Minister Mariano Rajoy's government took the sweeping action just two    days after it nationalised the fourth-biggest bank, Bankia, to salvage a    balance sheet dripping in red ink.",51,59,sweeping,4,8,12
3NRZ1LDP7W72JGQIKX5RU2JW9UMPZI,"Prime Minister Mariano Rajoy's government took the sweeping action just two    days after it nationalised the fourth-biggest bank, Bankia, to salvage a    balance sheet dripping in red ink.",51,66,sweeping action,5,3,8
3NRZ1LDP7W72JGQIKX5RU2JW9UMPZI,"Prime Minister Mariano Rajoy's government took the sweeping action just two    days after it nationalised the fourth-biggest bank, Bankia, to salvage a    balance sheet dripping in red ink.",93,105,nationalised,8,4,12
3NRZ1LDP7W72JGQIKX5RU2JW9UMPZI,"Prime Minister Mariano Rajoy's government took the sweeping action just two    days after it nationalised the fourth-biggest bank, Bankia, to salvage a    balance sheet dripping in red ink.",142,149,salvage,8,9,17
3NRZ1LDP7W72JGQIKX5RU2JW9UMPZI,"Prime Minister Mariano Rajoy's government took the sweeping action just two    days after it nationalised the fourth-biggest bank, Bankia, to salvage a    balance sheet dripping in red ink.",155,168,balance sheet,3,1,4
3NRZ1LDP7W72JGQIKX5RU2JW9UMPZI,"Prime Minister Mariano Rajoy's government took the sweeping action just two    days after it nationalised the fourth-biggest bank, Bankia, to salvage a    balance sheet dripping in red ink.",155,188,balance sheet dripping in red ink,2,0,2
3NRZ1LDP7W72JGQIKX5RU2JW9UMPZI,"Prime Minister Mariano Rajoy's government took the sweeping action just two    days after it nationalised the fourth-biggest bank, Bankia, to salvage a    balance sheet dripping in red ink.",169,177,dripping,3,10,13
3NRZ1LDP7W72JGQIKX5RU2JW9UMPZI,"Prime Minister Mariano Rajoy's government took the sweeping action just two    days after it nationalised the fourth-biggest bank, Bankia, to salvage a    balance sheet dripping in red ink.",169,188,dripping in red ink,1,1,2
3NRZ1LDP7W72JGQIKX5RU2JW9UMPZI,"Prime Minister Mariano Rajoy's government took the sweeping action just two    days after it nationalised the fourth-biggest bank, Bankia, to salvage a    balance sheet dripping in red ink.",181,188,red ink,1,0,1
3NRZ1LDP7W72JGQIKX5RU2JW9UMPZI,"Madrid will charge two independent auditing firms with valuing banks' exposure    to the collapsed property sector, ministers told a news conference after a    cabinet meeting.",23,34,independent,2,1,3
3NRZ1LDP7W72JGQIKX5RU2JW9UMPZI,"Madrid will charge two independent auditing firms with valuing banks' exposure    to the collapsed property sector, ministers told a news conference after a    cabinet meeting.",23,49,independent auditing firms,3,0,3
3NRZ1LDP7W72JGQIKX5RU2JW9UMPZI,"Madrid will charge two independent auditing firms with valuing banks' exposure    to the collapsed property sector, ministers told a news conference after a    cabinet meeting.",35,43,auditing,6,2,8
3NRZ1LDP7W72JGQIKX5RU2JW9UMPZI,"Madrid will charge two independent auditing firms with valuing banks' exposure    to the collapsed property sector, ministers told a news conference after a    cabinet meeting.",35,49,auditing firms,0,1,1
3NRZ1LDP7W72JGQIKX5RU2JW9UMPZI,"Madrid will charge two independent auditing firms with valuing banks' exposure    to the collapsed property sector, ministers told a news conference after a    cabinet meeting.",55,62,valuing,1,0,1
3NRZ1LDP7W72JGQIKX5RU2JW9UMPZI,"Madrid will charge two independent auditing firms with valuing banks' exposure    to the collapsed property sector, ministers told a news conference after a    cabinet meeting.",70,78,exposure,4,6,10
3NRZ1LDP7W72JGQIKX5RU2JW9UMPZI,"Madrid will charge two independent auditing firms with valuing banks' exposure    to the collapsed property sector, ministers told a news conference after a    cabinet meeting.",89,98,collapsed,4,6,10
3NRZ1LDP7W72JGQIKX5RU2JW9UMPZI,"Madrid will charge two independent auditing firms with valuing banks' exposure    to the collapsed property sector, ministers told a news conference after a    cabinet meeting.",89,114,collapsed property sector,3,0,3
3NRZ1LDP7W72JGQIKX5RU2JW9UMPZI,"Madrid will charge two independent auditing firms with valuing banks' exposure    to the collapsed property sector, ministers told a news conference after a    cabinet meeting.",99,114,property sector,2,0,2
3NRZ1LDP7W72JGQIKX5RU2JW9UMPZI,"Madrid will charge two independent auditing firms with valuing banks' exposure    to the collapsed property sector, ministers told a news conference after a    cabinet meeting.",160,167,cabinet,2,0,2
3NRZ1LDP7W72JGQIKX5RU2JW9UMPZI,"Madrid will charge two independent auditing firms with valuing banks' exposure    to the collapsed property sector, ministers told a news conference after a    cabinet meeting.",160,175,cabinet meeting,3,0,3
3NRZ1LDP7W72JGQIKX5RU2JW9UMPZI,"The government wants complete transparency, clarity is crucial to end    any doubt about Spain's solvency, Economy Minister Luis de Guindos    told the conference.",22,43,complete transparency,1,0,1
3NRZ1LDP7W72JGQIKX5RU2JW9UMPZI,"The government wants complete transparency, clarity is crucial to end    any doubt about Spain's solvency, Economy Minister Luis de Guindos    told the conference.",31,43,transparency,10,8,18
3NRZ1LDP7W72JGQIKX5RU2JW9UMPZI,"The government wants complete transparency, clarity is crucial to end    any doubt about Spain's solvency, Economy Minister Luis de Guindos    told the conference.",45,52,clarity,3,2,5
3NRZ1LDP7W72JGQIKX5RU2JW9UMPZI,"The government wants complete transparency, clarity is crucial to end    any doubt about Spain's solvency, Economy Minister Luis de Guindos    told the conference.",56,63,crucial,3,5,8
3NRZ1LDP7W72JGQIKX5RU2JW9UMPZI,"The government wants complete transparency, clarity is crucial to end    any doubt about Spain's solvency, Economy Minister Luis de Guindos    told the conference.",90,105,Spains solvency,1,0,1
3NRZ1LDP7W72JGQIKX5RU2JW9UMPZI,"The government wants complete transparency, clarity is crucial to end    any doubt about Spain's solvency, Economy Minister Luis de Guindos    told the conference.",98,106,solvency,7,6,13
3NRZ1LDP7W72JGQIKX5RU2JW9UMPZI,"As ministers spoke, however, Madrid's IBEX-35 index of leading shares plunged    3.32pc to 6,811.6 points, dragged down by plummeting values for even the    strongest banks.",46,69,index of leading shares,1,0,1
3NRZ1LDP7W72JGQIKX5RU2JW9UMPZI,"As ministers spoke, however, Madrid's IBEX-35 index of leading shares plunged    3.32pc to 6,811.6 points, dragged down by plummeting values for even the    strongest banks.",55,69,leading shares,0,1,1
3NRZ1LDP7W72JGQIKX5RU2JW9UMPZI,"As ministers spoke, however, Madrid's IBEX-35 index of leading shares plunged    3.32pc to 6,811.6 points, dragged down by plummeting values for even the    strongest banks.",55,77,leading shares plunged,1,0,1
3NRZ1LDP7W72JGQIKX5RU2JW9UMPZI,"As ministers spoke, however, Madrid's IBEX-35 index of leading shares plunged    3.32pc to 6,811.6 points, dragged down by plummeting values for even the    strongest banks.",70,77,plunged,4,8,12
3NRZ1LDP7W72JGQIKX5RU2JW9UMPZI,"As ministers spoke, however, Madrid's IBEX-35 index of leading shares plunged    3.32pc to 6,811.6 points, dragged down by plummeting values for even the    strongest banks.",107,114,dragged,1,1,2
3NRZ1LDP7W72JGQIKX5RU2JW9UMPZI,"As ministers spoke, however, Madrid's IBEX-35 index of leading shares plunged    3.32pc to 6,811.6 points, dragged down by plummeting values for even the    strongest banks.",107,119,dragged down,0,2,2
3NRZ1LDP7W72JGQIKX5RU2JW9UMPZI,"As ministers spoke, however, Madrid's IBEX-35 index of leading shares plunged    3.32pc to 6,811.6 points, dragged down by plummeting values for even the    strongest banks.",123,133,plummeting,7,10,17
3NRZ1LDP7W72JGQIKX5RU2JW9UMPZI,"As ministers spoke, however, Madrid's IBEX-35 index of leading shares plunged    3.32pc to 6,811.6 points, dragged down by plummeting values for even the    strongest banks.",123,140,plummeting values,3,1,4
3NRZ1LDP7W72JGQIKX5RU2JW9UMPZI,"Santander, the eurozone's biggest bank by assets, slumped 5.18pc to €4.665;    Spanish number-two BBVA dropped 5.84pc to €5; and Bankia skidded 3.37pc to    €2.034.",15,24,eurozones,2,0,2
3NRZ1LDP7W72JGQIKX5RU2JW9UMPZI,"Santander, the eurozone's biggest bank by assets, slumped 5.18pc to €4.665;    Spanish number-two BBVA dropped 5.84pc to €5; and Bankia skidded 3.37pc to    €2.034.",50,57,slumped,3,7,10
3NRZ1LDP7W72JGQIKX5RU2JW9UMPZI,"Santander, the eurozone's biggest bank by assets, slumped 5.18pc to €4.665;    Spanish number-two BBVA dropped 5.84pc to €5; and Bankia skidded 3.37pc to    €2.034.",103,110,dropped,0,1,1
3NRZ1LDP7W72JGQIKX5RU2JW9UMPZI,"Santander, the eurozone's biggest bank by assets, slumped 5.18pc to €4.665;    Spanish number-two BBVA dropped 5.84pc to €5; and Bankia skidded 3.37pc to    €2.034.",136,143,skidded,1,1,2
3QD8LUVX4XZ9LB8KZ08SZBY4B7Q5X9,Tensions stemming from the 14-month-old uprising against President Bashar Assad also touched off clashes across the border in Lebanon as the revolt threatened to morph into a broader conflict.,0,8,Tensions,5,0,5
3QD8LUVX4XZ9LB8KZ08SZBY4B7Q5X9,Tensions stemming from the 14-month-old uprising against President Bashar Assad also touched off clashes across the border in Lebanon as the revolt threatened to morph into a broader conflict.,0,17,Tensions stemming,1,0,1
3QD8LUVX4XZ9LB8KZ08SZBY4B7Q5X9,Tensions stemming from the 14-month-old uprising against President Bashar Assad also touched off clashes across the border in Lebanon as the revolt threatened to morph into a broader conflict.,9,17,stemming,9,10,19
3QD8LUVX4XZ9LB8KZ08SZBY4B7Q5X9,Tensions stemming from the 14-month-old uprising against President Bashar Assad also touched off clashes across the border in Lebanon as the revolt threatened to morph into a broader conflict.,40,48,uprising,5,6,11
3QD8LUVX4XZ9LB8KZ08SZBY4B7Q5X9,Tensions stemming from the 14-month-old uprising against President Bashar Assad also touched off clashes across the border in Lebanon as the revolt threatened to morph into a broader conflict.,85,96,touched off,1,2,3
3QD8LUVX4XZ9LB8KZ08SZBY4B7Q5X9,Tensions stemming from the 14-month-old uprising against President Bashar Assad also touched off clashes across the border in Lebanon as the revolt threatened to morph into a broader conflict.,85,104,touched off clashes,1,2,3
3QD8LUVX4XZ9LB8KZ08SZBY4B7Q5X9,Tensions stemming from the 14-month-old uprising against President Bashar Assad also touched off clashes across the border in Lebanon as the revolt threatened to morph into a broader conflict.,97,104,clashes,1,3,4
3QD8LUVX4XZ9LB8KZ08SZBY4B7Q5X9,Tensions stemming from the 14-month-old uprising against President Bashar Assad also touched off clashes across the border in Lebanon as the revolt threatened to morph into a broader conflict.,141,147,revolt,4,3,7
3QD8LUVX4XZ9LB8KZ08SZBY4B7Q5X9,Tensions stemming from the 14-month-old uprising against President Bashar Assad also touched off clashes across the border in Lebanon as the revolt threatened to morph into a broader conflict.,141,158,revolt threatened,1,1,2
3QD8LUVX4XZ9LB8KZ08SZBY4B7Q5X9,Tensions stemming from the 14-month-old uprising against President Bashar Assad also touched off clashes across the border in Lebanon as the revolt threatened to morph into a broader conflict.,148,158,threatened,1,2,3
3QD8LUVX4XZ9LB8KZ08SZBY4B7Q5X9,Tensions stemming from the 14-month-old uprising against President Bashar Assad also touched off clashes across the border in Lebanon as the revolt threatened to morph into a broader conflict.,162,167,morph,10,8,18
3QD8LUVX4XZ9LB8KZ08SZBY4B7Q5X9,Tensions stemming from the 14-month-old uprising against President Bashar Assad also touched off clashes across the border in Lebanon as the revolt threatened to morph into a broader conflict.,162,172,morph into,0,2,2
3QD8LUVX4XZ9LB8KZ08SZBY4B7Q5X9,Tensions stemming from the 14-month-old uprising against President Bashar Assad also touched off clashes across the border in Lebanon as the revolt threatened to morph into a broader conflict.,175,182,broader,2,1,3
3QD8LUVX4XZ9LB8KZ08SZBY4B7Q5X9,Tensions stemming from the 14-month-old uprising against President Bashar Assad also touched off clashes across the border in Lebanon as the revolt threatened to morph into a broader conflict.,175,191,broader conflict,1,2,3
3QD8LUVX4XZ9LB8KZ08SZBY4B7Q5X9,Tensions stemming from the 14-month-old uprising against President Bashar Assad also touched off clashes across the border in Lebanon as the revolt threatened to morph into a broader conflict.,183,191,conflict,3,2,5
3QD8LUVX4XZ9LB8KZ08SZBY4B7Q5X9,The relentless violence further undermines a U.N.-backed peace plan that is supposed to bring an end to Syria's deadly crisis.,4,14,relentless,6,10,16
3QD8LUVX4XZ9LB8KZ08SZBY4B7Q5X9,The relentless violence further undermines a U.N.-backed peace plan that is supposed to bring an end to Syria's deadly crisis.,4,23,relentless violence,1,2,3
3QD8LUVX4XZ9LB8KZ08SZBY4B7Q5X9,The relentless violence further undermines a U.N.-backed peace plan that is supposed to bring an end to Syria's deadly crisis.,15,23,violence,1,0,1
3QD8LUVX4XZ9LB8KZ08SZBY4B7Q5X9,The relentless violence further undermines a U.N.-backed peace plan that is supposed to bring an end to Syria's deadly crisis.,32,42,undermines,8,6,14
3QD8LUVX4XZ9LB8KZ08SZBY4B7Q5X9,The relentless violence further undermines a U.N.-backed peace plan that is supposed to bring an end to Syria's deadly crisis.,76,84,supposed,1,0,1
3QD8LUVX4XZ9LB8KZ08SZBY4B7Q5X9,The relentless violence further undermines a U.N.-backed peace plan that is supposed to bring an end to Syria's deadly crisis.,112,125,deadly crisis,0,1,1
3QD8LUVX4XZ9LB8KZ08SZBY4B7Q5X9,The relentless violence further undermines a U.N.-backed peace plan that is supposed to bring an end to Syria's deadly crisis.,119,125,crisis,2,2,4
3QD8LUVX4XZ9LB8KZ08SZBY4B7Q5X9,"A cease-fire that was supposed to begin on April 12 has had only a limited effect, throwing into doubt the rest of the plan that calls for talks between Assad's regime and those seeking to end his rule.",2,12,cease-fire,8,5,13
3QD8LUVX4XZ9LB8KZ08SZBY4B7Q5X9,"A cease-fire that was supposed to begin on April 12 has had only a limited effect, throwing into doubt the rest of the plan that calls for talks between Assad's regime and those seeking to end his rule.",22,30,supposed,1,0,1
3QD8LUVX4XZ9LB8KZ08SZBY4B7Q5X9,"A cease-fire that was supposed to begin on April 12 has had only a limited effect, throwing into doubt the rest of the plan that calls for talks between Assad's regime and those seeking to end his rule.",83,102,throwing into doubt,1,1,2
3QD8LUVX4XZ9LB8KZ08SZBY4B7Q5X9,"A cease-fire that was supposed to begin on April 12 has had only a limited effect, throwing into doubt the rest of the plan that calls for talks between Assad's regime and those seeking to end his rule.",161,167,regime,6,2,8
3QD8LUVX4XZ9LB8KZ08SZBY4B7Q5X9,"The raid against the impoverished village of al-Tamana, about 55 kilometers (35 miles) northwest of the city of Hama, began late Saturday and continued through the early hours on Sunday.",4,8,raid,1,2,3
3QD8LUVX4XZ9LB8KZ08SZBY4B7Q5X9,"The raid against the impoverished village of al-Tamana, about 55 kilometers (35 miles) northwest of the city of Hama, began late Saturday and continued through the early hours on Sunday.",21,33,impoverished,10,10,20
3QD8LUVX4XZ9LB8KZ08SZBY4B7Q5X9,"The raid against the impoverished village of al-Tamana, about 55 kilometers (35 miles) northwest of the city of Hama, began late Saturday and continued through the early hours on Sunday.",21,41,impoverished village,1,1,2
3QD8LUVX4XZ9LB8KZ08SZBY4B7Q5X9,"The raid against the impoverished village of al-Tamana, about 55 kilometers (35 miles) northwest of the city of Hama, began late Saturday and continued through the early hours on Sunday.",65,75,kilometers,2,0,2
3QD8LUVX4XZ9LB8KZ08SZBY4B7Q5X9,The Britain-based Syrian Observatory for Human Rights said five people were killed in the raid and government troops were setting fire to homes.,25,36,Observatory,0,2,2
3QD8LUVX4XZ9LB8KZ08SZBY4B7Q5X9,The Britain-based Syrian Observatory for Human Rights said five people were killed in the raid and government troops were setting fire to homes.,90,94,raid,0,1,1
3QD8LUVX4XZ9LB8KZ08SZBY4B7Q5X9,The Britain-based Syrian Observatory for Human Rights said five people were killed in the raid and government troops were setting fire to homes.,99,109,government,2,0,2
3QD8LUVX4XZ9LB8KZ08SZBY4B7Q5X9,The Britain-based Syrian Observatory for Human Rights said five people were killed in the raid and government troops were setting fire to homes.,122,129,setting,0,1,1
3GL25Y6843V7TITQRZPEGD9QX2GMXG,The incident occurred barely a week after President Benigno Aquino III pushed anew for a rules-based solution to the Spratlys row.,4,12,incident,7,4,11
3GL25Y6843V7TITQRZPEGD9QX2GMXG,The incident occurred barely a week after President Benigno Aquino III pushed anew for a rules-based solution to the Spratlys row.,4,21,incident occurred,0,1,1
3GL25Y6843V7TITQRZPEGD9QX2GMXG,The incident occurred barely a week after President Benigno Aquino III pushed anew for a rules-based solution to the Spratlys row.,13,21,occurred,2,0,2
3GL25Y6843V7TITQRZPEGD9QX2GMXG,The incident occurred barely a week after President Benigno Aquino III pushed anew for a rules-based solution to the Spratlys row.,22,28,barely,2,5,7
3GL25Y6843V7TITQRZPEGD9QX2GMXG,The incident occurred barely a week after President Benigno Aquino III pushed anew for a rules-based solution to the Spratlys row.,71,82,pushed anew,1,0,1
3GL25Y6843V7TITQRZPEGD9QX2GMXG,The incident occurred barely a week after President Benigno Aquino III pushed anew for a rules-based solution to the Spratlys row.,78,82,anew,4,3,7
3GL25Y6843V7TITQRZPEGD9QX2GMXG,The incident occurred barely a week after President Benigno Aquino III pushed anew for a rules-based solution to the Spratlys row.,89,100,rules-based,3,3,6
3GL25Y6843V7TITQRZPEGD9QX2GMXG,The incident occurred barely a week after President Benigno Aquino III pushed anew for a rules-based solution to the Spratlys row.,89,109,rules-based solution,1,0,1
3GL25Y6843V7TITQRZPEGD9QX2GMXG,The incident occurred barely a week after President Benigno Aquino III pushed anew for a rules-based solution to the Spratlys row.,101,109,solution,1,0,1
3GL25Y6843V7TITQRZPEGD9QX2GMXG,The incident occurred barely a week after President Benigno Aquino III pushed anew for a rules-based solution to the Spratlys row.,117,125,Spratlys,0,2,2
3GL25Y6843V7TITQRZPEGD9QX2GMXG,The incident occurred barely a week after President Benigno Aquino III pushed anew for a rules-based solution to the Spratlys row.,117,129,Spratlys row,2,1,3
3GL25Y6843V7TITQRZPEGD9QX2GMXG,The incident occurred barely a week after President Benigno Aquino III pushed anew for a rules-based solution to the Spratlys row.,126,129,row,1,1,2
3GL25Y6843V7TITQRZPEGD9QX2GMXG,"Earlier this month, Aquino urged the Association of Southeast Asian Nations to arrive at a common stand, even as he said the Philippines is willing to host a meeting on the matter.",20,26,Aquino,0,2,2
3GL25Y6843V7TITQRZPEGD9QX2GMXG,"Earlier this month, Aquino urged the Association of Southeast Asian Nations to arrive at a common stand, even as he said the Philippines is willing to host a meeting on the matter.",27,32,urged,4,5,9
3GL25Y6843V7TITQRZPEGD9QX2GMXG,"Earlier this month, Aquino urged the Association of Southeast Asian Nations to arrive at a common stand, even as he said the Philippines is willing to host a meeting on the matter.",37,48,Association,2,0,2
3GL25Y6843V7TITQRZPEGD9QX2GMXG,"Earlier this month, Aquino urged the Association of Southeast Asian Nations to arrive at a common stand, even as he said the Philippines is willing to host a meeting on the matter.",91,97,common,1,0,1
3GL25Y6843V7TITQRZPEGD9QX2GMXG,"Earlier this month, Aquino urged the Association of Southeast Asian Nations to arrive at a common stand, even as he said the Philippines is willing to host a meeting on the matter.",91,103,common stand,2,2,4
3GL25Y6843V7TITQRZPEGD9QX2GMXG,"Earlier this month, Aquino urged the Association of Southeast Asian Nations to arrive at a common stand, even as he said the Philippines is willing to host a meeting on the matter.",140,147,willing,1,0,1
3GL25Y6843V7TITQRZPEGD9QX2GMXG,"Earlier this month, Aquino urged the Association of Southeast Asian Nations to arrive at a common stand, even as he said the Philippines is willing to host a meeting on the matter.",151,155,host,0,2,2
3GL25Y6843V7TITQRZPEGD9QX2GMXG,"Earlier this month, Aquino urged the Association of Southeast Asian Nations to arrive at a common stand, even as he said the Philippines is willing to host a meeting on the matter.",151,165,host a meeting,0,1,1
3GL25Y6843V7TITQRZPEGD9QX2GMXG,"Aside from the Philippines and China, there are four other claimants to the Spratlys: Malaysia, Vietnam, Taiwan, and Brunei.",15,26,Philippines,1,0,1
3GL25Y6843V7TITQRZPEGD9QX2GMXG,"Aside from the Philippines and China, there are four other claimants to the Spratlys: Malaysia, Vietnam, Taiwan, and Brunei.",59,68,claimants,8,10,18
3GL25Y6843V7TITQRZPEGD9QX2GMXG,"Aside from the Philippines and China, there are four other claimants to the Spratlys: Malaysia, Vietnam, Taiwan, and Brunei.",76,84,Spratlys,2,0,2
3GL25Y6843V7TITQRZPEGD9QX2GMXG,"The DFA said a Philippine Navy surveillance aircraft monitored eight Chinese fishing vessels anchored inside the Panatag (Scarborough) Shoal in the West Philippine Sea on Sunday, April 8.",4,7,DFA,2,1,3
3GL25Y6843V7TITQRZPEGD9QX2GMXG,"The DFA said a Philippine Navy surveillance aircraft monitored eight Chinese fishing vessels anchored inside the Panatag (Scarborough) Shoal in the West Philippine Sea on Sunday, April 8.",15,43,Philippine Navy surveillance,1,0,1
3GL25Y6843V7TITQRZPEGD9QX2GMXG,"The DFA said a Philippine Navy surveillance aircraft monitored eight Chinese fishing vessels anchored inside the Panatag (Scarborough) Shoal in the West Philippine Sea on Sunday, April 8.",15,52,Philippine Navy surveillance aircraft,0,1,1
3GL25Y6843V7TITQRZPEGD9QX2GMXG,"The DFA said a Philippine Navy surveillance aircraft monitored eight Chinese fishing vessels anchored inside the Panatag (Scarborough) Shoal in the West Philippine Sea on Sunday, April 8.",31,43,surveillance,9,8,17
3GL25Y6843V7TITQRZPEGD9QX2GMXG,"The DFA said a Philippine Navy surveillance aircraft monitored eight Chinese fishing vessels anchored inside the Panatag (Scarborough) Shoal in the West Philippine Sea on Sunday, April 8.",31,52,surveillance aircraft,0,1,1
3GL25Y6843V7TITQRZPEGD9QX2GMXG,"The DFA said a Philippine Navy surveillance aircraft monitored eight Chinese fishing vessels anchored inside the Panatag (Scarborough) Shoal in the West Philippine Sea on Sunday, April 8.",53,62,monitored,5,2,7
3GL25Y6843V7TITQRZPEGD9QX2GMXG,"The DFA said a Philippine Navy surveillance aircraft monitored eight Chinese fishing vessels anchored inside the Panatag (Scarborough) Shoal in the West Philippine Sea on Sunday, April 8.",77,92,fishing vessels,0,1,1
3GL25Y6843V7TITQRZPEGD9QX2GMXG,"The DFA said a Philippine Navy surveillance aircraft monitored eight Chinese fishing vessels anchored inside the Panatag (Scarborough) Shoal in the West Philippine Sea on Sunday, April 8.",85,92,vessels,0,2,2
3GL25Y6843V7TITQRZPEGD9QX2GMXG,"The DFA said a Philippine Navy surveillance aircraft monitored eight Chinese fishing vessels anchored inside the Panatag (Scarborough) Shoal in the West Philippine Sea on Sunday, April 8.",85,101,vessels anchored,2,0,2
3GL25Y6843V7TITQRZPEGD9QX2GMXG,"The DFA said a Philippine Navy surveillance aircraft monitored eight Chinese fishing vessels anchored inside the Panatag (Scarborough) Shoal in the West Philippine Sea on Sunday, April 8.",93,101,anchored,4,7,11
3GL25Y6843V7TITQRZPEGD9QX2GMXG,"The DFA said a Philippine Navy surveillance aircraft monitored eight Chinese fishing vessels anchored inside the Panatag (Scarborough) Shoal in the West Philippine Sea on Sunday, April 8.",109,133,the Panatag (Scarborough,1,0,1
3GL25Y6843V7TITQRZPEGD9QX2GMXG,"The DFA said a Philippine Navy surveillance aircraft monitored eight Chinese fishing vessels anchored inside the Panatag (Scarborough) Shoal in the West Philippine Sea on Sunday, April 8.",135,140,Shoal,1,1,2
3GL25Y6843V7TITQRZPEGD9QX2GMXG,"It said Panatag Shoal is an integral part of Philippine territory, 124 nautical miles from the nearest base-point in Zambales.",28,36,integral,10,4,14
3GL25Y6843V7TITQRZPEGD9QX2GMXG,"It said Panatag Shoal is an integral part of Philippine territory, 124 nautical miles from the nearest base-point in Zambales.",28,41,integral part,1,1,2
3GL25Y6843V7TITQRZPEGD9QX2GMXG,"It said Panatag Shoal is an integral part of Philippine territory, 124 nautical miles from the nearest base-point in Zambales.",56,65,territory,2,1,3
3GL25Y6843V7TITQRZPEGD9QX2GMXG,"It said Panatag Shoal is an integral part of Philippine territory, 124 nautical miles from the nearest base-point in Zambales.",71,79,nautical,3,2,5
3GL25Y6843V7TITQRZPEGD9QX2GMXG,"It said Panatag Shoal is an integral part of Philippine territory, 124 nautical miles from the nearest base-point in Zambales.",71,85,nautical miles,1,3,4
3GL25Y6843V7TITQRZPEGD9QX2GMXG,"It said Panatag Shoal is an integral part of Philippine territory, 124 nautical miles from the nearest base-point in Zambales.",103,113,base-point,5,4,9
3GL25Y6843V7TITQRZPEGD9QX2GMXG,"It said Panatag Shoal is an integral part of Philippine territory, 124 nautical miles from the nearest base-point in Zambales.",117,125,Zambales,1,0,1
3G9UA71JVVVNDVHE6P8O6M4LQEI7JB,"A suicide attacker detonated a bomb at the gates of a compound used by foreigners in Kabul, Afghanistan, Wednesday, killing seven Afghans, officials said.",2,9,suicide,1,2,3
3G9UA71JVVVNDVHE6P8O6M4LQEI7JB,"A suicide attacker detonated a bomb at the gates of a compound used by foreigners in Kabul, Afghanistan, Wednesday, killing seven Afghans, officials said.",2,18,suicide attacker,3,1,4
3G9UA71JVVVNDVHE6P8O6M4LQEI7JB,"A suicide attacker detonated a bomb at the gates of a compound used by foreigners in Kabul, Afghanistan, Wednesday, killing seven Afghans, officials said.",19,28,detonated,9,9,18
3G9UA71JVVVNDVHE6P8O6M4LQEI7JB,"A suicide attacker detonated a bomb at the gates of a compound used by foreigners in Kabul, Afghanistan, Wednesday, killing seven Afghans, officials said.",19,35,detonated a bomb,0,1,1
3G9UA71JVVVNDVHE6P8O6M4LQEI7JB,"A suicide attacker detonated a bomb at the gates of a compound used by foreigners in Kabul, Afghanistan, Wednesday, killing seven Afghans, officials said.",54,62,compound,6,6,12
3G9UA71JVVVNDVHE6P8O6M4LQEI7JB,"A suicide attacker detonated a bomb at the gates of a compound used by foreigners in Kabul, Afghanistan, Wednesday, killing seven Afghans, officials said.",71,81,foreigners,1,1,2
3G9UA71JVVVNDVHE6P8O6M4LQEI7JB,"A suicide attacker detonated a bomb at the gates of a compound used by foreigners in Kabul, Afghanistan, Wednesday, killing seven Afghans, officials said.",130,137,Afghans,1,0,1
3G9UA71JVVVNDVHE6P8O6M4LQEI7JB,"A suicide attacker detonated a bomb at the gates of a compound used by foreigners in Kabul, Afghanistan, Wednesday, killing seven Afghans, officials said.",139,148,officials,1,0,1
3G9UA71JVVVNDVHE6P8O6M4LQEI7JB,"The Taliban claimed responsibility for the attack, saying it was a warning to U.S. President Obama, who had cleared Afghan airspace less than two hours before the incident, The New York Times reported.",4,11,Taliban,1,0,1
3G9UA71JVVVNDVHE6P8O6M4LQEI7JB,"The Taliban claimed responsibility for the attack, saying it was a warning to U.S. President Obama, who had cleared Afghan airspace less than two hours before the incident, The New York Times reported.",12,19,claimed,2,1,3
3G9UA71JVVVNDVHE6P8O6M4LQEI7JB,"The Taliban claimed responsibility for the attack, saying it was a warning to U.S. President Obama, who had cleared Afghan airspace less than two hours before the incident, The New York Times reported.",12,34,claimed responsibility,1,3,4
3G9UA71JVVVNDVHE6P8O6M4LQEI7JB,"The Taliban claimed responsibility for the attack, saying it was a warning to U.S. President Obama, who had cleared Afghan airspace less than two hours before the incident, The New York Times reported.",20,34,responsibility,2,0,2
3G9UA71JVVVNDVHE6P8O6M4LQEI7JB,"The Taliban claimed responsibility for the attack, saying it was a warning to U.S. President Obama, who had cleared Afghan airspace less than two hours before the incident, The New York Times reported.",108,115,cleared,2,0,2
3G9UA71JVVVNDVHE6P8O6M4LQEI7JB,"The Taliban claimed responsibility for the attack, saying it was a warning to U.S. President Obama, who had cleared Afghan airspace less than two hours before the incident, The New York Times reported.",116,131,Afghan airspace,3,0,3
3G9UA71JVVVNDVHE6P8O6M4LQEI7JB,"The Taliban claimed responsibility for the attack, saying it was a warning to U.S. President Obama, who had cleared Afghan airspace less than two hours before the incident, The New York Times reported.",123,131,airspace,5,4,9
3G9UA71JVVVNDVHE6P8O6M4LQEI7JB,"The Taliban claimed responsibility for the attack, saying it was a warning to U.S. President Obama, who had cleared Afghan airspace less than two hours before the incident, The New York Times reported.",163,171,incident,5,2,7
3G9UA71JVVVNDVHE6P8O6M4LQEI7JB,"At least one Taliban fighter died in the ensuing fighting with Afghan special police and Norwegian military officers, The Wall Street Journal reported.",13,20,Taliban,1,0,1
3G9UA71JVVVNDVHE6P8O6M4LQEI7JB,"At least one Taliban fighter died in the ensuing fighting with Afghan special police and Norwegian military officers, The Wall Street Journal reported.",41,48,ensuing,9,10,19
3G9UA71JVVVNDVHE6P8O6M4LQEI7JB,"At least one Taliban fighter died in the ensuing fighting with Afghan special police and Norwegian military officers, The Wall Street Journal reported.",41,57,ensuing fighting,1,1,2
3G9UA71JVVVNDVHE6P8O6M4LQEI7JB,"At least one Taliban fighter died in the ensuing fighting with Afghan special police and Norwegian military officers, The Wall Street Journal reported.",70,77,special,1,0,1
3G9UA71JVVVNDVHE6P8O6M4LQEI7JB,"At least one Taliban fighter died in the ensuing fighting with Afghan special police and Norwegian military officers, The Wall Street Journal reported.",70,84,special police,1,0,1
3G9UA71JVVVNDVHE6P8O6M4LQEI7JB,"At least one Taliban fighter died in the ensuing fighting with Afghan special police and Norwegian military officers, The Wall Street Journal reported.",122,141,Wall Street Journal,0,1,1
3G9UA71JVVVNDVHE6P8O6M4LQEI7JB,"At least one Taliban fighter died in the ensuing fighting with Afghan special police and Norwegian military officers, The Wall Street Journal reported.",134,141,Journal,1,0,1
3G9UA71JVVVNDVHE6P8O6M4LQEI7JB,"Hospital officials said 18 other people were hospitalized, including seven schoolchildren at a nearby school, and one person was in a critical condition.",45,57,hospitalized,0,2,2
3G9UA71JVVVNDVHE6P8O6M4LQEI7JB,"Hospital officials said 18 other people were hospitalized, including seven schoolchildren at a nearby school, and one person was in a critical condition.",95,101,nearby,0,1,1
3G9UA71JVVVNDVHE6P8O6M4LQEI7JB,"Hospital officials said 18 other people were hospitalized, including seven schoolchildren at a nearby school, and one person was in a critical condition.",134,142,critical,3,3,6
3G9UA71JVVVNDVHE6P8O6M4LQEI7JB,"Hospital officials said 18 other people were hospitalized, including seven schoolchildren at a nearby school, and one person was in a critical condition.",134,152,critical condition,5,3,8
3G9UA71JVVVNDVHE6P8O6M4LQEI7JB,Obama made an unannounced visit to Afghanistan Tuesday and met with Afghan President Hamid Karzai to sign a strategic partnership agreement.,14,25,unannounced,7,5,12
3G9UA71JVVVNDVHE6P8O6M4LQEI7JB,Obama made an unannounced visit to Afghanistan Tuesday and met with Afghan President Hamid Karzai to sign a strategic partnership agreement.,108,117,strategic,2,4,6
3G9UA71JVVVNDVHE6P8O6M4LQEI7JB,Obama made an unannounced visit to Afghanistan Tuesday and met with Afghan President Hamid Karzai to sign a strategic partnership agreement.,108,129,strategic partnership,2,1,3
3G9UA71JVVVNDVHE6P8O6M4LQEI7JB,Obama made an unannounced visit to Afghanistan Tuesday and met with Afghan President Hamid Karzai to sign a strategic partnership agreement.,108,139,strategic partnership agreement,6,2,8
3G9UA71JVVVNDVHE6P8O6M4LQEI7JB,Obama made an unannounced visit to Afghanistan Tuesday and met with Afghan President Hamid Karzai to sign a strategic partnership agreement.,118,129,partnership,1,1,2
30UZJB2POHDX5D16FB14SV903B153I,The Taliban claimed responsibility for attacks that rocked Kabul a few hours later.,12,34,claimed responsibility,1,0,1
30UZJB2POHDX5D16FB14SV903B153I,The Taliban claimed responsibility for attacks that rocked Kabul a few hours later.,20,34,responsibility,2,6,8
30UZJB2POHDX5D16FB14SV903B153I,The Taliban claimed responsibility for attacks that rocked Kabul a few hours later.,52,58,rocked,0,5,5
30UZJB2POHDX5D16FB14SV903B153I,"Officials and witnesses said a suicide car bomber and Taliban militants disguised in burqas attacked a compound housing hundreds of foreigners in the Afghan capital, killing seven.",14,23,witnesses,1,3,4
30UZJB2POHDX5D16FB14SV903B153I,"Officials and witnesses said a suicide car bomber and Taliban militants disguised in burqas attacked a compound housing hundreds of foreigners in the Afghan capital, killing seven.",31,38,suicide,2,0,2
30UZJB2POHDX5D16FB14SV903B153I,"Officials and witnesses said a suicide car bomber and Taliban militants disguised in burqas attacked a compound housing hundreds of foreigners in the Afghan capital, killing seven.",31,49,suicide car bomber,1,0,1
30UZJB2POHDX5D16FB14SV903B153I,"Officials and witnesses said a suicide car bomber and Taliban militants disguised in burqas attacked a compound housing hundreds of foreigners in the Afghan capital, killing seven.",62,71,militants,5,3,8
30UZJB2POHDX5D16FB14SV903B153I,"Officials and witnesses said a suicide car bomber and Taliban militants disguised in burqas attacked a compound housing hundreds of foreigners in the Afghan capital, killing seven.",72,81,disguised,6,10,16
30UZJB2POHDX5D16FB14SV903B153I,"Officials and witnesses said a suicide car bomber and Taliban militants disguised in burqas attacked a compound housing hundreds of foreigners in the Afghan capital, killing seven.",85,91,burqas,7,4,11
30UZJB2POHDX5D16FB14SV903B153I,"Officials and witnesses said a suicide car bomber and Taliban militants disguised in burqas attacked a compound housing hundreds of foreigners in the Afghan capital, killing seven.",101,111,a compound,1,0,1
30UZJB2POHDX5D16FB14SV903B153I,"Officials and witnesses said a suicide car bomber and Taliban militants disguised in burqas attacked a compound housing hundreds of foreigners in the Afghan capital, killing seven.",103,111,compound,2,2,4
30UZJB2POHDX5D16FB14SV903B153I,"Officials and witnesses said a suicide car bomber and Taliban militants disguised in burqas attacked a compound housing hundreds of foreigners in the Afghan capital, killing seven.",103,119,compound housing,0,1,1
30UZJB2POHDX5D16FB14SV903B153I,"Officials and witnesses said a suicide car bomber and Taliban militants disguised in burqas attacked a compound housing hundreds of foreigners in the Afghan capital, killing seven.",112,119,housing,0,1,1
30UZJB2POHDX5D16FB14SV903B153I,"Officials and witnesses said a suicide car bomber and Taliban militants disguised in burqas attacked a compound housing hundreds of foreigners in the Afghan capital, killing seven.",132,142,foreigners,1,0,1
30UZJB2POHDX5D16FB14SV903B153I,"With the agreement signed Wednesday in Afghanistan, the U.S. also has in mind the strategic significance of preserving a military partnership on Iran's eastern frontier, even if it does not include permanent U.S. bases.",9,18,agreement,0,1,1
30UZJB2POHDX5D16FB14SV903B153I,"With the agreement signed Wednesday in Afghanistan, the U.S. also has in mind the strategic significance of preserving a military partnership on Iran's eastern frontier, even if it does not include permanent U.S. bases.",82,91,strategic,3,4,7
30UZJB2POHDX5D16FB14SV903B153I,"With the agreement signed Wednesday in Afghanistan, the U.S. also has in mind the strategic significance of preserving a military partnership on Iran's eastern frontier, even if it does not include permanent U.S. bases.",82,104,strategic significance,4,5,9
30UZJB2POHDX5D16FB14SV903B153I,"With the agreement signed Wednesday in Afghanistan, the U.S. also has in mind the strategic significance of preserving a military partnership on Iran's eastern frontier, even if it does not include permanent U.S. bases.",92,104,significance,4,3,7
30UZJB2POHDX5D16FB14SV903B153I,"With the agreement signed Wednesday in Afghanistan, the U.S. also has in mind the strategic significance of preserving a military partnership on Iran's eastern frontier, even if it does not include permanent U.S. bases.",108,118,preserving,3,6,9
30UZJB2POHDX5D16FB14SV903B153I,"With the agreement signed Wednesday in Afghanistan, the U.S. also has in mind the strategic significance of preserving a military partnership on Iran's eastern frontier, even if it does not include permanent U.S. bases.",121,141,military partnership,2,0,2
30UZJB2POHDX5D16FB14SV903B153I,"With the agreement signed Wednesday in Afghanistan, the U.S. also has in mind the strategic significance of preserving a military partnership on Iran's eastern frontier, even if it does not include permanent U.S. bases.",152,168,eastern frontier,2,0,2
30UZJB2POHDX5D16FB14SV903B153I,"With the agreement signed Wednesday in Afghanistan, the U.S. also has in mind the strategic significance of preserving a military partnership on Iran's eastern frontier, even if it does not include permanent U.S. bases.",160,168,frontier,2,5,7
30UZJB2POHDX5D16FB14SV903B153I,"With the agreement signed Wednesday in Afghanistan, the U.S. also has in mind the strategic significance of preserving a military partnership on Iran's eastern frontier, even if it does not include permanent U.S. bases.",198,207,permanent,4,0,4
30UZJB2POHDX5D16FB14SV903B153I,"With the agreement signed Wednesday in Afghanistan, the U.S. also has in mind the strategic significance of preserving a military partnership on Iran's eastern frontier, even if it does not include permanent U.S. bases.",208,218,U.S. bases,1,0,1
30UZJB2POHDX5D16FB14SV903B153I,"Even after the U.S. combat mission is concluded in 2014, it is likely that thousands of U.S. troops will remain for some years to conduct counterterrorism strikes and otherwise train and advise Afghan forces, and help the Afghans collect and exploit intelligence on insurgents and other military targets.",15,34,U.S. combat mission,0,1,1
30UZJB2POHDX5D16FB14SV903B153I,"Even after the U.S. combat mission is concluded in 2014, it is likely that thousands of U.S. troops will remain for some years to conduct counterterrorism strikes and otherwise train and advise Afghan forces, and help the Afghans collect and exploit intelligence on insurgents and other military targets.",20,26,combat,0,2,2
30UZJB2POHDX5D16FB14SV903B153I,"Even after the U.S. combat mission is concluded in 2014, it is likely that thousands of U.S. troops will remain for some years to conduct counterterrorism strikes and otherwise train and advise Afghan forces, and help the Afghans collect and exploit intelligence on insurgents and other military targets.",20,34,combat mission,1,0,1
30UZJB2POHDX5D16FB14SV903B153I,"Even after the U.S. combat mission is concluded in 2014, it is likely that thousands of U.S. troops will remain for some years to conduct counterterrorism strikes and otherwise train and advise Afghan forces, and help the Afghans collect and exploit intelligence on insurgents and other military targets.",38,47,concluded,1,2,3
30UZJB2POHDX5D16FB14SV903B153I,"Even after the U.S. combat mission is concluded in 2014, it is likely that thousands of U.S. troops will remain for some years to conduct counterterrorism strikes and otherwise train and advise Afghan forces, and help the Afghans collect and exploit intelligence on insurgents and other military targets.",130,137,conduct,2,1,3
30UZJB2POHDX5D16FB14SV903B153I,"Even after the U.S. combat mission is concluded in 2014, it is likely that thousands of U.S. troops will remain for some years to conduct counterterrorism strikes and otherwise train and advise Afghan forces, and help the Afghans collect and exploit intelligence on insurgents and other military targets.",130,154,conduct counterterrorism,1,1,2
30UZJB2POHDX5D16FB14SV903B153I,"Even after the U.S. combat mission is concluded in 2014, it is likely that thousands of U.S. troops will remain for some years to conduct counterterrorism strikes and otherwise train and advise Afghan forces, and help the Afghans collect and exploit intelligence on insurgents and other military targets.",138,154,counterterrorism,10,9,19
30UZJB2POHDX5D16FB14SV903B153I,"Even after the U.S. combat mission is concluded in 2014, it is likely that thousands of U.S. troops will remain for some years to conduct counterterrorism strikes and otherwise train and advise Afghan forces, and help the Afghans collect and exploit intelligence on insurgents and other military targets.",138,162,counterterrorism strikes,2,0,2
30UZJB2POHDX5D16FB14SV903B153I,"Even after the U.S. combat mission is concluded in 2014, it is likely that thousands of U.S. troops will remain for some years to conduct counterterrorism strikes and otherwise train and advise Afghan forces, and help the Afghans collect and exploit intelligence on insurgents and other military targets.",155,162,strikes,0,1,1
30UZJB2POHDX5D16FB14SV903B153I,"Even after the U.S. combat mission is concluded in 2014, it is likely that thousands of U.S. troops will remain for some years to conduct counterterrorism strikes and otherwise train and advise Afghan forces, and help the Afghans collect and exploit intelligence on insurgents and other military targets.",167,176,otherwise,0,2,2
30UZJB2POHDX5D16FB14SV903B153I,"Even after the U.S. combat mission is concluded in 2014, it is likely that thousands of U.S. troops will remain for some years to conduct counterterrorism strikes and otherwise train and advise Afghan forces, and help the Afghans collect and exploit intelligence on insurgents and other military targets.",187,193,advise,1,0,1
30UZJB2POHDX5D16FB14SV903B153I,"Even after the U.S. combat mission is concluded in 2014, it is likely that thousands of U.S. troops will remain for some years to conduct counterterrorism strikes and otherwise train and advise Afghan forces, and help the Afghans collect and exploit intelligence on insurgents and other military targets.",242,249,exploit,7,9,16
30UZJB2POHDX5D16FB14SV903B153I,"Even after the U.S. combat mission is concluded in 2014, it is likely that thousands of U.S. troops will remain for some years to conduct counterterrorism strikes and otherwise train and advise Afghan forces, and help the Afghans collect and exploit intelligence on insurgents and other military targets.",242,262,exploit intelligence,3,1,4
30UZJB2POHDX5D16FB14SV903B153I,"Even after the U.S. combat mission is concluded in 2014, it is likely that thousands of U.S. troops will remain for some years to conduct counterterrorism strikes and otherwise train and advise Afghan forces, and help the Afghans collect and exploit intelligence on insurgents and other military targets.",250,262,intelligence,2,1,3
30UZJB2POHDX5D16FB14SV903B153I,"Even after the U.S. combat mission is concluded in 2014, it is likely that thousands of U.S. troops will remain for some years to conduct counterterrorism strikes and otherwise train and advise Afghan forces, and help the Afghans collect and exploit intelligence on insurgents and other military targets.",266,276,insurgents,10,10,20
30UZJB2POHDX5D16FB14SV903B153I,"Even after the U.S. combat mission is concluded in 2014, it is likely that thousands of U.S. troops will remain for some years to conduct counterterrorism strikes and otherwise train and advise Afghan forces, and help the Afghans collect and exploit intelligence on insurgents and other military targets.",287,303,military targets,2,0,2
30UZJB2POHDX5D16FB14SV903B153I,"Even after the U.S. combat mission is concluded in 2014, it is likely that thousands of U.S. troops will remain for some years to conduct counterterrorism strikes and otherwise train and advise Afghan forces, and help the Afghans collect and exploit intelligence on insurgents and other military targets.",296,303,targets,0,1,1
3YO4AH2FPDLQH7L7GG7OO86KWJPQ0I,Part of the plan includes the deployment in flashpoint areas of around 300 UN military observers.,30,40,deployment,10,9,19
3YO4AH2FPDLQH7L7GG7OO86KWJPQ0I,Part of the plan includes the deployment in flashpoint areas of around 300 UN military observers.,30,60,deployment in flashpoint areas,1,0,1
3YO4AH2FPDLQH7L7GG7OO86KWJPQ0I,Part of the plan includes the deployment in flashpoint areas of around 300 UN military observers.,44,54,flashpoint,10,8,18
3YO4AH2FPDLQH7L7GG7OO86KWJPQ0I,Part of the plan includes the deployment in flashpoint areas of around 300 UN military observers.,44,60,flashpoint areas,3,2,5
3YO4AH2FPDLQH7L7GG7OO86KWJPQ0I,Part of the plan includes the deployment in flashpoint areas of around 300 UN military observers.,75,86,UN military,1,0,1
3YO4AH2FPDLQH7L7GG7OO86KWJPQ0I,Part of the plan includes the deployment in flashpoint areas of around 300 UN military observers.,78,96,military observers,0,1,1
3YO4AH2FPDLQH7L7GG7OO86KWJPQ0I,Part of the plan includes the deployment in flashpoint areas of around 300 UN military observers.,87,96,observers,1,2,3
3YO4AH2FPDLQH7L7GG7OO86KWJPQ0I,"By Sunday, 189 observers were on the ground, the UN mission in Syria said.",15,24,observers,1,1,2
3YO4AH2FPDLQH7L7GG7OO86KWJPQ0I,"By Sunday, 189 observers were on the ground, the UN mission in Syria said.",15,43,observers were on the ground,1,0,1
3YO4AH2FPDLQH7L7GG7OO86KWJPQ0I,"By Sunday, 189 observers were on the ground, the UN mission in Syria said.",49,59,UN mission,1,0,1
3YO4AH2FPDLQH7L7GG7OO86KWJPQ0I,"By Sunday, 189 observers were on the ground, the UN mission in Syria said.",63,68,Syria,1,0,1
3YO4AH2FPDLQH7L7GG7OO86KWJPQ0I,"Despite the presence of the observers, more than 50 people were killed across Syria at the weekend in raids and shelling attacks by regime forces on rebel strongholds, and in clashes between soldiers and armed rebels, the Observatory said.",0,7,Despite,1,5,6
3YO4AH2FPDLQH7L7GG7OO86KWJPQ0I,"Despite the presence of the observers, more than 50 people were killed across Syria at the weekend in raids and shelling attacks by regime forces on rebel strongholds, and in clashes between soldiers and armed rebels, the Observatory said.",12,20,presence,0,1,1
3YO4AH2FPDLQH7L7GG7OO86KWJPQ0I,"Despite the presence of the observers, more than 50 people were killed across Syria at the weekend in raids and shelling attacks by regime forces on rebel strongholds, and in clashes between soldiers and armed rebels, the Observatory said.",102,107,raids,1,2,3
3YO4AH2FPDLQH7L7GG7OO86KWJPQ0I,"Despite the presence of the observers, more than 50 people were killed across Syria at the weekend in raids and shelling attacks by regime forces on rebel strongholds, and in clashes between soldiers and armed rebels, the Observatory said.",112,120,shelling,3,5,8
3YO4AH2FPDLQH7L7GG7OO86KWJPQ0I,"Despite the presence of the observers, more than 50 people were killed across Syria at the weekend in raids and shelling attacks by regime forces on rebel strongholds, and in clashes between soldiers and armed rebels, the Observatory said.",112,128,shelling attacks,5,2,7
3YO4AH2FPDLQH7L7GG7OO86KWJPQ0I,"Despite the presence of the observers, more than 50 people were killed across Syria at the weekend in raids and shelling attacks by regime forces on rebel strongholds, and in clashes between soldiers and armed rebels, the Observatory said.",132,138,regime,7,1,8
3YO4AH2FPDLQH7L7GG7OO86KWJPQ0I,"Despite the presence of the observers, more than 50 people were killed across Syria at the weekend in raids and shelling attacks by regime forces on rebel strongholds, and in clashes between soldiers and armed rebels, the Observatory said.",132,145,regime forces,3,2,5
3YO4AH2FPDLQH7L7GG7OO86KWJPQ0I,"Despite the presence of the observers, more than 50 people were killed across Syria at the weekend in raids and shelling attacks by regime forces on rebel strongholds, and in clashes between soldiers and armed rebels, the Observatory said.",149,154,rebel,1,1,2
3YO4AH2FPDLQH7L7GG7OO86KWJPQ0I,"Despite the presence of the observers, more than 50 people were killed across Syria at the weekend in raids and shelling attacks by regime forces on rebel strongholds, and in clashes between soldiers and armed rebels, the Observatory said.",149,166,rebel strongholds,5,0,5
3YO4AH2FPDLQH7L7GG7OO86KWJPQ0I,"Despite the presence of the observers, more than 50 people were killed across Syria at the weekend in raids and shelling attacks by regime forces on rebel strongholds, and in clashes between soldiers and armed rebels, the Observatory said.",155,166,strongholds,4,10,14
3YO4AH2FPDLQH7L7GG7OO86KWJPQ0I,"Despite the presence of the observers, more than 50 people were killed across Syria at the weekend in raids and shelling attacks by regime forces on rebel strongholds, and in clashes between soldiers and armed rebels, the Observatory said.",175,182,clashes,1,2,3
3YO4AH2FPDLQH7L7GG7OO86KWJPQ0I,"Despite the presence of the observers, more than 50 people were killed across Syria at the weekend in raids and shelling attacks by regime forces on rebel strongholds, and in clashes between soldiers and armed rebels, the Observatory said.",204,216,armed rebels,0,1,1
3YO4AH2FPDLQH7L7GG7OO86KWJPQ0I,"Despite the presence of the observers, more than 50 people were killed across Syria at the weekend in raids and shelling attacks by regime forces on rebel strongholds, and in clashes between soldiers and armed rebels, the Observatory said.",210,216,rebels,0,3,3
3YO4AH2FPDLQH7L7GG7OO86KWJPQ0I,"Despite the presence of the observers, more than 50 people were killed across Syria at the weekend in raids and shelling attacks by regime forces on rebel strongholds, and in clashes between soldiers and armed rebels, the Observatory said.",222,233,Observatory,3,0,3
3YO4AH2FPDLQH7L7GG7OO86KWJPQ0I,"More than 12,000 people, the majority of them civilians, have died since the Syrian uprising began in March 2011, according to the watchdog, including more than 900 killed since the April 12 truce.",46,55,civilians,2,2,4
3YO4AH2FPDLQH7L7GG7OO86KWJPQ0I,"More than 12,000 people, the majority of them civilians, have died since the Syrian uprising began in March 2011, according to the watchdog, including more than 900 killed since the April 12 truce.",84,92,uprising,3,9,12
3YO4AH2FPDLQH7L7GG7OO86KWJPQ0I,"More than 12,000 people, the majority of them civilians, have died since the Syrian uprising began in March 2011, according to the watchdog, including more than 900 killed since the April 12 truce.",131,139,watchdog,6,7,13
3YO4AH2FPDLQH7L7GG7OO86KWJPQ0I,"More than 12,000 people, the majority of them civilians, have died since the Syrian uprising began in March 2011, according to the watchdog, including more than 900 killed since the April 12 truce.",191,196,truce,2,3,5
3YO4AH2FPDLQH7L7GG7OO86KWJPQ0I,"Syria-linked violence has also spilled across the border into Lebanon, with four people killed since Saturday during sectarian clashes in the northern port city of Tripoli, according to officials.",0,12,Syria-linked,1,0,1
3YO4AH2FPDLQH7L7GG7OO86KWJPQ0I,"Syria-linked violence has also spilled across the border into Lebanon, with four people killed since Saturday during sectarian clashes in the northern port city of Tripoli, according to officials.",0,21,Syria-linked violence,1,1,2
3YO4AH2FPDLQH7L7GG7OO86KWJPQ0I,"Syria-linked violence has also spilled across the border into Lebanon, with four people killed since Saturday during sectarian clashes in the northern port city of Tripoli, according to officials.",13,21,violence,0,2,2
3YO4AH2FPDLQH7L7GG7OO86KWJPQ0I,"Syria-linked violence has also spilled across the border into Lebanon, with four people killed since Saturday during sectarian clashes in the northern port city of Tripoli, according to officials.",31,38,spilled,3,6,9
3YO4AH2FPDLQH7L7GG7OO86KWJPQ0I,"Syria-linked violence has also spilled across the border into Lebanon, with four people killed since Saturday during sectarian clashes in the northern port city of Tripoli, according to officials.",31,45,spilled across,0,1,1
3YO4AH2FPDLQH7L7GG7OO86KWJPQ0I,"Syria-linked violence has also spilled across the border into Lebanon, with four people killed since Saturday during sectarian clashes in the northern port city of Tripoli, according to officials.",62,69,Lebanon,1,0,1
3YO4AH2FPDLQH7L7GG7OO86KWJPQ0I,"Syria-linked violence has also spilled across the border into Lebanon, with four people killed since Saturday during sectarian clashes in the northern port city of Tripoli, according to officials.",117,126,sectarian,7,1,8
3YO4AH2FPDLQH7L7GG7OO86KWJPQ0I,"Syria-linked violence has also spilled across the border into Lebanon, with four people killed since Saturday during sectarian clashes in the northern port city of Tripoli, according to officials.",117,134,sectarian clashes,8,6,14
3YO4AH2FPDLQH7L7GG7OO86KWJPQ0I,"Syria-linked violence has also spilled across the border into Lebanon, with four people killed since Saturday during sectarian clashes in the northern port city of Tripoli, according to officials.",127,134,clashes,0,1,1
3NSCTNUR2ZOXPY0ROQGEF3N6AMHA5A,"He added: At around 11.10am, a 26-year-old man was arrested on suspicion of murder and a 28-year-old male and 28-year-old female were arrested on suspicion of assisting an offender.",63,72,suspicion,10,10,20
3NSCTNUR2ZOXPY0ROQGEF3N6AMHA5A,"He added: At around 11.10am, a 26-year-old man was arrested on suspicion of murder and a 28-year-old male and 28-year-old female were arrested on suspicion of assisting an offender.",63,82,suspicion of murder,2,2,4
3NSCTNUR2ZOXPY0ROQGEF3N6AMHA5A,"He added: At around 11.10am, a 26-year-old man was arrested on suspicion of murder and a 28-year-old male and 28-year-old female were arrested on suspicion of assisting an offender.",76,82,murder,0,1,1
3NSCTNUR2ZOXPY0ROQGEF3N6AMHA5A,"He added: At around 11.10am, a 26-year-old man was arrested on suspicion of murder and a 28-year-old male and 28-year-old female were arrested on suspicion of assisting an offender.",134,142,arrested,1,1,2
3NSCTNUR2ZOXPY0ROQGEF3N6AMHA5A,"He added: At around 11.10am, a 26-year-old man was arrested on suspicion of murder and a 28-year-old male and 28-year-old female were arrested on suspicion of assisting an offender.",134,155,arrested on suspicion,1,0,1
3NSCTNUR2ZOXPY0ROQGEF3N6AMHA5A,"He added: At around 11.10am, a 26-year-old man was arrested on suspicion of murder and a 28-year-old male and 28-year-old female were arrested on suspicion of assisting an offender.",146,155,suspicion,6,2,8
3NSCTNUR2ZOXPY0ROQGEF3N6AMHA5A,"He added: At around 11.10am, a 26-year-old man was arrested on suspicion of murder and a 28-year-old male and 28-year-old female were arrested on suspicion of assisting an offender.",146,180,suspicion of assisting an offender,3,0,3
3NSCTNUR2ZOXPY0ROQGEF3N6AMHA5A,"He added: At around 11.10am, a 26-year-old man was arrested on suspicion of murder and a 28-year-old male and 28-year-old female were arrested on suspicion of assisting an offender.",159,168,assisting,2,2,4
3NSCTNUR2ZOXPY0ROQGEF3N6AMHA5A,"He added: At around 11.10am, a 26-year-old man was arrested on suspicion of murder and a 28-year-old male and 28-year-old female were arrested on suspicion of assisting an offender.",159,180,assisting an offender,2,1,3
3NSCTNUR2ZOXPY0ROQGEF3N6AMHA5A,"He added: At around 11.10am, a 26-year-old man was arrested on suspicion of murder and a 28-year-old male and 28-year-old female were arrested on suspicion of assisting an offender.",172,180,offender,2,9,11
3NSCTNUR2ZOXPY0ROQGEF3N6AMHA5A,All three were arrested in the Toome area and have been taken to the Serious Crime Suite at Antrim police station.,31,36,Toome,0,1,1
3NSCTNUR2ZOXPY0ROQGEF3N6AMHA5A,All three were arrested in the Toome area and have been taken to the Serious Crime Suite at Antrim police station.,69,82,Serious Crime,1,1,2
3NSCTNUR2ZOXPY0ROQGEF3N6AMHA5A,All three were arrested in the Toome area and have been taken to the Serious Crime Suite at Antrim police station.,69,88,Serious Crime Suite,1,0,1
3NSCTNUR2ZOXPY0ROQGEF3N6AMHA5A,All three were arrested in the Toome area and have been taken to the Serious Crime Suite at Antrim police station.,92,98,Antrim,0,1,1
3NSCTNUR2ZOXPY0ROQGEF3N6AMHA5A,Investigating officers have appealed for anyone with information about the incident to contact them.,0,13,Investigating,5,3,8
3NSCTNUR2ZOXPY0ROQGEF3N6AMHA5A,Investigating officers have appealed for anyone with information about the incident to contact them.,0,22,Investigating officers,2,0,2
3NSCTNUR2ZOXPY0ROQGEF3N6AMHA5A,Investigating officers have appealed for anyone with information about the incident to contact them.,28,36,appealed,6,7,13
3NSCTNUR2ZOXPY0ROQGEF3N6AMHA5A,Investigating officers have appealed for anyone with information about the incident to contact them.,53,64,information,2,1,3
3NSCTNUR2ZOXPY0ROQGEF3N6AMHA5A,Investigating officers have appealed for anyone with information about the incident to contact them.,75,83,incident,7,5,12
3NSCTNUR2ZOXPY0ROQGEF3N6AMHA5A,"The Embassy is still engaged in discussions with the Philippine DFA to seek a solution of this issue, so that China-Philippine friendly relations and peace, stability in South China Sea are well preserved in the best interest of the two countries.",4,11,Embassy,3,2,5
3NSCTNUR2ZOXPY0ROQGEF3N6AMHA5A,"The Embassy is still engaged in discussions with the Philippine DFA to seek a solution of this issue, so that China-Philippine friendly relations and peace, stability in South China Sea are well preserved in the best interest of the two countries.",21,28,engaged,6,7,13
3NSCTNUR2ZOXPY0ROQGEF3N6AMHA5A,"The Embassy is still engaged in discussions with the Philippine DFA to seek a solution of this issue, so that China-Philippine friendly relations and peace, stability in South China Sea are well preserved in the best interest of the two countries.",32,43,discussions,3,2,5
3NSCTNUR2ZOXPY0ROQGEF3N6AMHA5A,"The Embassy is still engaged in discussions with the Philippine DFA to seek a solution of this issue, so that China-Philippine friendly relations and peace, stability in South China Sea are well preserved in the best interest of the two countries.",53,67,Philippine DFA,1,0,1
3NSCTNUR2ZOXPY0ROQGEF3N6AMHA5A,"The Embassy is still engaged in discussions with the Philippine DFA to seek a solution of this issue, so that China-Philippine friendly relations and peace, stability in South China Sea are well preserved in the best interest of the two countries.",64,67,DFA,0,1,1
3NSCTNUR2ZOXPY0ROQGEF3N6AMHA5A,"The Embassy is still engaged in discussions with the Philippine DFA to seek a solution of this issue, so that China-Philippine friendly relations and peace, stability in South China Sea are well preserved in the best interest of the two countries.",71,75,seek,0,1,1
3NSCTNUR2ZOXPY0ROQGEF3N6AMHA5A,"The Embassy is still engaged in discussions with the Philippine DFA to seek a solution of this issue, so that China-Philippine friendly relations and peace, stability in South China Sea are well preserved in the best interest of the two countries.",78,86,solution,1,1,2
3NSCTNUR2ZOXPY0ROQGEF3N6AMHA5A,"The Embassy is still engaged in discussions with the Philippine DFA to seek a solution of this issue, so that China-Philippine friendly relations and peace, stability in South China Sea are well preserved in the best interest of the two countries.",95,100,issue,0,1,1
3NSCTNUR2ZOXPY0ROQGEF3N6AMHA5A,"The Embassy is still engaged in discussions with the Philippine DFA to seek a solution of this issue, so that China-Philippine friendly relations and peace, stability in South China Sea are well preserved in the best interest of the two countries.",127,145,friendly relations,1,0,1
3NSCTNUR2ZOXPY0ROQGEF3N6AMHA5A,"The Embassy is still engaged in discussions with the Philippine DFA to seek a solution of this issue, so that China-Philippine friendly relations and peace, stability in South China Sea are well preserved in the best interest of the two countries.",136,145,relations,3,0,3
3NSCTNUR2ZOXPY0ROQGEF3N6AMHA5A,"The Embassy is still engaged in discussions with the Philippine DFA to seek a solution of this issue, so that China-Philippine friendly relations and peace, stability in South China Sea are well preserved in the best interest of the two countries.",157,166,stability,6,5,11
3NSCTNUR2ZOXPY0ROQGEF3N6AMHA5A,"The Embassy is still engaged in discussions with the Philippine DFA to seek a solution of this issue, so that China-Philippine friendly relations and peace, stability in South China Sea are well preserved in the best interest of the two countries.",190,204,well preserved,1,1,2
3NSCTNUR2ZOXPY0ROQGEF3N6AMHA5A,"The Embassy is still engaged in discussions with the Philippine DFA to seek a solution of this issue, so that China-Philippine friendly relations and peace, stability in South China Sea are well preserved in the best interest of the two countries.",195,204,preserved,3,4,7
3NSCTNUR2ZOXPY0ROQGEF3N6AMHA5A,"Del Rosario invited Ma to the DFA Wednesday morning for further discussion of the issue, the DFA added.",12,19,invited,0,1,1
3NSCTNUR2ZOXPY0ROQGEF3N6AMHA5A,"Del Rosario invited Ma to the DFA Wednesday morning for further discussion of the issue, the DFA added.",30,33,DFA,0,1,1
3NSCTNUR2ZOXPY0ROQGEF3N6AMHA5A,"Del Rosario invited Ma to the DFA Wednesday morning for further discussion of the issue, the DFA added.",64,74,discussion,2,0,2
3NSCTNUR2ZOXPY0ROQGEF3N6AMHA5A,"Del Rosario invited Ma to the DFA Wednesday morning for further discussion of the issue, the DFA added.",82,87,issue,0,1,1
3NSCTNUR2ZOXPY0ROQGEF3N6AMHA5A,"Del Rosario invited Ma to the DFA Wednesday morning for further discussion of the issue, the DFA added.",93,96,DFA,1,1,2
3GKAWYFRAPUZGFLMSFGU3A0TLCCDP7,The announcement came as Spanish bank stocks tumbled Friday.,4,16,announcement,3,1,4
3GKAWYFRAPUZGFLMSFGU3A0TLCCDP7,The announcement came as Spanish bank stocks tumbled Friday.,33,44,bank stocks,1,0,1
3GKAWYFRAPUZGFLMSFGU3A0TLCCDP7,The announcement came as Spanish bank stocks tumbled Friday.,38,44,stocks,1,1,2
3GKAWYFRAPUZGFLMSFGU3A0TLCCDP7,The announcement came as Spanish bank stocks tumbled Friday.,45,52,tumbled,9,10,19
3GKAWYFRAPUZGFLMSFGU3A0TLCCDP7,"Spain is expected to present new reforms to complete the clean-up of its banks on Friday, May 11, after difficult last-minute talks between the government and lenders.",9,17,expected,0,1,1
3GKAWYFRAPUZGFLMSFGU3A0TLCCDP7,"Spain is expected to present new reforms to complete the clean-up of its banks on Friday, May 11, after difficult last-minute talks between the government and lenders.",29,40,new reforms,2,0,2
3GKAWYFRAPUZGFLMSFGU3A0TLCCDP7,"Spain is expected to present new reforms to complete the clean-up of its banks on Friday, May 11, after difficult last-minute talks between the government and lenders.",33,40,reforms,4,5,9
3GKAWYFRAPUZGFLMSFGU3A0TLCCDP7,"Spain is expected to present new reforms to complete the clean-up of its banks on Friday, May 11, after difficult last-minute talks between the government and lenders.",57,65,clean-up,2,3,5
3GKAWYFRAPUZGFLMSFGU3A0TLCCDP7,"Spain is expected to present new reforms to complete the clean-up of its banks on Friday, May 11, after difficult last-minute talks between the government and lenders.",57,78,clean-up of its banks,1,1,2
3GKAWYFRAPUZGFLMSFGU3A0TLCCDP7,"Spain is expected to present new reforms to complete the clean-up of its banks on Friday, May 11, after difficult last-minute talks between the government and lenders.",114,131,last-minute talks,1,1,2
3GKAWYFRAPUZGFLMSFGU3A0TLCCDP7,"Spain is expected to present new reforms to complete the clean-up of its banks on Friday, May 11, after difficult last-minute talks between the government and lenders.",144,154,government,1,0,1
3GKAWYFRAPUZGFLMSFGU3A0TLCCDP7,"Spain is expected to present new reforms to complete the clean-up of its banks on Friday, May 11, after difficult last-minute talks between the government and lenders.",159,166,lenders,2,5,7
3GKAWYFRAPUZGFLMSFGU3A0TLCCDP7,"Reuters reported that at its weekly cabinet meeting, the government will approve a plan to force banks to park their toxic real estate assets in holding companies that would later sell them off.",0,7,Reuters,5,2,7
3GKAWYFRAPUZGFLMSFGU3A0TLCCDP7,"Reuters reported that at its weekly cabinet meeting, the government will approve a plan to force banks to park their toxic real estate assets in holding companies that would later sell them off.",36,43,cabinet,1,1,2
3GKAWYFRAPUZGFLMSFGU3A0TLCCDP7,"Reuters reported that at its weekly cabinet meeting, the government will approve a plan to force banks to park their toxic real estate assets in holding companies that would later sell them off.",57,67,government,1,0,1
3GKAWYFRAPUZGFLMSFGU3A0TLCCDP7,"Reuters reported that at its weekly cabinet meeting, the government will approve a plan to force banks to park their toxic real estate assets in holding companies that would later sell them off.",103,110,to park,1,0,1
3GKAWYFRAPUZGFLMSFGU3A0TLCCDP7,"Reuters reported that at its weekly cabinet meeting, the government will approve a plan to force banks to park their toxic real estate assets in holding companies that would later sell them off.",106,110,park,0,1,1
3GKAWYFRAPUZGFLMSFGU3A0TLCCDP7,"Reuters reported that at its weekly cabinet meeting, the government will approve a plan to force banks to park their toxic real estate assets in holding companies that would later sell them off.",117,122,toxic,3,5,8
3GKAWYFRAPUZGFLMSFGU3A0TLCCDP7,"Reuters reported that at its weekly cabinet meeting, the government will approve a plan to force banks to park their toxic real estate assets in holding companies that would later sell them off.",117,141,toxic real estate assets,6,1,7
3GKAWYFRAPUZGFLMSFGU3A0TLCCDP7,"Reuters reported that at its weekly cabinet meeting, the government will approve a plan to force banks to park their toxic real estate assets in holding companies that would later sell them off.",135,141,assets,1,0,1
3GKAWYFRAPUZGFLMSFGU3A0TLCCDP7,"Reuters reported that at its weekly cabinet meeting, the government will approve a plan to force banks to park their toxic real estate assets in holding companies that would later sell them off.",145,152,holding,0,2,2
3GKAWYFRAPUZGFLMSFGU3A0TLCCDP7,"Reuters reported that at its weekly cabinet meeting, the government will approve a plan to force banks to park their toxic real estate assets in holding companies that would later sell them off.",145,162,holding companies,4,2,6
3GKAWYFRAPUZGFLMSFGU3A0TLCCDP7,The cabinet is also expected to announce demands for the banks to set aside a further 35 billion euros ($45 billion) to cover sound loans in their real estate portfolios.,4,11,cabinet,4,0,4
3GKAWYFRAPUZGFLMSFGU3A0TLCCDP7,The cabinet is also expected to announce demands for the banks to set aside a further 35 billion euros ($45 billion) to cover sound loans in their real estate portfolios.,20,28,expected,0,1,1
3GKAWYFRAPUZGFLMSFGU3A0TLCCDP7,The cabinet is also expected to announce demands for the banks to set aside a further 35 billion euros ($45 billion) to cover sound loans in their real estate portfolios.,32,40,announce,1,1,2
3GKAWYFRAPUZGFLMSFGU3A0TLCCDP7,The cabinet is also expected to announce demands for the banks to set aside a further 35 billion euros ($45 billion) to cover sound loans in their real estate portfolios.,41,48,demands,0,2,2
3GKAWYFRAPUZGFLMSFGU3A0TLCCDP7,The cabinet is also expected to announce demands for the banks to set aside a further 35 billion euros ($45 billion) to cover sound loans in their real estate portfolios.,66,75,set aside,0,1,1
3GKAWYFRAPUZGFLMSFGU3A0TLCCDP7,The cabinet is also expected to announce demands for the banks to set aside a further 35 billion euros ($45 billion) to cover sound loans in their real estate portfolios.,70,75,aside,0,2,2
3GKAWYFRAPUZGFLMSFGU3A0TLCCDP7,The cabinet is also expected to announce demands for the banks to set aside a further 35 billion euros ($45 billion) to cover sound loans in their real estate portfolios.,120,137,cover sound loans,0,1,1
3GKAWYFRAPUZGFLMSFGU3A0TLCCDP7,The cabinet is also expected to announce demands for the banks to set aside a further 35 billion euros ($45 billion) to cover sound loans in their real estate portfolios.,126,137,sound loans,4,1,5
3GKAWYFRAPUZGFLMSFGU3A0TLCCDP7,The cabinet is also expected to announce demands for the banks to set aside a further 35 billion euros ($45 billion) to cover sound loans in their real estate portfolios.,132,137,loans,0,1,1
3GKAWYFRAPUZGFLMSFGU3A0TLCCDP7,The cabinet is also expected to announce demands for the banks to set aside a further 35 billion euros ($45 billion) to cover sound loans in their real estate portfolios.,147,169,real estate portfolios,3,1,4
3GKAWYFRAPUZGFLMSFGU3A0TLCCDP7,The cabinet is also expected to announce demands for the banks to set aside a further 35 billion euros ($45 billion) to cover sound loans in their real estate portfolios.,159,169,portfolios,9,7,16
3GKAWYFRAPUZGFLMSFGU3A0TLCCDP7,The government has already forced banks to make provisions of 54 billion euros to cover bad assets.,48,58,provisions,6,6,12
3GKAWYFRAPUZGFLMSFGU3A0TLCCDP7,The government has already forced banks to make provisions of 54 billion euros to cover bad assets.,88,98,bad assets,6,2,8
3GKAWYFRAPUZGFLMSFGU3A0TLCCDP7,The government has already forced banks to make provisions of 54 billion euros to cover bad assets.,92,98,assets,2,0,2
3GKAWYFRAPUZGFLMSFGU3A0TLCCDP7,"The text is being finalized after talks with the banks, a government source told Reuters, adding that both the new provisions and the ""bad bank"" scheme would be approved on Friday.",19,28,finalized,2,2,4
3GKAWYFRAPUZGFLMSFGU3A0TLCCDP7,"The text is being finalized after talks with the banks, a government source told Reuters, adding that both the new provisions and the ""bad bank"" scheme would be approved on Friday.",60,70,government,1,0,1
3GKAWYFRAPUZGFLMSFGU3A0TLCCDP7,"The text is being finalized after talks with the banks, a government source told Reuters, adding that both the new provisions and the ""bad bank"" scheme would be approved on Friday.",83,90,Reuters,3,0,3
3GKAWYFRAPUZGFLMSFGU3A0TLCCDP7,"The text is being finalized after talks with the banks, a government source told Reuters, adding that both the new provisions and the ""bad bank"" scheme would be approved on Friday.",113,127,new provisions,1,0,1
3GKAWYFRAPUZGFLMSFGU3A0TLCCDP7,"The text is being finalized after talks with the banks, a government source told Reuters, adding that both the new provisions and the ""bad bank"" scheme would be approved on Friday.",117,127,provisions,3,3,6
3GKAWYFRAPUZGFLMSFGU3A0TLCCDP7,"The text is being finalized after talks with the banks, a government source told Reuters, adding that both the new provisions and the ""bad bank"" scheme would be approved on Friday.",136,151,bad bank scheme,1,1,2
3GKAWYFRAPUZGFLMSFGU3A0TLCCDP7,"The text is being finalized after talks with the banks, a government source told Reuters, adding that both the new provisions and the ""bad bank"" scheme would be approved on Friday.",137,145,bad bank,1,1,2
3GKAWYFRAPUZGFLMSFGU3A0TLCCDP7,"The text is being finalized after talks with the banks, a government source told Reuters, adding that both the new provisions and the ""bad bank"" scheme would be approved on Friday.",147,153,scheme,3,0,3
3GKAWYFRAPUZGFLMSFGU3A0TLCCDP7,"The text is being finalized after talks with the banks, a government source told Reuters, adding that both the new provisions and the ""bad bank"" scheme would be approved on Friday.",163,171,approved,1,0,1
3PEG1BH7AES5QRQM1RKGC3QUPUXKB0,"Thirty-three-year-old Tonya Thomas fatally shot her four children, who ranged in age from 12 to 17, said Lt. Tod Goodyear, a spokesman for the Brevard County Sheriff's Office.",0,21,Thirty-three-year-old,1,0,1
3PEG1BH7AES5QRQM1RKGC3QUPUXKB0,"Thirty-three-year-old Tonya Thomas fatally shot her four children, who ranged in age from 12 to 17, said Lt. Tod Goodyear, a spokesman for the Brevard County Sheriff's Office.",35,42,fatally,7,8,15
3PEG1BH7AES5QRQM1RKGC3QUPUXKB0,"Thirty-three-year-old Tonya Thomas fatally shot her four children, who ranged in age from 12 to 17, said Lt. Tod Goodyear, a spokesman for the Brevard County Sheriff's Office.",35,47,fatally shot,1,1,2
3PEG1BH7AES5QRQM1RKGC3QUPUXKB0,"Thirty-three-year-old Tonya Thomas fatally shot her four children, who ranged in age from 12 to 17, said Lt. Tod Goodyear, a spokesman for the Brevard County Sheriff's Office.",43,47,shot,1,0,1
3PEG1BH7AES5QRQM1RKGC3QUPUXKB0,"Thirty-three-year-old Tonya Thomas fatally shot her four children, who ranged in age from 12 to 17, said Lt. Tod Goodyear, a spokesman for the Brevard County Sheriff's Office.",71,77,ranged,4,2,6
3PEG1BH7AES5QRQM1RKGC3QUPUXKB0,"Thirty-three-year-old Tonya Thomas fatally shot her four children, who ranged in age from 12 to 17, said Lt. Tod Goodyear, a spokesman for the Brevard County Sheriff's Office.",123,134,a spokesman,1,0,1
3PEG1BH7AES5QRQM1RKGC3QUPUXKB0,"Thirty-three-year-old Tonya Thomas fatally shot her four children, who ranged in age from 12 to 17, said Lt. Tod Goodyear, a spokesman for the Brevard County Sheriff's Office.",125,134,spokesman,3,5,8
3PEG1BH7AES5QRQM1RKGC3QUPUXKB0,"Thirty-three-year-old Tonya Thomas fatally shot her four children, who ranged in age from 12 to 17, said Lt. Tod Goodyear, a spokesman for the Brevard County Sheriff's Office.",158,165,Sheriff,1,0,1
3PEG1BH7AES5QRQM1RKGC3QUPUXKB0,"Thirty-three-year-old Tonya Thomas fatally shot her four children, who ranged in age from 12 to 17, said Lt. Tod Goodyear, a spokesman for the Brevard County Sheriff's Office.",158,166,Sheriffs,1,0,1
3PEG1BH7AES5QRQM1RKGC3QUPUXKB0,"Thirty-three-year-old Tonya Thomas fatally shot her four children, who ranged in age from 12 to 17, said Lt. Tod Goodyear, a spokesman for the Brevard County Sheriff's Office.",158,173,Sheriffs Office,1,0,1
3PEG1BH7AES5QRQM1RKGC3QUPUXKB0,Three of the children had gone to a neighbor's front door before dawn to say their mother had shot them.,36,44,neighbor,1,0,1
3PEG1BH7AES5QRQM1RKGC3QUPUXKB0,Three of the children had gone to a neighbor's front door before dawn to say their mother had shot them.,36,45,neighbors,0,3,3
3PEG1BH7AES5QRQM1RKGC3QUPUXKB0,Three of the children had gone to a neighbor's front door before dawn to say their mother had shot them.,36,56,neighbors front door,1,0,1
3PEG1BH7AES5QRQM1RKGC3QUPUXKB0,Three of the children had gone to a neighbor's front door before dawn to say their mother had shot them.,65,69,dawn,3,5,8
3PEG1BH7AES5QRQM1RKGC3QUPUXKB0,"From what the neighbors said, she was very calm.	15	24	neighbors	0	2	2
3PEG1BH7AES5QRQM1RKGC3QUPUXKB0	From what the neighbors said, she was very calm.",44,48,calm,1,2,3
3PEG1BH7AES5QRQM1RKGC3QUPUXKB0,She walked out and called them back.,4,14,walked out,1,0,1
3PEG1BH7AES5QRQM1RKGC3QUPUXKB0,"They turned around and walked back to the house,"" Goodyear said.",23,34,walked back,1,0,1
3PEG1BH7AES5QRQM1RKGC3QUPUXKB0,The neighbor then heard gunshots and called 911.,4,12,neighbor,1,1,2
3PEG1BH7AES5QRQM1RKGC3QUPUXKB0,The neighbor then heard gunshots and called 911.,24,32,gunshots,3,2,5
3PEG1BH7AES5QRQM1RKGC3QUPUXKB0,Another neighbor told deputies that Thomas sent a text message in the middle of the night saying she wanted to be cremated with her children.,8,16,neighbor,1,1,2
3PEG1BH7AES5QRQM1RKGC3QUPUXKB0,Another neighbor told deputies that Thomas sent a text message in the middle of the night saying she wanted to be cremated with her children.,22,30,deputies,7,5,12
3PEG1BH7AES5QRQM1RKGC3QUPUXKB0,Another neighbor told deputies that Thomas sent a text message in the middle of the night saying she wanted to be cremated with her children.,50,54,text,1,0,1
3PEG1BH7AES5QRQM1RKGC3QUPUXKB0,Another neighbor told deputies that Thomas sent a text message in the middle of the night saying she wanted to be cremated with her children.,50,62,text message,0,1,1
3PEG1BH7AES5QRQM1RKGC3QUPUXKB0,Another neighbor told deputies that Thomas sent a text message in the middle of the night saying she wanted to be cremated with her children.,55,62,message,0,1,1
3PEG1BH7AES5QRQM1RKGC3QUPUXKB0,Another neighbor told deputies that Thomas sent a text message in the middle of the night saying she wanted to be cremated with her children.,114,122,cremated,10,10,20
3DGDV62G7OACD5N6VQWD7R9PPYQ2PH,The demonstrations on Monday and Tuesday were an unusually sustained show of support for the Russian opposition.,4,18,demonstrations,10,7,17
3DGDV62G7OACD5N6VQWD7R9PPYQ2PH,The demonstrations on Monday and Tuesday were an unusually sustained show of support for the Russian opposition.,49,58,unusually,0,1,1
3DGDV62G7OACD5N6VQWD7R9PPYQ2PH,The demonstrations on Monday and Tuesday were an unusually sustained show of support for the Russian opposition.,49,68,unusually sustained,4,0,4
3DGDV62G7OACD5N6VQWD7R9PPYQ2PH,The demonstrations on Monday and Tuesday were an unusually sustained show of support for the Russian opposition.,49,84,unusually sustained show of support,1,0,1
3DGDV62G7OACD5N6VQWD7R9PPYQ2PH,The demonstrations on Monday and Tuesday were an unusually sustained show of support for the Russian opposition.,59,68,sustained,7,10,17
3DGDV62G7OACD5N6VQWD7R9PPYQ2PH,The demonstrations on Monday and Tuesday were an unusually sustained show of support for the Russian opposition.,101,111,opposition,4,1,5
3DGDV62G7OACD5N6VQWD7R9PPYQ2PH,"The thousands who rallied in the capital and St Petersburg clashed with police and interior ministry troops, who later detained hundreds of protesters.",18,25,rallied,3,7,10
3DGDV62G7OACD5N6VQWD7R9PPYQ2PH,"The thousands who rallied in the capital and St Petersburg clashed with police and interior ministry troops, who later detained hundreds of protesters.",59,66,clashed,1,0,1
3DGDV62G7OACD5N6VQWD7R9PPYQ2PH,"The thousands who rallied in the capital and St Petersburg clashed with police and interior ministry troops, who later detained hundreds of protesters.",83,91,interior,1,2,3
3DGDV62G7OACD5N6VQWD7R9PPYQ2PH,"The thousands who rallied in the capital and St Petersburg clashed with police and interior ministry troops, who later detained hundreds of protesters.",83,100,interior ministry,0,1,1
3DGDV62G7OACD5N6VQWD7R9PPYQ2PH,"The thousands who rallied in the capital and St Petersburg clashed with police and interior ministry troops, who later detained hundreds of protesters.",83,107,interior ministry troops,3,0,3
3DGDV62G7OACD5N6VQWD7R9PPYQ2PH,"The thousands who rallied in the capital and St Petersburg clashed with police and interior ministry troops, who later detained hundreds of protesters.",92,100,ministry,1,0,1
3DGDV62G7OACD5N6VQWD7R9PPYQ2PH,"The thousands who rallied in the capital and St Petersburg clashed with police and interior ministry troops, who later detained hundreds of protesters.",119,127,detained,6,8,14
3DGDV62G7OACD5N6VQWD7R9PPYQ2PH,"The thousands who rallied in the capital and St Petersburg clashed with police and interior ministry troops, who later detained hundreds of protesters.",140,150,protesters,1,4,5
3DGDV62G7OACD5N6VQWD7R9PPYQ2PH,"More opposition rallies were expected on Wednesday, along with pro-Putin gatherings.",5,15,opposition,3,0,3
3DGDV62G7OACD5N6VQWD7R9PPYQ2PH,"More opposition rallies were expected on Wednesday, along with pro-Putin gatherings.",5,23,opposition rallies,3,0,3
3DGDV62G7OACD5N6VQWD7R9PPYQ2PH,"More opposition rallies were expected on Wednesday, along with pro-Putin gatherings.",16,23,rallies,0,2,2
3DGDV62G7OACD5N6VQWD7R9PPYQ2PH,"More opposition rallies were expected on Wednesday, along with pro-Putin gatherings.",63,72,pro-Putin,1,0,1
3DGDV62G7OACD5N6VQWD7R9PPYQ2PH,"More opposition rallies were expected on Wednesday, along with pro-Putin gatherings.",63,83,pro-Putin gatherings,1,2,3
3DGDV62G7OACD5N6VQWD7R9PPYQ2PH,"More opposition rallies were expected on Wednesday, along with pro-Putin gatherings.",73,83,gatherings,0,6,6
3DGDV62G7OACD5N6VQWD7R9PPYQ2PH,"Putin was expected to formally register on Wednesday to run for president, a position he held from 2000-2008, a period in which he grew more authoritarian.",22,39,formally register,2,0,2
3DGDV62G7OACD5N6VQWD7R9PPYQ2PH,"Putin was expected to formally register on Wednesday to run for president, a position he held from 2000-2008, a period in which he grew more authoritarian.",131,135,grew,0,1,1
3DGDV62G7OACD5N6VQWD7R9PPYQ2PH,"Putin was expected to formally register on Wednesday to run for president, a position he held from 2000-2008, a period in which he grew more authoritarian.",131,154,grew more authoritarian,1,0,1
3DGDV62G7OACD5N6VQWD7R9PPYQ2PH,"Putin was expected to formally register on Wednesday to run for president, a position he held from 2000-2008, a period in which he grew more authoritarian.",141,154,authoritarian,10,10,20
3DGDV62G7OACD5N6VQWD7R9PPYQ2PH,Sunday's parliamentary vote suggests Russians are tiring of Putin and his United Russia party.,9,22,parliamentary,8,2,10
3DGDV62G7OACD5N6VQWD7R9PPYQ2PH,Sunday's parliamentary vote suggests Russians are tiring of Putin and his United Russia party.,9,27,parliamentary vote,2,0,2
3DGDV62G7OACD5N6VQWD7R9PPYQ2PH,Sunday's parliamentary vote suggests Russians are tiring of Putin and his United Russia party.,50,56,tiring,0,3,3
3DGDV62G7OACD5N6VQWD7R9PPYQ2PH,Sunday's parliamentary vote suggests Russians are tiring of Putin and his United Russia party.,50,59,tiring of,0,1,1
3DGDV62G7OACD5N6VQWD7R9PPYQ2PH,Sunday's parliamentary vote suggests Russians are tiring of Putin and his United Russia party.,60,65,Putin,0,1,1
3DGDV62G7OACD5N6VQWD7R9PPYQ2PH,"Preliminary results indicate the party won less than 50% of votes, a steep fall from its earlier majority.",0,11,Preliminary,7,3,10
3DGDV62G7OACD5N6VQWD7R9PPYQ2PH,"Preliminary results indicate the party won less than 50% of votes, a steep fall from its earlier majority.",0,19,Preliminary results,2,0,2
3DGDV62G7OACD5N6VQWD7R9PPYQ2PH,"Preliminary results indicate the party won less than 50% of votes, a steep fall from its earlier majority.",69,74,steep,2,4,6
3DGDV62G7OACD5N6VQWD7R9PPYQ2PH,"Preliminary results indicate the party won less than 50% of votes, a steep fall from its earlier majority.",69,79,steep fall,0,1,1
3DGDV62G7OACD5N6VQWD7R9PPYQ2PH,"Preliminary results indicate the party won less than 50% of votes, a steep fall from its earlier majority.",75,79,fall,0,1,1
3DGDV62G7OACD5N6VQWD7R9PPYQ2PH,"Preliminary results indicate the party won less than 50% of votes, a steep fall from its earlier majority.",89,105,earlier majority,2,0,2
3DGDV62G7OACD5N6VQWD7R9PPYQ2PH,The poll has been marred by widespread allegations of vote-rigging.,18,24,marred,4,7,11
3DGDV62G7OACD5N6VQWD7R9PPYQ2PH,The poll has been marred by widespread allegations of vote-rigging.,28,38,widespread,0,2,2
3DGDV62G7OACD5N6VQWD7R9PPYQ2PH,The poll has been marred by widespread allegations of vote-rigging.,28,50,widespread allegations,3,0,3
3DGDV62G7OACD5N6VQWD7R9PPYQ2PH,The poll has been marred by widespread allegations of vote-rigging.,28,66,widespread allegations of vote-rigging,1,0,1
3DGDV62G7OACD5N6VQWD7R9PPYQ2PH,The poll has been marred by widespread allegations of vote-rigging.,39,50,allegations,5,8,13
3DGDV62G7OACD5N6VQWD7R9PPYQ2PH,The poll has been marred by widespread allegations of vote-rigging.,54,66,vote-rigging,4,10,14
3DGDV62G7OACD5N6VQWD7R9PPYQ2PH,"The allegations have fired up the opposition, which has long seen its protests crushed and its pleas ignored by the Kremlin-dominated media.",4,15,allegations,3,3,6
3DGDV62G7OACD5N6VQWD7R9PPYQ2PH,"The allegations have fired up the opposition, which has long seen its protests crushed and its pleas ignored by the Kremlin-dominated media.",34,44,opposition,4,0,4
3DGDV62G7OACD5N6VQWD7R9PPYQ2PH,"The allegations have fired up the opposition, which has long seen its protests crushed and its pleas ignored by the Kremlin-dominated media.",79,86,crushed,0,1,1
3DGDV62G7OACD5N6VQWD7R9PPYQ2PH,"The allegations have fired up the opposition, which has long seen its protests crushed and its pleas ignored by the Kremlin-dominated media.",95,100,pleas,1,7,8
3DGDV62G7OACD5N6VQWD7R9PPYQ2PH,"The allegations have fired up the opposition, which has long seen its protests crushed and its pleas ignored by the Kremlin-dominated media.",101,108,ignored,0,2,2
3DGDV62G7OACD5N6VQWD7R9PPYQ2PH,"The allegations have fired up the opposition, which has long seen its protests crushed and its pleas ignored by the Kremlin-dominated media.",116,133,Kremlin-dominated,2,0,2
3DGDV62G7OACD5N6VQWD7R9PPYQ2PH,"The allegations have fired up the opposition, which has long seen its protests crushed and its pleas ignored by the Kremlin-dominated media.",116,139,Kremlin-dominated media,3,1,4
3T6SSHJUZFBO74E47YRLLAFUR3PII2,"Let us honor the memory of the fallen, not only by keeping them in our daily thoughts but also by staying true to their commitment,"" Romney said.",7,12,honor,2,5,7
3T6SSHJUZFBO74E47YRLLAFUR3PII2,"Let us honor the memory of the fallen, not only by keeping them in our daily thoughts but also by staying true to their commitment,"" Romney said.",17,23,memory,1,1,2
3T6SSHJUZFBO74E47YRLLAFUR3PII2,"Let us honor the memory of the fallen, not only by keeping them in our daily thoughts but also by staying true to their commitment,"" Romney said.",27,37,the fallen,1,1,2
3T6SSHJUZFBO74E47YRLLAFUR3PII2,"Let us honor the memory of the fallen, not only by keeping them in our daily thoughts but also by staying true to their commitment,"" Romney said.",31,37,fallen,1,2,3
3T6SSHJUZFBO74E47YRLLAFUR3PII2,"Let us honor the memory of the fallen, not only by keeping them in our daily thoughts but also by staying true to their commitment,"" Romney said.",71,85,daily thoughts,1,0,1
3T6SSHJUZFBO74E47YRLLAFUR3PII2,"Let us honor the memory of the fallen, not only by keeping them in our daily thoughts but also by staying true to their commitment,"" Romney said.",120,130,commitment,8,10,18
3T6SSHJUZFBO74E47YRLLAFUR3PII2,"Before the trip, former President Bill Clinton touted Mr. Obama's bold decision to go after bin Laden in a campaign ad that also suggested Romney might not have made the same call.",17,23,former,0,1,1
3T6SSHJUZFBO74E47YRLLAFUR3PII2,"Before the trip, former President Bill Clinton touted Mr. Obama's bold decision to go after bin Laden in a campaign ad that also suggested Romney might not have made the same call.",47,53,touted,7,8,15
3T6SSHJUZFBO74E47YRLLAFUR3PII2,"Before the trip, former President Bill Clinton touted Mr. Obama's bold decision to go after bin Laden in a campaign ad that also suggested Romney might not have made the same call.",66,70,bold,1,0,1
3T6SSHJUZFBO74E47YRLLAFUR3PII2,"Before the trip, former President Bill Clinton touted Mr. Obama's bold decision to go after bin Laden in a campaign ad that also suggested Romney might not have made the same call.",71,79,decision,0,1,1
3T6SSHJUZFBO74E47YRLLAFUR3PII2,"Before the trip, former President Bill Clinton touted Mr. Obama's bold decision to go after bin Laden in a campaign ad that also suggested Romney might not have made the same call.",107,115,campaign,7,8,15
3T6SSHJUZFBO74E47YRLLAFUR3PII2,"Before the trip, former President Bill Clinton touted Mr. Obama's bold decision to go after bin Laden in a campaign ad that also suggested Romney might not have made the same call.",107,118,campaign ad,1,1,2
3T6SSHJUZFBO74E47YRLLAFUR3PII2,"Before the trip, former President Bill Clinton touted Mr. Obama's bold decision to go after bin Laden in a campaign ad that also suggested Romney might not have made the same call.",129,138,suggested,0,4,4
3T6SSHJUZFBO74E47YRLLAFUR3PII2,"Romney fired back Tuesday, appearing with former New York City Mayor Rudy Giuliani in front of a New York City firehouse and saying Obama should not be politicizing the issue.",7,17,fired back,2,3,5
3T6SSHJUZFBO74E47YRLLAFUR3PII2,"Romney fired back Tuesday, appearing with former New York City Mayor Rudy Giuliani in front of a New York City firehouse and saying Obama should not be politicizing the issue.",27,36,appearing,1,3,4
3T6SSHJUZFBO74E47YRLLAFUR3PII2,"Romney fired back Tuesday, appearing with former New York City Mayor Rudy Giuliani in front of a New York City firehouse and saying Obama should not be politicizing the issue.",111,120,firehouse,2,4,6
3T6SSHJUZFBO74E47YRLLAFUR3PII2,"Romney fired back Tuesday, appearing with former New York City Mayor Rudy Giuliani in front of a New York City firehouse and saying Obama should not be politicizing the issue.",152,164,politicizing,10,10,20
3T6SSHJUZFBO74E47YRLLAFUR3PII2,"Romney fired back Tuesday, appearing with former New York City Mayor Rudy Giuliani in front of a New York City firehouse and saying Obama should not be politicizing the issue.",152,174,politicizing the issue,1,0,1
3T6SSHJUZFBO74E47YRLLAFUR3PII2,"Romney fired back Tuesday, appearing with former New York City Mayor Rudy Giuliani in front of a New York City firehouse and saying Obama should not be politicizing the issue.",169,174,issue,1,1,2
3T6SSHJUZFBO74E47YRLLAFUR3PII2,"Military personnel watch on a screen as President Barack Obama makes a live address at Bagram Air Field, Afghanistan, Wednesday, May 2, 2012.",0,18,Military personnel,1,1,2
3T6SSHJUZFBO74E47YRLLAFUR3PII2,"Military personnel watch on a screen as President Barack Obama makes a live address at Bagram Air Field, Afghanistan, Wednesday, May 2, 2012.",9,18,personnel,2,0,2
3T6SSHJUZFBO74E47YRLLAFUR3PII2,"Military personnel watch on a screen as President Barack Obama makes a live address at Bagram Air Field, Afghanistan, Wednesday, May 2, 2012.",71,83,live address,2,0,2
3T6SSHJUZFBO74E47YRLLAFUR3PII2,"Military personnel watch on a screen as President Barack Obama makes a live address at Bagram Air Field, Afghanistan, Wednesday, May 2, 2012.",76,83,address,1,0,1
3T6SSHJUZFBO74E47YRLLAFUR3PII2,"Military personnel watch on a screen as President Barack Obama makes a live address at Bagram Air Field, Afghanistan, Wednesday, May 2, 2012.",87,93,Bagram,1,0,1
3T6SSHJUZFBO74E47YRLLAFUR3PII2,"Fierce clashes between Syrian government forces and opposition fighters have left at least 23 soldiers killed in the central Syrian city of Rastan, activists say.",0,6,Fierce,7,7,14
3T6SSHJUZFBO74E47YRLLAFUR3PII2,"Fierce clashes between Syrian government forces and opposition fighters have left at least 23 soldiers killed in the central Syrian city of Rastan, activists say.",0,14,Fierce clashes,0,3,3
3T6SSHJUZFBO74E47YRLLAFUR3PII2,"Fierce clashes between Syrian government forces and opposition fighters have left at least 23 soldiers killed in the central Syrian city of Rastan, activists say.",7,14,clashes,1,4,5
3T6SSHJUZFBO74E47YRLLAFUR3PII2,"Fierce clashes between Syrian government forces and opposition fighters have left at least 23 soldiers killed in the central Syrian city of Rastan, activists say.",30,40,government,1,0,1
3T6SSHJUZFBO74E47YRLLAFUR3PII2,"Fierce clashes between Syrian government forces and opposition fighters have left at least 23 soldiers killed in the central Syrian city of Rastan, activists say.",30,47,government forces,1,0,1
3T6SSHJUZFBO74E47YRLLAFUR3PII2,"Fierce clashes between Syrian government forces and opposition fighters have left at least 23 soldiers killed in the central Syrian city of Rastan, activists say.",52,62,opposition,3,1,4
3T6SSHJUZFBO74E47YRLLAFUR3PII2,"Fierce clashes between Syrian government forces and opposition fighters have left at least 23 soldiers killed in the central Syrian city of Rastan, activists say.",52,71,opposition fighters,1,0,1
3T6SSHJUZFBO74E47YRLLAFUR3PII2,"Fierce clashes between Syrian government forces and opposition fighters have left at least 23 soldiers killed in the central Syrian city of Rastan, activists say.",117,124,central,1,0,1
3T6SSHJUZFBO74E47YRLLAFUR3PII2,"Fierce clashes between Syrian government forces and opposition fighters have left at least 23 soldiers killed in the central Syrian city of Rastan, activists say.",148,157,activists,2,6,8
30Y6N4AHYPXKSS1157KJ8508MU0DRZ,"Earlier in the week, the Spanish government took a 45% stake in Bankia.",33,43,government,2,0,2
30Y6N4AHYPXKSS1157KJ8508MU0DRZ,"Earlier in the week, the Spanish government took a 45% stake in Bankia.",55,60,stake,4,10,14
30Y6N4AHYPXKSS1157KJ8508MU0DRZ,"Earlier in the week, the Spanish government took a 45% stake in Bankia.",64,70,Bankia,1,0,1
30Y6N4AHYPXKSS1157KJ8508MU0DRZ,It had already forced banks to make provisions of 54bn euros to cover bad loans.,15,21,forced,0,1,1
30Y6N4AHYPXKSS1157KJ8508MU0DRZ,It had already forced banks to make provisions of 54bn euros to cover bad loans.,15,46,forced banks to make provisions,1,0,1
30Y6N4AHYPXKSS1157KJ8508MU0DRZ,It had already forced banks to make provisions of 54bn euros to cover bad loans.,36,46,provisions,10,9,19
30Y6N4AHYPXKSS1157KJ8508MU0DRZ,It had already forced banks to make provisions of 54bn euros to cover bad loans.,55,60,euros,1,0,1
30Y6N4AHYPXKSS1157KJ8508MU0DRZ,It had already forced banks to make provisions of 54bn euros to cover bad loans.,70,79,bad loans,1,2,3
30Y6N4AHYPXKSS1157KJ8508MU0DRZ,It had already forced banks to make provisions of 54bn euros to cover bad loans.,74,79,loans,0,1,1
30Y6N4AHYPXKSS1157KJ8508MU0DRZ,"The big question is whether the Spanish state can afford on its own to put into these banks the sort of capital that is necessary or whether they will have to go for emergency help from the eurozone bailout fund or the IMF, said BBC business editor Robert Peston.",1,17,The big question,1,0,1
30Y6N4AHYPXKSS1157KJ8508MU0DRZ,"The big question is whether the Spanish state can afford on its own to put into these banks the sort of capital that is necessary or whether they will have to go for emergency help from the eurozone bailout fund or the IMF, said BBC business editor Robert Peston.",51,57,afford,2,3,5
30Y6N4AHYPXKSS1157KJ8508MU0DRZ,"The big question is whether the Spanish state can afford on its own to put into these banks the sort of capital that is necessary or whether they will have to go for emergency help from the eurozone bailout fund or the IMF, said BBC business editor Robert Peston.",97,112,sort of capital,1,0,1
30Y6N4AHYPXKSS1157KJ8508MU0DRZ,"The big question is whether the Spanish state can afford on its own to put into these banks the sort of capital that is necessary or whether they will have to go for emergency help from the eurozone bailout fund or the IMF, said BBC business editor Robert Peston.",105,112,capital,3,1,4
30Y6N4AHYPXKSS1157KJ8508MU0DRZ,"The big question is whether the Spanish state can afford on its own to put into these banks the sort of capital that is necessary or whether they will have to go for emergency help from the eurozone bailout fund or the IMF, said BBC business editor Robert Peston.",167,176,emergency,2,1,3
30Y6N4AHYPXKSS1157KJ8508MU0DRZ,"The big question is whether the Spanish state can afford on its own to put into these banks the sort of capital that is necessary or whether they will have to go for emergency help from the eurozone bailout fund or the IMF, said BBC business editor Robert Peston.",191,199,eurozone,3,1,4
30Y6N4AHYPXKSS1157KJ8508MU0DRZ,"The big question is whether the Spanish state can afford on its own to put into these banks the sort of capital that is necessary or whether they will have to go for emergency help from the eurozone bailout fund or the IMF, said BBC business editor Robert Peston.",191,207,eurozone bailout,1,0,1
30Y6N4AHYPXKSS1157KJ8508MU0DRZ,"The big question is whether the Spanish state can afford on its own to put into these banks the sort of capital that is necessary or whether they will have to go for emergency help from the eurozone bailout fund or the IMF, said BBC business editor Robert Peston.",191,212,eurozone bailout fund,4,0,4
30Y6N4AHYPXKSS1157KJ8508MU0DRZ,"The big question is whether the Spanish state can afford on its own to put into these banks the sort of capital that is necessary or whether they will have to go for emergency help from the eurozone bailout fund or the IMF, said BBC business editor Robert Peston.",200,207,bailout,6,8,14
30Y6N4AHYPXKSS1157KJ8508MU0DRZ,"The big question is whether the Spanish state can afford on its own to put into these banks the sort of capital that is necessary or whether they will have to go for emergency help from the eurozone bailout fund or the IMF, said BBC business editor Robert Peston.",200,212,bailout fund,1,5,6
30Y6N4AHYPXKSS1157KJ8508MU0DRZ,"The big question is whether the Spanish state can afford on its own to put into these banks the sort of capital that is necessary or whether they will have to go for emergency help from the eurozone bailout fund or the IMF, said BBC business editor Robert Peston.",220,223,IMF,1,0,1
30Y6N4AHYPXKSS1157KJ8508MU0DRZ,"The big question is whether the Spanish state can afford on its own to put into these banks the sort of capital that is necessary or whether they will have to go for emergency help from the eurozone bailout fund or the IMF, said BBC business editor Robert Peston.",244,250,editor,0,1,1
30Y6N4AHYPXKSS1157KJ8508MU0DRZ,"JPMorgan Chase, the biggest US bank, reveals a surprise trading loss of $2bn (£1.2bn) on complex investments made by its traders.",37,44,reveals,2,4,6
30Y6N4AHYPXKSS1157KJ8508MU0DRZ,"JPMorgan Chase, the biggest US bank, reveals a surprise trading loss of $2bn (£1.2bn) on complex investments made by its traders.",47,68,surprise trading loss,1,0,1
30Y6N4AHYPXKSS1157KJ8508MU0DRZ,"JPMorgan Chase, the biggest US bank, reveals a surprise trading loss of $2bn (£1.2bn) on complex investments made by its traders.",56,68,trading loss,1,1,2
30Y6N4AHYPXKSS1157KJ8508MU0DRZ,"JPMorgan Chase, the biggest US bank, reveals a surprise trading loss of $2bn (£1.2bn) on complex investments made by its traders.",89,96,complex,1,0,1
30Y6N4AHYPXKSS1157KJ8508MU0DRZ,"JPMorgan Chase, the biggest US bank, reveals a surprise trading loss of $2bn (£1.2bn) on complex investments made by its traders.",89,108,complex investments,8,3,11
30Y6N4AHYPXKSS1157KJ8508MU0DRZ,"JPMorgan Chase, the biggest US bank, reveals a surprise trading loss of $2bn (£1.2bn) on complex investments made by its traders.",97,108,investments,2,1,3
30Y6N4AHYPXKSS1157KJ8508MU0DRZ,"JPMorgan Chase, the biggest US bank, reveals a surprise trading loss of $2bn (£1.2bn) on complex investments made by its traders.",121,128,traders,1,1,2
30Y6N4AHYPXKSS1157KJ8508MU0DRZ,The Spanish government on Friday announced measures to protect the country's banks against the risks caused by loans going bad.,33,42,announced,0,2,2
30Y6N4AHYPXKSS1157KJ8508MU0DRZ,The Spanish government on Friday announced measures to protect the country's banks against the risks caused by loans going bad.,43,51,measures,1,3,4
30Y6N4AHYPXKSS1157KJ8508MU0DRZ,The Spanish government on Friday announced measures to protect the country's banks against the risks caused by loans going bad.,55,99,protect the countrys banks against the risks,1,0,1
30Y6N4AHYPXKSS1157KJ8508MU0DRZ,The Spanish government on Friday announced measures to protect the country's banks against the risks caused by loans going bad.,95,100,risks,2,1,3
30Y6N4AHYPXKSS1157KJ8508MU0DRZ,The Spanish government on Friday announced measures to protect the country's banks against the risks caused by loans going bad.,111,116,loans,0,1,1
30Y6N4AHYPXKSS1157KJ8508MU0DRZ,The Spanish government on Friday announced measures to protect the country's banks against the risks caused by loans going bad.,111,126,loans going bad,0,1,1
30Y6N4AHYPXKSS1157KJ8508MU0DRZ,"According to the new measures announced by vice prime minister Soraya Saenz de Santamaria and Economy Minister Luis de Guindos, Spain's banks will have to find an extra 30 billion euros (39 billion U.S. dollars) of capital.",17,29,new measures,1,1,2
30Y6N4AHYPXKSS1157KJ8508MU0DRZ,"According to the new measures announced by vice prime minister Soraya Saenz de Santamaria and Economy Minister Luis de Guindos, Spain's banks will have to find an extra 30 billion euros (39 billion U.S. dollars) of capital.",21,29,measures,1,2,3
30Y6N4AHYPXKSS1157KJ8508MU0DRZ,"According to the new measures announced by vice prime minister Soraya Saenz de Santamaria and Economy Minister Luis de Guindos, Spain's banks will have to find an extra 30 billion euros (39 billion U.S. dollars) of capital.",30,39,announced,1,0,1
30Y6N4AHYPXKSS1157KJ8508MU0DRZ,"According to the new measures announced by vice prime minister Soraya Saenz de Santamaria and Economy Minister Luis de Guindos, Spain's banks will have to find an extra 30 billion euros (39 billion U.S. dollars) of capital.",43,62,vice prime minister,1,0,1
30Y6N4AHYPXKSS1157KJ8508MU0DRZ,"According to the new measures announced by vice prime minister Soraya Saenz de Santamaria and Economy Minister Luis de Guindos, Spain's banks will have to find an extra 30 billion euros (39 billion U.S. dollars) of capital.",63,89,Soraya Saenz de Santamaria,1,0,1
30Y6N4AHYPXKSS1157KJ8508MU0DRZ,"According to the new measures announced by vice prime minister Soraya Saenz de Santamaria and Economy Minister Luis de Guindos, Spain's banks will have to find an extra 30 billion euros (39 billion U.S. dollars) of capital.",102,110,Minister,1,0,1
30Y6N4AHYPXKSS1157KJ8508MU0DRZ,"According to the new measures announced by vice prime minister Soraya Saenz de Santamaria and Economy Minister Luis de Guindos, Spain's banks will have to find an extra 30 billion euros (39 billion U.S. dollars) of capital.",111,126,Luis de Guindos,1,0,1
30Y6N4AHYPXKSS1157KJ8508MU0DRZ,"According to the new measures announced by vice prime minister Soraya Saenz de Santamaria and Economy Minister Luis de Guindos, Spain's banks will have to find an extra 30 billion euros (39 billion U.S. dollars) of capital.",215,222,capital,2,1,3
362E9TQF2HRABD89HARI0Y2ECQXGI8,"The move will provide an extra 30bn euros (24.1bn) financial cushion, taking total provisions against real estate assets to 137bn euros (110bn), worth 45% of the banks' portfolios.",51,68,financial cushion,6,6,12
362E9TQF2HRABD89HARI0Y2ECQXGI8,"The move will provide an extra 30bn euros (24.1bn) financial cushion, taking total provisions against real estate assets to 137bn euros (110bn), worth 45% of the banks' portfolios.",61,68,cushion,1,1,2
362E9TQF2HRABD89HARI0Y2ECQXGI8,"The move will provide an extra 30bn euros (24.1bn) financial cushion, taking total provisions against real estate assets to 137bn euros (110bn), worth 45% of the banks' portfolios.",77,93,total provisions,1,0,1
362E9TQF2HRABD89HARI0Y2ECQXGI8,"The move will provide an extra 30bn euros (24.1bn) financial cushion, taking total provisions against real estate assets to 137bn euros (110bn), worth 45% of the banks' portfolios.",83,93,provisions,6,3,9
362E9TQF2HRABD89HARI0Y2ECQXGI8,"The move will provide an extra 30bn euros (24.1bn) financial cushion, taking total provisions against real estate assets to 137bn euros (110bn), worth 45% of the banks' portfolios.",102,120,real estate assets,3,1,4
362E9TQF2HRABD89HARI0Y2ECQXGI8,"The move will provide an extra 30bn euros (24.1bn) financial cushion, taking total provisions against real estate assets to 137bn euros (110bn), worth 45% of the banks' portfolios.",114,120,assets,1,0,1
362E9TQF2HRABD89HARI0Y2ECQXGI8,"The move will provide an extra 30bn euros (24.1bn) financial cushion, taking total provisions against real estate assets to 137bn euros (110bn), worth 45% of the banks' portfolios.",169,179,portfolios,6,9,15
362E9TQF2HRABD89HARI0Y2ECQXGI8,Economy minister Luis de Guindos said public funds available for the banks would be less than 15bn euros (12bn) and would not have any effect on the country's deficit.,0,7,Economy,1,0,1
362E9TQF2HRABD89HARI0Y2ECQXGI8,Economy minister Luis de Guindos said public funds available for the banks would be less than 15bn euros (12bn) and would not have any effect on the country's deficit.,17,32,Luis de Guindos,1,0,1
362E9TQF2HRABD89HARI0Y2ECQXGI8,Economy minister Luis de Guindos said public funds available for the banks would be less than 15bn euros (12bn) and would not have any effect on the country's deficit.,38,50,public funds,1,0,1
362E9TQF2HRABD89HARI0Y2ECQXGI8,Economy minister Luis de Guindos said public funds available for the banks would be less than 15bn euros (12bn) and would not have any effect on the country's deficit.,159,166,deficit,10,10,20
362E9TQF2HRABD89HARI0Y2ECQXGI8,"Two independent auditing firms will be responsible for valuing banks' exposure to the nation's collapsed property sector, ministers told a news conference after a cabinet meeting.",4,30,independent auditing firms,1,0,1
362E9TQF2HRABD89HARI0Y2ECQXGI8,"Two independent auditing firms will be responsible for valuing banks' exposure to the nation's collapsed property sector, ministers told a news conference after a cabinet meeting.",16,24,auditing,5,5,10
362E9TQF2HRABD89HARI0Y2ECQXGI8,"Two independent auditing firms will be responsible for valuing banks' exposure to the nation's collapsed property sector, ministers told a news conference after a cabinet meeting.",16,30,auditing firms,3,1,4
362E9TQF2HRABD89HARI0Y2ECQXGI8,"Two independent auditing firms will be responsible for valuing banks' exposure to the nation's collapsed property sector, ministers told a news conference after a cabinet meeting.",55,62,valuing,3,0,3
362E9TQF2HRABD89HARI0Y2ECQXGI8,"Two independent auditing firms will be responsible for valuing banks' exposure to the nation's collapsed property sector, ministers told a news conference after a cabinet meeting.",70,78,exposure,3,5,8
362E9TQF2HRABD89HARI0Y2ECQXGI8,"Two independent auditing firms will be responsible for valuing banks' exposure to the nation's collapsed property sector, ministers told a news conference after a cabinet meeting.",95,104,collapsed,4,4,8
362E9TQF2HRABD89HARI0Y2ECQXGI8,"Two independent auditing firms will be responsible for valuing banks' exposure to the nation's collapsed property sector, ministers told a news conference after a cabinet meeting.",95,120,collapsed property sector,4,0,4
362E9TQF2HRABD89HARI0Y2ECQXGI8,"Two independent auditing firms will be responsible for valuing banks' exposure to the nation's collapsed property sector, ministers told a news conference after a cabinet meeting.",105,120,property sector,1,0,1
362E9TQF2HRABD89HARI0Y2ECQXGI8,"Two independent auditing firms will be responsible for valuing banks' exposure to the nation's collapsed property sector, ministers told a news conference after a cabinet meeting.",114,120,sector,1,0,1
362E9TQF2HRABD89HARI0Y2ECQXGI8,"Two independent auditing firms will be responsible for valuing banks' exposure to the nation's collapsed property sector, ministers told a news conference after a cabinet meeting.",122,131,ministers,1,0,1
362E9TQF2HRABD89HARI0Y2ECQXGI8,"Two independent auditing firms will be responsible for valuing banks' exposure to the nation's collapsed property sector, ministers told a news conference after a cabinet meeting.",144,154,conference,2,1,3
362E9TQF2HRABD89HARI0Y2ECQXGI8,"Two independent auditing firms will be responsible for valuing banks' exposure to the nation's collapsed property sector, ministers told a news conference after a cabinet meeting.",163,170,cabinet,1,1,2
362E9TQF2HRABD89HARI0Y2ECQXGI8,"Two independent auditing firms will be responsible for valuing banks' exposure to the nation's collapsed property sector, ministers told a news conference after a cabinet meeting.",163,178,cabinet meeting,3,0,3
362E9TQF2HRABD89HARI0Y2ECQXGI8,"Banks which are unable to raise the extra capital will have access to a five-year loan, via a convertible bond, from the state at an interest rate of 10%, they added.",36,49,extra capital,0,1,1
362E9TQF2HRABD89HARI0Y2ECQXGI8,"Banks which are unable to raise the extra capital will have access to a five-year loan, via a convertible bond, from the state at an interest rate of 10%, they added.",42,49,capital,2,0,2
362E9TQF2HRABD89HARI0Y2ECQXGI8,"Banks which are unable to raise the extra capital will have access to a five-year loan, via a convertible bond, from the state at an interest rate of 10%, they added.",60,66,access,1,2,3
362E9TQF2HRABD89HARI0Y2ECQXGI8,"Banks which are unable to raise the extra capital will have access to a five-year loan, via a convertible bond, from the state at an interest rate of 10%, they added.",72,86,five-year loan,0,1,1
362E9TQF2HRABD89HARI0Y2ECQXGI8,"Banks which are unable to raise the extra capital will have access to a five-year loan, via a convertible bond, from the state at an interest rate of 10%, they added.",92,110,a convertible bond,0,1,1
362E9TQF2HRABD89HARI0Y2ECQXGI8,"Banks which are unable to raise the extra capital will have access to a five-year loan, via a convertible bond, from the state at an interest rate of 10%, they added.",94,105,convertible,2,5,7
362E9TQF2HRABD89HARI0Y2ECQXGI8,"Banks which are unable to raise the extra capital will have access to a five-year loan, via a convertible bond, from the state at an interest rate of 10%, they added.",94,110,convertible bond,7,5,12
362E9TQF2HRABD89HARI0Y2ECQXGI8,"Banks which are unable to raise the extra capital will have access to a five-year loan, via a convertible bond, from the state at an interest rate of 10%, they added.",133,146,interest rate,1,0,1
362E9TQF2HRABD89HARI0Y2ECQXGI8,The country will also make its rental market more flexible in order to incentivise banks to offload their real estate assets.,31,44,rental market,0,1,1
362E9TQF2HRABD89HARI0Y2ECQXGI8,The country will also make its rental market more flexible in order to incentivise banks to offload their real estate assets.,50,58,flexible,1,2,3
362E9TQF2HRABD89HARI0Y2ECQXGI8,The country will also make its rental market more flexible in order to incentivise banks to offload their real estate assets.,71,82,incentivise,10,10,20
362E9TQF2HRABD89HARI0Y2ECQXGI8,The country will also make its rental market more flexible in order to incentivise banks to offload their real estate assets.,71,88,incentivise banks,1,0,1
362E9TQF2HRABD89HARI0Y2ECQXGI8,The country will also make its rental market more flexible in order to incentivise banks to offload their real estate assets.,71,99,incentivise banks to offload,0,1,1
362E9TQF2HRABD89HARI0Y2ECQXGI8,The country will also make its rental market more flexible in order to incentivise banks to offload their real estate assets.,92,99,offload,4,7,11
362E9TQF2HRABD89HARI0Y2ECQXGI8,The country will also make its rental market more flexible in order to incentivise banks to offload their real estate assets.,118,124,assets,1,1,2
3SCKNODZ0XHJWL8ZLN0GZTL20ZB7N6,Chinese antitrust and competition authorities have approved Google to acquire Motorolla.,0,17,Chinese antitrust,1,0,1
3SCKNODZ0XHJWL8ZLN0GZTL20ZB7N6,Chinese antitrust and competition authorities have approved Google to acquire Motorolla.,8,17,antitrust,8,9,17
3SCKNODZ0XHJWL8ZLN0GZTL20ZB7N6,Chinese antitrust and competition authorities have approved Google to acquire Motorolla.,8,33,antitrust and competition,1,0,1
3SCKNODZ0XHJWL8ZLN0GZTL20ZB7N6,Chinese antitrust and competition authorities have approved Google to acquire Motorolla.,8,45,antitrust and competition authorities,2,0,2
3SCKNODZ0XHJWL8ZLN0GZTL20ZB7N6,Chinese antitrust and competition authorities have approved Google to acquire Motorolla.,22,33,competition,1,4,5
3SCKNODZ0XHJWL8ZLN0GZTL20ZB7N6,Chinese antitrust and competition authorities have approved Google to acquire Motorolla.,22,45,competition authorities,3,0,3
3SCKNODZ0XHJWL8ZLN0GZTL20ZB7N6,Chinese antitrust and competition authorities have approved Google to acquire Motorolla.,34,45,authorities,0,2,2
3SCKNODZ0XHJWL8ZLN0GZTL20ZB7N6,Chinese antitrust and competition authorities have approved Google to acquire Motorolla.,70,77,acquire,5,6,11
3SCKNODZ0XHJWL8ZLN0GZTL20ZB7N6,"VentureBeat reports that according to The Wall Street Journal, Google's deal to purchase Motorola Mobility for $12.5 billion dollars will likely close next week.",0,19,VentureBeat reports,1,0,1
3SCKNODZ0XHJWL8ZLN0GZTL20ZB7N6,"VentureBeat reports that according to The Wall Street Journal, Google's deal to purchase Motorola Mobility for $12.5 billion dollars will likely close next week.",25,34,according,0,1,1
3SCKNODZ0XHJWL8ZLN0GZTL20ZB7N6,"VentureBeat reports that according to The Wall Street Journal, Google's deal to purchase Motorola Mobility for $12.5 billion dollars will likely close next week.",54,61,Journal,0,1,1
3SCKNODZ0XHJWL8ZLN0GZTL20ZB7N6,"VentureBeat reports that according to The Wall Street Journal, Google's deal to purchase Motorola Mobility for $12.5 billion dollars will likely close next week.",80,88,purchase,0,3,3
3SCKNODZ0XHJWL8ZLN0GZTL20ZB7N6,"VentureBeat reports that according to The Wall Street Journal, Google's deal to purchase Motorola Mobility for $12.5 billion dollars will likely close next week.",145,150,close,1,0,1
3SCKNODZ0XHJWL8ZLN0GZTL20ZB7N6,"The deal is said to give Google 17,000 patents and 6,800 pending patent applications owned by Motorola.",39,46,patents,5,3,8
3SCKNODZ0XHJWL8ZLN0GZTL20ZB7N6,"The deal is said to give Google 17,000 patents and 6,800 pending patent applications owned by Motorola.",57,64,pending,1,3,4
3SCKNODZ0XHJWL8ZLN0GZTL20ZB7N6,"The deal is said to give Google 17,000 patents and 6,800 pending patent applications owned by Motorola.",57,71,pending patent,2,0,2
3SCKNODZ0XHJWL8ZLN0GZTL20ZB7N6,"The deal is said to give Google 17,000 patents and 6,800 pending patent applications owned by Motorola.",57,84,pending patent applications,3,1,4
3SCKNODZ0XHJWL8ZLN0GZTL20ZB7N6,"The deal is said to give Google 17,000 patents and 6,800 pending patent applications owned by Motorola.",65,71,patent,3,1,4
3SCKNODZ0XHJWL8ZLN0GZTL20ZB7N6,"The deal is said to give Google 17,000 patents and 6,800 pending patent applications owned by Motorola.",65,84,patent applications,2,1,3
3SCKNODZ0XHJWL8ZLN0GZTL20ZB7N6,"The deal is said to give Google 17,000 patents and 6,800 pending patent applications owned by Motorola.",72,84,applications,1,1,2
3SCKNODZ0XHJWL8ZLN0GZTL20ZB7N6,"The deal is said to give Google 17,000 patents and 6,800 pending patent applications owned by Motorola.",85,90,owned,0,1,1
3SCKNODZ0XHJWL8ZLN0GZTL20ZB7N6,"China was the last regulatory hold-out to approve the merger, which was approved by the United States Department of Justice and European Union regulators in February.",14,38,last regulatory hold-out,1,0,1
3SCKNODZ0XHJWL8ZLN0GZTL20ZB7N6,"China was the last regulatory hold-out to approve the merger, which was approved by the United States Department of Justice and European Union regulators in February.",19,29,regulatory,6,3,9
3SCKNODZ0XHJWL8ZLN0GZTL20ZB7N6,"China was the last regulatory hold-out to approve the merger, which was approved by the United States Department of Justice and European Union regulators in February.",19,38,regulatory hold-out,4,1,5
3SCKNODZ0XHJWL8ZLN0GZTL20ZB7N6,"China was the last regulatory hold-out to approve the merger, which was approved by the United States Department of Justice and European Union regulators in February.",30,38,hold-out,2,4,6
3SCKNODZ0XHJWL8ZLN0GZTL20ZB7N6,"China was the last regulatory hold-out to approve the merger, which was approved by the United States Department of Justice and European Union regulators in February.",54,60,merger,8,6,14
3SCKNODZ0XHJWL8ZLN0GZTL20ZB7N6,"China was the last regulatory hold-out to approve the merger, which was approved by the United States Department of Justice and European Union regulators in February.",72,80,approved,0,1,1
3SCKNODZ0XHJWL8ZLN0GZTL20ZB7N6,"China was the last regulatory hold-out to approve the merger, which was approved by the United States Department of Justice and European Union regulators in February.",143,153,regulators,3,3,6
3SCKNODZ0XHJWL8ZLN0GZTL20ZB7N6,"Now that China has given the go-ahead, the deal can be finalized.",19,37,given the go-ahead,1,0,1
3SCKNODZ0XHJWL8ZLN0GZTL20ZB7N6,"Now that China has given the go-ahead, the deal can be finalized.",29,37,go-ahead,3,5,8
3SCKNODZ0XHJWL8ZLN0GZTL20ZB7N6,"Now that China has given the go-ahead, the deal can be finalized.",55,64,finalized,4,1,5
3SCKNODZ0XHJWL8ZLN0GZTL20ZB7N6,Antitrust issues were a major reason that regulatory boards had to mull over before approving the deal.,0,9,Antitrust,3,2,5
3SCKNODZ0XHJWL8ZLN0GZTL20ZB7N6,Antitrust issues were a major reason that regulatory boards had to mull over before approving the deal.,0,16,Antitrust issues,3,1,4
3SCKNODZ0XHJWL8ZLN0GZTL20ZB7N6,Antitrust issues were a major reason that regulatory boards had to mull over before approving the deal.,10,16,issues,0,1,1
3SCKNODZ0XHJWL8ZLN0GZTL20ZB7N6,Antitrust issues were a major reason that regulatory boards had to mull over before approving the deal.,42,52,regulatory,1,0,1
3SCKNODZ0XHJWL8ZLN0GZTL20ZB7N6,Antitrust issues were a major reason that regulatory boards had to mull over before approving the deal.,42,59,regulatory boards,3,2,5
3SCKNODZ0XHJWL8ZLN0GZTL20ZB7N6,Antitrust issues were a major reason that regulatory boards had to mull over before approving the deal.,53,59,boards,0,1,1
3SCKNODZ0XHJWL8ZLN0GZTL20ZB7N6,Antitrust issues were a major reason that regulatory boards had to mull over before approving the deal.,64,76,to mull over,0,1,1
3SCKNODZ0XHJWL8ZLN0GZTL20ZB7N6,Antitrust issues were a major reason that regulatory boards had to mull over before approving the deal.,67,71,mull,2,4,6
3SCKNODZ0XHJWL8ZLN0GZTL20ZB7N6,Antitrust issues were a major reason that regulatory boards had to mull over before approving the deal.,67,76,mull over,4,5,9
3SCKNODZ0XHJWL8ZLN0GZTL20ZB7N6,"Mainly, there were concerns that Motorola would be given preferential treatment for the Android operating system, which runs on Motorola devices.",19,27,concerns,0,1,1
3SCKNODZ0XHJWL8ZLN0GZTL20ZB7N6,"Mainly, there were concerns that Motorola would be given preferential treatment for the Android operating system, which runs on Motorola devices.",57,69,preferential,7,5,12
3SCKNODZ0XHJWL8ZLN0GZTL20ZB7N6,"Mainly, there were concerns that Motorola would be given preferential treatment for the Android operating system, which runs on Motorola devices.",57,79,preferential treatment,7,4,11
3SCKNODZ0XHJWL8ZLN0GZTL20ZB7N6,"Mainly, there were concerns that Motorola would be given preferential treatment for the Android operating system, which runs on Motorola devices.",70,79,treatment,1,0,1
3SCKNODZ0XHJWL8ZLN0GZTL20ZB7N6,"Mainly, there were concerns that Motorola would be given preferential treatment for the Android operating system, which runs on Motorola devices.",88,112,Android operating system,0,1,1
3SCKNODZ0XHJWL8ZLN0GZTL20ZB7N6,"Mainly, there were concerns that Motorola would be given preferential treatment for the Android operating system, which runs on Motorola devices.",96,105,operating,1,0,1
3SCKNODZ0XHJWL8ZLN0GZTL20ZB7N6,"Mainly, there were concerns that Motorola would be given preferential treatment for the Android operating system, which runs on Motorola devices.",96,112,operating system,3,0,3
3SCKNODZ0XHJWL8ZLN0GZTL20ZB7N6,"Mainly, there were concerns that Motorola would be given preferential treatment for the Android operating system, which runs on Motorola devices.",128,144,Motorola devices,0,1,1
3SCKNODZ0XHJWL8ZLN0GZTL20ZB7N6,"Mainly, there were concerns that Motorola would be given preferential treatment for the Android operating system, which runs on Motorola devices.",137,144,devices,0,1,1
338GLSUI43CTRRFAB2FEMF8PLM2SF7,"The next day, Thomas called to report that her son had kicked and punched her when she tried to wake him up for school.",66,73,punched,0,3,3
338GLSUI43CTRRFAB2FEMF8PLM2SF7,"The following day, child welfare investigators visited the house to look into allegations of inadequate supervision of the children.",19,46,child welfare investigators,4,1,5
338GLSUI43CTRRFAB2FEMF8PLM2SF7,"The following day, child welfare investigators visited the house to look into allegations of inadequate supervision of the children.",25,32,welfare,4,3,7
338GLSUI43CTRRFAB2FEMF8PLM2SF7,"The following day, child welfare investigators visited the house to look into allegations of inadequate supervision of the children.",25,46,welfare investigators,2,0,2
338GLSUI43CTRRFAB2FEMF8PLM2SF7,"The following day, child welfare investigators visited the house to look into allegations of inadequate supervision of the children.",33,46,investigators,2,3,5
338GLSUI43CTRRFAB2FEMF8PLM2SF7,"The following day, child welfare investigators visited the house to look into allegations of inadequate supervision of the children.",78,89,allegations,10,10,20
338GLSUI43CTRRFAB2FEMF8PLM2SF7,"The following day, child welfare investigators visited the house to look into allegations of inadequate supervision of the children.",78,115,allegations of inadequate supervision,2,0,2
338GLSUI43CTRRFAB2FEMF8PLM2SF7,"The following day, child welfare investigators visited the house to look into allegations of inadequate supervision of the children.",93,103,inadequate,5,8,13
338GLSUI43CTRRFAB2FEMF8PLM2SF7,"The following day, child welfare investigators visited the house to look into allegations of inadequate supervision of the children.",93,115,inadequate supervision,6,3,9
338GLSUI43CTRRFAB2FEMF8PLM2SF7,Records also showed that Thomas was arrested in 2002 on a misdemeanor battery charge for striking the father of her children.,58,69,misdemeanor,8,10,18
338GLSUI43CTRRFAB2FEMF8PLM2SF7,Records also showed that Thomas was arrested in 2002 on a misdemeanor battery charge for striking the father of her children.,58,84,misdemeanor battery charge,4,1,5
338GLSUI43CTRRFAB2FEMF8PLM2SF7,Records also showed that Thomas was arrested in 2002 on a misdemeanor battery charge for striking the father of her children.,70,77,battery,2,2,4
338GLSUI43CTRRFAB2FEMF8PLM2SF7,Records also showed that Thomas was arrested in 2002 on a misdemeanor battery charge for striking the father of her children.,70,84,battery charge,1,1,2
338GLSUI43CTRRFAB2FEMF8PLM2SF7,Records also showed that Thomas was arrested in 2002 on a misdemeanor battery charge for striking the father of her children.,89,97,striking,3,1,4
338GLSUI43CTRRFAB2FEMF8PLM2SF7,The charge was later dropped.,21,28,dropped,1,2,3
338GLSUI43CTRRFAB2FEMF8PLM2SF7,"Two years earlier, she filed a domestic violence complaint against Joe Johnson, but that was dismissed after a hearing.",23,28,filed,0,1,1
338GLSUI43CTRRFAB2FEMF8PLM2SF7,"Two years earlier, she filed a domestic violence complaint against Joe Johnson, but that was dismissed after a hearing.",31,39,domestic,1,0,1
338GLSUI43CTRRFAB2FEMF8PLM2SF7,"Two years earlier, she filed a domestic violence complaint against Joe Johnson, but that was dismissed after a hearing.",31,48,domestic violence,3,1,4
338GLSUI43CTRRFAB2FEMF8PLM2SF7,"Two years earlier, she filed a domestic violence complaint against Joe Johnson, but that was dismissed after a hearing.",31,58,domestic violence complaint,3,1,4
338GLSUI43CTRRFAB2FEMF8PLM2SF7,"Two years earlier, she filed a domestic violence complaint against Joe Johnson, but that was dismissed after a hearing.",40,48,violence,0,3,3
338GLSUI43CTRRFAB2FEMF8PLM2SF7,"Two years earlier, she filed a domestic violence complaint against Joe Johnson, but that was dismissed after a hearing.",49,58,complaint,4,3,7
338GLSUI43CTRRFAB2FEMF8PLM2SF7,"Two years earlier, she filed a domestic violence complaint against Joe Johnson, but that was dismissed after a hearing.",93,102,dismissed,8,2,10
338GLSUI43CTRRFAB2FEMF8PLM2SF7,"Two years earlier, she filed a domestic violence complaint against Joe Johnson, but that was dismissed after a hearing.",111,118,hearing,2,0,2
338GLSUI43CTRRFAB2FEMF8PLM2SF7,"Jamie Hudson, whose mother lives two doors down from the family, said the boys in the family were known to shoot BBs at a home across the street and had threatened to set it on fire.",113,116,BBs,2,2,4
338GLSUI43CTRRFAB2FEMF8PLM2SF7,"Jamie Hudson, whose mother lives two doors down from the family, said the boys in the family were known to shoot BBs at a home across the street and had threatened to set it on fire.",153,163,threatened,4,7,11
338GLSUI43CTRRFAB2FEMF8PLM2SF7,"Jamie Hudson, whose mother lives two doors down from the family, said the boys in the family were known to shoot BBs at a home across the street and had threatened to set it on fire.",167,181,set it on fire,0,1,1
3O0M2G5VC631OWMMIFJ4EG683V194V,It comes after the Bank of Spain effectively nationalized one of the nation's largest banks earlier this week.,33,44,effectively,0,1,1
3O0M2G5VC631OWMMIFJ4EG683V194V,It comes after the Bank of Spain effectively nationalized one of the nation's largest banks earlier this week.,33,57,effectively nationalized,1,0,1
3O0M2G5VC631OWMMIFJ4EG683V194V,It comes after the Bank of Spain effectively nationalized one of the nation's largest banks earlier this week.,45,57,nationalized,8,3,11
3O0M2G5VC631OWMMIFJ4EG683V194V,"Spanish banks have been struggling for years with the fallout from the nation's property bust, which saddled them with billions of euro worth of bad property loans.",24,34,struggling,0,4,4
3O0M2G5VC631OWMMIFJ4EG683V194V,"Spanish banks have been struggling for years with the fallout from the nation's property bust, which saddled them with billions of euro worth of bad property loans.",54,61,fallout,5,3,8
3O0M2G5VC631OWMMIFJ4EG683V194V,"Spanish banks have been struggling for years with the fallout from the nation's property bust, which saddled them with billions of euro worth of bad property loans.",71,92,nations property bust,1,0,1
3O0M2G5VC631OWMMIFJ4EG683V194V,"Spanish banks have been struggling for years with the fallout from the nation's property bust, which saddled them with billions of euro worth of bad property loans.",80,93,property bust,4,1,5
3O0M2G5VC631OWMMIFJ4EG683V194V,"Spanish banks have been struggling for years with the fallout from the nation's property bust, which saddled them with billions of euro worth of bad property loans.",89,93,bust,1,1,2
3O0M2G5VC631OWMMIFJ4EG683V194V,"Spanish banks have been struggling for years with the fallout from the nation's property bust, which saddled them with billions of euro worth of bad property loans.",101,108,saddled,6,4,10
3O0M2G5VC631OWMMIFJ4EG683V194V,"Spanish banks have been struggling for years with the fallout from the nation's property bust, which saddled them with billions of euro worth of bad property loans.",136,141,worth,0,1,1
3O0M2G5VC631OWMMIFJ4EG683V194V,"Spanish banks have been struggling for years with the fallout from the nation's property bust, which saddled them with billions of euro worth of bad property loans.",145,163,bad property loans,1,0,1
3O0M2G5VC631OWMMIFJ4EG683V194V,"Spanish banks have been struggling for years with the fallout from the nation's property bust, which saddled them with billions of euro worth of bad property loans.",149,163,property loans,1,0,1
3O0M2G5VC631OWMMIFJ4EG683V194V,"While the government has taken steps to support banks, analysts say more needs to be done to fix the problem once and for all.",55,63,analysts,10,4,14
3O0M2G5VC631OWMMIFJ4EG683V194V,11/05/2012 - 08:05:17 The Spanish government is expected to announce a new round of financial sector reforms later today.,34,44,government,1,0,1
3O0M2G5VC631OWMMIFJ4EG683V194V,11/05/2012 - 08:05:17 The Spanish government is expected to announce a new round of financial sector reforms later today.,48,56,expected,1,1,2
3O0M2G5VC631OWMMIFJ4EG683V194V,11/05/2012 - 08:05:17 The Spanish government is expected to announce a new round of financial sector reforms later today.,60,68,announce,0,1,1
3O0M2G5VC631OWMMIFJ4EG683V194V,11/05/2012 - 08:05:17 The Spanish government is expected to announce a new round of financial sector reforms later today.,84,93,financial,1,0,1
3O0M2G5VC631OWMMIFJ4EG683V194V,11/05/2012 - 08:05:17 The Spanish government is expected to announce a new round of financial sector reforms later today.,84,108,financial sector reforms,7,2,9
3O0M2G5VC631OWMMIFJ4EG683V194V,11/05/2012 - 08:05:17 The Spanish government is expected to announce a new round of financial sector reforms later today.,94,100,sector,4,0,4
3O0M2G5VC631OWMMIFJ4EG683V194V,11/05/2012 - 08:05:17 The Spanish government is expected to announce a new round of financial sector reforms later today.,94,108,sector reforms,0,1,1
3O0M2G5VC631OWMMIFJ4EG683V194V,11/05/2012 - 08:05:17 The Spanish government is expected to announce a new round of financial sector reforms later today.,101,108,reforms,1,4,5
3X4Q1O9UBHN1E68BM20TEIL7P8S7OU,"The trouble is, he is talking to audiences that have a very strong belief that the United States is going to abandon them, Biddle said in a phone interview.",5,12,trouble,0,2,2
3X4Q1O9UBHN1E68BM20TEIL7P8S7OU,"The trouble is, he is talking to audiences that have a very strong belief that the United States is going to abandon them, Biddle said in a phone interview.",34,43,audiences,6,2,8
3X4Q1O9UBHN1E68BM20TEIL7P8S7OU,"The trouble is, he is talking to audiences that have a very strong belief that the United States is going to abandon them, Biddle said in a phone interview.",68,74,belief,0,1,1
3X4Q1O9UBHN1E68BM20TEIL7P8S7OU,"The trouble is, he is talking to audiences that have a very strong belief that the United States is going to abandon them, Biddle said in a phone interview.",110,117,abandon,8,5,13
3X4Q1O9UBHN1E68BM20TEIL7P8S7OU,"The trouble is, he is talking to audiences that have a very strong belief that the United States is going to abandon them, Biddle said in a phone interview.",125,131,Biddle,0,1,1
3X4Q1O9UBHN1E68BM20TEIL7P8S7OU,"The trouble is, he is talking to audiences that have a very strong belief that the United States is going to abandon them, Biddle said in a phone interview.",148,157,interview,1,1,2
3X4Q1O9UBHN1E68BM20TEIL7P8S7OU,"The U.S. embassy, which neighbors the AFP bureau in Kabul, said its embassy was “under lockdown” and warned staff to “take cover, move away from the windows.”",9,16,embassy,3,1,4
3X4Q1O9UBHN1E68BM20TEIL7P8S7OU,"The U.S. embassy, which neighbors the AFP bureau in Kabul, said its embassy was “under lockdown” and warned staff to “take cover, move away from the windows.”",24,33,neighbors,0,2,2
3X4Q1O9UBHN1E68BM20TEIL7P8S7OU,"The U.S. embassy, which neighbors the AFP bureau in Kabul, said its embassy was “under lockdown” and warned staff to “take cover, move away from the windows.”",38,48,AFP bureau,1,0,1
3X4Q1O9UBHN1E68BM20TEIL7P8S7OU,"The U.S. embassy, which neighbors the AFP bureau in Kabul, said its embassy was “under lockdown” and warned staff to “take cover, move away from the windows.”",42,48,bureau,3,1,4
3X4Q1O9UBHN1E68BM20TEIL7P8S7OU,"The U.S. embassy, which neighbors the AFP bureau in Kabul, said its embassy was “under lockdown” and warned staff to “take cover, move away from the windows.”",68,75,embassy,3,0,3
3X4Q1O9UBHN1E68BM20TEIL7P8S7OU,"The U.S. embassy, which neighbors the AFP bureau in Kabul, said its embassy was “under lockdown” and warned staff to “take cover, move away from the windows.”",80,96,“under lockdown”,1,5,6
3X4Q1O9UBHN1E68BM20TEIL7P8S7OU,"The U.S. embassy, which neighbors the AFP bureau in Kabul, said its embassy was “under lockdown” and warned staff to “take cover, move away from the windows.”",87,96,lockdown”,1,1,2
3X4Q1O9UBHN1E68BM20TEIL7P8S7OU,"The U.S. embassy, which neighbors the AFP bureau in Kabul, said its embassy was “under lockdown” and warned staff to “take cover, move away from the windows.”",101,107,warned,1,1,2
3X4Q1O9UBHN1E68BM20TEIL7P8S7OU,"The U.S. embassy, which neighbors the AFP bureau in Kabul, said its embassy was “under lockdown” and warned staff to “take cover, move away from the windows.”",117,128,“take cover,1,0,1
3X4Q1O9UBHN1E68BM20TEIL7P8S7OU,"Obama earlier dropped from night skies into Kabul on a brief visit amid secrecy and tight security and signed a deal with President Hamid Karzai, cementing 10 years of U.S. aid for Afghanistan after NATO combat troops leave in 2014.",14,21,dropped,0,3,3
3X4Q1O9UBHN1E68BM20TEIL7P8S7OU,"Obama earlier dropped from night skies into Kabul on a brief visit amid secrecy and tight security and signed a deal with President Hamid Karzai, cementing 10 years of U.S. aid for Afghanistan after NATO combat troops leave in 2014.",27,38,night skies,0,3,3
3X4Q1O9UBHN1E68BM20TEIL7P8S7OU,"Obama earlier dropped from night skies into Kabul on a brief visit amid secrecy and tight security and signed a deal with President Hamid Karzai, cementing 10 years of U.S. aid for Afghanistan after NATO combat troops leave in 2014.",67,71,amid,5,7,12
3X4Q1O9UBHN1E68BM20TEIL7P8S7OU,"Obama earlier dropped from night skies into Kabul on a brief visit amid secrecy and tight security and signed a deal with President Hamid Karzai, cementing 10 years of U.S. aid for Afghanistan after NATO combat troops leave in 2014.",67,79,amid secrecy,3,3,6
3X4Q1O9UBHN1E68BM20TEIL7P8S7OU,"Obama earlier dropped from night skies into Kabul on a brief visit amid secrecy and tight security and signed a deal with President Hamid Karzai, cementing 10 years of U.S. aid for Afghanistan after NATO combat troops leave in 2014.",72,79,secrecy,2,2,4
3X4Q1O9UBHN1E68BM20TEIL7P8S7OU,"Obama earlier dropped from night skies into Kabul on a brief visit amid secrecy and tight security and signed a deal with President Hamid Karzai, cementing 10 years of U.S. aid for Afghanistan after NATO combat troops leave in 2014.",112,116,deal,0,1,1
3X4Q1O9UBHN1E68BM20TEIL7P8S7OU,"Obama earlier dropped from night skies into Kabul on a brief visit amid secrecy and tight security and signed a deal with President Hamid Karzai, cementing 10 years of U.S. aid for Afghanistan after NATO combat troops leave in 2014.",146,155,cementing,8,7,15
3X4Q1O9UBHN1E68BM20TEIL7P8S7OU,"Obama earlier dropped from night skies into Kabul on a brief visit amid secrecy and tight security and signed a deal with President Hamid Karzai, cementing 10 years of U.S. aid for Afghanistan after NATO combat troops leave in 2014.",204,210,combat,2,3,5
3X4Q1O9UBHN1E68BM20TEIL7P8S7OU,"The attack was a reminder of the extremist threat that stalks Afghanistan, with the Taliban resurgent a decade after they were driven from power for refusing to hand over Bin Laden following the 9/11 attacks.",33,42,extremist,5,5,10
3X4Q1O9UBHN1E68BM20TEIL7P8S7OU,"The attack was a reminder of the extremist threat that stalks Afghanistan, with the Taliban resurgent a decade after they were driven from power for refusing to hand over Bin Laden following the 9/11 attacks.",33,49,extremist threat,2,1,3
3X4Q1O9UBHN1E68BM20TEIL7P8S7OU,"The attack was a reminder of the extremist threat that stalks Afghanistan, with the Taliban resurgent a decade after they were driven from power for refusing to hand over Bin Laden following the 9/11 attacks.",55,61,stalks,4,7,11
3X4Q1O9UBHN1E68BM20TEIL7P8S7OU,"The attack was a reminder of the extremist threat that stalks Afghanistan, with the Taliban resurgent a decade after they were driven from power for refusing to hand over Bin Laden following the 9/11 attacks.",92,101,resurgent,10,10,20
3X4Q1O9UBHN1E68BM20TEIL7P8S7OU,"The attack was a reminder of the extremist threat that stalks Afghanistan, with the Taliban resurgent a decade after they were driven from power for refusing to hand over Bin Laden following the 9/11 attacks.",104,110,decade,0,2,2
3X4Q1O9UBHN1E68BM20TEIL7P8S7OU,"The attack was a reminder of the extremist threat that stalks Afghanistan, with the Taliban resurgent a decade after they were driven from power for refusing to hand over Bin Laden following the 9/11 attacks.",127,133,driven,1,0,1
3X4Q1O9UBHN1E68BM20TEIL7P8S7OU,"The attack was a reminder of the extremist threat that stalks Afghanistan, with the Taliban resurgent a decade after they were driven from power for refusing to hand over Bin Laden following the 9/11 attacks.",149,157,refusing,1,1,2
3G5RUKN2EC4NA4WS0KY0DPC8VPZN9Y,A 26-year-old man is still being questioned by police on suspicion of murder.,33,43,questioned,1,1,2
3G5RUKN2EC4NA4WS0KY0DPC8VPZN9Y,A 26-year-old man is still being questioned by police on suspicion of murder.,57,66,suspicion,10,10,20
3G5RUKN2EC4NA4WS0KY0DPC8VPZN9Y,A 26-year-old man is still being questioned by police on suspicion of murder.,57,76,suspicion of murder,0,1,1
3G5RUKN2EC4NA4WS0KY0DPC8VPZN9Y,"A man and woman, both aged 28, arrested on suspicion of assisting an offender were released, without charge, on Saturday evening.",31,39,arrested,1,1,2
3G5RUKN2EC4NA4WS0KY0DPC8VPZN9Y,"A man and woman, both aged 28, arrested on suspicion of assisting an offender were released, without charge, on Saturday evening.",43,52,suspicion,2,1,3
3G5RUKN2EC4NA4WS0KY0DPC8VPZN9Y,"A man and woman, both aged 28, arrested on suspicion of assisting an offender were released, without charge, on Saturday evening.",43,77,suspicion of assisting an offender,1,0,1
3G5RUKN2EC4NA4WS0KY0DPC8VPZN9Y,"A man and woman, both aged 28, arrested on suspicion of assisting an offender were released, without charge, on Saturday evening.",56,65,assisting,3,3,6
3G5RUKN2EC4NA4WS0KY0DPC8VPZN9Y,"A man and woman, both aged 28, arrested on suspicion of assisting an offender were released, without charge, on Saturday evening.",56,77,assisting an offender,1,0,1
3G5RUKN2EC4NA4WS0KY0DPC8VPZN9Y,"A man and woman, both aged 28, arrested on suspicion of assisting an offender were released, without charge, on Saturday evening.",69,77,offender,2,9,11
3G5RUKN2EC4NA4WS0KY0DPC8VPZN9Y,"A man and woman, both aged 28, arrested on suspicion of assisting an offender were released, without charge, on Saturday evening.",83,91,released,1,2,3
3G5RUKN2EC4NA4WS0KY0DPC8VPZN9Y,"A man and woman, both aged 28, arrested on suspicion of assisting an offender were released, without charge, on Saturday evening.",93,107,without charge,2,0,2
3G5RUKN2EC4NA4WS0KY0DPC8VPZN9Y,"A man and woman, both aged 28, arrested on suspicion of assisting an offender were released, without charge, on Saturday evening.",101,107,charge,1,2,3
3G5RUKN2EC4NA4WS0KY0DPC8VPZN9Y,They were all arrested in the Toome area within an hour on the shooting.,30,35,Toome,1,2,3
3G5RUKN2EC4NA4WS0KY0DPC8VPZN9Y,They were all arrested in the Toome area within an hour on the shooting.,63,71,shooting,0,1,1
3G5RUKN2EC4NA4WS0KY0DPC8VPZN9Y,Deputy First Minister Martin McGuinness has visited the victims' family and said they are in deep shock.,0,6,Deputy,0,1,1
3G5RUKN2EC4NA4WS0KY0DPC8VPZN9Y,Deputy First Minister Martin McGuinness has visited the victims' family and said they are in deep shock.,0,21,Deputy First Minister,1,0,1
3G5RUKN2EC4NA4WS0KY0DPC8VPZN9Y,Deputy First Minister Martin McGuinness has visited the victims' family and said they are in deep shock.,29,39,McGuinness,0,1,1
3G5RUKN2EC4NA4WS0KY0DPC8VPZN9Y,Deputy First Minister Martin McGuinness has visited the victims' family and said they are in deep shock.,44,51,visited,0,1,1
3G5RUKN2EC4NA4WS0KY0DPC8VPZN9Y,Deputy First Minister Martin McGuinness has visited the victims' family and said they are in deep shock.,56,63,victims,1,5,6
3G5RUKN2EC4NA4WS0KY0DPC8VPZN9Y,Deputy First Minister Martin McGuinness has visited the victims' family and said they are in deep shock.,93,103,deep shock,3,0,3
3G5RUKN2EC4NA4WS0KY0DPC8VPZN9Y,Deputy First Minister Martin McGuinness has visited the victims' family and said they are in deep shock.,98,103,shock,0,1,1
3G5RUKN2EC4NA4WS0KY0DPC8VPZN9Y,"He said: ""This family is clearly deeply shocked and traumatised by what has happened over the weekend.",25,39,clearly deeply,0,1,1
3G5RUKN2EC4NA4WS0KY0DPC8VPZN9Y,"He said: ""This family is clearly deeply shocked and traumatised by what has happened over the weekend.",52,63,traumatised,10,10,20
3G5RUKN2EC4NA4WS0KY0DPC8VPZN9Y,"Their daughter has been murdered and another daughter seriously injured.	25	33	murdered	1	1	2
3G5RUKN2EC4NA4WS0KY0DPC8VPZN9Y	Their daughter has been murdered and another daughter seriously injured.",55,72,seriously injured,0,1,1
3G5RUKN2EC4NA4WS0KY0DPC8VPZN9Y,"Their daughter has been murdered and another daughter seriously injured.	65	72	injured	0	1	1
3G5RUKN2EC4NA4WS0KY0DPC8VPZN9Y	I spent some time with the family and offered our support and that of the wider community at this time.",74,89,wider community,2,4,6
3G5RUKN2EC4NA4WS0KY0DPC8VPZN9Y,"I spent some time with the family and offered our support and that of the wider community at this time.""",80,89,community,1,0,1
3G5RUKN2EC4NA4WS0KY0DPC8VPZN9Y,SDLP Mid-Ulster MLA Patsy McGlone has said there is an overwhelming sense of shock in the county over the shooting.,0,15,SDLP Mid-Ulster,0,1,1
3G5RUKN2EC4NA4WS0KY0DPC8VPZN9Y,SDLP Mid-Ulster MLA Patsy McGlone has said there is an overwhelming sense of shock in the county over the shooting.,55,67,overwhelming,10,10,20
3G5RUKN2EC4NA4WS0KY0DPC8VPZN9Y,SDLP Mid-Ulster MLA Patsy McGlone has said there is an overwhelming sense of shock in the county over the shooting.,55,82,overwhelming sense of shock,1,0,1
3UV0D2KX1MKAP6DZL1JWOCSJ76ZF4N,"Israel's ambassador to Egypt, Yitzhak Levanon, returned to Cairo on Sunday after he was evacuated in September following an attack on the embassy, an airport official told AFP.",9,19,ambassador,6,2,8
3UV0D2KX1MKAP6DZL1JWOCSJ76ZF4N,"Israel's ambassador to Egypt, Yitzhak Levanon, returned to Cairo on Sunday after he was evacuated in September following an attack on the embassy, an airport official told AFP.",88,97,evacuated,10,10,20
3UV0D2KX1MKAP6DZL1JWOCSJ76ZF4N,"Israel's ambassador to Egypt, Yitzhak Levanon, returned to Cairo on Sunday after he was evacuated in September following an attack on the embassy, an airport official told AFP.",138,145,embassy,5,2,7
3UV0D2KX1MKAP6DZL1JWOCSJ76ZF4N,"Israel's ambassador to Egypt, Yitzhak Levanon, returned to Cairo on Sunday after he was evacuated in September following an attack on the embassy, an airport official told AFP.",172,175,AFP,1,0,1
3UV0D2KX1MKAP6DZL1JWOCSJ76ZF4N,"Levanon arrived in the early hours of Sunday on a Turkish Airlines flight from Istanbul, the official said.",9,16,arrived,0,1,1
3UV0D2KX1MKAP6DZL1JWOCSJ76ZF4N,"The ambassador's arrival had not been announced and he flew in in complete secrecy, the official said.",5,16,ambassadors,1,0,1
3UV0D2KX1MKAP6DZL1JWOCSJ76ZF4N,"The ambassador's arrival had not been announced and he flew in in complete secrecy, the official said.",39,48,announced,0,2,2
3UV0D2KX1MKAP6DZL1JWOCSJ76ZF4N,"The ambassador's arrival had not been announced and he flew in in complete secrecy, the official said.",56,60,flew,0,1,1
3UV0D2KX1MKAP6DZL1JWOCSJ76ZF4N,"The ambassador's arrival had not been announced and he flew in in complete secrecy, the official said.",56,63,flew in,0,1,1
3UV0D2KX1MKAP6DZL1JWOCSJ76ZF4N,"The ambassador's arrival had not been announced and he flew in in complete secrecy, the official said.",67,83,complete secrecy,3,2,5
3UV0D2KX1MKAP6DZL1JWOCSJ76ZF4N,"The ambassador's arrival had not been announced and he flew in in complete secrecy, the official said.",76,83,secrecy,8,3,11
3UV0D2KX1MKAP6DZL1JWOCSJ76ZF4N,"On September 9, protesters attacked the Israeli embassy headquarters in a residential building in central Cairo, forcing the evacuation of all embassy staff.",16,26,protesters,2,6,8
3UV0D2KX1MKAP6DZL1JWOCSJ76ZF4N,"On September 9, protesters attacked the Israeli embassy headquarters in a residential building in central Cairo, forcing the evacuation of all embassy staff.",48,55,embassy,0,2,2
3UV0D2KX1MKAP6DZL1JWOCSJ76ZF4N,"On September 9, protesters attacked the Israeli embassy headquarters in a residential building in central Cairo, forcing the evacuation of all embassy staff.",48,68,embassy headquarters,1,0,1
3UV0D2KX1MKAP6DZL1JWOCSJ76ZF4N,"On September 9, protesters attacked the Israeli embassy headquarters in a residential building in central Cairo, forcing the evacuation of all embassy staff.",56,68,headquarters,1,2,3
3UV0D2KX1MKAP6DZL1JWOCSJ76ZF4N,"On September 9, protesters attacked the Israeli embassy headquarters in a residential building in central Cairo, forcing the evacuation of all embassy staff.",74,85,residential,1,1,2
3UV0D2KX1MKAP6DZL1JWOCSJ76ZF4N,"On September 9, protesters attacked the Israeli embassy headquarters in a residential building in central Cairo, forcing the evacuation of all embassy staff.",74,94,residential building,0,1,1
3UV0D2KX1MKAP6DZL1JWOCSJ76ZF4N,"On September 9, protesters attacked the Israeli embassy headquarters in a residential building in central Cairo, forcing the evacuation of all embassy staff.",113,120,forcing,1,1,2
3UV0D2KX1MKAP6DZL1JWOCSJ76ZF4N,"On September 9, protesters attacked the Israeli embassy headquarters in a residential building in central Cairo, forcing the evacuation of all embassy staff.",113,135,forcing the evacuation,0,1,1
3UV0D2KX1MKAP6DZL1JWOCSJ76ZF4N,"On September 9, protesters attacked the Israeli embassy headquarters in a residential building in central Cairo, forcing the evacuation of all embassy staff.",125,135,evacuation,8,5,13
3UV0D2KX1MKAP6DZL1JWOCSJ76ZF4N,"On September 9, protesters attacked the Israeli embassy headquarters in a residential building in central Cairo, forcing the evacuation of all embassy staff.",143,150,embassy,1,2,3
3UV0D2KX1MKAP6DZL1JWOCSJ76ZF4N,"On September 9, protesters attacked the Israeli embassy headquarters in a residential building in central Cairo, forcing the evacuation of all embassy staff.",143,156,embassy staff,1,0,1
3UV0D2KX1MKAP6DZL1JWOCSJ76ZF4N,"On September 9, protesters attacked the Israeli embassy headquarters in a residential building in central Cairo, forcing the evacuation of all embassy staff.",151,156,staff,0,2,2
3UV0D2KX1MKAP6DZL1JWOCSJ76ZF4N,"Crowds had smashed through an external security wall, tossed embassy papers from balconies and tore down the Israeli flag.",0,6,Crowds,0,2,2
3UV0D2KX1MKAP6DZL1JWOCSJ76ZF4N,"Crowds had smashed through an external security wall, tossed embassy papers from balconies and tore down the Israeli flag.",11,18,smashed,2,2,4
3UV0D2KX1MKAP6DZL1JWOCSJ76ZF4N,"Crowds had smashed through an external security wall, tossed embassy papers from balconies and tore down the Israeli flag.",11,26,smashed through,0,2,2
3UV0D2KX1MKAP6DZL1JWOCSJ76ZF4N,"Crowds had smashed through an external security wall, tossed embassy papers from balconies and tore down the Israeli flag.",30,38,external,2,1,3
3UV0D2KX1MKAP6DZL1JWOCSJ76ZF4N,"Crowds had smashed through an external security wall, tossed embassy papers from balconies and tore down the Israeli flag.",30,47,external security,1,0,1
3UV0D2KX1MKAP6DZL1JWOCSJ76ZF4N,"Crowds had smashed through an external security wall, tossed embassy papers from balconies and tore down the Israeli flag.",30,52,external security wall,3,0,3
3UV0D2KX1MKAP6DZL1JWOCSJ76ZF4N,"Crowds had smashed through an external security wall, tossed embassy papers from balconies and tore down the Israeli flag.",39,52,security wall,1,0,1
3UV0D2KX1MKAP6DZL1JWOCSJ76ZF4N,"Crowds had smashed through an external security wall, tossed embassy papers from balconies and tore down the Israeli flag.",54,60,tossed,1,8,9
3UV0D2KX1MKAP6DZL1JWOCSJ76ZF4N,"Crowds had smashed through an external security wall, tossed embassy papers from balconies and tore down the Israeli flag.",54,68,tossed embassy,0,1,1
3UV0D2KX1MKAP6DZL1JWOCSJ76ZF4N,"Crowds had smashed through an external security wall, tossed embassy papers from balconies and tore down the Israeli flag.",61,68,embassy,2,0,2
3UV0D2KX1MKAP6DZL1JWOCSJ76ZF4N,"Crowds had smashed through an external security wall, tossed embassy papers from balconies and tore down the Israeli flag.",61,75,embassy papers,1,0,1
3UV0D2KX1MKAP6DZL1JWOCSJ76ZF4N,"Crowds had smashed through an external security wall, tossed embassy papers from balconies and tore down the Israeli flag.",81,90,balconies,3,1,4
3UV0D2KX1MKAP6DZL1JWOCSJ76ZF4N,"Crowds had smashed through an external security wall, tossed embassy papers from balconies and tore down the Israeli flag.",95,99,tore,0,1,1
3UV0D2KX1MKAP6DZL1JWOCSJ76ZF4N,"Crowds had smashed through an external security wall, tossed embassy papers from balconies and tore down the Israeli flag.",95,104,tore down,0,2,2
3UV0D2KX1MKAP6DZL1JWOCSJ76ZF4N,"It was the worst incident since Israel set up its mission in Egypt, the first Arab country to sign a peace treaty with the Jewish state in 1979.",11,16,worst,1,0,1
3UV0D2KX1MKAP6DZL1JWOCSJ76ZF4N,"It was the worst incident since Israel set up its mission in Egypt, the first Arab country to sign a peace treaty with the Jewish state in 1979.",11,25,worst incident,0,2,2
3UV0D2KX1MKAP6DZL1JWOCSJ76ZF4N,"It was the worst incident since Israel set up its mission in Egypt, the first Arab country to sign a peace treaty with the Jewish state in 1979.",17,25,incident,2,2,4
3UV0D2KX1MKAP6DZL1JWOCSJ76ZF4N,"It was the worst incident since Israel set up its mission in Egypt, the first Arab country to sign a peace treaty with the Jewish state in 1979.",50,57,mission,0,1,1
3UV0D2KX1MKAP6DZL1JWOCSJ76ZF4N,"It was the worst incident since Israel set up its mission in Egypt, the first Arab country to sign a peace treaty with the Jewish state in 1979.",101,113,peace treaty,4,4,8
3UV0D2KX1MKAP6DZL1JWOCSJ76ZF4N,"It was the worst incident since Israel set up its mission in Egypt, the first Arab country to sign a peace treaty with the Jewish state in 1979.",107,113,treaty,2,2,4
311HQEI8RSHDDAMIOBBAUGSBADJ7ZN,"More and more people are starting to believe that the election results are not fair, he told Interfax.",38,45,believe,0,1,1
311HQEI8RSHDDAMIOBBAUGSBADJ7ZN,"More and more people are starting to believe that the election results are not fair, he told Interfax.",55,63,election,1,0,1
311HQEI8RSHDDAMIOBBAUGSBADJ7ZN,"More and more people are starting to believe that the election results are not fair, he told Interfax.",80,84,fair,1,0,1
311HQEI8RSHDDAMIOBBAUGSBADJ7ZN,"More and more people are starting to believe that the election results are not fair, he told Interfax.",95,103,Interfax,0,1,1
311HQEI8RSHDDAMIOBBAUGSBADJ7ZN,I believe that ignoring public opinion discredits the authorities and destabilizes the situation.,16,24,ignoring,1,2,3
311HQEI8RSHDDAMIOBBAUGSBADJ7ZN,I believe that ignoring public opinion discredits the authorities and destabilizes the situation.,25,39,public opinion,1,0,1
311HQEI8RSHDDAMIOBBAUGSBADJ7ZN,I believe that ignoring public opinion discredits the authorities and destabilizes the situation.,32,39,opinion,0,1,1
311HQEI8RSHDDAMIOBBAUGSBADJ7ZN,I believe that ignoring public opinion discredits the authorities and destabilizes the situation.,40,50,discredits,10,10,20
311HQEI8RSHDDAMIOBBAUGSBADJ7ZN,I believe that ignoring public opinion discredits the authorities and destabilizes the situation.,55,66,authorities,3,2,5
311HQEI8RSHDDAMIOBBAUGSBADJ7ZN,I believe that ignoring public opinion discredits the authorities and destabilizes the situation.,71,83,destabilizes,10,10,20
311HQEI8RSHDDAMIOBBAUGSBADJ7ZN,I believe that ignoring public opinion discredits the authorities and destabilizes the situation.,71,97,destabilizes the situation,1,0,1
311HQEI8RSHDDAMIOBBAUGSBADJ7ZN,"Gorbachev added that authorities ""must admit that there have been numerous falsifications and ballot stuffing.""",66,74,numerous,0,1,1
311HQEI8RSHDDAMIOBBAUGSBADJ7ZN,"Gorbachev added that authorities ""must admit that there have been numerous falsifications and ballot stuffing.""",66,89,numerous falsifications,3,2,5
311HQEI8RSHDDAMIOBBAUGSBADJ7ZN,"Gorbachev added that authorities ""must admit that there have been numerous falsifications and ballot stuffing.""",66,109,numerous falsifications and ballot stuffing,1,0,1
311HQEI8RSHDDAMIOBBAUGSBADJ7ZN,"Gorbachev added that authorities ""must admit that there have been numerous falsifications and ballot stuffing.""",75,89,falsifications,10,9,19
311HQEI8RSHDDAMIOBBAUGSBADJ7ZN,"Gorbachev added that authorities ""must admit that there have been numerous falsifications and ballot stuffing.""",94,100,ballot,2,1,3
311HQEI8RSHDDAMIOBBAUGSBADJ7ZN,"Gorbachev added that authorities ""must admit that there have been numerous falsifications and ballot stuffing.""",94,109,ballot stuffing,7,8,15
311HQEI8RSHDDAMIOBBAUGSBADJ7ZN,"Gorbachev added that authorities ""must admit that there have been numerous falsifications and ballot stuffing.""",101,109,stuffing,0,4,4
311HQEI8RSHDDAMIOBBAUGSBADJ7ZN,"Sunday's parliamentary vote suggested Russians are tiring of Putin and his United Russia party, which has dominated all other political forces in Russia for the past dozen years and earned a reputation for corruption.",9,22,parliamentary,6,3,9
311HQEI8RSHDDAMIOBBAUGSBADJ7ZN,"Sunday's parliamentary vote suggested Russians are tiring of Putin and his United Russia party, which has dominated all other political forces in Russia for the past dozen years and earned a reputation for corruption.",9,27,parliamentary vote,1,0,1
311HQEI8RSHDDAMIOBBAUGSBADJ7ZN,"Sunday's parliamentary vote suggested Russians are tiring of Putin and his United Russia party, which has dominated all other political forces in Russia for the past dozen years and earned a reputation for corruption.",51,57,tiring,1,1,2
311HQEI8RSHDDAMIOBBAUGSBADJ7ZN,"Sunday's parliamentary vote suggested Russians are tiring of Putin and his United Russia party, which has dominated all other political forces in Russia for the past dozen years and earned a reputation for corruption.",106,115,dominated,8,5,13
311HQEI8RSHDDAMIOBBAUGSBADJ7ZN,"Sunday's parliamentary vote suggested Russians are tiring of Putin and his United Russia party, which has dominated all other political forces in Russia for the past dozen years and earned a reputation for corruption.",126,142,political forces,1,0,1
311HQEI8RSHDDAMIOBBAUGSBADJ7ZN,"Sunday's parliamentary vote suggested Russians are tiring of Putin and his United Russia party, which has dominated all other political forces in Russia for the past dozen years and earned a reputation for corruption.",191,201,reputation,6,4,10
311HQEI8RSHDDAMIOBBAUGSBADJ7ZN,"Sunday's parliamentary vote suggested Russians are tiring of Putin and his United Russia party, which has dominated all other political forces in Russia for the past dozen years and earned a reputation for corruption.",191,216,reputation for corruption,1,1,2
311HQEI8RSHDDAMIOBBAUGSBADJ7ZN,"Sunday's parliamentary vote suggested Russians are tiring of Putin and his United Russia party, which has dominated all other political forces in Russia for the past dozen years and earned a reputation for corruption.",206,216,corruption,9,4,13
311HQEI8RSHDDAMIOBBAUGSBADJ7ZN,"Putin, meanwhile, officially registered Wednesday to run for the presidency in March, but the unusually sustained protests of the past two days suggested his drive to retake the job he held from 2000-2008 may not go as smoothly as he had expected.",18,39,officially registered,1,0,1
311HQEI8RSHDDAMIOBBAUGSBADJ7ZN,"Putin, meanwhile, officially registered Wednesday to run for the presidency in March, but the unusually sustained protests of the past two days suggested his drive to retake the job he held from 2000-2008 may not go as smoothly as he had expected.",65,75,presidency,2,1,3
311HQEI8RSHDDAMIOBBAUGSBADJ7ZN,"Putin, meanwhile, officially registered Wednesday to run for the presidency in March, but the unusually sustained protests of the past two days suggested his drive to retake the job he held from 2000-2008 may not go as smoothly as he had expected.",94,103,unusually,1,1,2
311HQEI8RSHDDAMIOBBAUGSBADJ7ZN,"Putin, meanwhile, officially registered Wednesday to run for the presidency in March, but the unusually sustained protests of the past two days suggested his drive to retake the job he held from 2000-2008 may not go as smoothly as he had expected.",94,122,unusually sustained protests,2,0,2
311HQEI8RSHDDAMIOBBAUGSBADJ7ZN,"Putin, meanwhile, officially registered Wednesday to run for the presidency in March, but the unusually sustained protests of the past two days suggested his drive to retake the job he held from 2000-2008 may not go as smoothly as he had expected.",104,113,sustained,7,6,13
311HQEI8RSHDDAMIOBBAUGSBADJ7ZN,"Putin, meanwhile, officially registered Wednesday to run for the presidency in March, but the unusually sustained protests of the past two days suggested his drive to retake the job he held from 2000-2008 may not go as smoothly as he had expected.",104,122,sustained protests,1,0,1
311HQEI8RSHDDAMIOBBAUGSBADJ7ZN,"Putin, meanwhile, officially registered Wednesday to run for the presidency in March, but the unusually sustained protests of the past two days suggested his drive to retake the job he held from 2000-2008 may not go as smoothly as he had expected.",144,153,suggested,1,0,1
311HQEI8RSHDDAMIOBBAUGSBADJ7ZN,"Putin, meanwhile, officially registered Wednesday to run for the presidency in March, but the unusually sustained protests of the past two days suggested his drive to retake the job he held from 2000-2008 may not go as smoothly as he had expected.",154,163,his drive,1,0,1
311HQEI8RSHDDAMIOBBAUGSBADJ7ZN,"Putin, meanwhile, officially registered Wednesday to run for the presidency in March, but the unusually sustained protests of the past two days suggested his drive to retake the job he held from 2000-2008 may not go as smoothly as he had expected.",167,173,retake,0,1,1
311HQEI8RSHDDAMIOBBAUGSBADJ7ZN,"Putin, meanwhile, officially registered Wednesday to run for the presidency in March, but the unusually sustained protests of the past two days suggested his drive to retake the job he held from 2000-2008 may not go as smoothly as he had expected.",219,227,smoothly,0,2,2
3UEDKCTP9VRIOFNWOA80714Y646K7E,"But pro-Kremlin supporters also staged two large protests in Moscow that attracted thousands, highlighting political divisions in Russian society.",4,15,pro-Kremlin,5,0,5
3UEDKCTP9VRIOFNWOA80714Y646K7E,"But pro-Kremlin supporters also staged two large protests in Moscow that attracted thousands, highlighting political divisions in Russian society.",4,26,pro-Kremlin supporters,2,0,2
3UEDKCTP9VRIOFNWOA80714Y646K7E,"But pro-Kremlin supporters also staged two large protests in Moscow that attracted thousands, highlighting political divisions in Russian society.",16,26,supporters,2,1,3
3UEDKCTP9VRIOFNWOA80714Y646K7E,"But pro-Kremlin supporters also staged two large protests in Moscow that attracted thousands, highlighting political divisions in Russian society.",32,38,staged,2,5,7
3UEDKCTP9VRIOFNWOA80714Y646K7E,"But pro-Kremlin supporters also staged two large protests in Moscow that attracted thousands, highlighting political divisions in Russian society.",73,82,attracted,0,1,1
3UEDKCTP9VRIOFNWOA80714Y646K7E,"But pro-Kremlin supporters also staged two large protests in Moscow that attracted thousands, highlighting political divisions in Russian society.",94,106,highlighting,6,3,9
3UEDKCTP9VRIOFNWOA80714Y646K7E,"But pro-Kremlin supporters also staged two large protests in Moscow that attracted thousands, highlighting political divisions in Russian society.",94,116,highlighting political,1,0,1
3UEDKCTP9VRIOFNWOA80714Y646K7E,"But pro-Kremlin supporters also staged two large protests in Moscow that attracted thousands, highlighting political divisions in Russian society.",94,126,highlighting political divisions,1,0,1
3UEDKCTP9VRIOFNWOA80714Y646K7E,"But pro-Kremlin supporters also staged two large protests in Moscow that attracted thousands, highlighting political divisions in Russian society.",107,126,political divisions,3,1,4
3UEDKCTP9VRIOFNWOA80714Y646K7E,"But pro-Kremlin supporters also staged two large protests in Moscow that attracted thousands, highlighting political divisions in Russian society.",117,126,divisions,2,0,2
3UEDKCTP9VRIOFNWOA80714Y646K7E,"Although Sunday's election results signal Putin's return to the presidency in next March's poll may not be as easy as he expected, he has downplayed the reduced majority.",35,41,signal,1,0,1
3UEDKCTP9VRIOFNWOA80714Y646K7E,"Although Sunday's election results signal Putin's return to the presidency in next March's poll may not be as easy as he expected, he has downplayed the reduced majority.",64,74,presidency,0,1,1
3UEDKCTP9VRIOFNWOA80714Y646K7E,"Although Sunday's election results signal Putin's return to the presidency in next March's poll may not be as easy as he expected, he has downplayed the reduced majority.",121,129,expected,1,2,3
3UEDKCTP9VRIOFNWOA80714Y646K7E,"Although Sunday's election results signal Putin's return to the presidency in next March's poll may not be as easy as he expected, he has downplayed the reduced majority.",138,148,downplayed,9,10,19
3UEDKCTP9VRIOFNWOA80714Y646K7E,"Although Sunday's election results signal Putin's return to the presidency in next March's poll may not be as easy as he expected, he has downplayed the reduced majority.",138,169,downplayed the reduced majority,2,0,2
3UEDKCTP9VRIOFNWOA80714Y646K7E,"Although Sunday's election results signal Putin's return to the presidency in next March's poll may not be as easy as he expected, he has downplayed the reduced majority.",153,169,reduced majority,1,0,1
3UEDKCTP9VRIOFNWOA80714Y646K7E,"Although Sunday's election results signal Putin's return to the presidency in next March's poll may not be as easy as he expected, he has downplayed the reduced majority.",161,169,majority,0,1,1
3UEDKCTP9VRIOFNWOA80714Y646K7E,"He said it was ""inevitable"" because voters always are unhappy with the party in power.",16,26,inevitable,10,9,19
3UEDKCTP9VRIOFNWOA80714Y646K7E,He also dismissed allegations of corruption among his United Russia party members.,8,17,dismissed,5,3,8
3UEDKCTP9VRIOFNWOA80714Y646K7E,He also dismissed allegations of corruption among his United Russia party members.,8,29,dismissed allegations,4,1,5
3UEDKCTP9VRIOFNWOA80714Y646K7E,He also dismissed allegations of corruption among his United Russia party members.,8,43,dismissed allegations of corruption,1,0,1
3UEDKCTP9VRIOFNWOA80714Y646K7E,He also dismissed allegations of corruption among his United Russia party members.,18,29,allegations,9,10,19
3UEDKCTP9VRIOFNWOA80714Y646K7E,He also dismissed allegations of corruption among his United Russia party members.,33,43,corruption,10,4,14
3UEDKCTP9VRIOFNWOA80714Y646K7E,He also dismissed allegations of corruption among his United Russia party members.,54,73,United Russia party,1,0,1
3UEDKCTP9VRIOFNWOA80714Y646K7E,He also dismissed allegations of corruption among his United Russia party members.,54,81,United Russia party members,1,0,1
3UEDKCTP9VRIOFNWOA80714Y646K7E,"It is understood the dead girl had been living at her family home, in a neighbouring housing estate, and was visiting her older sister at the time of the shooting.",72,84,neighbouring,1,0,1
3UEDKCTP9VRIOFNWOA80714Y646K7E,"It is understood the dead girl had been living at her family home, in a neighbouring housing estate, and was visiting her older sister at the time of the shooting.",72,99,neighbouring housing estate,2,1,3
3UEDKCTP9VRIOFNWOA80714Y646K7E,"It is understood the dead girl had been living at her family home, in a neighbouring housing estate, and was visiting her older sister at the time of the shooting.",85,99,housing estate,2,2,4
3UEDKCTP9VRIOFNWOA80714Y646K7E,"It is understood the dead girl had been living at her family home, in a neighbouring housing estate, and was visiting her older sister at the time of the shooting.",93,99,estate,1,0,1
3UEDKCTP9VRIOFNWOA80714Y646K7E,"Locals reported seeing and speaking with her in the village during the morning, before police were called to the scene at around 10.40am.",7,15,reported,0,1,1
3I7KR83SNAEM2YBP376KLXV41UU9KF,He said authorities have not yet determined the owner of then gun but they are pretty certain Thomas was the killer.,8,19,authorities,5,0,5
3I7KR83SNAEM2YBP376KLXV41UU9KF,He said authorities have not yet determined the owner of then gun but they are pretty certain Thomas was the killer.,33,43,determined,7,4,11
3I7KR83SNAEM2YBP376KLXV41UU9KF,He said authorities have not yet determined the owner of then gun but they are pretty certain Thomas was the killer.,79,85,pretty,0,1,1
3I7KR83SNAEM2YBP376KLXV41UU9KF,He said authorities have not yet determined the owner of then gun but they are pretty certain Thomas was the killer.,79,93,pretty certain,0,1,1
3I7KR83SNAEM2YBP376KLXV41UU9KF,The Philippines has summoned China's ambassador in Manila after two Chinese ships blocked a Philippine Navy vessel from arresting Chinese fishermen in the South China Sea.,20,28,summoned,10,10,20
3I7KR83SNAEM2YBP376KLXV41UU9KF,The Philippines has summoned China's ambassador in Manila after two Chinese ships blocked a Philippine Navy vessel from arresting Chinese fishermen in the South China Sea.,37,47,ambassador,4,0,4
3I7KR83SNAEM2YBP376KLXV41UU9KF,The Philippines has summoned China's ambassador in Manila after two Chinese ships blocked a Philippine Navy vessel from arresting Chinese fishermen in the South China Sea.,82,89,blocked,0,2,2
3I7KR83SNAEM2YBP376KLXV41UU9KF,The Philippines has summoned China's ambassador in Manila after two Chinese ships blocked a Philippine Navy vessel from arresting Chinese fishermen in the South China Sea.,92,102,Philippine,1,0,1
3I7KR83SNAEM2YBP376KLXV41UU9KF,The Philippines has summoned China's ambassador in Manila after two Chinese ships blocked a Philippine Navy vessel from arresting Chinese fishermen in the South China Sea.,103,114,Navy vessel,0,1,1
3I7KR83SNAEM2YBP376KLXV41UU9KF,The Philippines has summoned China's ambassador in Manila after two Chinese ships blocked a Philippine Navy vessel from arresting Chinese fishermen in the South China Sea.,108,114,vessel,6,3,9
3I7KR83SNAEM2YBP376KLXV41UU9KF,The Philippines has summoned China's ambassador in Manila after two Chinese ships blocked a Philippine Navy vessel from arresting Chinese fishermen in the South China Sea.,120,129,arresting,2,1,3
3I7KR83SNAEM2YBP376KLXV41UU9KF,"Eight Chinese fishing vessels were anchored off Scarborough Shoal, the Philippine government said on Wednesday, as Albert del Rosario, the country's foreign affairs secretary, called in Ma Keqing, the ambassador, for talks.",14,29,fishing vessels,1,0,1
3I7KR83SNAEM2YBP376KLXV41UU9KF,"Eight Chinese fishing vessels were anchored off Scarborough Shoal, the Philippine government said on Wednesday, as Albert del Rosario, the country's foreign affairs secretary, called in Ma Keqing, the ambassador, for talks.",22,29,vessels,0,2,2
3I7KR83SNAEM2YBP376KLXV41UU9KF,"Eight Chinese fishing vessels were anchored off Scarborough Shoal, the Philippine government said on Wednesday, as Albert del Rosario, the country's foreign affairs secretary, called in Ma Keqing, the ambassador, for talks.",35,43,anchored,7,7,14
3I7KR83SNAEM2YBP376KLXV41UU9KF,"Eight Chinese fishing vessels were anchored off Scarborough Shoal, the Philippine government said on Wednesday, as Albert del Rosario, the country's foreign affairs secretary, called in Ma Keqing, the ambassador, for talks.",35,47,anchored off,0,3,3
3I7KR83SNAEM2YBP376KLXV41UU9KF,"Eight Chinese fishing vessels were anchored off Scarborough Shoal, the Philippine government said on Wednesday, as Albert del Rosario, the country's foreign affairs secretary, called in Ma Keqing, the ambassador, for talks.",48,59,Scarborough,1,0,1
3I7KR83SNAEM2YBP376KLXV41UU9KF,"Eight Chinese fishing vessels were anchored off Scarborough Shoal, the Philippine government said on Wednesday, as Albert del Rosario, the country's foreign affairs secretary, called in Ma Keqing, the ambassador, for talks.",48,65,Scarborough Shoal,1,0,1
3I7KR83SNAEM2YBP376KLXV41UU9KF,"Eight Chinese fishing vessels were anchored off Scarborough Shoal, the Philippine government said on Wednesday, as Albert del Rosario, the country's foreign affairs secretary, called in Ma Keqing, the ambassador, for talks.",60,65,Shoal,0,1,1
3I7KR83SNAEM2YBP376KLXV41UU9KF,"Eight Chinese fishing vessels were anchored off Scarborough Shoal, the Philippine government said on Wednesday, as Albert del Rosario, the country's foreign affairs secretary, called in Ma Keqing, the ambassador, for talks.",71,81,Philippine,1,0,1
3I7KR83SNAEM2YBP376KLXV41UU9KF,"Eight Chinese fishing vessels were anchored off Scarborough Shoal, the Philippine government said on Wednesday, as Albert del Rosario, the country's foreign affairs secretary, called in Ma Keqing, the ambassador, for talks.",126,133,Rosario,1,0,1
3I7KR83SNAEM2YBP376KLXV41UU9KF,"Eight Chinese fishing vessels were anchored off Scarborough Shoal, the Philippine government said on Wednesday, as Albert del Rosario, the country's foreign affairs secretary, called in Ma Keqing, the ambassador, for talks.",149,156,foreign,1,0,1
3I7KR83SNAEM2YBP376KLXV41UU9KF,"Eight Chinese fishing vessels were anchored off Scarborough Shoal, the Philippine government said on Wednesday, as Albert del Rosario, the country's foreign affairs secretary, called in Ma Keqing, the ambassador, for talks.",149,174,foreign affairs secretary,2,0,2
3I7KR83SNAEM2YBP376KLXV41UU9KF,"Eight Chinese fishing vessels were anchored off Scarborough Shoal, the Philippine government said on Wednesday, as Albert del Rosario, the country's foreign affairs secretary, called in Ma Keqing, the ambassador, for talks.",201,211,ambassador,3,1,4
3I7KR83SNAEM2YBP376KLXV41UU9KF,"Manila and Beijing contest sovereignty over the small group of islands and reefs, which lie about 124 nautical miles from the western coast of the Philippines' main island of Luzon.",19,26,contest,2,2,4
3I7KR83SNAEM2YBP376KLXV41UU9KF,"Manila and Beijing contest sovereignty over the small group of islands and reefs, which lie about 124 nautical miles from the western coast of the Philippines' main island of Luzon.",19,38,contest sovereignty,3,1,4
3I7KR83SNAEM2YBP376KLXV41UU9KF,"Manila and Beijing contest sovereignty over the small group of islands and reefs, which lie about 124 nautical miles from the western coast of the Philippines' main island of Luzon.",27,38,sovereignty,9,10,19
3I7KR83SNAEM2YBP376KLXV41UU9KF,"Manila and Beijing contest sovereignty over the small group of islands and reefs, which lie about 124 nautical miles from the western coast of the Philippines' main island of Luzon.",75,80,reefs,3,3,6
3I7KR83SNAEM2YBP376KLXV41UU9KF,"Manila and Beijing contest sovereignty over the small group of islands and reefs, which lie about 124 nautical miles from the western coast of the Philippines' main island of Luzon.",102,110,nautical,6,1,7
3I7KR83SNAEM2YBP376KLXV41UU9KF,"Manila and Beijing contest sovereignty over the small group of islands and reefs, which lie about 124 nautical miles from the western coast of the Philippines' main island of Luzon.",102,116,nautical miles,2,3,5
3I7KR83SNAEM2YBP376KLXV41UU9KF,"The foreign affairs department statement said the Philippines' flagship warship, the Gregorio Del Pilar, found the eight vessels there on Sunday while patrolling the area.",4,30,foreign affairs department,2,1,3
3I7KR83SNAEM2YBP376KLXV41UU9KF,"The foreign affairs department statement said the Philippines' flagship warship, the Gregorio Del Pilar, found the eight vessels there on Sunday while patrolling the area.",20,30,department,1,1,2
3I7KR83SNAEM2YBP376KLXV41UU9KF,"The foreign affairs department statement said the Philippines' flagship warship, the Gregorio Del Pilar, found the eight vessels there on Sunday while patrolling the area.",31,40,statement,0,1,1
3I7KR83SNAEM2YBP376KLXV41UU9KF,"The foreign affairs department statement said the Philippines' flagship warship, the Gregorio Del Pilar, found the eight vessels there on Sunday while patrolling the area.",50,61,Philippines,1,0,1
3I7KR83SNAEM2YBP376KLXV41UU9KF,"The foreign affairs department statement said the Philippines' flagship warship, the Gregorio Del Pilar, found the eight vessels there on Sunday while patrolling the area.",63,71,flagship,4,3,7
3I7KR83SNAEM2YBP376KLXV41UU9KF,"The foreign affairs department statement said the Philippines' flagship warship, the Gregorio Del Pilar, found the eight vessels there on Sunday while patrolling the area.",63,79,flagship warship,3,1,4
3I7KR83SNAEM2YBP376KLXV41UU9KF,"The foreign affairs department statement said the Philippines' flagship warship, the Gregorio Del Pilar, found the eight vessels there on Sunday while patrolling the area.",72,79,warship,1,0,1
3I7KR83SNAEM2YBP376KLXV41UU9KF,"The foreign affairs department statement said the Philippines' flagship warship, the Gregorio Del Pilar, found the eight vessels there on Sunday while patrolling the area.",121,128,vessels,4,2,6
3I7KR83SNAEM2YBP376KLXV41UU9KF,"The foreign affairs department statement said the Philippines' flagship warship, the Gregorio Del Pilar, found the eight vessels there on Sunday while patrolling the area.",151,161,patrolling,6,6,12
3MJ28H2Y1E9MR2USY9LWGY7BZ3L5O4,"A 21-year-old man was arrested on April 30, on suspicion of murder and was released on bail until May 29 pending further enquiries.",47,56,suspicion,5,5,10
3MJ28H2Y1E9MR2USY9LWGY7BZ3L5O4,"A 21-year-old man was arrested on April 30, on suspicion of murder and was released on bail until May 29 pending further enquiries.",47,66,suspicion of murder,2,2,4
3MJ28H2Y1E9MR2USY9LWGY7BZ3L5O4,"A 21-year-old man was arrested on April 30, on suspicion of murder and was released on bail until May 29 pending further enquiries.",87,91,bail,4,3,7
3MJ28H2Y1E9MR2USY9LWGY7BZ3L5O4,"A 21-year-old man was arrested on April 30, on suspicion of murder and was released on bail until May 29 pending further enquiries.",105,112,pending,2,3,5
3MJ28H2Y1E9MR2USY9LWGY7BZ3L5O4,"A 21-year-old man was arrested on April 30, on suspicion of murder and was released on bail until May 29 pending further enquiries.",105,130,pending further enquiries,2,1,3
3MJ28H2Y1E9MR2USY9LWGY7BZ3L5O4,"A 21-year-old man was arrested on April 30, on suspicion of murder and was released on bail until May 29 pending further enquiries.",121,130,enquiries,7,6,13
3MJ28H2Y1E9MR2USY9LWGY7BZ3L5O4,"Google Inc. (GOOG) won approval from Chinese regulators for its $12.5 billion purchase of Motorola Mobility Holdings Inc. (MMI), clearing a final hurdle for a deal that boosts its patents portfolio and steps up competition with Apple Inc. (AAPL) “We are pleased the deal has received approval in all jurisdictions,” Motorola Mobility said in an e-mailed statement, confirming that the deal has been approved in China.",23,31,approval,0,3,3
3MJ28H2Y1E9MR2USY9LWGY7BZ3L5O4,"Google Inc. (GOOG) won approval from Chinese regulators for its $12.5 billion purchase of Motorola Mobility Holdings Inc. (MMI), clearing a final hurdle for a deal that boosts its patents portfolio and steps up competition with Apple Inc. (AAPL) “We are pleased the deal has received approval in all jurisdictions,” Motorola Mobility said in an e-mailed statement, confirming that the deal has been approved in China.",45,55,regulators,6,2,8
3MJ28H2Y1E9MR2USY9LWGY7BZ3L5O4,"Google Inc. (GOOG) won approval from Chinese regulators for its $12.5 billion purchase of Motorola Mobility Holdings Inc. (MMI), clearing a final hurdle for a deal that boosts its patents portfolio and steps up competition with Apple Inc. (AAPL) “We are pleased the deal has received approval in all jurisdictions,” Motorola Mobility said in an e-mailed statement, confirming that the deal has been approved in China.",129,152,clearing a final hurdle,1,0,1
3MJ28H2Y1E9MR2USY9LWGY7BZ3L5O4,"Google Inc. (GOOG) won approval from Chinese regulators for its $12.5 billion purchase of Motorola Mobility Holdings Inc. (MMI), clearing a final hurdle for a deal that boosts its patents portfolio and steps up competition with Apple Inc. (AAPL) “We are pleased the deal has received approval in all jurisdictions,” Motorola Mobility said in an e-mailed statement, confirming that the deal has been approved in China.",140,152,final hurdle,0,2,2
3MJ28H2Y1E9MR2USY9LWGY7BZ3L5O4,"Google Inc. (GOOG) won approval from Chinese regulators for its $12.5 billion purchase of Motorola Mobility Holdings Inc. (MMI), clearing a final hurdle for a deal that boosts its patents portfolio and steps up competition with Apple Inc. (AAPL) “We are pleased the deal has received approval in all jurisdictions,” Motorola Mobility said in an e-mailed statement, confirming that the deal has been approved in China.",146,152,hurdle,7,6,13
3MJ28H2Y1E9MR2USY9LWGY7BZ3L5O4,"Google Inc. (GOOG) won approval from Chinese regulators for its $12.5 billion purchase of Motorola Mobility Holdings Inc. (MMI), clearing a final hurdle for a deal that boosts its patents portfolio and steps up competition with Apple Inc. (AAPL) “We are pleased the deal has received approval in all jurisdictions,” Motorola Mobility said in an e-mailed statement, confirming that the deal has been approved in China.",169,175,boosts,1,2,3
3MJ28H2Y1E9MR2USY9LWGY7BZ3L5O4,"Google Inc. (GOOG) won approval from Chinese regulators for its $12.5 billion purchase of Motorola Mobility Holdings Inc. (MMI), clearing a final hurdle for a deal that boosts its patents portfolio and steps up competition with Apple Inc. (AAPL) “We are pleased the deal has received approval in all jurisdictions,” Motorola Mobility said in an e-mailed statement, confirming that the deal has been approved in China.",180,187,patents,3,0,3
3MJ28H2Y1E9MR2USY9LWGY7BZ3L5O4,"Google Inc. (GOOG) won approval from Chinese regulators for its $12.5 billion purchase of Motorola Mobility Holdings Inc. (MMI), clearing a final hurdle for a deal that boosts its patents portfolio and steps up competition with Apple Inc. (AAPL) “We are pleased the deal has received approval in all jurisdictions,” Motorola Mobility said in an e-mailed statement, confirming that the deal has been approved in China.",180,197,patents portfolio,7,2,9
3MJ28H2Y1E9MR2USY9LWGY7BZ3L5O4,"Google Inc. (GOOG) won approval from Chinese regulators for its $12.5 billion purchase of Motorola Mobility Holdings Inc. (MMI), clearing a final hurdle for a deal that boosts its patents portfolio and steps up competition with Apple Inc. (AAPL) “We are pleased the deal has received approval in all jurisdictions,” Motorola Mobility said in an e-mailed statement, confirming that the deal has been approved in China.",188,197,portfolio,5,6,11
3MJ28H2Y1E9MR2USY9LWGY7BZ3L5O4,"Google Inc. (GOOG) won approval from Chinese regulators for its $12.5 billion purchase of Motorola Mobility Holdings Inc. (MMI), clearing a final hurdle for a deal that boosts its patents portfolio and steps up competition with Apple Inc. (AAPL) “We are pleased the deal has received approval in all jurisdictions,” Motorola Mobility said in an e-mailed statement, confirming that the deal has been approved in China.",211,222,competition,4,1,5
3MJ28H2Y1E9MR2USY9LWGY7BZ3L5O4,"Google Inc. (GOOG) won approval from Chinese regulators for its $12.5 billion purchase of Motorola Mobility Holdings Inc. (MMI), clearing a final hurdle for a deal that boosts its patents portfolio and steps up competition with Apple Inc. (AAPL) “We are pleased the deal has received approval in all jurisdictions,” Motorola Mobility said in an e-mailed statement, confirming that the deal has been approved in China.",284,292,approval,1,0,1
3MJ28H2Y1E9MR2USY9LWGY7BZ3L5O4,"Google Inc. (GOOG) won approval from Chinese regulators for its $12.5 billion purchase of Motorola Mobility Holdings Inc. (MMI), clearing a final hurdle for a deal that boosts its patents portfolio and steps up competition with Apple Inc. (AAPL) “We are pleased the deal has received approval in all jurisdictions,” Motorola Mobility said in an e-mailed statement, confirming that the deal has been approved in China.",300,313,jurisdictions,10,9,19
3MJ28H2Y1E9MR2USY9LWGY7BZ3L5O4,"Google Inc. (GOOG) won approval from Chinese regulators for its $12.5 billion purchase of Motorola Mobility Holdings Inc. (MMI), clearing a final hurdle for a deal that boosts its patents portfolio and steps up competition with Apple Inc. (AAPL) “We are pleased the deal has received approval in all jurisdictions,” Motorola Mobility said in an e-mailed statement, confirming that the deal has been approved in China.",300,315,"jurisdictions,”",1,0,1
3MJ28H2Y1E9MR2USY9LWGY7BZ3L5O4,"Google Inc. (GOOG) won approval from Chinese regulators for its $12.5 billion purchase of Motorola Mobility Holdings Inc. (MMI), clearing a final hurdle for a deal that boosts its patents portfolio and steps up competition with Apple Inc. (AAPL) “We are pleased the deal has received approval in all jurisdictions,” Motorola Mobility said in an e-mailed statement, confirming that the deal has been approved in China.",365,375,confirming,0,2,2
3MJ28H2Y1E9MR2USY9LWGY7BZ3L5O4,“We expect to close imminently.”,14,30,close imminently,1,0,1
3MJ28H2Y1E9MR2USY9LWGY7BZ3L5O4,“We expect to close imminently.”,20,30,imminently,10,10,20
3MJ28H2Y1E9MR2USY9LWGY7BZ3L5O4,"The acquisition, announced last year, has already received approvals in Europe, the U.S. and other jurisdictions worldwide.",4,15,acquisition,10,8,18
3MJ28H2Y1E9MR2USY9LWGY7BZ3L5O4,"The acquisition, announced last year, has already received approvals in Europe, the U.S. and other jurisdictions worldwide.",17,26,announced,1,0,1
3MJ28H2Y1E9MR2USY9LWGY7BZ3L5O4,"The acquisition, announced last year, has already received approvals in Europe, the U.S. and other jurisdictions worldwide.",59,68,approvals,1,0,1
3MJ28H2Y1E9MR2USY9LWGY7BZ3L5O4,"The acquisition, announced last year, has already received approvals in Europe, the U.S. and other jurisdictions worldwide.",99,112,jurisdictions,6,3,9
3MJ28H2Y1E9MR2USY9LWGY7BZ3L5O4,Motorola Mobility had said in a regulatory filing in February that it needed approval in China.,32,42,regulatory,3,1,4
3MJ28H2Y1E9MR2USY9LWGY7BZ3L5O4,Motorola Mobility had said in a regulatory filing in February that it needed approval in China.,32,49,regulatory filing,6,1,7
3MJ28H2Y1E9MR2USY9LWGY7BZ3L5O4,Motorola Mobility had said in a regulatory filing in February that it needed approval in China.,43,49,filing,0,2,2
3MJ28H2Y1E9MR2USY9LWGY7BZ3L5O4,"Google, facing legal disputes over its Android smartphone software, will be able to draw on more than 17,000 patents from Libertyville, Illinois-based Motorola Mobility.",15,29,legal disputes,3,4,7
3MJ28H2Y1E9MR2USY9LWGY7BZ3L5O4,"Google, facing legal disputes over its Android smartphone software, will be able to draw on more than 17,000 patents from Libertyville, Illinois-based Motorola Mobility.",21,29,disputes,0,3,3
3MJ28H2Y1E9MR2USY9LWGY7BZ3L5O4,"Google, facing legal disputes over its Android smartphone software, will be able to draw on more than 17,000 patents from Libertyville, Illinois-based Motorola Mobility.",47,57,smartphone,1,0,1
3MJ28H2Y1E9MR2USY9LWGY7BZ3L5O4,"Google, facing legal disputes over its Android smartphone software, will be able to draw on more than 17,000 patents from Libertyville, Illinois-based Motorola Mobility.",47,67,smartphone  software,1,0,1
3MJ28H2Y1E9MR2USY9LWGY7BZ3L5O4,"Google, facing legal disputes over its Android smartphone software, will be able to draw on more than 17,000 patents from Libertyville, Illinois-based Motorola Mobility.",58,66,software,0,2,2
3MJ28H2Y1E9MR2USY9LWGY7BZ3L5O4,"Google, facing legal disputes over its Android smartphone software, will be able to draw on more than 17,000 patents from Libertyville, Illinois-based Motorola Mobility.",109,116,patents,4,0,4
3MJ28H2Y1E9MR2USY9LWGY7BZ3L5O4,"Google, facing legal disputes over its Android smartphone software, will be able to draw on more than 17,000 patents from Libertyville, Illinois-based Motorola Mobility.",122,134,Libertyville,0,1,1
3IHWR4LC7DEVIY2RYCFU8LLGPKN8IE,"The Israeli official said the new ambassador to Cairo, Yaakov Amitai, was expected to travel to the Egyptian capital in December to present his credentials, but the embassy would not be staffed or resume normal activity until acceptable security arrangements were in place.",34,44,ambassador,4,1,5
3IHWR4LC7DEVIY2RYCFU8LLGPKN8IE,"The Israeli official said the new ambassador to Cairo, Yaakov Amitai, was expected to travel to the Egyptian capital in December to present his credentials, but the embassy would not be staffed or resume normal activity until acceptable security arrangements were in place.",74,82,expected,0,1,1
3IHWR4LC7DEVIY2RYCFU8LLGPKN8IE,"The Israeli official said the new ambassador to Cairo, Yaakov Amitai, was expected to travel to the Egyptian capital in December to present his credentials, but the embassy would not be staffed or resume normal activity until acceptable security arrangements were in place.",74,92,expected to travel,0,1,1
3IHWR4LC7DEVIY2RYCFU8LLGPKN8IE,"The Israeli official said the new ambassador to Cairo, Yaakov Amitai, was expected to travel to the Egyptian capital in December to present his credentials, but the embassy would not be staffed or resume normal activity until acceptable security arrangements were in place.",132,155,present his credentials,1,0,1
3IHWR4LC7DEVIY2RYCFU8LLGPKN8IE,"The Israeli official said the new ambassador to Cairo, Yaakov Amitai, was expected to travel to the Egyptian capital in December to present his credentials, but the embassy would not be staffed or resume normal activity until acceptable security arrangements were in place.",144,155,credentials,10,9,19
3IHWR4LC7DEVIY2RYCFU8LLGPKN8IE,"The Israeli official said the new ambassador to Cairo, Yaakov Amitai, was expected to travel to the Egyptian capital in December to present his credentials, but the embassy would not be staffed or resume normal activity until acceptable security arrangements were in place.",165,172,embassy,3,2,5
3IHWR4LC7DEVIY2RYCFU8LLGPKN8IE,"The Israeli official said the new ambassador to Cairo, Yaakov Amitai, was expected to travel to the Egyptian capital in December to present his credentials, but the embassy would not be staffed or resume normal activity until acceptable security arrangements were in place.",186,193,staffed,6,10,16
3IHWR4LC7DEVIY2RYCFU8LLGPKN8IE,"The Israeli official said the new ambassador to Cairo, Yaakov Amitai, was expected to travel to the Egyptian capital in December to present his credentials, but the embassy would not be staffed or resume normal activity until acceptable security arrangements were in place.",197,203,resume,0,2,2
3IHWR4LC7DEVIY2RYCFU8LLGPKN8IE,"The Israeli official said the new ambassador to Cairo, Yaakov Amitai, was expected to travel to the Egyptian capital in December to present his credentials, but the embassy would not be staffed or resume normal activity until acceptable security arrangements were in place.",197,219,resume normal activity,2,0,2
3IHWR4LC7DEVIY2RYCFU8LLGPKN8IE,"The Israeli official said the new ambassador to Cairo, Yaakov Amitai, was expected to travel to the Egyptian capital in December to present his credentials, but the embassy would not be staffed or resume normal activity until acceptable security arrangements were in place.",226,236,acceptable,0,1,1
3IHWR4LC7DEVIY2RYCFU8LLGPKN8IE,"The Israeli official said the new ambassador to Cairo, Yaakov Amitai, was expected to travel to the Egyptian capital in December to present his credentials, but the embassy would not be staffed or resume normal activity until acceptable security arrangements were in place.",237,245,security,1,0,1
3IHWR4LC7DEVIY2RYCFU8LLGPKN8IE,"The Israeli official said the new ambassador to Cairo, Yaakov Amitai, was expected to travel to the Egyptian capital in December to present his credentials, but the embassy would not be staffed or resume normal activity until acceptable security arrangements were in place.",237,258,security arrangements,3,2,5
3IHWR4LC7DEVIY2RYCFU8LLGPKN8IE,"The Israeli official said the new ambassador to Cairo, Yaakov Amitai, was expected to travel to the Egyptian capital in December to present his credentials, but the embassy would not be staffed or resume normal activity until acceptable security arrangements were in place.",246,258,arrangements,1,4,5
3IHWR4LC7DEVIY2RYCFU8LLGPKN8IE,"Many Egyptians view Israel, which signed a peace treaty with Egypt in 1979 after four wars between the two countries, with hostility.",43,55,peace treaty,2,4,6
3IHWR4LC7DEVIY2RYCFU8LLGPKN8IE,"Many Egyptians view Israel, which signed a peace treaty with Egypt in 1979 after four wars between the two countries, with hostility.",49,55,treaty,0,1,1
3IHWR4LC7DEVIY2RYCFU8LLGPKN8IE,"Many Egyptians view Israel, which signed a peace treaty with Egypt in 1979 after four wars between the two countries, with hostility.",123,132,hostility,10,9,19
3IHWR4LC7DEVIY2RYCFU8LLGPKN8IE,"Anti-Israeli sentiment, muted before President Hosni Mubarak was overthrown in February, has become more vocal.",0,22,Anti-Israeli sentiment,1,0,1
3IHWR4LC7DEVIY2RYCFU8LLGPKN8IE,"Anti-Israeli sentiment, muted before President Hosni Mubarak was overthrown in February, has become more vocal.",13,22,sentiment,7,2,9
3IHWR4LC7DEVIY2RYCFU8LLGPKN8IE,"Anti-Israeli sentiment, muted before President Hosni Mubarak was overthrown in February, has become more vocal.",24,29,muted,4,6,10
3IHWR4LC7DEVIY2RYCFU8LLGPKN8IE,"Anti-Israeli sentiment, muted before President Hosni Mubarak was overthrown in February, has become more vocal.",65,75,overthrown,4,8,12
3IHWR4LC7DEVIY2RYCFU8LLGPKN8IE,"Anti-Israeli sentiment, muted before President Hosni Mubarak was overthrown in February, has become more vocal.",100,110,more vocal,0,1,1
3IHWR4LC7DEVIY2RYCFU8LLGPKN8IE,"Anti-Israeli sentiment, muted before President Hosni Mubarak was overthrown in February, has become more vocal.",105,110,vocal,5,5,10
3IHWR4LC7DEVIY2RYCFU8LLGPKN8IE,A postmortem is due to be carried out today on the body of a teenager who was shot dead in Co Derry yesterday.,2,12,postmortem,10,6,16
3IHWR4LC7DEVIY2RYCFU8LLGPKN8IE,A postmortem is due to be carried out today on the body of a teenager who was shot dead in Co Derry yesterday.,61,69,teenager,0,1,1
3IHWR4LC7DEVIY2RYCFU8LLGPKN8IE,A 26-year-old man is being questioned by detectives about the murder of the 18-year-old and the serious wounding of her sister in a gun attack in a small village of Bellaghy.,41,51,detectives,1,1,2
3IHWR4LC7DEVIY2RYCFU8LLGPKN8IE,A 26-year-old man is being questioned by detectives about the murder of the 18-year-old and the serious wounding of her sister in a gun attack in a small village of Bellaghy.,62,68,murder,1,0,1
3IHWR4LC7DEVIY2RYCFU8LLGPKN8IE,A 26-year-old man is being questioned by detectives about the murder of the 18-year-old and the serious wounding of her sister in a gun attack in a small village of Bellaghy.,96,112,serious wounding,1,0,1
3IHWR4LC7DEVIY2RYCFU8LLGPKN8IE,A 26-year-old man is being questioned by detectives about the murder of the 18-year-old and the serious wounding of her sister in a gun attack in a small village of Bellaghy.,104,112,wounding,3,5,8
3OEWW2KGQJCHVF9LDF3FEAV3B7GDOQ,"An EU statement issued at a meeting of ministers from the 27-nation bloc said they adopted ""sanctions against the Syrian regime"" but gave no details.",3,5,EU,1,0,1
3OEWW2KGQJCHVF9LDF3FEAV3B7GDOQ,"An EU statement issued at a meeting of ministers from the 27-nation bloc said they adopted ""sanctions against the Syrian regime"" but gave no details.",16,22,issued,0,2,2
3OEWW2KGQJCHVF9LDF3FEAV3B7GDOQ,"An EU statement issued at a meeting of ministers from the 27-nation bloc said they adopted ""sanctions against the Syrian regime"" but gave no details.",39,48,ministers,1,0,1
3OEWW2KGQJCHVF9LDF3FEAV3B7GDOQ,"An EU statement issued at a meeting of ministers from the 27-nation bloc said they adopted ""sanctions against the Syrian regime"" but gave no details.",68,72,bloc,7,4,11
3OEWW2KGQJCHVF9LDF3FEAV3B7GDOQ,"An EU statement issued at a meeting of ministers from the 27-nation bloc said they adopted ""sanctions against the Syrian regime"" but gave no details.",83,90,adopted,1,2,3
3OEWW2KGQJCHVF9LDF3FEAV3B7GDOQ,"An EU statement issued at a meeting of ministers from the 27-nation bloc said they adopted ""sanctions against the Syrian regime"" but gave no details.",92,101,sanctions,10,5,15
3OEWW2KGQJCHVF9LDF3FEAV3B7GDOQ,"An EU statement issued at a meeting of ministers from the 27-nation bloc said they adopted ""sanctions against the Syrian regime"" but gave no details.",92,127,sanctions against the Syrian regime,1,0,1
3OEWW2KGQJCHVF9LDF3FEAV3B7GDOQ,"An EU statement issued at a meeting of ministers from the 27-nation bloc said they adopted ""sanctions against the Syrian regime"" but gave no details.",121,127,regime,7,7,14
3OEWW2KGQJCHVF9LDF3FEAV3B7GDOQ,"Rebels killed 23 Syrian soldiers on Monday, according to a rights group opposed to President Bashar Assad, in battles around the town of Rastan that further undermined a sagging U.N.-backed ceasefire.",0,6,Rebels,2,1,3
3OEWW2KGQJCHVF9LDF3FEAV3B7GDOQ,"Rebels killed 23 Syrian soldiers on Monday, according to a rights group opposed to President Bashar Assad, in battles around the town of Rastan that further undermined a sagging U.N.-backed ceasefire.",59,71,rights group,0,1,1
3OEWW2KGQJCHVF9LDF3FEAV3B7GDOQ,"Rebels killed 23 Syrian soldiers on Monday, according to a rights group opposed to President Bashar Assad, in battles around the town of Rastan that further undermined a sagging U.N.-backed ceasefire.",72,79,opposed,1,0,1
3OEWW2KGQJCHVF9LDF3FEAV3B7GDOQ,"Rebels killed 23 Syrian soldiers on Monday, according to a rights group opposed to President Bashar Assad, in battles around the town of Rastan that further undermined a sagging U.N.-backed ceasefire.",110,117,battles,0,1,1
3OEWW2KGQJCHVF9LDF3FEAV3B7GDOQ,"Rebels killed 23 Syrian soldiers on Monday, according to a rights group opposed to President Bashar Assad, in battles around the town of Rastan that further undermined a sagging U.N.-backed ceasefire.",157,167,undermined,10,5,15
3OEWW2KGQJCHVF9LDF3FEAV3B7GDOQ,"Rebels killed 23 Syrian soldiers on Monday, according to a rights group opposed to President Bashar Assad, in battles around the town of Rastan that further undermined a sagging U.N.-backed ceasefire.",157,177,undermined a sagging,1,0,1
3OEWW2KGQJCHVF9LDF3FEAV3B7GDOQ,"Rebels killed 23 Syrian soldiers on Monday, according to a rights group opposed to President Bashar Assad, in battles around the town of Rastan that further undermined a sagging U.N.-backed ceasefire.",170,177,sagging,5,8,13
3OEWW2KGQJCHVF9LDF3FEAV3B7GDOQ,"Rebels killed 23 Syrian soldiers on Monday, according to a rights group opposed to President Bashar Assad, in battles around the town of Rastan that further undermined a sagging U.N.-backed ceasefire.",170,199,sagging U.N.-backed ceasefire,1,0,1
3OEWW2KGQJCHVF9LDF3FEAV3B7GDOQ,"Rebels killed 23 Syrian soldiers on Monday, according to a rights group opposed to President Bashar Assad, in battles around the town of Rastan that further undermined a sagging U.N.-backed ceasefire.",190,199,ceasefire,8,9,17
3OEWW2KGQJCHVF9LDF3FEAV3B7GDOQ,"The fighting on the outskirts of Rastan followed heavy army shelling of the town in which opposition sources said at least nine people were killed, including a local rebel commander.",20,29,outskirts,8,6,14
3OEWW2KGQJCHVF9LDF3FEAV3B7GDOQ,"The fighting on the outskirts of Rastan followed heavy army shelling of the town in which opposition sources said at least nine people were killed, including a local rebel commander.",49,68,heavy army shelling,1,0,1
3OEWW2KGQJCHVF9LDF3FEAV3B7GDOQ,"The fighting on the outskirts of Rastan followed heavy army shelling of the town in which opposition sources said at least nine people were killed, including a local rebel commander.",60,68,shelling,6,4,10
3OEWW2KGQJCHVF9LDF3FEAV3B7GDOQ,"The fighting on the outskirts of Rastan followed heavy army shelling of the town in which opposition sources said at least nine people were killed, including a local rebel commander.",90,100,opposition,3,0,3
3OEWW2KGQJCHVF9LDF3FEAV3B7GDOQ,"The fighting on the outskirts of Rastan followed heavy army shelling of the town in which opposition sources said at least nine people were killed, including a local rebel commander.",90,108,opposition sources,2,0,2
3OEWW2KGQJCHVF9LDF3FEAV3B7GDOQ,"The fighting on the outskirts of Rastan followed heavy army shelling of the town in which opposition sources said at least nine people were killed, including a local rebel commander.",166,181,rebel commander,1,0,1
3OEWW2KGQJCHVF9LDF3FEAV3B7GDOQ,"Rastan, 25 km (15 miles) north of Homs city, has slipped in and out of government control several times since the uprising against Assad erupted in March 2011.",49,56,slipped,2,1,3
3OEWW2KGQJCHVF9LDF3FEAV3B7GDOQ,"Rastan, 25 km (15 miles) north of Homs city, has slipped in and out of government control several times since the uprising against Assad erupted in March 2011.",49,59,slipped in,0,2,2
3OEWW2KGQJCHVF9LDF3FEAV3B7GDOQ,"Rastan, 25 km (15 miles) north of Homs city, has slipped in and out of government control several times since the uprising against Assad erupted in March 2011.",71,81,government,1,0,1
3OEWW2KGQJCHVF9LDF3FEAV3B7GDOQ,"Rastan, 25 km (15 miles) north of Homs city, has slipped in and out of government control several times since the uprising against Assad erupted in March 2011.",114,122,uprising,6,8,14
3OEWW2KGQJCHVF9LDF3FEAV3B7GDOQ,"Rastan, 25 km (15 miles) north of Homs city, has slipped in and out of government control several times since the uprising against Assad erupted in March 2011.",137,144,erupted,5,4,9
3OEWW2KGQJCHVF9LDF3FEAV3B7GDOQ,"Shelling began on Sunday and intensified overnight, activists said, a new blow to a ceasefire declared by peace envoy Kofi Annan a month ago and which U.N. monitoring mission on the ground are observing.",0,8,Shelling,3,0,3
3OEWW2KGQJCHVF9LDF3FEAV3B7GDOQ,"Shelling began on Sunday and intensified overnight, activists said, a new blow to a ceasefire declared by peace envoy Kofi Annan a month ago and which U.N. monitoring mission on the ground are observing.",29,40,intensified,9,7,16
3OEWW2KGQJCHVF9LDF3FEAV3B7GDOQ,"Shelling began on Sunday and intensified overnight, activists said, a new blow to a ceasefire declared by peace envoy Kofi Annan a month ago and which U.N. monitoring mission on the ground are observing.",52,61,activists,2,1,3
3OEWW2KGQJCHVF9LDF3FEAV3B7GDOQ,"Shelling began on Sunday and intensified overnight, activists said, a new blow to a ceasefire declared by peace envoy Kofi Annan a month ago and which U.N. monitoring mission on the ground are observing.",74,78,blow,2,1,3
3OEWW2KGQJCHVF9LDF3FEAV3B7GDOQ,"Shelling began on Sunday and intensified overnight, activists said, a new blow to a ceasefire declared by peace envoy Kofi Annan a month ago and which U.N. monitoring mission on the ground are observing.",74,81,blow to,0,1,1
3OEWW2KGQJCHVF9LDF3FEAV3B7GDOQ,"Shelling began on Sunday and intensified overnight, activists said, a new blow to a ceasefire declared by peace envoy Kofi Annan a month ago and which U.N. monitoring mission on the ground are observing.",84,93,ceasefire,2,2,4
3OEWW2KGQJCHVF9LDF3FEAV3B7GDOQ,"Shelling began on Sunday and intensified overnight, activists said, a new blow to a ceasefire declared by peace envoy Kofi Annan a month ago and which U.N. monitoring mission on the ground are observing.",94,102,declared,1,0,1
3OEWW2KGQJCHVF9LDF3FEAV3B7GDOQ,"Shelling began on Sunday and intensified overnight, activists said, a new blow to a ceasefire declared by peace envoy Kofi Annan a month ago and which U.N. monitoring mission on the ground are observing.",106,117,peace envoy,0,1,1
3OEWW2KGQJCHVF9LDF3FEAV3B7GDOQ,"Shelling began on Sunday and intensified overnight, activists said, a new blow to a ceasefire declared by peace envoy Kofi Annan a month ago and which U.N. monitoring mission on the ground are observing.",112,117,envoy,9,1,10
3OEWW2KGQJCHVF9LDF3FEAV3B7GDOQ,"Shelling began on Sunday and intensified overnight, activists said, a new blow to a ceasefire declared by peace envoy Kofi Annan a month ago and which U.N. monitoring mission on the ground are observing.",151,174,U.N. monitoring mission,1,0,1
3OEWW2KGQJCHVF9LDF3FEAV3B7GDOQ,"Shelling began on Sunday and intensified overnight, activists said, a new blow to a ceasefire declared by peace envoy Kofi Annan a month ago and which U.N. monitoring mission on the ground are observing.",156,166,monitoring,4,1,5
3OEWW2KGQJCHVF9LDF3FEAV3B7GDOQ,"Shelling began on Sunday and intensified overnight, activists said, a new blow to a ceasefire declared by peace envoy Kofi Annan a month ago and which U.N. monitoring mission on the ground are observing.",156,174,monitoring mission,0,1,1
3OEWW2KGQJCHVF9LDF3FEAV3B7GDOQ,"Shelling began on Sunday and intensified overnight, activists said, a new blow to a ceasefire declared by peace envoy Kofi Annan a month ago and which U.N. monitoring mission on the ground are observing.",182,188,ground,1,0,1
3OEWW2KGQJCHVF9LDF3FEAV3B7GDOQ,"Shelling began on Sunday and intensified overnight, activists said, a new blow to a ceasefire declared by peace envoy Kofi Annan a month ago and which U.N. monitoring mission on the ground are observing.",193,202,observing,1,0,1
32L724R85LLGOQ18KTH5U7G6EUNIP8,"The children's father was separated from Thomas but still lives in Brevard County, according to Lt Goodyear.",26,35,separated,9,3,12
32L724R85LLGOQ18KTH5U7G6EUNIP8,"The children's father was separated from Thomas but still lives in Brevard County, according to Lt Goodyear.",26,47,separated from Thomas,0,1,1
32L724R85LLGOQ18KTH5U7G6EUNIP8,"The children's father was separated from Thomas but still lives in Brevard County, according to Lt Goodyear.",83,92,according,1,0,1
32L724R85LLGOQ18KTH5U7G6EUNIP8,"Police have found the body of a young woman near to an observatory in Merseyside Police made the discovery at Bidston Hill observatory near Birkenhead, Merseyside, at about 5.30pm on Saturday following a call from a concerned member of the public.",49,66,to an observatory,0,1,1
32L724R85LLGOQ18KTH5U7G6EUNIP8,"Police have found the body of a young woman near to an observatory in Merseyside Police made the discovery at Bidston Hill observatory near Birkenhead, Merseyside, at about 5.30pm on Saturday following a call from a concerned member of the public.",55,66,observatory,10,9,19
32L724R85LLGOQ18KTH5U7G6EUNIP8,"Police have found the body of a young woman near to an observatory in Merseyside Police made the discovery at Bidston Hill observatory near Birkenhead, Merseyside, at about 5.30pm on Saturday following a call from a concerned member of the public.",88,106,made the discovery,0,1,1
32L724R85LLGOQ18KTH5U7G6EUNIP8,"Police have found the body of a young woman near to an observatory in Merseyside Police made the discovery at Bidston Hill observatory near Birkenhead, Merseyside, at about 5.30pm on Saturday following a call from a concerned member of the public.",97,106,discovery,2,3,5
32L724R85LLGOQ18KTH5U7G6EUNIP8,"Police have found the body of a young woman near to an observatory in Merseyside Police made the discovery at Bidston Hill observatory near Birkenhead, Merseyside, at about 5.30pm on Saturday following a call from a concerned member of the public.",97,122,discovery at Bidston Hill,0,1,1
32L724R85LLGOQ18KTH5U7G6EUNIP8,"Police have found the body of a young woman near to an observatory in Merseyside Police made the discovery at Bidston Hill observatory near Birkenhead, Merseyside, at about 5.30pm on Saturday following a call from a concerned member of the public.",123,134,observatory,2,1,3
32L724R85LLGOQ18KTH5U7G6EUNIP8,"Police have found the body of a young woman near to an observatory in Merseyside Police made the discovery at Bidston Hill observatory near Birkenhead, Merseyside, at about 5.30pm on Saturday following a call from a concerned member of the public.",192,208,following a call,0,1,1
32L724R85LLGOQ18KTH5U7G6EUNIP8,"Police have found the body of a young woman near to an observatory in Merseyside Police made the discovery at Bidston Hill observatory near Birkenhead, Merseyside, at about 5.30pm on Saturday following a call from a concerned member of the public.",216,225,concerned,4,10,14
32L724R85LLGOQ18KTH5U7G6EUNIP8,"Police have found the body of a young woman near to an observatory in Merseyside Police made the discovery at Bidston Hill observatory near Birkenhead, Merseyside, at about 5.30pm on Saturday following a call from a concerned member of the public.",216,246,concerned member of the public,2,0,2
32L724R85LLGOQ18KTH5U7G6EUNIP8,"An 18-year-old man from Moreton, Wirral, has been arrested on suspicion of murder.",50,58,arrested,0,1,1
32L724R85LLGOQ18KTH5U7G6EUNIP8,"An 18-year-old man from Moreton, Wirral, has been arrested on suspicion of murder.",62,71,suspicion,10,9,19
32L724R85LLGOQ18KTH5U7G6EUNIP8,"An 18-year-old man from Moreton, Wirral, has been arrested on suspicion of murder.",62,81,suspicion of murder,1,3,4
32L724R85LLGOQ18KTH5U7G6EUNIP8,"An 18-year-old man from Moreton, Wirral, has been arrested on suspicion of murder.",75,81,murder,1,0,1
32L724R85LLGOQ18KTH5U7G6EUNIP8,"The victim, believed to be in her late teens, has yet to be formally identified, Merseyside Police said.",4,10,victim,2,5,7
32L724R85LLGOQ18KTH5U7G6EUNIP8,"The victim, believed to be in her late teens, has yet to be formally identified, Merseyside Police said.",12,44,believed to be in her late teens,0,1,1
32L724R85LLGOQ18KTH5U7G6EUNIP8,"The victim, believed to be in her late teens, has yet to be formally identified, Merseyside Police said.",30,44,her late teens,0,1,1
32L724R85LLGOQ18KTH5U7G6EUNIP8,"The victim, believed to be in her late teens, has yet to be formally identified, Merseyside Police said.",34,44,late teens,1,0,1
32L724R85LLGOQ18KTH5U7G6EUNIP8,"The victim, believed to be in her late teens, has yet to be formally identified, Merseyside Police said.",39,44,teens,0,1,1
32L724R85LLGOQ18KTH5U7G6EUNIP8,"The victim, believed to be in her late teens, has yet to be formally identified, Merseyside Police said.",60,68,formally,1,0,1
32L724R85LLGOQ18KTH5U7G6EUNIP8,"The victim, believed to be in her late teens, has yet to be formally identified, Merseyside Police said.",60,79,formally identified,4,3,7
32L724R85LLGOQ18KTH5U7G6EUNIP8,"The victim, believed to be in her late teens, has yet to be formally identified, Merseyside Police said.",69,79,identified,2,5,7
32L724R85LLGOQ18KTH5U7G6EUNIP8,A post-mortem examination to establish the cause of death is expected to take place.,2,13,post-mortem,6,7,13
32L724R85LLGOQ18KTH5U7G6EUNIP8,A post-mortem examination to establish the cause of death is expected to take place.,2,25,post-mortem examination,5,1,6
32L724R85LLGOQ18KTH5U7G6EUNIP8,A post-mortem examination to establish the cause of death is expected to take place.,14,25,examination,1,0,1
32L724R85LLGOQ18KTH5U7G6EUNIP8,A post-mortem examination to establish the cause of death is expected to take place.,29,38,establish,1,4,5
32L724R85LLGOQ18KTH5U7G6EUNIP8,A post-mortem examination to establish the cause of death is expected to take place.,29,57,establish the cause of death,0,1,1
32L724R85LLGOQ18KTH5U7G6EUNIP8,A post-mortem examination to establish the cause of death is expected to take place.,61,69,expected,0,2,2
32L724R85LLGOQ18KTH5U7G6EUNIP8,"Police are appealing for information about anyone seen acting suspiciously lately at Bidston Hill, Bidston, to come forward.",11,20,appealing,7,7,14
32L724R85LLGOQ18KTH5U7G6EUNIP8,"Police are appealing for information about anyone seen acting suspiciously lately at Bidston Hill, Bidston, to come forward.",11,36,appealing for information,0,1,1
32L724R85LLGOQ18KTH5U7G6EUNIP8,"Police are appealing for information about anyone seen acting suspiciously lately at Bidston Hill, Bidston, to come forward.",25,36,information,2,1,3
32L724R85LLGOQ18KTH5U7G6EUNIP8,"Police are appealing for information about anyone seen acting suspiciously lately at Bidston Hill, Bidston, to come forward.",55,74,acting suspiciously,1,1,2
32L724R85LLGOQ18KTH5U7G6EUNIP8,"Police are appealing for information about anyone seen acting suspiciously lately at Bidston Hill, Bidston, to come forward.",62,74,suspiciously,10,5,15
32L724R85LLGOQ18KTH5U7G6EUNIP8,"Police are appealing for information about anyone seen acting suspiciously lately at Bidston Hill, Bidston, to come forward.",116,123,forward,0,1,1
30P8I9JKOIMHHM3PZL7ABQ1JVWI5V6,Goodyear said that this was not the first time police were called to the house.,0,8,Goodyear,1,1,2
30P8I9JKOIMHHM3PZL7ABQ1JVWI5V6,Deupities said a neighbor had previously called 911 due to a domestic abuse.,0,9,Deupities,6,7,13
30P8I9JKOIMHHM3PZL7ABQ1JVWI5V6,Deupities said a neighbor had previously called 911 due to a domestic abuse.,17,25,neighbor,1,2,3
30P8I9JKOIMHHM3PZL7ABQ1JVWI5V6,Deupities said a neighbor had previously called 911 due to a domestic abuse.,30,40,previously,3,2,5
30P8I9JKOIMHHM3PZL7ABQ1JVWI5V6,Deupities said a neighbor had previously called 911 due to a domestic abuse.,61,69,domestic,4,1,5
30P8I9JKOIMHHM3PZL7ABQ1JVWI5V6,Deupities said a neighbor had previously called 911 due to a domestic abuse.,61,75,domestic abuse,6,5,11
30P8I9JKOIMHHM3PZL7ABQ1JVWI5V6,Deupities said a neighbor had previously called 911 due to a domestic abuse.,70,75,abuse,0,4,4
30P8I9JKOIMHHM3PZL7ABQ1JVWI5V6,Travis St. Peter lived on the same block as Thomas and her children.,35,40,block,1,1,2
30P8I9JKOIMHHM3PZL7ABQ1JVWI5V6,He said they were trouble makers who would shoot BB guns and lighting fireworks.,18,32,trouble makers,1,1,2
30P8I9JKOIMHHM3PZL7ABQ1JVWI5V6,He said they were trouble makers who would shoot BB guns and lighting fireworks.,49,56,BB guns,0,2,2
30P8I9JKOIMHHM3PZL7ABQ1JVWI5V6,He said they were trouble makers who would shoot BB guns and lighting fireworks.,61,69,lighting,0,1,1
30P8I9JKOIMHHM3PZL7ABQ1JVWI5V6,He said they were trouble makers who would shoot BB guns and lighting fireworks.,61,79,lighting fireworks,0,1,1
30P8I9JKOIMHHM3PZL7ABQ1JVWI5V6,He said they were trouble makers who would shoot BB guns and lighting fireworks.,70,79,fireworks,0,5,5
30P8I9JKOIMHHM3PZL7ABQ1JVWI5V6,"The guy had to board up his windows because they always, basically destroyed his house, said St. Travis, reported WFTV.",5,8,guy,0,1,1
30P8I9JKOIMHHM3PZL7ABQ1JVWI5V6,"The guy had to board up his windows because they always, basically destroyed his house, said St. Travis, reported WFTV.",13,36,to board up his windows,0,1,1
30P8I9JKOIMHHM3PZL7ABQ1JVWI5V6,"The guy had to board up his windows because they always, basically destroyed his house, said St. Travis, reported WFTV.",16,21,board,1,2,3
30P8I9JKOIMHHM3PZL7ABQ1JVWI5V6,"The guy had to board up his windows because they always, basically destroyed his house, said St. Travis, reported WFTV.",16,24,board up,1,3,4
30P8I9JKOIMHHM3PZL7ABQ1JVWI5V6,"The guy had to board up his windows because they always, basically destroyed his house, said St. Travis, reported WFTV.",58,67,basically,1,1,2
30P8I9JKOIMHHM3PZL7ABQ1JVWI5V6,"The guy had to board up his windows because they always, basically destroyed his house, said St. Travis, reported WFTV.",68,77,destroyed,2,1,3
30P8I9JKOIMHHM3PZL7ABQ1JVWI5V6,"You always hear the mom's yelling at midnight and stuff.""",26,33,yelling,3,5,8
30P8I9JKOIMHHM3PZL7ABQ1JVWI5V6,"You always hear the mom's yelling at midnight and stuff.""",37,55,midnight and stuff,0,1,1
30P8I9JKOIMHHM3PZL7ABQ1JVWI5V6,"You always hear the mom's yelling at midnight and stuff.""",50,55,stuff,1,4,5
30P8I9JKOIMHHM3PZL7ABQ1JVWI5V6,"Deputies said that the father of the children, who does not live with the family, was notified of the incident.",0,8,Deputies,2,0,2
30P8I9JKOIMHHM3PZL7ABQ1JVWI5V6,"Deputies said that the father of the children, who does not live with the family, was notified of the incident.",86,94,notified,7,5,12
30P8I9JKOIMHHM3PZL7ABQ1JVWI5V6,"Deputies said that the father of the children, who does not live with the family, was notified of the incident.",86,110,notified of the incident,2,0,2
30P8I9JKOIMHHM3PZL7ABQ1JVWI5V6,"Deputies said that the father of the children, who does not live with the family, was notified of the incident.",102,110,incident,4,3,7
30P8I9JKOIMHHM3PZL7ABQ1JVWI5V6,Reports indicate that he had a difficult time composing himself as investigators interviewed him.,8,16,indicate,6,2,8
30P8I9JKOIMHHM3PZL7ABQ1JVWI5V6,Reports indicate that he had a difficult time composing himself as investigators interviewed him.,31,40,difficult,0,1,1
30P8I9JKOIMHHM3PZL7ABQ1JVWI5V6,Reports indicate that he had a difficult time composing himself as investigators interviewed him.,31,45,difficult time,1,0,1
30P8I9JKOIMHHM3PZL7ABQ1JVWI5V6,Reports indicate that he had a difficult time composing himself as investigators interviewed him.,46,55,composing,10,9,19
30P8I9JKOIMHHM3PZL7ABQ1JVWI5V6,Reports indicate that he had a difficult time composing himself as investigators interviewed him.,46,63,composing himself,2,0,2
30P8I9JKOIMHHM3PZL7ABQ1JVWI5V6,Reports indicate that he had a difficult time composing himself as investigators interviewed him.,67,80,investigators,6,3,9
30P8I9JKOIMHHM3PZL7ABQ1JVWI5V6,Reports indicate that he had a difficult time composing himself as investigators interviewed him.,67,92,investigators interviewed,1,1,2
30P8I9JKOIMHHM3PZL7ABQ1JVWI5V6,Reports indicate that he had a difficult time composing himself as investigators interviewed him.,81,92,interviewed,1,1,2
3X0EMNLXEPQLAWL8J0GO9W60MWJPVC,"It has been an ongoing problem on our street with them, Hudson said.",16,23,ongoing,6,7,13
3X0EMNLXEPQLAWL8J0GO9W60MWJPVC,"It has been an ongoing problem on our street with them, Hudson said.",16,31,ongoing problem,1,1,2
3X0EMNLXEPQLAWL8J0GO9W60MWJPVC,Goodyear said Jaxs Johnson had recently been arrested on a domestic violence charge.,0,8,Goodyear,1,0,1
3X0EMNLXEPQLAWL8J0GO9W60MWJPVC,Goodyear said Jaxs Johnson had recently been arrested on a domestic violence charge.,45,53,arrested,1,1,2
3X0EMNLXEPQLAWL8J0GO9W60MWJPVC,Goodyear said Jaxs Johnson had recently been arrested on a domestic violence charge.,59,67,domestic,7,2,9
3X0EMNLXEPQLAWL8J0GO9W60MWJPVC,Goodyear said Jaxs Johnson had recently been arrested on a domestic violence charge.,59,76,domestic violence,3,4,7
3X0EMNLXEPQLAWL8J0GO9W60MWJPVC,Goodyear said Jaxs Johnson had recently been arrested on a domestic violence charge.,59,83,domestic violence charge,3,1,4
3X0EMNLXEPQLAWL8J0GO9W60MWJPVC,Goodyear said Jaxs Johnson had recently been arrested on a domestic violence charge.,68,76,violence,1,0,1
3X0EMNLXEPQLAWL8J0GO9W60MWJPVC,Goodyear said Jaxs Johnson had recently been arrested on a domestic violence charge.,77,83,charge,0,1,1
3X0EMNLXEPQLAWL8J0GO9W60MWJPVC,He said he didn't know if the boy had been accused of hitting his mother or causing damage at the house.,43,50,accused,7,6,13
3X0EMNLXEPQLAWL8J0GO9W60MWJPVC,He said he didn't know if the boy had been accused of hitting his mother or causing damage at the house.,43,53,accused of,0,1,1
3X0EMNLXEPQLAWL8J0GO9W60MWJPVC,He said he didn't know if the boy had been accused of hitting his mother or causing damage at the house.,43,61,accused of hitting,0,1,1
3X0EMNLXEPQLAWL8J0GO9W60MWJPVC,He said he didn't know if the boy had been accused of hitting his mother or causing damage at the house.,54,61,hitting,0,1,1
3X0EMNLXEPQLAWL8J0GO9W60MWJPVC,He said he didn't know if the boy had been accused of hitting his mother or causing damage at the house.,84,90,damage,0,1,1
3X0EMNLXEPQLAWL8J0GO9W60MWJPVC,"Austin Lewis, a 16-year-old classmate of Pebbles Johnson, said the family ""had problems like everybody else but nothing that drastic.""",28,37,classmate,0,1,1
3X0EMNLXEPQLAWL8J0GO9W60MWJPVC,"Austin Lewis, a 16-year-old classmate of Pebbles Johnson, said the family ""had problems like everybody else but nothing that drastic.""",125,132,drastic,10,10,20
3X0EMNLXEPQLAWL8J0GO9W60MWJPVC,"He described Pebbles Johnson as ""very loving and caring.""",3,12,described,1,2,3
3X0EMNLXEPQLAWL8J0GO9W60MWJPVC,"He described Pebbles Johnson as ""very loving and caring.""",13,20,Pebbles,0,1,1
3X0EMNLXEPQLAWL8J0GO9W60MWJPVC,"He described Pebbles Johnson as ""very loving and caring.""",49,55,caring,0,1,1
3X0EMNLXEPQLAWL8J0GO9W60MWJPVC,"Didn't let anything affect her.	21	27	affect	3	1	4
3X0EMNLXEPQLAWL8J0GO9W60MWJPVC	She was always in a good mood.",25,29,mood,0,1,1
3X0EMNLXEPQLAWL8J0GO9W60MWJPVC,"A pastor at the church the family attended described it as ""normal stuff.""",2,8,pastor,4,0,4
3X0EMNLXEPQLAWL8J0GO9W60MWJPVC,"A pastor at the church the family attended described it as ""normal stuff.""",34,42,attended,0,1,1
3X0EMNLXEPQLAWL8J0GO9W60MWJPVC,"A pastor at the church the family attended described it as ""normal stuff.""",34,52,attended described,1,0,1
3X0EMNLXEPQLAWL8J0GO9W60MWJPVC,"A pastor at the church the family attended described it as ""normal stuff.""",43,52,described,1,0,1
3X0EMNLXEPQLAWL8J0GO9W60MWJPVC,"A pastor at the church the family attended described it as ""normal stuff.""",60,72,normal stuff,0,2,2
3X0EMNLXEPQLAWL8J0GO9W60MWJPVC,"A pastor at the church the family attended described it as ""normal stuff.""",67,72,stuff,0,1,1
3X0EMNLXEPQLAWL8J0GO9W60MWJPVC,"I think he was punching some walls or something, said Jarvis Wash, pastor of the Real Church in Rockledge, Fla.",16,24,punching,4,6,10
3X0EMNLXEPQLAWL8J0GO9W60MWJPVC,"I think he was punching some walls or something, said Jarvis Wash, pastor of the Real Church in Rockledge, Fla.",16,35,punching some walls,0,1,1
3X0EMNLXEPQLAWL8J0GO9W60MWJPVC,"I think he was punching some walls or something, said Jarvis Wash, pastor of the Real Church in Rockledge, Fla.",98,107,Rockledge,0,1,1
3X0EMNLXEPQLAWL8J0GO9W60MWJPVC,"I think he was punching some walls or something, said Jarvis Wash, pastor of the Real Church in Rockledge, Fla.",109,112,Fla,1,0,1
3PMR2DOWOO2IN9KAFP6N2016HBX543,"The goal I set - to defeat al-Qaeda, and deny it a chance to rebuild - is now within our reach.''",4,8,goal,0,1,1
3PMR2DOWOO2IN9KAFP6N2016HBX543,"The goal I set - to defeat al-Qaeda, and deny it a chance to rebuild - is now within our reach.''",20,26,defeat,0,3,3
3PMR2DOWOO2IN9KAFP6N2016HBX543,"The goal I set - to defeat al-Qaeda, and deny it a chance to rebuild - is now within our reach.''",41,45,deny,0,3,3
3PMR2DOWOO2IN9KAFP6N2016HBX543,"The goal I set - to defeat al-Qaeda, and deny it a chance to rebuild - is now within our reach.''",61,68,rebuild,1,1,2
3PMR2DOWOO2IN9KAFP6N2016HBX543,"The goal I set - to defeat al-Qaeda, and deny it a chance to rebuild - is now within our reach.''",89,94,reach,0,2,2
3PMR2DOWOO2IN9KAFP6N2016HBX543,"Asserting that the US had largely achieved its military goals, Mr Obama said Afghans were ready to take responsibility for their own security, a transition that will start in earnest next year when US and NATO troops step back from a combat role to training and counter-terrorism operations.",0,9,Asserting,10,10,20
3PMR2DOWOO2IN9KAFP6N2016HBX543,"Asserting that the US had largely achieved its military goals, Mr Obama said Afghans were ready to take responsibility for their own security, a transition that will start in earnest next year when US and NATO troops step back from a combat role to training and counter-terrorism operations.",34,42,achieved,2,1,3
3PMR2DOWOO2IN9KAFP6N2016HBX543,"Asserting that the US had largely achieved its military goals, Mr Obama said Afghans were ready to take responsibility for their own security, a transition that will start in earnest next year when US and NATO troops step back from a combat role to training and counter-terrorism operations.",133,141,security,1,0,1
3PMR2DOWOO2IN9KAFP6N2016HBX543,"Asserting that the US had largely achieved its military goals, Mr Obama said Afghans were ready to take responsibility for their own security, a transition that will start in earnest next year when US and NATO troops step back from a combat role to training and counter-terrorism operations.",145,155,transition,10,7,17
3PMR2DOWOO2IN9KAFP6N2016HBX543,"Asserting that the US had largely achieved its military goals, Mr Obama said Afghans were ready to take responsibility for their own security, a transition that will start in earnest next year when US and NATO troops step back from a combat role to training and counter-terrorism operations.",172,182,in earnest,2,0,2
3PMR2DOWOO2IN9KAFP6N2016HBX543,"Asserting that the US had largely achieved its military goals, Mr Obama said Afghans were ready to take responsibility for their own security, a transition that will start in earnest next year when US and NATO troops step back from a combat role to training and counter-terrorism operations.",175,182,earnest,8,6,14
3PMR2DOWOO2IN9KAFP6N2016HBX543,"Asserting that the US had largely achieved its military goals, Mr Obama said Afghans were ready to take responsibility for their own security, a transition that will start in earnest next year when US and NATO troops step back from a combat role to training and counter-terrorism operations.",210,216,troops,0,1,1
3PMR2DOWOO2IN9KAFP6N2016HBX543,"Asserting that the US had largely achieved its military goals, Mr Obama said Afghans were ready to take responsibility for their own security, a transition that will start in earnest next year when US and NATO troops step back from a combat role to training and counter-terrorism operations.",217,226,step back,0,1,1
3PMR2DOWOO2IN9KAFP6N2016HBX543,"Asserting that the US had largely achieved its military goals, Mr Obama said Afghans were ready to take responsibility for their own security, a transition that will start in earnest next year when US and NATO troops step back from a combat role to training and counter-terrorism operations.",234,240,combat,1,3,4
3PMR2DOWOO2IN9KAFP6N2016HBX543,"Asserting that the US had largely achieved its military goals, Mr Obama said Afghans were ready to take responsibility for their own security, a transition that will start in earnest next year when US and NATO troops step back from a combat role to training and counter-terrorism operations.",234,245,combat role,1,2,3
3PMR2DOWOO2IN9KAFP6N2016HBX543,"Asserting that the US had largely achieved its military goals, Mr Obama said Afghans were ready to take responsibility for their own security, a transition that will start in earnest next year when US and NATO troops step back from a combat role to training and counter-terrorism operations.",262,279,counter-terrorism,6,8,14
3PMR2DOWOO2IN9KAFP6N2016HBX543,"Asserting that the US had largely achieved its military goals, Mr Obama said Afghans were ready to take responsibility for their own security, a transition that will start in earnest next year when US and NATO troops step back from a combat role to training and counter-terrorism operations.",262,290,counter-terrorism operations,6,1,7
3PMR2DOWOO2IN9KAFP6N2016HBX543,"Asserting that the US had largely achieved its military goals, Mr Obama said Afghans were ready to take responsibility for their own security, a transition that will start in earnest next year when US and NATO troops step back from a combat role to training and counter-terrorism operations.",280,290,operations,2,0,2
3PMR2DOWOO2IN9KAFP6N2016HBX543,"Insurgents killed at least seven people in an attack targeting  foreigners in Kabul Wednesday, just two hours after U.S. President  Barack Obama left Afghanistan following a brief unannounced visit.",0,10,Insurgents,10,9,19
3PMR2DOWOO2IN9KAFP6N2016HBX543,"Insurgents killed at least seven people in an attack targeting  foreigners in Kabul Wednesday, just two hours after U.S. President  Barack Obama left Afghanistan following a brief unannounced visit.",53,62,targeting,0,4,4
3PMR2DOWOO2IN9KAFP6N2016HBX543,"Insurgents killed at least seven people in an attack targeting  foreigners in Kabul Wednesday, just two hours after U.S. President  Barack Obama left Afghanistan following a brief unannounced visit.",64,74,foreigners,1,0,1
3PMR2DOWOO2IN9KAFP6N2016HBX543,"Insurgents killed at least seven people in an attack targeting  foreigners in Kabul Wednesday, just two hours after U.S. President  Barack Obama left Afghanistan following a brief unannounced visit.",174,191,brief unannounced,1,0,1
3PMR2DOWOO2IN9KAFP6N2016HBX543,"Insurgents killed at least seven people in an attack targeting  foreigners in Kabul Wednesday, just two hours after U.S. President  Barack Obama left Afghanistan following a brief unannounced visit.",180,191,unannounced,6,3,9
3PMR2DOWOO2IN9KAFP6N2016HBX543,The Taliban claimed responsibility for the assault on the heavily  secured compound housing hundreds of international workers on the  eastern outskirts of the capital.,12,19,claimed,0,1,1
3PMR2DOWOO2IN9KAFP6N2016HBX543,The Taliban claimed responsibility for the assault on the heavily  secured compound housing hundreds of international workers on the  eastern outskirts of the capital.,20,34,responsibility,2,0,2
3PMR2DOWOO2IN9KAFP6N2016HBX543,The Taliban claimed responsibility for the assault on the heavily  secured compound housing hundreds of international workers on the  eastern outskirts of the capital.,43,50,assault,1,7,8
3PMR2DOWOO2IN9KAFP6N2016HBX543,The Taliban claimed responsibility for the assault on the heavily  secured compound housing hundreds of international workers on the  eastern outskirts of the capital.,58,74,heavily  secured,1,0,1
3PMR2DOWOO2IN9KAFP6N2016HBX543,The Taliban claimed responsibility for the assault on the heavily  secured compound housing hundreds of international workers on the  eastern outskirts of the capital.,58,83,heavily  secured compound,1,0,1
3PMR2DOWOO2IN9KAFP6N2016HBX543,The Taliban claimed responsibility for the assault on the heavily  secured compound housing hundreds of international workers on the  eastern outskirts of the capital.,67,74,secured,0,1,1
3PMR2DOWOO2IN9KAFP6N2016HBX543,The Taliban claimed responsibility for the assault on the heavily  secured compound housing hundreds of international workers on the  eastern outskirts of the capital.,75,83,compound,6,1,7
3PMR2DOWOO2IN9KAFP6N2016HBX543,The Taliban claimed responsibility for the assault on the heavily  secured compound housing hundreds of international workers on the  eastern outskirts of the capital.,75,91,compound housing,0,1,1
3PMR2DOWOO2IN9KAFP6N2016HBX543,The Taliban claimed responsibility for the assault on the heavily  secured compound housing hundreds of international workers on the  eastern outskirts of the capital.,84,91,housing,0,1,1
3PMR2DOWOO2IN9KAFP6N2016HBX543,The Taliban claimed responsibility for the assault on the heavily  secured compound housing hundreds of international workers on the  eastern outskirts of the capital.,104,117,international,2,0,2
3PMR2DOWOO2IN9KAFP6N2016HBX543,The Taliban claimed responsibility for the assault on the heavily  secured compound housing hundreds of international workers on the  eastern outskirts of the capital.,134,151,eastern outskirts,0,1,1
3PMR2DOWOO2IN9KAFP6N2016HBX543,The Taliban claimed responsibility for the assault on the heavily  secured compound housing hundreds of international workers on the  eastern outskirts of the capital.,142,151,outskirts,10,7,17
3PMR2DOWOO2IN9KAFP6N2016HBX543,The Taliban claimed responsibility for the assault on the heavily  secured compound housing hundreds of international workers on the  eastern outskirts of the capital.,159,166,capital,1,0,1
39HYCOOPKOMTVCO90ZO2M66YG71DMB,"Rami Abdul-Rahman, who heads the Observatory, said the rebels were able to destroy several army vehicles during the clashes and kill soldiers.",33,44,Observatory,9,5,14
39HYCOOPKOMTVCO90ZO2M66YG71DMB,"Rami Abdul-Rahman, who heads the Observatory, said the rebels were able to destroy several army vehicles during the clashes and kill soldiers.",55,61,rebels,0,1,1
39HYCOOPKOMTVCO90ZO2M66YG71DMB,"Rami Abdul-Rahman, who heads the Observatory, said the rebels were able to destroy several army vehicles during the clashes and kill soldiers.",96,104,vehicles,0,1,1
39HYCOOPKOMTVCO90ZO2M66YG71DMB,"Rami Abdul-Rahman, who heads the Observatory, said the rebels were able to destroy several army vehicles during the clashes and kill soldiers.",116,123,clashes,4,3,7
39HYCOOPKOMTVCO90ZO2M66YG71DMB,The accounts could not be independently confirmed.,4,12,accounts,1,0,1
39HYCOOPKOMTVCO90ZO2M66YG71DMB,The accounts could not be independently confirmed.,26,39,independently,5,1,6
39HYCOOPKOMTVCO90ZO2M66YG71DMB,The accounts could not be independently confirmed.,26,49,independently confirmed,5,2,7
39HYCOOPKOMTVCO90ZO2M66YG71DMB,"The attack on Rastan came after Syrian forces killed at least five people when they raided a Sunni farming village in Hama province, torching homes and looting shops in what appeared to be a sign of worsening relations among the country's religious groups.",84,90,raided,3,3,6
39HYCOOPKOMTVCO90ZO2M66YG71DMB,"The attack on Rastan came after Syrian forces killed at least five people when they raided a Sunni farming village in Hama province, torching homes and looting shops in what appeared to be a sign of worsening relations among the country's religious groups.",93,98,Sunni,0,1,1
39HYCOOPKOMTVCO90ZO2M66YG71DMB,"The attack on Rastan came after Syrian forces killed at least five people when they raided a Sunni farming village in Hama province, torching homes and looting shops in what appeared to be a sign of worsening relations among the country's religious groups.",123,131,province,2,1,3
39HYCOOPKOMTVCO90ZO2M66YG71DMB,"The attack on Rastan came after Syrian forces killed at least five people when they raided a Sunni farming village in Hama province, torching homes and looting shops in what appeared to be a sign of worsening relations among the country's religious groups.",133,141,torching,5,7,12
39HYCOOPKOMTVCO90ZO2M66YG71DMB,"The attack on Rastan came after Syrian forces killed at least five people when they raided a Sunni farming village in Hama province, torching homes and looting shops in what appeared to be a sign of worsening relations among the country's religious groups.",133,147,torching homes,2,1,3
39HYCOOPKOMTVCO90ZO2M66YG71DMB,"The attack on Rastan came after Syrian forces killed at least five people when they raided a Sunni farming village in Hama province, torching homes and looting shops in what appeared to be a sign of worsening relations among the country's religious groups.",152,159,looting,6,9,15
39HYCOOPKOMTVCO90ZO2M66YG71DMB,"The attack on Rastan came after Syrian forces killed at least five people when they raided a Sunni farming village in Hama province, torching homes and looting shops in what appeared to be a sign of worsening relations among the country's religious groups.",152,165,looting shops,3,1,4
39HYCOOPKOMTVCO90ZO2M66YG71DMB,"The attack on Rastan came after Syrian forces killed at least five people when they raided a Sunni farming village in Hama province, torching homes and looting shops in what appeared to be a sign of worsening relations among the country's religious groups.",199,208,worsening,5,4,9
39HYCOOPKOMTVCO90ZO2M66YG71DMB,"The attack on Rastan came after Syrian forces killed at least five people when they raided a Sunni farming village in Hama province, torching homes and looting shops in what appeared to be a sign of worsening relations among the country's religious groups.",199,218,worsening relations,3,1,4
39HYCOOPKOMTVCO90ZO2M66YG71DMB,"The attack on Rastan came after Syrian forces killed at least five people when they raided a Sunni farming village in Hama province, torching homes and looting shops in what appeared to be a sign of worsening relations among the country's religious groups.",209,218,relations,1,0,1
39HYCOOPKOMTVCO90ZO2M66YG71DMB,"Syria is overwhelmingly Sunni, but President Bashar Assad and the ruling elite belong to the minatory Alawite sect.",9,23,overwhelmingly,9,8,17
39HYCOOPKOMTVCO90ZO2M66YG71DMB,"Syria is overwhelmingly Sunni, but President Bashar Assad and the ruling elite belong to the minatory Alawite sect.",24,29,Sunni,0,1,1
39HYCOOPKOMTVCO90ZO2M66YG71DMB,"Syria is overwhelmingly Sunni, but President Bashar Assad and the ruling elite belong to the minatory Alawite sect.",66,72,ruling,0,1,1
39HYCOOPKOMTVCO90ZO2M66YG71DMB,"Syria is overwhelmingly Sunni, but President Bashar Assad and the ruling elite belong to the minatory Alawite sect.",66,78,ruling elite,2,2,4
39HYCOOPKOMTVCO90ZO2M66YG71DMB,"Syria is overwhelmingly Sunni, but President Bashar Assad and the ruling elite belong to the minatory Alawite sect.",73,78,elite,5,3,8
39HYCOOPKOMTVCO90ZO2M66YG71DMB,"Syria is overwhelmingly Sunni, but President Bashar Assad and the ruling elite belong to the minatory Alawite sect.",93,101,minatory,10,4,14
39HYCOOPKOMTVCO90ZO2M66YG71DMB,"Syria is overwhelmingly Sunni, but President Bashar Assad and the ruling elite belong to the minatory Alawite sect.",93,114,minatory Alawite sect,2,0,2
39HYCOOPKOMTVCO90ZO2M66YG71DMB,"Syria is overwhelmingly Sunni, but President Bashar Assad and the ruling elite belong to the minatory Alawite sect.",102,109,Alawite,0,1,1
39HYCOOPKOMTVCO90ZO2M66YG71DMB,"Syria is overwhelmingly Sunni, but President Bashar Assad and the ruling elite belong to the minatory Alawite sect.",102,114,Alawite sect,1,1,2
39HYCOOPKOMTVCO90ZO2M66YG71DMB,"Syria is overwhelmingly Sunni, but President Bashar Assad and the ruling elite belong to the minatory Alawite sect.",110,114,sect,5,0,5
39HYCOOPKOMTVCO90ZO2M66YG71DMB,"Sectarian tensions appear to be growing in some areas, adding a dangerous new element to the violence.",0,9,Sectarian,6,0,6
39HYCOOPKOMTVCO90ZO2M66YG71DMB,"Sectarian tensions appear to be growing in some areas, adding a dangerous new element to the violence.",0,18,Sectarian tensions,2,3,5
39HYCOOPKOMTVCO90ZO2M66YG71DMB,"Sectarian tensions appear to be growing in some areas, adding a dangerous new element to the violence.",10,18,tensions,1,0,1
39HYCOOPKOMTVCO90ZO2M66YG71DMB,"Sectarian tensions appear to be growing in some areas, adding a dangerous new element to the violence.",74,85,new element,0,1,1
39HYCOOPKOMTVCO90ZO2M66YG71DMB,"Sectarian tensions appear to be growing in some areas, adding a dangerous new element to the violence.",78,85,element,2,0,2
39HYCOOPKOMTVCO90ZO2M66YG71DMB,"Many Syrians accuse Assad of exploiting that divide by unleashing Alawite gunmen known as ""shabiha"" who operate as hired muscle for the regime.",13,19,accuse,1,1,2
39HYCOOPKOMTVCO90ZO2M66YG71DMB,"Many Syrians accuse Assad of exploiting that divide by unleashing Alawite gunmen known as ""shabiha"" who operate as hired muscle for the regime.",29,39,exploiting,8,3,11
39HYCOOPKOMTVCO90ZO2M66YG71DMB,"Many Syrians accuse Assad of exploiting that divide by unleashing Alawite gunmen known as ""shabiha"" who operate as hired muscle for the regime.",55,65,unleashing,6,8,14
39HYCOOPKOMTVCO90ZO2M66YG71DMB,"Many Syrians accuse Assad of exploiting that divide by unleashing Alawite gunmen known as ""shabiha"" who operate as hired muscle for the regime.",55,80,unleashing Alawite gunmen,1,0,1
39HYCOOPKOMTVCO90ZO2M66YG71DMB,"Many Syrians accuse Assad of exploiting that divide by unleashing Alawite gunmen known as ""shabiha"" who operate as hired muscle for the regime.",91,98,shabiha,5,1,6
39HYCOOPKOMTVCO90ZO2M66YG71DMB,"Many Syrians accuse Assad of exploiting that divide by unleashing Alawite gunmen known as ""shabiha"" who operate as hired muscle for the regime.",115,120,hired,0,2,2
39HYCOOPKOMTVCO90ZO2M66YG71DMB,"Many Syrians accuse Assad of exploiting that divide by unleashing Alawite gunmen known as ""shabiha"" who operate as hired muscle for the regime.",115,127,hired muscle,3,3,6
39HYCOOPKOMTVCO90ZO2M66YG71DMB,"Many Syrians accuse Assad of exploiting that divide by unleashing Alawite gunmen known as ""shabiha"" who operate as hired muscle for the regime.",121,127,muscle,1,0,1
39HYCOOPKOMTVCO90ZO2M66YG71DMB,"Many Syrians accuse Assad of exploiting that divide by unleashing Alawite gunmen known as ""shabiha"" who operate as hired muscle for the regime.",136,142,regime,2,0,2
3MA5N0ATTCCXEUOXWIGCZH3FYICKWM,"While the government has taken steps to support banks, analysts say more needs to be done to fix the problem once and for all.",10,20,government,1,0,1
3MA5N0ATTCCXEUOXWIGCZH3FYICKWM,"While the government has taken steps to support banks, analysts say more needs to be done to fix the problem once and for all.",21,36,has taken steps,0,1,1
3MA5N0ATTCCXEUOXWIGCZH3FYICKWM,"While the government has taken steps to support banks, analysts say more needs to be done to fix the problem once and for all.",40,53,support banks,1,0,1
3MA5N0ATTCCXEUOXWIGCZH3FYICKWM,"While the government has taken steps to support banks, analysts say more needs to be done to fix the problem once and for all.",55,63,analysts,10,8,18
3MA5N0ATTCCXEUOXWIGCZH3FYICKWM,"While the government has taken steps to support banks, analysts say more needs to be done to fix the problem once and for all.",93,108,fix the problem,0,1,1
3MA5N0ATTCCXEUOXWIGCZH3FYICKWM,"President Barack Obama made a surprise visit on Tuesday to Afghanistan, where he will sign an agreement outlining the U.S.' role in the country as the decade-long war there winds down.",30,38,surprise,0,1,1
3MA5N0ATTCCXEUOXWIGCZH3FYICKWM,"President Barack Obama made a surprise visit on Tuesday to Afghanistan, where he will sign an agreement outlining the U.S.' role in the country as the decade-long war there winds down.",94,103,agreement,0,4,4
3MA5N0ATTCCXEUOXWIGCZH3FYICKWM,"President Barack Obama made a surprise visit on Tuesday to Afghanistan, where he will sign an agreement outlining the U.S.' role in the country as the decade-long war there winds down.",94,113,agreement outlining,1,0,1
3MA5N0ATTCCXEUOXWIGCZH3FYICKWM,"President Barack Obama made a surprise visit on Tuesday to Afghanistan, where he will sign an agreement outlining the U.S.' role in the country as the decade-long war there winds down.",104,113,outlining,5,4,9
3MA5N0ATTCCXEUOXWIGCZH3FYICKWM,"President Barack Obama made a surprise visit on Tuesday to Afghanistan, where he will sign an agreement outlining the U.S.' role in the country as the decade-long war there winds down.",104,127,outlining the U.S. role,1,1,2
3MA5N0ATTCCXEUOXWIGCZH3FYICKWM,"President Barack Obama made a surprise visit on Tuesday to Afghanistan, where he will sign an agreement outlining the U.S.' role in the country as the decade-long war there winds down.",151,162,decade-long,3,5,8
3MA5N0ATTCCXEUOXWIGCZH3FYICKWM,"President Barack Obama made a surprise visit on Tuesday to Afghanistan, where he will sign an agreement outlining the U.S.' role in the country as the decade-long war there winds down.",151,166,decade-long war,0,1,1
3MA5N0ATTCCXEUOXWIGCZH3FYICKWM,"President Barack Obama made a surprise visit on Tuesday to Afghanistan, where he will sign an agreement outlining the U.S.' role in the country as the decade-long war there winds down.",173,178,winds,0,1,1
3MA5N0ATTCCXEUOXWIGCZH3FYICKWM,"President Barack Obama made a surprise visit on Tuesday to Afghanistan, where he will sign an agreement outlining the U.S.' role in the country as the decade-long war there winds down.",173,183,winds down,3,4,7
3MA5N0ATTCCXEUOXWIGCZH3FYICKWM,"Obama will meet with Afghan President Hamid Karzai to sign a ""strategic partnership"" agreement that will govern the U.S.' involvement in the country until American combat troops are withdrawn by the end of 2014, according to the New York Times.",38,50,Hamid Karzai,1,0,1
3MA5N0ATTCCXEUOXWIGCZH3FYICKWM,"Obama will meet with Afghan President Hamid Karzai to sign a ""strategic partnership"" agreement that will govern the U.S.' involvement in the country until American combat troops are withdrawn by the end of 2014, according to the New York Times.",62,71,strategic,1,1,2
3MA5N0ATTCCXEUOXWIGCZH3FYICKWM,"Obama will meet with Afghan President Hamid Karzai to sign a ""strategic partnership"" agreement that will govern the U.S.' involvement in the country until American combat troops are withdrawn by the end of 2014, according to the New York Times.",62,83,strategic partnership,10,6,16
3MA5N0ATTCCXEUOXWIGCZH3FYICKWM,"Obama will meet with Afghan President Hamid Karzai to sign a ""strategic partnership"" agreement that will govern the U.S.' involvement in the country until American combat troops are withdrawn by the end of 2014, according to the New York Times.",56,87,strategic partnership agreement,0,1,1
3MA5N0ATTCCXEUOXWIGCZH3FYICKWM,"Obama will meet with Afghan President Hamid Karzai to sign a ""strategic partnership"" agreement that will govern the U.S.' involvement in the country until American combat troops are withdrawn by the end of 2014, according to the New York Times.",72,83,partnership,0,1,1
3MA5N0ATTCCXEUOXWIGCZH3FYICKWM,"Obama will meet with Afghan President Hamid Karzai to sign a ""strategic partnership"" agreement that will govern the U.S.' involvement in the country until American combat troops are withdrawn by the end of 2014, according to the New York Times.",105,111,govern,2,0,2
3MA5N0ATTCCXEUOXWIGCZH3FYICKWM,"Obama will meet with Afghan President Hamid Karzai to sign a ""strategic partnership"" agreement that will govern the U.S.' involvement in the country until American combat troops are withdrawn by the end of 2014, according to the New York Times.",122,133,involvement,2,1,3
3MA5N0ATTCCXEUOXWIGCZH3FYICKWM,"Obama will meet with Afghan President Hamid Karzai to sign a ""strategic partnership"" agreement that will govern the U.S.' involvement in the country until American combat troops are withdrawn by the end of 2014, according to the New York Times.",164,170,combat,0,1,1
3MA5N0ATTCCXEUOXWIGCZH3FYICKWM,"Obama will meet with Afghan President Hamid Karzai to sign a ""strategic partnership"" agreement that will govern the U.S.' involvement in the country until American combat troops are withdrawn by the end of 2014, according to the New York Times.",164,177,combat troops,4,1,5
3MA5N0ATTCCXEUOXWIGCZH3FYICKWM,"Obama will meet with Afghan President Hamid Karzai to sign a ""strategic partnership"" agreement that will govern the U.S.' involvement in the country until American combat troops are withdrawn by the end of 2014, according to the New York Times.",171,177,troops,0,1,1
3MA5N0ATTCCXEUOXWIGCZH3FYICKWM,"Obama will meet with Afghan President Hamid Karzai to sign a ""strategic partnership"" agreement that will govern the U.S.' involvement in the country until American combat troops are withdrawn by the end of 2014, according to the New York Times.",182,191,withdrawn,4,6,10
3MA5N0ATTCCXEUOXWIGCZH3FYICKWM,"Obama left the U.S. around 12 a.m. early Tuesday morning and landed at Bagram Air Field at 10:30 p.m. local time, according to a pool report.",61,67,landed,0,1,1
3MA5N0ATTCCXEUOXWIGCZH3FYICKWM,"Obama left the U.S. around 12 a.m. early Tuesday morning and landed at Bagram Air Field at 10:30 p.m. local time, according to a pool report.",71,77,Bagram,1,0,1
3MA5N0ATTCCXEUOXWIGCZH3FYICKWM,"Obama left the U.S. around 12 a.m. early Tuesday morning and landed at Bagram Air Field at 10:30 p.m. local time, according to a pool report.",114,123,according,0,1,1
3MA5N0ATTCCXEUOXWIGCZH3FYICKWM,"Obama left the U.S. around 12 a.m. early Tuesday morning and landed at Bagram Air Field at 10:30 p.m. local time, according to a pool report.",114,126,according to,1,0,1
3MA5N0ATTCCXEUOXWIGCZH3FYICKWM,"Obama left the U.S. around 12 a.m. early Tuesday morning and landed at Bagram Air Field at 10:30 p.m. local time, according to a pool report.",129,133,pool,0,1,1
3MA5N0ATTCCXEUOXWIGCZH3FYICKWM,"Obama left the U.S. around 12 a.m. early Tuesday morning and landed at Bagram Air Field at 10:30 p.m. local time, according to a pool report.",129,140,pool report,10,4,14
3AC6MFV69KJA6ZSU1KXMLTH5NFRHZ8,"This attack was to make clear our reaction to Obama's trip to Afghanistan.	17	30	to make clear	1	0	1
3AC6MFV69KJA6ZSU1KXMLTH5NFRHZ8	This attack was to make clear our reaction to Obama's trip to Afghanistan.",20,30,make clear,2,0,2
3AC6MFV69KJA6ZSU1KXMLTH5NFRHZ8,"This attack was to make clear our reaction to Obama's trip to Afghanistan.	35	43	reaction	2	2	4
3AC6MFV69KJA6ZSU1KXMLTH5NFRHZ8	The message was that instead of signing a strategic partnership deal with Afghanistan, he should think about taking his troops out from Afghanistan and leave it to Afghans to rebuild their country, Taliban spokesman Zabihullah Mujahid told Reuters by telephone from an undisclosed location.",21,28,instead,0,1,1
3AC6MFV69KJA6ZSU1KXMLTH5NFRHZ8,"The message was that instead of signing a strategic partnership deal with Afghanistan, he should think about taking his troops out from Afghanistan and leave it to Afghans to rebuild their country,"" Taliban spokesman Zabihullah Mujahid told Reuters by telephone from an undisclosed location.",42,51,strategic,5,3,8
3AC6MFV69KJA6ZSU1KXMLTH5NFRHZ8,"The message was that instead of signing a strategic partnership deal with Afghanistan, he should think about taking his troops out from Afghanistan and leave it to Afghans to rebuild their country,"" Taliban spokesman Zabihullah Mujahid told Reuters by telephone from an undisclosed location.",42,63,strategic partnership,4,2,6
3AC6MFV69KJA6ZSU1KXMLTH5NFRHZ8,"The message was that instead of signing a strategic partnership deal with Afghanistan, he should think about taking his troops out from Afghanistan and leave it to Afghans to rebuild their country,"" Taliban spokesman Zabihullah Mujahid told Reuters by telephone from an undisclosed location.",42,68,strategic partnership deal,5,3,8
3AC6MFV69KJA6ZSU1KXMLTH5NFRHZ8,"The message was that instead of signing a strategic partnership deal with Afghanistan, he should think about taking his troops out from Afghanistan and leave it to Afghans to rebuild their country,"" Taliban spokesman Zabihullah Mujahid told Reuters by telephone from an undisclosed location.",120,126,troops,0,1,1
3AC6MFV69KJA6ZSU1KXMLTH5NFRHZ8,"The message was that instead of signing a strategic partnership deal with Afghanistan, he should think about taking his troops out from Afghanistan and leave it to Afghans to rebuild their country,"" Taliban spokesman Zabihullah Mujahid told Reuters by telephone from an undisclosed location.",175,182,rebuild,1,4,5
3AC6MFV69KJA6ZSU1KXMLTH5NFRHZ8,"The message was that instead of signing a strategic partnership deal with Afghanistan, he should think about taking his troops out from Afghanistan and leave it to Afghans to rebuild their country,"" Taliban spokesman Zabihullah Mujahid told Reuters by telephone from an undisclosed location.",175,196,rebuild their country,1,0,1
3AC6MFV69KJA6ZSU1KXMLTH5NFRHZ8,"The message was that instead of signing a strategic partnership deal with Afghanistan, he should think about taking his troops out from Afghanistan and leave it to Afghans to rebuild their country,"" Taliban spokesman Zabihullah Mujahid told Reuters by telephone from an undisclosed location.",199,206,Taliban,1,0,1
3AC6MFV69KJA6ZSU1KXMLTH5NFRHZ8,"The message was that instead of signing a strategic partnership deal with Afghanistan, he should think about taking his troops out from Afghanistan and leave it to Afghans to rebuild their country,"" Taliban spokesman Zabihullah Mujahid told Reuters by telephone from an undisclosed location.",207,216,spokesman,3,3,6
3AC6MFV69KJA6ZSU1KXMLTH5NFRHZ8,"The message was that instead of signing a strategic partnership deal with Afghanistan, he should think about taking his troops out from Afghanistan and leave it to Afghans to rebuild their country,"" Taliban spokesman Zabihullah Mujahid told Reuters by telephone from an undisclosed location.",241,248,Reuters,1,1,2
3AC6MFV69KJA6ZSU1KXMLTH5NFRHZ8,"The message was that instead of signing a strategic partnership deal with Afghanistan, he should think about taking his troops out from Afghanistan and leave it to Afghans to rebuild their country,"" Taliban spokesman Zabihullah Mujahid told Reuters by telephone from an undisclosed location.",252,261,telephone,1,0,1
3AC6MFV69KJA6ZSU1KXMLTH5NFRHZ8,"The message was that instead of signing a strategic partnership deal with Afghanistan, he should think about taking his troops out from Afghanistan and leave it to Afghans to rebuild their country,"" Taliban spokesman Zabihullah Mujahid told Reuters by telephone from an undisclosed location.",270,281,undisclosed,9,6,15
3AC6MFV69KJA6ZSU1KXMLTH5NFRHZ8,"The message was that instead of signing a strategic partnership deal with Afghanistan, he should think about taking his troops out from Afghanistan and leave it to Afghans to rebuild their country,"" Taliban spokesman Zabihullah Mujahid told Reuters by telephone from an undisclosed location.",270,290,undisclosed location,5,3,8
3AC6MFV69KJA6ZSU1KXMLTH5NFRHZ8,"But America's Kabul ambassador, Ryan Crocker, said involvement of the Haqqani network - which Washington believes is based in Pakistan's North Waziristan region and which it blames for high-profile attacks in Kabul in April - could not be ruled out.",20,30,ambassador,6,1,7
3AC6MFV69KJA6ZSU1KXMLTH5NFRHZ8,"But America's Kabul ambassador, Ryan Crocker, said involvement of the Haqqani network - which Washington believes is based in Pakistan's North Waziristan region and which it blames for high-profile attacks in Kabul in April - could not be ruled out.",51,62,involvement,1,3,4
3AC6MFV69KJA6ZSU1KXMLTH5NFRHZ8,"But America's Kabul ambassador, Ryan Crocker, said involvement of the Haqqani network - which Washington believes is based in Pakistan's North Waziristan region and which it blames for high-profile attacks in Kabul in April - could not be ruled out.",70,85,Haqqani network,2,1,3
3AC6MFV69KJA6ZSU1KXMLTH5NFRHZ8,"But America's Kabul ambassador, Ryan Crocker, said involvement of the Haqqani network - which Washington believes is based in Pakistan's North Waziristan region and which it blames for high-profile attacks in Kabul in April - could not be ruled out.",78,85,network,2,0,2
3AC6MFV69KJA6ZSU1KXMLTH5NFRHZ8,"But America's Kabul ambassador, Ryan Crocker, said involvement of the Haqqani network - which Washington believes is based in Pakistan's North Waziristan region and which it blames for high-profile attacks in Kabul in April - could not be ruled out.",174,180,blames,0,3,3
3AC6MFV69KJA6ZSU1KXMLTH5NFRHZ8,"But America's Kabul ambassador, Ryan Crocker, said involvement of the Haqqani network - which Washington believes is based in Pakistan's North Waziristan region and which it blames for high-profile attacks in Kabul in April - could not be ruled out.",185,197,high-profile,7,4,11
3AC6MFV69KJA6ZSU1KXMLTH5NFRHZ8,"But America's Kabul ambassador, Ryan Crocker, said involvement of the Haqqani network - which Washington believes is based in Pakistan's North Waziristan region and which it blames for high-profile attacks in Kabul in April - could not be ruled out.",185,205,high-profile attacks,2,4,6
3AC6MFV69KJA6ZSU1KXMLTH5NFRHZ8,"But America's Kabul ambassador, Ryan Crocker, said involvement of the Haqqani network - which Washington believes is based in Pakistan's North Waziristan region and which it blames for high-profile attacks in Kabul in April - could not be ruled out.",239,244,ruled,0,1,1
3AC6MFV69KJA6ZSU1KXMLTH5NFRHZ8,"But America's Kabul ambassador, Ryan Crocker, said involvement of the Haqqani network - which Washington believes is based in Pakistan's North Waziristan region and which it blames for high-profile attacks in Kabul in April - could not be ruled out.",239,248,ruled out,2,2,4
3AC6MFV69KJA6ZSU1KXMLTH5NFRHZ8,"On the anniversary of bin Laden's killing, Crocker said he did not believe there would be a sole turning point in the war.",7,18,anniversary,1,2,3
3AC6MFV69KJA6ZSU1KXMLTH5NFRHZ8,"On the anniversary of bin Laden's killing, Crocker said he did not believe there would be a sole turning point in the war.",43,50,Crocker,0,1,1
3AC6MFV69KJA6ZSU1KXMLTH5NFRHZ8,"On the anniversary of bin Laden's killing, Crocker said he did not believe there would be a sole turning point in the war.",67,74,believe,0,1,1
3AC6MFV69KJA6ZSU1KXMLTH5NFRHZ8,"On the anniversary of bin Laden's killing, Crocker said he did not believe there would be a sole turning point in the war.",92,96,sole,8,2,10
3AC6MFV69KJA6ZSU1KXMLTH5NFRHZ8,"On the anniversary of bin Laden's killing, Crocker said he did not believe there would be a sole turning point in the war.",92,110,sole turning point,5,2,7
3AC6MFV69KJA6ZSU1KXMLTH5NFRHZ8,"On the anniversary of bin Laden's killing, Crocker said he did not believe there would be a sole turning point in the war.",97,110,turning point,2,3,5
3GONHBMNHVZWYDT5SHDZDYP152EMZD,Opposition parties and international observers said the poll was marred by widespread reports and allegations of vote-rigging.,0,10,Opposition,4,0,4
3GONHBMNHVZWYDT5SHDZDYP152EMZD,Opposition parties and international observers said the poll was marred by widespread reports and allegations of vote-rigging.,0,18,Opposition parties,1,1,2
3GONHBMNHVZWYDT5SHDZDYP152EMZD,Opposition parties and international observers said the poll was marred by widespread reports and allegations of vote-rigging.,23,36,international,2,0,2
3GONHBMNHVZWYDT5SHDZDYP152EMZD,Opposition parties and international observers said the poll was marred by widespread reports and allegations of vote-rigging.,23,46,international observers,2,1,3
3GONHBMNHVZWYDT5SHDZDYP152EMZD,Opposition parties and international observers said the poll was marred by widespread reports and allegations of vote-rigging.,37,46,observers,1,1,2
3GONHBMNHVZWYDT5SHDZDYP152EMZD,Opposition parties and international observers said the poll was marred by widespread reports and allegations of vote-rigging.,56,60,poll,1,1,2
3GONHBMNHVZWYDT5SHDZDYP152EMZD,Opposition parties and international observers said the poll was marred by widespread reports and allegations of vote-rigging.,56,71,poll was marred,0,1,1
3GONHBMNHVZWYDT5SHDZDYP152EMZD,Opposition parties and international observers said the poll was marred by widespread reports and allegations of vote-rigging.,61,71,was marred,0,1,1
3GONHBMNHVZWYDT5SHDZDYP152EMZD,Opposition parties and international observers said the poll was marred by widespread reports and allegations of vote-rigging.,65,71,marred,7,10,17
3GONHBMNHVZWYDT5SHDZDYP152EMZD,Opposition parties and international observers said the poll was marred by widespread reports and allegations of vote-rigging.,75,85,widespread,5,4,9
3GONHBMNHVZWYDT5SHDZDYP152EMZD,Opposition parties and international observers said the poll was marred by widespread reports and allegations of vote-rigging.,98,109,allegations,7,8,15
3GONHBMNHVZWYDT5SHDZDYP152EMZD,Opposition parties and international observers said the poll was marred by widespread reports and allegations of vote-rigging.,98,125,allegations of vote-rigging,1,0,1
3GONHBMNHVZWYDT5SHDZDYP152EMZD,Opposition parties and international observers said the poll was marred by widespread reports and allegations of vote-rigging.,113,125,vote-rigging,8,10,18
3GONHBMNHVZWYDT5SHDZDYP152EMZD,"The allegations have fired up the opposition, which has long seen its protests crushed and its pleas ignored by the Kremlin-dominated media.",4,15,allegations,6,4,10
3GONHBMNHVZWYDT5SHDZDYP152EMZD,"The allegations have fired up the opposition, which has long seen its protests crushed and its pleas ignored by the Kremlin-dominated media.",21,29,fired up,0,1,1
3GONHBMNHVZWYDT5SHDZDYP152EMZD,"The allegations have fired up the opposition, which has long seen its protests crushed and its pleas ignored by the Kremlin-dominated media.",34,44,opposition,2,0,2
3GONHBMNHVZWYDT5SHDZDYP152EMZD,"The allegations have fired up the opposition, which has long seen its protests crushed and its pleas ignored by the Kremlin-dominated media.",70,78,protests,0,1,1
3GONHBMNHVZWYDT5SHDZDYP152EMZD,"The allegations have fired up the opposition, which has long seen its protests crushed and its pleas ignored by the Kremlin-dominated media.",70,86,protests crushed,0,2,2
3GONHBMNHVZWYDT5SHDZDYP152EMZD,"The allegations have fired up the opposition, which has long seen its protests crushed and its pleas ignored by the Kremlin-dominated media.",79,86,crushed,0,1,1
3GONHBMNHVZWYDT5SHDZDYP152EMZD,"The allegations have fired up the opposition, which has long seen its protests crushed and its pleas ignored by the Kremlin-dominated media.",95,100,pleas,3,9,12
3GONHBMNHVZWYDT5SHDZDYP152EMZD,"The allegations have fired up the opposition, which has long seen its protests crushed and its pleas ignored by the Kremlin-dominated media.",101,108,ignored,1,0,1
3GONHBMNHVZWYDT5SHDZDYP152EMZD,"The allegations have fired up the opposition, which has long seen its protests crushed and its pleas ignored by the Kremlin-dominated media.",116,133,Kremlin-dominated,5,1,6
3GONHBMNHVZWYDT5SHDZDYP152EMZD,"The allegations have fired up the opposition, which has long seen its protests crushed and its pleas ignored by the Kremlin-dominated media.",116,139,Kremlin-dominated media,3,1,4
3GONHBMNHVZWYDT5SHDZDYP152EMZD,"On Facebook, more than 10,000 people signed up to a page announcing an opposition rally for Saturday.",57,67,announcing,2,1,3
3GONHBMNHVZWYDT5SHDZDYP152EMZD,"On Facebook, more than 10,000 people signed up to a page announcing an opposition rally for Saturday.",71,81,opposition,3,0,3
3GONHBMNHVZWYDT5SHDZDYP152EMZD,"On Facebook, more than 10,000 people signed up to a page announcing an opposition rally for Saturday.",71,87,opposition rally,0,1,1
3GONHBMNHVZWYDT5SHDZDYP152EMZD,"On Facebook, more than 10,000 people signed up to a page announcing an opposition rally for Saturday.",82,87,rally,0,2,2
3GONHBMNHVZWYDT5SHDZDYP152EMZD,"Authorities said Tuesday that at least 51,500 police officers and 2,000 Interior Ministry troops have been deployed in Moscow since the election.",72,89,Interior Ministry,0,1,1
3GONHBMNHVZWYDT5SHDZDYP152EMZD,"Authorities said Tuesday that at least 51,500 police officers and 2,000 Interior Ministry troops have been deployed in Moscow since the election.",72,96,Interior Ministry troops,2,1,3
3GONHBMNHVZWYDT5SHDZDYP152EMZD,"Authorities said Tuesday that at least 51,500 police officers and 2,000 Interior Ministry troops have been deployed in Moscow since the election.",107,115,deployed,5,6,11
3GONHBMNHVZWYDT5SHDZDYP152EMZD,"Unlike the police, Interior Ministry troops are an armed force, largely manned by conscripts.",19,27,Interior,1,0,1
3GONHBMNHVZWYDT5SHDZDYP152EMZD,"Unlike the police, Interior Ministry troops are an armed force, largely manned by conscripts.",51,62,armed force,0,1,1
3GONHBMNHVZWYDT5SHDZDYP152EMZD,"Unlike the police, Interior Ministry troops are an armed force, largely manned by conscripts.",72,78,manned,5,7,12
3GONHBMNHVZWYDT5SHDZDYP152EMZD,"Unlike the police, Interior Ministry troops are an armed force, largely manned by conscripts.",72,92,manned by conscripts,1,1,2
3GONHBMNHVZWYDT5SHDZDYP152EMZD,"Unlike the police, Interior Ministry troops are an armed force, largely manned by conscripts.",82,92,conscripts,10,9,19
3GONHBMNHVZWYDT5SHDZDYP152EMZD,"On Wednesday, Muscovites spotted dozens of helicopters patrolling the city — a rare sight in the capital.",14,24,Muscovites,2,0,2
3GONHBMNHVZWYDT5SHDZDYP152EMZD,"On Wednesday, Muscovites spotted dozens of helicopters patrolling the city — a rare sight in the capital.",25,32,spotted,0,4,4
3GONHBMNHVZWYDT5SHDZDYP152EMZD,"On Wednesday, Muscovites spotted dozens of helicopters patrolling the city — a rare sight in the capital.",55,65,patrolling,4,3,7
3GONHBMNHVZWYDT5SHDZDYP152EMZD,"On Wednesday, Muscovites spotted dozens of helicopters patrolling the city — a rare sight in the capital.",79,83,rare,1,0,1
3GONHBMNHVZWYDT5SHDZDYP152EMZD,"On Wednesday, Muscovites spotted dozens of helicopters patrolling the city — a rare sight in the capital.",84,89,sight,0,2,2
3GONHBMNHVZWYDT5SHDZDYP152EMZD,The trial of the former Bosnia Serb army commander Ratko Mladic is due to begin today.Mladic stands accused of 11 counts of wars crimes and crimes against humanity.He is accused of leading a brutal campaign of ethnic cleansing during the Bosnian war between 1992 and 1995.,41,50,commander,2,0,2
3GONHBMNHVZWYDT5SHDZDYP152EMZD,The trial of the former Bosnia Serb army commander Ratko Mladic is due to begin today.Mladic stands accused of 11 counts of wars crimes and crimes against humanity.He is accused of leading a brutal campaign of ethnic cleansing during the Bosnian war between 1992 and 1995.,100,107,accused,3,1,4
3GONHBMNHVZWYDT5SHDZDYP152EMZD,The trial of the former Bosnia Serb army commander Ratko Mladic is due to begin today.Mladic stands accused of 11 counts of wars crimes and crimes against humanity.He is accused of leading a brutal campaign of ethnic cleansing during the Bosnian war between 1992 and 1995.,140,163,crimes against humanity,2,0,2
3GONHBMNHVZWYDT5SHDZDYP152EMZD,The trial of the former Bosnia Serb army commander Ratko Mladic is due to begin today.Mladic stands accused of 11 counts of wars crimes and crimes against humanity.He is accused of leading a brutal campaign of ethnic cleansing during the Bosnian war between 1992 and 1995.,155,163,humanity,4,0,4
3GONHBMNHVZWYDT5SHDZDYP152EMZD,The trial of the former Bosnia Serb army commander Ratko Mladic is due to begin today.Mladic stands accused of 11 counts of wars crimes and crimes against humanity.He is accused of leading a brutal campaign of ethnic cleansing during the Bosnian war between 1992 and 1995.,170,177,accused,1,0,1
3GONHBMNHVZWYDT5SHDZDYP152EMZD,The trial of the former Bosnia Serb army commander Ratko Mladic is due to begin today.Mladic stands accused of 11 counts of wars crimes and crimes against humanity.He is accused of leading a brutal campaign of ethnic cleansing during the Bosnian war between 1992 and 1995.,191,197,brutal,3,2,5
3GONHBMNHVZWYDT5SHDZDYP152EMZD,The trial of the former Bosnia Serb army commander Ratko Mladic is due to begin today.Mladic stands accused of 11 counts of wars crimes and crimes against humanity.He is accused of leading a brutal campaign of ethnic cleansing during the Bosnian war between 1992 and 1995.,191,206,brutal campaign,2,1,3
3GONHBMNHVZWYDT5SHDZDYP152EMZD,The trial of the former Bosnia Serb army commander Ratko Mladic is due to begin today.Mladic stands accused of 11 counts of wars crimes and crimes against humanity.He is accused of leading a brutal campaign of ethnic cleansing during the Bosnian war between 1992 and 1995.,191,226,brutal campaign of ethnic cleansing,0,1,1
3GONHBMNHVZWYDT5SHDZDYP152EMZD,The trial of the former Bosnia Serb army commander Ratko Mladic is due to begin today.Mladic stands accused of 11 counts of wars crimes and crimes against humanity.He is accused of leading a brutal campaign of ethnic cleansing during the Bosnian war between 1992 and 1995.,210,216,ethnic,1,1,2
3GONHBMNHVZWYDT5SHDZDYP152EMZD,The trial of the former Bosnia Serb army commander Ratko Mladic is due to begin today.Mladic stands accused of 11 counts of wars crimes and crimes against humanity.He is accused of leading a brutal campaign of ethnic cleansing during the Bosnian war between 1992 and 1995.,210,226,ethnic cleansing,6,5,11
3GONHBMNHVZWYDT5SHDZDYP152EMZD,The trial of the former Bosnia Serb army commander Ratko Mladic is due to begin today.Mladic stands accused of 11 counts of wars crimes and crimes against humanity.He is accused of leading a brutal campaign of ethnic cleansing during the Bosnian war between 1992 and 1995.,217,226,cleansing,1,1,2
32204AGAABDAFIXPBS9X0M1ZDQLHGA,That prompted the Chinese surveillance ships to insert themselves into the situation.,5,13,prompted,3,10,13
32204AGAABDAFIXPBS9X0M1ZDQLHGA,That prompted the Chinese surveillance ships to insert themselves into the situation.,26,38,surveillance,8,10,18
32204AGAABDAFIXPBS9X0M1ZDQLHGA,That prompted the Chinese surveillance ships to insert themselves into the situation.,26,44,surveillance ships,2,4,6
32204AGAABDAFIXPBS9X0M1ZDQLHGA,That prompted the Chinese surveillance ships to insert themselves into the situation.,48,54,insert,3,3,6
32204AGAABDAFIXPBS9X0M1ZDQLHGA,That prompted the Chinese surveillance ships to insert themselves into the situation.,48,65,insert themselves,0,1,1
32204AGAABDAFIXPBS9X0M1ZDQLHGA,That prompted the Chinese surveillance ships to insert themselves into the situation.,75,84,situation,1,1,2
32204AGAABDAFIXPBS9X0M1ZDQLHGA,"The Chinese Embassy said it got in touch with the Philippine Foreign Affairs Department and reiterated China's claim of sovereignty over Huangyan Island, urging the Philippine to leave the area, GMA said.",12,19,Embassy,0,2,2
32204AGAABDAFIXPBS9X0M1ZDQLHGA,"The Chinese Embassy said it got in touch with the Philippine Foreign Affairs Department and reiterated China's claim of sovereignty over Huangyan Island, urging the Philippine to leave the area, GMA said.",28,40,got in touch,0,1,1
32204AGAABDAFIXPBS9X0M1ZDQLHGA,"The Chinese Embassy said it got in touch with the Philippine Foreign Affairs Department and reiterated China's claim of sovereignty over Huangyan Island, urging the Philippine to leave the area, GMA said.",32,45,in touch with,0,1,1
32204AGAABDAFIXPBS9X0M1ZDQLHGA,"The Chinese Embassy said it got in touch with the Philippine Foreign Affairs Department and reiterated China's claim of sovereignty over Huangyan Island, urging the Philippine to leave the area, GMA said.",92,102,reiterated,10,10,20
32204AGAABDAFIXPBS9X0M1ZDQLHGA,"The Chinese Embassy said it got in touch with the Philippine Foreign Affairs Department and reiterated China's claim of sovereignty over Huangyan Island, urging the Philippine to leave the area, GMA said.",111,116,claim,0,1,1
32204AGAABDAFIXPBS9X0M1ZDQLHGA,"The Chinese Embassy said it got in touch with the Philippine Foreign Affairs Department and reiterated China's claim of sovereignty over Huangyan Island, urging the Philippine to leave the area, GMA said.",111,131,claim of sovereignty,2,0,2
32204AGAABDAFIXPBS9X0M1ZDQLHGA,"The Chinese Embassy said it got in touch with the Philippine Foreign Affairs Department and reiterated China's claim of sovereignty over Huangyan Island, urging the Philippine to leave the area, GMA said.",120,131,sovereignty,6,10,16
32204AGAABDAFIXPBS9X0M1ZDQLHGA,"The Chinese Embassy said it got in touch with the Philippine Foreign Affairs Department and reiterated China's claim of sovereignty over Huangyan Island, urging the Philippine to leave the area, GMA said.",120,136,sovereignty over,0,1,1
32204AGAABDAFIXPBS9X0M1ZDQLHGA,"The Chinese Embassy said it got in touch with the Philippine Foreign Affairs Department and reiterated China's claim of sovereignty over Huangyan Island, urging the Philippine to leave the area, GMA said.",154,160,urging,2,9,11
32204AGAABDAFIXPBS9X0M1ZDQLHGA,"Israeli ambassador to Egypt Yitzhak Levanon who is due to be replaced in the coming weeks has returned to Cairo, media reports said on Sunday.",8,18,ambassador,0,3,3
32204AGAABDAFIXPBS9X0M1ZDQLHGA,"Israeli ambassador to Egypt Yitzhak Levanon who is due to be replaced in the coming weeks has returned to Cairo, media reports said on Sunday.",61,69,replaced,0,1,1
32204AGAABDAFIXPBS9X0M1ZDQLHGA,"Israeli ambassador to Egypt Yitzhak Levanon who is due to be replaced in the coming weeks has returned to Cairo, media reports said on Sunday.",113,118,media,1,0,1
32204AGAABDAFIXPBS9X0M1ZDQLHGA,"Israeli ambassador to Egypt Yitzhak Levanon who is due to be replaced in the coming weeks has returned to Cairo, media reports said on Sunday.",113,126,media reports,1,0,1
32204AGAABDAFIXPBS9X0M1ZDQLHGA,"He was airlifted out of Egypt when thousands of angry protesters attacked the embassy in September in response to the killing of six Egyptian soldiers by Israeli forces in Sinai, in what Israel said was involuntary manslaughter.",7,16,airlifted,4,9,13
32204AGAABDAFIXPBS9X0M1ZDQLHGA,"He was airlifted out of Egypt when thousands of angry protesters attacked the embassy in September in response to the killing of six Egyptian soldiers by Israeli forces in Sinai, in what Israel said was involuntary manslaughter.",48,64,angry protesters,0,1,1
32204AGAABDAFIXPBS9X0M1ZDQLHGA,"He was airlifted out of Egypt when thousands of angry protesters attacked the embassy in September in response to the killing of six Egyptian soldiers by Israeli forces in Sinai, in what Israel said was involuntary manslaughter.",54,64,protesters,2,1,3
32204AGAABDAFIXPBS9X0M1ZDQLHGA,"He was airlifted out of Egypt when thousands of angry protesters attacked the embassy in September in response to the killing of six Egyptian soldiers by Israeli forces in Sinai, in what Israel said was involuntary manslaughter.",78,85,embassy,0,3,3
32204AGAABDAFIXPBS9X0M1ZDQLHGA,"He was airlifted out of Egypt when thousands of angry protesters attacked the embassy in September in response to the killing of six Egyptian soldiers by Israeli forces in Sinai, in what Israel said was involuntary manslaughter.",203,214,involuntary,1,4,5
32204AGAABDAFIXPBS9X0M1ZDQLHGA,"He was airlifted out of Egypt when thousands of angry protesters attacked the embassy in September in response to the killing of six Egyptian soldiers by Israeli forces in Sinai, in what Israel said was involuntary manslaughter.",203,227,involuntary manslaughter,8,5,13
32204AGAABDAFIXPBS9X0M1ZDQLHGA,"He was airlifted out of Egypt when thousands of angry protesters attacked the embassy in September in response to the killing of six Egyptian soldiers by Israeli forces in Sinai, in what Israel said was involuntary manslaughter.",215,227,manslaughter,3,9,12
32204AGAABDAFIXPBS9X0M1ZDQLHGA,Tel Aviv expressed its official apologies to Cairo on the incident.,9,18,expressed,2,2,4
32204AGAABDAFIXPBS9X0M1ZDQLHGA,Tel Aviv expressed its official apologies to Cairo on the incident.,23,41,official apologies,1,0,1
32204AGAABDAFIXPBS9X0M1ZDQLHGA,Tel Aviv expressed its official apologies to Cairo on the incident.,32,41,apologies,1,3,4
32204AGAABDAFIXPBS9X0M1ZDQLHGA,Tel Aviv expressed its official apologies to Cairo on the incident.,58,66,incident,2,2,4
32204AGAABDAFIXPBS9X0M1ZDQLHGA,Levanon is expected to stay in Cairo for two days to hold a series of farewell meetings with Egyptian officials.,50,57,to hold,0,1,1
32204AGAABDAFIXPBS9X0M1ZDQLHGA,Levanon is expected to stay in Cairo for two days to hold a series of farewell meetings with Egyptian officials.,60,66,series,1,0,1
32204AGAABDAFIXPBS9X0M1ZDQLHGA,Levanon is expected to stay in Cairo for two days to hold a series of farewell meetings with Egyptian officials.,70,78,farewell,3,5,8
32204AGAABDAFIXPBS9X0M1ZDQLHGA,Levanon is expected to stay in Cairo for two days to hold a series of farewell meetings with Egyptian officials.,70,87,farewell meetings,2,3,5
3SCKNODZ0XHJWL8ZLN0GZTL20ZBN7M,A huge security operation has covered Moscow in a show of force following protests over scandal-marred elections that saw Prime Minister Vladimir Putin's party struggle to keep a majority.,7,25,security operation,3,1,4
3SCKNODZ0XHJWL8ZLN0GZTL20ZBN7M,A huge security operation has covered Moscow in a show of force following protests over scandal-marred elections that saw Prime Minister Vladimir Putin's party struggle to keep a majority.,16,25,operation,0,1,1
3SCKNODZ0XHJWL8ZLN0GZTL20ZBN7M,A huge security operation has covered Moscow in a show of force following protests over scandal-marred elections that saw Prime Minister Vladimir Putin's party struggle to keep a majority.,38,44,Moscow,0,1,1
3SCKNODZ0XHJWL8ZLN0GZTL20ZBN7M,A huge security operation has covered Moscow in a show of force following protests over scandal-marred elections that saw Prime Minister Vladimir Putin's party struggle to keep a majority.,50,63,show of force,1,0,1
3SCKNODZ0XHJWL8ZLN0GZTL20ZBN7M,A huge security operation has covered Moscow in a show of force following protests over scandal-marred elections that saw Prime Minister Vladimir Putin's party struggle to keep a majority.,74,82,protests,0,1,1
3SCKNODZ0XHJWL8ZLN0GZTL20ZBN7M,A huge security operation has covered Moscow in a show of force following protests over scandal-marred elections that saw Prime Minister Vladimir Putin's party struggle to keep a majority.,88,102,scandal-marred,10,10,20
3SCKNODZ0XHJWL8ZLN0GZTL20ZBN7M,A huge security operation has covered Moscow in a show of force following protests over scandal-marred elections that saw Prime Minister Vladimir Putin's party struggle to keep a majority.,88,112,scandal-marred elections,0,1,1
3SCKNODZ0XHJWL8ZLN0GZTL20ZBN7M,A huge security operation has covered Moscow in a show of force following protests over scandal-marred elections that saw Prime Minister Vladimir Putin's party struggle to keep a majority.,160,168,struggle,0,4,4
3SCKNODZ0XHJWL8ZLN0GZTL20ZBN7M,A huge security operation has covered Moscow in a show of force following protests over scandal-marred elections that saw Prime Minister Vladimir Putin's party struggle to keep a majority.,179,187,majority,2,0,2
3SCKNODZ0XHJWL8ZLN0GZTL20ZBN7M,Demonstrations on Monday and Tuesday were an unusually sustained show of indignation for the Russian opposition.,0,14,Demonstrations,5,4,9
3SCKNODZ0XHJWL8ZLN0GZTL20ZBN7M,Demonstrations on Monday and Tuesday were an unusually sustained show of indignation for the Russian opposition.,45,54,unusually,1,1,2
3SCKNODZ0XHJWL8ZLN0GZTL20ZBN7M,Demonstrations on Monday and Tuesday were an unusually sustained show of indignation for the Russian opposition.,45,64,unusually sustained,0,1,1
3SCKNODZ0XHJWL8ZLN0GZTL20ZBN7M,Demonstrations on Monday and Tuesday were an unusually sustained show of indignation for the Russian opposition.,45,69,unusually sustained show,0,1,1
3SCKNODZ0XHJWL8ZLN0GZTL20ZBN7M,Demonstrations on Monday and Tuesday were an unusually sustained show of indignation for the Russian opposition.,55,64,sustained,9,6,15
3SCKNODZ0XHJWL8ZLN0GZTL20ZBN7M,Demonstrations on Monday and Tuesday were an unusually sustained show of indignation for the Russian opposition.,65,84,show of indignation,1,0,1
3SCKNODZ0XHJWL8ZLN0GZTL20ZBN7M,Demonstrations on Monday and Tuesday were an unusually sustained show of indignation for the Russian opposition.,73,84,indignation,10,10,20
3SCKNODZ0XHJWL8ZLN0GZTL20ZBN7M,Demonstrations on Monday and Tuesday were an unusually sustained show of indignation for the Russian opposition.,101,111,opposition,3,0,3
3SCKNODZ0XHJWL8ZLN0GZTL20ZBN7M,"The thousands of Russians who rallied in Moscow and St Petersburg faced police and Interior Ministry troops, who detained hundreds of protesters.",30,37,rallied,2,7,9
3SCKNODZ0XHJWL8ZLN0GZTL20ZBN7M,"The thousands of Russians who rallied in Moscow and St Petersburg faced police and Interior Ministry troops, who detained hundreds of protesters.",83,100,Interior Ministry,0,1,1
3SCKNODZ0XHJWL8ZLN0GZTL20ZBN7M,"The thousands of Russians who rallied in Moscow and St Petersburg faced police and Interior Ministry troops, who detained hundreds of protesters.",83,107,Interior Ministry troops,1,0,1
3SCKNODZ0XHJWL8ZLN0GZTL20ZBN7M,"The thousands of Russians who rallied in Moscow and St Petersburg faced police and Interior Ministry troops, who detained hundreds of protesters.",113,121,detained,4,7,11
3SCKNODZ0XHJWL8ZLN0GZTL20ZBN7M,"The thousands of Russians who rallied in Moscow and St Petersburg faced police and Interior Ministry troops, who detained hundreds of protesters.",134,144,protesters,2,2,4
3SCKNODZ0XHJWL8ZLN0GZTL20ZBN7M,"Sunday's parliamentary vote suggested Russians are tiring of Mr Putin and his United Russia party and allegations of vote-rigging have fired up the opposition, which has long seen its protests crushed and its pleas ignored by the Kremlin-dominated media.",9,22,parliamentary,6,1,7
3SCKNODZ0XHJWL8ZLN0GZTL20ZBN7M,"Sunday's parliamentary vote suggested Russians are tiring of Mr Putin and his United Russia party and allegations of vote-rigging have fired up the opposition, which has long seen its protests crushed and its pleas ignored by the Kremlin-dominated media.",28,37,suggested,1,1,2
3SCKNODZ0XHJWL8ZLN0GZTL20ZBN7M,"Sunday's parliamentary vote suggested Russians are tiring of Mr Putin and his United Russia party and allegations of vote-rigging have fired up the opposition, which has long seen its protests crushed and its pleas ignored by the Kremlin-dominated media.",51,57,tiring,0,3,3
3SCKNODZ0XHJWL8ZLN0GZTL20ZBN7M,"Sunday's parliamentary vote suggested Russians are tiring of Mr Putin and his United Russia party and allegations of vote-rigging have fired up the opposition, which has long seen its protests crushed and its pleas ignored by the Kremlin-dominated media.",102,113,allegations,5,10,15
3SCKNODZ0XHJWL8ZLN0GZTL20ZBN7M,"Sunday's parliamentary vote suggested Russians are tiring of Mr Putin and his United Russia party and allegations of vote-rigging have fired up the opposition, which has long seen its protests crushed and its pleas ignored by the Kremlin-dominated media.",117,129,vote-rigging,9,10,19
3SCKNODZ0XHJWL8ZLN0GZTL20ZBN7M,"Sunday's parliamentary vote suggested Russians are tiring of Mr Putin and his United Russia party and allegations of vote-rigging have fired up the opposition, which has long seen its protests crushed and its pleas ignored by the Kremlin-dominated media.",135,143,fired up,1,0,1
3SCKNODZ0XHJWL8ZLN0GZTL20ZBN7M,"Sunday's parliamentary vote suggested Russians are tiring of Mr Putin and his United Russia party and allegations of vote-rigging have fired up the opposition, which has long seen its protests crushed and its pleas ignored by the Kremlin-dominated media.",148,158,opposition,2,0,2
3SCKNODZ0XHJWL8ZLN0GZTL20ZBN7M,"Sunday's parliamentary vote suggested Russians are tiring of Mr Putin and his United Russia party and allegations of vote-rigging have fired up the opposition, which has long seen its protests crushed and its pleas ignored by the Kremlin-dominated media.",193,200,crushed,2,1,3
3SCKNODZ0XHJWL8ZLN0GZTL20ZBN7M,"Sunday's parliamentary vote suggested Russians are tiring of Mr Putin and his United Russia party and allegations of vote-rigging have fired up the opposition, which has long seen its protests crushed and its pleas ignored by the Kremlin-dominated media.",209,214,pleas,3,3,6
3SCKNODZ0XHJWL8ZLN0GZTL20ZBN7M,"Sunday's parliamentary vote suggested Russians are tiring of Mr Putin and his United Russia party and allegations of vote-rigging have fired up the opposition, which has long seen its protests crushed and its pleas ignored by the Kremlin-dominated media.",215,222,ignored,0,2,2
3SCKNODZ0XHJWL8ZLN0GZTL20ZBN7M,"Sunday's parliamentary vote suggested Russians are tiring of Mr Putin and his United Russia party and allegations of vote-rigging have fired up the opposition, which has long seen its protests crushed and its pleas ignored by the Kremlin-dominated media.",230,247,Kremlin-dominated,5,0,5
3SCKNODZ0XHJWL8ZLN0GZTL20ZBN7M,"Sunday's parliamentary vote suggested Russians are tiring of Mr Putin and his United Russia party and allegations of vote-rigging have fired up the opposition, which has long seen its protests crushed and its pleas ignored by the Kremlin-dominated media.",230,253,Kremlin-dominated media,1,1,2
3SCKNODZ0XHJWL8ZLN0GZTL20ZBN7M,At least 300 people were detained by police at a protest in central Moscow on Tuesday night.,25,33,detained,5,3,8
3YLTXLH3DF7GSVQOEBZKUVFREH8HPE,"China has regularly dismissed the protests, saying Beijing has indisputable sovereignty over those areas on historical grounds.",10,29,regularly dismissed,1,0,1
3YLTXLH3DF7GSVQOEBZKUVFREH8HPE,"China has regularly dismissed the protests, saying Beijing has indisputable sovereignty over those areas on historical grounds.",10,42,regularly dismissed the protests,1,0,1
3YLTXLH3DF7GSVQOEBZKUVFREH8HPE,"China has regularly dismissed the protests, saying Beijing has indisputable sovereignty over those areas on historical grounds.",20,29,dismissed,5,5,10
3YLTXLH3DF7GSVQOEBZKUVFREH8HPE,"China has regularly dismissed the protests, saying Beijing has indisputable sovereignty over those areas on historical grounds.",34,42,protests,0,3,3
3YLTXLH3DF7GSVQOEBZKUVFREH8HPE,"China has regularly dismissed the protests, saying Beijing has indisputable sovereignty over those areas on historical grounds.",63,75,indisputable,6,6,12
3YLTXLH3DF7GSVQOEBZKUVFREH8HPE,"China has regularly dismissed the protests, saying Beijing has indisputable sovereignty over those areas on historical grounds.",63,87,indisputable sovereignty,8,5,13
3YLTXLH3DF7GSVQOEBZKUVFREH8HPE,"China has regularly dismissed the protests, saying Beijing has indisputable sovereignty over those areas on historical grounds.",76,87,sovereignty,6,10,16
3YLTXLH3DF7GSVQOEBZKUVFREH8HPE,"China has regularly dismissed the protests, saying Beijing has indisputable sovereignty over those areas on historical grounds.",108,118,historical,2,0,2
3YLTXLH3DF7GSVQOEBZKUVFREH8HPE,"China has regularly dismissed the protests, saying Beijing has indisputable sovereignty over those areas on historical grounds.",108,126,historical grounds,2,2,4
3YLTXLH3DF7GSVQOEBZKUVFREH8HPE,"Israel's outgoing ambassador to Egypt arrived in Cairo on Sunday to bid farewell to former colleagues, after an attack on the Israeli mission in September forced its evacuation, according to a spokesman at Israel's Foreign Ministry in Jerusalem.",9,17,outgoing,1,2,3
3YLTXLH3DF7GSVQOEBZKUVFREH8HPE,"Israel's outgoing ambassador to Egypt arrived in Cairo on Sunday to bid farewell to former colleagues, after an attack on the Israeli mission in September forced its evacuation, according to a spokesman at Israel's Foreign Ministry in Jerusalem.",9,28,outgoing ambassador,1,1,2
3YLTXLH3DF7GSVQOEBZKUVFREH8HPE,"Israel's outgoing ambassador to Egypt arrived in Cairo on Sunday to bid farewell to former colleagues, after an attack on the Israeli mission in September forced its evacuation, according to a spokesman at Israel's Foreign Ministry in Jerusalem.",18,28,ambassador,7,3,10
3YLTXLH3DF7GSVQOEBZKUVFREH8HPE,"Israel's outgoing ambassador to Egypt arrived in Cairo on Sunday to bid farewell to former colleagues, after an attack on the Israeli mission in September forced its evacuation, according to a spokesman at Israel's Foreign Ministry in Jerusalem.",68,71,bid,0,1,1
3YLTXLH3DF7GSVQOEBZKUVFREH8HPE,"Israel's outgoing ambassador to Egypt arrived in Cairo on Sunday to bid farewell to former colleagues, after an attack on the Israeli mission in September forced its evacuation, according to a spokesman at Israel's Foreign Ministry in Jerusalem.",68,80,bid farewell,1,1,2
3YLTXLH3DF7GSVQOEBZKUVFREH8HPE,"Israel's outgoing ambassador to Egypt arrived in Cairo on Sunday to bid farewell to former colleagues, after an attack on the Israeli mission in September forced its evacuation, according to a spokesman at Israel's Foreign Ministry in Jerusalem.",72,80,farewell,1,8,9
3YLTXLH3DF7GSVQOEBZKUVFREH8HPE,"Israel's outgoing ambassador to Egypt arrived in Cairo on Sunday to bid farewell to former colleagues, after an attack on the Israeli mission in September forced its evacuation, according to a spokesman at Israel's Foreign Ministry in Jerusalem.",91,101,colleagues,2,1,3
3YLTXLH3DF7GSVQOEBZKUVFREH8HPE,"Israel's outgoing ambassador to Egypt arrived in Cairo on Sunday to bid farewell to former colleagues, after an attack on the Israeli mission in September forced its evacuation, according to a spokesman at Israel's Foreign Ministry in Jerusalem.",166,176,evacuation,10,10,20
3YLTXLH3DF7GSVQOEBZKUVFREH8HPE,"Israel's outgoing ambassador to Egypt arrived in Cairo on Sunday to bid farewell to former colleagues, after an attack on the Israeli mission in September forced its evacuation, according to a spokesman at Israel's Foreign Ministry in Jerusalem.",193,202,spokesman,3,3,6
3YLTXLH3DF7GSVQOEBZKUVFREH8HPE,"Yitzhak Levanon, who will be retiring at the end of the month, departed to Cairo for several days in order to bid farewell to friends and colleagues, Foreign Ministry deputy spokesman Lior Ben-Dor told Xinhua.",9,16,Levanon,0,1,1
3YLTXLH3DF7GSVQOEBZKUVFREH8HPE,"Yitzhak Levanon, who will be retiring at the end of the month, departed to Cairo for several days in order to bid farewell to friends and colleagues, Foreign Ministry deputy spokesman Lior Ben-Dor told Xinhua.",30,38,retiring,1,2,3
3YLTXLH3DF7GSVQOEBZKUVFREH8HPE,"Yitzhak Levanon, who will be retiring at the end of the month, departed to Cairo for several days in order to bid farewell to friends and colleagues, Foreign Ministry deputy spokesman Lior Ben-Dor told Xinhua.",64,72,departed,1,3,4
3YLTXLH3DF7GSVQOEBZKUVFREH8HPE,"Yitzhak Levanon, who will be retiring at the end of the month, departed to Cairo for several days in order to bid farewell to friends and colleagues, Foreign Ministry deputy spokesman Lior Ben-Dor told Xinhua.",111,123,bid farewell,2,0,2
3YLTXLH3DF7GSVQOEBZKUVFREH8HPE,"Yitzhak Levanon, who will be retiring at the end of the month, departed to Cairo for several days in order to bid farewell to friends and colleagues, Foreign Ministry deputy spokesman Lior Ben-Dor told Xinhua.",115,123,farewell,1,2,3
3YLTXLH3DF7GSVQOEBZKUVFREH8HPE,"Yitzhak Levanon, who will be retiring at the end of the month, departed to Cairo for several days in order to bid farewell to friends and colleagues, Foreign Ministry deputy spokesman Lior Ben-Dor told Xinhua.",139,149,colleagues,3,1,4
3YLTXLH3DF7GSVQOEBZKUVFREH8HPE,"Yitzhak Levanon, who will be retiring at the end of the month, departed to Cairo for several days in order to bid farewell to friends and colleagues, Foreign Ministry deputy spokesman Lior Ben-Dor told Xinhua.",152,185,Foreign Ministry deputy spokesman,1,0,1
3YLTXLH3DF7GSVQOEBZKUVFREH8HPE,"Yitzhak Levanon, who will be retiring at the end of the month, departed to Cairo for several days in order to bid farewell to friends and colleagues, Foreign Ministry deputy spokesman Lior Ben-Dor told Xinhua.",176,185,spokesman,1,0,1
3YLTXLH3DF7GSVQOEBZKUVFREH8HPE,"A general atmosphere of anti-Israel sentiments came to a head on Sept. 10, when hundreds of Egyptian protesters stormed the Israeli embassy and tore apart its security wall, forcing Prime Minister Benjamin Netanyahu to order the emergency evacuation of Levanon and some 80 of his staff and their families back to Israel.",2,20,general atmosphere,2,0,2
3YLTXLH3DF7GSVQOEBZKUVFREH8HPE,"A general atmosphere of anti-Israel sentiments came to a head on Sept. 10, when hundreds of Egyptian protesters stormed the Israeli embassy and tore apart its security wall, forcing Prime Minister Benjamin Netanyahu to order the emergency evacuation of Levanon and some 80 of his staff and their families back to Israel.",10,20,atmosphere,4,1,5
3YLTXLH3DF7GSVQOEBZKUVFREH8HPE,"A general atmosphere of anti-Israel sentiments came to a head on Sept. 10, when hundreds of Egyptian protesters stormed the Israeli embassy and tore apart its security wall, forcing Prime Minister Benjamin Netanyahu to order the emergency evacuation of Levanon and some 80 of his staff and their families back to Israel.",24,46,anti-Israel sentiments,1,2,3
3YLTXLH3DF7GSVQOEBZKUVFREH8HPE,"A general atmosphere of anti-Israel sentiments came to a head on Sept. 10, when hundreds of Egyptian protesters stormed the Israeli embassy and tore apart its security wall, forcing Prime Minister Benjamin Netanyahu to order the emergency evacuation of Levanon and some 80 of his staff and their families back to Israel.",36,46,sentiments,6,5,11
3YLTXLH3DF7GSVQOEBZKUVFREH8HPE,"A general atmosphere of anti-Israel sentiments came to a head on Sept. 10, when hundreds of Egyptian protesters stormed the Israeli embassy and tore apart its security wall, forcing Prime Minister Benjamin Netanyahu to order the emergency evacuation of Levanon and some 80 of his staff and their families back to Israel.",112,119,stormed,3,5,8
3YLTXLH3DF7GSVQOEBZKUVFREH8HPE,"A general atmosphere of anti-Israel sentiments came to a head on Sept. 10, when hundreds of Egyptian protesters stormed the Israeli embassy and tore apart its security wall, forcing Prime Minister Benjamin Netanyahu to order the emergency evacuation of Levanon and some 80 of his staff and their families back to Israel.",132,139,embassy,1,1,2
3YLTXLH3DF7GSVQOEBZKUVFREH8HPE,"A general atmosphere of anti-Israel sentiments came to a head on Sept. 10, when hundreds of Egyptian protesters stormed the Israeli embassy and tore apart its security wall, forcing Prime Minister Benjamin Netanyahu to order the emergency evacuation of Levanon and some 80 of his staff and their families back to Israel.",144,148,tore,1,1,2
3YLTXLH3DF7GSVQOEBZKUVFREH8HPE,"A general atmosphere of anti-Israel sentiments came to a head on Sept. 10, when hundreds of Egyptian protesters stormed the Israeli embassy and tore apart its security wall, forcing Prime Minister Benjamin Netanyahu to order the emergency evacuation of Levanon and some 80 of his staff and their families back to Israel.",144,154,tore apart,0,3,3
3YLTXLH3DF7GSVQOEBZKUVFREH8HPE,"A general atmosphere of anti-Israel sentiments came to a head on Sept. 10, when hundreds of Egyptian protesters stormed the Israeli embassy and tore apart its security wall, forcing Prime Minister Benjamin Netanyahu to order the emergency evacuation of Levanon and some 80 of his staff and their families back to Israel.",159,172,security wall,2,0,2
3YLTXLH3DF7GSVQOEBZKUVFREH8HPE,"A general atmosphere of anti-Israel sentiments came to a head on Sept. 10, when hundreds of Egyptian protesters stormed the Israeli embassy and tore apart its security wall, forcing Prime Minister Benjamin Netanyahu to order the emergency evacuation of Levanon and some 80 of his staff and their families back to Israel.",229,238,emergency,0,1,1
3YLTXLH3DF7GSVQOEBZKUVFREH8HPE,"A general atmosphere of anti-Israel sentiments came to a head on Sept. 10, when hundreds of Egyptian protesters stormed the Israeli embassy and tore apart its security wall, forcing Prime Minister Benjamin Netanyahu to order the emergency evacuation of Levanon and some 80 of his staff and their families back to Israel.",229,249,emergency evacuation,1,1,2
3YLTXLH3DF7GSVQOEBZKUVFREH8HPE,"A general atmosphere of anti-Israel sentiments came to a head on Sept. 10, when hundreds of Egyptian protesters stormed the Israeli embassy and tore apart its security wall, forcing Prime Minister Benjamin Netanyahu to order the emergency evacuation of Levanon and some 80 of his staff and their families back to Israel.",239,249,evacuation,4,1,5
3P6ENY9P79XOB93K1G90LYEFRQAIH9,"A definitive clean-up of troubled banks, as well as an accelerated 2014 budget, are among a package of reforms that could win centre-right Prime Minister Mariano Rajoy more time from the European Union to hit tough deficit targets, EU sources have told Reuters.",2,12,definitive,8,4,12
3P6ENY9P79XOB93K1G90LYEFRQAIH9,"A definitive clean-up of troubled banks, as well as an accelerated 2014 budget, are among a package of reforms that could win centre-right Prime Minister Mariano Rajoy more time from the European Union to hit tough deficit targets, EU sources have told Reuters.",2,21,definitive clean-up,3,2,5
3P6ENY9P79XOB93K1G90LYEFRQAIH9,"A definitive clean-up of troubled banks, as well as an accelerated 2014 budget, are among a package of reforms that could win centre-right Prime Minister Mariano Rajoy more time from the European Union to hit tough deficit targets, EU sources have told Reuters.",2,39,definitive clean-up of troubled banks,1,0,1
3P6ENY9P79XOB93K1G90LYEFRQAIH9,"A definitive clean-up of troubled banks, as well as an accelerated 2014 budget, are among a package of reforms that could win centre-right Prime Minister Mariano Rajoy more time from the European Union to hit tough deficit targets, EU sources have told Reuters.",13,39,clean-up of troubled banks,1,0,1
3P6ENY9P79XOB93K1G90LYEFRQAIH9,"A definitive clean-up of troubled banks, as well as an accelerated 2014 budget, are among a package of reforms that could win centre-right Prime Minister Mariano Rajoy more time from the European Union to hit tough deficit targets, EU sources have told Reuters.",25,33,troubled,0,2,2
3P6ENY9P79XOB93K1G90LYEFRQAIH9,"A definitive clean-up of troubled banks, as well as an accelerated 2014 budget, are among a package of reforms that could win centre-right Prime Minister Mariano Rajoy more time from the European Union to hit tough deficit targets, EU sources have told Reuters.",25,39,troubled banks,2,0,2
3P6ENY9P79XOB93K1G90LYEFRQAIH9,"A definitive clean-up of troubled banks, as well as an accelerated 2014 budget, are among a package of reforms that could win centre-right Prime Minister Mariano Rajoy more time from the European Union to hit tough deficit targets, EU sources have told Reuters.",55,66,accelerated,7,7,14
3P6ENY9P79XOB93K1G90LYEFRQAIH9,"A definitive clean-up of troubled banks, as well as an accelerated 2014 budget, are among a package of reforms that could win centre-right Prime Minister Mariano Rajoy more time from the European Union to hit tough deficit targets, EU sources have told Reuters.",92,99,package,0,1,1
3P6ENY9P79XOB93K1G90LYEFRQAIH9,"A definitive clean-up of troubled banks, as well as an accelerated 2014 budget, are among a package of reforms that could win centre-right Prime Minister Mariano Rajoy more time from the European Union to hit tough deficit targets, EU sources have told Reuters.",92,110,package of reforms,1,0,1
3P6ENY9P79XOB93K1G90LYEFRQAIH9,"A definitive clean-up of troubled banks, as well as an accelerated 2014 budget, are among a package of reforms that could win centre-right Prime Minister Mariano Rajoy more time from the European Union to hit tough deficit targets, EU sources have told Reuters.",103,110,reforms,1,1,2
3P6ENY9P79XOB93K1G90LYEFRQAIH9,"A definitive clean-up of troubled banks, as well as an accelerated 2014 budget, are among a package of reforms that could win centre-right Prime Minister Mariano Rajoy more time from the European Union to hit tough deficit targets, EU sources have told Reuters.",126,138,centre-right,7,2,9
3P6ENY9P79XOB93K1G90LYEFRQAIH9,"A definitive clean-up of troubled banks, as well as an accelerated 2014 budget, are among a package of reforms that could win centre-right Prime Minister Mariano Rajoy more time from the European Union to hit tough deficit targets, EU sources have told Reuters.",187,201,European Union,0,1,1
3P6ENY9P79XOB93K1G90LYEFRQAIH9,"A definitive clean-up of troubled banks, as well as an accelerated 2014 budget, are among a package of reforms that could win centre-right Prime Minister Mariano Rajoy more time from the European Union to hit tough deficit targets, EU sources have told Reuters.",209,214,tough,0,1,1
3P6ENY9P79XOB93K1G90LYEFRQAIH9,"A definitive clean-up of troubled banks, as well as an accelerated 2014 budget, are among a package of reforms that could win centre-right Prime Minister Mariano Rajoy more time from the European Union to hit tough deficit targets, EU sources have told Reuters.",209,230,tough deficit targets,2,1,3
3P6ENY9P79XOB93K1G90LYEFRQAIH9,"A definitive clean-up of troubled banks, as well as an accelerated 2014 budget, are among a package of reforms that could win centre-right Prime Minister Mariano Rajoy more time from the European Union to hit tough deficit targets, EU sources have told Reuters.",215,222,deficit,4,5,9
3P6ENY9P79XOB93K1G90LYEFRQAIH9,"A definitive clean-up of troubled banks, as well as an accelerated 2014 budget, are among a package of reforms that could win centre-right Prime Minister Mariano Rajoy more time from the European Union to hit tough deficit targets, EU sources have told Reuters.",215,230,deficit targets,3,3,6
3P6ENY9P79XOB93K1G90LYEFRQAIH9,"A definitive clean-up of troubled banks, as well as an accelerated 2014 budget, are among a package of reforms that could win centre-right Prime Minister Mariano Rajoy more time from the European Union to hit tough deficit targets, EU sources have told Reuters.",223,230,targets,1,0,1
3P6ENY9P79XOB93K1G90LYEFRQAIH9,"A definitive clean-up of troubled banks, as well as an accelerated 2014 budget, are among a package of reforms that could win centre-right Prime Minister Mariano Rajoy more time from the European Union to hit tough deficit targets, EU sources have told Reuters.",232,234,EU,1,0,1
3P6ENY9P79XOB93K1G90LYEFRQAIH9,"A definitive clean-up of troubled banks, as well as an accelerated 2014 budget, are among a package of reforms that could win centre-right Prime Minister Mariano Rajoy more time from the European Union to hit tough deficit targets, EU sources have told Reuters.",253,260,Reuters,1,2,3
3P6ENY9P79XOB93K1G90LYEFRQAIH9,"Spain is walking on the edge of a cliff.	10	40	walking on the edge of a cliff	1	0	1
3P6ENY9P79XOB93K1G90LYEFRQAIH9	Spain is walking on the edge of a cliff.",25,29,edge,0,1,1
3P6ENY9P79XOB93K1G90LYEFRQAIH9,"Spain is walking on the edge of a cliff.	25	40	edge of a cliff	1	2	3
3P6ENY9P79XOB93K1G90LYEFRQAIH9	Spain is walking on the edge of a cliff.",35,40,cliff,1,4,5
3P6ENY9P79XOB93K1G90LYEFRQAIH9,"If they fail to deliver, what has been so far a national crisis will degenerate into a systemic crisis for the EU,"" one senior source said.",16,23,deliver,0,1,1
3P6ENY9P79XOB93K1G90LYEFRQAIH9,"If they fail to deliver, what has been so far a national crisis will degenerate into a systemic crisis for the EU,"" one senior source said.",48,56,national,1,0,1
3P6ENY9P79XOB93K1G90LYEFRQAIH9,"If they fail to deliver, what has been so far a national crisis will degenerate into a systemic crisis for the EU,"" one senior source said.",48,63,national crisis,2,0,2
3P6ENY9P79XOB93K1G90LYEFRQAIH9,"If they fail to deliver, what has been so far a national crisis will degenerate into a systemic crisis for the EU,"" one senior source said.",57,63,crisis,1,2,3
3P6ENY9P79XOB93K1G90LYEFRQAIH9,"If they fail to deliver, what has been so far a national crisis will degenerate into a systemic crisis for the EU,"" one senior source said.",69,79,degenerate,10,10,20
3P6ENY9P79XOB93K1G90LYEFRQAIH9,"If they fail to deliver, what has been so far a national crisis will degenerate into a systemic crisis for the EU,"" one senior source said.",87,95,systemic,2,1,3
3P6ENY9P79XOB93K1G90LYEFRQAIH9,"If they fail to deliver, what has been so far a national crisis will degenerate into a systemic crisis for the EU,"" one senior source said.",87,102,systemic crisis,7,5,12
3P6ENY9P79XOB93K1G90LYEFRQAIH9,"Hoping to put an end to its four-year banking crisis, Spain effectively took over Bankia SA, one of the country's biggest banks, this week after days of market anxiety over the lender's viability.",60,71,effectively,0,1,1
3P6ENY9P79XOB93K1G90LYEFRQAIH9,"Hoping to put an end to its four-year banking crisis, Spain effectively took over Bankia SA, one of the country's biggest banks, this week after days of market anxiety over the lender's viability.",153,167,market anxiety,4,2,6
3P6ENY9P79XOB93K1G90LYEFRQAIH9,"Hoping to put an end to its four-year banking crisis, Spain effectively took over Bankia SA, one of the country's biggest banks, this week after days of market anxiety over the lender's viability.",160,167,anxiety,3,6,9
3P6ENY9P79XOB93K1G90LYEFRQAIH9,"Hoping to put an end to its four-year banking crisis, Spain effectively took over Bankia SA, one of the country's biggest banks, this week after days of market anxiety over the lender's viability.",177,184,lenders,1,4,5
3P6ENY9P79XOB93K1G90LYEFRQAIH9,"Hoping to put an end to its four-year banking crisis, Spain effectively took over Bankia SA, one of the country's biggest banks, this week after days of market anxiety over the lender's viability.",177,194,lenders viability,4,4,8
3P6ENY9P79XOB93K1G90LYEFRQAIH9,"Hoping to put an end to its four-year banking crisis, Spain effectively took over Bankia SA, one of the country's biggest banks, this week after days of market anxiety over the lender's viability.",186,195,viability,7,4,11
3P6ENY9P79XOB93K1G90LYEFRQAIH9,"Spanish stocks were down 2.1 percent on Friday morning, in line with other European markets, after getting a big boost on Thursday from the banking reform plans.",109,118,big boost,0,2,2
3P6ENY9P79XOB93K1G90LYEFRQAIH9,"Spanish stocks were down 2.1 percent on Friday morning, in line with other European markets, after getting a big boost on Thursday from the banking reform plans.",113,118,boost,2,3,5
3P6ENY9P79XOB93K1G90LYEFRQAIH9,"Spanish stocks were down 2.1 percent on Friday morning, in line with other European markets, after getting a big boost on Thursday from the banking reform plans.",140,160,banking reform plans,4,0,4
3P6ENY9P79XOB93K1G90LYEFRQAIH9,"Spanish stocks were down 2.1 percent on Friday morning, in line with other European markets, after getting a big boost on Thursday from the banking reform plans.",148,154,reform,2,1,3
3G4VVJO6PZH7ULRWKW2H7NVJ6YCPKQ,The car has been seized for a technical and forensic examination.,17,23,seized,10,8,18
3G4VVJO6PZH7ULRWKW2H7NVJ6YCPKQ,The car has been seized for a technical and forensic examination.,30,39,technical,4,0,4
3G4VVJO6PZH7ULRWKW2H7NVJ6YCPKQ,The car has been seized for a technical and forensic examination.,30,64,technical and forensic examination,3,0,3
3G4VVJO6PZH7ULRWKW2H7NVJ6YCPKQ,The car has been seized for a technical and forensic examination.,44,52,forensic,5,6,11
3G4VVJO6PZH7ULRWKW2H7NVJ6YCPKQ,The car has been seized for a technical and forensic examination.,44,64,forensic examination,7,2,9
3G4VVJO6PZH7ULRWKW2H7NVJ6YCPKQ,"Israel's ambassador to Cairo has travelled to Egypt for the first time since he and his staff were evacuated from the country in September after protesters stormed the Israeli embassy, a Foreign Ministry official said on Sunday.",9,19,ambassador,2,1,3
3G4VVJO6PZH7ULRWKW2H7NVJ6YCPKQ,"Israel's ambassador to Cairo has travelled to Egypt for the first time since he and his staff were evacuated from the country in September after protesters stormed the Israeli embassy, a Foreign Ministry official said on Sunday.",88,93,staff,0,1,1
3G4VVJO6PZH7ULRWKW2H7NVJ6YCPKQ,"Israel's ambassador to Cairo has travelled to Egypt for the first time since he and his staff were evacuated from the country in September after protesters stormed the Israeli embassy, a Foreign Ministry official said on Sunday.",99,108,evacuated,10,8,18
3G4VVJO6PZH7ULRWKW2H7NVJ6YCPKQ,"Israel's ambassador to Cairo has travelled to Egypt for the first time since he and his staff were evacuated from the country in September after protesters stormed the Israeli embassy, a Foreign Ministry official said on Sunday.",145,155,protesters,4,2,6
3G4VVJO6PZH7ULRWKW2H7NVJ6YCPKQ,"Israel's ambassador to Cairo has travelled to Egypt for the first time since he and his staff were evacuated from the country in September after protesters stormed the Israeli embassy, a Foreign Ministry official said on Sunday.",156,163,stormed,4,6,10
3G4VVJO6PZH7ULRWKW2H7NVJ6YCPKQ,"Israel's ambassador to Cairo has travelled to Egypt for the first time since he and his staff were evacuated from the country in September after protesters stormed the Israeli embassy, a Foreign Ministry official said on Sunday.",176,183,embassy,0,1,1
3G4VVJO6PZH7ULRWKW2H7NVJ6YCPKQ,"Playing down the significance of Yitzhak Levanon's trip, the official, who asked not to be identified, said the ambassador went to Egypt on Saturday for farewell meetings with foreign and Egyptian diplomats before his retirement.",0,12,Playing down,1,2,3
3G4VVJO6PZH7ULRWKW2H7NVJ6YCPKQ,"Playing down the significance of Yitzhak Levanon's trip, the official, who asked not to be identified, said the ambassador went to Egypt on Saturday for farewell meetings with foreign and Egyptian diplomats before his retirement.",0,29,Playing down the significance,1,0,1
3G4VVJO6PZH7ULRWKW2H7NVJ6YCPKQ,"Playing down the significance of Yitzhak Levanon's trip, the official, who asked not to be identified, said the ambassador went to Egypt on Saturday for farewell meetings with foreign and Egyptian diplomats before his retirement.",17,29,significance,5,4,9
3G4VVJO6PZH7ULRWKW2H7NVJ6YCPKQ,"Playing down the significance of Yitzhak Levanon's trip, the official, who asked not to be identified, said the ambassador went to Egypt on Saturday for farewell meetings with foreign and Egyptian diplomats before his retirement.",91,101,identified,0,1,1
3G4VVJO6PZH7ULRWKW2H7NVJ6YCPKQ,"Playing down the significance of Yitzhak Levanon's trip, the official, who asked not to be identified, said the ambassador went to Egypt on Saturday for farewell meetings with foreign and Egyptian diplomats before his retirement.",153,161,farewell,2,2,4
3G4VVJO6PZH7ULRWKW2H7NVJ6YCPKQ,"Playing down the significance of Yitzhak Levanon's trip, the official, who asked not to be identified, said the ambassador went to Egypt on Saturday for farewell meetings with foreign and Egyptian diplomats before his retirement.",153,170,farewell meetings,1,2,3
3G4VVJO6PZH7ULRWKW2H7NVJ6YCPKQ,"Playing down the significance of Yitzhak Levanon's trip, the official, who asked not to be identified, said the ambassador went to Egypt on Saturday for farewell meetings with foreign and Egyptian diplomats before his retirement.",197,206,diplomats,5,5,10
3G4VVJO6PZH7ULRWKW2H7NVJ6YCPKQ,"Playing down the significance of Yitzhak Levanon's trip, the official, who asked not to be identified, said the ambassador went to Egypt on Saturday for farewell meetings with foreign and Egyptian diplomats before his retirement.",218,228,retirement,3,2,5
3G4VVJO6PZH7ULRWKW2H7NVJ6YCPKQ,"Israel's embassy in a high-rise building in Cairo has remained unoccupied since protesters broke in two months ago, trapping Israeli security guards inside until they were rescued by Egyptian troops.",9,16,embassy,0,1,1
3G4VVJO6PZH7ULRWKW2H7NVJ6YCPKQ,"Israel's embassy in a high-rise building in Cairo has remained unoccupied since protesters broke in two months ago, trapping Israeli security guards inside until they were rescued by Egyptian troops.",22,31,high-rise,1,3,4
3G4VVJO6PZH7ULRWKW2H7NVJ6YCPKQ,"Israel's embassy in a high-rise building in Cairo has remained unoccupied since protesters broke in two months ago, trapping Israeli security guards inside until they were rescued by Egyptian troops.",22,40,high-rise building,2,1,3
3G4VVJO6PZH7ULRWKW2H7NVJ6YCPKQ,"Israel's embassy in a high-rise building in Cairo has remained unoccupied since protesters broke in two months ago, trapping Israeli security guards inside until they were rescued by Egyptian troops.",63,73,unoccupied,7,2,9
3G4VVJO6PZH7ULRWKW2H7NVJ6YCPKQ,"Israel's embassy in a high-rise building in Cairo has remained unoccupied since protesters broke in two months ago, trapping Israeli security guards inside until they were rescued by Egyptian troops.",80,90,protesters,3,0,3
3G4VVJO6PZH7ULRWKW2H7NVJ6YCPKQ,"Israel's embassy in a high-rise building in Cairo has remained unoccupied since protesters broke in two months ago, trapping Israeli security guards inside until they were rescued by Egyptian troops.",116,124,trapping,2,4,6
3G4VVJO6PZH7ULRWKW2H7NVJ6YCPKQ,"Israel's embassy in a high-rise building in Cairo has remained unoccupied since protesters broke in two months ago, trapping Israeli security guards inside until they were rescued by Egyptian troops.",172,179,rescued,0,6,6
3G4VVJO6PZH7ULRWKW2H7NVJ6YCPKQ,The incident followed the killing in August of five Egyptian security guards by Israeli soldiers pursuing militants who had ambushed and killed eight Israelis along the Israeli-Egyptian border.,4,12,incident,1,0,1
3G4VVJO6PZH7ULRWKW2H7NVJ6YCPKQ,The incident followed the killing in August of five Egyptian security guards by Israeli soldiers pursuing militants who had ambushed and killed eight Israelis along the Israeli-Egyptian border.,97,105,pursuing,3,4,7
3G4VVJO6PZH7ULRWKW2H7NVJ6YCPKQ,The incident followed the killing in August of five Egyptian security guards by Israeli soldiers pursuing militants who had ambushed and killed eight Israelis along the Israeli-Egyptian border.,97,115,pursuing militants,2,0,2
3G4VVJO6PZH7ULRWKW2H7NVJ6YCPKQ,The incident followed the killing in August of five Egyptian security guards by Israeli soldiers pursuing militants who had ambushed and killed eight Israelis along the Israeli-Egyptian border.,106,115,militants,7,3,10
3G4VVJO6PZH7ULRWKW2H7NVJ6YCPKQ,The incident followed the killing in August of five Egyptian security guards by Israeli soldiers pursuing militants who had ambushed and killed eight Israelis along the Israeli-Egyptian border.,124,132,ambushed,10,10,20
3SSN80MU8CPC3UTN6NCY10HM7KIKXF,The Observatory said dozens had been wounded in shelling of the city by Syrian troops.,4,15,Observatory,3,3,6
3SSN80MU8CPC3UTN6NCY10HM7KIKXF,The Observatory said dozens had been wounded in shelling of the city by Syrian troops.,21,27,dozens,0,2,2
3SSN80MU8CPC3UTN6NCY10HM7KIKXF,The Observatory said dozens had been wounded in shelling of the city by Syrian troops.,37,44,wounded,0,3,3
3SSN80MU8CPC3UTN6NCY10HM7KIKXF,The Observatory said dozens had been wounded in shelling of the city by Syrian troops.,37,56,wounded in shelling,1,0,1
3SSN80MU8CPC3UTN6NCY10HM7KIKXF,The Observatory said dozens had been wounded in shelling of the city by Syrian troops.,48,56,shelling,7,9,16
3SSN80MU8CPC3UTN6NCY10HM7KIKXF,The Observatory said dozens had been wounded in shelling of the city by Syrian troops.,48,68,shelling of the city,1,0,1
3SSN80MU8CPC3UTN6NCY10HM7KIKXF,"The bombardment by regime forces resumed following the deadly clashes, it added.",4,15,bombardment,10,8,18
3SSN80MU8CPC3UTN6NCY10HM7KIKXF,"The bombardment by regime forces resumed following the deadly clashes, it added.",4,32,bombardment by regime forces,2,0,2
3SSN80MU8CPC3UTN6NCY10HM7KIKXF,"The bombardment by regime forces resumed following the deadly clashes, it added.",19,25,regime,4,4,8
3SSN80MU8CPC3UTN6NCY10HM7KIKXF,"The bombardment by regime forces resumed following the deadly clashes, it added.",33,40,resumed,1,3,4
3SSN80MU8CPC3UTN6NCY10HM7KIKXF,"The bombardment by regime forces resumed following the deadly clashes, it added.",55,69,deadly clashes,0,1,1
3SSN80MU8CPC3UTN6NCY10HM7KIKXF,"The bombardment by regime forces resumed following the deadly clashes, it added.",62,69,clashes,0,1,1
3SSN80MU8CPC3UTN6NCY10HM7KIKXF,"In Quraya in the eastern province of Deir Ezzor, a 15-year-old boy was killed by machinegun fire as regime forces raided the town, the Observatory said, bringing the total number of people killed on Monday to 25.",25,33,province,1,3,4
3SSN80MU8CPC3UTN6NCY10HM7KIKXF,"In Quraya in the eastern province of Deir Ezzor, a 15-year-old boy was killed by machinegun fire as regime forces raided the town, the Observatory said, bringing the total number of people killed on Monday to 25.",37,47,Deir Ezzor,1,0,1
3SSN80MU8CPC3UTN6NCY10HM7KIKXF,"In Quraya in the eastern province of Deir Ezzor, a 15-year-old boy was killed by machinegun fire as regime forces raided the town, the Observatory said, bringing the total number of people killed on Monday to 25.",81,91,machinegun,3,2,5
3SSN80MU8CPC3UTN6NCY10HM7KIKXF,"In Quraya in the eastern province of Deir Ezzor, a 15-year-old boy was killed by machinegun fire as regime forces raided the town, the Observatory said, bringing the total number of people killed on Monday to 25.",81,96,machinegun fire,2,1,3
3SSN80MU8CPC3UTN6NCY10HM7KIKXF,"In Quraya in the eastern province of Deir Ezzor, a 15-year-old boy was killed by machinegun fire as regime forces raided the town, the Observatory said, bringing the total number of people killed on Monday to 25.",100,106,regime,1,1,2
3SSN80MU8CPC3UTN6NCY10HM7KIKXF,"In Quraya in the eastern province of Deir Ezzor, a 15-year-old boy was killed by machinegun fire as regime forces raided the town, the Observatory said, bringing the total number of people killed on Monday to 25.",100,113,regime forces,0,1,1
3SSN80MU8CPC3UTN6NCY10HM7KIKXF,"In Quraya in the eastern province of Deir Ezzor, a 15-year-old boy was killed by machinegun fire as regime forces raided the town, the Observatory said, bringing the total number of people killed on Monday to 25.",114,120,raided,1,3,4
3SSN80MU8CPC3UTN6NCY10HM7KIKXF,"In Quraya in the eastern province of Deir Ezzor, a 15-year-old boy was killed by machinegun fire as regime forces raided the town, the Observatory said, bringing the total number of people killed on Monday to 25.",135,146,Observatory,0,2,2
3SSN80MU8CPC3UTN6NCY10HM7KIKXF,The watchdog added that 15 residents of the city were arrested.,0,12,The watchdog,0,1,1
3SSN80MU8CPC3UTN6NCY10HM7KIKXF,The watchdog added that 15 residents of the city were arrested.,4,12,watchdog,8,10,18
3SSN80MU8CPC3UTN6NCY10HM7KIKXF,"And in the capital Damascus, regime forces raided the neighborhood of Qaboon, while snipers were stationed on the roofs of some buildings.",11,18,capital,1,0,1
3SSN80MU8CPC3UTN6NCY10HM7KIKXF,"And in the capital Damascus, regime forces raided the neighborhood of Qaboon, while snipers were stationed on the roofs of some buildings.",29,35,regime,1,2,3
3SSN80MU8CPC3UTN6NCY10HM7KIKXF,"And in the capital Damascus, regime forces raided the neighborhood of Qaboon, while snipers were stationed on the roofs of some buildings.",43,49,raided,1,3,4
3SSN80MU8CPC3UTN6NCY10HM7KIKXF,"And in the capital Damascus, regime forces raided the neighborhood of Qaboon, while snipers were stationed on the roofs of some buildings.",54,66,neighborhood,1,1,2
3SSN80MU8CPC3UTN6NCY10HM7KIKXF,"And in the capital Damascus, regime forces raided the neighborhood of Qaboon, while snipers were stationed on the roofs of some buildings.",84,91,snipers,8,10,18
3SSN80MU8CPC3UTN6NCY10HM7KIKXF,"And in the capital Damascus, regime forces raided the neighborhood of Qaboon, while snipers were stationed on the roofs of some buildings.",97,106,stationed,4,2,6
3SSN80MU8CPC3UTN6NCY10HM7KIKXF,"The watchdog said 45 people — 25 civilians, 15 soldiers and five rebels — were killed in a surge of violence in various flashpoints on Sunday, despite a ceasefire brokered by UN-Arab League peace envoy Kofi Annan that was supposed to take effect on April 12.",4,12,watchdog,2,2,4
3SSN80MU8CPC3UTN6NCY10HM7KIKXF,"The watchdog said 45 people — 25 civilians, 15 soldiers and five rebels — were killed in a surge of violence in various flashpoints on Sunday, despite a ceasefire brokered by UN-Arab League peace envoy Kofi Annan that was supposed to take effect on April 12.",33,42,civilians,1,0,1
3SSN80MU8CPC3UTN6NCY10HM7KIKXF,"The watchdog said 45 people — 25 civilians, 15 soldiers and five rebels — were killed in a surge of violence in various flashpoints on Sunday, despite a ceasefire brokered by UN-Arab League peace envoy Kofi Annan that was supposed to take effect on April 12.",65,71,rebels,0,3,3
3SSN80MU8CPC3UTN6NCY10HM7KIKXF,"The watchdog said 45 people — 25 civilians, 15 soldiers and five rebels — were killed in a surge of violence in various flashpoints on Sunday, despite a ceasefire brokered by UN-Arab League peace envoy Kofi Annan that was supposed to take effect on April 12.",89,108,a surge of violence,0,1,1
3SSN80MU8CPC3UTN6NCY10HM7KIKXF,"The watchdog said 45 people — 25 civilians, 15 soldiers and five rebels — were killed in a surge of violence in various flashpoints on Sunday, despite a ceasefire brokered by UN-Arab League peace envoy Kofi Annan that was supposed to take effect on April 12.",91,96,surge,5,4,9
3SSN80MU8CPC3UTN6NCY10HM7KIKXF,"The watchdog said 45 people — 25 civilians, 15 soldiers and five rebels — were killed in a surge of violence in various flashpoints on Sunday, despite a ceasefire brokered by UN-Arab League peace envoy Kofi Annan that was supposed to take effect on April 12.",91,108,surge of violence,0,2,2
3SSN80MU8CPC3UTN6NCY10HM7KIKXF,"The watchdog said 45 people — 25 civilians, 15 soldiers and five rebels — were killed in a surge of violence in various flashpoints on Sunday, despite a ceasefire brokered by UN-Arab League peace envoy Kofi Annan that was supposed to take effect on April 12.",100,108,violence,0,1,1
3SSN80MU8CPC3UTN6NCY10HM7KIKXF,"The watchdog said 45 people — 25 civilians, 15 soldiers and five rebels — were killed in a surge of violence in various flashpoints on Sunday, despite a ceasefire brokered by UN-Arab League peace envoy Kofi Annan that was supposed to take effect on April 12.",112,131,various flashpoints,2,0,2
3SSN80MU8CPC3UTN6NCY10HM7KIKXF,"The watchdog said 45 people — 25 civilians, 15 soldiers and five rebels — were killed in a surge of violence in various flashpoints on Sunday, despite a ceasefire brokered by UN-Arab League peace envoy Kofi Annan that was supposed to take effect on April 12.",120,131,flashpoints,10,10,20
3SSN80MU8CPC3UTN6NCY10HM7KIKXF,"The watchdog said 45 people — 25 civilians, 15 soldiers and five rebels — were killed in a surge of violence in various flashpoints on Sunday, despite a ceasefire brokered by UN-Arab League peace envoy Kofi Annan that was supposed to take effect on April 12.",143,150,despite,0,2,2
3SSN80MU8CPC3UTN6NCY10HM7KIKXF,"The watchdog said 45 people — 25 civilians, 15 soldiers and five rebels — were killed in a surge of violence in various flashpoints on Sunday, despite a ceasefire brokered by UN-Arab League peace envoy Kofi Annan that was supposed to take effect on April 12.",153,162,ceasefire,5,9,14
3SSN80MU8CPC3UTN6NCY10HM7KIKXF,"The watchdog said 45 people — 25 civilians, 15 soldiers and five rebels — were killed in a surge of violence in various flashpoints on Sunday, despite a ceasefire brokered by UN-Arab League peace envoy Kofi Annan that was supposed to take effect on April 12.",153,171,ceasefire brokered,4,1,5
3SSN80MU8CPC3UTN6NCY10HM7KIKXF,"The watchdog said 45 people — 25 civilians, 15 soldiers and five rebels — were killed in a surge of violence in various flashpoints on Sunday, despite a ceasefire brokered by UN-Arab League peace envoy Kofi Annan that was supposed to take effect on April 12.",163,171,brokered,1,6,7
3SSN80MU8CPC3UTN6NCY10HM7KIKXF,"The watchdog said 45 people — 25 civilians, 15 soldiers and five rebels — were killed in a surge of violence in various flashpoints on Sunday, despite a ceasefire brokered by UN-Arab League peace envoy Kofi Annan that was supposed to take effect on April 12.",190,201,peace envoy,0,1,1
3SSN80MU8CPC3UTN6NCY10HM7KIKXF,"The watchdog said 45 people — 25 civilians, 15 soldiers and five rebels — were killed in a surge of violence in various flashpoints on Sunday, despite a ceasefire brokered by UN-Arab League peace envoy Kofi Annan that was supposed to take effect on April 12.",196,201,envoy,4,3,7
3SSN80MU8CPC3UTN6NCY10HM7KIKXF,"The watchdog said 45 people — 25 civilians, 15 soldiers and five rebels — were killed in a surge of violence in various flashpoints on Sunday, despite a ceasefire brokered by UN-Arab League peace envoy Kofi Annan that was supposed to take effect on April 12.",202,212,Kofi Annan,1,0,1
3PEG1BH7AES5QRQM1RKGC3QUOHUBKX,"The government of Mariano Rajoy took the sweeping action just two days after it effectively took over the fourth-biggest bank, Bankia, to salvage its balance sheet, bulging with losses.",4,14,government,1,0,1
3PEG1BH7AES5QRQM1RKGC3QUOHUBKX,"The government of Mariano Rajoy took the sweeping action just two days after it effectively took over the fourth-biggest bank, Bankia, to salvage its balance sheet, bulging with losses.",41,49,sweeping,3,7,10
3PEG1BH7AES5QRQM1RKGC3QUOHUBKX,"The government of Mariano Rajoy took the sweeping action just two days after it effectively took over the fourth-biggest bank, Bankia, to salvage its balance sheet, bulging with losses.",41,56,sweeping action,5,2,7
3PEG1BH7AES5QRQM1RKGC3QUOHUBKX,"The government of Mariano Rajoy took the sweeping action just two days after it effectively took over the fourth-biggest bank, Bankia, to salvage its balance sheet, bulging with losses.",80,91,effectively,1,2,3
3PEG1BH7AES5QRQM1RKGC3QUOHUBKX,"The government of Mariano Rajoy took the sweeping action just two days after it effectively took over the fourth-biggest bank, Bankia, to salvage its balance sheet, bulging with losses.",138,145,salvage,10,8,18
3PEG1BH7AES5QRQM1RKGC3QUOHUBKX,"The government of Mariano Rajoy took the sweeping action just two days after it effectively took over the fourth-biggest bank, Bankia, to salvage its balance sheet, bulging with losses.",150,163,balance sheet,3,2,5
3PEG1BH7AES5QRQM1RKGC3QUOHUBKX,"The government of Mariano Rajoy took the sweeping action just two days after it effectively took over the fourth-biggest bank, Bankia, to salvage its balance sheet, bulging with losses.",165,172,bulging,9,8,17
3PEG1BH7AES5QRQM1RKGC3QUOHUBKX,"The government also ordered an independent audit on loans and property assets across the entire banking sector, as the European Union had asked.",31,42,independent,2,1,3
3PEG1BH7AES5QRQM1RKGC3QUOHUBKX,"The government also ordered an independent audit on loans and property assets across the entire banking sector, as the European Union had asked.",31,48,independent audit,3,1,4
3PEG1BH7AES5QRQM1RKGC3QUOHUBKX,"The government also ordered an independent audit on loans and property assets across the entire banking sector, as the European Union had asked.",43,48,audit,4,2,6
3PEG1BH7AES5QRQM1RKGC3QUOHUBKX,"The government also ordered an independent audit on loans and property assets across the entire banking sector, as the European Union had asked.",71,77,assets,1,0,1
3PEG1BH7AES5QRQM1RKGC3QUOHUBKX,"The government also ordered an independent audit on loans and property assets across the entire banking sector, as the European Union had asked.",96,110,banking sector,2,0,2
3PEG1BH7AES5QRQM1RKGC3QUOHUBKX,"The government also ordered an independent audit on loans and property assets across the entire banking sector, as the European Union had asked.",104,110,sector,1,0,1
3PEG1BH7AES5QRQM1RKGC3QUOHUBKX,"Luis de Guindos, Spain's economy minister, said: ""The government wants complete transparency, clarity is crucial to end any doubt about Spain's solvency.""",0,15,Luis de Guindos,1,0,1
3PEG1BH7AES5QRQM1RKGC3QUOHUBKX,"Luis de Guindos, Spain's economy minister, said: ""The government wants complete transparency, clarity is crucial to end any doubt about Spain's solvency.""",25,32,economy,1,0,1
3PEG1BH7AES5QRQM1RKGC3QUOHUBKX,"Luis de Guindos, Spain's economy minister, said: ""The government wants complete transparency, clarity is crucial to end any doubt about Spain's solvency.""",71,92,complete transparency,1,0,1
3PEG1BH7AES5QRQM1RKGC3QUOHUBKX,"Luis de Guindos, Spain's economy minister, said: ""The government wants complete transparency, clarity is crucial to end any doubt about Spain's solvency.""",80,92,transparency,7,9,16
3PEG1BH7AES5QRQM1RKGC3QUOHUBKX,"Luis de Guindos, Spain's economy minister, said: ""The government wants complete transparency, clarity is crucial to end any doubt about Spain's solvency.""",94,101,clarity,6,2,8
3PEG1BH7AES5QRQM1RKGC3QUOHUBKX,"Luis de Guindos, Spain's economy minister, said: ""The government wants complete transparency, clarity is crucial to end any doubt about Spain's solvency.""",105,112,crucial,2,3,5
3PEG1BH7AES5QRQM1RKGC3QUOHUBKX,"Luis de Guindos, Spain's economy minister, said: ""The government wants complete transparency, clarity is crucial to end any doubt about Spain's solvency.""",144,152,solvency,10,9,19
3PEG1BH7AES5QRQM1RKGC3QUOHUBKX,"Banks have until the end of the year to move their property holdings into asset-management firms for a fire-sale, Guindos said.",51,68,property holdings,1,0,1
3PEG1BH7AES5QRQM1RKGC3QUOHUBKX,"Banks have until the end of the year to move their property holdings into asset-management firms for a fire-sale, Guindos said.",74,90,asset-management,3,4,7
3PEG1BH7AES5QRQM1RKGC3QUOHUBKX,"Banks have until the end of the year to move their property holdings into asset-management firms for a fire-sale, Guindos said.",74,96,asset-management firms,2,0,2
3PEG1BH7AES5QRQM1RKGC3QUOHUBKX,"Banks have until the end of the year to move their property holdings into asset-management firms for a fire-sale, Guindos said.",103,112,fire-sale,5,7,12
3PEG1BH7AES5QRQM1RKGC3QUOHUBKX,Deficit-cutting targets Spain separately annnounced that it stood by its ambitious deficit-cutting targets for 2012 and 2013 despite European forecasts that it would fail to achieve them.,0,15,Deficit-cutting,4,9,13
3PEG1BH7AES5QRQM1RKGC3QUOHUBKX,Deficit-cutting targets Spain separately annnounced that it stood by its ambitious deficit-cutting targets for 2012 and 2013 despite European forecasts that it would fail to achieve them.,0,23,Deficit-cutting targets,2,0,2
3PEG1BH7AES5QRQM1RKGC3QUOHUBKX,Deficit-cutting targets Spain separately annnounced that it stood by its ambitious deficit-cutting targets for 2012 and 2013 despite European forecasts that it would fail to achieve them.,16,23,targets,0,1,1
3PEG1BH7AES5QRQM1RKGC3QUOHUBKX,Deficit-cutting targets Spain separately annnounced that it stood by its ambitious deficit-cutting targets for 2012 and 2013 despite European forecasts that it would fail to achieve them.,41,51,annnounced,1,2,3
3PEG1BH7AES5QRQM1RKGC3QUOHUBKX,Deficit-cutting targets Spain separately annnounced that it stood by its ambitious deficit-cutting targets for 2012 and 2013 despite European forecasts that it would fail to achieve them.,60,65,stood,0,1,1
3PEG1BH7AES5QRQM1RKGC3QUOHUBKX,Deficit-cutting targets Spain separately annnounced that it stood by its ambitious deficit-cutting targets for 2012 and 2013 despite European forecasts that it would fail to achieve them.,73,82,ambitious,3,8,11
3PEG1BH7AES5QRQM1RKGC3QUOHUBKX,Deficit-cutting targets Spain separately annnounced that it stood by its ambitious deficit-cutting targets for 2012 and 2013 despite European forecasts that it would fail to achieve them.,73,98,ambitious deficit-cutting,1,0,1
3PEG1BH7AES5QRQM1RKGC3QUOHUBKX,Deficit-cutting targets Spain separately annnounced that it stood by its ambitious deficit-cutting targets for 2012 and 2013 despite European forecasts that it would fail to achieve them.,83,98,deficit-cutting,4,2,6
3PEG1BH7AES5QRQM1RKGC3QUOHUBKX,Deficit-cutting targets Spain separately annnounced that it stood by its ambitious deficit-cutting targets for 2012 and 2013 despite European forecasts that it would fail to achieve them.,125,132,despite,0,1,1
3PEG1BH7AES5QRQM1RKGC3QUOHUBKX,Deficit-cutting targets Spain separately annnounced that it stood by its ambitious deficit-cutting targets for 2012 and 2013 despite European forecasts that it would fail to achieve them.,142,151,forecasts,4,8,12
3MJ9GGZYO375Q1H467EGHWKUQCQA29,A 32-year-old is recovering after he was shot in the chest and arm by a gunman in the Ballyfermot area of Dublin last night.,17,27,recovering,4,5,9
3MJ9GGZYO375Q1H467EGHWKUQCQA29,A 32-year-old is recovering after he was shot in the chest and arm by a gunman in the Ballyfermot area of Dublin last night.,53,58,chest,0,1,1
3MJ9GGZYO375Q1H467EGHWKUQCQA29,A 32-year-old is recovering after he was shot in the chest and arm by a gunman in the Ballyfermot area of Dublin last night.,86,97,Ballyfermot,0,1,1
3MJ9GGZYO375Q1H467EGHWKUQCQA29,A 32-year-old is recovering after he was shot in the chest and arm by a gunman in the Ballyfermot area of Dublin last night.,86,102,Ballyfermot area,1,0,1
3MJ9GGZYO375Q1H467EGHWKUQCQA29,"The gunman fired a number of shots at the victim, who was in his car outside the Ruby Finnegans pub on Sarsfield Road at around 11.10pm.",42,48,victim,0,5,5
3MJ9GGZYO375Q1H467EGHWKUQCQA29,"The gunman fired a number of shots at the victim, who was in his car outside the Ruby Finnegans pub on Sarsfield Road at around 11.10pm.",96,99,pub,2,0,2
3MJ9GGZYO375Q1H467EGHWKUQCQA29,"He made his getaway in a car that was later found burnt out in Inchicore, where a gun was also recovered.",12,19,getaway,8,8,16
3MJ9GGZYO375Q1H467EGHWKUQCQA29,"He made his getaway in a car that was later found burnt out in Inchicore, where a gun was also recovered.",50,55,burnt,2,2,4
3MJ9GGZYO375Q1H467EGHWKUQCQA29,"He made his getaway in a car that was later found burnt out in Inchicore, where a gun was also recovered.",50,59,burnt out,1,0,1
3MJ9GGZYO375Q1H467EGHWKUQCQA29,"He made his getaway in a car that was later found burnt out in Inchicore, where a gun was also recovered.",63,72,Inchicore,0,1,1
3MJ9GGZYO375Q1H467EGHWKUQCQA29,"He made his getaway in a car that was later found burnt out in Inchicore, where a gun was also recovered.",95,104,recovered,2,0,2
3MJ9GGZYO375Q1H467EGHWKUQCQA29,The victim was taken to Tallaght Hospital.,4,10,victim,3,0,3
3MJ9GGZYO375Q1H467EGHWKUQCQA29,His injuries are not believed to be life-threatening.,4,12,injuries,0,2,2
3MJ9GGZYO375Q1H467EGHWKUQCQA29,His injuries are not believed to be life-threatening.,36,52,life-threatening,10,9,19
3MJ9GGZYO375Q1H467EGHWKUQCQA29,Both cars have been taken away for technical and forensic examination.,35,44,technical,5,1,6
3MJ9GGZYO375Q1H467EGHWKUQCQA29,Both cars have been taken away for technical and forensic examination.,35,69,technical and forensic examination,3,1,4
3MJ9GGZYO375Q1H467EGHWKUQCQA29,Both cars have been taken away for technical and forensic examination.,49,57,forensic,5,4,9
3MJ9GGZYO375Q1H467EGHWKUQCQA29,Both cars have been taken away for technical and forensic examination.,49,69,forensic examination,8,4,12
3MJ9GGZYO375Q1H467EGHWKUQCQA29,Gardaí say witnesses at the scene describe a silver saloon car leaving the area.,0,6,Gardaí,0,1,1
3MJ9GGZYO375Q1H467EGHWKUQCQA29,Gardaí say witnesses at the scene describe a silver saloon car leaving the area.,11,20,witnesses,3,1,4
3MJ9GGZYO375Q1H467EGHWKUQCQA29,Gardaí say witnesses at the scene describe a silver saloon car leaving the area.,45,62,silver saloon car,1,0,1
3MJ9GGZYO375Q1H467EGHWKUQCQA29,Gardaí say witnesses at the scene describe a silver saloon car leaving the area.,52,58,saloon,2,1,3
3MJ9GGZYO375Q1H467EGHWKUQCQA29,Gardaí say witnesses at the scene describe a silver saloon car leaving the area.,52,62,saloon car,4,2,6
3MJ9GGZYO375Q1H467EGHWKUQCQA29,A silver car was subsequently discovered on fire at Goldenbridge Terrace in Inchicore at 11.30pm.,17,29,subsequently,10,6,16
3MJ9GGZYO375Q1H467EGHWKUQCQA29,A silver car was subsequently discovered on fire at Goldenbridge Terrace in Inchicore at 11.30pm.,17,40,subsequently discovered,1,0,1
3JTPR5MTZSD31B9D0HT39HQ2FYB5KK,"China insists it has sovereign rights to all of the South China Sea, even waters close to the coast of other countries and hundreds of miles from its own mainland.",6,13,insists,0,3,3
3JTPR5MTZSD31B9D0HT39HQ2FYB5KK,"China insists it has sovereign rights to all of the South China Sea, even waters close to the coast of other countries and hundreds of miles from its own mainland.",21,30,sovereign,8,8,16
3JTPR5MTZSD31B9D0HT39HQ2FYB5KK,"China insists it has sovereign rights to all of the South China Sea, even waters close to the coast of other countries and hundreds of miles from its own mainland.",21,37,sovereign rights,3,4,7
3JTPR5MTZSD31B9D0HT39HQ2FYB5KK,"China insists it has sovereign rights to all of the South China Sea, even waters close to the coast of other countries and hundreds of miles from its own mainland.",154,162,mainland,1,4,5
3JTPR5MTZSD31B9D0HT39HQ2FYB5KK,"The Philippines says it has sovereign rights over waters within its 200-nautical-mile exclusive economic zone, and that its position is supported by international law.",28,37,sovereign,6,3,9
3JTPR5MTZSD31B9D0HT39HQ2FYB5KK,"The Philippines says it has sovereign rights over waters within its 200-nautical-mile exclusive economic zone, and that its position is supported by international law.",28,44,sovereign rights,1,2,3
3JTPR5MTZSD31B9D0HT39HQ2FYB5KK,"The Philippines says it has sovereign rights over waters within its 200-nautical-mile exclusive economic zone, and that its position is supported by international law.",86,95,exclusive,4,3,7
3JTPR5MTZSD31B9D0HT39HQ2FYB5KK,"The Philippines says it has sovereign rights over waters within its 200-nautical-mile exclusive economic zone, and that its position is supported by international law.",86,104,exclusive economic,1,0,1
3JTPR5MTZSD31B9D0HT39HQ2FYB5KK,"The Philippines says it has sovereign rights over waters within its 200-nautical-mile exclusive economic zone, and that its position is supported by international law.",86,109,exclusive economic zone,2,2,4
3JTPR5MTZSD31B9D0HT39HQ2FYB5KK,"The Philippines says it has sovereign rights over waters within its 200-nautical-mile exclusive economic zone, and that its position is supported by international law.",96,104,economic,2,0,2
3JTPR5MTZSD31B9D0HT39HQ2FYB5KK,"The Philippines says it has sovereign rights over waters within its 200-nautical-mile exclusive economic zone, and that its position is supported by international law.",96,109,economic zone,1,0,1
3JTPR5MTZSD31B9D0HT39HQ2FYB5KK,"The Philippines says it has sovereign rights over waters within its 200-nautical-mile exclusive economic zone, and that its position is supported by international law.",124,132,position,1,1,2
3JTPR5MTZSD31B9D0HT39HQ2FYB5KK,"The Philippines says it has sovereign rights over waters within its 200-nautical-mile exclusive economic zone, and that its position is supported by international law.",136,145,supported,0,1,1
3JTPR5MTZSD31B9D0HT39HQ2FYB5KK,"The Philippines says it has sovereign rights over waters within its 200-nautical-mile exclusive economic zone, and that its position is supported by international law.",149,162,international,1,0,1
3JTPR5MTZSD31B9D0HT39HQ2FYB5KK,"The Philippines says it has sovereign rights over waters within its 200-nautical-mile exclusive economic zone, and that its position is supported by international law.",149,166,international law,0,1,1
3JTPR5MTZSD31B9D0HT39HQ2FYB5KK,"Apart from China and the Philippines, Taiwan, Malaysia, Brunei and Vietnam, also have overlapping claims to parts of the South China Sea, making the waters one of Asia's potential flashpoints for armed conflict.",86,97,overlapping,5,5,10
3JTPR5MTZSD31B9D0HT39HQ2FYB5KK,"Apart from China and the Philippines, Taiwan, Malaysia, Brunei and Vietnam, also have overlapping claims to parts of the South China Sea, making the waters one of Asia's potential flashpoints for armed conflict.",86,104,overlapping claims,2,5,7
3JTPR5MTZSD31B9D0HT39HQ2FYB5KK,"Apart from China and the Philippines, Taiwan, Malaysia, Brunei and Vietnam, also have overlapping claims to parts of the South China Sea, making the waters one of Asia's potential flashpoints for armed conflict.",98,104,claims,0,1,1
3JTPR5MTZSD31B9D0HT39HQ2FYB5KK,"Apart from China and the Philippines, Taiwan, Malaysia, Brunei and Vietnam, also have overlapping claims to parts of the South China Sea, making the waters one of Asia's potential flashpoints for armed conflict.",168,191,s potential flashpoints,1,0,1
3JTPR5MTZSD31B9D0HT39HQ2FYB5KK,"Apart from China and the Philippines, Taiwan, Malaysia, Brunei and Vietnam, also have overlapping claims to parts of the South China Sea, making the waters one of Asia's potential flashpoints for armed conflict.",170,179,potential,2,2,4
3JTPR5MTZSD31B9D0HT39HQ2FYB5KK,"Apart from China and the Philippines, Taiwan, Malaysia, Brunei and Vietnam, also have overlapping claims to parts of the South China Sea, making the waters one of Asia's potential flashpoints for armed conflict.",170,191,potential flashpoints,3,2,5
3JTPR5MTZSD31B9D0HT39HQ2FYB5KK,"Apart from China and the Philippines, Taiwan, Malaysia, Brunei and Vietnam, also have overlapping claims to parts of the South China Sea, making the waters one of Asia's potential flashpoints for armed conflict.",180,191,flashpoints,7,10,17
3JTPR5MTZSD31B9D0HT39HQ2FYB5KK,"Apart from China and the Philippines, Taiwan, Malaysia, Brunei and Vietnam, also have overlapping claims to parts of the South China Sea, making the waters one of Asia's potential flashpoints for armed conflict.",196,210,armed conflict,1,2,3
3JTPR5MTZSD31B9D0HT39HQ2FYB5KK,"Apart from China and the Philippines, Taiwan, Malaysia, Brunei and Vietnam, also have overlapping claims to parts of the South China Sea, making the waters one of Asia's potential flashpoints for armed conflict.",202,210,conflict,1,4,5
3JTPR5MTZSD31B9D0HT39HQ2FYB5KK,The Philippines and Vietnam complained last year of increasingly aggressive acts by China in staking its claim to the South China Sea.,28,38,complained,0,1,1
3JTPR5MTZSD31B9D0HT39HQ2FYB5KK,The Philippines and Vietnam complained last year of increasingly aggressive acts by China in staking its claim to the South China Sea.,52,64,increasingly,0,1,1
3JTPR5MTZSD31B9D0HT39HQ2FYB5KK,The Philippines and Vietnam complained last year of increasingly aggressive acts by China in staking its claim to the South China Sea.,52,75,increasingly aggressive,2,0,2
3JTPR5MTZSD31B9D0HT39HQ2FYB5KK,The Philippines and Vietnam complained last year of increasingly aggressive acts by China in staking its claim to the South China Sea.,52,80,increasingly aggressive acts,1,0,1
3JTPR5MTZSD31B9D0HT39HQ2FYB5KK,The Philippines and Vietnam complained last year of increasingly aggressive acts by China in staking its claim to the South China Sea.,65,75,aggressive,4,3,7
3JTPR5MTZSD31B9D0HT39HQ2FYB5KK,The Philippines and Vietnam complained last year of increasingly aggressive acts by China in staking its claim to the South China Sea.,65,80,aggressive acts,0,2,2
3JTPR5MTZSD31B9D0HT39HQ2FYB5KK,The Philippines and Vietnam complained last year of increasingly aggressive acts by China in staking its claim to the South China Sea.,93,100,staking,3,8,11
3JTPR5MTZSD31B9D0HT39HQ2FYB5KK,The Philippines and Vietnam complained last year of increasingly aggressive acts by China in staking its claim to the South China Sea.,93,110,staking its claim,1,0,1
3JTPR5MTZSD31B9D0HT39HQ2FYB5KK,"The Philippines accused Chinese vessels of firing warning shots at Filipino fishermen, as well as harassing an oil exploration vessel.",16,23,accused,1,3,4
3JTPR5MTZSD31B9D0HT39HQ2FYB5KK,"The Philippines accused Chinese vessels of firing warning shots at Filipino fishermen, as well as harassing an oil exploration vessel.",24,39,Chinese vessels,0,1,1
3JTPR5MTZSD31B9D0HT39HQ2FYB5KK,"The Philippines accused Chinese vessels of firing warning shots at Filipino fishermen, as well as harassing an oil exploration vessel.",32,39,vessels,3,1,4
3JTPR5MTZSD31B9D0HT39HQ2FYB5KK,"The Philippines accused Chinese vessels of firing warning shots at Filipino fishermen, as well as harassing an oil exploration vessel.",50,57,warning,1,0,1
3JTPR5MTZSD31B9D0HT39HQ2FYB5KK,"The Philippines accused Chinese vessels of firing warning shots at Filipino fishermen, as well as harassing an oil exploration vessel.",50,63,warning shots,0,2,2
3JTPR5MTZSD31B9D0HT39HQ2FYB5KK,"The Philippines accused Chinese vessels of firing warning shots at Filipino fishermen, as well as harassing an oil exploration vessel.",98,107,harassing,8,10,18
3JTPR5MTZSD31B9D0HT39HQ2FYB5KK,"The Philippines accused Chinese vessels of firing warning shots at Filipino fishermen, as well as harassing an oil exploration vessel.",98,133,harassing an oil exploration vessel,1,0,1
3JTPR5MTZSD31B9D0HT39HQ2FYB5KK,"The Philippines accused Chinese vessels of firing warning shots at Filipino fishermen, as well as harassing an oil exploration vessel.",111,126,oil exploration,1,0,1
3JTPR5MTZSD31B9D0HT39HQ2FYB5KK,"The Philippines accused Chinese vessels of firing warning shots at Filipino fishermen, as well as harassing an oil exploration vessel.",111,133,oil exploration vessel,2,1,3
3JTPR5MTZSD31B9D0HT39HQ2FYB5KK,"The Philippines accused Chinese vessels of firing warning shots at Filipino fishermen, as well as harassing an oil exploration vessel.",115,126,exploration,4,3,7
3JTPR5MTZSD31B9D0HT39HQ2FYB5KK,"The Philippines accused Chinese vessels of firing warning shots at Filipino fishermen, as well as harassing an oil exploration vessel.",115,133,exploration vessel,1,0,1
3JTPR5MTZSD31B9D0HT39HQ2FYB5KK,"The Philippines accused Chinese vessels of firing warning shots at Filipino fishermen, as well as harassing an oil exploration vessel.",127,133,vessel,0,2,2
3OPLMF3EU5OIB6X1PH1QIY33U6DNL1,"Thus far, however, the government action to clean up its banks seems to have failed to boost the sector's stocks.",0,8,Thus far,1,1,2
3OPLMF3EU5OIB6X1PH1QIY33U6DNL1,"Thus far, however, the government action to clean up its banks seems to have failed to boost the sector's stocks.",23,33,government,1,0,1
3OPLMF3EU5OIB6X1PH1QIY33U6DNL1,"Thus far, however, the government action to clean up its banks seems to have failed to boost the sector's stocks.",87,92,boost,6,4,10
3OPLMF3EU5OIB6X1PH1QIY33U6DNL1,"Thus far, however, the government action to clean up its banks seems to have failed to boost the sector's stocks.",97,103,sector,1,0,1
3OPLMF3EU5OIB6X1PH1QIY33U6DNL1,"Thus far, however, the government action to clean up its banks seems to have failed to boost the sector's stocks.",97,104,sectors,3,0,3
3OPLMF3EU5OIB6X1PH1QIY33U6DNL1,"Thus far, however, the government action to clean up its banks seems to have failed to boost the sector's stocks.",97,111,sectors stocks,3,3,6
3OPLMF3EU5OIB6X1PH1QIY33U6DNL1,"Thus far, however, the government action to clean up its banks seems to have failed to boost the sector's stocks.",106,112,stocks,1,1,2
3OPLMF3EU5OIB6X1PH1QIY33U6DNL1,"Madrid's IBEX-35 index of leading shares closed down 0.71 per cent, but at one point was off more than 3.0 per cent as even the healthiest banks suffered.",17,22,index,2,2,4
3OPLMF3EU5OIB6X1PH1QIY33U6DNL1,"Madrid's IBEX-35 index of leading shares closed down 0.71 per cent, but at one point was off more than 3.0 per cent as even the healthiest banks suffered.",17,40,index of leading shares,1,0,1
3OPLMF3EU5OIB6X1PH1QIY33U6DNL1,"Madrid's IBEX-35 index of leading shares closed down 0.71 per cent, but at one point was off more than 3.0 per cent as even the healthiest banks suffered.",26,33,leading,0,1,1
3OPLMF3EU5OIB6X1PH1QIY33U6DNL1,"Madrid's IBEX-35 index of leading shares closed down 0.71 per cent, but at one point was off more than 3.0 per cent as even the healthiest banks suffered.",26,40,leading shares,4,2,6
3OPLMF3EU5OIB6X1PH1QIY33U6DNL1,"Madrid's IBEX-35 index of leading shares closed down 0.71 per cent, but at one point was off more than 3.0 per cent as even the healthiest banks suffered.",128,138,healthiest,3,4,7
3OPLMF3EU5OIB6X1PH1QIY33U6DNL1,"Madrid's IBEX-35 index of leading shares closed down 0.71 per cent, but at one point was off more than 3.0 per cent as even the healthiest banks suffered.",128,144,healthiest banks,1,3,4
3OPLMF3EU5OIB6X1PH1QIY33U6DNL1,"Madrid's IBEX-35 index of leading shares closed down 0.71 per cent, but at one point was off more than 3.0 per cent as even the healthiest banks suffered.",145,153,suffered,1,3,4
3OPLMF3EU5OIB6X1PH1QIY33U6DNL1,"Santander, the eurozone's biggest bank by assets, fell 1.0 per cent to 4.871 euros, Spanish number-two BBVA dropped 1.26 per cent to 5.243 euros and Bankia skidded 3.37 per cent to 2.034 euros.",0,9,Santander,0,1,1
3OPLMF3EU5OIB6X1PH1QIY33U6DNL1,"Santander, the eurozone's biggest bank by assets, fell 1.0 per cent to 4.871 euros, Spanish number-two BBVA dropped 1.26 per cent to 5.243 euros and Bankia skidded 3.37 per cent to 2.034 euros.",15,23,eurozone,1,0,1
3OPLMF3EU5OIB6X1PH1QIY33U6DNL1,"Santander, the eurozone's biggest bank by assets, fell 1.0 per cent to 4.871 euros, Spanish number-two BBVA dropped 1.26 per cent to 5.243 euros and Bankia skidded 3.37 per cent to 2.034 euros.",15,24,eurozones,6,0,6
3OPLMF3EU5OIB6X1PH1QIY33U6DNL1,"Santander, the eurozone's biggest bank by assets, fell 1.0 per cent to 4.871 euros, Spanish number-two BBVA dropped 1.26 per cent to 5.243 euros and Bankia skidded 3.37 per cent to 2.034 euros.",42,48,assets,2,3,5
3OPLMF3EU5OIB6X1PH1QIY33U6DNL1,"Santander, the eurozone's biggest bank by assets, fell 1.0 per cent to 4.871 euros, Spanish number-two BBVA dropped 1.26 per cent to 5.243 euros and Bankia skidded 3.37 per cent to 2.034 euros.",103,107,BBVA,1,1,2
3OPLMF3EU5OIB6X1PH1QIY33U6DNL1,"Santander, the eurozone's biggest bank by assets, fell 1.0 per cent to 4.871 euros, Spanish number-two BBVA dropped 1.26 per cent to 5.243 euros and Bankia skidded 3.37 per cent to 2.034 euros.",149,155,Bankia,0,1,1
3OPLMF3EU5OIB6X1PH1QIY33U6DNL1,"Santander, the eurozone's biggest bank by assets, fell 1.0 per cent to 4.871 euros, Spanish number-two BBVA dropped 1.26 per cent to 5.243 euros and Bankia skidded 3.37 per cent to 2.034 euros.",156,163,skidded,7,10,17
3OPLMF3EU5OIB6X1PH1QIY33U6DNL1,"Bankia, in which the state is taking a 45-per cent stake as a crisis measure to save it from crippling bad loans, had 37.5bn euros in exposure to the property sector at the end of 2011.",0,6,Bankia,0,1,1
3OPLMF3EU5OIB6X1PH1QIY33U6DNL1,"Bankia, in which the state is taking a 45-per cent stake as a crisis measure to save it from crippling bad loans, had 37.5bn euros in exposure to the property sector at the end of 2011.",51,56,stake,1,5,6
3OPLMF3EU5OIB6X1PH1QIY33U6DNL1,"Bankia, in which the state is taking a 45-per cent stake as a crisis measure to save it from crippling bad loans, had 37.5bn euros in exposure to the property sector at the end of 2011.",62,68,crisis,3,4,7
3OPLMF3EU5OIB6X1PH1QIY33U6DNL1,"Bankia, in which the state is taking a 45-per cent stake as a crisis measure to save it from crippling bad loans, had 37.5bn euros in exposure to the property sector at the end of 2011.",62,76,crisis measure,3,2,5
3OPLMF3EU5OIB6X1PH1QIY33U6DNL1,"Bankia, in which the state is taking a 45-per cent stake as a crisis measure to save it from crippling bad loans, had 37.5bn euros in exposure to the property sector at the end of 2011.",93,102,crippling,6,10,16
3OPLMF3EU5OIB6X1PH1QIY33U6DNL1,"Bankia, in which the state is taking a 45-per cent stake as a crisis measure to save it from crippling bad loans, had 37.5bn euros in exposure to the property sector at the end of 2011.",93,112,crippling bad loans,4,1,5
3OPLMF3EU5OIB6X1PH1QIY33U6DNL1,"Bankia, in which the state is taking a 45-per cent stake as a crisis measure to save it from crippling bad loans, had 37.5bn euros in exposure to the property sector at the end of 2011.",131,142,in exposure,1,0,1
3OPLMF3EU5OIB6X1PH1QIY33U6DNL1,"Bankia, in which the state is taking a 45-per cent stake as a crisis measure to save it from crippling bad loans, had 37.5bn euros in exposure to the property sector at the end of 2011.",134,142,exposure,4,4,8
3OPLMF3EU5OIB6X1PH1QIY33U6DNL1,"Bankia, in which the state is taking a 45-per cent stake as a crisis measure to save it from crippling bad loans, had 37.5bn euros in exposure to the property sector at the end of 2011.",134,165,exposure to the property sector,0,1,1
3OPLMF3EU5OIB6X1PH1QIY33U6DNL1,"Bankia, in which the state is taking a 45-per cent stake as a crisis measure to save it from crippling bad loans, had 37.5bn euros in exposure to the property sector at the end of 2011.",150,165,property sector,3,0,3
3OPLMF3EU5OIB6X1PH1QIY33U6DNL1,"Sunni gunmen stand in the middle of Syria Street which divides the Sunni and Alawite areas, in the northern port city of Tripoli, Lebanon,.",0,5,Sunni,0,1,1
3OPLMF3EU5OIB6X1PH1QIY33U6DNL1,"Sunni gunmen stand in the middle of Syria Street which divides the Sunni and Alawite areas, in the northern port city of Tripoli, Lebanon,.",0,12,Sunni gunmen,2,0,2
3OPLMF3EU5OIB6X1PH1QIY33U6DNL1,"Sunni gunmen stand in the middle of Syria Street which divides the Sunni and Alawite areas, in the northern port city of Tripoli, Lebanon,.",6,12,gunmen,0,1,1
3OPLMF3EU5OIB6X1PH1QIY33U6DNL1,"Sunni gunmen stand in the middle of Syria Street which divides the Sunni and Alawite areas, in the northern port city of Tripoli, Lebanon,.",55,62,divides,2,2,4
3OPLMF3EU5OIB6X1PH1QIY33U6DNL1,"Sunni gunmen stand in the middle of Syria Street which divides the Sunni and Alawite areas, in the northern port city of Tripoli, Lebanon,.",67,84,Sunni and Alawite,1,0,1
3OPLMF3EU5OIB6X1PH1QIY33U6DNL1,"Sunni gunmen stand in the middle of Syria Street which divides the Sunni and Alawite areas, in the northern port city of Tripoli, Lebanon,.",77,84,Alawite,0,1,1
3OPLMF3EU5OIB6X1PH1QIY33U6DNL1,"Sunni gunmen stand in the middle of Syria Street which divides the Sunni and Alawite areas, in the northern port city of Tripoli, Lebanon,.",77,90,Alawite areas,1,0,1
3OPLMF3EU5OIB6X1PH1QIY33U6DNL1,"Sunni gunmen stand in the middle of Syria Street which divides the Sunni and Alawite areas, in the northern port city of Tripoli, Lebanon,.",99,107,northern,1,0,1
3GS542CVJVOJKFQMWK2EJ8CM3RW950,"Syria restricts media access, making it difficult to verify accounts of the unrest.",6,15,restricts,6,3,9
3GS542CVJVOJKFQMWK2EJ8CM3RW950,"Syria restricts media access, making it difficult to verify accounts of the unrest.",6,28,restricts media access,2,0,2
3GS542CVJVOJKFQMWK2EJ8CM3RW950,"Syria restricts media access, making it difficult to verify accounts of the unrest.",16,28,media access,1,1,2
3GS542CVJVOJKFQMWK2EJ8CM3RW950,"Syria restricts media access, making it difficult to verify accounts of the unrest.",22,28,access,1,1,2
3GS542CVJVOJKFQMWK2EJ8CM3RW950,"Syria restricts media access, making it difficult to verify accounts of the unrest.",40,68,difficult to verify accounts,1,0,1
3GS542CVJVOJKFQMWK2EJ8CM3RW950,"Syria restricts media access, making it difficult to verify accounts of the unrest.",53,59,verify,2,1,3
3GS542CVJVOJKFQMWK2EJ8CM3RW950,"Syria restricts media access, making it difficult to verify accounts of the unrest.",53,68,verify accounts,2,0,2
3GS542CVJVOJKFQMWK2EJ8CM3RW950,"Syria restricts media access, making it difficult to verify accounts of the unrest.",60,68,accounts,0,1,1
3GS542CVJVOJKFQMWK2EJ8CM3RW950,"Syria restricts media access, making it difficult to verify accounts of the unrest.",76,82,unrest,5,10,15
3GS542CVJVOJKFQMWK2EJ8CM3RW950,"Syria's Sunni majority is at the forefront of the uprising against Assad, whose minority Alawite sect is an offshoot of Shi'ite Islam.",8,13,Sunni,0,1,1
3GS542CVJVOJKFQMWK2EJ8CM3RW950,"Syria's Sunni majority is at the forefront of the uprising against Assad, whose minority Alawite sect is an offshoot of Shi'ite Islam.",14,22,majority,1,1,2
3GS542CVJVOJKFQMWK2EJ8CM3RW950,"Syria's Sunni majority is at the forefront of the uprising against Assad, whose minority Alawite sect is an offshoot of Shi'ite Islam.",33,42,forefront,6,10,16
3GS542CVJVOJKFQMWK2EJ8CM3RW950,"Syria's Sunni majority is at the forefront of the uprising against Assad, whose minority Alawite sect is an offshoot of Shi'ite Islam.",33,58,forefront of the uprising,1,0,1
3GS542CVJVOJKFQMWK2EJ8CM3RW950,"Syria's Sunni majority is at the forefront of the uprising against Assad, whose minority Alawite sect is an offshoot of Shi'ite Islam.",50,58,uprising,3,5,8
3GS542CVJVOJKFQMWK2EJ8CM3RW950,"Syria's Sunni majority is at the forefront of the uprising against Assad, whose minority Alawite sect is an offshoot of Shi'ite Islam.",80,88,minority,1,0,1
3GS542CVJVOJKFQMWK2EJ8CM3RW950,"Syria's Sunni majority is at the forefront of the uprising against Assad, whose minority Alawite sect is an offshoot of Shi'ite Islam.",80,116,minority Alawite sect is an offshoot,1,0,1
3GS542CVJVOJKFQMWK2EJ8CM3RW950,"Syria's Sunni majority is at the forefront of the uprising against Assad, whose minority Alawite sect is an offshoot of Shi'ite Islam.",89,96,Alawite,0,1,1
3GS542CVJVOJKFQMWK2EJ8CM3RW950,"Syria's Sunni majority is at the forefront of the uprising against Assad, whose minority Alawite sect is an offshoot of Shi'ite Islam.",89,101,Alawite sect,2,1,3
3GS542CVJVOJKFQMWK2EJ8CM3RW950,"Syria's Sunni majority is at the forefront of the uprising against Assad, whose minority Alawite sect is an offshoot of Shi'ite Islam.",97,101,sect,3,2,5
3GS542CVJVOJKFQMWK2EJ8CM3RW950,"Syria's Sunni majority is at the forefront of the uprising against Assad, whose minority Alawite sect is an offshoot of Shi'ite Islam.",108,116,offshoot,8,10,18
3GS542CVJVOJKFQMWK2EJ8CM3RW950,"Syria's Sunni majority is at the forefront of the uprising against Assad, whose minority Alawite sect is an offshoot of Shi'ite Islam.",120,126,Shiite,0,1,1
3GS542CVJVOJKFQMWK2EJ8CM3RW950,"Syria's Sunni majority is at the forefront of the uprising against Assad, whose minority Alawite sect is an offshoot of Shi'ite Islam.",120,132,Shiite Islam,1,0,1
3GS542CVJVOJKFQMWK2EJ8CM3RW950,Assad's government says it is fighting a terrorist attempt to divide Syria.,8,18,government,1,0,1
3GS542CVJVOJKFQMWK2EJ8CM3RW950,Assad's government says it is fighting a terrorist attempt to divide Syria.,62,68,divide,1,0,1
3GS542CVJVOJKFQMWK2EJ8CM3RW950,"Rastan has in the past been a major source of Sunni Muslim conscripts who provide most of manpower in the military, which is dominated by Alawite officers.",0,6,Rastan,0,1,1
3GS542CVJVOJKFQMWK2EJ8CM3RW950,"Rastan has in the past been a major source of Sunni Muslim conscripts who provide most of manpower in the military, which is dominated by Alawite officers.",46,51,Sunni,0,1,1
3GS542CVJVOJKFQMWK2EJ8CM3RW950,"Rastan has in the past been a major source of Sunni Muslim conscripts who provide most of manpower in the military, which is dominated by Alawite officers.",59,69,conscripts,8,10,18
3GS542CVJVOJKFQMWK2EJ8CM3RW950,"Rastan has in the past been a major source of Sunni Muslim conscripts who provide most of manpower in the military, which is dominated by Alawite officers.",74,81,provide,0,1,1
3GS542CVJVOJKFQMWK2EJ8CM3RW950,"Rastan has in the past been a major source of Sunni Muslim conscripts who provide most of manpower in the military, which is dominated by Alawite officers.",90,98,manpower,4,3,7
3GS542CVJVOJKFQMWK2EJ8CM3RW950,"Rastan has in the past been a major source of Sunni Muslim conscripts who provide most of manpower in the military, which is dominated by Alawite officers.",125,134,dominated,1,4,5
3GS542CVJVOJKFQMWK2EJ8CM3RW950,"Rastan has in the past been a major source of Sunni Muslim conscripts who provide most of manpower in the military, which is dominated by Alawite officers.",138,145,Alawite,0,1,1
3GS542CVJVOJKFQMWK2EJ8CM3RW950,Sunni officers from Rastan began defecting after security forces shot dead dozens of demonstrators in the town and arrested many of its notables.,20,26,Rastan,0,1,1
3GS542CVJVOJKFQMWK2EJ8CM3RW950,Sunni officers from Rastan began defecting after security forces shot dead dozens of demonstrators in the town and arrested many of its notables.,33,42,defecting,7,5,12
3GS542CVJVOJKFQMWK2EJ8CM3RW950,Sunni officers from Rastan began defecting after security forces shot dead dozens of demonstrators in the town and arrested many of its notables.,85,98,demonstrators,4,3,7
3GS542CVJVOJKFQMWK2EJ8CM3RW950,Sunni officers from Rastan began defecting after security forces shot dead dozens of demonstrators in the town and arrested many of its notables.,136,144,notables,8,5,13
3GS542CVJVOJKFQMWK2EJ8CM3RW950,The area was scene of the first serious armed confrontations between army defectors and loyalist forces last year.,32,60,serious armed confrontations,2,0,2
3GS542CVJVOJKFQMWK2EJ8CM3RW950,The area was scene of the first serious armed confrontations between army defectors and loyalist forces last year.,46,60,confrontations,7,9,16
3GS542CVJVOJKFQMWK2EJ8CM3RW950,The area was scene of the first serious armed confrontations between army defectors and loyalist forces last year.,69,83,army defectors,1,0,1
3GS542CVJVOJKFQMWK2EJ8CM3RW950,The area was scene of the first serious armed confrontations between army defectors and loyalist forces last year.,74,83,defectors,5,7,12
3GS542CVJVOJKFQMWK2EJ8CM3RW950,The area was scene of the first serious armed confrontations between army defectors and loyalist forces last year.,88,96,loyalist,3,3,6
3GS542CVJVOJKFQMWK2EJ8CM3RW950,The area was scene of the first serious armed confrontations between army defectors and loyalist forces last year.,88,103,loyalist forces,1,0,1
3GS542CVJVOJKFQMWK2EJ8CM3RW950,Assad's forces regained control of the city several times but it has kept falling back into rebel hands.,15,23,regained,2,3,5
3GS542CVJVOJKFQMWK2EJ8CM3RW950,Assad's forces regained control of the city several times but it has kept falling back into rebel hands.,74,86,falling back,0,1,1
3GS542CVJVOJKFQMWK2EJ8CM3RW950,Assad's forces regained control of the city several times but it has kept falling back into rebel hands.,92,97,rebel,1,4,5
3DQYSJDTYLC9HU1DA11V354HO0PEXJ,"The acquisition is the largest wireless-equipment deal in at least a decade, according to data compiled by Bloomberg.",4,15,acquisition,10,10,20
3DQYSJDTYLC9HU1DA11V354HO0PEXJ,"The acquisition is the largest wireless-equipment deal in at least a decade, according to data compiled by Bloomberg.",31,49,wireless-equipment,5,5,10
3DQYSJDTYLC9HU1DA11V354HO0PEXJ,"The acquisition is the largest wireless-equipment deal in at least a decade, according to data compiled by Bloomberg.",31,54,wireless-equipment deal,1,0,1
3DQYSJDTYLC9HU1DA11V354HO0PEXJ,"The acquisition is the largest wireless-equipment deal in at least a decade, according to data compiled by Bloomberg.",50,54,deal,0,1,1
3DQYSJDTYLC9HU1DA11V354HO0PEXJ,"The acquisition is the largest wireless-equipment deal in at least a decade, according to data compiled by Bloomberg.",69,75,decade,0,3,3
3DQYSJDTYLC9HU1DA11V354HO0PEXJ,"The acquisition is the largest wireless-equipment deal in at least a decade, according to data compiled by Bloomberg.",90,94,data,1,0,1
3DQYSJDTYLC9HU1DA11V354HO0PEXJ,"The acquisition is the largest wireless-equipment deal in at least a decade, according to data compiled by Bloomberg.",90,103,data compiled,1,0,1
3DQYSJDTYLC9HU1DA11V354HO0PEXJ,"The acquisition is the largest wireless-equipment deal in at least a decade, according to data compiled by Bloomberg.",95,103,compiled,8,7,15
3DQYSJDTYLC9HU1DA11V354HO0PEXJ,"“Our stance since we agreed to acquire Motorola has not changed and we look forward to closing the deal,” Mountain View, California-based Google said in an e-mailed statement.",5,11,stance,4,8,12
3DQYSJDTYLC9HU1DA11V354HO0PEXJ,"“Our stance since we agreed to acquire Motorola has not changed and we look forward to closing the deal,” Mountain View, California-based Google said in an e-mailed statement.",21,27,agreed,1,0,1
3DQYSJDTYLC9HU1DA11V354HO0PEXJ,"“Our stance since we agreed to acquire Motorola has not changed and we look forward to closing the deal,” Mountain View, California-based Google said in an e-mailed statement.",31,38,acquire,6,3,9
3DQYSJDTYLC9HU1DA11V354HO0PEXJ,"“Our stance since we agreed to acquire Motorola has not changed and we look forward to closing the deal,” Mountain View, California-based Google said in an e-mailed statement.",71,86,look forward to,0,1,1
3DQYSJDTYLC9HU1DA11V354HO0PEXJ,"“Our stance since we agreed to acquire Motorola has not changed and we look forward to closing the deal,” Mountain View, California-based Google said in an e-mailed statement.",87,103,closing the deal,2,0,2
3DQYSJDTYLC9HU1DA11V354HO0PEXJ,The company also confirmed it had received word from Chinese authorities of the purchase being approved.,17,26,confirmed,2,3,5
3DQYSJDTYLC9HU1DA11V354HO0PEXJ,The company also confirmed it had received word from Chinese authorities of the purchase being approved.,34,47,received word,1,0,1
3DQYSJDTYLC9HU1DA11V354HO0PEXJ,The company also confirmed it had received word from Chinese authorities of the purchase being approved.,61,72,authorities,1,3,4
3DQYSJDTYLC9HU1DA11V354HO0PEXJ,The company also confirmed it had received word from Chinese authorities of the purchase being approved.,80,88,purchase,1,0,1
3DQYSJDTYLC9HU1DA11V354HO0PEXJ,The company also confirmed it had received word from Chinese authorities of the purchase being approved.,95,103,approved,1,2,3
3DQYSJDTYLC9HU1DA11V354HO0PEXJ,Google fell 3.6 percent to $600.40 yesterday in New York trading.,7,11,fell,0,1,1
3DQYSJDTYLC9HU1DA11V354HO0PEXJ,Google fell 3.6 percent to $600.40 yesterday in New York trading.,48,65,New York  trading,1,0,1
3DQYSJDTYLC9HU1DA11V354HO0PEXJ,Google fell 3.6 percent to $600.40 yesterday in New York trading.,57,64,trading,1,0,1
3DQYSJDTYLC9HU1DA11V354HO0PEXJ,The shares have fallen 7 percent this year.,4,10,shares,2,2,4
3DQYSJDTYLC9HU1DA11V354HO0PEXJ,The shares have fallen 7 percent this year.,16,22,fallen,0,1,1
3DQYSJDTYLC9HU1DA11V354HO0PEXJ,Motorola Mobility closed unchanged at $39.20.,18,24,closed,1,0,1
3DQYSJDTYLC9HU1DA11V354HO0PEXJ,Motorola Mobility closed unchanged at $39.20.,25,34,unchanged,1,1,2
3DQYSJDTYLC9HU1DA11V354HO0PEXJ,The stock is up 1 percent year to date.,4,9,stock,2,1,3
3DQYSJDTYLC9HU1DA11V354HO0PEXJ,The stock is up 1 percent year to date.,26,38,year to date,0,1,1
3DQYSJDTYLC9HU1DA11V354HO0PEXJ,A teenager has been shot dead and her sister has been seriously injured in a gun attack in Bellaghy.,2,10,teenager,0,3,3
3DQYSJDTYLC9HU1DA11V354HO0PEXJ,A teenager has been shot dead and her sister has been seriously injured in a gun attack in Bellaghy.,54,71,seriously injured,1,2,3
3DQYSJDTYLC9HU1DA11V354HO0PEXJ,A teenager has been shot dead and her sister has been seriously injured in a gun attack in Bellaghy.,64,71,injured,0,1,1
3DQYSJDTYLC9HU1DA11V354HO0PEXJ,A teenager has been shot dead and her sister has been seriously injured in a gun attack in Bellaghy.,77,87,gun attack,0,1,1
3DQYSJDTYLC9HU1DA11V354HO0PEXJ,The fatal incident occurred at a house in the William Court area of the Co Londonderry village on Saturday morning.,4,9,fatal,3,6,9
3DQYSJDTYLC9HU1DA11V354HO0PEXJ,The fatal incident occurred at a house in the William Court area of the Co Londonderry village on Saturday morning.,4,18,fatal incident,4,3,7
3DQYSJDTYLC9HU1DA11V354HO0PEXJ,The fatal incident occurred at a house in the William Court area of the Co Londonderry village on Saturday morning.,10,18,incident,1,0,1
3DQYSJDTYLC9HU1DA11V354HO0PEXJ,The fatal incident occurred at a house in the William Court area of the Co Londonderry village on Saturday morning.,19,27,occurred,1,2,3
3Y3CZJSZ9KUPOFM8Q120ATCGAQ55RD,The children ranged in age from 12 to 17.,13,19,ranged,5,5,10
3Y3CZJSZ9KUPOFM8Q120ATCGAQ55RD,The children ranged in age from 12 to 17.,13,26,ranged in age,0,1,1
3Y3CZJSZ9KUPOFM8Q120ATCGAQ55RD,"It appeared they had been shot, Goodyear said.",4,12,appeared,3,4,7
3Y3CZJSZ9KUPOFM8Q120ATCGAQ55RD,"It appeared they had been shot, Goodyear said.",18,26,had been,0,1,1
3Y3CZJSZ9KUPOFM8Q120ATCGAQ55RD,"It appeared they had been shot, Goodyear said.",27,31,shot,1,1,2
3Y3CZJSZ9KUPOFM8Q120ATCGAQ55RD,"The mother of the children came out of the residence next door, called for the children to return home, at which time they left and went back to the house.",44,53,residence,9,2,11
3Y3CZJSZ9KUPOFM8Q120ATCGAQ55RD,"The mother of the children came out of the residence next door, called for the children to return home, at which time they left and went back to the house.",44,63,residence next door,1,0,1
3Y3CZJSZ9KUPOFM8Q120ATCGAQ55RD,The neighbor then heard gunshots and called police.,4,12,neighbor,0,4,4
3Y3CZJSZ9KUPOFM8Q120ATCGAQ55RD,The neighbor then heard gunshots and called police.,13,23,then heard,0,1,1
3Y3CZJSZ9KUPOFM8Q120ATCGAQ55RD,The neighbor then heard gunshots and called police.,18,23,heard,0,1,1
3Y3CZJSZ9KUPOFM8Q120ATCGAQ55RD,The neighbor then heard gunshots and called police.,24,32,gunshots,0,2,2
3Y3CZJSZ9KUPOFM8Q120ATCGAQ55RD,"Another neighbor told deputies that Thomas sent a text message in the middle of the night saying she wanted to be cremated with her children, Goodyear said.",8,16,neighbor,0,1,1
3Y3CZJSZ9KUPOFM8Q120ATCGAQ55RD,"Another neighbor told deputies that Thomas sent a text message in the middle of the night saying she wanted to be cremated with her children, Goodyear said.",22,30,deputies,7,5,12
3Y3CZJSZ9KUPOFM8Q120ATCGAQ55RD,"Another neighbor told deputies that Thomas sent a text message in the middle of the night saying she wanted to be cremated with her children, Goodyear said.",50,62,text message,1,1,2
3Y3CZJSZ9KUPOFM8Q120ATCGAQ55RD,"Another neighbor told deputies that Thomas sent a text message in the middle of the night saying she wanted to be cremated with her children, Goodyear said.",55,62,message,0,1,1
3Y3CZJSZ9KUPOFM8Q120ATCGAQ55RD,"Another neighbor told deputies that Thomas sent a text message in the middle of the night saying she wanted to be cremated with her children, Goodyear said.",108,122,to be cremated,0,1,1
3Y3CZJSZ9KUPOFM8Q120ATCGAQ55RD,"Another neighbor told deputies that Thomas sent a text message in the middle of the night saying she wanted to be cremated with her children, Goodyear said.",114,122,cremated,10,10,20
3Y3CZJSZ9KUPOFM8Q120ATCGAQ55RD,"The shooting happened in an area known as the ""Space Coast"" because it is the home of NASA's Kennedy Space Center, the location of numerous shuttle launches.",4,12,shooting,0,1,1
3Y3CZJSZ9KUPOFM8Q120ATCGAQ55RD,"The shooting happened in an area known as the ""Space Coast"" because it is the home of NASA's Kennedy Space Center, the location of numerous shuttle launches.",47,58,Space Coast,3,0,3
3Y3CZJSZ9KUPOFM8Q120ATCGAQ55RD,"The shooting happened in an area known as the ""Space Coast"" because it is the home of NASA's Kennedy Space Center, the location of numerous shuttle launches.",93,113,Kennedy Space Center,1,0,1
3Y3CZJSZ9KUPOFM8Q120ATCGAQ55RD,"The shooting happened in an area known as the ""Space Coast"" because it is the home of NASA's Kennedy Space Center, the location of numerous shuttle launches.",119,127,location,1,1,2
3Y3CZJSZ9KUPOFM8Q120ATCGAQ55RD,"The shooting happened in an area known as the ""Space Coast"" because it is the home of NASA's Kennedy Space Center, the location of numerous shuttle launches.",131,139,numerous,5,5,10
3Y3CZJSZ9KUPOFM8Q120ATCGAQ55RD,"The shooting happened in an area known as the ""Space Coast"" because it is the home of NASA's Kennedy Space Center, the location of numerous shuttle launches.",131,156,numerous shuttle launches,1,0,1
3Y3CZJSZ9KUPOFM8Q120ATCGAQ55RD,"The shooting happened in an area known as the ""Space Coast"" because it is the home of NASA's Kennedy Space Center, the location of numerous shuttle launches.",140,147,shuttle,3,3,6
3Y3CZJSZ9KUPOFM8Q120ATCGAQ55RD,"The shooting happened in an area known as the ""Space Coast"" because it is the home of NASA's Kennedy Space Center, the location of numerous shuttle launches.",140,156,shuttle launches,1,2,3
3Y3CZJSZ9KUPOFM8Q120ATCGAQ55RD,"The shooting happened in an area known as the ""Space Coast"" because it is the home of NASA's Kennedy Space Center, the location of numerous shuttle launches.",148,156,launches,1,3,4
3Y3CZJSZ9KUPOFM8Q120ATCGAQ55RD,Gardaí are to carry out a technical examination of the scene of a shooting in Dublin last night.,0,6,Gardaí,1,1,2
3Y3CZJSZ9KUPOFM8Q120ATCGAQ55RD,Gardaí are to carry out a technical examination of the scene of a shooting in Dublin last night.,26,35,technical,5,0,5
3Y3CZJSZ9KUPOFM8Q120ATCGAQ55RD,Gardaí are to carry out a technical examination of the scene of a shooting in Dublin last night.,26,47,technical examination,5,3,8
3Y3CZJSZ9KUPOFM8Q120ATCGAQ55RD,Gardaí are to carry out a technical examination of the scene of a shooting in Dublin last night.,36,47,examination,4,0,4
3Y3CZJSZ9KUPOFM8Q120ATCGAQ55RD,Gardaí are to carry out a technical examination of the scene of a shooting in Dublin last night.,66,74,shooting,0,1,1
36QZ6V1589EIA9C06RAD8F9SUWESUC,The deal signed with Karzai does not commit the United States to any specific troop presence or spending.,4,8,deal,0,2,2
36QZ6V1589EIA9C06RAD8F9SUWESUC,The deal signed with Karzai does not commit the United States to any specific troop presence or spending.,9,15,signed,1,0,1
36QZ6V1589EIA9C06RAD8F9SUWESUC,The deal signed with Karzai does not commit the United States to any specific troop presence or spending.,21,27,Karzai,2,0,2
36QZ6V1589EIA9C06RAD8F9SUWESUC,The deal signed with Karzai does not commit the United States to any specific troop presence or spending.,37,43,commit,5,4,9
36QZ6V1589EIA9C06RAD8F9SUWESUC,The deal signed with Karzai does not commit the United States to any specific troop presence or spending.,69,77,specific,1,2,3
36QZ6V1589EIA9C06RAD8F9SUWESUC,The deal signed with Karzai does not commit the United States to any specific troop presence or spending.,69,92,specific troop presence,1,0,1
36QZ6V1589EIA9C06RAD8F9SUWESUC,The deal signed with Karzai does not commit the United States to any specific troop presence or spending.,78,83,troop,0,1,1
36QZ6V1589EIA9C06RAD8F9SUWESUC,The deal signed with Karzai does not commit the United States to any specific troop presence or spending.,78,92,troop presence,2,0,2
36QZ6V1589EIA9C06RAD8F9SUWESUC,The deal signed with Karzai does not commit the United States to any specific troop presence or spending.,84,92,presence,1,0,1
36QZ6V1589EIA9C06RAD8F9SUWESUC,The deal signed with Karzai does not commit the United States to any specific troop presence or spending.,96,104,spending,1,0,1
36QZ6V1589EIA9C06RAD8F9SUWESUC,But it does allow the U.S. to potentially keep troops in Afghanistan through 2024 for two specific purposes: continued training of Afghan forces and targeted operations against al-Qaida.,30,41,potentially,5,4,9
36QZ6V1589EIA9C06RAD8F9SUWESUC,But it does allow the U.S. to potentially keep troops in Afghanistan through 2024 for two specific purposes: continued training of Afghan forces and targeted operations against al-Qaida.,30,53,potentially keep troops,0,1,1
36QZ6V1589EIA9C06RAD8F9SUWESUC,But it does allow the U.S. to potentially keep troops in Afghanistan through 2024 for two specific purposes: continued training of Afghan forces and targeted operations against al-Qaida.,47,53,troops,1,1,2
36QZ6V1589EIA9C06RAD8F9SUWESUC,But it does allow the U.S. to potentially keep troops in Afghanistan through 2024 for two specific purposes: continued training of Afghan forces and targeted operations against al-Qaida.,90,98,specific,1,1,2
36QZ6V1589EIA9C06RAD8F9SUWESUC,But it does allow the U.S. to potentially keep troops in Afghanistan through 2024 for two specific purposes: continued training of Afghan forces and targeted operations against al-Qaida.,90,107,specific purposes,1,0,1
36QZ6V1589EIA9C06RAD8F9SUWESUC,But it does allow the U.S. to potentially keep troops in Afghanistan through 2024 for two specific purposes: continued training of Afghan forces and targeted operations against al-Qaida.,99,107,purposes,0,1,1
36QZ6V1589EIA9C06RAD8F9SUWESUC,But it does allow the U.S. to potentially keep troops in Afghanistan through 2024 for two specific purposes: continued training of Afghan forces and targeted operations against al-Qaida.,109,118,continued,0,1,1
36QZ6V1589EIA9C06RAD8F9SUWESUC,But it does allow the U.S. to potentially keep troops in Afghanistan through 2024 for two specific purposes: continued training of Afghan forces and targeted operations against al-Qaida.,149,157,targeted,0,1,1
36QZ6V1589EIA9C06RAD8F9SUWESUC,But it does allow the U.S. to potentially keep troops in Afghanistan through 2024 for two specific purposes: continued training of Afghan forces and targeted operations against al-Qaida.,149,168,targeted operations,5,1,6
36QZ6V1589EIA9C06RAD8F9SUWESUC,But it does allow the U.S. to potentially keep troops in Afghanistan through 2024 for two specific purposes: continued training of Afghan forces and targeted operations against al-Qaida.,158,168,operations,1,0,1
36QZ6V1589EIA9C06RAD8F9SUWESUC,The United States also promises to seek money from Congress every year to support Afghanistan.,35,39,seek,2,1,3
36QZ6V1589EIA9C06RAD8F9SUWESUC,The United States also promises to seek money from Congress every year to support Afghanistan.,35,59,seek money from Congress,1,0,1
36QZ6V1589EIA9C06RAD8F9SUWESUC,The United States also promises to seek money from Congress every year to support Afghanistan.,51,59,Congress,2,0,2
36QZ6V1589EIA9C06RAD8F9SUWESUC,"The attack began with a suicide car bomb near the gate of the privately guarded compound, which sits off Jalalabad road — one of the main thoroughfares out of the city, Interior Ministry spokesman Sediq Sediqi said.",24,31,suicide,4,2,6
36QZ6V1589EIA9C06RAD8F9SUWESUC,"The attack began with a suicide car bomb near the gate of the privately guarded compound, which sits off Jalalabad road — one of the main thoroughfares out of the city, Interior Ministry spokesman Sediq Sediqi said.",24,40,suicide car bomb,3,0,3
36QZ6V1589EIA9C06RAD8F9SUWESUC,"The attack began with a suicide car bomb near the gate of the privately guarded compound, which sits off Jalalabad road — one of the main thoroughfares out of the city, Interior Ministry spokesman Sediq Sediqi said.",62,71,privately,0,1,1
36QZ6V1589EIA9C06RAD8F9SUWESUC,"The attack began with a suicide car bomb near the gate of the privately guarded compound, which sits off Jalalabad road — one of the main thoroughfares out of the city, Interior Ministry spokesman Sediq Sediqi said.",62,88,privately guarded compound,3,0,3
36QZ6V1589EIA9C06RAD8F9SUWESUC,"The attack began with a suicide car bomb near the gate of the privately guarded compound, which sits off Jalalabad road — one of the main thoroughfares out of the city, Interior Ministry spokesman Sediq Sediqi said.",72,79,guarded,0,1,1
36QZ6V1589EIA9C06RAD8F9SUWESUC,"The attack began with a suicide car bomb near the gate of the privately guarded compound, which sits off Jalalabad road — one of the main thoroughfares out of the city, Interior Ministry spokesman Sediq Sediqi said.",80,88,compound,6,2,8
36QZ6V1589EIA9C06RAD8F9SUWESUC,"The attack began with a suicide car bomb near the gate of the privately guarded compound, which sits off Jalalabad road — one of the main thoroughfares out of the city, Interior Ministry spokesman Sediq Sediqi said.",96,104,sits off,2,0,2
36QZ6V1589EIA9C06RAD8F9SUWESUC,"The attack began with a suicide car bomb near the gate of the privately guarded compound, which sits off Jalalabad road — one of the main thoroughfares out of the city, Interior Ministry spokesman Sediq Sediqi said.",138,151,thoroughfares,10,10,20
36QZ6V1589EIA9C06RAD8F9SUWESUC,"The attack began with a suicide car bomb near the gate of the privately guarded compound, which sits off Jalalabad road — one of the main thoroughfares out of the city, Interior Ministry spokesman Sediq Sediqi said.",169,186,Interior Ministry,1,0,1
36QZ6V1589EIA9C06RAD8F9SUWESUC,"The attack began with a suicide car bomb near the gate of the privately guarded compound, which sits off Jalalabad road — one of the main thoroughfares out of the city, Interior Ministry spokesman Sediq Sediqi said.",187,196,spokesman,1,3,4
36QZ6V1589EIA9C06RAD8F9SUWESUC,"Kabul Deputy Police Chief Daoud Amin said those killed in the blast included four people in a station wagon that was driving past the area, a passer-by and a Nepalese security guard.",62,67,blast,2,3,5
36QZ6V1589EIA9C06RAD8F9SUWESUC,"Kabul Deputy Police Chief Daoud Amin said those killed in the blast included four people in a station wagon that was driving past the area, a passer-by and a Nepalese security guard.",68,76,included,0,1,1
36QZ6V1589EIA9C06RAD8F9SUWESUC,"Kabul Deputy Police Chief Daoud Amin said those killed in the blast included four people in a station wagon that was driving past the area, a passer-by and a Nepalese security guard.",94,107,station wagon,2,4,6
36QZ6V1589EIA9C06RAD8F9SUWESUC,"Kabul Deputy Police Chief Daoud Amin said those killed in the blast included four people in a station wagon that was driving past the area, a passer-by and a Nepalese security guard.",102,107,wagon,1,1,2
36QZ6V1589EIA9C06RAD8F9SUWESUC,"Kabul Deputy Police Chief Daoud Amin said those killed in the blast included four people in a station wagon that was driving past the area, a passer-by and a Nepalese security guard.",142,151,passer-by,4,3,7
36QZ6V1589EIA9C06RAD8F9SUWESUC,"Kabul Deputy Police Chief Daoud Amin said those killed in the blast included four people in a station wagon that was driving past the area, a passer-by and a Nepalese security guard.",142,155,passer-by and,0,1,1
36QZ6V1589EIA9C06RAD8F9SUWESUC,"Kabul Deputy Police Chief Daoud Amin said those killed in the blast included four people in a station wagon that was driving past the area, a passer-by and a Nepalese security guard.",158,166,Nepalese,1,0,1
3PN6H8C9R4RSTBFK3WYXDFBYN3FADI,"For years he had evaded capture and was one of the world's most wanted men, but his time on the run finally ended last year when he was arrested near Belgrade.The 70 year old will be brought before the UN Yugoslav War Crimes tribunal in the Hague later this morning accused with some of the worst atrocities in Europe since World War Two.",17,23,evaded,8,10,18
3PN6H8C9R4RSTBFK3WYXDFBYN3FADI,"For years he had evaded capture and was one of the world's most wanted men, but his time on the run finally ended last year when he was arrested near Belgrade.The 70 year old will be brought before the UN Yugoslav War Crimes tribunal in the Hague later this morning accused with some of the worst atrocities in Europe since World War Two.",17,31,evaded capture,3,1,4
3PN6H8C9R4RSTBFK3WYXDFBYN3FADI,"For years he had evaded capture and was one of the world's most wanted men, but his time on the run finally ended last year when he was arrested near Belgrade.The 70 year old will be brought before the UN Yugoslav War Crimes tribunal in the Hague later this morning accused with some of the worst atrocities in Europe since World War Two.",24,31,capture,0,3,3
3PN6H8C9R4RSTBFK3WYXDFBYN3FADI,"For years he had evaded capture and was one of the world's most wanted men, but his time on the run finally ended last year when he was arrested near Belgrade.The 70 year old will be brought before the UN Yugoslav War Crimes tribunal in the Hague later this morning accused with some of the worst atrocities in Europe since World War Two.",59,74,most wanted men,0,1,1
3PN6H8C9R4RSTBFK3WYXDFBYN3FADI,"For years he had evaded capture and was one of the world's most wanted men, but his time on the run finally ended last year when he was arrested near Belgrade.The 70 year old will be brought before the UN Yugoslav War Crimes tribunal in the Hague later this morning accused with some of the worst atrocities in Europe since World War Two.",136,144,arrested,2,1,3
3PN6H8C9R4RSTBFK3WYXDFBYN3FADI,"For years he had evaded capture and was one of the world's most wanted men, but his time on the run finally ended last year when he was arrested near Belgrade.The 70 year old will be brought before the UN Yugoslav War Crimes tribunal in the Hague later this morning accused with some of the worst atrocities in Europe since World War Two.",205,213,Yugoslav,0,1,1
3PN6H8C9R4RSTBFK3WYXDFBYN3FADI,"For years he had evaded capture and was one of the world's most wanted men, but his time on the run finally ended last year when he was arrested near Belgrade.The 70 year old will be brought before the UN Yugoslav War Crimes tribunal in the Hague later this morning accused with some of the worst atrocities in Europe since World War Two.",214,224,War Crimes,1,0,1
3PN6H8C9R4RSTBFK3WYXDFBYN3FADI,"For years he had evaded capture and was one of the world's most wanted men, but his time on the run finally ended last year when he was arrested near Belgrade.The 70 year old will be brought before the UN Yugoslav War Crimes tribunal in the Hague later this morning accused with some of the worst atrocities in Europe since World War Two.",214,233,War Crimes tribunal,0,2,2
3PN6H8C9R4RSTBFK3WYXDFBYN3FADI,"For years he had evaded capture and was one of the world's most wanted men, but his time on the run finally ended last year when he was arrested near Belgrade.The 70 year old will be brought before the UN Yugoslav War Crimes tribunal in the Hague later this morning accused with some of the worst atrocities in Europe since World War Two.",225,233,tribunal,9,3,12
3PN6H8C9R4RSTBFK3WYXDFBYN3FADI,"For years he had evaded capture and was one of the world's most wanted men, but his time on the run finally ended last year when he was arrested near Belgrade.The 70 year old will be brought before the UN Yugoslav War Crimes tribunal in the Hague later this morning accused with some of the worst atrocities in Europe since World War Two.",241,246,Hague,1,1,2
3PN6H8C9R4RSTBFK3WYXDFBYN3FADI,"For years he had evaded capture and was one of the world's most wanted men, but his time on the run finally ended last year when he was arrested near Belgrade.The 70 year old will be brought before the UN Yugoslav War Crimes tribunal in the Hague later this morning accused with some of the worst atrocities in Europe since World War Two.",266,273,accused,1,3,4
3PN6H8C9R4RSTBFK3WYXDFBYN3FADI,"For years he had evaded capture and was one of the world's most wanted men, but his time on the run finally ended last year when he was arrested near Belgrade.The 70 year old will be brought before the UN Yugoslav War Crimes tribunal in the Hague later this morning accused with some of the worst atrocities in Europe since World War Two.",291,296,worst,0,2,2
3PN6H8C9R4RSTBFK3WYXDFBYN3FADI,"For years he had evaded capture and was one of the world's most wanted men, but his time on the run finally ended last year when he was arrested near Belgrade.The 70 year old will be brought before the UN Yugoslav War Crimes tribunal in the Hague later this morning accused with some of the worst atrocities in Europe since World War Two.",291,307,worst atrocities,2,1,3
3PN6H8C9R4RSTBFK3WYXDFBYN3FADI,"For years he had evaded capture and was one of the world's most wanted men, but his time on the run finally ended last year when he was arrested near Belgrade.The 70 year old will be brought before the UN Yugoslav War Crimes tribunal in the Hague later this morning accused with some of the worst atrocities in Europe since World War Two.",297,307,atrocities,9,10,19
3PN6H8C9R4RSTBFK3WYXDFBYN3FADI,"He has denied charges of genocide, murder acts of terror and other crimes against humanity.The most infamous of the charges accuses Mladic of overseeing the massacre  of 8 thousand Muslim boys and men in Srebrenica in Eastern Bosnia in 1995.",7,13,denied,0,3,3
3PN6H8C9R4RSTBFK3WYXDFBYN3FADI,"He has denied charges of genocide, murder acts of terror and other crimes against humanity.The most infamous of the charges accuses Mladic of overseeing the massacre  of 8 thousand Muslim boys and men in Srebrenica in Eastern Bosnia in 1995.",14,21,charges,0,1,1
3PN6H8C9R4RSTBFK3WYXDFBYN3FADI,"He has denied charges of genocide, murder acts of terror and other crimes against humanity.The most infamous of the charges accuses Mladic of overseeing the massacre  of 8 thousand Muslim boys and men in Srebrenica in Eastern Bosnia in 1995.",25,33,genocide,10,10,20
3PN6H8C9R4RSTBFK3WYXDFBYN3FADI,"He has denied charges of genocide, murder acts of terror and other crimes against humanity.The most infamous of the charges accuses Mladic of overseeing the massacre  of 8 thousand Muslim boys and men in Srebrenica in Eastern Bosnia in 1995.",35,56,murder acts of terror,2,0,2
3PN6H8C9R4RSTBFK3WYXDFBYN3FADI,"He has denied charges of genocide, murder acts of terror and other crimes against humanity.The most infamous of the charges accuses Mladic of overseeing the massacre  of 8 thousand Muslim boys and men in Srebrenica in Eastern Bosnia in 1995.",50,56,terror,0,2,2
3PN6H8C9R4RSTBFK3WYXDFBYN3FADI,"He has denied charges of genocide, murder acts of terror and other crimes against humanity.The most infamous of the charges accuses Mladic of overseeing the massacre  of 8 thousand Muslim boys and men in Srebrenica in Eastern Bosnia in 1995.",67,90,crimes against humanity,3,0,3
3PN6H8C9R4RSTBFK3WYXDFBYN3FADI,"He has denied charges of genocide, murder acts of terror and other crimes against humanity.The most infamous of the charges accuses Mladic of overseeing the massacre  of 8 thousand Muslim boys and men in Srebrenica in Eastern Bosnia in 1995.",82,90,humanity,4,1,5
3PN6H8C9R4RSTBFK3WYXDFBYN3FADI,"He has denied charges of genocide, murder acts of terror and other crimes against humanity.The most infamous of the charges accuses Mladic of overseeing the massacre  of 8 thousand Muslim boys and men in Srebrenica in Eastern Bosnia in 1995.",100,108,infamous,7,4,11
3PN6H8C9R4RSTBFK3WYXDFBYN3FADI,"He has denied charges of genocide, murder acts of terror and other crimes against humanity.The most infamous of the charges accuses Mladic of overseeing the massacre  of 8 thousand Muslim boys and men in Srebrenica in Eastern Bosnia in 1995.",124,131,accuses,1,1,2
3PN6H8C9R4RSTBFK3WYXDFBYN3FADI,"He has denied charges of genocide, murder acts of terror and other crimes against humanity.The most infamous of the charges accuses Mladic of overseeing the massacre  of 8 thousand Muslim boys and men in Srebrenica in Eastern Bosnia in 1995.",142,152,overseeing,3,4,7
3PN6H8C9R4RSTBFK3WYXDFBYN3FADI,"He has denied charges of genocide, murder acts of terror and other crimes against humanity.The most infamous of the charges accuses Mladic of overseeing the massacre  of 8 thousand Muslim boys and men in Srebrenica in Eastern Bosnia in 1995.",157,165,massacre,6,5,11
3PN6H8C9R4RSTBFK3WYXDFBYN3FADI,Mladic reportedly gave a thumbs-up and clapped to supporters in the court's public gallery as the trial got under way.,25,34,thumbs-up,4,4,8
3PN6H8C9R4RSTBFK3WYXDFBYN3FADI,Mladic reportedly gave a thumbs-up and clapped to supporters in the court's public gallery as the trial got under way.,25,46,thumbs-up and clapped,1,0,1
3PN6H8C9R4RSTBFK3WYXDFBYN3FADI,Mladic reportedly gave a thumbs-up and clapped to supporters in the court's public gallery as the trial got under way.,39,46,clapped,0,3,3
3PN6H8C9R4RSTBFK3WYXDFBYN3FADI,Mladic reportedly gave a thumbs-up and clapped to supporters in the court's public gallery as the trial got under way.,50,60,supporters,1,0,1
3PN6H8C9R4RSTBFK3WYXDFBYN3FADI,Mladic reportedly gave a thumbs-up and clapped to supporters in the court's public gallery as the trial got under way.,68,89,courts public gallery,2,0,2
3PN6H8C9R4RSTBFK3WYXDFBYN3FADI,Mladic reportedly gave a thumbs-up and clapped to supporters in the court's public gallery as the trial got under way.,83,90,gallery,2,0,2
3PN6H8C9R4RSTBFK3WYXDFBYN3FADI,Mladic reportedly gave a thumbs-up and clapped to supporters in the court's public gallery as the trial got under way.,98,103,trial,0,2,2
37PGLWGSJT7FDZ4S71CXYQU7KKHIK7,"Preliminary results indicate the party won less than 50 percent of votes, a steep fall from its earlier majority.",0,11,Preliminary,10,7,17
37PGLWGSJT7FDZ4S71CXYQU7KKHIK7,"Preliminary results indicate the party won less than 50 percent of votes, a steep fall from its earlier majority.",0,19,Preliminary results,2,0,2
37PGLWGSJT7FDZ4S71CXYQU7KKHIK7,"Preliminary results indicate the party won less than 50 percent of votes, a steep fall from its earlier majority.",20,28,indicate,1,3,4
37PGLWGSJT7FDZ4S71CXYQU7KKHIK7,"Preliminary results indicate the party won less than 50 percent of votes, a steep fall from its earlier majority.",76,81,steep,2,3,5
37PGLWGSJT7FDZ4S71CXYQU7KKHIK7,"Preliminary results indicate the party won less than 50 percent of votes, a steep fall from its earlier majority.",76,86,steep fall,1,4,5
37PGLWGSJT7FDZ4S71CXYQU7KKHIK7,"Preliminary results indicate the party won less than 50 percent of votes, a steep fall from its earlier majority.",96,112,earlier majority,1,0,1
37PGLWGSJT7FDZ4S71CXYQU7KKHIK7,"Preliminary results indicate the party won less than 50 percent of votes, a steep fall from its earlier majority.",104,112,majority,3,0,3
37PGLWGSJT7FDZ4S71CXYQU7KKHIK7,Opposition parties and international observers said the poll was marred by widespread reports and allegations of vote-rigging.,0,10,Opposition,5,0,5
37PGLWGSJT7FDZ4S71CXYQU7KKHIK7,Opposition parties and international observers said the poll was marred by widespread reports and allegations of vote-rigging.,0,18,Opposition parties,1,0,1
37PGLWGSJT7FDZ4S71CXYQU7KKHIK7,Opposition parties and international observers said the poll was marred by widespread reports and allegations of vote-rigging.,23,46,international observers,1,0,1
37PGLWGSJT7FDZ4S71CXYQU7KKHIK7,Opposition parties and international observers said the poll was marred by widespread reports and allegations of vote-rigging.,37,46,observers,1,2,3
37PGLWGSJT7FDZ4S71CXYQU7KKHIK7,Opposition parties and international observers said the poll was marred by widespread reports and allegations of vote-rigging.,56,60,poll,0,1,1
37PGLWGSJT7FDZ4S71CXYQU7KKHIK7,Opposition parties and international observers said the poll was marred by widespread reports and allegations of vote-rigging.,65,71,marred,7,10,17
37PGLWGSJT7FDZ4S71CXYQU7KKHIK7,Opposition parties and international observers said the poll was marred by widespread reports and allegations of vote-rigging.,75,85,widespread,2,3,5
37PGLWGSJT7FDZ4S71CXYQU7KKHIK7,Opposition parties and international observers said the poll was marred by widespread reports and allegations of vote-rigging.,98,109,allegations,10,8,18
37PGLWGSJT7FDZ4S71CXYQU7KKHIK7,Opposition parties and international observers said the poll was marred by widespread reports and allegations of vote-rigging.,98,125,allegations of vote-rigging,1,1,2
37PGLWGSJT7FDZ4S71CXYQU7KKHIK7,Opposition parties and international observers said the poll was marred by widespread reports and allegations of vote-rigging.,113,125,vote-rigging,7,10,17
37PGLWGSJT7FDZ4S71CXYQU7KKHIK7,"Kirill Kudryavtsev / AFP - Getty Images Police officers surround Russian opposition leader Boris Nemtsov, who was detained while taking part in an unauthorized rally at the Triumfalnaya Square in central Moscow late on Tuesday.",56,64,surround,0,1,1
37PGLWGSJT7FDZ4S71CXYQU7KKHIK7,"Kirill Kudryavtsev / AFP - Getty Images Police officers surround Russian opposition leader Boris Nemtsov, who was detained while taking part in an unauthorized rally at the Triumfalnaya Square in central Moscow late on Tuesday.",65,90,Russian opposition leader,1,0,1
37PGLWGSJT7FDZ4S71CXYQU7KKHIK7,"Kirill Kudryavtsev / AFP - Getty Images Police officers surround Russian opposition leader Boris Nemtsov, who was detained while taking part in an unauthorized rally at the Triumfalnaya Square in central Moscow late on Tuesday.",73,83,opposition,2,1,3
37PGLWGSJT7FDZ4S71CXYQU7KKHIK7,"Kirill Kudryavtsev / AFP - Getty Images Police officers surround Russian opposition leader Boris Nemtsov, who was detained while taking part in an unauthorized rally at the Triumfalnaya Square in central Moscow late on Tuesday.",114,122,detained,6,8,14
37PGLWGSJT7FDZ4S71CXYQU7KKHIK7,"Kirill Kudryavtsev / AFP - Getty Images Police officers surround Russian opposition leader Boris Nemtsov, who was detained while taking part in an unauthorized rally at the Triumfalnaya Square in central Moscow late on Tuesday.",147,159,unauthorized,10,7,17
37PGLWGSJT7FDZ4S71CXYQU7KKHIK7,"Kirill Kudryavtsev / AFP - Getty Images Police officers surround Russian opposition leader Boris Nemtsov, who was detained while taking part in an unauthorized rally at the Triumfalnaya Square in central Moscow late on Tuesday.",147,165,unauthorized rally,3,1,4
37PGLWGSJT7FDZ4S71CXYQU7KKHIK7,"Kirill Kudryavtsev / AFP - Getty Images Police officers surround Russian opposition leader Boris Nemtsov, who was detained while taking part in an unauthorized rally at the Triumfalnaya Square in central Moscow late on Tuesday.",160,165,rally,1,3,4
37PGLWGSJT7FDZ4S71CXYQU7KKHIK7,"Meanwhile, Russia's foreign minister took a swipe at Secretary of State Hillary Clinton Wednesday over her criticism of the election, saying it was ""not Hyde Park"" where speakers could just arrive, hold forth and leave without listening to others.",20,36,foreign minister,1,0,1
37PGLWGSJT7FDZ4S71CXYQU7KKHIK7,"Meanwhile, Russia's foreign minister took a swipe at Secretary of State Hillary Clinton Wednesday over her criticism of the election, saying it was ""not Hyde Park"" where speakers could just arrive, hold forth and leave without listening to others.",44,49,swipe,3,10,13
37PGLWGSJT7FDZ4S71CXYQU7KKHIK7,"Meanwhile, Russia's foreign minister took a swipe at Secretary of State Hillary Clinton Wednesday over her criticism of the election, saying it was ""not Hyde Park"" where speakers could just arrive, hold forth and leave without listening to others.",107,116,criticism,6,7,13
37PGLWGSJT7FDZ4S71CXYQU7KKHIK7,"Meanwhile, Russia's foreign minister took a swipe at Secretary of State Hillary Clinton Wednesday over her criticism of the election, saying it was ""not Hyde Park"" where speakers could just arrive, hold forth and leave without listening to others.",198,208,hold forth,1,1,2
37PGLWGSJT7FDZ4S71CXYQU7KKHIK7,"A Florida mother who fatally shot her four children before killing herself Tuesday called three of the kids who had sought help from a neighbor back to the house before firing the fatal shots, authorities said.",21,28,fatally,4,2,6
37PGLWGSJT7FDZ4S71CXYQU7KKHIK7,"A Florida mother who fatally shot her four children before killing herself Tuesday called three of the kids who had sought help from a neighbor back to the house before firing the fatal shots, authorities said.",21,33,fatally shot,0,2,2
37PGLWGSJT7FDZ4S71CXYQU7KKHIK7,"A Florida mother who fatally shot her four children before killing herself Tuesday called three of the kids who had sought help from a neighbor back to the house before firing the fatal shots, authorities said.",116,122,sought,2,3,5
37PGLWGSJT7FDZ4S71CXYQU7KKHIK7,"A Florida mother who fatally shot her four children before killing herself Tuesday called three of the kids who had sought help from a neighbor back to the house before firing the fatal shots, authorities said.",135,143,neighbor,0,1,1
37PGLWGSJT7FDZ4S71CXYQU7KKHIK7,"A Florida mother who fatally shot her four children before killing herself Tuesday called three of the kids who had sought help from a neighbor back to the house before firing the fatal shots, authorities said.",180,185,fatal,3,2,5
37PGLWGSJT7FDZ4S71CXYQU7KKHIK7,"A Florida mother who fatally shot her four children before killing herself Tuesday called three of the kids who had sought help from a neighbor back to the house before firing the fatal shots, authorities said.",180,191,fatal shots,1,0,1
32K26U12DNPCLZIIERPT92PB70DDVS,Analysts welcome the measures but accuse the government of reacting too late to a problem that was diagnosed years ago.,0,8,Analysts,7,4,11
32K26U12DNPCLZIIERPT92PB70DDVS,Analysts welcome the measures but accuse the government of reacting too late to a problem that was diagnosed years ago.,21,29,measures,3,1,4
32K26U12DNPCLZIIERPT92PB70DDVS,Analysts welcome the measures but accuse the government of reacting too late to a problem that was diagnosed years ago.,34,40,accuse,4,7,11
32K26U12DNPCLZIIERPT92PB70DDVS,Analysts welcome the measures but accuse the government of reacting too late to a problem that was diagnosed years ago.,45,55,government,1,0,1
32K26U12DNPCLZIIERPT92PB70DDVS,Analysts welcome the measures but accuse the government of reacting too late to a problem that was diagnosed years ago.,59,67,reacting,1,0,1
32K26U12DNPCLZIIERPT92PB70DDVS,Analysts welcome the measures but accuse the government of reacting too late to a problem that was diagnosed years ago.,99,108,diagnosed,9,8,17
32K26U12DNPCLZIIERPT92PB70DDVS,"Eduardo Martinez-Abascal, professor of Financial Management at IESE Business School said the Bankia move was a necessary step but one that should have been taken several years ago as other countries had done.",26,59,professor of Financial Management,1,0,1
32K26U12DNPCLZIIERPT92PB70DDVS,"Eduardo Martinez-Abascal, professor of Financial Management at IESE Business School said the Bankia move was a necessary step but one that should have been taken several years ago as other countries had done.",39,48,Financial,1,0,1
32K26U12DNPCLZIIERPT92PB70DDVS,"Eduardo Martinez-Abascal, professor of Financial Management at IESE Business School said the Bankia move was a necessary step but one that should have been taken several years ago as other countries had done.",49,59,Management,1,0,1
32K26U12DNPCLZIIERPT92PB70DDVS,"Eduardo Martinez-Abascal, professor of Financial Management at IESE Business School said the Bankia move was a necessary step but one that should have been taken several years ago as other countries had done.",63,67,IESE,1,1,2
32K26U12DNPCLZIIERPT92PB70DDVS,"Eduardo Martinez-Abascal, professor of Financial Management at IESE Business School said the Bankia move was a necessary step but one that should have been taken several years ago as other countries had done.",93,99,Bankia,0,1,1
32K26U12DNPCLZIIERPT92PB70DDVS,"Less money would have been needed and the confidence generated could have generated growth, he said.",43,53,confidence,1,2,3
32K26U12DNPCLZIIERPT92PB70DDVS,"Less money would have been needed and the confidence generated could have generated growth, he said.",43,63,confidence generated,1,1,2
32K26U12DNPCLZIIERPT92PB70DDVS,"Less money would have been needed and the confidence generated could have generated growth, he said.",54,63,generated,4,0,4
32K26U12DNPCLZIIERPT92PB70DDVS,"Less money would have been needed and the confidence generated could have generated growth, he said.",75,84,generated,2,1,3
32K26U12DNPCLZIIERPT92PB70DDVS,"Less money would have been needed and the confidence generated could have generated growth, he said.",75,91,generated growth,1,1,2
32K26U12DNPCLZIIERPT92PB70DDVS,"Less money would have been needed and the confidence generated could have generated growth, he said.",85,91,growth,0,2,2
32K26U12DNPCLZIIERPT92PB70DDVS,"Antonio Barros, Europe analyst for Eurasia Group, said that while the Bankia move and the reform will likely represent an important effort by the government to try dispelling doubts about the strength of Spanish banks, more needs to be done to regain market confidence.",23,30,analyst,1,0,1
32K26U12DNPCLZIIERPT92PB70DDVS,"Antonio Barros, Europe analyst for Eurasia Group, said that while the Bankia move and the reform will likely represent an important effort by the government to try dispelling doubts about the strength of Spanish banks, more needs to be done to regain market confidence.",90,96,reform,2,3,5
32K26U12DNPCLZIIERPT92PB70DDVS,"Antonio Barros, Europe analyst for Eurasia Group, said that while the Bankia move and the reform will likely represent an important effort by the government to try dispelling doubts about the strength of Spanish banks, more needs to be done to regain market confidence.",109,118,represent,1,1,2
32K26U12DNPCLZIIERPT92PB70DDVS,"Antonio Barros, Europe analyst for Eurasia Group, said that while the Bankia move and the reform will likely represent an important effort by the government to try dispelling doubts about the strength of Spanish banks, more needs to be done to regain market confidence.",164,174,dispelling,9,10,19
32K26U12DNPCLZIIERPT92PB70DDVS,"Antonio Barros, Europe analyst for Eurasia Group, said that while the Bankia move and the reform will likely represent an important effort by the government to try dispelling doubts about the strength of Spanish banks, more needs to be done to regain market confidence.",164,181,dispelling doubts,4,2,6
32K26U12DNPCLZIIERPT92PB70DDVS,"Antonio Barros, Europe analyst for Eurasia Group, said that while the Bankia move and the reform will likely represent an important effort by the government to try dispelling doubts about the strength of Spanish banks, more needs to be done to regain market confidence.",192,200,strength,0,1,1
32K26U12DNPCLZIIERPT92PB70DDVS,"Antonio Barros, Europe analyst for Eurasia Group, said that while the Bankia move and the reform will likely represent an important effort by the government to try dispelling doubts about the strength of Spanish banks, more needs to be done to regain market confidence.",244,250,regain,0,4,4
32K26U12DNPCLZIIERPT92PB70DDVS,"Antonio Barros, Europe analyst for Eurasia Group, said that while the Bankia move and the reform will likely represent an important effort by the government to try dispelling doubts about the strength of Spanish banks, more needs to be done to regain market confidence.",251,268,market confidence,3,1,4
32K26U12DNPCLZIIERPT92PB70DDVS,"The successive rounds of financial system reform have not helped to build the necessary credibility for the system, and short of a big bang solution that specifies where the money to recapitalize the banks is going to come from, today's (Friday's) reforms might disappoint markets, Barroso said in a note.",5,15,successive,4,3,7
32K26U12DNPCLZIIERPT92PB70DDVS,"The successive rounds of financial system reform have not helped to build the necessary credibility for the system, and short of a big bang solution that specifies where the money to recapitalize the banks is going to come from, today's (Friday's) reforms might disappoint markets, Barroso said in a note.",5,22,successive rounds,3,1,4
32K26U12DNPCLZIIERPT92PB70DDVS,"The successive rounds of financial system reform have not helped to build the necessary credibility for the system, and short of a big bang solution that specifies where the money to recapitalize the banks is going to come from, today's (Friday's) reforms might disappoint markets, Barroso said in a note.",16,22,rounds,0,1,1
32K26U12DNPCLZIIERPT92PB70DDVS,"The successive rounds of financial system reform have not helped to build the necessary credibility for the system, and short of a big bang solution that specifies where the money to recapitalize the banks is going to come from, today's (Friday's) reforms might disappoint markets, Barroso said in a note.",26,49,financial system reform,3,0,3
32K26U12DNPCLZIIERPT92PB70DDVS,"The successive rounds of financial system reform have not helped to build the necessary credibility for the system, and short of a big bang solution that specifies where the money to recapitalize the banks is going to come from, today's (Friday's) reforms might disappoint markets, Barroso said in a note.",43,49,reform,2,0,2
32K26U12DNPCLZIIERPT92PB70DDVS,"The successive rounds of financial system reform have not helped to build the necessary credibility for the system, and short of a big bang solution that specifies where the money to recapitalize the banks is going to come from, today's (Friday's) reforms might disappoint markets, Barroso said in a note.",79,100,necessary credibility,2,0,2
32K26U12DNPCLZIIERPT92PB70DDVS,"The successive rounds of financial system reform have not helped to build the necessary credibility for the system, and short of a big bang solution that specifies where the money to recapitalize the banks is going to come from, today's (Friday's) reforms might disappoint markets, Barroso said in a note.",89,100,credibility,8,9,17
32K26U12DNPCLZIIERPT92PB70DDVS,"The successive rounds of financial system reform have not helped to build the necessary credibility for the system, and short of a big bang solution that specifies where the money to recapitalize the banks is going to come from, today's (Friday's) reforms might disappoint markets, Barroso said in a note.",132,140,big bang,0,2,2
32K26U12DNPCLZIIERPT92PB70DDVS,"The successive rounds of financial system reform have not helped to build the necessary credibility for the system, and short of a big bang solution that specifies where the money to recapitalize the banks is going to come from, today's (Friday's) reforms might disappoint markets, Barroso said in a note.",132,149,big bang solution,8,2,10
32K26U12DNPCLZIIERPT92PB70DDVS,"The successive rounds of financial system reform have not helped to build the necessary credibility for the system, and short of a big bang solution that specifies where the money to recapitalize the banks is going to come from, today's (Friday's) reforms might disappoint markets, Barroso said in a note.",155,164,specifies,1,0,1
32K26U12DNPCLZIIERPT92PB70DDVS,"The successive rounds of financial system reform have not helped to build the necessary credibility for the system, and short of a big bang solution that specifies where the money to recapitalize the banks is going to come from, today's (Friday's) reforms might disappoint markets, Barroso said in a note.",184,196,recapitalize,10,9,19
32K26U12DNPCLZIIERPT92PB70DDVS,"The successive rounds of financial system reform have not helped to build the necessary credibility for the system, and short of a big bang solution that specifies where the money to recapitalize the banks is going to come from, today's (Friday's) reforms might disappoint markets, Barroso said in a note.",184,206,recapitalize the banks,1,0,1
32K26U12DNPCLZIIERPT92PB70DDVS,"The successive rounds of financial system reform have not helped to build the necessary credibility for the system, and short of a big bang solution that specifies where the money to recapitalize the banks is going to come from, today's (Friday's) reforms might disappoint markets, Barroso said in a note.",249,256,reforms,3,1,4
32K26U12DNPCLZIIERPT92PB70DDVS,"The successive rounds of financial system reform have not helped to build the necessary credibility for the system, and short of a big bang solution that specifies where the money to recapitalize the banks is going to come from, today's (Friday's) reforms might disappoint markets, Barroso said in a note.",263,273,disappoint,0,1,1
3LG268AV387PKYF112V3ENITNJ4ERN,"Unfortunately he did not see that text or read it on his phone until he woke up this morning ... well after the incident occurred, Goodyear said.",1,14,Unfortunately,6,3,9
3LG268AV387PKYF112V3ENITNJ4ERN,"Unfortunately he did not see that text or read it on his phone until he woke up this morning ... well after the incident occurred, Goodyear said.",35,39,text,1,1,2
3LG268AV387PKYF112V3ENITNJ4ERN,"Unfortunately he did not see that text or read it on his phone until he woke up this morning ... well after the incident occurred, Goodyear said.",113,121,incident,5,3,8
3LG268AV387PKYF112V3ENITNJ4ERN,"Unfortunately he did not see that text or read it on his phone until he woke up this morning ... well after the incident occurred, Goodyear said.",113,130,incident occurred,1,2,3
3LG268AV387PKYF112V3ENITNJ4ERN,"Unfortunately he did not see that text or read it on his phone until he woke up this morning ... well after the incident occurred, Goodyear said.",122,130,occurred,3,1,4
3LG268AV387PKYF112V3ENITNJ4ERN,The children's father does not live with the family and Goodyear said he was distraught.,77,87,distraught,10,10,20
3LG268AV387PKYF112V3ENITNJ4ERN,Goodyear said police do not have a motive.,35,41,motive,7,9,16
3LG268AV387PKYF112V3ENITNJ4ERN,He said authorities have received previous calls from Thomas' home pertaining to domestic violence.,8,19,authorities,5,4,9
3LG268AV387PKYF112V3ENITNJ4ERN,He said authorities have received previous calls from Thomas' home pertaining to domestic violence.,25,33,received,1,0,1
3LG268AV387PKYF112V3ENITNJ4ERN,He said authorities have received previous calls from Thomas' home pertaining to domestic violence.,34,42,previous,0,1,1
3LG268AV387PKYF112V3ENITNJ4ERN,He said authorities have received previous calls from Thomas' home pertaining to domestic violence.,67,77,pertaining,10,10,20
3LG268AV387PKYF112V3ENITNJ4ERN,He said authorities have received previous calls from Thomas' home pertaining to domestic violence.,81,89,domestic,1,2,3
3LG268AV387PKYF112V3ENITNJ4ERN,He said authorities have received previous calls from Thomas' home pertaining to domestic violence.,81,98,domestic violence,5,4,9
3LG268AV387PKYF112V3ENITNJ4ERN,He said authorities have received previous calls from Thomas' home pertaining to domestic violence.,90,98,violence,0,2,2
3LG268AV387PKYF112V3ENITNJ4ERN,Goodyear said he was having a hard time trying to understand how a mother could commit such a grisly act.,80,86,commit,1,1,2
3LG268AV387PKYF112V3ENITNJ4ERN,Goodyear said he was having a hard time trying to understand how a mother could commit such a grisly act.,94,100,grisly,10,10,20
3LG268AV387PKYF112V3ENITNJ4ERN,Goodyear said he was having a hard time trying to understand how a mother could commit such a grisly act.,94,104,grisly act,2,2,4
3LG268AV387PKYF112V3ENITNJ4ERN,He said she remained very calm when she called the children back to their house.,12,20,remained,0,1,1
3LG268AV387PKYF112V3ENITNJ4ERN,He said she remained very calm when she called the children back to their house.,26,30,calm,1,1,2
3LG268AV387PKYF112V3ENITNJ4ERN,"I cannot comprehend as a parent doing this to their children ... calling them back in and shooting them, he said.",10,20,comprehend,10,10,20
3P458N04Q1IHMEPXHH6U14VSRXZ2X5,"As the children were walking home, the neighbor called 911.",39,47,neighbor,1,1,2
3P458N04Q1IHMEPXHH6U14VSRXZ2X5,"Moments later, the neighbor told the authorities that she heard several more gunshots.",0,7,Moments,0,2,2
3P458N04Q1IHMEPXHH6U14VSRXZ2X5,"Moments later, the neighbor told the authorities that she heard several more gunshots.",0,13,Moments later,0,1,1
3P458N04Q1IHMEPXHH6U14VSRXZ2X5,"Moments later, the neighbor told the authorities that she heard several more gunshots.",19,27,neighbor,0,1,1
3P458N04Q1IHMEPXHH6U14VSRXZ2X5,"Moments later, the neighbor told the authorities that she heard several more gunshots.",37,48,authorities,10,5,15
3P458N04Q1IHMEPXHH6U14VSRXZ2X5,"Moments later, the neighbor told the authorities that she heard several more gunshots.",77,85,gunshots,1,1,2
3P458N04Q1IHMEPXHH6U14VSRXZ2X5,"Sheriff's deputies, who arrived within four minutes of the call, heard additional gunshots, Lieutenant Goodyear said.",0,7,Sheriff,1,0,1
3P458N04Q1IHMEPXHH6U14VSRXZ2X5,"Sheriff's deputies, who arrived within four minutes of the call, heard additional gunshots, Lieutenant Goodyear said.",0,17,Sheriffs deputies,1,0,1
3P458N04Q1IHMEPXHH6U14VSRXZ2X5,"Sheriff's deputies, who arrived within four minutes of the call, heard additional gunshots, Lieutenant Goodyear said.",10,18,deputies,2,7,9
3P458N04Q1IHMEPXHH6U14VSRXZ2X5,"Sheriff's deputies, who arrived within four minutes of the call, heard additional gunshots, Lieutenant Goodyear said.",24,31,arrived,0,1,1
3P458N04Q1IHMEPXHH6U14VSRXZ2X5,"Sheriff's deputies, who arrived within four minutes of the call, heard additional gunshots, Lieutenant Goodyear said.",71,81,additional,3,2,5
3P458N04Q1IHMEPXHH6U14VSRXZ2X5,"Sheriff's deputies, who arrived within four minutes of the call, heard additional gunshots, Lieutenant Goodyear said.",92,102,Lieutenant,2,3,5
3P458N04Q1IHMEPXHH6U14VSRXZ2X5,"A few minutes later, deputies saw someone who may have been armed with a gun open the front door before going back inside.",21,29,deputies,2,2,4
3P458N04Q1IHMEPXHH6U14VSRXZ2X5,"A few minutes later, deputies saw someone who may have been armed with a gun open the front door before going back inside.",60,65,armed,1,0,1
3P458N04Q1IHMEPXHH6U14VSRXZ2X5,"About 30 minutes later, there was a final shot, Lieutenant Goodyear said.",36,46,final shot,0,1,1
3P458N04Q1IHMEPXHH6U14VSRXZ2X5,"About 30 minutes later, there was a final shot, Lieutenant Goodyear said.",48,58,Lieutenant,3,0,3
3P458N04Q1IHMEPXHH6U14VSRXZ2X5,"Shortly after, a special weapons team entered the house and found three children and Ms. Thomas, who the authorities said had a self-inflicted gunshot wound.",0,13,Shortly after,0,1,1
3P458N04Q1IHMEPXHH6U14VSRXZ2X5,"Shortly after, a special weapons team entered the house and found three children and Ms. Thomas, who the authorities said had a self-inflicted gunshot wound.",17,37,special weapons team,4,1,5
3P458N04Q1IHMEPXHH6U14VSRXZ2X5,"Shortly after, a special weapons team entered the house and found three children and Ms. Thomas, who the authorities said had a self-inflicted gunshot wound.",25,32,weapons,1,1,2
3P458N04Q1IHMEPXHH6U14VSRXZ2X5,"Shortly after, a special weapons team entered the house and found three children and Ms. Thomas, who the authorities said had a self-inflicted gunshot wound.",38,45,entered,0,1,1
3P458N04Q1IHMEPXHH6U14VSRXZ2X5,"Shortly after, a special weapons team entered the house and found three children and Ms. Thomas, who the authorities said had a self-inflicted gunshot wound.",105,116,authorities,3,1,4
3P458N04Q1IHMEPXHH6U14VSRXZ2X5,"Shortly after, a special weapons team entered the house and found three children and Ms. Thomas, who the authorities said had a self-inflicted gunshot wound.",128,142,self-inflicted,10,10,20
3P458N04Q1IHMEPXHH6U14VSRXZ2X5,"Shortly after, a special weapons team entered the house and found three children and Ms. Thomas, who the authorities said had a self-inflicted gunshot wound.",128,156,self-inflicted gunshot wound,1,0,1
3P458N04Q1IHMEPXHH6U14VSRXZ2X5,"Shortly after, a special weapons team entered the house and found three children and Ms. Thomas, who the authorities said had a self-inflicted gunshot wound.",151,156,wound,1,1,2
3P458N04Q1IHMEPXHH6U14VSRXZ2X5,"The body of a fourth child, who had also been shot, was found in the front yard.",69,79,front yard,0,1,1
3P458N04Q1IHMEPXHH6U14VSRXZ2X5,"Lieutenant Goodyear said there had been other calls to 911 related to incidents at the house, the most recent on Easter.",0,10,Lieutenant,2,0,2
3P458N04Q1IHMEPXHH6U14VSRXZ2X5,"Lieutenant Goodyear said there had been other calls to 911 related to incidents at the house, the most recent on Easter.",59,66,related,1,0,1
3P458N04Q1IHMEPXHH6U14VSRXZ2X5,"Lieutenant Goodyear said there had been other calls to 911 related to incidents at the house, the most recent on Easter.",70,79,incidents,10,4,14
3P458N04Q1IHMEPXHH6U14VSRXZ2X5,"Lieutenant Goodyear said there had been other calls to 911 related to incidents at the house, the most recent on Easter.",98,109,most recent,0,1,1
3P458N04Q1IHMEPXHH6U14VSRXZ2X5,"Lieutenant Goodyear said there had been other calls to 911 related to incidents at the house, the most recent on Easter.",103,109,recent,1,1,2
3P458N04Q1IHMEPXHH6U14VSRXZ2X5,"Lieutenant Goodyear said there had been other calls to 911 related to incidents at the house, the most recent on Easter.",113,119,Easter,0,1,1
3OYHVNTV5TZP9LFV5WP2INQTVSSKOD,"It was an effort to say that progress has been made and that the end is coming, however slowly, while trying to assure the Afghans that the United States will not cut and run once the combat mission ends.",10,16,effort,0,3,3
3OYHVNTV5TZP9LFV5WP2INQTVSSKOD,"It was an effort to say that progress has been made and that the end is coming, however slowly, while trying to assure the Afghans that the United States will not cut and run once the combat mission ends.",29,37,progress,1,3,4
3OYHVNTV5TZP9LFV5WP2INQTVSSKOD,"It was an effort to say that progress has been made and that the end is coming, however slowly, while trying to assure the Afghans that the United States will not cut and run once the combat mission ends.",29,51,progress has been made,1,0,1
3OYHVNTV5TZP9LFV5WP2INQTVSSKOD,"It was an effort to say that progress has been made and that the end is coming, however slowly, while trying to assure the Afghans that the United States will not cut and run once the combat mission ends.",112,118,assure,4,3,7
3OYHVNTV5TZP9LFV5WP2INQTVSSKOD,"It was an effort to say that progress has been made and that the end is coming, however slowly, while trying to assure the Afghans that the United States will not cut and run once the combat mission ends.",163,174,cut and run,3,1,4
3OYHVNTV5TZP9LFV5WP2INQTVSSKOD,"It was an effort to say that progress has been made and that the end is coming, however slowly, while trying to assure the Afghans that the United States will not cut and run once the combat mission ends.",184,190,combat,1,3,4
3OYHVNTV5TZP9LFV5WP2INQTVSSKOD,"It was an effort to say that progress has been made and that the end is coming, however slowly, while trying to assure the Afghans that the United States will not cut and run once the combat mission ends.",184,198,combat mission,3,4,7
3OYHVNTV5TZP9LFV5WP2INQTVSSKOD,"It was an effort to say that progress has been made and that the end is coming, however slowly, while trying to assure the Afghans that the United States will not cut and run once the combat mission ends.",184,203,combat mission ends,0,1,1
3OYHVNTV5TZP9LFV5WP2INQTVSSKOD,"It was an effort to say that progress has been made and that the end is coming, however slowly, while trying to assure the Afghans that the United States will not cut and run once the combat mission ends.",191,198,mission,0,1,1
3OYHVNTV5TZP9LFV5WP2INQTVSSKOD,"It was an effort to say that progress has been made and that the end is coming, however slowly, while trying to assure the Afghans that the United States will not cut and run once the combat mission ends.",191,203,mission ends,1,0,1
3OYHVNTV5TZP9LFV5WP2INQTVSSKOD,"He said the United States must see this battle through to a successful conclusion, although not one that involves nation-building.",40,46,battle,0,1,1
3OYHVNTV5TZP9LFV5WP2INQTVSSKOD,"He said the United States must see this battle through to a successful conclusion, although not one that involves nation-building.",60,70,successful,1,0,1
3OYHVNTV5TZP9LFV5WP2INQTVSSKOD,"He said the United States must see this battle through to a successful conclusion, although not one that involves nation-building.",60,81,successful conclusion,2,2,4
3OYHVNTV5TZP9LFV5WP2INQTVSSKOD,"He said the United States must see this battle through to a successful conclusion, although not one that involves nation-building.",71,81,conclusion,5,5,10
3OYHVNTV5TZP9LFV5WP2INQTVSSKOD,"He said the United States must see this battle through to a successful conclusion, although not one that involves nation-building.",105,113,involves,0,2,2
3OYHVNTV5TZP9LFV5WP2INQTVSSKOD,"He said the United States must see this battle through to a successful conclusion, although not one that involves nation-building.",114,129,nation-building,8,5,13
3OYHVNTV5TZP9LFV5WP2INQTVSSKOD,"In President Barack Obama's twin narratives, the United States is both leaving Afghanistan and staying there.",28,32,twin,0,1,1
3OYHVNTV5TZP9LFV5WP2INQTVSSKOD,"In President Barack Obama's twin narratives, the United States is both leaving Afghanistan and staying there.",28,43,twin narratives,4,3,7
3OYHVNTV5TZP9LFV5WP2INQTVSSKOD,"In President Barack Obama's twin narratives, the United States is both leaving Afghanistan and staying there.",33,43,narratives,8,9,17
3OYHVNTV5TZP9LFV5WP2INQTVSSKOD,"The different messages are meant for different audiences, one at home and one away.",14,22,messages,0,1,1
3OYHVNTV5TZP9LFV5WP2INQTVSSKOD,"The different messages are meant for different audiences, one at home and one away.",27,32,meant,0,1,1
3OYHVNTV5TZP9LFV5WP2INQTVSSKOD,"The different messages are meant for different audiences, one at home and one away.",47,56,audiences,4,6,10
3OYHVNTV5TZP9LFV5WP2INQTVSSKOD,"As Obama's brief, symbolic visit to Afghanistan on Wednesday made clear, the more important audience is American voters fed up with a war that will be in its 12th year on Election Day in November.",11,16,brief,0,1,1
3OYHVNTV5TZP9LFV5WP2INQTVSSKOD,"As Obama's brief, symbolic visit to Afghanistan on Wednesday made clear, the more important audience is American voters fed up with a war that will be in its 12th year on Election Day in November.",18,26,symbolic,10,3,13
3OYHVNTV5TZP9LFV5WP2INQTVSSKOD,"As Obama's brief, symbolic visit to Afghanistan on Wednesday made clear, the more important audience is American voters fed up with a war that will be in its 12th year on Election Day in November.",18,32,symbolic visit,0,2,2
3OYHVNTV5TZP9LFV5WP2INQTVSSKOD,"As Obama's brief, symbolic visit to Afghanistan on Wednesday made clear, the more important audience is American voters fed up with a war that will be in its 12th year on Election Day in November.",73,100,the more important audience,1,0,1
3OYHVNTV5TZP9LFV5WP2INQTVSSKOD,"As Obama's brief, symbolic visit to Afghanistan on Wednesday made clear, the more important audience is American voters fed up with a war that will be in its 12th year on Election Day in November.",92,100,audience,3,0,3
3OYHVNTV5TZP9LFV5WP2INQTVSSKOD,"As Obama's brief, symbolic visit to Afghanistan on Wednesday made clear, the more important audience is American voters fed up with a war that will be in its 12th year on Election Day in November.",120,123,fed,0,1,1
3OYHVNTV5TZP9LFV5WP2INQTVSSKOD,"As Obama's brief, symbolic visit to Afghanistan on Wednesday made clear, the more important audience is American voters fed up with a war that will be in its 12th year on Election Day in November.",120,126,fed up,4,6,10
3O2Y2UIUCQVV38226T6CVTHF4SPKFI,"From broadband communications infrastructure, enterprise mobility and public safety solutions to mobile and wireline digital communication devices that provide compelling experiences, Motorola is leading the next wave of innovations that enable people, enterprises and governments to be more connected and more mobile.",5,14,broadband,1,1,2
3O2Y2UIUCQVV38226T6CVTHF4SPKFI,"From broadband communications infrastructure, enterprise mobility and public safety solutions to mobile and wireline digital communication devices that provide compelling experiences, Motorola is leading the next wave of innovations that enable people, enterprises and governments to be more connected and more mobile.",5,44,broadband communications infrastructure,6,3,9
3O2Y2UIUCQVV38226T6CVTHF4SPKFI,"From broadband communications infrastructure, enterprise mobility and public safety solutions to mobile and wireline digital communication devices that provide compelling experiences, Motorola is leading the next wave of innovations that enable people, enterprises and governments to be more connected and more mobile.",30,44,infrastructure,6,7,13
3O2Y2UIUCQVV38226T6CVTHF4SPKFI,"From broadband communications infrastructure, enterprise mobility and public safety solutions to mobile and wireline digital communication devices that provide compelling experiences, Motorola is leading the next wave of innovations that enable people, enterprises and governments to be more connected and more mobile.",46,56,enterprise,3,3,6
3O2Y2UIUCQVV38226T6CVTHF4SPKFI,"From broadband communications infrastructure, enterprise mobility and public safety solutions to mobile and wireline digital communication devices that provide compelling experiences, Motorola is leading the next wave of innovations that enable people, enterprises and governments to be more connected and more mobile.",46,65,enterprise mobility,6,1,7
3O2Y2UIUCQVV38226T6CVTHF4SPKFI,"From broadband communications infrastructure, enterprise mobility and public safety solutions to mobile and wireline digital communication devices that provide compelling experiences, Motorola is leading the next wave of innovations that enable people, enterprises and governments to be more connected and more mobile.",57,65,mobility,2,1,3
3O2Y2UIUCQVV38226T6CVTHF4SPKFI,"From broadband communications infrastructure, enterprise mobility and public safety solutions to mobile and wireline digital communication devices that provide compelling experiences, Motorola is leading the next wave of innovations that enable people, enterprises and governments to be more connected and more mobile.",70,93,public safety solutions,1,1,2
3O2Y2UIUCQVV38226T6CVTHF4SPKFI,"From broadband communications infrastructure, enterprise mobility and public safety solutions to mobile and wireline digital communication devices that provide compelling experiences, Motorola is leading the next wave of innovations that enable people, enterprises and governments to be more connected and more mobile.",84,93,solutions,1,0,1
3O2Y2UIUCQVV38226T6CVTHF4SPKFI,"From broadband communications infrastructure, enterprise mobility and public safety solutions to mobile and wireline digital communication devices that provide compelling experiences, Motorola is leading the next wave of innovations that enable people, enterprises and governments to be more connected and more mobile.",108,116,wireline,4,3,7
3O2Y2UIUCQVV38226T6CVTHF4SPKFI,"From broadband communications infrastructure, enterprise mobility and public safety solutions to mobile and wireline digital communication devices that provide compelling experiences, Motorola is leading the next wave of innovations that enable people, enterprises and governments to be more connected and more mobile.",108,146,wireline digital communication devices,1,0,1
3O2Y2UIUCQVV38226T6CVTHF4SPKFI,"From broadband communications infrastructure, enterprise mobility and public safety solutions to mobile and wireline digital communication devices that provide compelling experiences, Motorola is leading the next wave of innovations that enable people, enterprises and governments to be more connected and more mobile.",125,138,communication,1,0,1
3O2Y2UIUCQVV38226T6CVTHF4SPKFI,"From broadband communications infrastructure, enterprise mobility and public safety solutions to mobile and wireline digital communication devices that provide compelling experiences, Motorola is leading the next wave of innovations that enable people, enterprises and governments to be more connected and more mobile.",160,170,compelling,8,9,17
3O2Y2UIUCQVV38226T6CVTHF4SPKFI,"From broadband communications infrastructure, enterprise mobility and public safety solutions to mobile and wireline digital communication devices that provide compelling experiences, Motorola is leading the next wave of innovations that enable people, enterprises and governments to be more connected and more mobile.",160,182,compelling experiences,3,1,4
3O2Y2UIUCQVV38226T6CVTHF4SPKFI,"From broadband communications infrastructure, enterprise mobility and public safety solutions to mobile and wireline digital communication devices that provide compelling experiences, Motorola is leading the next wave of innovations that enable people, enterprises and governments to be more connected and more mobile.",208,217,next wave,0,1,1
3O2Y2UIUCQVV38226T6CVTHF4SPKFI,"From broadband communications infrastructure, enterprise mobility and public safety solutions to mobile and wireline digital communication devices that provide compelling experiences, Motorola is leading the next wave of innovations that enable people, enterprises and governments to be more connected and more mobile.",208,232,next wave of innovations,1,0,1
3O2Y2UIUCQVV38226T6CVTHF4SPKFI,"From broadband communications infrastructure, enterprise mobility and public safety solutions to mobile and wireline digital communication devices that provide compelling experiences, Motorola is leading the next wave of innovations that enable people, enterprises and governments to be more connected and more mobile.",213,217,wave,2,0,2
3O2Y2UIUCQVV38226T6CVTHF4SPKFI,"From broadband communications infrastructure, enterprise mobility and public safety solutions to mobile and wireline digital communication devices that provide compelling experiences, Motorola is leading the next wave of innovations that enable people, enterprises and governments to be more connected and more mobile.",213,232,wave of innovations,1,0,1
3O2Y2UIUCQVV38226T6CVTHF4SPKFI,"From broadband communications infrastructure, enterprise mobility and public safety solutions to mobile and wireline digital communication devices that provide compelling experiences, Motorola is leading the next wave of innovations that enable people, enterprises and governments to be more connected and more mobile.",221,232,innovations,8,9,17
3O2Y2UIUCQVV38226T6CVTHF4SPKFI,"From broadband communications infrastructure, enterprise mobility and public safety solutions to mobile and wireline digital communication devices that provide compelling experiences, Motorola is leading the next wave of innovations that enable people, enterprises and governments to be more connected and more mobile.",253,264,enterprises,1,2,3
3O2Y2UIUCQVV38226T6CVTHF4SPKFI,"Motorola (NYSE: MOT) had sales of US $22 billion in 2009 Google provides search and advertising services, which together aim to organize and monetize the world's information.",10,19,NYSE: MOT,1,0,1
3O2Y2UIUCQVV38226T6CVTHF4SPKFI,"Motorola (NYSE: MOT) had sales of US $22 billion in 2009 Google provides search and advertising services, which together aim to organize and monetize the world's information.",84,95,advertising,1,0,1
3O2Y2UIUCQVV38226T6CVTHF4SPKFI,"Motorola (NYSE: MOT) had sales of US $22 billion in 2009 Google provides search and advertising services, which together aim to organize and monetize the world's information.",121,124,aim,0,1,1
3O2Y2UIUCQVV38226T6CVTHF4SPKFI,"Motorola (NYSE: MOT) had sales of US $22 billion in 2009 Google provides search and advertising services, which together aim to organize and monetize the world's information.",128,136,organize,1,0,1
3O2Y2UIUCQVV38226T6CVTHF4SPKFI,"Motorola (NYSE: MOT) had sales of US $22 billion in 2009 Google provides search and advertising services, which together aim to organize and monetize the world's information.",141,149,monetize,10,9,19
3O2Y2UIUCQVV38226T6CVTHF4SPKFI,"Motorola (NYSE: MOT) had sales of US $22 billion in 2009 Google provides search and advertising services, which together aim to organize and monetize the world's information.",141,172,monetize the worlds information,1,0,1
3O2Y2UIUCQVV38226T6CVTHF4SPKFI,"Motorola (NYSE: MOT) had sales of US $22 billion in 2009 Google provides search and advertising services, which together aim to organize and monetize the world's information.",154,172,worlds information,0,1,1
3O2Y2UIUCQVV38226T6CVTHF4SPKFI,"In addition to its dominant search engine, it offers a plethora of online tools and platforms including: Gmail, Maps, YouTube, and Google+, the company's extension into the social space.",19,27,dominant,6,7,13
3O2Y2UIUCQVV38226T6CVTHF4SPKFI,"In addition to its dominant search engine, it offers a plethora of online tools and platforms including: Gmail, Maps, YouTube, and Google+, the company's extension into the social space.",19,41,dominant search engine,1,0,1
3O2Y2UIUCQVV38226T6CVTHF4SPKFI,"In addition to its dominant search engine, it offers a plethora of online tools and platforms including: Gmail, Maps, YouTube, and Google+, the company's extension into the social space.",55,63,plethora,9,10,19
3O2Y2UIUCQVV38226T6CVTHF4SPKFI,"In addition to its dominant search engine, it offers a plethora of online tools and platforms including: Gmail, Maps, YouTube, and Google+, the company's extension into the social space.",55,66,plethora of,0,2,2
3O2Y2UIUCQVV38226T6CVTHF4SPKFI,"In addition to its dominant search engine, it offers a plethora of online tools and platforms including: Gmail, Maps, YouTube, and Google+, the company's extension into the social space.",55,79,plethora of online tools,1,0,1
3O2Y2UIUCQVV38226T6CVTHF4SPKFI,"In addition to its dominant search engine, it offers a plethora of online tools and platforms including: Gmail, Maps, YouTube, and Google+, the company's extension into the social space.",154,163,extension,2,2,4
3O2Y2UIUCQVV38226T6CVTHF4SPKFI,"In addition to its dominant search engine, it offers a plethora of online tools and platforms including: Gmail, Maps, YouTube, and Google+, the company's extension into the social space.",173,185,social space,1,0,1
3O2Y2UIUCQVV38226T6CVTHF4SPKFI,"Most of its Web-based products are free, funded by Google's highly integrated online advertising platforms AdWords and AdSense.",12,21,Web-based,1,0,1
3O2Y2UIUCQVV38226T6CVTHF4SPKFI,"Most of its Web-based products are free, funded by Google's highly integrated online advertising platforms AdWords and AdSense.",41,47,funded,1,1,2
3O2Y2UIUCQVV38226T6CVTHF4SPKFI,"Most of its Web-based products are free, funded by Google's highly integrated online advertising platforms AdWords and AdSense.",60,77,highly integrated,1,0,1
3O2Y2UIUCQVV38226T6CVTHF4SPKFI,"Most of its Web-based products are free, funded by Google's highly integrated online advertising platforms AdWords and AdSense.",60,106,highly integrated online advertising platforms,2,0,2
3O2Y2UIUCQVV38226T6CVTHF4SPKFI,"Most of its Web-based products are free, funded by Google's highly integrated online advertising platforms AdWords and AdSense.",67,77,integrated,8,4,12
3O2Y2UIUCQVV38226T6CVTHF4SPKFI,"Most of its Web-based products are free, funded by Google's highly integrated online advertising platforms AdWords and AdSense.",78,84,online,0,1,1
3O2Y2UIUCQVV38226T6CVTHF4SPKFI,"Most of its Web-based products are free, funded by Google's highly integrated online advertising platforms AdWords and AdSense.",78,106,online advertising platforms,1,0,1
3O2Y2UIUCQVV38226T6CVTHF4SPKFI,"Most of its Web-based products are free, funded by Google's highly integrated online advertising platforms AdWords and AdSense.",85,96,advertising,1,0,1
3O2Y2UIUCQVV38226T6CVTHF4SPKFI,"Most of its Web-based products are free, funded by Google's highly integrated online advertising platforms AdWords and AdSense.",97,106,platforms,1,0,1
3O2Y2UIUCQVV38226T6CVTHF4SPKFI,"Syrian forces killed at least five people when they raided a Sunni farming village on Sunday, torching homes and looting shops in what activists said is a sign of worsening relations among the country's religious groups.",52,58,raided,2,2,4
3O2Y2UIUCQVV38226T6CVTHF4SPKFI,"Syrian forces killed at least five people when they raided a Sunni farming village on Sunday, torching homes and looting shops in what activists said is a sign of worsening relations among the country's religious groups.",61,66,Sunni,0,1,1
3O2Y2UIUCQVV38226T6CVTHF4SPKFI,"Syrian forces killed at least five people when they raided a Sunni farming village on Sunday, torching homes and looting shops in what activists said is a sign of worsening relations among the country's religious groups.",94,102,torching,3,4,7
3O2Y2UIUCQVV38226T6CVTHF4SPKFI,"Syrian forces killed at least five people when they raided a Sunni farming village on Sunday, torching homes and looting shops in what activists said is a sign of worsening relations among the country's religious groups.",94,108,torching homes,0,1,1
3O2Y2UIUCQVV38226T6CVTHF4SPKFI,"Syrian forces killed at least five people when they raided a Sunni farming village on Sunday, torching homes and looting shops in what activists said is a sign of worsening relations among the country's religious groups.",113,120,looting,3,6,9
3O2Y2UIUCQVV38226T6CVTHF4SPKFI,"Syrian forces killed at least five people when they raided a Sunni farming village on Sunday, torching homes and looting shops in what activists said is a sign of worsening relations among the country's religious groups.",113,126,looting shops,0,2,2
3O2Y2UIUCQVV38226T6CVTHF4SPKFI,"Syrian forces killed at least five people when they raided a Sunni farming village on Sunday, torching homes and looting shops in what activists said is a sign of worsening relations among the country's religious groups.",135,144,activists,2,6,8
3O2Y2UIUCQVV38226T6CVTHF4SPKFI,"Syrian forces killed at least five people when they raided a Sunni farming village on Sunday, torching homes and looting shops in what activists said is a sign of worsening relations among the country's religious groups.",163,172,worsening,2,8,10
3O2Y2UIUCQVV38226T6CVTHF4SPKFI,"Syrian forces killed at least five people when they raided a Sunni farming village on Sunday, torching homes and looting shops in what activists said is a sign of worsening relations among the country's religious groups.",163,182,worsening relations,1,0,1
3BO3NEOQM0I91MV6VAZ84CRBF8NIAS,Investigating officers have appealed to anyone who was in the Sarsfield Road or Goldenbridge Terrace areas last night to contact them on 01-6667200.,0,13,Investigating,6,4,10
3BO3NEOQM0I91MV6VAZ84CRBF8NIAS,Investigating officers have appealed to anyone who was in the Sarsfield Road or Goldenbridge Terrace areas last night to contact them on 01-6667200.,0,22,Investigating officers,2,1,3
3BO3NEOQM0I91MV6VAZ84CRBF8NIAS,Investigating officers have appealed to anyone who was in the Sarsfield Road or Goldenbridge Terrace areas last night to contact them on 01-6667200.,28,36,appealed,7,10,17
3BO3NEOQM0I91MV6VAZ84CRBF8NIAS,Investigating officers have appealed to anyone who was in the Sarsfield Road or Goldenbridge Terrace areas last night to contact them on 01-6667200.,28,46,appealed to anyone,1,0,1
3BO3NEOQM0I91MV6VAZ84CRBF8NIAS,16/05/2012 - 08:35:41 Gardaí are to carry out a technical examination at the scene of a shooting in Dublin last night.,22,28,Gardaí,0,2,2
3BO3NEOQM0I91MV6VAZ84CRBF8NIAS,16/05/2012 - 08:35:41 Gardaí are to carry out a technical examination at the scene of a shooting in Dublin last night.,48,57,technical,2,0,2
3BO3NEOQM0I91MV6VAZ84CRBF8NIAS,16/05/2012 - 08:35:41 Gardaí are to carry out a technical examination at the scene of a shooting in Dublin last night.,48,69,technical examination,7,4,11
3BO3NEOQM0I91MV6VAZ84CRBF8NIAS,16/05/2012 - 08:35:41 Gardaí are to carry out a technical examination at the scene of a shooting in Dublin last night.,58,69,examination,6,0,6
3BO3NEOQM0I91MV6VAZ84CRBF8NIAS,16/05/2012 - 08:35:41 Gardaí are to carry out a technical examination at the scene of a shooting in Dublin last night.,88,96,shooting,1,0,1
3BO3NEOQM0I91MV6VAZ84CRBF8NIAS,A man is being treated at Tallaght hospital after he drove himself to a prison for help after he was injured in the attack.,15,22,treated,1,0,1
3BO3NEOQM0I91MV6VAZ84CRBF8NIAS,A man is being treated at Tallaght hospital after he drove himself to a prison for help after he was injured in the attack.,101,108,injured,1,4,5
3BO3NEOQM0I91MV6VAZ84CRBF8NIAS,A man is being treated at Tallaght hospital after he drove himself to a prison for help after he was injured in the attack.,116,122,attack,1,0,1
3BO3NEOQM0I91MV6VAZ84CRBF8NIAS,"The victim, a 32-year-old, was hit in the side of his body as he sat in a car outside Finnegan’s pub.",4,10,victim,0,4,4
3BO3NEOQM0I91MV6VAZ84CRBF8NIAS,"The victim, a 32-year-old, was hit in the side of his body as he sat in a car outside Finnegan’s pub.",65,68,sat,0,1,1
3BO3NEOQM0I91MV6VAZ84CRBF8NIAS,"The victim, a 32-year-old, was hit in the side of his body as he sat in a car outside Finnegan’s pub.",86,100,Finnegan’s pub,0,1,1
3BO3NEOQM0I91MV6VAZ84CRBF8NIAS,"The victim, a 32-year-old, was hit in the side of his body as he sat in a car outside Finnegan’s pub.",97,100,pub,3,1,4
3BO3NEOQM0I91MV6VAZ84CRBF8NIAS,"He drove himself to nearby Cloverhill Prison, where he called for help.",3,8,drove,0,1,1
3BO3NEOQM0I91MV6VAZ84CRBF8NIAS,"He drove himself to nearby Cloverhill Prison, where he called for help.",20,26,nearby,1,0,1
3BO3NEOQM0I91MV6VAZ84CRBF8NIAS,"He drove himself to nearby Cloverhill Prison, where he called for help.",55,65,called for,0,1,1
3BO3NEOQM0I91MV6VAZ84CRBF8NIAS,His injuries are said to be non-life-threatening.,4,12,injuries,0,3,3
3BO3NEOQM0I91MV6VAZ84CRBF8NIAS,His injuries are said to be non-life-threatening.,28,48,non-life-threatening,10,10,20
3BO3NEOQM0I91MV6VAZ84CRBF8NIAS,"The gunman fled in a silver saloon car that was later found burnt out at Golden Bridge Terrace, Inchicore.",4,10,gunman,0,1,1
3BO3NEOQM0I91MV6VAZ84CRBF8NIAS,"The gunman fled in a silver saloon car that was later found burnt out at Golden Bridge Terrace, Inchicore.",4,15,gunman fled,0,1,1
3BO3NEOQM0I91MV6VAZ84CRBF8NIAS,"The gunman fled in a silver saloon car that was later found burnt out at Golden Bridge Terrace, Inchicore.",11,15,fled,1,5,6
3BO3NEOQM0I91MV6VAZ84CRBF8NIAS,"The gunman fled in a silver saloon car that was later found burnt out at Golden Bridge Terrace, Inchicore.",21,34,silver saloon,1,0,1
3BO3NEOQM0I91MV6VAZ84CRBF8NIAS,"The gunman fled in a silver saloon car that was later found burnt out at Golden Bridge Terrace, Inchicore.",21,38,silver saloon car,0,1,1
3BO3NEOQM0I91MV6VAZ84CRBF8NIAS,"The gunman fled in a silver saloon car that was later found burnt out at Golden Bridge Terrace, Inchicore.",28,34,saloon,5,1,6
3BO3NEOQM0I91MV6VAZ84CRBF8NIAS,"The gunman fled in a silver saloon car that was later found burnt out at Golden Bridge Terrace, Inchicore.",28,38,saloon car,4,0,4
3BO3NEOQM0I91MV6VAZ84CRBF8NIAS,"The gunman fled in a silver saloon car that was later found burnt out at Golden Bridge Terrace, Inchicore.",60,65,burnt,2,2,4
3BO3NEOQM0I91MV6VAZ84CRBF8NIAS,"The gunman fled in a silver saloon car that was later found burnt out at Golden Bridge Terrace, Inchicore.",60,69,burnt out,2,4,6
3UY4PIS8QRM5LZTXW7J7YJUPXDBN1P,"As a SWAT team arrived, officers heard gunshots inside.",5,9,SWAT,2,1,3
3UY4PIS8QRM5LZTXW7J7YJUPXDBN1P,"As a SWAT team arrived, officers heard gunshots inside.",5,14,SWAT team,4,2,6
3UY4PIS8QRM5LZTXW7J7YJUPXDBN1P,"As a SWAT team arrived, officers heard gunshots inside.",15,22,arrived,0,1,1
3UY4PIS8QRM5LZTXW7J7YJUPXDBN1P,"As a SWAT team arrived, officers heard gunshots inside.",33,38,heard,1,1,2
3UY4PIS8QRM5LZTXW7J7YJUPXDBN1P,"As a SWAT team arrived, officers heard gunshots inside.",39,47,gunshots,0,3,3
3UY4PIS8QRM5LZTXW7J7YJUPXDBN1P,"SWAT officers entered through a back sliding door just before 7 a.m., and found Thomas and three other children dead.",0,4,SWAT,1,1,2
3UY4PIS8QRM5LZTXW7J7YJUPXDBN1P,"SWAT officers entered through a back sliding door just before 7 a.m., and found Thomas and three other children dead.",0,13,SWAT officers,1,0,1
3UY4PIS8QRM5LZTXW7J7YJUPXDBN1P,"SWAT officers entered through a back sliding door just before 7 a.m., and found Thomas and three other children dead.",14,21,entered,0,1,1
3UY4PIS8QRM5LZTXW7J7YJUPXDBN1P,"SWAT officers entered through a back sliding door just before 7 a.m., and found Thomas and three other children dead.",32,49,back sliding door,1,1,2
3UY4PIS8QRM5LZTXW7J7YJUPXDBN1P,"SWAT officers entered through a back sliding door just before 7 a.m., and found Thomas and three other children dead.",37,44,sliding,1,1,2
3UY4PIS8QRM5LZTXW7J7YJUPXDBN1P,"SWAT officers entered through a back sliding door just before 7 a.m., and found Thomas and three other children dead.",37,49,sliding door,0,1,1
3UY4PIS8QRM5LZTXW7J7YJUPXDBN1P,"They were identified as Joel Johnson, 12, Jazlin Johnson, 13, and Jaxs Johnson, 15.",10,20,identified,4,4,8
3UY4PIS8QRM5LZTXW7J7YJUPXDBN1P,"Goodyear said the children's father, who was separated from the family, had been notified of the deaths.",45,54,separated,8,3,11
3UY4PIS8QRM5LZTXW7J7YJUPXDBN1P,"Goodyear said the children's father, who was separated from the family, had been notified of the deaths.",81,89,notified,5,6,11
3UY4PIS8QRM5LZTXW7J7YJUPXDBN1P,"Also, a friend of Thomas told police she texted him during the night that she wanted to be cremated with her four children, Goodyear said.",41,47,texted,0,6,6
3UY4PIS8QRM5LZTXW7J7YJUPXDBN1P,"Also, a friend of Thomas told police she texted him during the night that she wanted to be cremated with her four children, Goodyear said.",91,99,cremated,10,10,20
3UY4PIS8QRM5LZTXW7J7YJUPXDBN1P,"However, the friend did not see the text until after he woke up Tuesday morning and the incident was over.",56,60,woke,0,1,1
3UY4PIS8QRM5LZTXW7J7YJUPXDBN1P,"However, the friend did not see the text until after he woke up Tuesday morning and the incident was over.",88,96,incident,10,5,15
3UY4PIS8QRM5LZTXW7J7YJUPXDBN1P,"The friend, who was not identified, called police after seeing news of the deaths, he said.",24,34,identified,4,1,5
3UY4PIS8QRM5LZTXW7J7YJUPXDBN1P,"The friend, who was not identified, called police after seeing news of the deaths, he said.",56,62,seeing,0,1,1
3J9L0X0VDFNDXY56SLPN98PZN0F9WK,"The attack occurred at the gate of a compound known as Green Village, which houses private security guards, some foreign diplomats, U.N. employees and other foreign workers in the city, the ministry spokesman said.",11,19,occurred,1,7,8
3J9L0X0VDFNDXY56SLPN98PZN0F9WK,"The attack occurred at the gate of a compound known as Green Village, which houses private security guards, some foreign diplomats, U.N. employees and other foreign workers in the city, the ministry spokesman said.",37,45,compound,6,7,13
3J9L0X0VDFNDXY56SLPN98PZN0F9WK,"The attack occurred at the gate of a compound known as Green Village, which houses private security guards, some foreign diplomats, U.N. employees and other foreign workers in the city, the ministry spokesman said.",83,106,private security guards,2,0,2
3J9L0X0VDFNDXY56SLPN98PZN0F9WK,"The attack occurred at the gate of a compound known as Green Village, which houses private security guards, some foreign diplomats, U.N. employees and other foreign workers in the city, the ministry spokesman said.",113,130,foreign diplomats,1,0,1
3J9L0X0VDFNDXY56SLPN98PZN0F9WK,"The attack occurred at the gate of a compound known as Green Village, which houses private security guards, some foreign diplomats, U.N. employees and other foreign workers in the city, the ministry spokesman said.",121,130,diplomats,5,3,8
3J9L0X0VDFNDXY56SLPN98PZN0F9WK,"The attack occurred at the gate of a compound known as Green Village, which houses private security guards, some foreign diplomats, U.N. employees and other foreign workers in the city, the ministry spokesman said.",137,146,employees,1,1,2
3J9L0X0VDFNDXY56SLPN98PZN0F9WK,"The attack occurred at the gate of a compound known as Green Village, which houses private security guards, some foreign diplomats, U.N. employees and other foreign workers in the city, the ministry spokesman said.",190,208,ministry spokesman,1,0,1
3J9L0X0VDFNDXY56SLPN98PZN0F9WK,"The attack occurred at the gate of a compound known as Green Village, which houses private security guards, some foreign diplomats, U.N. employees and other foreign workers in the city, the ministry spokesman said.",199,208,spokesman,1,4,5
3J9L0X0VDFNDXY56SLPN98PZN0F9WK,"Residents living near the compound and people inside said they heard several blasts, mortar explosions and gunfire, the Times said.",0,9,Residents,1,1,2
3J9L0X0VDFNDXY56SLPN98PZN0F9WK,"Residents living near the compound and people inside said they heard several blasts, mortar explosions and gunfire, the Times said.",26,34,compound,5,3,8
3J9L0X0VDFNDXY56SLPN98PZN0F9WK,"Residents living near the compound and people inside said they heard several blasts, mortar explosions and gunfire, the Times said.",69,83,several blasts,0,1,1
3J9L0X0VDFNDXY56SLPN98PZN0F9WK,"Residents living near the compound and people inside said they heard several blasts, mortar explosions and gunfire, the Times said.",77,83,blasts,1,2,3
3J9L0X0VDFNDXY56SLPN98PZN0F9WK,"Residents living near the compound and people inside said they heard several blasts, mortar explosions and gunfire, the Times said.",85,91,mortar,5,4,9
3J9L0X0VDFNDXY56SLPN98PZN0F9WK,"Residents living near the compound and people inside said they heard several blasts, mortar explosions and gunfire, the Times said.",85,102,mortar explosions,3,0,3
3J9L0X0VDFNDXY56SLPN98PZN0F9WK,"Residents living near the compound and people inside said they heard several blasts, mortar explosions and gunfire, the Times said.",92,102,explosions,0,3,3
3J9L0X0VDFNDXY56SLPN98PZN0F9WK,"Residents living near the compound and people inside said they heard several blasts, mortar explosions and gunfire, the Times said.",107,114,gunfire,0,1,1
3J9L0X0VDFNDXY56SLPN98PZN0F9WK,"In a telephone interview with the Times, Taliban spokesman Zabiullah Mujahid said, ""As soon as the mujahedin learned about Obama's trip to Kabul we planned to conduct an operation at the heart of the city to send a message to Obama that instead of signing strategic partnerships and instead of imposing a corrupt and unpopular government over the people of Afghanistan, he should think of ways to withdraw his troops from Afghanistan.""",15,24,interview,1,2,3
3J9L0X0VDFNDXY56SLPN98PZN0F9WK,"In a telephone interview with the Times, Taliban spokesman Zabiullah Mujahid said, ""As soon as the mujahedin learned about Obama's trip to Kabul we planned to conduct an operation at the heart of the city to send a message to Obama that instead of signing strategic partnerships and instead of imposing a corrupt and unpopular government over the people of Afghanistan, he should think of ways to withdraw his troops from Afghanistan.""",41,48,Taliban,1,0,1
3J9L0X0VDFNDXY56SLPN98PZN0F9WK,"In a telephone interview with the Times, Taliban spokesman Zabiullah Mujahid said, ""As soon as the mujahedin learned about Obama's trip to Kabul we planned to conduct an operation at the heart of the city to send a message to Obama that instead of signing strategic partnerships and instead of imposing a corrupt and unpopular government over the people of Afghanistan, he should think of ways to withdraw his troops from Afghanistan.""",49,58,spokesman,1,1,2
3J9L0X0VDFNDXY56SLPN98PZN0F9WK,"In a telephone interview with the Times, Taliban spokesman Zabiullah Mujahid said, ""As soon as the mujahedin learned about Obama's trip to Kabul we planned to conduct an operation at the heart of the city to send a message to Obama that instead of signing strategic partnerships and instead of imposing a corrupt and unpopular government over the people of Afghanistan, he should think of ways to withdraw his troops from Afghanistan.""",59,76,Zabiullah Mujahid,1,0,1
3J9L0X0VDFNDXY56SLPN98PZN0F9WK,"In a telephone interview with the Times, Taliban spokesman Zabiullah Mujahid said, ""As soon as the mujahedin learned about Obama's trip to Kabul we planned to conduct an operation at the heart of the city to send a message to Obama that instead of signing strategic partnerships and instead of imposing a corrupt and unpopular government over the people of Afghanistan, he should think of ways to withdraw his troops from Afghanistan.""",99,108,mujahedin,7,4,11
3J9L0X0VDFNDXY56SLPN98PZN0F9WK,"In a telephone interview with the Times, Taliban spokesman Zabiullah Mujahid said, ""As soon as the mujahedin learned about Obama's trip to Kabul we planned to conduct an operation at the heart of the city to send a message to Obama that instead of signing strategic partnerships and instead of imposing a corrupt and unpopular government over the people of Afghanistan, he should think of ways to withdraw his troops from Afghanistan.""",139,144,Kabul,1,0,1
3J9L0X0VDFNDXY56SLPN98PZN0F9WK,"In a telephone interview with the Times, Taliban spokesman Zabiullah Mujahid said, ""As soon as the mujahedin learned about Obama's trip to Kabul we planned to conduct an operation at the heart of the city to send a message to Obama that instead of signing strategic partnerships and instead of imposing a corrupt and unpopular government over the people of Afghanistan, he should think of ways to withdraw his troops from Afghanistan.""",159,166,conduct,3,2,5
3J9L0X0VDFNDXY56SLPN98PZN0F9WK,"In a telephone interview with the Times, Taliban spokesman Zabiullah Mujahid said, ""As soon as the mujahedin learned about Obama's trip to Kabul we planned to conduct an operation at the heart of the city to send a message to Obama that instead of signing strategic partnerships and instead of imposing a corrupt and unpopular government over the people of Afghanistan, he should think of ways to withdraw his troops from Afghanistan.""",159,179,conduct an operation,2,0,2
3J9L0X0VDFNDXY56SLPN98PZN0F9WK,"In a telephone interview with the Times, Taliban spokesman Zabiullah Mujahid said, ""As soon as the mujahedin learned about Obama's trip to Kabul we planned to conduct an operation at the heart of the city to send a message to Obama that instead of signing strategic partnerships and instead of imposing a corrupt and unpopular government over the people of Afghanistan, he should think of ways to withdraw his troops from Afghanistan.""",170,179,operation,1,2,3
3J9L0X0VDFNDXY56SLPN98PZN0F9WK,"In a telephone interview with the Times, Taliban spokesman Zabiullah Mujahid said, ""As soon as the mujahedin learned about Obama's trip to Kabul we planned to conduct an operation at the heart of the city to send a message to Obama that instead of signing strategic partnerships and instead of imposing a corrupt and unpopular government over the people of Afghanistan, he should think of ways to withdraw his troops from Afghanistan.""",187,204,heart of the city,2,0,2
3J9L0X0VDFNDXY56SLPN98PZN0F9WK,"In a telephone interview with the Times, Taliban spokesman Zabiullah Mujahid said, ""As soon as the mujahedin learned about Obama's trip to Kabul we planned to conduct an operation at the heart of the city to send a message to Obama that instead of signing strategic partnerships and instead of imposing a corrupt and unpopular government over the people of Afghanistan, he should think of ways to withdraw his troops from Afghanistan.""",237,244,instead,0,1,1
3J9L0X0VDFNDXY56SLPN98PZN0F9WK,"In a telephone interview with the Times, Taliban spokesman Zabiullah Mujahid said, ""As soon as the mujahedin learned about Obama's trip to Kabul we planned to conduct an operation at the heart of the city to send a message to Obama that instead of signing strategic partnerships and instead of imposing a corrupt and unpopular government over the people of Afghanistan, he should think of ways to withdraw his troops from Afghanistan.""",256,265,strategic,2,4,6
3J9L0X0VDFNDXY56SLPN98PZN0F9WK,"In a telephone interview with the Times, Taliban spokesman Zabiullah Mujahid said, ""As soon as the mujahedin learned about Obama's trip to Kabul we planned to conduct an operation at the heart of the city to send a message to Obama that instead of signing strategic partnerships and instead of imposing a corrupt and unpopular government over the people of Afghanistan, he should think of ways to withdraw his troops from Afghanistan.""",256,278,strategic partnerships,7,4,11
3J9L0X0VDFNDXY56SLPN98PZN0F9WK,"In a telephone interview with the Times, Taliban spokesman Zabiullah Mujahid said, ""As soon as the mujahedin learned about Obama's trip to Kabul we planned to conduct an operation at the heart of the city to send a message to Obama that instead of signing strategic partnerships and instead of imposing a corrupt and unpopular government over the people of Afghanistan, he should think of ways to withdraw his troops from Afghanistan.""",266,278,partnerships,1,0,1
3J9L0X0VDFNDXY56SLPN98PZN0F9WK,"In a telephone interview with the Times, Taliban spokesman Zabiullah Mujahid said, ""As soon as the mujahedin learned about Obama's trip to Kabul we planned to conduct an operation at the heart of the city to send a message to Obama that instead of signing strategic partnerships and instead of imposing a corrupt and unpopular government over the people of Afghanistan, he should think of ways to withdraw his troops from Afghanistan.""",294,302,imposing,9,8,17
3J9L0X0VDFNDXY56SLPN98PZN0F9WK,"In a telephone interview with the Times, Taliban spokesman Zabiullah Mujahid said, ""As soon as the mujahedin learned about Obama's trip to Kabul we planned to conduct an operation at the heart of the city to send a message to Obama that instead of signing strategic partnerships and instead of imposing a corrupt and unpopular government over the people of Afghanistan, he should think of ways to withdraw his troops from Afghanistan.""",305,312,corrupt,4,6,10
3J9L0X0VDFNDXY56SLPN98PZN0F9WK,"In a telephone interview with the Times, Taliban spokesman Zabiullah Mujahid said, ""As soon as the mujahedin learned about Obama's trip to Kabul we planned to conduct an operation at the heart of the city to send a message to Obama that instead of signing strategic partnerships and instead of imposing a corrupt and unpopular government over the people of Afghanistan, he should think of ways to withdraw his troops from Afghanistan.""",305,326,corrupt and unpopular,0,1,1
3J9L0X0VDFNDXY56SLPN98PZN0F9WK,"In a telephone interview with the Times, Taliban spokesman Zabiullah Mujahid said, ""As soon as the mujahedin learned about Obama's trip to Kabul we planned to conduct an operation at the heart of the city to send a message to Obama that instead of signing strategic partnerships and instead of imposing a corrupt and unpopular government over the people of Afghanistan, he should think of ways to withdraw his troops from Afghanistan.""",317,326,unpopular,0,2,2
3J9L0X0VDFNDXY56SLPN98PZN0F9WK,"In a telephone interview with the Times, Taliban spokesman Zabiullah Mujahid said, ""As soon as the mujahedin learned about Obama's trip to Kabul we planned to conduct an operation at the heart of the city to send a message to Obama that instead of signing strategic partnerships and instead of imposing a corrupt and unpopular government over the people of Afghanistan, he should think of ways to withdraw his troops from Afghanistan.""",317,337,unpopular government,1,0,1
3J9L0X0VDFNDXY56SLPN98PZN0F9WK,"In a telephone interview with the Times, Taliban spokesman Zabiullah Mujahid said, ""As soon as the mujahedin learned about Obama's trip to Kabul we planned to conduct an operation at the heart of the city to send a message to Obama that instead of signing strategic partnerships and instead of imposing a corrupt and unpopular government over the people of Afghanistan, he should think of ways to withdraw his troops from Afghanistan.""",327,337,government,0,1,1
3J9L0X0VDFNDXY56SLPN98PZN0F9WK,"In a telephone interview with the Times, Taliban spokesman Zabiullah Mujahid said, ""As soon as the mujahedin learned about Obama's trip to Kabul we planned to conduct an operation at the heart of the city to send a message to Obama that instead of signing strategic partnerships and instead of imposing a corrupt and unpopular government over the people of Afghanistan, he should think of ways to withdraw his troops from Afghanistan.""",397,405,withdraw,2,5,7
3VADEH0UHCY5I444P5BJY9MTMFMSPG,"The government may also disclose details on its nationalisation this week of Bankia, the Spanish bank with the highest exposure to bad property loans following a crash in the construction sector that started in 2008.",4,14,government,2,1,3
3VADEH0UHCY5I444P5BJY9MTMFMSPG,"The government may also disclose details on its nationalisation this week of Bankia, the Spanish bank with the highest exposure to bad property loans following a crash in the construction sector that started in 2008.",24,32,disclose,8,3,11
3VADEH0UHCY5I444P5BJY9MTMFMSPG,"The government may also disclose details on its nationalisation this week of Bankia, the Spanish bank with the highest exposure to bad property loans following a crash in the construction sector that started in 2008.",24,40,disclose details,0,1,1
3VADEH0UHCY5I444P5BJY9MTMFMSPG,"The government may also disclose details on its nationalisation this week of Bankia, the Spanish bank with the highest exposure to bad property loans following a crash in the construction sector that started in 2008.",48,63,nationalisation,10,6,16
3VADEH0UHCY5I444P5BJY9MTMFMSPG,"The government may also disclose details on its nationalisation this week of Bankia, the Spanish bank with the highest exposure to bad property loans following a crash in the construction sector that started in 2008.",119,127,exposure,7,5,12
3VADEH0UHCY5I444P5BJY9MTMFMSPG,"The government may also disclose details on its nationalisation this week of Bankia, the Spanish bank with the highest exposure to bad property loans following a crash in the construction sector that started in 2008.",131,149,bad property loans,0,2,2
3VADEH0UHCY5I444P5BJY9MTMFMSPG,"The government may also disclose details on its nationalisation this week of Bankia, the Spanish bank with the highest exposure to bad property loans following a crash in the construction sector that started in 2008.",144,149,loans,0,1,1
3VADEH0UHCY5I444P5BJY9MTMFMSPG,"The government may also disclose details on its nationalisation this week of Bankia, the Spanish bank with the highest exposure to bad property loans following a crash in the construction sector that started in 2008.",162,167,crash,2,1,3
3VADEH0UHCY5I444P5BJY9MTMFMSPG,"The government may also disclose details on its nationalisation this week of Bankia, the Spanish bank with the highest exposure to bad property loans following a crash in the construction sector that started in 2008.",175,187,construction,2,1,3
3VADEH0UHCY5I444P5BJY9MTMFMSPG,"The government may also disclose details on its nationalisation this week of Bankia, the Spanish bank with the highest exposure to bad property loans following a crash in the construction sector that started in 2008.",175,194,construction sector,4,0,4
3VADEH0UHCY5I444P5BJY9MTMFMSPG,"The government may also disclose details on its nationalisation this week of Bankia, the Spanish bank with the highest exposure to bad property loans following a crash in the construction sector that started in 2008.",188,194,sector,3,0,3
3VADEH0UHCY5I444P5BJY9MTMFMSPG,Spain is in its second recession in three years and is battling to reduce a swollen deficit and 24.4% unemployment.,16,32,second recession,1,0,1
3VADEH0UHCY5I444P5BJY9MTMFMSPG,Spain is in its second recession in three years and is battling to reduce a swollen deficit and 24.4% unemployment.,23,32,recession,10,10,20
3VADEH0UHCY5I444P5BJY9MTMFMSPG,Spain is in its second recession in three years and is battling to reduce a swollen deficit and 24.4% unemployment.,55,63,battling,1,3,4
3VADEH0UHCY5I444P5BJY9MTMFMSPG,Spain is in its second recession in three years and is battling to reduce a swollen deficit and 24.4% unemployment.,76,83,swollen,1,6,7
3VADEH0UHCY5I444P5BJY9MTMFMSPG,Spain is in its second recession in three years and is battling to reduce a swollen deficit and 24.4% unemployment.,76,91,swollen deficit,9,5,14
3VADEH0UHCY5I444P5BJY9MTMFMSPG,Spain is in its second recession in three years and is battling to reduce a swollen deficit and 24.4% unemployment.,84,91,deficit,5,4,9
3VADEH0UHCY5I444P5BJY9MTMFMSPG,Spain is in its second recession in three years and is battling to reduce a swollen deficit and 24.4% unemployment.,102,114,unemployment,2,1,3
3VADEH0UHCY5I444P5BJY9MTMFMSPG,"Spanish bank stocks tumbled Friday as the government readied drastic reforms to save their balance sheets, two days after nationalising the fourth-biggest bank, Bankia.",13,27,stocks tumbled,0,1,1
3VADEH0UHCY5I444P5BJY9MTMFMSPG,"Spanish bank stocks tumbled Friday as the government readied drastic reforms to save their balance sheets, two days after nationalising the fourth-biggest bank, Bankia.",20,27,tumbled,3,10,13
3VADEH0UHCY5I444P5BJY9MTMFMSPG,"Spanish bank stocks tumbled Friday as the government readied drastic reforms to save their balance sheets, two days after nationalising the fourth-biggest bank, Bankia.",42,52,government,2,0,2
3VADEH0UHCY5I444P5BJY9MTMFMSPG,"Spanish bank stocks tumbled Friday as the government readied drastic reforms to save their balance sheets, two days after nationalising the fourth-biggest bank, Bankia.",53,60,readied,2,4,6
3VADEH0UHCY5I444P5BJY9MTMFMSPG,"Spanish bank stocks tumbled Friday as the government readied drastic reforms to save their balance sheets, two days after nationalising the fourth-biggest bank, Bankia.",53,76,readied drastic reforms,1,0,1
3VADEH0UHCY5I444P5BJY9MTMFMSPG,"Spanish bank stocks tumbled Friday as the government readied drastic reforms to save their balance sheets, two days after nationalising the fourth-biggest bank, Bankia.",61,68,drastic,4,4,8
3VADEH0UHCY5I444P5BJY9MTMFMSPG,"Spanish bank stocks tumbled Friday as the government readied drastic reforms to save their balance sheets, two days after nationalising the fourth-biggest bank, Bankia.",61,76,drastic reforms,4,3,7
3VADEH0UHCY5I444P5BJY9MTMFMSPG,"Spanish bank stocks tumbled Friday as the government readied drastic reforms to save their balance sheets, two days after nationalising the fourth-biggest bank, Bankia.",69,76,reforms,0,1,1
3VADEH0UHCY5I444P5BJY9MTMFMSPG,"Spanish bank stocks tumbled Friday as the government readied drastic reforms to save their balance sheets, two days after nationalising the fourth-biggest bank, Bankia.",80,105,save their balance sheets,0,1,1
3VADEH0UHCY5I444P5BJY9MTMFMSPG,"Spanish bank stocks tumbled Friday as the government readied drastic reforms to save their balance sheets, two days after nationalising the fourth-biggest bank, Bankia.",91,105,balance sheets,4,1,5
3VADEH0UHCY5I444P5BJY9MTMFMSPG,"Spanish bank stocks tumbled Friday as the government readied drastic reforms to save their balance sheets, two days after nationalising the fourth-biggest bank, Bankia.",99,105,sheets,0,1,1
3VADEH0UHCY5I444P5BJY9MTMFMSPG,"Spanish bank stocks tumbled Friday as the government readied drastic reforms to save their balance sheets, two days after nationalising the fourth-biggest bank, Bankia.",122,135,nationalising,9,1,10
3VADEH0UHCY5I444P5BJY9MTMFMSPG,"Prime Minister Mariano Rajoy met with his ministers to adopt the broad reforms, expected to bring to light the financial sector's massive exposure to the collapsed property sector.",23,28,Rajoy,1,0,1
3VADEH0UHCY5I444P5BJY9MTMFMSPG,"Prime Minister Mariano Rajoy met with his ministers to adopt the broad reforms, expected to bring to light the financial sector's massive exposure to the collapsed property sector.",55,60,adopt,1,0,1
3VADEH0UHCY5I444P5BJY9MTMFMSPG,"Prime Minister Mariano Rajoy met with his ministers to adopt the broad reforms, expected to bring to light the financial sector's massive exposure to the collapsed property sector.",65,70,broad,0,3,3
3VADEH0UHCY5I444P5BJY9MTMFMSPG,"Prime Minister Mariano Rajoy met with his ministers to adopt the broad reforms, expected to bring to light the financial sector's massive exposure to the collapsed property sector.",65,78,broad reforms,5,2,7
3VADEH0UHCY5I444P5BJY9MTMFMSPG,"Prime Minister Mariano Rajoy met with his ministers to adopt the broad reforms, expected to bring to light the financial sector's massive exposure to the collapsed property sector.",71,78,reforms,2,0,2
3VADEH0UHCY5I444P5BJY9MTMFMSPG,"Prime Minister Mariano Rajoy met with his ministers to adopt the broad reforms, expected to bring to light the financial sector's massive exposure to the collapsed property sector.",92,106,bring to light,1,0,1
3VADEH0UHCY5I444P5BJY9MTMFMSPG,"Prime Minister Mariano Rajoy met with his ministers to adopt the broad reforms, expected to bring to light the financial sector's massive exposure to the collapsed property sector.",111,128,financial sectors,1,0,1
3VADEH0UHCY5I444P5BJY9MTMFMSPG,"Prime Minister Mariano Rajoy met with his ministers to adopt the broad reforms, expected to bring to light the financial sector's massive exposure to the collapsed property sector.",121,128,sectors,1,0,1
3VADEH0UHCY5I444P5BJY9MTMFMSPG,"Prime Minister Mariano Rajoy met with his ministers to adopt the broad reforms, expected to bring to light the financial sector's massive exposure to the collapsed property sector.",130,137,massive,1,1,2
3VADEH0UHCY5I444P5BJY9MTMFMSPG,"Prime Minister Mariano Rajoy met with his ministers to adopt the broad reforms, expected to bring to light the financial sector's massive exposure to the collapsed property sector.",130,146,massive exposure,0,1,1
3VADEH0UHCY5I444P5BJY9MTMFMSPG,"Prime Minister Mariano Rajoy met with his ministers to adopt the broad reforms, expected to bring to light the financial sector's massive exposure to the collapsed property sector.",138,146,exposure,1,0,1
3VADEH0UHCY5I444P5BJY9MTMFMSPG,"Prime Minister Mariano Rajoy met with his ministers to adopt the broad reforms, expected to bring to light the financial sector's massive exposure to the collapsed property sector.",154,163,collapsed,0,9,9
3VADEH0UHCY5I444P5BJY9MTMFMSPG,"Prime Minister Mariano Rajoy met with his ministers to adopt the broad reforms, expected to bring to light the financial sector's massive exposure to the collapsed property sector.",154,179,collapsed property sector,3,0,3
3VADEH0UHCY5I444P5BJY9MTMFMSPG,"Prime Minister Mariano Rajoy met with his ministers to adopt the broad reforms, expected to bring to light the financial sector's massive exposure to the collapsed property sector.",164,172,property,0,1,1
3VADEH0UHCY5I444P5BJY9MTMFMSPG,"Market doubts about the full extent of the losses on bad loans in Spain's banks, which overextended themselves during a property boom that went bust in 2008, hurt the shares of even the strongest banks.",0,13,Market doubts,1,0,1
3VADEH0UHCY5I444P5BJY9MTMFMSPG,"Market doubts about the full extent of the losses on bad loans in Spain's banks, which overextended themselves during a property boom that went bust in 2008, hurt the shares of even the strongest banks.",87,99,overextended,8,5,13
3VADEH0UHCY5I444P5BJY9MTMFMSPG,"Market doubts about the full extent of the losses on bad loans in Spain's banks, which overextended themselves during a property boom that went bust in 2008, hurt the shares of even the strongest banks.",120,133,property boom,4,0,4
3VADEH0UHCY5I444P5BJY9MTMFMSPG,"Market doubts about the full extent of the losses on bad loans in Spain's banks, which overextended themselves during a property boom that went bust in 2008, hurt the shares of even the strongest banks.",129,133,boom,0,3,3
3VADEH0UHCY5I444P5BJY9MTMFMSPG,"Market doubts about the full extent of the losses on bad loans in Spain's banks, which overextended themselves during a property boom that went bust in 2008, hurt the shares of even the strongest banks.",144,148,bust,0,1,1
3421H3BM9AIRRE57LM68KIVRM5U9JG,A neighbor heard shots at 4:50 a.m. and then responded to a knock at the door to find three of the children.,2,10,neighbor,0,2,2
3421H3BM9AIRRE57LM68KIVRM5U9JG,A neighbor heard shots at 4:50 a.m. and then responded to a knock at the door to find three of the children.,11,16,heard,0,1,1
3421H3BM9AIRRE57LM68KIVRM5U9JG,A neighbor heard shots at 4:50 a.m. and then responded to a knock at the door to find three of the children.,45,54,responded,5,7,12
3421H3BM9AIRRE57LM68KIVRM5U9JG,A neighbor heard shots at 4:50 a.m. and then responded to a knock at the door to find three of the children.,45,65,responded to a knock,0,1,1
3421H3BM9AIRRE57LM68KIVRM5U9JG,A neighbor heard shots at 4:50 a.m. and then responded to a knock at the door to find three of the children.,60,65,knock,0,1,1
3421H3BM9AIRRE57LM68KIVRM5U9JG,A neighbor heard shots at 4:50 a.m. and then responded to a knock at the door to find three of the children.,60,77,knock at the door,1,0,1
3421H3BM9AIRRE57LM68KIVRM5U9JG,"The mother, Tanya Thomas, 33, called them back home, Brevard County Sheriff's Office Lt. Tod Goodyear told reporters.",68,83,Sheriffs Office,1,0,1
3421H3BM9AIRRE57LM68KIVRM5U9JG,"The mother, Tanya Thomas, 33, called them back home, Brevard County Sheriff's Office Lt. Tod Goodyear told reporters.",107,116,reporters,0,1,1
3421H3BM9AIRRE57LM68KIVRM5U9JG,Deputies arrived at the house several minutes later to hear more shots fired.,0,8,Deputies,7,4,11
3421H3BM9AIRRE57LM68KIVRM5U9JG,Deputies arrived at the house several minutes later to hear more shots fired.,9,16,arrived,0,2,2
3421H3BM9AIRRE57LM68KIVRM5U9JG,Deputies arrived at the house several minutes later to hear more shots fired.,30,45,several minutes,1,0,1
3421H3BM9AIRRE57LM68KIVRM5U9JG,"They discovered Thomas's eldest daughter, Pebbles Johnson, 17, wounded in the front yard.",5,15,discovered,4,2,6
3421H3BM9AIRRE57LM68KIVRM5U9JG,"They discovered Thomas's eldest daughter, Pebbles Johnson, 17, wounded in the front yard.",25,31,eldest,1,1,2
3421H3BM9AIRRE57LM68KIVRM5U9JG,"They discovered Thomas's eldest daughter, Pebbles Johnson, 17, wounded in the front yard.",42,49,Pebbles,0,1,1
3421H3BM9AIRRE57LM68KIVRM5U9JG,"They discovered Thomas's eldest daughter, Pebbles Johnson, 17, wounded in the front yard.",63,70,wounded,4,3,7
3421H3BM9AIRRE57LM68KIVRM5U9JG,"They discovered Thomas's eldest daughter, Pebbles Johnson, 17, wounded in the front yard.",78,88,front yard,0,1,1
3421H3BM9AIRRE57LM68KIVRM5U9JG,They drove a patrol car onto the lawn in an attempt to rescue her.,13,19,patrol,2,2,4
3421H3BM9AIRRE57LM68KIVRM5U9JG,They drove a patrol car onto the lawn in an attempt to rescue her.,13,23,patrol car,2,0,2
3421H3BM9AIRRE57LM68KIVRM5U9JG,They drove a patrol car onto the lawn in an attempt to rescue her.,33,37,lawn,0,3,3
3421H3BM9AIRRE57LM68KIVRM5U9JG,They drove a patrol car onto the lawn in an attempt to rescue her.,44,51,attempt,3,2,5
3421H3BM9AIRRE57LM68KIVRM5U9JG,They drove a patrol car onto the lawn in an attempt to rescue her.,55,61,rescue,1,7,8
3421H3BM9AIRRE57LM68KIVRM5U9JG,"Johnson was rushed to hospital but died from her wounds, Goodyear said.",12,18,rushed,0,4,4
3421H3BM9AIRRE57LM68KIVRM5U9JG,"Johnson was rushed to hospital but died from her wounds, Goodyear said.",49,55,wounds,3,2,5
3421H3BM9AIRRE57LM68KIVRM5U9JG,"No suicide note was found in the home, but Goodyear said a witness told police he received a text from Thomas at about 3 a.m. that said she wanted to be cremated with the children.",3,10,suicide,9,4,13
3421H3BM9AIRRE57LM68KIVRM5U9JG,"No suicide note was found in the home, but Goodyear said a witness told police he received a text from Thomas at about 3 a.m. that said she wanted to be cremated with the children.",3,15,suicide note,2,3,5
3421H3BM9AIRRE57LM68KIVRM5U9JG,"No suicide note was found in the home, but Goodyear said a witness told police he received a text from Thomas at about 3 a.m. that said she wanted to be cremated with the children.",59,66,witness,2,5,7
3421H3BM9AIRRE57LM68KIVRM5U9JG,"No suicide note was found in the home, but Goodyear said a witness told police he received a text from Thomas at about 3 a.m. that said she wanted to be cremated with the children.",82,90,received,0,1,1
3421H3BM9AIRRE57LM68KIVRM5U9JG,"No suicide note was found in the home, but Goodyear said a witness told police he received a text from Thomas at about 3 a.m. that said she wanted to be cremated with the children.",93,97,text,0,1,1
3421H3BM9AIRRE57LM68KIVRM5U9JG,"No suicide note was found in the home, but Goodyear said a witness told police he received a text from Thomas at about 3 a.m. that said she wanted to be cremated with the children.",153,161,cremated,10,10,20
3IZPORCT1FA14863R339ZQF6FZWHR6,"Russian authorities should annul the parliamentary vote results and hold a new election, ex-Soviet leader Mikhail Gorbachev urged Wednesday as popular indignation grew over widespread reports of alleged election fraud.",0,7,Russian,0,1,1
3IZPORCT1FA14863R339ZQF6FZWHR6,"Russian authorities should annul the parliamentary vote results and hold a new election, ex-Soviet leader Mikhail Gorbachev urged Wednesday as popular indignation grew over widespread reports of alleged election fraud.",8,19,authorities,4,3,7
3IZPORCT1FA14863R339ZQF6FZWHR6,"Russian authorities should annul the parliamentary vote results and hold a new election, ex-Soviet leader Mikhail Gorbachev urged Wednesday as popular indignation grew over widespread reports of alleged election fraud.",8,36,authorities should annul the,1,0,1
3IZPORCT1FA14863R339ZQF6FZWHR6,"Russian authorities should annul the parliamentary vote results and hold a new election, ex-Soviet leader Mikhail Gorbachev urged Wednesday as popular indignation grew over widespread reports of alleged election fraud.",27,32,annul,9,7,16
3IZPORCT1FA14863R339ZQF6FZWHR6,"Russian authorities should annul the parliamentary vote results and hold a new election, ex-Soviet leader Mikhail Gorbachev urged Wednesday as popular indignation grew over widespread reports of alleged election fraud.",37,50,parliamentary,9,3,12
3IZPORCT1FA14863R339ZQF6FZWHR6,"Russian authorities should annul the parliamentary vote results and hold a new election, ex-Soviet leader Mikhail Gorbachev urged Wednesday as popular indignation grew over widespread reports of alleged election fraud.",89,98,ex-Soviet,0,1,1
3IZPORCT1FA14863R339ZQF6FZWHR6,"Russian authorities should annul the parliamentary vote results and hold a new election, ex-Soviet leader Mikhail Gorbachev urged Wednesday as popular indignation grew over widespread reports of alleged election fraud.",106,113,Mikhail,0,1,1
3IZPORCT1FA14863R339ZQF6FZWHR6,"Russian authorities should annul the parliamentary vote results and hold a new election, ex-Soviet leader Mikhail Gorbachev urged Wednesday as popular indignation grew over widespread reports of alleged election fraud.",114,123,Gorbachev,0,1,1
3IZPORCT1FA14863R339ZQF6FZWHR6,"Russian authorities should annul the parliamentary vote results and hold a new election, ex-Soviet leader Mikhail Gorbachev urged Wednesday as popular indignation grew over widespread reports of alleged election fraud.",124,129,urged,0,6,6
3IZPORCT1FA14863R339ZQF6FZWHR6,"Russian authorities should annul the parliamentary vote results and hold a new election, ex-Soviet leader Mikhail Gorbachev urged Wednesday as popular indignation grew over widespread reports of alleged election fraud.",130,139,Wednesday,0,1,1
3IZPORCT1FA14863R339ZQF6FZWHR6,"Russian authorities should annul the parliamentary vote results and hold a new election, ex-Soviet leader Mikhail Gorbachev urged Wednesday as popular indignation grew over widespread reports of alleged election fraud.",143,162,popular indignation,2,0,2
3IZPORCT1FA14863R339ZQF6FZWHR6,"Russian authorities should annul the parliamentary vote results and hold a new election, ex-Soviet leader Mikhail Gorbachev urged Wednesday as popular indignation grew over widespread reports of alleged election fraud.",151,162,indignation,10,10,20
3IZPORCT1FA14863R339ZQF6FZWHR6,"Russian authorities should annul the parliamentary vote results and hold a new election, ex-Soviet leader Mikhail Gorbachev urged Wednesday as popular indignation grew over widespread reports of alleged election fraud.",173,183,widespread,2,3,5
3IZPORCT1FA14863R339ZQF6FZWHR6,"Russian authorities should annul the parliamentary vote results and hold a new election, ex-Soviet leader Mikhail Gorbachev urged Wednesday as popular indignation grew over widespread reports of alleged election fraud.",195,202,alleged,5,8,13
3IZPORCT1FA14863R339ZQF6FZWHR6,"Russian authorities should annul the parliamentary vote results and hold a new election, ex-Soviet leader Mikhail Gorbachev urged Wednesday as popular indignation grew over widespread reports of alleged election fraud.",195,217,alleged election fraud,2,0,2
3IZPORCT1FA14863R339ZQF6FZWHR6,"Russian authorities should annul the parliamentary vote results and hold a new election, ex-Soviet leader Mikhail Gorbachev urged Wednesday as popular indignation grew over widespread reports of alleged election fraud.",203,217,election fraud,1,0,1
3IZPORCT1FA14863R339ZQF6FZWHR6,"Russian authorities should annul the parliamentary vote results and hold a new election, ex-Soviet leader Mikhail Gorbachev urged Wednesday as popular indignation grew over widespread reports of alleged election fraud.",212,217,fraud,0,2,2
3IZPORCT1FA14863R339ZQF6FZWHR6,"Thousands of Russians have rallied in Moscow and St. Petersburg in the last two days, facing off against tens of thousands of police and Interior Ministry troops.",0,9,Thousands,0,1,1
3IZPORCT1FA14863R339ZQF6FZWHR6,"Thousands of Russians have rallied in Moscow and St. Petersburg in the last two days, facing off against tens of thousands of police and Interior Ministry troops.",27,34,rallied,2,5,7
3IZPORCT1FA14863R339ZQF6FZWHR6,"Thousands of Russians have rallied in Moscow and St. Petersburg in the last two days, facing off against tens of thousands of police and Interior Ministry troops.",86,96,facing off,1,0,1
3IZPORCT1FA14863R339ZQF6FZWHR6,"Thousands of Russians have rallied in Moscow and St. Petersburg in the last two days, facing off against tens of thousands of police and Interior Ministry troops.",137,154,Interior Ministry,0,1,1
3IZPORCT1FA14863R339ZQF6FZWHR6,"Thousands of Russians have rallied in Moscow and St. Petersburg in the last two days, facing off against tens of thousands of police and Interior Ministry troops.",137,161,Interior Ministry troops,1,1,2
3IZPORCT1FA14863R339ZQF6FZWHR6,Hundreds of protesters have been detained in both cities.,12,22,protesters,3,3,6
3IZPORCT1FA14863R339ZQF6FZWHR6,Hundreds of protesters have been detained in both cities.,23,41,have been detained,1,0,1
3IZPORCT1FA14863R339ZQF6FZWHR6,Hundreds of protesters have been detained in both cities.,33,41,detained,8,8,16
3IZPORCT1FA14863R339ZQF6FZWHR6,Gorbachev told the Interfax news agency that authorities must hold a fresh election or deal with a rising tide of discontent.,84,124,or deal with a rising tide of discontent,1,0,1
3IZPORCT1FA14863R339ZQF6FZWHR6,Gorbachev told the Interfax news agency that authorities must hold a fresh election or deal with a rising tide of discontent.,99,110,rising tide,3,1,4
3IZPORCT1FA14863R339ZQF6FZWHR6,Gorbachev told the Interfax news agency that authorities must hold a fresh election or deal with a rising tide of discontent.,99,124,rising tide of discontent,0,1,1
3IZPORCT1FA14863R339ZQF6FZWHR6,Gorbachev told the Interfax news agency that authorities must hold a fresh election or deal with a rising tide of discontent.,106,110,tide,0,2,2
3IZPORCT1FA14863R339ZQF6FZWHR6,Gorbachev told the Interfax news agency that authorities must hold a fresh election or deal with a rising tide of discontent.,106,124,tide of discontent,1,2,3
3IZPORCT1FA14863R339ZQF6FZWHR6,Gorbachev told the Interfax news agency that authorities must hold a fresh election or deal with a rising tide of discontent.,114,124,discontent,10,5,15
3IZPORCT1FA14863R339ZQF6FZWHR6,"Prime Minister Vladimir Putin's United Russia party won less than 50 percent of Sunday's vote, a steep fall from its earlier two-thirds majority, according to preliminary results.",15,23,Vladimir,0,1,1
3IZPORCT1FA14863R339ZQF6FZWHR6,"Prime Minister Vladimir Putin's United Russia party won less than 50 percent of Sunday's vote, a steep fall from its earlier two-thirds majority, according to preliminary results.",32,51,United Russia party,1,0,1
3IZPORCT1FA14863R339ZQF6FZWHR6,"Prime Minister Vladimir Putin's United Russia party won less than 50 percent of Sunday's vote, a steep fall from its earlier two-thirds majority, according to preliminary results.",97,102,steep,2,3,5
3IZPORCT1FA14863R339ZQF6FZWHR6,"Prime Minister Vladimir Putin's United Russia party won less than 50 percent of Sunday's vote, a steep fall from its earlier two-thirds majority, according to preliminary results.",136,144,majority,1,1,2
3IZPORCT1FA14863R339ZQF6FZWHR6,"Prime Minister Vladimir Putin's United Russia party won less than 50 percent of Sunday's vote, a steep fall from its earlier two-thirds majority, according to preliminary results.",159,170,preliminary,8,0,8
3IZPORCT1FA14863R339ZQF6FZWHR6,"Prime Minister Vladimir Putin's United Russia party won less than 50 percent of Sunday's vote, a steep fall from its earlier two-thirds majority, according to preliminary results.",159,178,preliminary results,2,2,4
3IZPORCT1FA14863R339ZQF6FZWHR6,"But opposition parties and international observers said the vote was marred by vote-rigging, including alleged ballot-box stuffing and false voter rolls.",4,14,opposition,3,1,4
3IZPORCT1FA14863R339ZQF6FZWHR6,"But opposition parties and international observers said the vote was marred by vote-rigging, including alleged ballot-box stuffing and false voter rolls.",4,22,opposition parties,1,0,1
3IZPORCT1FA14863R339ZQF6FZWHR6,"But opposition parties and international observers said the vote was marred by vote-rigging, including alleged ballot-box stuffing and false voter rolls.",27,40,international,2,0,2
3IZPORCT1FA14863R339ZQF6FZWHR6,"But opposition parties and international observers said the vote was marred by vote-rigging, including alleged ballot-box stuffing and false voter rolls.",27,50,international observers,1,0,1
3IZPORCT1FA14863R339ZQF6FZWHR6,"But opposition parties and international observers said the vote was marred by vote-rigging, including alleged ballot-box stuffing and false voter rolls.",41,50,observers,0,2,2
3IZPORCT1FA14863R339ZQF6FZWHR6,"But opposition parties and international observers said the vote was marred by vote-rigging, including alleged ballot-box stuffing and false voter rolls.",69,75,marred,4,9,13
3IZPORCT1FA14863R339ZQF6FZWHR6,"But opposition parties and international observers said the vote was marred by vote-rigging, including alleged ballot-box stuffing and false voter rolls.",79,91,vote-rigging,8,9,17
3IZPORCT1FA14863R339ZQF6FZWHR6,"But opposition parties and international observers said the vote was marred by vote-rigging, including alleged ballot-box stuffing and false voter rolls.",103,110,alleged,1,2,3
3IZPORCT1FA14863R339ZQF6FZWHR6,"But opposition parties and international observers said the vote was marred by vote-rigging, including alleged ballot-box stuffing and false voter rolls.",103,130,alleged ballot-box stuffing,0,1,1
3IZPORCT1FA14863R339ZQF6FZWHR6,"But opposition parties and international observers said the vote was marred by vote-rigging, including alleged ballot-box stuffing and false voter rolls.",111,121,ballot-box,1,2,3
3IZPORCT1FA14863R339ZQF6FZWHR6,"But opposition parties and international observers said the vote was marred by vote-rigging, including alleged ballot-box stuffing and false voter rolls.",111,130,ballot-box stuffing,3,2,5
3IZPORCT1FA14863R339ZQF6FZWHR6,"But opposition parties and international observers said the vote was marred by vote-rigging, including alleged ballot-box stuffing and false voter rolls.",122,130,stuffing,1,4,5
3IZPORCT1FA14863R339ZQF6FZWHR6,"But opposition parties and international observers said the vote was marred by vote-rigging, including alleged ballot-box stuffing and false voter rolls.",141,152,voter rolls,2,0,2
3IZPORCT1FA14863R339ZQF6FZWHR6,"But opposition parties and international observers said the vote was marred by vote-rigging, including alleged ballot-box stuffing and false voter rolls.",147,152,rolls,0,1,1
391JB9X4ZY919IUJSGAPQJ1O0SDKMY,“With this attack we want to send a message to Obama that the Afghans will welcome you with attacks.,11,17,attack,0,1,1
391JB9X4ZY919IUJSGAPQJ1O0SDKMY,“With this attack we want to send a message to Obama that the Afghans will welcome you with attacks.,29,43,send a message,1,0,1
391JB9X4ZY919IUJSGAPQJ1O0SDKMY,“With this attack we want to send a message to Obama that the Afghans will welcome you with attacks.,36,43,message,0,1,1
391JB9X4ZY919IUJSGAPQJ1O0SDKMY,“With this attack we want to send a message to Obama that the Afghans will welcome you with attacks.,92,99,attacks,1,1,2
391JB9X4ZY919IUJSGAPQJ1O0SDKMY,He needs to [remove US] forces from Afghanistan.,24,30,forces,2,0,2
391JB9X4ZY919IUJSGAPQJ1O0SDKMY,Not kill the innocent Afghans and destroy the Afghans country.,13,21,innocent,5,8,13
391JB9X4ZY919IUJSGAPQJ1O0SDKMY,Not kill the innocent Afghans and destroy the Afghans country.,34,41,destroy,0,1,1
391JB9X4ZY919IUJSGAPQJ1O0SDKMY,"You don’t need to sign agreements, you need to focus on how to get out of this country,” says Zabiullah Mujahid, a spokesman for the Taliban.",18,22,sign,0,1,1
391JB9X4ZY919IUJSGAPQJ1O0SDKMY,"You don’t need to sign agreements, you need to focus on how to get out of this country,” says Zabiullah Mujahid, a spokesman for the Taliban.",18,33,sign agreements,1,0,1
391JB9X4ZY919IUJSGAPQJ1O0SDKMY,"You don’t need to sign agreements, you need to focus on how to get out of this country,” says Zabiullah Mujahid, a spokesman for the Taliban.",23,33,agreements,6,4,10
391JB9X4ZY919IUJSGAPQJ1O0SDKMY,"You don’t need to sign agreements, you need to focus on how to get out of this country,” says Zabiullah Mujahid, a spokesman for the Taliban.",47,52,focus,0,1,1
391JB9X4ZY919IUJSGAPQJ1O0SDKMY,"You don’t need to sign agreements, you need to focus on how to get out of this country,” says Zabiullah Mujahid, a spokesman for the Taliban.",47,55,focus on,0,1,1
391JB9X4ZY919IUJSGAPQJ1O0SDKMY,"You don’t need to sign agreements, you need to focus on how to get out of this country,” says Zabiullah Mujahid, a spokesman for the Taliban.",94,111,Zabiullah Mujahid,0,1,1
391JB9X4ZY919IUJSGAPQJ1O0SDKMY,"You don’t need to sign agreements, you need to focus on how to get out of this country,” says Zabiullah Mujahid, a spokesman for the Taliban.",115,124,spokesman,0,7,7
391JB9X4ZY919IUJSGAPQJ1O0SDKMY,"“This attack was planned in a very short time, just after the mujahideen got the news of Obama’s arrival.”",62,72,mujahideen,10,2,12
391JB9X4ZY919IUJSGAPQJ1O0SDKMY,"“This attack was planned in a very short time, just after the mujahideen got the news of Obama’s arrival.”",97,104,arrival,0,1,1
391JB9X4ZY919IUJSGAPQJ1O0SDKMY,The attack comes just after the Taliban announced the start of their annual spring offensive in which they increase military activity during warm weather months.,28,39,the Taliban,1,0,1
391JB9X4ZY919IUJSGAPQJ1O0SDKMY,The attack comes just after the Taliban announced the start of their annual spring offensive in which they increase military activity during warm weather months.,40,49,announced,1,1,2
391JB9X4ZY919IUJSGAPQJ1O0SDKMY,The attack comes just after the Taliban announced the start of their annual spring offensive in which they increase military activity during warm weather months.,69,75,annual,2,1,3
391JB9X4ZY919IUJSGAPQJ1O0SDKMY,The attack comes just after the Taliban announced the start of their annual spring offensive in which they increase military activity during warm weather months.,69,92,annual spring offensive,1,2,3
391JB9X4ZY919IUJSGAPQJ1O0SDKMY,The attack comes just after the Taliban announced the start of their annual spring offensive in which they increase military activity during warm weather months.,76,82,spring,0,1,1
391JB9X4ZY919IUJSGAPQJ1O0SDKMY,The attack comes just after the Taliban announced the start of their annual spring offensive in which they increase military activity during warm weather months.,76,92,spring offensive,3,0,3
391JB9X4ZY919IUJSGAPQJ1O0SDKMY,The attack comes just after the Taliban announced the start of their annual spring offensive in which they increase military activity during warm weather months.,83,92,offensive,6,6,12
391JB9X4ZY919IUJSGAPQJ1O0SDKMY,The attack comes just after the Taliban announced the start of their annual spring offensive in which they increase military activity during warm weather months.,107,115,increase,0,1,1
391JB9X4ZY919IUJSGAPQJ1O0SDKMY,The attack comes just after the Taliban announced the start of their annual spring offensive in which they increase military activity during warm weather months.,116,133,military activity,0,1,1
391JB9X4ZY919IUJSGAPQJ1O0SDKMY,"Taliban officials have said they will target members of the Karzai government, parliamentarians, and international troops.",0,7,Taliban,1,0,1
391JB9X4ZY919IUJSGAPQJ1O0SDKMY,"Taliban officials have said they will target members of the Karzai government, parliamentarians, and international troops.",8,17,officials,1,0,1
391JB9X4ZY919IUJSGAPQJ1O0SDKMY,"Taliban officials have said they will target members of the Karzai government, parliamentarians, and international troops.",38,44,target,2,5,7
391JB9X4ZY919IUJSGAPQJ1O0SDKMY,"Taliban officials have said they will target members of the Karzai government, parliamentarians, and international troops.",60,66,Karzai,1,0,1
391JB9X4ZY919IUJSGAPQJ1O0SDKMY,"Taliban officials have said they will target members of the Karzai government, parliamentarians, and international troops.",60,77,Karzai government,2,0,2
391JB9X4ZY919IUJSGAPQJ1O0SDKMY,"Taliban officials have said they will target members of the Karzai government, parliamentarians, and international troops.",67,77,government,1,0,1
391JB9X4ZY919IUJSGAPQJ1O0SDKMY,"Taliban officials have said they will target members of the Karzai government, parliamentarians, and international troops.",79,95,parliamentarians,10,3,13
391JB9X4ZY919IUJSGAPQJ1O0SDKMY,"Taliban officials have said they will target members of the Karzai government, parliamentarians, and international troops.",101,114,international,3,0,3
391JB9X4ZY919IUJSGAPQJ1O0SDKMY,"Taliban officials have said they will target members of the Karzai government, parliamentarians, and international troops.",101,121,international troops,1,0,1
391JB9X4ZY919IUJSGAPQJ1O0SDKMY,"Taliban officials have said they will target members of the Karzai government, parliamentarians, and international troops.",115,121,troops,1,0,1
3RSBJ6YZECRETZNH4LY52AYOOXZFOX,"He didn't see the text until he woke up this morning, Goodyear said.",19,23,text,1,2,3
3RSBJ6YZECRETZNH4LY52AYOOXZFOX,"Deputies identified the children as Pebbles Johnson, 17; Jaxs Johnson, 15; Jazzlyn Johnson, 13; and Joel Johnson, 12.",0,8,Deputies,4,6,10
3RSBJ6YZECRETZNH4LY52AYOOXZFOX,"Deputies identified the children as Pebbles Johnson, 17; Jaxs Johnson, 15; Jazzlyn Johnson, 13; and Joel Johnson, 12.",9,19,identified,5,3,8
3RSBJ6YZECRETZNH4LY52AYOOXZFOX,"The shooting happened in Port St. John, about 15 miles west of Cape Canaveral in an area known as the ""Space Coast"" because it is the home of NASA's Kennedy Space Center, the location of numerous famed shuttle launches.",4,12,shooting,0,1,1
3RSBJ6YZECRETZNH4LY52AYOOXZFOX,"The shooting happened in Port St. John, about 15 miles west of Cape Canaveral in an area known as the ""Space Coast"" because it is the home of NASA's Kennedy Space Center, the location of numerous famed shuttle launches.",13,21,happened,0,1,1
3RSBJ6YZECRETZNH4LY52AYOOXZFOX,"The shooting happened in Port St. John, about 15 miles west of Cape Canaveral in an area known as the ""Space Coast"" because it is the home of NASA's Kennedy Space Center, the location of numerous famed shuttle launches.",68,77,Canaveral,0,1,1
3RSBJ6YZECRETZNH4LY52AYOOXZFOX,"The shooting happened in Port St. John, about 15 miles west of Cape Canaveral in an area known as the ""Space Coast"" because it is the home of NASA's Kennedy Space Center, the location of numerous famed shuttle launches.",103,114,Space Coast,1,0,1
3RSBJ6YZECRETZNH4LY52AYOOXZFOX,"The shooting happened in Port St. John, about 15 miles west of Cape Canaveral in an area known as the ""Space Coast"" because it is the home of NASA's Kennedy Space Center, the location of numerous famed shuttle launches.",175,183,location,0,1,1
3RSBJ6YZECRETZNH4LY52AYOOXZFOX,"The shooting happened in Port St. John, about 15 miles west of Cape Canaveral in an area known as the ""Space Coast"" because it is the home of NASA's Kennedy Space Center, the location of numerous famed shuttle launches.",187,195,numerous,7,4,11
3RSBJ6YZECRETZNH4LY52AYOOXZFOX,"The shooting happened in Port St. John, about 15 miles west of Cape Canaveral in an area known as the ""Space Coast"" because it is the home of NASA's Kennedy Space Center, the location of numerous famed shuttle launches.",187,209,numerous famed shuttle,1,0,1
3RSBJ6YZECRETZNH4LY52AYOOXZFOX,"The shooting happened in Port St. John, about 15 miles west of Cape Canaveral in an area known as the ""Space Coast"" because it is the home of NASA's Kennedy Space Center, the location of numerous famed shuttle launches.",196,201,famed,4,7,11
3RSBJ6YZECRETZNH4LY52AYOOXZFOX,"The shooting happened in Port St. John, about 15 miles west of Cape Canaveral in an area known as the ""Space Coast"" because it is the home of NASA's Kennedy Space Center, the location of numerous famed shuttle launches.",196,209,famed shuttle,0,1,1
3RSBJ6YZECRETZNH4LY52AYOOXZFOX,"The shooting happened in Port St. John, about 15 miles west of Cape Canaveral in an area known as the ""Space Coast"" because it is the home of NASA's Kennedy Space Center, the location of numerous famed shuttle launches.",202,209,shuttle,3,2,5
3RSBJ6YZECRETZNH4LY52AYOOXZFOX,"The shooting happened in Port St. John, about 15 miles west of Cape Canaveral in an area known as the ""Space Coast"" because it is the home of NASA's Kennedy Space Center, the location of numerous famed shuttle launches.",202,218,shuttle launches,3,1,4
3RSBJ6YZECRETZNH4LY52AYOOXZFOX,"The shooting happened in Port St. John, about 15 miles west of Cape Canaveral in an area known as the ""Space Coast"" because it is the home of NASA's Kennedy Space Center, the location of numerous famed shuttle launches.",210,218,launches,2,4,6
3RSBJ6YZECRETZNH4LY52AYOOXZFOX,A spokesman for the Department of Children and Families wouldn't immediately comment on whether the family had a history with the agency.,2,11,spokesman,2,5,7
3RSBJ6YZECRETZNH4LY52AYOOXZFOX,A spokesman for the Department of Children and Families wouldn't immediately comment on whether the family had a history with the agency.,65,76,immediately,3,2,5
3RSBJ6YZECRETZNH4LY52AYOOXZFOX,A spokesman for the Department of Children and Families wouldn't immediately comment on whether the family had a history with the agency.,113,120,history,0,1,1
3RSBJ6YZECRETZNH4LY52AYOOXZFOX,A spokesman for the Department of Children and Families wouldn't immediately comment on whether the family had a history with the agency.,130,136,agency,1,1,2
3RSBJ6YZECRETZNH4LY52AYOOXZFOX,Dispatch records released Tuesday show that authorities responded to Thomas' house on three successive days in April.,0,8,Dispatch,6,6,12
3RSBJ6YZECRETZNH4LY52AYOOXZFOX,Dispatch records released Tuesday show that authorities responded to Thomas' house on three successive days in April.,0,16,Dispatch records,3,2,5
3RSBJ6YZECRETZNH4LY52AYOOXZFOX,Dispatch records released Tuesday show that authorities responded to Thomas' house on three successive days in April.,17,25,released,0,2,2
3RSBJ6YZECRETZNH4LY52AYOOXZFOX,Dispatch records released Tuesday show that authorities responded to Thomas' house on three successive days in April.,44,55,authorities,2,4,6
3RSBJ6YZECRETZNH4LY52AYOOXZFOX,Dispatch records released Tuesday show that authorities responded to Thomas' house on three successive days in April.,44,65,authorities responded,1,0,1
3RSBJ6YZECRETZNH4LY52AYOOXZFOX,Dispatch records released Tuesday show that authorities responded to Thomas' house on three successive days in April.,56,65,responded,1,3,4
3RSBJ6YZECRETZNH4LY52AYOOXZFOX,Dispatch records released Tuesday show that authorities responded to Thomas' house on three successive days in April.,92,102,successive,10,7,17
3RSBJ6YZECRETZNH4LY52AYOOXZFOX,Dispatch records released Tuesday show that authorities responded to Thomas' house on three successive days in April.,92,107,successive days,1,0,1
3RSBJ6YZECRETZNH4LY52AYOOXZFOX,"In the first visit, on Easter Sunday, Thomas reported that her son had thrown a bicycle through a window at the house.",23,29,Easter,1,0,1
3RSBJ6YZECRETZNH4LY52AYOOXZFOX,"In the first visit, on Easter Sunday, Thomas reported that her son had thrown a bicycle through a window at the house.",71,77,thrown,1,1,2
3909MD9T2ZISH8ASA7V9XY4AKVTFET,"Panatag/Scarborough is within the Philippines' Exclusive Economic Zone and Continental Shelf, the DFA added.",34,69,Philippines Exclusive Economic Zone,2,0,2
3909MD9T2ZISH8ASA7V9XY4AKVTFET,"Panatag/Scarborough is within the Philippines' Exclusive Economic Zone and Continental Shelf, the DFA added.",47,56,Exclusive,2,1,3
3909MD9T2ZISH8ASA7V9XY4AKVTFET,"Panatag/Scarborough is within the Philippines' Exclusive Economic Zone and Continental Shelf, the DFA added.",47,70,Exclusive Economic Zone,2,3,5
3909MD9T2ZISH8ASA7V9XY4AKVTFET,"Panatag/Scarborough is within the Philippines' Exclusive Economic Zone and Continental Shelf, the DFA added.",47,92,Exclusive Economic Zone and Continental Shelf,1,0,1
3909MD9T2ZISH8ASA7V9XY4AKVTFET,"Panatag/Scarborough is within the Philippines' Exclusive Economic Zone and Continental Shelf, the DFA added.",57,65,Economic,2,0,2
3909MD9T2ZISH8ASA7V9XY4AKVTFET,"Panatag/Scarborough is within the Philippines' Exclusive Economic Zone and Continental Shelf, the DFA added.",75,86,Continental,1,1,2
3909MD9T2ZISH8ASA7V9XY4AKVTFET,"Panatag/Scarborough is within the Philippines' Exclusive Economic Zone and Continental Shelf, the DFA added.",75,92,Continental Shelf,6,3,9
3909MD9T2ZISH8ASA7V9XY4AKVTFET,"Panatag/Scarborough is within the Philippines' Exclusive Economic Zone and Continental Shelf, the DFA added.",87,92,Shelf,0,1,1
3909MD9T2ZISH8ASA7V9XY4AKVTFET,"Panatag/Scarborough is within the Philippines' Exclusive Economic Zone and Continental Shelf, the DFA added.",98,101,DFA,1,1,2
3909MD9T2ZISH8ASA7V9XY4AKVTFET,The Navy deployed the BRP Gregorio del Pilar (PF-15) from Palawan  on Sunday.,9,17,deployed,6,3,9
3909MD9T2ZISH8ASA7V9XY4AKVTFET,The Navy deployed the BRP Gregorio del Pilar (PF-15) from Palawan  on Sunday.,22,25,BRP,1,1,2
3909MD9T2ZISH8ASA7V9XY4AKVTFET,"But on Tuesday, when the Gregorio del Pilar dispatched a boarding team to inspect the fishing vessels and collect photos and other evidence of their catch, two Chinese vessels showed up, including the government surveillance ship.",44,54,dispatched,7,6,13
3909MD9T2ZISH8ASA7V9XY4AKVTFET,"But on Tuesday, when the Gregorio del Pilar dispatched a boarding team to inspect the fishing vessels and collect photos and other evidence of their catch, two Chinese vessels showed up, including the government surveillance ship.",57,65,boarding,2,0,2
3909MD9T2ZISH8ASA7V9XY4AKVTFET,"But on Tuesday, when the Gregorio del Pilar dispatched a boarding team to inspect the fishing vessels and collect photos and other evidence of their catch, two Chinese vessels showed up, including the government surveillance ship.",57,70,boarding team,4,1,5
3909MD9T2ZISH8ASA7V9XY4AKVTFET,"But on Tuesday, when the Gregorio del Pilar dispatched a boarding team to inspect the fishing vessels and collect photos and other evidence of their catch, two Chinese vessels showed up, including the government surveillance ship.",74,81,inspect,0,1,1
3909MD9T2ZISH8ASA7V9XY4AKVTFET,"But on Tuesday, when the Gregorio del Pilar dispatched a boarding team to inspect the fishing vessels and collect photos and other evidence of their catch, two Chinese vessels showed up, including the government surveillance ship.",86,101,fishing vessels,3,1,4
3909MD9T2ZISH8ASA7V9XY4AKVTFET,"But on Tuesday, when the Gregorio del Pilar dispatched a boarding team to inspect the fishing vessels and collect photos and other evidence of their catch, two Chinese vessels showed up, including the government surveillance ship.",94,101,vessels,3,1,4
3909MD9T2ZISH8ASA7V9XY4AKVTFET,"But on Tuesday, when the Gregorio del Pilar dispatched a boarding team to inspect the fishing vessels and collect photos and other evidence of their catch, two Chinese vessels showed up, including the government surveillance ship.",131,139,evidence,3,1,4
3909MD9T2ZISH8ASA7V9XY4AKVTFET,"But on Tuesday, when the Gregorio del Pilar dispatched a boarding team to inspect the fishing vessels and collect photos and other evidence of their catch, two Chinese vessels showed up, including the government surveillance ship.",149,154,catch,0,2,2
3909MD9T2ZISH8ASA7V9XY4AKVTFET,"But on Tuesday, when the Gregorio del Pilar dispatched a boarding team to inspect the fishing vessels and collect photos and other evidence of their catch, two Chinese vessels showed up, including the government surveillance ship.",168,175,vessels,2,2,4
3909MD9T2ZISH8ASA7V9XY4AKVTFET,"But on Tuesday, when the Gregorio del Pilar dispatched a boarding team to inspect the fishing vessels and collect photos and other evidence of their catch, two Chinese vessels showed up, including the government surveillance ship.",187,196,including,0,1,1
3909MD9T2ZISH8ASA7V9XY4AKVTFET,"But on Tuesday, when the Gregorio del Pilar dispatched a boarding team to inspect the fishing vessels and collect photos and other evidence of their catch, two Chinese vessels showed up, including the government surveillance ship.",201,224,government surveillance,1,0,1
3909MD9T2ZISH8ASA7V9XY4AKVTFET,"But on Tuesday, when the Gregorio del Pilar dispatched a boarding team to inspect the fishing vessels and collect photos and other evidence of their catch, two Chinese vessels showed up, including the government surveillance ship.",201,229,government surveillance ship,3,0,3
3909MD9T2ZISH8ASA7V9XY4AKVTFET,"But on Tuesday, when the Gregorio del Pilar dispatched a boarding team to inspect the fishing vessels and collect photos and other evidence of their catch, two Chinese vessels showed up, including the government surveillance ship.",212,224,surveillance,9,2,11
3909MD9T2ZISH8ASA7V9XY4AKVTFET,"But on Tuesday, when the Gregorio del Pilar dispatched a boarding team to inspect the fishing vessels and collect photos and other evidence of their catch, two Chinese vessels showed up, including the government surveillance ship.",212,229,surveillance ship,0,3,3
3909MD9T2ZISH8ASA7V9XY4AKVTFET,"Initially, it said the inspection team reported that large amounts of illegally collected corals, giant clams and live sharks were found inside the compartments of the first fishing vessel that was boarded by the Navy team.",0,9,Initially,0,1,1
3909MD9T2ZISH8ASA7V9XY4AKVTFET,"Initially, it said the inspection team reported that large amounts of illegally collected corals, giant clams and live sharks were found inside the compartments of the first fishing vessel that was boarded by the Navy team.",23,33,inspection,4,1,5
3909MD9T2ZISH8ASA7V9XY4AKVTFET,"Initially, it said the inspection team reported that large amounts of illegally collected corals, giant clams and live sharks were found inside the compartments of the first fishing vessel that was boarded by the Navy team.",23,38,inspection team,0,1,1
3909MD9T2ZISH8ASA7V9XY4AKVTFET,"Initially, it said the inspection team reported that large amounts of illegally collected corals, giant clams and live sharks were found inside the compartments of the first fishing vessel that was boarded by the Navy team.",70,79,illegally,0,1,1
3909MD9T2ZISH8ASA7V9XY4AKVTFET,"Initially, it said the inspection team reported that large amounts of illegally collected corals, giant clams and live sharks were found inside the compartments of the first fishing vessel that was boarded by the Navy team.",70,89,illegally collected,0,1,1
3909MD9T2ZISH8ASA7V9XY4AKVTFET,"Initially, it said the inspection team reported that large amounts of illegally collected corals, giant clams and live sharks were found inside the compartments of the first fishing vessel that was boarded by the Navy team.",70,96,illegally collected corals,3,0,3
3909MD9T2ZISH8ASA7V9XY4AKVTFET,"Initially, it said the inspection team reported that large amounts of illegally collected corals, giant clams and live sharks were found inside the compartments of the first fishing vessel that was boarded by the Navy team.",90,96,corals,1,2,3
3909MD9T2ZISH8ASA7V9XY4AKVTFET,"Initially, it said the inspection team reported that large amounts of illegally collected corals, giant clams and live sharks were found inside the compartments of the first fishing vessel that was boarded by the Navy team.",104,109,clams,1,1,2
3909MD9T2ZISH8ASA7V9XY4AKVTFET,"Initially, it said the inspection team reported that large amounts of illegally collected corals, giant clams and live sharks were found inside the compartments of the first fishing vessel that was boarded by the Navy team.",148,160,compartments,8,1,9
3909MD9T2ZISH8ASA7V9XY4AKVTFET,"Initially, it said the inspection team reported that large amounts of illegally collected corals, giant clams and live sharks were found inside the compartments of the first fishing vessel that was boarded by the Navy team.",168,188,first fishing vessel,1,0,1
3909MD9T2ZISH8ASA7V9XY4AKVTFET,"Initially, it said the inspection team reported that large amounts of illegally collected corals, giant clams and live sharks were found inside the compartments of the first fishing vessel that was boarded by the Navy team.",182,188,vessel,0,2,2
3909MD9T2ZISH8ASA7V9XY4AKVTFET,"Initially, it said the inspection team reported that large amounts of illegally collected corals, giant clams and live sharks were found inside the compartments of the first fishing vessel that was boarded by the Navy team.",198,205,boarded,1,1,2
3909MD9T2ZISH8ASA7V9XY4AKVTFET,"The Gregorio del Pilar reported two Chinese maritime surveillance ships identified as Zhonggou Haijian 75 and Zhonggou Haijian 84 sailed to the mouth of the Shoal, ""placing themselves between PF-15 and the eight Chinese fishing vessels, thus preventing the arrest of the erring  Chinese fishermen.""",36,71,Chinese maritime surveillance ships,1,0,1
3909MD9T2ZISH8ASA7V9XY4AKVTFET,"The Gregorio del Pilar reported two Chinese maritime surveillance ships identified as Zhonggou Haijian 75 and Zhonggou Haijian 84 sailed to the mouth of the Shoal, ""placing themselves between PF-15 and the eight Chinese fishing vessels, thus preventing the arrest of the erring  Chinese fishermen.""",44,52,maritime,5,1,6
3909MD9T2ZISH8ASA7V9XY4AKVTFET,"The Gregorio del Pilar reported two Chinese maritime surveillance ships identified as Zhonggou Haijian 75 and Zhonggou Haijian 84 sailed to the mouth of the Shoal, ""placing themselves between PF-15 and the eight Chinese fishing vessels, thus preventing the arrest of the erring  Chinese fishermen.""",44,71,maritime surveillance ships,3,0,3
3909MD9T2ZISH8ASA7V9XY4AKVTFET,"The Gregorio del Pilar reported two Chinese maritime surveillance ships identified as Zhonggou Haijian 75 and Zhonggou Haijian 84 sailed to the mouth of the Shoal, ""placing themselves between PF-15 and the eight Chinese fishing vessels, thus preventing the arrest of the erring  Chinese fishermen.""",44,65,maritime surveillance,2,0,2
3909MD9T2ZISH8ASA7V9XY4AKVTFET,"The Gregorio del Pilar reported two Chinese maritime surveillance ships identified as Zhonggou Haijian 75 and Zhonggou Haijian 84 sailed to the mouth of the Shoal, ""placing themselves between PF-15 and the eight Chinese fishing vessels, thus preventing the arrest of the erring  Chinese fishermen.""",53,65,surveillance,4,0,4
3909MD9T2ZISH8ASA7V9XY4AKVTFET,"The Gregorio del Pilar reported two Chinese maritime surveillance ships identified as Zhonggou Haijian 75 and Zhonggou Haijian 84 sailed to the mouth of the Shoal, ""placing themselves between PF-15 and the eight Chinese fishing vessels, thus preventing the arrest of the erring  Chinese fishermen.""",72,82,identified,1,2,3
3909MD9T2ZISH8ASA7V9XY4AKVTFET,"The Gregorio del Pilar reported two Chinese maritime surveillance ships identified as Zhonggou Haijian 75 and Zhonggou Haijian 84 sailed to the mouth of the Shoal, ""placing themselves between PF-15 and the eight Chinese fishing vessels, thus preventing the arrest of the erring  Chinese fishermen.""",86,94,Zhonggou,1,0,1
3909MD9T2ZISH8ASA7V9XY4AKVTFET,"The Gregorio del Pilar reported two Chinese maritime surveillance ships identified as Zhonggou Haijian 75 and Zhonggou Haijian 84 sailed to the mouth of the Shoal, ""placing themselves between PF-15 and the eight Chinese fishing vessels, thus preventing the arrest of the erring  Chinese fishermen.""",157,162,Shoal,4,1,5
3909MD9T2ZISH8ASA7V9XY4AKVTFET,"The Gregorio del Pilar reported two Chinese maritime surveillance ships identified as Zhonggou Haijian 75 and Zhonggou Haijian 84 sailed to the mouth of the Shoal, ""placing themselves between PF-15 and the eight Chinese fishing vessels, thus preventing the arrest of the erring  Chinese fishermen.""",228,235,vessels,0,1,1
3909MD9T2ZISH8ASA7V9XY4AKVTFET,"The Gregorio del Pilar reported two Chinese maritime surveillance ships identified as Zhonggou Haijian 75 and Zhonggou Haijian 84 sailed to the mouth of the Shoal, ""placing themselves between PF-15 and the eight Chinese fishing vessels, thus preventing the arrest of the erring  Chinese fishermen.""",242,252,preventing,1,1,2
3909MD9T2ZISH8ASA7V9XY4AKVTFET,"The Gregorio del Pilar reported two Chinese maritime surveillance ships identified as Zhonggou Haijian 75 and Zhonggou Haijian 84 sailed to the mouth of the Shoal, ""placing themselves between PF-15 and the eight Chinese fishing vessels, thus preventing the arrest of the erring  Chinese fishermen.""",271,277,erring,5,1,6
3RWB1RTQDJONZKPVB75EHIMSAXUP8G,"At the same time, it suggested that between now and November, the president will point to his management of the wars in Iraq and Afghanistan, and the administration's efforts to significantly degrade al-Qaeda, as major successes of his first term.",21,30,suggested,0,3,3
3RWB1RTQDJONZKPVB75EHIMSAXUP8G,"At the same time, it suggested that between now and November, the president will point to his management of the wars in Iraq and Afghanistan, and the administration's efforts to significantly degrade al-Qaeda, as major successes of his first term.",94,104,management,3,1,4
3RWB1RTQDJONZKPVB75EHIMSAXUP8G,"At the same time, it suggested that between now and November, the president will point to his management of the wars in Iraq and Afghanistan, and the administration's efforts to significantly degrade al-Qaeda, as major successes of his first term.",94,116,management of the wars,1,0,1
3RWB1RTQDJONZKPVB75EHIMSAXUP8G,"At the same time, it suggested that between now and November, the president will point to his management of the wars in Iraq and Afghanistan, and the administration's efforts to significantly degrade al-Qaeda, as major successes of his first term.",150,165,administrations,6,1,7
3RWB1RTQDJONZKPVB75EHIMSAXUP8G,"At the same time, it suggested that between now and November, the president will point to his management of the wars in Iraq and Afghanistan, and the administration's efforts to significantly degrade al-Qaeda, as major successes of his first term.",178,191,significantly,5,4,9
3RWB1RTQDJONZKPVB75EHIMSAXUP8G,"At the same time, it suggested that between now and November, the president will point to his management of the wars in Iraq and Afghanistan, and the administration's efforts to significantly degrade al-Qaeda, as major successes of his first term.",178,199,significantly degrade,3,4,7
3RWB1RTQDJONZKPVB75EHIMSAXUP8G,"At the same time, it suggested that between now and November, the president will point to his management of the wars in Iraq and Afghanistan, and the administration's efforts to significantly degrade al-Qaeda, as major successes of his first term.",192,199,degrade,8,2,10
3RWB1RTQDJONZKPVB75EHIMSAXUP8G,"At the same time, it suggested that between now and November, the president will point to his management of the wars in Iraq and Afghanistan, and the administration's efforts to significantly degrade al-Qaeda, as major successes of his first term.",213,218,major,0,1,1
3RWB1RTQDJONZKPVB75EHIMSAXUP8G,"At the same time, it suggested that between now and November, the president will point to his management of the wars in Iraq and Afghanistan, and the administration's efforts to significantly degrade al-Qaeda, as major successes of his first term.",219,228,successes,0,1,1
3RWB1RTQDJONZKPVB75EHIMSAXUP8G,"At the same time, it suggested that between now and November, the president will point to his management of the wars in Iraq and Afghanistan, and the administration's efforts to significantly degrade al-Qaeda, as major successes of his first term.",242,246,term,0,1,1
3RWB1RTQDJONZKPVB75EHIMSAXUP8G,Yet the visit was also a reminder that Obama is keenly aware that he is dealing with a war-weary nation when it comes to Afghanistan.,25,33,reminder,0,2,2
3RWB1RTQDJONZKPVB75EHIMSAXUP8G,Yet the visit was also a reminder that Obama is keenly aware that he is dealing with a war-weary nation when it comes to Afghanistan.,48,54,keenly,5,5,10
3RWB1RTQDJONZKPVB75EHIMSAXUP8G,Yet the visit was also a reminder that Obama is keenly aware that he is dealing with a war-weary nation when it comes to Afghanistan.,48,60,keenly aware,2,1,3
3RWB1RTQDJONZKPVB75EHIMSAXUP8G,Yet the visit was also a reminder that Obama is keenly aware that he is dealing with a war-weary nation when it comes to Afghanistan.,72,79,dealing,0,2,2
3RWB1RTQDJONZKPVB75EHIMSAXUP8G,Yet the visit was also a reminder that Obama is keenly aware that he is dealing with a war-weary nation when it comes to Afghanistan.,87,96,war-weary,10,6,16
3RWB1RTQDJONZKPVB75EHIMSAXUP8G,Yet the visit was also a reminder that Obama is keenly aware that he is dealing with a war-weary nation when it comes to Afghanistan.,87,103,war-weary nation,1,2,3
3RWB1RTQDJONZKPVB75EHIMSAXUP8G,"In the latest Washington Post-ABC News poll, two-thirds of Americans said they think the decade-long battle there has not been worth the costs it has incurred; nearly half the country feels strongly that way.",25,43,Post-ABC News poll,0,2,2
3RWB1RTQDJONZKPVB75EHIMSAXUP8G,"In the latest Washington Post-ABC News poll, two-thirds of Americans said they think the decade-long battle there has not been worth the costs it has incurred; nearly half the country feels strongly that way.",89,100,decade-long,2,4,6
3RWB1RTQDJONZKPVB75EHIMSAXUP8G,"In the latest Washington Post-ABC News poll, two-thirds of Americans said they think the decade-long battle there has not been worth the costs it has incurred; nearly half the country feels strongly that way.",89,107,decade-long battle,1,1,2
3RWB1RTQDJONZKPVB75EHIMSAXUP8G,"In the latest Washington Post-ABC News poll, two-thirds of Americans said they think the decade-long battle there has not been worth the costs it has incurred; nearly half the country feels strongly that way.",127,132,worth,0,2,2
3RWB1RTQDJONZKPVB75EHIMSAXUP8G,"In the latest Washington Post-ABC News poll, two-thirds of Americans said they think the decade-long battle there has not been worth the costs it has incurred; nearly half the country feels strongly that way.",150,158,incurred,10,9,19
3RWB1RTQDJONZKPVB75EHIMSAXUP8G,Even a majority of Republicans hold a negative view of the conflict.,7,15,majority,0,2,2
3RWB1RTQDJONZKPVB75EHIMSAXUP8G,Even a majority of Republicans hold a negative view of the conflict.,59,67,conflict,3,7,10
3RWB1RTQDJONZKPVB75EHIMSAXUP8G,Obama's message Tuesday night in his nationally televised speech was tailored to directly address that sentiment.,37,47,nationally,1,0,1
3RWB1RTQDJONZKPVB75EHIMSAXUP8G,Obama's message Tuesday night in his nationally televised speech was tailored to directly address that sentiment.,48,57,televised,3,1,4
3RWB1RTQDJONZKPVB75EHIMSAXUP8G,Obama's message Tuesday night in his nationally televised speech was tailored to directly address that sentiment.,48,64,televised speech,0,2,2
3RWB1RTQDJONZKPVB75EHIMSAXUP8G,Obama's message Tuesday night in his nationally televised speech was tailored to directly address that sentiment.,69,77,tailored,10,10,20
3RWB1RTQDJONZKPVB75EHIMSAXUP8G,Obama's message Tuesday night in his nationally televised speech was tailored to directly address that sentiment.,90,97,address,1,0,1
3RWB1RTQDJONZKPVB75EHIMSAXUP8G,Obama's message Tuesday night in his nationally televised speech was tailored to directly address that sentiment.,103,112,sentiment,10,5,15
3CIS7GGG65KH0Q7I5WQ8JY5DUI8EUR,Albert Del Rosario said he met ambassador Ma Keqing and both reaffirmed their governments' positions that the Scarborough Shoal where the ships are facing off was part of their own country's territory.,31,41,ambassador,5,2,7
3CIS7GGG65KH0Q7I5WQ8JY5DUI8EUR,Albert Del Rosario said he met ambassador Ma Keqing and both reaffirmed their governments' positions that the Scarborough Shoal where the ships are facing off was part of their own country's territory.,61,71,reaffirmed,10,7,17
3CIS7GGG65KH0Q7I5WQ8JY5DUI8EUR,Albert Del Rosario said he met ambassador Ma Keqing and both reaffirmed their governments' positions that the Scarborough Shoal where the ships are facing off was part of their own country's territory.,78,89,governments,1,0,1
3CIS7GGG65KH0Q7I5WQ8JY5DUI8EUR,Albert Del Rosario said he met ambassador Ma Keqing and both reaffirmed their governments' positions that the Scarborough Shoal where the ships are facing off was part of their own country's territory.,122,127,Shoal,1,0,1
3CIS7GGG65KH0Q7I5WQ8JY5DUI8EUR,Albert Del Rosario said he met ambassador Ma Keqing and both reaffirmed their governments' positions that the Scarborough Shoal where the ships are facing off was part of their own country's territory.,148,158,facing off,1,2,3
3CIS7GGG65KH0Q7I5WQ8JY5DUI8EUR,Albert Del Rosario said he met ambassador Ma Keqing and both reaffirmed their governments' positions that the Scarborough Shoal where the ships are facing off was part of their own country's territory.,191,200,territory,2,2,4
3CIS7GGG65KH0Q7I5WQ8JY5DUI8EUR,"Mr Del Rosario said that despite the impasse, ""we resolved to seek a diplomatic solution to the issue"".",25,32,despite,0,1,1
3CIS7GGG65KH0Q7I5WQ8JY5DUI8EUR,"Mr Del Rosario said that despite the impasse, ""we resolved to seek a diplomatic solution to the issue"".",25,44,despite the impasse,0,1,1
3CIS7GGG65KH0Q7I5WQ8JY5DUI8EUR,"Mr Del Rosario said that despite the impasse, ""we resolved to seek a diplomatic solution to the issue"".",37,44,impasse,10,8,18
3CIS7GGG65KH0Q7I5WQ8JY5DUI8EUR,"Mr Del Rosario said that despite the impasse, ""we resolved to seek a diplomatic solution to the issue"".",50,58,resolved,0,2,2
3CIS7GGG65KH0Q7I5WQ8JY5DUI8EUR,"Mr Del Rosario said that despite the impasse, ""we resolved to seek a diplomatic solution to the issue"".",69,79,diplomatic,6,2,8
3CIS7GGG65KH0Q7I5WQ8JY5DUI8EUR,"Mr Del Rosario said that despite the impasse, ""we resolved to seek a diplomatic solution to the issue"".",69,88,diplomatic solution,3,2,5
3CIS7GGG65KH0Q7I5WQ8JY5DUI8EUR,"Mr Del Rosario said that despite the impasse, ""we resolved to seek a diplomatic solution to the issue"".",96,101,issue,1,0,1
3CIS7GGG65KH0Q7I5WQ8JY5DUI8EUR,The Philippine government says its navy tried to detain Chinese fishermen but was prevented by the Chinese surveillance craft.,15,25,government,1,0,1
3CIS7GGG65KH0Q7I5WQ8JY5DUI8EUR,The Philippine government says its navy tried to detain Chinese fishermen but was prevented by the Chinese surveillance craft.,49,55,detain,4,3,7
3CIS7GGG65KH0Q7I5WQ8JY5DUI8EUR,The Philippine government says its navy tried to detain Chinese fishermen but was prevented by the Chinese surveillance craft.,64,73,fishermen,1,0,1
3CIS7GGG65KH0Q7I5WQ8JY5DUI8EUR,The Philippine government says its navy tried to detain Chinese fishermen but was prevented by the Chinese surveillance craft.,82,91,prevented,1,0,1
3CIS7GGG65KH0Q7I5WQ8JY5DUI8EUR,The Philippine government says its navy tried to detain Chinese fishermen but was prevented by the Chinese surveillance craft.,107,119,surveillance,7,5,12
3CIS7GGG65KH0Q7I5WQ8JY5DUI8EUR,The Philippine government says its navy tried to detain Chinese fishermen but was prevented by the Chinese surveillance craft.,107,125,surveillance craft,4,2,6
3CIS7GGG65KH0Q7I5WQ8JY5DUI8EUR,The Philippine government says its navy tried to detain Chinese fishermen but was prevented by the Chinese surveillance craft.,120,125,craft,0,2,2
3CIS7GGG65KH0Q7I5WQ8JY5DUI8EUR,Beijing called on the Philippine ship to leave the waters.,51,57,waters,0,1,1
3CIS7GGG65KH0Q7I5WQ8JY5DUI8EUR,The shoal lies off the north-western province of Zambales.,4,9,shoal,9,4,13
3CIS7GGG65KH0Q7I5WQ8JY5DUI8EUR,The shoal lies off the north-western province of Zambales.,23,36,north-western,0,1,1
3CIS7GGG65KH0Q7I5WQ8JY5DUI8EUR,The shoal lies off the north-western province of Zambales.,37,45,province,1,0,1
3CIS7GGG65KH0Q7I5WQ8JY5DUI8EUR,"China and the Philippines have been disputing ownership of the shoal, in addition to the Spratly Islands and other areas in the South China Sea.",36,45,disputing,9,5,14
3CIS7GGG65KH0Q7I5WQ8JY5DUI8EUR,"China and the Philippines have been disputing ownership of the shoal, in addition to the Spratly Islands and other areas in the South China Sea.",36,55,disputing ownership,1,0,1
3CIS7GGG65KH0Q7I5WQ8JY5DUI8EUR,"China and the Philippines have been disputing ownership of the shoal, in addition to the Spratly Islands and other areas in the South China Sea.",63,68,shoal,1,2,3
3CIS7GGG65KH0Q7I5WQ8JY5DUI8EUR,"The Philippine Department of Foreign Affairs said that on Sunday, a Philippine navy surveillance plane sighted eight Chinese fishing vessels anchored in a lagoon at Scarborough, prompting the military to deploy its largest warship, the BRP Gregorio del Pilar, which was recently acquired from the United States.",15,44,Department of Foreign Affairs,1,0,1
3CIS7GGG65KH0Q7I5WQ8JY5DUI8EUR,"The Philippine Department of Foreign Affairs said that on Sunday, a Philippine navy surveillance plane sighted eight Chinese fishing vessels anchored in a lagoon at Scarborough, prompting the military to deploy its largest warship, the BRP Gregorio del Pilar, which was recently acquired from the United States.",84,96,surveillance,8,1,9
3CIS7GGG65KH0Q7I5WQ8JY5DUI8EUR,"The Philippine Department of Foreign Affairs said that on Sunday, a Philippine navy surveillance plane sighted eight Chinese fishing vessels anchored in a lagoon at Scarborough, prompting the military to deploy its largest warship, the BRP Gregorio del Pilar, which was recently acquired from the United States.",84,102,surveillance plane,0,1,1
3CIS7GGG65KH0Q7I5WQ8JY5DUI8EUR,"The Philippine Department of Foreign Affairs said that on Sunday, a Philippine navy surveillance plane sighted eight Chinese fishing vessels anchored in a lagoon at Scarborough, prompting the military to deploy its largest warship, the BRP Gregorio del Pilar, which was recently acquired from the United States.",103,110,sighted,1,3,4
3CIS7GGG65KH0Q7I5WQ8JY5DUI8EUR,"The Philippine Department of Foreign Affairs said that on Sunday, a Philippine navy surveillance plane sighted eight Chinese fishing vessels anchored in a lagoon at Scarborough, prompting the military to deploy its largest warship, the BRP Gregorio del Pilar, which was recently acquired from the United States.",117,140,Chinese fishing vessels,1,0,1
3CIS7GGG65KH0Q7I5WQ8JY5DUI8EUR,"The Philippine Department of Foreign Affairs said that on Sunday, a Philippine navy surveillance plane sighted eight Chinese fishing vessels anchored in a lagoon at Scarborough, prompting the military to deploy its largest warship, the BRP Gregorio del Pilar, which was recently acquired from the United States.",125,140,fishing vessels,1,1,2
3CIS7GGG65KH0Q7I5WQ8JY5DUI8EUR,"The Philippine Department of Foreign Affairs said that on Sunday, a Philippine navy surveillance plane sighted eight Chinese fishing vessels anchored in a lagoon at Scarborough, prompting the military to deploy its largest warship, the BRP Gregorio del Pilar, which was recently acquired from the United States.",133,140,vessels,0,2,2
3CIS7GGG65KH0Q7I5WQ8JY5DUI8EUR,"The Philippine Department of Foreign Affairs said that on Sunday, a Philippine navy surveillance plane sighted eight Chinese fishing vessels anchored in a lagoon at Scarborough, prompting the military to deploy its largest warship, the BRP Gregorio del Pilar, which was recently acquired from the United States.",133,149,vessels anchored,1,0,1
3CIS7GGG65KH0Q7I5WQ8JY5DUI8EUR,"The Philippine Department of Foreign Affairs said that on Sunday, a Philippine navy surveillance plane sighted eight Chinese fishing vessels anchored in a lagoon at Scarborough, prompting the military to deploy its largest warship, the BRP Gregorio del Pilar, which was recently acquired from the United States.",141,149,anchored,5,4,9
3CIS7GGG65KH0Q7I5WQ8JY5DUI8EUR,"The Philippine Department of Foreign Affairs said that on Sunday, a Philippine navy surveillance plane sighted eight Chinese fishing vessels anchored in a lagoon at Scarborough, prompting the military to deploy its largest warship, the BRP Gregorio del Pilar, which was recently acquired from the United States.",155,161,lagoon,5,1,6
3CIS7GGG65KH0Q7I5WQ8JY5DUI8EUR,"The Philippine Department of Foreign Affairs said that on Sunday, a Philippine navy surveillance plane sighted eight Chinese fishing vessels anchored in a lagoon at Scarborough, prompting the military to deploy its largest warship, the BRP Gregorio del Pilar, which was recently acquired from the United States.",178,187,prompting,1,2,3
3CIS7GGG65KH0Q7I5WQ8JY5DUI8EUR,"The Philippine Department of Foreign Affairs said that on Sunday, a Philippine navy surveillance plane sighted eight Chinese fishing vessels anchored in a lagoon at Scarborough, prompting the military to deploy its largest warship, the BRP Gregorio del Pilar, which was recently acquired from the United States.",204,210,deploy,5,5,10
3CIS7GGG65KH0Q7I5WQ8JY5DUI8EUR,"The Philippine Department of Foreign Affairs said that on Sunday, a Philippine navy surveillance plane sighted eight Chinese fishing vessels anchored in a lagoon at Scarborough, prompting the military to deploy its largest warship, the BRP Gregorio del Pilar, which was recently acquired from the United States.",223,230,warship,2,1,3
3CIS7GGG65KH0Q7I5WQ8JY5DUI8EUR,"The Philippine Department of Foreign Affairs said that on Sunday, a Philippine navy surveillance plane sighted eight Chinese fishing vessels anchored in a lagoon at Scarborough, prompting the military to deploy its largest warship, the BRP Gregorio del Pilar, which was recently acquired from the United States.",270,287,recently acquired,1,0,1
3CIS7GGG65KH0Q7I5WQ8JY5DUI8EUR,"The Philippine Department of Foreign Affairs said that on Sunday, a Philippine navy surveillance plane sighted eight Chinese fishing vessels anchored in a lagoon at Scarborough, prompting the military to deploy its largest warship, the BRP Gregorio del Pilar, which was recently acquired from the United States.",279,287,acquired,10,1,11
3RDTX9JRTY2Y7J45KDHBHSQIUXR97F,"For banks unable to raise the funds, the government will provide five-year loans, convertible into shares with an interest rate double the rate on government bonds.",10,16,unable,0,1,1
3RDTX9JRTY2Y7J45KDHBHSQIUXR97F,"For banks unable to raise the funds, the government will provide five-year loans, convertible into shares with an interest rate double the rate on government bonds.",20,25,raise,0,2,2
3RDTX9JRTY2Y7J45KDHBHSQIUXR97F,"For banks unable to raise the funds, the government will provide five-year loans, convertible into shares with an interest rate double the rate on government bonds.",30,35,funds,1,0,1
3RDTX9JRTY2Y7J45KDHBHSQIUXR97F,"For banks unable to raise the funds, the government will provide five-year loans, convertible into shares with an interest rate double the rate on government bonds.",41,51,government,1,0,1
3RDTX9JRTY2Y7J45KDHBHSQIUXR97F,"For banks unable to raise the funds, the government will provide five-year loans, convertible into shares with an interest rate double the rate on government bonds.",82,93,convertible,10,7,17
3RDTX9JRTY2Y7J45KDHBHSQIUXR97F,"For banks unable to raise the funds, the government will provide five-year loans, convertible into shares with an interest rate double the rate on government bonds.",82,105,convertible into shares,1,0,1
3RDTX9JRTY2Y7J45KDHBHSQIUXR97F,"For banks unable to raise the funds, the government will provide five-year loans, convertible into shares with an interest rate double the rate on government bonds.",99,105,shares,0,2,2
3RDTX9JRTY2Y7J45KDHBHSQIUXR97F,"For banks unable to raise the funds, the government will provide five-year loans, convertible into shares with an interest rate double the rate on government bonds.",114,127,interest rate,1,2,3
3RDTX9JRTY2Y7J45KDHBHSQIUXR97F,"For banks unable to raise the funds, the government will provide five-year loans, convertible into shares with an interest rate double the rate on government bonds.",147,163,government bonds,1,0,1
3RDTX9JRTY2Y7J45KDHBHSQIUXR97F,"For banks unable to raise the funds, the government will provide five-year loans, convertible into shares with an interest rate double the rate on government bonds.",158,163,bonds,0,2,2
3RDTX9JRTY2Y7J45KDHBHSQIUXR97F,"The state will have to raise money on debt markets for the loans to the banks, which will be made through an instrument known as contingent convertibles, or CoCos, which carry the risk that the state ends up with ownership of still-troubled banks.",23,28,raise,0,1,1
3RDTX9JRTY2Y7J45KDHBHSQIUXR97F,"The state will have to raise money on debt markets for the loans to the banks, which will be made through an instrument known as contingent convertibles, or CoCos, which carry the risk that the state ends up with ownership of still-troubled banks.",38,42,debt,2,1,3
3RDTX9JRTY2Y7J45KDHBHSQIUXR97F,"The state will have to raise money on debt markets for the loans to the banks, which will be made through an instrument known as contingent convertibles, or CoCos, which carry the risk that the state ends up with ownership of still-troubled banks.",38,50,debt markets,3,2,5
3RDTX9JRTY2Y7J45KDHBHSQIUXR97F,"The state will have to raise money on debt markets for the loans to the banks, which will be made through an instrument known as contingent convertibles, or CoCos, which carry the risk that the state ends up with ownership of still-troubled banks.",109,119,instrument,6,2,8
3RDTX9JRTY2Y7J45KDHBHSQIUXR97F,"The state will have to raise money on debt markets for the loans to the banks, which will be made through an instrument known as contingent convertibles, or CoCos, which carry the risk that the state ends up with ownership of still-troubled banks.",129,139,contingent,3,7,10
3RDTX9JRTY2Y7J45KDHBHSQIUXR97F,"The state will have to raise money on debt markets for the loans to the banks, which will be made through an instrument known as contingent convertibles, or CoCos, which carry the risk that the state ends up with ownership of still-troubled banks.",129,152,contingent convertibles,9,5,14
3RDTX9JRTY2Y7J45KDHBHSQIUXR97F,"The state will have to raise money on debt markets for the loans to the banks, which will be made through an instrument known as contingent convertibles, or CoCos, which carry the risk that the state ends up with ownership of still-troubled banks.",140,152,convertibles,2,1,3
3RDTX9JRTY2Y7J45KDHBHSQIUXR97F,"The state will have to raise money on debt markets for the loans to the banks, which will be made through an instrument known as contingent convertibles, or CoCos, which carry the risk that the state ends up with ownership of still-troubled banks.",157,162,CoCos,3,3,6
3RDTX9JRTY2Y7J45KDHBHSQIUXR97F,"The state will have to raise money on debt markets for the loans to the banks, which will be made through an instrument known as contingent convertibles, or CoCos, which carry the risk that the state ends up with ownership of still-troubled banks.",213,222,ownership,1,0,1
3RDTX9JRTY2Y7J45KDHBHSQIUXR97F,"The state will have to raise money on debt markets for the loans to the banks, which will be made through an instrument known as contingent convertibles, or CoCos, which carry the risk that the state ends up with ownership of still-troubled banks.",226,240,still-troubled,1,0,1
3RDTX9JRTY2Y7J45KDHBHSQIUXR97F,"The state will have to raise money on debt markets for the loans to the banks, which will be made through an instrument known as contingent convertibles, or CoCos, which carry the risk that the state ends up with ownership of still-troubled banks.",226,246,still-troubled banks,0,1,1
3RDTX9JRTY2Y7J45KDHBHSQIUXR97F,Spain announced Friday a drastic reform forcing banks to set aside a new 30-billion-euro ($39 billion) financial cushion and to separate property assets from their balance sheets.,6,15,announced,0,1,1
3RDTX9JRTY2Y7J45KDHBHSQIUXR97F,Spain announced Friday a drastic reform forcing banks to set aside a new 30-billion-euro ($39 billion) financial cushion and to separate property assets from their balance sheets.,25,32,drastic,4,5,9
3RDTX9JRTY2Y7J45KDHBHSQIUXR97F,Spain announced Friday a drastic reform forcing banks to set aside a new 30-billion-euro ($39 billion) financial cushion and to separate property assets from their balance sheets.,25,39,drastic reform,6,2,8
3RDTX9JRTY2Y7J45KDHBHSQIUXR97F,Spain announced Friday a drastic reform forcing banks to set aside a new 30-billion-euro ($39 billion) financial cushion and to separate property assets from their balance sheets.,33,39,reform,1,2,3
3RDTX9JRTY2Y7J45KDHBHSQIUXR97F,Spain announced Friday a drastic reform forcing banks to set aside a new 30-billion-euro ($39 billion) financial cushion and to separate property assets from their balance sheets.,61,66,aside,1,1,2
3RDTX9JRTY2Y7J45KDHBHSQIUXR97F,Spain announced Friday a drastic reform forcing banks to set aside a new 30-billion-euro ($39 billion) financial cushion and to separate property assets from their balance sheets.,103,120,financial cushion,7,3,10
3RDTX9JRTY2Y7J45KDHBHSQIUXR97F,Spain announced Friday a drastic reform forcing banks to set aside a new 30-billion-euro ($39 billion) financial cushion and to separate property assets from their balance sheets.,113,120,cushion,2,4,6
3RDTX9JRTY2Y7J45KDHBHSQIUXR97F,Spain announced Friday a drastic reform forcing banks to set aside a new 30-billion-euro ($39 billion) financial cushion and to separate property assets from their balance sheets.,146,152,assets,3,1,4
3RDTX9JRTY2Y7J45KDHBHSQIUXR97F,Spain announced Friday a drastic reform forcing banks to set aside a new 30-billion-euro ($39 billion) financial cushion and to separate property assets from their balance sheets.,164,178,balance sheets,2,1,3
3RDTX9JRTY2Y7J45KDHBHSQIUXR97F,"The government will also charge two independent auditing firms with valuing banks' exposure to the collapsed property sector, ministers told a news conference after a cabinet meeting.",36,47,independent,1,0,1
3RDTX9JRTY2Y7J45KDHBHSQIUXR97F,"The government will also charge two independent auditing firms with valuing banks' exposure to the collapsed property sector, ministers told a news conference after a cabinet meeting.",36,62,independent auditing firms,2,0,2
3RDTX9JRTY2Y7J45KDHBHSQIUXR97F,"The government will also charge two independent auditing firms with valuing banks' exposure to the collapsed property sector, ministers told a news conference after a cabinet meeting.",48,56,auditing,8,7,15
3RDTX9JRTY2Y7J45KDHBHSQIUXR97F,"The government will also charge two independent auditing firms with valuing banks' exposure to the collapsed property sector, ministers told a news conference after a cabinet meeting.",48,62,auditing firms,1,0,1
3RDTX9JRTY2Y7J45KDHBHSQIUXR97F,"The government will also charge two independent auditing firms with valuing banks' exposure to the collapsed property sector, ministers told a news conference after a cabinet meeting.",68,75,valuing,2,1,3
3RDTX9JRTY2Y7J45KDHBHSQIUXR97F,"The government will also charge two independent auditing firms with valuing banks' exposure to the collapsed property sector, ministers told a news conference after a cabinet meeting.",68,90,valuing banks exposure,0,1,1
3RDTX9JRTY2Y7J45KDHBHSQIUXR97F,"The government will also charge two independent auditing firms with valuing banks' exposure to the collapsed property sector, ministers told a news conference after a cabinet meeting.",83,91,exposure,3,5,8
3RDTX9JRTY2Y7J45KDHBHSQIUXR97F,"The government will also charge two independent auditing firms with valuing banks' exposure to the collapsed property sector, ministers told a news conference after a cabinet meeting.",99,108,collapsed,1,5,6
3RDTX9JRTY2Y7J45KDHBHSQIUXR97F,"The government will also charge two independent auditing firms with valuing banks' exposure to the collapsed property sector, ministers told a news conference after a cabinet meeting.",99,124,collapsed property sector,4,1,5
3RDTX9JRTY2Y7J45KDHBHSQIUXR97F,"The government will also charge two independent auditing firms with valuing banks' exposure to the collapsed property sector, ministers told a news conference after a cabinet meeting.",118,124,sector,1,0,1
3RDTX9JRTY2Y7J45KDHBHSQIUXR97F,"The government will also charge two independent auditing firms with valuing banks' exposure to the collapsed property sector, ministers told a news conference after a cabinet meeting.",148,158,conference,1,2,3
3RDTX9JRTY2Y7J45KDHBHSQIUXR97F,"The government will also charge two independent auditing firms with valuing banks' exposure to the collapsed property sector, ministers told a news conference after a cabinet meeting.",167,174,cabinet,0,1,1
3RDTX9JRTY2Y7J45KDHBHSQIUXR97F,"The government will also charge two independent auditing firms with valuing banks' exposure to the collapsed property sector, ministers told a news conference after a cabinet meeting.",167,182,cabinet meeting,2,0,2
3TZ0XG8CBUL27X9OUI9HVSMD5HX982,"Earlier, financial sources had suggested the reform could be partly delayed to allow more time for negotiations between the government and major banks.",0,7,Earlier,0,1,1
3TZ0XG8CBUL27X9OUI9HVSMD5HX982,"Earlier, financial sources had suggested the reform could be partly delayed to allow more time for negotiations between the government and major banks.",9,18,financial,1,1,2
3TZ0XG8CBUL27X9OUI9HVSMD5HX982,"Earlier, financial sources had suggested the reform could be partly delayed to allow more time for negotiations between the government and major banks.",9,26,financial sources,2,1,3
3TZ0XG8CBUL27X9OUI9HVSMD5HX982,"Earlier, financial sources had suggested the reform could be partly delayed to allow more time for negotiations between the government and major banks.",31,40,suggested,1,1,2
3TZ0XG8CBUL27X9OUI9HVSMD5HX982,"Earlier, financial sources had suggested the reform could be partly delayed to allow more time for negotiations between the government and major banks.",45,51,reform,4,4,8
3TZ0XG8CBUL27X9OUI9HVSMD5HX982,"Earlier, financial sources had suggested the reform could be partly delayed to allow more time for negotiations between the government and major banks.",61,75,partly delayed,0,1,1
3TZ0XG8CBUL27X9OUI9HVSMD5HX982,"Earlier, financial sources had suggested the reform could be partly delayed to allow more time for negotiations between the government and major banks.",68,75,delayed,1,3,4
3TZ0XG8CBUL27X9OUI9HVSMD5HX982,"Earlier, financial sources had suggested the reform could be partly delayed to allow more time for negotiations between the government and major banks.",99,111,negotiations,10,6,16
3TZ0XG8CBUL27X9OUI9HVSMD5HX982,Spain is set to intensify the clean-up of its banks on Friday after difficult last-minute talks between the government and lenders on details of planned financial system reforms.,16,25,intensify,9,8,17
3TZ0XG8CBUL27X9OUI9HVSMD5HX982,Spain is set to intensify the clean-up of its banks on Friday after difficult last-minute talks between the government and lenders on details of planned financial system reforms.,16,38,intensify the clean-up,0,1,1
3TZ0XG8CBUL27X9OUI9HVSMD5HX982,Spain is set to intensify the clean-up of its banks on Friday after difficult last-minute talks between the government and lenders on details of planned financial system reforms.,30,38,clean-up,1,1,2
3TZ0XG8CBUL27X9OUI9HVSMD5HX982,Spain is set to intensify the clean-up of its banks on Friday after difficult last-minute talks between the government and lenders on details of planned financial system reforms.,30,51,clean-up of its banks,1,0,1
3TZ0XG8CBUL27X9OUI9HVSMD5HX982,Spain is set to intensify the clean-up of its banks on Friday after difficult last-minute talks between the government and lenders on details of planned financial system reforms.,78,89,last-minute,1,0,1
3TZ0XG8CBUL27X9OUI9HVSMD5HX982,Spain is set to intensify the clean-up of its banks on Friday after difficult last-minute talks between the government and lenders on details of planned financial system reforms.,123,130,lenders,1,4,5
3TZ0XG8CBUL27X9OUI9HVSMD5HX982,Spain is set to intensify the clean-up of its banks on Friday after difficult last-minute talks between the government and lenders on details of planned financial system reforms.,153,162,financial,1,0,1
3TZ0XG8CBUL27X9OUI9HVSMD5HX982,Spain is set to intensify the clean-up of its banks on Friday after difficult last-minute talks between the government and lenders on details of planned financial system reforms.,153,169,financial system,0,1,1
3TZ0XG8CBUL27X9OUI9HVSMD5HX982,Spain is set to intensify the clean-up of its banks on Friday after difficult last-minute talks between the government and lenders on details of planned financial system reforms.,153,177,financial system reforms,3,0,3
3TZ0XG8CBUL27X9OUI9HVSMD5HX982,Spain is set to intensify the clean-up of its banks on Friday after difficult last-minute talks between the government and lenders on details of planned financial system reforms.,170,177,reforms,1,0,1
3TZ0XG8CBUL27X9OUI9HVSMD5HX982,"At its weekly cabinet meeting, the government will approve a plan to force banks to park their toxic real estate assets in holding companies that would later sell them off, a move that could deepen losses for the lenders.",14,21,cabinet,3,0,3
3TZ0XG8CBUL27X9OUI9HVSMD5HX982,"At its weekly cabinet meeting, the government will approve a plan to force banks to park their toxic real estate assets in holding companies that would later sell them off, a move that could deepen losses for the lenders.",14,29,cabinet meeting,2,0,2
3TZ0XG8CBUL27X9OUI9HVSMD5HX982,"At its weekly cabinet meeting, the government will approve a plan to force banks to park their toxic real estate assets in holding companies that would later sell them off, a move that could deepen losses for the lenders.",81,88,to park,0,1,1
3TZ0XG8CBUL27X9OUI9HVSMD5HX982,"At its weekly cabinet meeting, the government will approve a plan to force banks to park their toxic real estate assets in holding companies that would later sell them off, a move that could deepen losses for the lenders.",95,100,toxic,3,4,7
3TZ0XG8CBUL27X9OUI9HVSMD5HX982,"At its weekly cabinet meeting, the government will approve a plan to force banks to park their toxic real estate assets in holding companies that would later sell them off, a move that could deepen losses for the lenders.",95,119,toxic real estate assets,3,3,6
3TZ0XG8CBUL27X9OUI9HVSMD5HX982,"At its weekly cabinet meeting, the government will approve a plan to force banks to park their toxic real estate assets in holding companies that would later sell them off, a move that could deepen losses for the lenders.",101,119,real estate assets,1,0,1
3TZ0XG8CBUL27X9OUI9HVSMD5HX982,"At its weekly cabinet meeting, the government will approve a plan to force banks to park their toxic real estate assets in holding companies that would later sell them off, a move that could deepen losses for the lenders.",106,112,estate,0,2,2
3TZ0XG8CBUL27X9OUI9HVSMD5HX982,"At its weekly cabinet meeting, the government will approve a plan to force banks to park their toxic real estate assets in holding companies that would later sell them off, a move that could deepen losses for the lenders.",113,119,assets,3,1,4
3TZ0XG8CBUL27X9OUI9HVSMD5HX982,"At its weekly cabinet meeting, the government will approve a plan to force banks to park their toxic real estate assets in holding companies that would later sell them off, a move that could deepen losses for the lenders.",123,140,holding companies,1,0,1
3TZ0XG8CBUL27X9OUI9HVSMD5HX982,"At its weekly cabinet meeting, the government will approve a plan to force banks to park their toxic real estate assets in holding companies that would later sell them off, a move that could deepen losses for the lenders.",191,197,deepen,1,3,4
3TZ0XG8CBUL27X9OUI9HVSMD5HX982,"At its weekly cabinet meeting, the government will approve a plan to force banks to park their toxic real estate assets in holding companies that would later sell them off, a move that could deepen losses for the lenders.",191,204,deepen losses,2,1,3
3TZ0XG8CBUL27X9OUI9HVSMD5HX982,"At its weekly cabinet meeting, the government will approve a plan to force banks to park their toxic real estate assets in holding companies that would later sell them off, a move that could deepen losses for the lenders.",213,220,lenders,0,2,2
3TZ0XG8CBUL27X9OUI9HVSMD5HX982,The cabinet is also expected to demand banks to set aside a further 35 billion euros (27.9 billion pounds) to cover sound loans in their real estate portfolios.,4,11,cabinet,3,1,4
3TZ0XG8CBUL27X9OUI9HVSMD5HX982,The cabinet is also expected to demand banks to set aside a further 35 billion euros (27.9 billion pounds) to cover sound loans in their real estate portfolios.,20,38,expected to demand,0,1,1
3TZ0XG8CBUL27X9OUI9HVSMD5HX982,The cabinet is also expected to demand banks to set aside a further 35 billion euros (27.9 billion pounds) to cover sound loans in their real estate portfolios.,32,38,demand,0,1,1
3TZ0XG8CBUL27X9OUI9HVSMD5HX982,The cabinet is also expected to demand banks to set aside a further 35 billion euros (27.9 billion pounds) to cover sound loans in their real estate portfolios.,48,57,set aside,0,1,1
3TZ0XG8CBUL27X9OUI9HVSMD5HX982,The cabinet is also expected to demand banks to set aside a further 35 billion euros (27.9 billion pounds) to cover sound loans in their real estate portfolios.,116,127,sound loans,4,3,7
3TZ0XG8CBUL27X9OUI9HVSMD5HX982,The cabinet is also expected to demand banks to set aside a further 35 billion euros (27.9 billion pounds) to cover sound loans in their real estate portfolios.,137,159,real estate portfolios,5,1,6
3TZ0XG8CBUL27X9OUI9HVSMD5HX982,The cabinet is also expected to demand banks to set aside a further 35 billion euros (27.9 billion pounds) to cover sound loans in their real estate portfolios.,142,159,estate portfolios,0,1,1
3TZ0XG8CBUL27X9OUI9HVSMD5HX982,The cabinet is also expected to demand banks to set aside a further 35 billion euros (27.9 billion pounds) to cover sound loans in their real estate portfolios.,149,159,portfolios,6,7,13
3TZ0XG8CBUL27X9OUI9HVSMD5HX982,The government has already obliged banks to make provisions of 54 billion euros to cover bad assets.,27,34,obliged,7,7,14
3TZ0XG8CBUL27X9OUI9HVSMD5HX982,The government has already obliged banks to make provisions of 54 billion euros to cover bad assets.,49,59,provisions,9,4,13
3TZ0XG8CBUL27X9OUI9HVSMD5HX982,The government has already obliged banks to make provisions of 54 billion euros to cover bad assets.,89,99,bad assets,1,4,5
3TZ0XG8CBUL27X9OUI9HVSMD5HX982,The government has already obliged banks to make provisions of 54 billion euros to cover bad assets.,93,99,assets,2,0,2
30UZJB2POHDX5D16FB14SV904CP357,"Two Chinese maritime surveillance ships, identified as Zhonggou Haijian 75 and Zhonggou Haijian 84, later approached and positioned themselves between the Philippine warship and the Chinese fishing vessels ""thus preventing the arrests of the erring Chinese fishermen"", the statement said.",12,20,maritime,3,3,6
30UZJB2POHDX5D16FB14SV904CP357,"Two Chinese maritime surveillance ships, identified as Zhonggou Haijian 75 and Zhonggou Haijian 84, later approached and positioned themselves between the Philippine warship and the Chinese fishing vessels ""thus preventing the arrests of the erring Chinese fishermen"", the statement said.",12,33,maritime surveillance,6,1,7
30UZJB2POHDX5D16FB14SV904CP357,"Two Chinese maritime surveillance ships, identified as Zhonggou Haijian 75 and Zhonggou Haijian 84, later approached and positioned themselves between the Philippine warship and the Chinese fishing vessels ""thus preventing the arrests of the erring Chinese fishermen"", the statement said.",12,39,maritime surveillance ships,5,1,6
30UZJB2POHDX5D16FB14SV904CP357,"Two Chinese maritime surveillance ships, identified as Zhonggou Haijian 75 and Zhonggou Haijian 84, later approached and positioned themselves between the Philippine warship and the Chinese fishing vessels ""thus preventing the arrests of the erring Chinese fishermen"", the statement said.",21,33,surveillance,5,4,9
30UZJB2POHDX5D16FB14SV904CP357,"Two Chinese maritime surveillance ships, identified as Zhonggou Haijian 75 and Zhonggou Haijian 84, later approached and positioned themselves between the Philippine warship and the Chinese fishing vessels ""thus preventing the arrests of the erring Chinese fishermen"", the statement said.",41,51,identified,0,1,1
30UZJB2POHDX5D16FB14SV904CP357,"Two Chinese maritime surveillance ships, identified as Zhonggou Haijian 75 and Zhonggou Haijian 84, later approached and positioned themselves between the Philippine warship and the Chinese fishing vessels ""thus preventing the arrests of the erring Chinese fishermen"", the statement said.",106,116,approached,2,2,4
30UZJB2POHDX5D16FB14SV904CP357,"Two Chinese maritime surveillance ships, identified as Zhonggou Haijian 75 and Zhonggou Haijian 84, later approached and positioned themselves between the Philippine warship and the Chinese fishing vessels ""thus preventing the arrests of the erring Chinese fishermen"", the statement said.",106,131,approached and positioned,1,0,1
30UZJB2POHDX5D16FB14SV904CP357,"Two Chinese maritime surveillance ships, identified as Zhonggou Haijian 75 and Zhonggou Haijian 84, later approached and positioned themselves between the Philippine warship and the Chinese fishing vessels ""thus preventing the arrests of the erring Chinese fishermen"", the statement said.",121,131,positioned,3,1,4
30UZJB2POHDX5D16FB14SV904CP357,"Two Chinese maritime surveillance ships, identified as Zhonggou Haijian 75 and Zhonggou Haijian 84, later approached and positioned themselves between the Philippine warship and the Chinese fishing vessels ""thus preventing the arrests of the erring Chinese fishermen"", the statement said.",190,205,fishing vessels,2,1,3
30UZJB2POHDX5D16FB14SV904CP357,"Two Chinese maritime surveillance ships, identified as Zhonggou Haijian 75 and Zhonggou Haijian 84, later approached and positioned themselves between the Philippine warship and the Chinese fishing vessels ""thus preventing the arrests of the erring Chinese fishermen"", the statement said.",198,205,vessels,1,2,3
30UZJB2POHDX5D16FB14SV904CP357,"Two Chinese maritime surveillance ships, identified as Zhonggou Haijian 75 and Zhonggou Haijian 84, later approached and positioned themselves between the Philippine warship and the Chinese fishing vessels ""thus preventing the arrests of the erring Chinese fishermen"", the statement said.",212,222,preventing,3,1,4
30UZJB2POHDX5D16FB14SV904CP357,"Two Chinese maritime surveillance ships, identified as Zhonggou Haijian 75 and Zhonggou Haijian 84, later approached and positioned themselves between the Philippine warship and the Chinese fishing vessels ""thus preventing the arrests of the erring Chinese fishermen"", the statement said.",242,248,erring,8,7,15
30UZJB2POHDX5D16FB14SV904CP357,"Chinese officials, who refer to Scarborough Shoal as Huangyan Island, have in the past asserted Chinese sovereignty over the area.",32,43,Scarborough,0,1,1
30UZJB2POHDX5D16FB14SV904CP357,"Chinese officials, who refer to Scarborough Shoal as Huangyan Island, have in the past asserted Chinese sovereignty over the area.",87,95,asserted,10,5,15
30UZJB2POHDX5D16FB14SV904CP357,"Chinese officials, who refer to Scarborough Shoal as Huangyan Island, have in the past asserted Chinese sovereignty over the area.",87,115,asserted Chinese sovereignty,1,0,1
30UZJB2POHDX5D16FB14SV904CP357,"Chinese officials, who refer to Scarborough Shoal as Huangyan Island, have in the past asserted Chinese sovereignty over the area.",96,115,Chinese sovereignty,2,0,2
30UZJB2POHDX5D16FB14SV904CP357,"Chinese officials, who refer to Scarborough Shoal as Huangyan Island, have in the past asserted Chinese sovereignty over the area.",104,115,sovereignty,10,10,20
30UZJB2POHDX5D16FB14SV904CP357,"The Philippines refers to the shoal, a rich fishing ground, as Panatag.",30,35,shoal,9,2,11
30UZJB2POHDX5D16FB14SV904CP357,"The Philippines refers to the shoal, a rich fishing ground, as Panatag.",37,58,a rich fishing ground,1,0,1
30UZJB2POHDX5D16FB14SV904CP357,"Last year the Philippines accused Chinese vessels of intruding into other parts of what it considers Philippine territory near the South China Sea, including the Spratlys.",26,33,accused,1,2,3
30UZJB2POHDX5D16FB14SV904CP357,"Last year the Philippines accused Chinese vessels of intruding into other parts of what it considers Philippine territory near the South China Sea, including the Spratlys.",42,49,vessels,1,1,2
30UZJB2POHDX5D16FB14SV904CP357,"Last year the Philippines accused Chinese vessels of intruding into other parts of what it considers Philippine territory near the South China Sea, including the Spratlys.",53,62,intruding,9,6,15
30UZJB2POHDX5D16FB14SV904CP357,"Last year the Philippines accused Chinese vessels of intruding into other parts of what it considers Philippine territory near the South China Sea, including the Spratlys.",112,121,territory,3,0,3
30UZJB2POHDX5D16FB14SV904CP357,"Last year the Philippines accused Chinese vessels of intruding into other parts of what it considers Philippine territory near the South China Sea, including the Spratlys.",162,170,Spratlys,1,0,1
30UZJB2POHDX5D16FB14SV904CP357,"China has regularly dismissed the protests, saying Beijing has indisputable sovereignty over those areas on historical grounds.",10,29,regularly dismissed,2,0,2
30UZJB2POHDX5D16FB14SV904CP357,"China has regularly dismissed the protests, saying Beijing has indisputable sovereignty over those areas on historical grounds.",20,29,dismissed,1,3,4
30UZJB2POHDX5D16FB14SV904CP357,"China has regularly dismissed the protests, saying Beijing has indisputable sovereignty over those areas on historical grounds.",34,42,protests,0,1,1
30UZJB2POHDX5D16FB14SV904CP357,"China has regularly dismissed the protests, saying Beijing has indisputable sovereignty over those areas on historical grounds.",63,75,indisputable,4,5,9
30UZJB2POHDX5D16FB14SV904CP357,"China has regularly dismissed the protests, saying Beijing has indisputable sovereignty over those areas on historical grounds.",63,87,indisputable sovereignty,8,1,9
30UZJB2POHDX5D16FB14SV904CP357,"China has regularly dismissed the protests, saying Beijing has indisputable sovereignty over those areas on historical grounds.",76,87,sovereignty,3,2,5
30UZJB2POHDX5D16FB14SV904CP357,"China has regularly dismissed the protests, saying Beijing has indisputable sovereignty over those areas on historical grounds.",108,118,historical,1,0,1
30UZJB2POHDX5D16FB14SV904CP357,"China has regularly dismissed the protests, saying Beijing has indisputable sovereignty over those areas on historical grounds.",108,126,historical grounds,1,1,2
30UZJB2POHDX5D16FB14SV904CP357,"Google said on Saturday that Chinese authorities have approved its $12.5 billion (7.9 billion pounds) purchase of Motorola Mobility Holdings, the last regulatory hurdle to a deal that would allow the world's No. 1 Internet search engine to develop its own line of smart phones.",151,161,regulatory,5,0,5
30UZJB2POHDX5D16FB14SV904CP357,"Google said on Saturday that Chinese authorities have approved its $12.5 billion (7.9 billion pounds) purchase of Motorola Mobility Holdings, the last regulatory hurdle to a deal that would allow the world's No. 1 Internet search engine to develop its own line of smart phones.",151,168,regulatory hurdle,8,5,13
30UZJB2POHDX5D16FB14SV904CP357,"Google said on Saturday that Chinese authorities have approved its $12.5 billion (7.9 billion pounds) purchase of Motorola Mobility Holdings, the last regulatory hurdle to a deal that would allow the world's No. 1 Internet search engine to develop its own line of smart phones.",162,168,hurdle,0,3,3
30UZJB2POHDX5D16FB14SV904CP357,"Google said on Saturday that Chinese authorities have approved its $12.5 billion (7.9 billion pounds) purchase of Motorola Mobility Holdings, the last regulatory hurdle to a deal that would allow the world's No. 1 Internet search engine to develop its own line of smart phones.",223,236,search engine,1,0,1
37MQ8Z1JQEX6MJF7MDSWKI21T3T2YB,"It is understood the dead girl had been living at her family home, in a neighbouring housing estate, and was visiting her older sister at the time of the shooting.",6,16,understood,2,1,3
37MQ8Z1JQEX6MJF7MDSWKI21T3T2YB,"It is understood the dead girl had been living at her family home, in a neighbouring housing estate, and was visiting her older sister at the time of the shooting.",72,84,neighbouring,3,3,6
37MQ8Z1JQEX6MJF7MDSWKI21T3T2YB,"It is understood the dead girl had been living at her family home, in a neighbouring housing estate, and was visiting her older sister at the time of the shooting.",72,99,neighbouring housing estate,1,2,3
37MQ8Z1JQEX6MJF7MDSWKI21T3T2YB,"It is understood the dead girl had been living at her family home, in a neighbouring housing estate, and was visiting her older sister at the time of the shooting.",85,99,housing estate,2,3,5
37MQ8Z1JQEX6MJF7MDSWKI21T3T2YB,"It is understood the dead girl had been living at her family home, in a neighbouring housing estate, and was visiting her older sister at the time of the shooting.",93,99,estate,3,2,5
37MQ8Z1JQEX6MJF7MDSWKI21T3T2YB,"Locals reported seeing and speaking with her in the village during the morning, before police were called to the scene at around 10.40am.",7,15,reported,0,2,2
37MQ8Z1JQEX6MJF7MDSWKI21T3T2YB,"Locals reported seeing and speaking with her in the village during the morning, before police were called to the scene at around 10.40am.",113,118,scene,0,3,3
37MQ8Z1JQEX6MJF7MDSWKI21T3T2YB,"Northern Ireland's deputy first minister and Mid-Ulster MP, Martin McGuinness, said his heart went out to the family of the girl tragically killed.",19,25,deputy,0,1,1
37MQ8Z1JQEX6MJF7MDSWKI21T3T2YB,"Northern Ireland's deputy first minister and Mid-Ulster MP, Martin McGuinness, said his heart went out to the family of the girl tragically killed.",19,40,deputy first minister,2,1,3
37MQ8Z1JQEX6MJF7MDSWKI21T3T2YB,"Northern Ireland's deputy first minister and Mid-Ulster MP, Martin McGuinness, said his heart went out to the family of the girl tragically killed.",32,40,minister,1,0,1
37MQ8Z1JQEX6MJF7MDSWKI21T3T2YB,"Northern Ireland's deputy first minister and Mid-Ulster MP, Martin McGuinness, said his heart went out to the family of the girl tragically killed.",45,58,Mid-Ulster MP,1,0,1
37MQ8Z1JQEX6MJF7MDSWKI21T3T2YB,"Northern Ireland's deputy first minister and Mid-Ulster MP, Martin McGuinness, said his heart went out to the family of the girl tragically killed.",88,102,heart went out,1,1,2
37MQ8Z1JQEX6MJF7MDSWKI21T3T2YB,"Northern Ireland's deputy first minister and Mid-Ulster MP, Martin McGuinness, said his heart went out to the family of the girl tragically killed.",129,139,tragically,8,7,15
37MQ8Z1JQEX6MJF7MDSWKI21T3T2YB,"Northern Ireland's deputy first minister and Mid-Ulster MP, Martin McGuinness, said his heart went out to the family of the girl tragically killed.",129,146,tragically killed,0,2,2
37MQ8Z1JQEX6MJF7MDSWKI21T3T2YB,"People I have spoken to in the area this morning are in a state of shock, he said.",14,20,spoken,0,1,1
37MQ8Z1JQEX6MJF7MDSWKI21T3T2YB,"People I have spoken to in the area this morning are in a state of shock, he said.",58,72,state of shock,4,4,8
37MQ8Z1JQEX6MJF7MDSWKI21T3T2YB,I would wish to extend my thoughts and prayers to the family and friends of the victim at this terrible time.,16,22,extend,6,6,12
37MQ8Z1JQEX6MJF7MDSWKI21T3T2YB,I would wish to extend my thoughts and prayers to the family and friends of the victim at this terrible time.,80,86,victim,2,4,6
37MQ8Z1JQEX6MJF7MDSWKI21T3T2YB,I would wish to extend my thoughts and prayers to the family and friends of the victim at this terrible time.,95,103,terrible,1,5,6
37MQ8Z1JQEX6MJF7MDSWKI21T3T2YB,I would wish to extend my thoughts and prayers to the family and friends of the victim at this terrible time.,95,108,terrible time,0,2,2
37MQ8Z1JQEX6MJF7MDSWKI21T3T2YB,A PSNI spokesman said they were alerted to the shooting shortly before 10.40am today.,2,6,PSNI,0,3,3
37MQ8Z1JQEX6MJF7MDSWKI21T3T2YB,A PSNI spokesman said they were alerted to the shooting shortly before 10.40am today.,7,16,spokesman,5,6,11
37MQ8Z1JQEX6MJF7MDSWKI21T3T2YB,A PSNI spokesman said they were alerted to the shooting shortly before 10.40am today.,32,39,alerted,6,6,12
37MQ8Z1JQEX6MJF7MDSWKI21T3T2YB,A PSNI spokesman said they were alerted to the shooting shortly before 10.40am today.,56,63,shortly,0,1,1
3J6BHNX0U9T7R0FJ4HPP3YQO568NKY,"Spain, the eurozone's fourth-largest economy, is in its second recession in three years and is battling to reduce a swollen deficit and 24.4 per cent unemployment.",11,20,eurozones,7,1,8
3J6BHNX0U9T7R0FJ4HPP3YQO568NKY,"Spain, the eurozone's fourth-largest economy, is in its second recession in three years and is battling to reduce a swollen deficit and 24.4 per cent unemployment.",11,43,eurozones fourth-largest economy,1,0,1
3J6BHNX0U9T7R0FJ4HPP3YQO568NKY,"Spain, the eurozone's fourth-largest economy, is in its second recession in three years and is battling to reduce a swollen deficit and 24.4 per cent unemployment.",22,36,fourth-largest,0,1,1
3J6BHNX0U9T7R0FJ4HPP3YQO568NKY,"Spain, the eurozone's fourth-largest economy, is in its second recession in three years and is battling to reduce a swollen deficit and 24.4 per cent unemployment.",63,72,recession,10,10,20
3J6BHNX0U9T7R0FJ4HPP3YQO568NKY,"Spain, the eurozone's fourth-largest economy, is in its second recession in three years and is battling to reduce a swollen deficit and 24.4 per cent unemployment.",95,103,battling,1,3,4
3J6BHNX0U9T7R0FJ4HPP3YQO568NKY,"Spain, the eurozone's fourth-largest economy, is in its second recession in three years and is battling to reduce a swollen deficit and 24.4 per cent unemployment.",107,113,reduce,0,1,1
3J6BHNX0U9T7R0FJ4HPP3YQO568NKY,"Spain, the eurozone's fourth-largest economy, is in its second recession in three years and is battling to reduce a swollen deficit and 24.4 per cent unemployment.",116,123,swollen,3,4,7
3J6BHNX0U9T7R0FJ4HPP3YQO568NKY,"Spain, the eurozone's fourth-largest economy, is in its second recession in three years and is battling to reduce a swollen deficit and 24.4 per cent unemployment.",116,131,swollen deficit,7,8,15
3J6BHNX0U9T7R0FJ4HPP3YQO568NKY,"Spain, the eurozone's fourth-largest economy, is in its second recession in three years and is battling to reduce a swollen deficit and 24.4 per cent unemployment.",124,131,deficit,3,6,9
3J6BHNX0U9T7R0FJ4HPP3YQO568NKY,"Spain, the eurozone's fourth-largest economy, is in its second recession in three years and is battling to reduce a swollen deficit and 24.4 per cent unemployment.",150,162,unemployment,4,3,7
3J6BHNX0U9T7R0FJ4HPP3YQO568NKY,The government is under intense pressure to reduce the deficit from 8.5 of GDP in 2011 to 5.3 per cent this year and to Europe Union limit of three percent in 2013.,4,14,government,1,0,1
3J6BHNX0U9T7R0FJ4HPP3YQO568NKY,The government is under intense pressure to reduce the deficit from 8.5 of GDP in 2011 to 5.3 per cent this year and to Europe Union limit of three percent in 2013.,18,40,under intense pressure,1,0,1
3J6BHNX0U9T7R0FJ4HPP3YQO568NKY,The government is under intense pressure to reduce the deficit from 8.5 of GDP in 2011 to 5.3 per cent this year and to Europe Union limit of three percent in 2013.,24,31,intense,3,8,11
3J6BHNX0U9T7R0FJ4HPP3YQO568NKY,The government is under intense pressure to reduce the deficit from 8.5 of GDP in 2011 to 5.3 per cent this year and to Europe Union limit of three percent in 2013.,24,40,intense pressure,1,1,2
3J6BHNX0U9T7R0FJ4HPP3YQO568NKY,The government is under intense pressure to reduce the deficit from 8.5 of GDP in 2011 to 5.3 per cent this year and to Europe Union limit of three percent in 2013.,55,62,deficit,6,0,6
3J6BHNX0U9T7R0FJ4HPP3YQO568NKY,The government is under intense pressure to reduce the deficit from 8.5 of GDP in 2011 to 5.3 per cent this year and to Europe Union limit of three percent in 2013.,75,78,GDP,2,0,2
3J6BHNX0U9T7R0FJ4HPP3YQO568NKY,The government is under intense pressure to reduce the deficit from 8.5 of GDP in 2011 to 5.3 per cent this year and to Europe Union limit of three percent in 2013.,120,132,Europe Union,1,0,1
3J6BHNX0U9T7R0FJ4HPP3YQO568NKY,"But the European Union painted a grim picture of Spain's economy hours ahead of the reform, saying the country's GDP will shrink 1.8 per cent this year — compared with the 1.7 per cent drop predicted by Madrid — and that the deficit will come in at 6.4 per cent of output, not 5.3 per cent, because of overspending by regional governments.",23,30,painted,1,2,3
3J6BHNX0U9T7R0FJ4HPP3YQO568NKY,"But the European Union painted a grim picture of Spain's economy hours ahead of the reform, saying the country's GDP will shrink 1.8 per cent this year — compared with the 1.7 per cent drop predicted by Madrid — and that the deficit will come in at 6.4 per cent of output, not 5.3 per cent, because of overspending by regional governments.",23,45,painted a grim picture,3,0,3
3J6BHNX0U9T7R0FJ4HPP3YQO568NKY,"But the European Union painted a grim picture of Spain's economy hours ahead of the reform, saying the country's GDP will shrink 1.8 per cent this year — compared with the 1.7 per cent drop predicted by Madrid — and that the deficit will come in at 6.4 per cent of output, not 5.3 per cent, because of overspending by regional governments.",33,37,grim,3,8,11
3J6BHNX0U9T7R0FJ4HPP3YQO568NKY,"But the European Union painted a grim picture of Spain's economy hours ahead of the reform, saying the country's GDP will shrink 1.8 per cent this year — compared with the 1.7 per cent drop predicted by Madrid — and that the deficit will come in at 6.4 per cent of output, not 5.3 per cent, because of overspending by regional governments.",33,45,grim picture,1,3,4
3J6BHNX0U9T7R0FJ4HPP3YQO568NKY,"But the European Union painted a grim picture of Spain's economy hours ahead of the reform, saying the country's GDP will shrink 1.8 per cent this year — compared with the 1.7 per cent drop predicted by Madrid — and that the deficit will come in at 6.4 per cent of output, not 5.3 per cent, because of overspending by regional governments.",84,90,reform,2,5,7
3J6BHNX0U9T7R0FJ4HPP3YQO568NKY,"But the European Union painted a grim picture of Spain's economy hours ahead of the reform, saying the country's GDP will shrink 1.8 per cent this year — compared with the 1.7 per cent drop predicted by Madrid — and that the deficit will come in at 6.4 per cent of output, not 5.3 per cent, because of overspending by regional governments.",113,116,GDP,2,0,2
3J6BHNX0U9T7R0FJ4HPP3YQO568NKY,"But the European Union painted a grim picture of Spain's economy hours ahead of the reform, saying the country's GDP will shrink 1.8 per cent this year — compared with the 1.7 per cent drop predicted by Madrid — and that the deficit will come in at 6.4 per cent of output, not 5.3 per cent, because of overspending by regional governments.",122,128,shrink,2,8,10
3J6BHNX0U9T7R0FJ4HPP3YQO568NKY,"But the European Union painted a grim picture of Spain's economy hours ahead of the reform, saying the country's GDP will shrink 1.8 per cent this year — compared with the 1.7 per cent drop predicted by Madrid — and that the deficit will come in at 6.4 per cent of output, not 5.3 per cent, because of overspending by regional governments.",185,189,drop,0,1,1
3J6BHNX0U9T7R0FJ4HPP3YQO568NKY,"But the European Union painted a grim picture of Spain's economy hours ahead of the reform, saying the country's GDP will shrink 1.8 per cent this year — compared with the 1.7 per cent drop predicted by Madrid — and that the deficit will come in at 6.4 per cent of output, not 5.3 per cent, because of overspending by regional governments.",190,199,predicted,4,6,10
3J6BHNX0U9T7R0FJ4HPP3YQO568NKY,"But the European Union painted a grim picture of Spain's economy hours ahead of the reform, saying the country's GDP will shrink 1.8 per cent this year — compared with the 1.7 per cent drop predicted by Madrid — and that the deficit will come in at 6.4 per cent of output, not 5.3 per cent, because of overspending by regional governments.",203,209,Madrid,0,1,1
3J6BHNX0U9T7R0FJ4HPP3YQO568NKY,"But the European Union painted a grim picture of Spain's economy hours ahead of the reform, saying the country's GDP will shrink 1.8 per cent this year — compared with the 1.7 per cent drop predicted by Madrid — and that the deficit will come in at 6.4 per cent of output, not 5.3 per cent, because of overspending by regional governments.",225,232,deficit,4,1,5
3J6BHNX0U9T7R0FJ4HPP3YQO568NKY,"But the European Union painted a grim picture of Spain's economy hours ahead of the reform, saying the country's GDP will shrink 1.8 per cent this year — compared with the 1.7 per cent drop predicted by Madrid — and that the deficit will come in at 6.4 per cent of output, not 5.3 per cent, because of overspending by regional governments.",265,271,output,2,1,3
3J6BHNX0U9T7R0FJ4HPP3YQO568NKY,"But the European Union painted a grim picture of Spain's economy hours ahead of the reform, saying the country's GDP will shrink 1.8 per cent this year — compared with the 1.7 per cent drop predicted by Madrid — and that the deficit will come in at 6.4 per cent of output, not 5.3 per cent, because of overspending by regional governments.",302,314,overspending,1,10,11
3J6BHNX0U9T7R0FJ4HPP3YQO568NKY,"But the European Union painted a grim picture of Spain's economy hours ahead of the reform, saying the country's GDP will shrink 1.8 per cent this year — compared with the 1.7 per cent drop predicted by Madrid — and that the deficit will come in at 6.4 per cent of output, not 5.3 per cent, because of overspending by regional governments.",302,338,overspending by regional governments,1,0,1
3J6BHNX0U9T7R0FJ4HPP3YQO568NKY,"But the European Union painted a grim picture of Spain's economy hours ahead of the reform, saying the country's GDP will shrink 1.8 per cent this year — compared with the 1.7 per cent drop predicted by Madrid — and that the deficit will come in at 6.4 per cent of output, not 5.3 per cent, because of overspending by regional governments.",318,338,regional governments,1,0,1
3FBEFUUYRK6T8205T9QJ791654P6AS,"Also Monday, the Observatory and the LCC said government troops stormed the Damascus suburb of Qaboun where they conducted raids and deployed snipers on roofs of buildings.",17,28,Observatory,3,3,6
3FBEFUUYRK6T8205T9QJ791654P6AS,"Also Monday, the Observatory and the LCC said government troops stormed the Damascus suburb of Qaboun where they conducted raids and deployed snipers on roofs of buildings.",37,40,LCC,1,1,2
3FBEFUUYRK6T8205T9QJ791654P6AS,"Also Monday, the Observatory and the LCC said government troops stormed the Damascus suburb of Qaboun where they conducted raids and deployed snipers on roofs of buildings.",46,56,government,1,0,1
3FBEFUUYRK6T8205T9QJ791654P6AS,"Also Monday, the Observatory and the LCC said government troops stormed the Damascus suburb of Qaboun where they conducted raids and deployed snipers on roofs of buildings.",64,71,stormed,4,10,14
3FBEFUUYRK6T8205T9QJ791654P6AS,"Also Monday, the Observatory and the LCC said government troops stormed the Damascus suburb of Qaboun where they conducted raids and deployed snipers on roofs of buildings.",76,84,Damascus,1,0,1
3FBEFUUYRK6T8205T9QJ791654P6AS,"Also Monday, the Observatory and the LCC said government troops stormed the Damascus suburb of Qaboun where they conducted raids and deployed snipers on roofs of buildings.",85,91,suburb,6,3,9
3FBEFUUYRK6T8205T9QJ791654P6AS,"Also Monday, the Observatory and the LCC said government troops stormed the Damascus suburb of Qaboun where they conducted raids and deployed snipers on roofs of buildings.",95,101,Qaboun,2,0,2
3FBEFUUYRK6T8205T9QJ791654P6AS,"Also Monday, the Observatory and the LCC said government troops stormed the Damascus suburb of Qaboun where they conducted raids and deployed snipers on roofs of buildings.",113,122,conducted,3,0,3
3FBEFUUYRK6T8205T9QJ791654P6AS,"Also Monday, the Observatory and the LCC said government troops stormed the Damascus suburb of Qaboun where they conducted raids and deployed snipers on roofs of buildings.",123,128,raids,2,0,2
3FBEFUUYRK6T8205T9QJ791654P6AS,"Also Monday, the Observatory and the LCC said government troops stormed the Damascus suburb of Qaboun where they conducted raids and deployed snipers on roofs of buildings.",133,141,deployed,5,7,12
3FBEFUUYRK6T8205T9QJ791654P6AS,"Also Monday, the Observatory and the LCC said government troops stormed the Damascus suburb of Qaboun where they conducted raids and deployed snipers on roofs of buildings.",133,149,deployed snipers,3,4,7
3FBEFUUYRK6T8205T9QJ791654P6AS,"Also Monday, the Observatory and the LCC said government troops stormed the Damascus suburb of Qaboun where they conducted raids and deployed snipers on roofs of buildings.",142,149,snipers,4,6,10
3FBEFUUYRK6T8205T9QJ791654P6AS,"In Damascus, state-run TV said the results of last week's parliamentary elections will be made public Tuesday.",13,22,state-run,2,0,2
3FBEFUUYRK6T8205T9QJ791654P6AS,"In Damascus, state-run TV said the results of last week's parliamentary elections will be made public Tuesday.",13,25,state-run TV,2,0,2
3FBEFUUYRK6T8205T9QJ791654P6AS,"In Damascus, state-run TV said the results of last week's parliamentary elections will be made public Tuesday.",58,71,parliamentary,6,1,7
3FBEFUUYRK6T8205T9QJ791654P6AS,"In Damascus, state-run TV said the results of last week's parliamentary elections will be made public Tuesday.",58,81,parliamentary elections,1,0,1
3FBEFUUYRK6T8205T9QJ791654P6AS,"The government has praised the vote as a milestone in promised political reforms, but the opposition boycotted the polls and said they were designed to strengthen Assad's grip on power.",4,14,government,1,0,1
3FBEFUUYRK6T8205T9QJ791654P6AS,"The government has praised the vote as a milestone in promised political reforms, but the opposition boycotted the polls and said they were designed to strengthen Assad's grip on power.",19,26,praised,1,1,2
3FBEFUUYRK6T8205T9QJ791654P6AS,"The government has praised the vote as a milestone in promised political reforms, but the opposition boycotted the polls and said they were designed to strengthen Assad's grip on power.",27,50,the vote as a milestone,0,1,1
3FBEFUUYRK6T8205T9QJ791654P6AS,"The government has praised the vote as a milestone in promised political reforms, but the opposition boycotted the polls and said they were designed to strengthen Assad's grip on power.",41,50,milestone,7,4,11
3FBEFUUYRK6T8205T9QJ791654P6AS,"The government has praised the vote as a milestone in promised political reforms, but the opposition boycotted the polls and said they were designed to strengthen Assad's grip on power.",41,80,milestone in promised political reforms,1,0,1
3FBEFUUYRK6T8205T9QJ791654P6AS,"The government has praised the vote as a milestone in promised political reforms, but the opposition boycotted the polls and said they were designed to strengthen Assad's grip on power.",63,80,political reforms,3,1,4
3FBEFUUYRK6T8205T9QJ791654P6AS,"The government has praised the vote as a milestone in promised political reforms, but the opposition boycotted the polls and said they were designed to strengthen Assad's grip on power.",73,80,reforms,1,2,3
3FBEFUUYRK6T8205T9QJ791654P6AS,"The government has praised the vote as a milestone in promised political reforms, but the opposition boycotted the polls and said they were designed to strengthen Assad's grip on power.",90,100,opposition,2,0,2
3FBEFUUYRK6T8205T9QJ791654P6AS,"The government has praised the vote as a milestone in promised political reforms, but the opposition boycotted the polls and said they were designed to strengthen Assad's grip on power.",101,110,boycotted,10,10,20
3FBEFUUYRK6T8205T9QJ791654P6AS,"The government has praised the vote as a milestone in promised political reforms, but the opposition boycotted the polls and said they were designed to strengthen Assad's grip on power.",101,120,boycotted the polls,1,0,1
3FBEFUUYRK6T8205T9QJ791654P6AS,"The government has praised the vote as a milestone in promised political reforms, but the opposition boycotted the polls and said they were designed to strengthen Assad's grip on power.",115,120,polls,1,0,1
3FBEFUUYRK6T8205T9QJ791654P6AS,"The government has praised the vote as a milestone in promised political reforms, but the opposition boycotted the polls and said they were designed to strengthen Assad's grip on power.",140,148,designed,1,1,2
3FBEFUUYRK6T8205T9QJ791654P6AS,"The government has praised the vote as a milestone in promised political reforms, but the opposition boycotted the polls and said they were designed to strengthen Assad's grip on power.",152,162,strengthen,0,1,1
3FBEFUUYRK6T8205T9QJ791654P6AS,"The government has praised the vote as a milestone in promised political reforms, but the opposition boycotted the polls and said they were designed to strengthen Assad's grip on power.",163,169,Assads,1,0,1
3FBEFUUYRK6T8205T9QJ791654P6AS,"The government has praised the vote as a milestone in promised political reforms, but the opposition boycotted the polls and said they were designed to strengthen Assad's grip on power.",171,175,grip,1,1,2
3FBEFUUYRK6T8205T9QJ791654P6AS,Syria's uprising started in March 2011 with protests calling for political reform.,8,16,uprising,1,4,5
3FBEFUUYRK6T8205T9QJ791654P6AS,Syria's uprising started in March 2011 with protests calling for political reform.,44,52,protests,0,1,1
3FBEFUUYRK6T8205T9QJ791654P6AS,Syria's uprising started in March 2011 with protests calling for political reform.,65,74,political,1,0,1
3FBEFUUYRK6T8205T9QJ791654P6AS,Syria's uprising started in March 2011 with protests calling for political reform.,65,81,political reform,3,0,3
3FBEFUUYRK6T8205T9QJ791654P6AS,Syria's uprising started in March 2011 with protests calling for political reform.,75,81,reform,0,2,2
3FBEFUUYRK6T8205T9QJ791654P6AS,"The government brutally cracked down on dissent, and many in the opposition have since taken up arms to defend themselves and attack government troops.",15,23,brutally,5,4,9
3FBEFUUYRK6T8205T9QJ791654P6AS,"The government brutally cracked down on dissent, and many in the opposition have since taken up arms to defend themselves and attack government troops.",15,36,brutally cracked down,1,0,1
3FBEFUUYRK6T8205T9QJ791654P6AS,"The government brutally cracked down on dissent, and many in the opposition have since taken up arms to defend themselves and attack government troops.",24,31,cracked,0,1,1
3FBEFUUYRK6T8205T9QJ791654P6AS,"The government brutally cracked down on dissent, and many in the opposition have since taken up arms to defend themselves and attack government troops.",24,36,cracked down,0,4,4
3FBEFUUYRK6T8205T9QJ791654P6AS,"The government brutally cracked down on dissent, and many in the opposition have since taken up arms to defend themselves and attack government troops.",40,47,dissent,6,7,13
3FBEFUUYRK6T8205T9QJ791654P6AS,"The government brutally cracked down on dissent, and many in the opposition have since taken up arms to defend themselves and attack government troops.",65,75,opposition,1,0,1
3FBEFUUYRK6T8205T9QJ791654P6AS,Some soldiers also have switched sides and joined forces with the rebels.,24,38,switched sides,1,3,4
3FBEFUUYRK6T8205T9QJ791654P6AS,Some soldiers also have switched sides and joined forces with the rebels.,66,72,rebels,2,3,5
3ZG552ORAM5PIPK2H25CDJY7BMRV2V,"A mother shot and killed her four children before turning a gun on herself in a small town in Florida on Tuesday, authorities said.",50,74,turning a gun on herself,0,1,1
3ZG552ORAM5PIPK2H25CDJY7BMRV2V,"A mother shot and killed her four children before turning a gun on herself in a small town in Florida on Tuesday, authorities said.",114,125,authorities,7,5,12
3ZG552ORAM5PIPK2H25CDJY7BMRV2V,"The shooting happened at a house in Port St. John, in Brevard County, about 15 miles from NASA's Kennedy Space Center.",4,21,shooting happened,1,0,1
3ZG552ORAM5PIPK2H25CDJY7BMRV2V,"The shooting happened at a house in Port St. John, in Brevard County, about 15 miles from NASA's Kennedy Space Center.",13,21,happened,0,1,1
3ZG552ORAM5PIPK2H25CDJY7BMRV2V,"The shooting happened at a house in Port St. John, in Brevard County, about 15 miles from NASA's Kennedy Space Center.",97,117,Kennedy Space Center,1,0,1
3ZG552ORAM5PIPK2H25CDJY7BMRV2V,"A spokesman for the Brevard County Sheriff's office identified the victims as four children aged 12, 13, 15 and 17.",2,11,spokesman,5,7,12
3ZG552ORAM5PIPK2H25CDJY7BMRV2V,"A spokesman for the Brevard County Sheriff's office identified the victims as four children aged 12, 13, 15 and 17.",20,34,Brevard County,0,1,1
3ZG552ORAM5PIPK2H25CDJY7BMRV2V,"A spokesman for the Brevard County Sheriff's office identified the victims as four children aged 12, 13, 15 and 17.",35,42,Sheriff,1,0,1
3ZG552ORAM5PIPK2H25CDJY7BMRV2V,"A spokesman for the Brevard County Sheriff's office identified the victims as four children aged 12, 13, 15 and 17.",35,50,Sheriffs office,1,0,1
3ZG552ORAM5PIPK2H25CDJY7BMRV2V,"A spokesman for the Brevard County Sheriff's office identified the victims as four children aged 12, 13, 15 and 17.",52,62,identified,6,3,9
3ZG552ORAM5PIPK2H25CDJY7BMRV2V,"A spokesman for the Brevard County Sheriff's office identified the victims as four children aged 12, 13, 15 and 17.",67,74,victims,2,8,10
3ZG552ORAM5PIPK2H25CDJY7BMRV2V,"They were shot by their 33-year-old mother, Tonya Thomas, who then turned the gun on herself, Tod Goodyear said.",67,81,turned the gun,1,0,1
3ZG552ORAM5PIPK2H25CDJY7BMRV2V,"All were shot with what appeared to be a handgun, he said.",24,32,appeared,2,3,5
3ZG552ORAM5PIPK2H25CDJY7BMRV2V,"All were shot with what appeared to be a handgun, he said.",41,48,handgun,0,3,3
3ZG552ORAM5PIPK2H25CDJY7BMRV2V,Goodyear said a neighbor called police before dawn on Tuesday to report gunfire.,16,24,neighbor,2,2,4
3ZG552ORAM5PIPK2H25CDJY7BMRV2V,Goodyear said a neighbor called police before dawn on Tuesday to report gunfire.,46,50,dawn,3,7,10
3ZG552ORAM5PIPK2H25CDJY7BMRV2V,Goodyear said a neighbor called police before dawn on Tuesday to report gunfire.,65,71,report,1,0,1
3ZG552ORAM5PIPK2H25CDJY7BMRV2V,Goodyear said a neighbor called police before dawn on Tuesday to report gunfire.,72,79,gunfire,0,1,1
3ZG552ORAM5PIPK2H25CDJY7BMRV2V,"When police arrived they found a fatally injured 17-year-old girl in the front yard of the house, which is in a quiet neighborhood of single family residences.",33,40,fatally,6,5,11
3ZG552ORAM5PIPK2H25CDJY7BMRV2V,"When police arrived they found a fatally injured 17-year-old girl in the front yard of the house, which is in a quiet neighborhood of single family residences.",33,48,fatally injured,4,5,9
3ZG552ORAM5PIPK2H25CDJY7BMRV2V,"When police arrived they found a fatally injured 17-year-old girl in the front yard of the house, which is in a quiet neighborhood of single family residences.",118,130,neighborhood,2,3,5
3ZG552ORAM5PIPK2H25CDJY7BMRV2V,"When police arrived they found a fatally injured 17-year-old girl in the front yard of the house, which is in a quiet neighborhood of single family residences.",134,158,single family residences,4,0,4
3ZG552ORAM5PIPK2H25CDJY7BMRV2V,"When police arrived they found a fatally injured 17-year-old girl in the front yard of the house, which is in a quiet neighborhood of single family residences.",148,158,residences,6,4,10
31N9JPQXIPJGPAEBYWMSQ6AWDP4NHU,"Spain's government tried to plug a gaping hole in the country's banking system on Friday, but the fourth such attempt to tackle the fallout of a property crash fell short of expectations.",28,32,plug,0,2,2
31N9JPQXIPJGPAEBYWMSQ6AWDP4NHU,"Spain's government tried to plug a gaping hole in the country's banking system on Friday, but the fourth such attempt to tackle the fallout of a property crash fell short of expectations.",28,46,plug a gaping hole,1,1,2
31N9JPQXIPJGPAEBYWMSQ6AWDP4NHU,"Spain's government tried to plug a gaping hole in the country's banking system on Friday, but the fourth such attempt to tackle the fallout of a property crash fell short of expectations.",35,41,gaping,7,5,12
31N9JPQXIPJGPAEBYWMSQ6AWDP4NHU,"Spain's government tried to plug a gaping hole in the country's banking system on Friday, but the fourth such attempt to tackle the fallout of a property crash fell short of expectations.",35,46,gaping hole,2,3,5
31N9JPQXIPJGPAEBYWMSQ6AWDP4NHU,"Spain's government tried to plug a gaping hole in the country's banking system on Friday, but the fourth such attempt to tackle the fallout of a property crash fell short of expectations.",121,127,tackle,4,5,9
31N9JPQXIPJGPAEBYWMSQ6AWDP4NHU,"Spain's government tried to plug a gaping hole in the country's banking system on Friday, but the fourth such attempt to tackle the fallout of a property crash fell short of expectations.",121,139,tackle the fallout,0,1,1
31N9JPQXIPJGPAEBYWMSQ6AWDP4NHU,"Spain's government tried to plug a gaping hole in the country's banking system on Friday, but the fourth such attempt to tackle the fallout of a property crash fell short of expectations.",132,139,fallout,8,4,12
31N9JPQXIPJGPAEBYWMSQ6AWDP4NHU,"Spain's government tried to plug a gaping hole in the country's banking system on Friday, but the fourth such attempt to tackle the fallout of a property crash fell short of expectations.",132,159,fallout of a property crash,0,1,1
31N9JPQXIPJGPAEBYWMSQ6AWDP4NHU,"Spain's government tried to plug a gaping hole in the country's banking system on Friday, but the fourth such attempt to tackle the fallout of a property crash fell short of expectations.",145,153,property,1,0,1
31N9JPQXIPJGPAEBYWMSQ6AWDP4NHU,"Spain's government tried to plug a gaping hole in the country's banking system on Friday, but the fourth such attempt to tackle the fallout of a property crash fell short of expectations.",145,159,property crash,3,0,3
31N9JPQXIPJGPAEBYWMSQ6AWDP4NHU,"Spain's government tried to plug a gaping hole in the country's banking system on Friday, but the fourth such attempt to tackle the fallout of a property crash fell short of expectations.",154,159,crash,0,1,1
31N9JPQXIPJGPAEBYWMSQ6AWDP4NHU,"Spain's government tried to plug a gaping hole in the country's banking system on Friday, but the fourth such attempt to tackle the fallout of a property crash fell short of expectations.",160,164,fell,0,1,1
31N9JPQXIPJGPAEBYWMSQ6AWDP4NHU,"Spain's government tried to plug a gaping hole in the country's banking system on Friday, but the fourth such attempt to tackle the fallout of a property crash fell short of expectations.",160,170,fell short,0,2,2
31N9JPQXIPJGPAEBYWMSQ6AWDP4NHU,"Spain's government tried to plug a gaping hole in the country's banking system on Friday, but the fourth such attempt to tackle the fallout of a property crash fell short of expectations.",174,186,expectations,4,2,6
31N9JPQXIPJGPAEBYWMSQ6AWDP4NHU,"The centre-right government offered high-interest loans to banks on the brink in a crisis which is shaking the euro zone, and ordered an independent audit of lending across the entire banking sector, as the European Union had asked.",4,16,centre-right,3,1,4
31N9JPQXIPJGPAEBYWMSQ6AWDP4NHU,"The centre-right government offered high-interest loans to banks on the brink in a crisis which is shaking the euro zone, and ordered an independent audit of lending across the entire banking sector, as the European Union had asked.",4,27,centre-right government,1,1,2
31N9JPQXIPJGPAEBYWMSQ6AWDP4NHU,"The centre-right government offered high-interest loans to banks on the brink in a crisis which is shaking the euro zone, and ordered an independent audit of lending across the entire banking sector, as the European Union had asked.",28,35,offered,0,1,1
31N9JPQXIPJGPAEBYWMSQ6AWDP4NHU,"The centre-right government offered high-interest loans to banks on the brink in a crisis which is shaking the euro zone, and ordered an independent audit of lending across the entire banking sector, as the European Union had asked.",36,49,high-interest,1,1,2
31N9JPQXIPJGPAEBYWMSQ6AWDP4NHU,"The centre-right government offered high-interest loans to banks on the brink in a crisis which is shaking the euro zone, and ordered an independent audit of lending across the entire banking sector, as the European Union had asked.",36,55,high-interest loans,2,1,3
31N9JPQXIPJGPAEBYWMSQ6AWDP4NHU,"The centre-right government offered high-interest loans to banks on the brink in a crisis which is shaking the euro zone, and ordered an independent audit of lending across the entire banking sector, as the European Union had asked.",72,77,brink,5,4,9
31N9JPQXIPJGPAEBYWMSQ6AWDP4NHU,"The centre-right government offered high-interest loans to banks on the brink in a crisis which is shaking the euro zone, and ordered an independent audit of lending across the entire banking sector, as the European Union had asked.",72,89,brink in a crisis,0,1,1
31N9JPQXIPJGPAEBYWMSQ6AWDP4NHU,"The centre-right government offered high-interest loans to banks on the brink in a crisis which is shaking the euro zone, and ordered an independent audit of lending across the entire banking sector, as the European Union had asked.",83,89,crisis,3,3,6
31N9JPQXIPJGPAEBYWMSQ6AWDP4NHU,"The centre-right government offered high-interest loans to banks on the brink in a crisis which is shaking the euro zone, and ordered an independent audit of lending across the entire banking sector, as the European Union had asked.",99,106,shaking,0,1,1
31N9JPQXIPJGPAEBYWMSQ6AWDP4NHU,"The centre-right government offered high-interest loans to banks on the brink in a crisis which is shaking the euro zone, and ordered an independent audit of lending across the entire banking sector, as the European Union had asked.",111,120,euro zone,1,0,1
31N9JPQXIPJGPAEBYWMSQ6AWDP4NHU,"The centre-right government offered high-interest loans to banks on the brink in a crisis which is shaking the euro zone, and ordered an independent audit of lending across the entire banking sector, as the European Union had asked.",137,148,independent,2,1,3
31N9JPQXIPJGPAEBYWMSQ6AWDP4NHU,"The centre-right government offered high-interest loans to banks on the brink in a crisis which is shaking the euro zone, and ordered an independent audit of lending across the entire banking sector, as the European Union had asked.",137,154,independent audit,2,0,2
31N9JPQXIPJGPAEBYWMSQ6AWDP4NHU,"The centre-right government offered high-interest loans to banks on the brink in a crisis which is shaking the euro zone, and ordered an independent audit of lending across the entire banking sector, as the European Union had asked.",137,165,independent audit of lending,0,1,1
31N9JPQXIPJGPAEBYWMSQ6AWDP4NHU,"The centre-right government offered high-interest loans to banks on the brink in a crisis which is shaking the euro zone, and ordered an independent audit of lending across the entire banking sector, as the European Union had asked.",149,154,audit,5,1,6
31N9JPQXIPJGPAEBYWMSQ6AWDP4NHU,"The centre-right government offered high-interest loans to banks on the brink in a crisis which is shaking the euro zone, and ordered an independent audit of lending across the entire banking sector, as the European Union had asked.",158,165,lending,0,1,1
31N9JPQXIPJGPAEBYWMSQ6AWDP4NHU,"The centre-right government offered high-interest loans to banks on the brink in a crisis which is shaking the euro zone, and ordered an independent audit of lending across the entire banking sector, as the European Union had asked.",184,198,banking sector,1,0,1
31N9JPQXIPJGPAEBYWMSQ6AWDP4NHU,"This is not the definitive clean-up framework that the market is clamoring for, said Nicholas Spiro from Spiro Sovereign Strategy.",17,27,definitive,6,3,9
31N9JPQXIPJGPAEBYWMSQ6AWDP4NHU,"This is not the definitive clean-up framework that the market is clamoring for, said Nicholas Spiro from Spiro Sovereign Strategy.",17,46,definitive clean-up framework,0,2,2
31N9JPQXIPJGPAEBYWMSQ6AWDP4NHU,"This is not the definitive clean-up framework that the market is clamoring for, said Nicholas Spiro from Spiro Sovereign Strategy.",28,46,clean-up framework,1,1,2
31N9JPQXIPJGPAEBYWMSQ6AWDP4NHU,"This is not the definitive clean-up framework that the market is clamoring for, said Nicholas Spiro from Spiro Sovereign Strategy.",37,46,framework,2,5,7
31N9JPQXIPJGPAEBYWMSQ6AWDP4NHU,"This is not the definitive clean-up framework that the market is clamoring for, said Nicholas Spiro from Spiro Sovereign Strategy.",66,75,clamoring,10,7,17
31N9JPQXIPJGPAEBYWMSQ6AWDP4NHU,"This is not the definitive clean-up framework that the market is clamoring for, said Nicholas Spiro from Spiro Sovereign Strategy.",66,79,clamoring for,0,1,1
31N9JPQXIPJGPAEBYWMSQ6AWDP4NHU,"This is not the definitive clean-up framework that the market is clamoring for, said Nicholas Spiro from Spiro Sovereign Strategy.",107,131,Spiro Sovereign Strategy,2,0,2
31N9JPQXIPJGPAEBYWMSQ6AWDP4NHU,"This is not the definitive clean-up framework that the market is clamoring for, said Nicholas Spiro from Spiro Sovereign Strategy.",113,122,Sovereign,1,1,2
31N9JPQXIPJGPAEBYWMSQ6AWDP4NHU,"This is not the definitive clean-up framework that the market is clamoring for, said Nicholas Spiro from Spiro Sovereign Strategy.",113,131,Sovereign Strategy,0,1,1
31N9JPQXIPJGPAEBYWMSQ6AWDP4NHU,"This is not the definitive clean-up framework that the market is clamoring for, said Nicholas Spiro from Spiro Sovereign Strategy.",123,131,Strategy,0,2,2
31N9JPQXIPJGPAEBYWMSQ6AWDP4NHU,"Spanish bank restructuring is a moving target: the deeper the economic downturn, the greater the uncertainty about the size of the sector's provisioning needs.",14,27,restructuring,9,5,14
31N9JPQXIPJGPAEBYWMSQ6AWDP4NHU,"Spanish bank restructuring is a moving target: the deeper the economic downturn, the greater the uncertainty about the size of the sector's provisioning needs.",33,46,moving target,1,0,1
31N9JPQXIPJGPAEBYWMSQ6AWDP4NHU,"Spanish bank restructuring is a moving target: the deeper the economic downturn, the greater the uncertainty about the size of the sector's provisioning needs.",63,71,economic,1,0,1
31N9JPQXIPJGPAEBYWMSQ6AWDP4NHU,"Spanish bank restructuring is a moving target: the deeper the economic downturn, the greater the uncertainty about the size of the sector's provisioning needs.",63,80,economic downturn,5,1,6
31N9JPQXIPJGPAEBYWMSQ6AWDP4NHU,"Spanish bank restructuring is a moving target: the deeper the economic downturn, the greater the uncertainty about the size of the sector's provisioning needs.",72,80,downturn,3,5,8
31N9JPQXIPJGPAEBYWMSQ6AWDP4NHU,"Spanish bank restructuring is a moving target: the deeper the economic downturn, the greater the uncertainty about the size of the sector's provisioning needs.",98,109,uncertainty,2,2,4
31N9JPQXIPJGPAEBYWMSQ6AWDP4NHU,"Spanish bank restructuring is a moving target: the deeper the economic downturn, the greater the uncertainty about the size of the sector's provisioning needs.",132,139,sectors,2,0,2
31N9JPQXIPJGPAEBYWMSQ6AWDP4NHU,"Spanish bank restructuring is a moving target: the deeper the economic downturn, the greater the uncertainty about the size of the sector's provisioning needs.",132,158,sectors provisioning needs,1,0,1
31N9JPQXIPJGPAEBYWMSQ6AWDP4NHU,"Spanish bank restructuring is a moving target: the deeper the economic downturn, the greater the uncertainty about the size of the sector's provisioning needs.",141,153,provisioning,6,4,10
31N9JPQXIPJGPAEBYWMSQ6AWDP4NHU,"Spanish bank restructuring is a moving target: the deeper the economic downturn, the greater the uncertainty about the size of the sector's provisioning needs.",141,159,provisioning needs,1,3,4
31N9JPQXIPJGPAEBYWMSQ6AWDP4NHU,"Spain's troubled banks, with more than 184 billion euros ($238 billion) in problem loans and assets after the property bubble burst four years ago, lie at the core of the euro zone debt crisis due to fears that a massive rescue could push Spanish public finances to breaking point.",75,99,problem loans and assets,1,0,1
31N9JPQXIPJGPAEBYWMSQ6AWDP4NHU,"Spain's troubled banks, with more than 184 billion euros ($238 billion) in problem loans and assets after the property bubble burst four years ago, lie at the core of the euro zone debt crisis due to fears that a massive rescue could push Spanish public finances to breaking point.",93,99,assets,1,1,2
31N9JPQXIPJGPAEBYWMSQ6AWDP4NHU,"Spain's troubled banks, with more than 184 billion euros ($238 billion) in problem loans and assets after the property bubble burst four years ago, lie at the core of the euro zone debt crisis due to fears that a massive rescue could push Spanish public finances to breaking point.",110,125,property bubble,3,1,4
31N9JPQXIPJGPAEBYWMSQ6AWDP4NHU,"Spain's troubled banks, with more than 184 billion euros ($238 billion) in problem loans and assets after the property bubble burst four years ago, lie at the core of the euro zone debt crisis due to fears that a massive rescue could push Spanish public finances to breaking point.",110,131,property bubble burst,2,0,2
31N9JPQXIPJGPAEBYWMSQ6AWDP4NHU,"Spain's troubled banks, with more than 184 billion euros ($238 billion) in problem loans and assets after the property bubble burst four years ago, lie at the core of the euro zone debt crisis due to fears that a massive rescue could push Spanish public finances to breaking point.",119,125,bubble,0,2,2
31N9JPQXIPJGPAEBYWMSQ6AWDP4NHU,"Spain's troubled banks, with more than 184 billion euros ($238 billion) in problem loans and assets after the property bubble burst four years ago, lie at the core of the euro zone debt crisis due to fears that a massive rescue could push Spanish public finances to breaking point.",119,131,bubble burst,2,1,3
31N9JPQXIPJGPAEBYWMSQ6AWDP4NHU,"Spain's troubled banks, with more than 184 billion euros ($238 billion) in problem loans and assets after the property bubble burst four years ago, lie at the core of the euro zone debt crisis due to fears that a massive rescue could push Spanish public finances to breaking point.",126,131,burst,0,2,2
31N9JPQXIPJGPAEBYWMSQ6AWDP4NHU,"Spain's troubled banks, with more than 184 billion euros ($238 billion) in problem loans and assets after the property bubble burst four years ago, lie at the core of the euro zone debt crisis due to fears that a massive rescue could push Spanish public finances to breaking point.",159,163,core,1,0,1
31N9JPQXIPJGPAEBYWMSQ6AWDP4NHU,"Spain's troubled banks, with more than 184 billion euros ($238 billion) in problem loans and assets after the property bubble burst four years ago, lie at the core of the euro zone debt crisis due to fears that a massive rescue could push Spanish public finances to breaking point.",171,185,euro zone debt,1,0,1
31N9JPQXIPJGPAEBYWMSQ6AWDP4NHU,"Spain's troubled banks, with more than 184 billion euros ($238 billion) in problem loans and assets after the property bubble burst four years ago, lie at the core of the euro zone debt crisis due to fears that a massive rescue could push Spanish public finances to breaking point.",171,192,euro zone debt crisis,1,1,2
31N9JPQXIPJGPAEBYWMSQ6AWDP4NHU,"Spain's troubled banks, with more than 184 billion euros ($238 billion) in problem loans and assets after the property bubble burst four years ago, lie at the core of the euro zone debt crisis due to fears that a massive rescue could push Spanish public finances to breaking point.",176,180,zone,0,1,1
31N9JPQXIPJGPAEBYWMSQ6AWDP4NHU,"Spain's troubled banks, with more than 184 billion euros ($238 billion) in problem loans and assets after the property bubble burst four years ago, lie at the core of the euro zone debt crisis due to fears that a massive rescue could push Spanish public finances to breaking point.",181,192,debt crisis,3,0,3
31N9JPQXIPJGPAEBYWMSQ6AWDP4NHU,"Spain's troubled banks, with more than 184 billion euros ($238 billion) in problem loans and assets after the property bubble burst four years ago, lie at the core of the euro zone debt crisis due to fears that a massive rescue could push Spanish public finances to breaking point.",186,192,crisis,1,0,1
31N9JPQXIPJGPAEBYWMSQ6AWDP4NHU,"Spain's troubled banks, with more than 184 billion euros ($238 billion) in problem loans and assets after the property bubble burst four years ago, lie at the core of the euro zone debt crisis due to fears that a massive rescue could push Spanish public finances to breaking point.",213,220,massive,1,0,1
31N9JPQXIPJGPAEBYWMSQ6AWDP4NHU,"Spain's troubled banks, with more than 184 billion euros ($238 billion) in problem loans and assets after the property bubble burst four years ago, lie at the core of the euro zone debt crisis due to fears that a massive rescue could push Spanish public finances to breaking point.",213,227,massive rescue,0,1,1
31N9JPQXIPJGPAEBYWMSQ6AWDP4NHU,"Spain's troubled banks, with more than 184 billion euros ($238 billion) in problem loans and assets after the property bubble burst four years ago, lie at the core of the euro zone debt crisis due to fears that a massive rescue could push Spanish public finances to breaking point.",221,227,rescue,0,2,2
31N9JPQXIPJGPAEBYWMSQ6AWDP4NHU,"Spain's troubled banks, with more than 184 billion euros ($238 billion) in problem loans and assets after the property bubble burst four years ago, lie at the core of the euro zone debt crisis due to fears that a massive rescue could push Spanish public finances to breaking point.",254,262,finances,1,0,1
31N9JPQXIPJGPAEBYWMSQ6AWDP4NHU,"Spain's troubled banks, with more than 184 billion euros ($238 billion) in problem loans and assets after the property bubble burst four years ago, lie at the core of the euro zone debt crisis due to fears that a massive rescue could push Spanish public finances to breaking point.",266,280,breaking point,0,1,1
31ODACBENUGQIG5JPIQ8YEC3RB8SQ7,"Meanwhile, the army has raided a Sunni village north of Hama, killing five people, the Observatory said.",0,9,Meanwhile,0,1,1
31ODACBENUGQIG5JPIQ8YEC3RB8SQ7,"Meanwhile, the army has raided a Sunni village north of Hama, killing five people, the Observatory said.",24,30,raided,4,6,10
31ODACBENUGQIG5JPIQ8YEC3RB8SQ7,"Meanwhile, the army has raided a Sunni village north of Hama, killing five people, the Observatory said.",33,38,Sunni,1,1,2
31ODACBENUGQIG5JPIQ8YEC3RB8SQ7,"Meanwhile, the army has raided a Sunni village north of Hama, killing five people, the Observatory said.",87,98,Observatory,2,7,9
31ODACBENUGQIG5JPIQ8YEC3RB8SQ7,Activists said at least 30 people died on Sunday - mainly civilians - as violence surged at flashpoints across the country despite an increase of UN observers.,0,9,Activists,7,6,13
31ODACBENUGQIG5JPIQ8YEC3RB8SQ7,Activists said at least 30 people died on Sunday - mainly civilians - as violence surged at flashpoints across the country despite an increase of UN observers.,58,67,civilians,3,2,5
31ODACBENUGQIG5JPIQ8YEC3RB8SQ7,Activists said at least 30 people died on Sunday - mainly civilians - as violence surged at flashpoints across the country despite an increase of UN observers.,73,88,violence surged,0,3,3
31ODACBENUGQIG5JPIQ8YEC3RB8SQ7,Activists said at least 30 people died on Sunday - mainly civilians - as violence surged at flashpoints across the country despite an increase of UN observers.,73,103,violence surged at flashpoints,1,0,1
31ODACBENUGQIG5JPIQ8YEC3RB8SQ7,Activists said at least 30 people died on Sunday - mainly civilians - as violence surged at flashpoints across the country despite an increase of UN observers.,82,88,surged,6,9,15
31ODACBENUGQIG5JPIQ8YEC3RB8SQ7,Activists said at least 30 people died on Sunday - mainly civilians - as violence surged at flashpoints across the country despite an increase of UN observers.,92,103,flashpoints,10,10,20
31ODACBENUGQIG5JPIQ8YEC3RB8SQ7,Activists said at least 30 people died on Sunday - mainly civilians - as violence surged at flashpoints across the country despite an increase of UN observers.,123,130,despite,1,4,5
31ODACBENUGQIG5JPIQ8YEC3RB8SQ7,Activists said at least 30 people died on Sunday - mainly civilians - as violence surged at flashpoints across the country despite an increase of UN observers.,146,158,UN observers,1,1,2
31ODACBENUGQIG5JPIQ8YEC3RB8SQ7,Activists said at least 30 people died on Sunday - mainly civilians - as violence surged at flashpoints across the country despite an increase of UN observers.,149,158,observers,0,1,1
31ODACBENUGQIG5JPIQ8YEC3RB8SQ7,"The figures cannot be verified independently, as journalists' movements are severely restricted in Syria.",22,30,verified,4,1,5
31ODACBENUGQIG5JPIQ8YEC3RB8SQ7,"The figures cannot be verified independently, as journalists' movements are severely restricted in Syria.",22,44,verified independently,2,3,5
31ODACBENUGQIG5JPIQ8YEC3RB8SQ7,"The figures cannot be verified independently, as journalists' movements are severely restricted in Syria.",31,44,independently,3,0,3
31ODACBENUGQIG5JPIQ8YEC3RB8SQ7,"The figures cannot be verified independently, as journalists' movements are severely restricted in Syria.",49,60,journalists,2,0,2
31ODACBENUGQIG5JPIQ8YEC3RB8SQ7,"The figures cannot be verified independently, as journalists' movements are severely restricted in Syria.",62,71,movements,1,0,1
31ODACBENUGQIG5JPIQ8YEC3RB8SQ7,"The figures cannot be verified independently, as journalists' movements are severely restricted in Syria.",76,84,severely,2,1,3
31ODACBENUGQIG5JPIQ8YEC3RB8SQ7,"The figures cannot be verified independently, as journalists' movements are severely restricted in Syria.",76,95,severely restricted,3,2,5
31ODACBENUGQIG5JPIQ8YEC3RB8SQ7,"The figures cannot be verified independently, as journalists' movements are severely restricted in Syria.",85,95,restricted,4,2,6
31ODACBENUGQIG5JPIQ8YEC3RB8SQ7,The Spanish government is expected to announce plans to clean up its banking system on Friday.,26,34,expected,0,2,2
31ODACBENUGQIG5JPIQ8YEC3RB8SQ7,The Spanish government is expected to announce plans to clean up its banking system on Friday.,38,46,announce,0,3,3
31ODACBENUGQIG5JPIQ8YEC3RB8SQ7,The Spanish government is expected to announce plans to clean up its banking system on Friday.,56,64,clean up,0,1,1
31ODACBENUGQIG5JPIQ8YEC3RB8SQ7,The Spanish government is expected to announce plans to clean up its banking system on Friday.,69,83,banking system,1,0,1
31ODACBENUGQIG5JPIQ8YEC3RB8SQ7,"It is likely to force the banks to set aside extra money, in the region of 30bn euros ($39bn; £24bn), to cover the cost of loans going bad.",35,44,set aside,0,3,3
31ODACBENUGQIG5JPIQ8YEC3RB8SQ7,"It is likely to force the banks to set aside extra money, in the region of 30bn euros ($39bn; £24bn), to cover the cost of loans going bad.",39,44,aside,0,3,3
31ODACBENUGQIG5JPIQ8YEC3RB8SQ7,"It is likely to force the banks to set aside extra money, in the region of 30bn euros ($39bn; £24bn), to cover the cost of loans going bad.",65,71,region,1,0,1
31ODACBENUGQIG5JPIQ8YEC3RB8SQ7,"It is likely to force the banks to set aside extra money, in the region of 30bn euros ($39bn; £24bn), to cover the cost of loans going bad.",123,138,loans going bad,2,0,2
31ODACBENUGQIG5JPIQ8YEC3RB8SQ7,The weekly cabinet meeting is also expected to approve a plan to force banks to put bad property loans into separate companies.,11,18,cabinet,5,1,6
31ODACBENUGQIG5JPIQ8YEC3RB8SQ7,The weekly cabinet meeting is also expected to approve a plan to force banks to put bad property loans into separate companies.,11,26,cabinet meeting,1,5,6
31ODACBENUGQIG5JPIQ8YEC3RB8SQ7,The weekly cabinet meeting is also expected to approve a plan to force banks to put bad property loans into separate companies.,35,43,expected,0,2,2
31ODACBENUGQIG5JPIQ8YEC3RB8SQ7,The weekly cabinet meeting is also expected to approve a plan to force banks to put bad property loans into separate companies.,47,54,approve,1,0,1
31ODACBENUGQIG5JPIQ8YEC3RB8SQ7,The weekly cabinet meeting is also expected to approve a plan to force banks to put bad property loans into separate companies.,84,102,bad property loans,3,2,5
31ODACBENUGQIG5JPIQ8YEC3RB8SQ7,The weekly cabinet meeting is also expected to approve a plan to force banks to put bad property loans into separate companies.,88,96,property,0,1,1
31ODACBENUGQIG5JPIQ8YEC3RB8SQ7,The weekly cabinet meeting is also expected to approve a plan to force banks to put bad property loans into separate companies.,88,102,property loans,1,0,1
31ODACBENUGQIG5JPIQ8YEC3RB8SQ7,The weekly cabinet meeting is also expected to approve a plan to force banks to put bad property loans into separate companies.,108,116,separate,1,0,1
3LOJFQ4BOXGY5OO6FNBM7TEUSF9KD7,"The acquisition, announced last year, had already received approvals in Europe, the U.S. and other jurisdictions worldwide.",4,15,acquisition,10,10,20
3LOJFQ4BOXGY5OO6FNBM7TEUSF9KD7,"The acquisition, announced last year, had already received approvals in Europe, the U.S. and other jurisdictions worldwide.",17,26,announced,2,1,3
3LOJFQ4BOXGY5OO6FNBM7TEUSF9KD7,"The acquisition, announced last year, had already received approvals in Europe, the U.S. and other jurisdictions worldwide.",50,69,received  approvals,1,0,1
3LOJFQ4BOXGY5OO6FNBM7TEUSF9KD7,"The acquisition, announced last year, had already received approvals in Europe, the U.S. and other jurisdictions worldwide.",59,68,approvals,0,1,1
3LOJFQ4BOXGY5OO6FNBM7TEUSF9KD7,"The acquisition, announced last year, had already received approvals in Europe, the U.S. and other jurisdictions worldwide.",93,122,other jurisdictions worldwide,1,0,1
3LOJFQ4BOXGY5OO6FNBM7TEUSF9KD7,"The acquisition, announced last year, had already received approvals in Europe, the U.S. and other jurisdictions worldwide.",99,112,jurisdictions,10,10,20
3LOJFQ4BOXGY5OO6FNBM7TEUSF9KD7,"The acquisition, announced last year, had already received approvals in Europe, the U.S. and other jurisdictions worldwide.",99,122,jurisdictions worldwide,1,1,2
3LOJFQ4BOXGY5OO6FNBM7TEUSF9KD7,"Libertyville, Illinois-based Motorola Mobility had said in a regulatory filing in February that only Chinese clearance was still required.",0,12,Libertyville,0,2,2
3LOJFQ4BOXGY5OO6FNBM7TEUSF9KD7,"Libertyville, Illinois-based Motorola Mobility had said in a regulatory filing in February that only Chinese clearance was still required.",14,28,Illinois-based,0,2,2
3LOJFQ4BOXGY5OO6FNBM7TEUSF9KD7,"Libertyville, Illinois-based Motorola Mobility had said in a regulatory filing in February that only Chinese clearance was still required.",38,46,Mobility,1,0,1
3LOJFQ4BOXGY5OO6FNBM7TEUSF9KD7,"Libertyville, Illinois-based Motorola Mobility had said in a regulatory filing in February that only Chinese clearance was still required.",59,79,a  regulatory filing,1,0,1
3LOJFQ4BOXGY5OO6FNBM7TEUSF9KD7,"Libertyville, Illinois-based Motorola Mobility had said in a regulatory filing in February that only Chinese clearance was still required.",61,71,regulatory,3,1,4
3LOJFQ4BOXGY5OO6FNBM7TEUSF9KD7,"Libertyville, Illinois-based Motorola Mobility had said in a regulatory filing in February that only Chinese clearance was still required.",61,78,regulatory filing,5,3,8
3LOJFQ4BOXGY5OO6FNBM7TEUSF9KD7,"Libertyville, Illinois-based Motorola Mobility had said in a regulatory filing in February that only Chinese clearance was still required.",72,78,filing,0,3,3
3LOJFQ4BOXGY5OO6FNBM7TEUSF9KD7,"Libertyville, Illinois-based Motorola Mobility had said in a regulatory filing in February that only Chinese clearance was still required.",109,118,clearance,5,5,10
3LOJFQ4BOXGY5OO6FNBM7TEUSF9KD7,"Libertyville, Illinois-based Motorola Mobility had said in a regulatory filing in February that only Chinese clearance was still required.",129,137,required,0,1,1
3LOJFQ4BOXGY5OO6FNBM7TEUSF9KD7,"“Our stance since we agreed to acquire Motorola has not changed and we look forward to closing the deal,” Mountain View, California-based Google said in an e-mailed statement yesterday.",5,11,stance,6,6,12
3LOJFQ4BOXGY5OO6FNBM7TEUSF9KD7,"“Our stance since we agreed to acquire Motorola has not changed and we look forward to closing the deal,” Mountain View, California-based Google said in an e-mailed statement yesterday.",31,38,acquire,3,5,8
3LOJFQ4BOXGY5OO6FNBM7TEUSF9KD7,"“Our stance since we agreed to acquire Motorola has not changed and we look forward to closing the deal,” Mountain View, California-based Google said in an e-mailed statement yesterday.",87,103,closing the deal,1,0,1
3LOJFQ4BOXGY5OO6FNBM7TEUSF9KD7,"“Our stance since we agreed to acquire Motorola has not changed and we look forward to closing the deal,” Mountain View, California-based Google said in an e-mailed statement yesterday.",121,137,California-based,0,1,1
3LOJFQ4BOXGY5OO6FNBM7TEUSF9KD7,The company also confirmed it had received word from Chinese authorities of the purchase being approved.,17,26,confirmed,0,3,3
3LOJFQ4BOXGY5OO6FNBM7TEUSF9KD7,The company also confirmed it had received word from Chinese authorities of the purchase being approved.,61,72,authorities,2,0,2
3LOJFQ4BOXGY5OO6FNBM7TEUSF9KD7,The company also confirmed it had received word from Chinese authorities of the purchase being approved.,80,88,purchase,0,2,2
3LOJFQ4BOXGY5OO6FNBM7TEUSF9KD7,"With the acquisition -- the largest wireless-equipment deal in at least a decade, according to data compiled by Bloomberg -- Google becomes a competitor to the other handset makers that make Android devices.",9,20,acquisition,7,3,10
3LOJFQ4BOXGY5OO6FNBM7TEUSF9KD7,"With the acquisition -- the largest wireless-equipment deal in at least a decade, according to data compiled by Bloomberg -- Google becomes a competitor to the other handset makers that make Android devices.",36,54,wireless-equipment,5,3,8
3LOJFQ4BOXGY5OO6FNBM7TEUSF9KD7,"With the acquisition -- the largest wireless-equipment deal in at least a decade, according to data compiled by Bloomberg -- Google becomes a competitor to the other handset makers that make Android devices.",36,59,wireless-equipment deal,1,0,1
3LOJFQ4BOXGY5OO6FNBM7TEUSF9KD7,"With the acquisition -- the largest wireless-equipment deal in at least a decade, according to data compiled by Bloomberg -- Google becomes a competitor to the other handset makers that make Android devices.",74,80,decade,2,3,5
3LOJFQ4BOXGY5OO6FNBM7TEUSF9KD7,"With the acquisition -- the largest wireless-equipment deal in at least a decade, according to data compiled by Bloomberg -- Google becomes a competitor to the other handset makers that make Android devices.",95,99,data,1,0,1
3LOJFQ4BOXGY5OO6FNBM7TEUSF9KD7,"With the acquisition -- the largest wireless-equipment deal in at least a decade, according to data compiled by Bloomberg -- Google becomes a competitor to the other handset makers that make Android devices.",100,108,compiled,6,10,16
3LOJFQ4BOXGY5OO6FNBM7TEUSF9KD7,"With the acquisition -- the largest wireless-equipment deal in at least a decade, according to data compiled by Bloomberg -- Google becomes a competitor to the other handset makers that make Android devices.",142,152,competitor,1,2,3
3LOJFQ4BOXGY5OO6FNBM7TEUSF9KD7,"With the acquisition -- the largest wireless-equipment deal in at least a decade, according to data compiled by Bloomberg -- Google becomes a competitor to the other handset makers that make Android devices.",166,173,handset,2,3,5
3LOJFQ4BOXGY5OO6FNBM7TEUSF9KD7,"With the acquisition -- the largest wireless-equipment deal in at least a decade, according to data compiled by Bloomberg -- Google becomes a competitor to the other handset makers that make Android devices.",166,180,handset makers,1,0,1
3LOJFQ4BOXGY5OO6FNBM7TEUSF9KD7,"With the acquisition -- the largest wireless-equipment deal in at least a decade, according to data compiled by Bloomberg -- Google becomes a competitor to the other handset makers that make Android devices.",199,206,devices,0,1,1
3LOJFQ4BOXGY5OO6FNBM7TEUSF9KD7,"In addition to Motorola Mobility phones, the software runs handsets made by companies such as Samsung Electronics Co. (005930) and HTC Corp. (2498) As part of the approval, Google needs to ensure that Android software versions are free and open over the next five years, China’s Ministry of Commerce said in a statement on its website.",24,32,Mobility,1,0,1
3LOJFQ4BOXGY5OO6FNBM7TEUSF9KD7,"In addition to Motorola Mobility phones, the software runs handsets made by companies such as Samsung Electronics Co. (005930) and HTC Corp. (2498) As part of the approval, Google needs to ensure that Android software versions are free and open over the next five years, China’s Ministry of Commerce said in a statement on its website.",45,53,software,0,1,1
3LOJFQ4BOXGY5OO6FNBM7TEUSF9KD7,"In addition to Motorola Mobility phones, the software runs handsets made by companies such as Samsung Electronics Co. (005930) and HTC Corp. (2498) As part of the approval, Google needs to ensure that Android software versions are free and open over the next five years, China’s Ministry of Commerce said in a statement on its website.",59,67,handsets,1,2,3
3LOJFQ4BOXGY5OO6FNBM7TEUSF9KD7,"In addition to Motorola Mobility phones, the software runs handsets made by companies such as Samsung Electronics Co. (005930) and HTC Corp. (2498) As part of the approval, Google needs to ensure that Android software versions are free and open over the next five years, China’s Ministry of Commerce said in a statement on its website.",163,171,approval,0,1,1
3LOJFQ4BOXGY5OO6FNBM7TEUSF9KD7,"In addition to Motorola Mobility phones, the software runs handsets made by companies such as Samsung Electronics Co. (005930) and HTC Corp. (2498) As part of the approval, Google needs to ensure that Android software versions are free and open over the next five years, China’s Ministry of Commerce said in a statement on its website.",189,195,ensure,3,2,5
3LOJFQ4BOXGY5OO6FNBM7TEUSF9KD7,"In addition to Motorola Mobility phones, the software runs handsets made by companies such as Samsung Electronics Co. (005930) and HTC Corp. (2498) As part of the approval, Google needs to ensure that Android software versions are free and open over the next five years, China’s Ministry of Commerce said in a statement on its website.",201,208,Android,0,1,1
3LOJFQ4BOXGY5OO6FNBM7TEUSF9KD7,"In addition to Motorola Mobility phones, the software runs handsets made by companies such as Samsung Electronics Co. (005930) and HTC Corp. (2498) As part of the approval, Google needs to ensure that Android software versions are free and open over the next five years, China’s Ministry of Commerce said in a statement on its website.",209,235,software versions are free,1,0,1
3LOJFQ4BOXGY5OO6FNBM7TEUSF9KD7,"In addition to Motorola Mobility phones, the software runs handsets made by companies such as Samsung Electronics Co. (005930) and HTC Corp. (2498) As part of the approval, Google needs to ensure that Android software versions are free and open over the next five years, China’s Ministry of Commerce said in a statement on its website.",218,226,versions,1,3,4
3LOJFQ4BOXGY5OO6FNBM7TEUSF9KD7,"In addition to Motorola Mobility phones, the software runs handsets made by companies such as Samsung Electronics Co. (005930) and HTC Corp. (2498) As part of the approval, Google needs to ensure that Android software versions are free and open over the next five years, China’s Ministry of Commerce said in a statement on its website.",231,244,free and open,2,0,2
3LOJFQ4BOXGY5OO6FNBM7TEUSF9KD7,"In addition to Motorola Mobility phones, the software runs handsets made by companies such as Samsung Electronics Co. (005930) and HTC Corp. (2498) As part of the approval, Google needs to ensure that Android software versions are free and open over the next five years, China’s Ministry of Commerce said in a statement on its website.",279,299,Ministry of Commerce,1,0,1
3LOJFQ4BOXGY5OO6FNBM7TEUSF9KD7,"In addition to Motorola Mobility phones, the software runs handsets made by companies such as Samsung Electronics Co. (005930) and HTC Corp. (2498) As part of the approval, Google needs to ensure that Android software versions are free and open over the next five years, China’s Ministry of Commerce said in a statement on its website.",291,299,Commerce,2,0,2
3LOJFQ4BOXGY5OO6FNBM7TEUSF9KD7,"In addition to Motorola Mobility phones, the software runs handsets made by companies such as Samsung Electronics Co. (005930) and HTC Corp. (2498) As part of the approval, Google needs to ensure that Android software versions are free and open over the next five years, China’s Ministry of Commerce said in a statement on its website.",310,319,statement,0,1,1
3X878VYTIEJ78TVINZH3ROCTX71F7G,"Mr Obama's address, during an unannounced visit to sign a strategic partnership agreement with President Hamid Karzai that sets the terms for relations after the departure of US troops in 2014, was a chance for him to make an election-year case that he is winding down a costly and increasingly unpopular war.''",30,41,unannounced,5,2,7
3X878VYTIEJ78TVINZH3ROCTX71F7G,"Mr Obama's address, during an unannounced visit to sign a strategic partnership agreement with President Hamid Karzai that sets the terms for relations after the departure of US troops in 2014, was a chance for him to make an election-year case that he is winding down a costly and increasingly unpopular war.''",30,47,unannounced visit,0,1,1
3X878VYTIEJ78TVINZH3ROCTX71F7G,"Mr Obama's address, during an unannounced visit to sign a strategic partnership agreement with President Hamid Karzai that sets the terms for relations after the departure of US troops in 2014, was a chance for him to make an election-year case that he is winding down a costly and increasingly unpopular war.''",58,67,strategic,3,2,5
3X878VYTIEJ78TVINZH3ROCTX71F7G,"Mr Obama's address, during an unannounced visit to sign a strategic partnership agreement with President Hamid Karzai that sets the terms for relations after the departure of US troops in 2014, was a chance for him to make an election-year case that he is winding down a costly and increasingly unpopular war.''",58,79,strategic partnership,1,1,2
3X878VYTIEJ78TVINZH3ROCTX71F7G,"Mr Obama's address, during an unannounced visit to sign a strategic partnership agreement with President Hamid Karzai that sets the terms for relations after the departure of US troops in 2014, was a chance for him to make an election-year case that he is winding down a costly and increasingly unpopular war.''",58,89,strategic partnership agreement,6,2,8
3X878VYTIEJ78TVINZH3ROCTX71F7G,"Mr Obama's address, during an unannounced visit to sign a strategic partnership agreement with President Hamid Karzai that sets the terms for relations after the departure of US troops in 2014, was a chance for him to make an election-year case that he is winding down a costly and increasingly unpopular war.''",132,137,terms,1,0,1
3X878VYTIEJ78TVINZH3ROCTX71F7G,"Mr Obama's address, during an unannounced visit to sign a strategic partnership agreement with President Hamid Karzai that sets the terms for relations after the departure of US troops in 2014, was a chance for him to make an election-year case that he is winding down a costly and increasingly unpopular war.''",132,151,terms for relations,0,1,1
3X878VYTIEJ78TVINZH3ROCTX71F7G,"Mr Obama's address, during an unannounced visit to sign a strategic partnership agreement with President Hamid Karzai that sets the terms for relations after the departure of US troops in 2014, was a chance for him to make an election-year case that he is winding down a costly and increasingly unpopular war.''",142,151,relations,1,1,2
3X878VYTIEJ78TVINZH3ROCTX71F7G,"Mr Obama's address, during an unannounced visit to sign a strategic partnership agreement with President Hamid Karzai that sets the terms for relations after the departure of US troops in 2014, was a chance for him to make an election-year case that he is winding down a costly and increasingly unpopular war.''",162,171,departure,4,5,9
3X878VYTIEJ78TVINZH3ROCTX71F7G,"Mr Obama's address, during an unannounced visit to sign a strategic partnership agreement with President Hamid Karzai that sets the terms for relations after the departure of US troops in 2014, was a chance for him to make an election-year case that he is winding down a costly and increasingly unpopular war.''",226,239,election-year,1,0,1
3X878VYTIEJ78TVINZH3ROCTX71F7G,"Mr Obama's address, during an unannounced visit to sign a strategic partnership agreement with President Hamid Karzai that sets the terms for relations after the departure of US troops in 2014, was a chance for him to make an election-year case that he is winding down a costly and increasingly unpopular war.''",256,263,winding,1,2,3
3X878VYTIEJ78TVINZH3ROCTX71F7G,"Mr Obama's address, during an unannounced visit to sign a strategic partnership agreement with President Hamid Karzai that sets the terms for relations after the departure of US troops in 2014, was a chance for him to make an election-year case that he is winding down a costly and increasingly unpopular war.''",256,268,winding down,6,6,12
3X878VYTIEJ78TVINZH3ROCTX71F7G,"Mr Obama's address, during an unannounced visit to sign a strategic partnership agreement with President Hamid Karzai that sets the terms for relations after the departure of US troops in 2014, was a chance for him to make an election-year case that he is winding down a costly and increasingly unpopular war.''",271,277,costly,1,1,2
3X878VYTIEJ78TVINZH3ROCTX71F7G,"Mr Obama's address, during an unannounced visit to sign a strategic partnership agreement with President Hamid Karzai that sets the terms for relations after the departure of US troops in 2014, was a chance for him to make an election-year case that he is winding down a costly and increasingly unpopular war.''",282,294,increasingly,1,0,1
3X878VYTIEJ78TVINZH3ROCTX71F7G,"Mr Obama's address, during an unannounced visit to sign a strategic partnership agreement with President Hamid Karzai that sets the terms for relations after the departure of US troops in 2014, was a chance for him to make an election-year case that he is winding down a costly and increasingly unpopular war.''",295,304,unpopular,2,0,2
3X878VYTIEJ78TVINZH3ROCTX71F7G,"Mr Obama's address, during an unannounced visit to sign a strategic partnership agreement with President Hamid Karzai that sets the terms for relations after the departure of US troops in 2014, was a chance for him to make an election-year case that he is winding down a costly and increasingly unpopular war.''",295,308,unpopular war,0,1,1
3X878VYTIEJ78TVINZH3ROCTX71F7G,"My fellow Americans,'' he said, speaking against a backdrop of armoured military vehicles and a US flag, ''we've travelled through more than a decade under the dark cloud of war.",3,9,fellow,0,1,1
3X878VYTIEJ78TVINZH3ROCTX71F7G,"My fellow Americans,'' he said, speaking against a backdrop of armoured military vehicles and a US flag, ''we've travelled through more than a decade under the dark cloud of war.",51,59,backdrop,6,1,7
3X878VYTIEJ78TVINZH3ROCTX71F7G,"My fellow Americans,'' he said, speaking against a backdrop of armoured military vehicles and a US flag, ''we've travelled through more than a decade under the dark cloud of war.",63,71,armoured,10,2,12
3X878VYTIEJ78TVINZH3ROCTX71F7G,"My fellow Americans,'' he said, speaking against a backdrop of armoured military vehicles and a US flag, ''we've travelled through more than a decade under the dark cloud of war.",63,89,armoured military vehicles,2,0,2
3X878VYTIEJ78TVINZH3ROCTX71F7G,"My fellow Americans,'' he said, speaking against a backdrop of armoured military vehicles and a US flag, ''we've travelled through more than a decade under the dark cloud of war.",72,89,military vehicles,1,0,1
3X878VYTIEJ78TVINZH3ROCTX71F7G,"My fellow Americans,'' he said, speaking against a backdrop of armoured military vehicles and a US flag, ''we've travelled through more than a decade under the dark cloud of war.",113,122,travelled,1,0,1
3X878VYTIEJ78TVINZH3ROCTX71F7G,"My fellow Americans,'' he said, speaking against a backdrop of armoured military vehicles and a US flag, ''we've travelled through more than a decade under the dark cloud of war.",143,149,decade,1,4,5
3X878VYTIEJ78TVINZH3ROCTX71F7G,"My fellow Americans,'' he said, speaking against a backdrop of armoured military vehicles and a US flag, ''we've travelled through more than a decade under the dark cloud of war.",160,177,dark cloud of war,3,0,3
3X878VYTIEJ78TVINZH3ROCTX71F7G,"My fellow Americans,'' he said, speaking against a backdrop of armoured military vehicles and a US flag, ''we've travelled through more than a decade under the dark cloud of war.",160,170,dark cloud,0,1,1
3X878VYTIEJ78TVINZH3ROCTX71F7G,"Yet here, in the pre-dawn darkness of Afghanistan, we can see the light of new day on the horizon.''",17,25,pre-dawn,5,3,8
3X878VYTIEJ78TVINZH3ROCTX71F7G,"Yet here, in the pre-dawn darkness of Afghanistan, we can see the light of new day on the horizon.''",17,34,pre-dawn darkness,2,1,3
3X878VYTIEJ78TVINZH3ROCTX71F7G,"Yet here, in the pre-dawn darkness of Afghanistan, we can see the light of new day on the horizon.''",26,34,darkness,0,1,1
3X878VYTIEJ78TVINZH3ROCTX71F7G,"Yet here, in the pre-dawn darkness of Afghanistan, we can see the light of new day on the horizon.''",90,97,horizon,3,4,7
3X878VYTIEJ78TVINZH3ROCTX71F7G,"His speech came as an already difficult relationship with Mr Karzai has been strained by recent events, including the release of photos showing US soldiers posing with the remains of Taliban insurgents and a US staff sergeant who has been charged in the killing of 16 Afghan civilians.",40,52,relationship,1,0,1
3X878VYTIEJ78TVINZH3ROCTX71F7G,"His speech came as an already difficult relationship with Mr Karzai has been strained by recent events, including the release of photos showing US soldiers posing with the remains of Taliban insurgents and a US staff sergeant who has been charged in the killing of 16 Afghan civilians.",77,85,strained,9,1,10
3X878VYTIEJ78TVINZH3ROCTX71F7G,"His speech came as an already difficult relationship with Mr Karzai has been strained by recent events, including the release of photos showing US soldiers posing with the remains of Taliban insurgents and a US staff sergeant who has been charged in the killing of 16 Afghan civilians.",77,102,strained by recent events,1,0,1
3X878VYTIEJ78TVINZH3ROCTX71F7G,"His speech came as an already difficult relationship with Mr Karzai has been strained by recent events, including the release of photos showing US soldiers posing with the remains of Taliban insurgents and a US staff sergeant who has been charged in the killing of 16 Afghan civilians.",156,162,posing,0,2,2
3X878VYTIEJ78TVINZH3ROCTX71F7G,"His speech came as an already difficult relationship with Mr Karzai has been strained by recent events, including the release of photos showing US soldiers posing with the remains of Taliban insurgents and a US staff sergeant who has been charged in the killing of 16 Afghan civilians.",172,179,remains,1,1,2
3X878VYTIEJ78TVINZH3ROCTX71F7G,"His speech came as an already difficult relationship with Mr Karzai has been strained by recent events, including the release of photos showing US soldiers posing with the remains of Taliban insurgents and a US staff sergeant who has been charged in the killing of 16 Afghan civilians.",183,201,Taliban insurgents,1,0,1
3X878VYTIEJ78TVINZH3ROCTX71F7G,"His speech came as an already difficult relationship with Mr Karzai has been strained by recent events, including the release of photos showing US soldiers posing with the remains of Taliban insurgents and a US staff sergeant who has been charged in the killing of 16 Afghan civilians.",183,190,Taliban,1,0,1
3X878VYTIEJ78TVINZH3ROCTX71F7G,"His speech came as an already difficult relationship with Mr Karzai has been strained by recent events, including the release of photos showing US soldiers posing with the remains of Taliban insurgents and a US staff sergeant who has been charged in the killing of 16 Afghan civilians.",191,201,insurgents,10,1,11
3X878VYTIEJ78TVINZH3ROCTX71F7G,"His speech came as an already difficult relationship with Mr Karzai has been strained by recent events, including the release of photos showing US soldiers posing with the remains of Taliban insurgents and a US staff sergeant who has been charged in the killing of 16 Afghan civilians.",211,225,staff sergeant,1,1,2
3X878VYTIEJ78TVINZH3ROCTX71F7G,"His speech came as an already difficult relationship with Mr Karzai has been strained by recent events, including the release of photos showing US soldiers posing with the remains of Taliban insurgents and a US staff sergeant who has been charged in the killing of 16 Afghan civilians.",217,225,sergeant,3,0,3
3X878VYTIEJ78TVINZH3ROCTX71F7G,"His speech came as an already difficult relationship with Mr Karzai has been strained by recent events, including the release of photos showing US soldiers posing with the remains of Taliban insurgents and a US staff sergeant who has been charged in the killing of 16 Afghan civilians.",268,284,Afghan civilians,1,0,1
3X878VYTIEJ78TVINZH3ROCTX71F7G,"His speech came as an already difficult relationship with Mr Karzai has been strained by recent events, including the release of photos showing US soldiers posing with the remains of Taliban insurgents and a US staff sergeant who has been charged in the killing of 16 Afghan civilians.",275,284,civilians,1,1,2
3OREP8RUT2C0O5U3B0Z1EBY1H0DBGU,"Rajoy said this week the banking intervention would not affect the annual public deficit, which has vowed to slash from 8.5 percent of economic output last year to 5.3 percent this year and 3.0 percent in 2013.",25,45,banking intervention,6,2,8
3OREP8RUT2C0O5U3B0Z1EBY1H0DBGU,"Rajoy said this week the banking intervention would not affect the annual public deficit, which has vowed to slash from 8.5 percent of economic output last year to 5.3 percent this year and 3.0 percent in 2013.",33,45,intervention,6,10,16
3OREP8RUT2C0O5U3B0Z1EBY1H0DBGU,"Rajoy said this week the banking intervention would not affect the annual public deficit, which has vowed to slash from 8.5 percent of economic output last year to 5.3 percent this year and 3.0 percent in 2013.",67,88,annual public deficit,4,2,6
3OREP8RUT2C0O5U3B0Z1EBY1H0DBGU,"Rajoy said this week the banking intervention would not affect the annual public deficit, which has vowed to slash from 8.5 percent of economic output last year to 5.3 percent this year and 3.0 percent in 2013.",74,88,public deficit,2,1,3
3OREP8RUT2C0O5U3B0Z1EBY1H0DBGU,"Rajoy said this week the banking intervention would not affect the annual public deficit, which has vowed to slash from 8.5 percent of economic output last year to 5.3 percent this year and 3.0 percent in 2013.",81,88,deficit,4,6,10
3OREP8RUT2C0O5U3B0Z1EBY1H0DBGU,"Rajoy said this week the banking intervention would not affect the annual public deficit, which has vowed to slash from 8.5 percent of economic output last year to 5.3 percent this year and 3.0 percent in 2013.",96,105,has vowed,0,1,1
3OREP8RUT2C0O5U3B0Z1EBY1H0DBGU,"Rajoy said this week the banking intervention would not affect the annual public deficit, which has vowed to slash from 8.5 percent of economic output last year to 5.3 percent this year and 3.0 percent in 2013.",100,105,vowed,2,8,10
3OREP8RUT2C0O5U3B0Z1EBY1H0DBGU,"Rajoy said this week the banking intervention would not affect the annual public deficit, which has vowed to slash from 8.5 percent of economic output last year to 5.3 percent this year and 3.0 percent in 2013.",100,114,vowed to slash,1,1,2
3OREP8RUT2C0O5U3B0Z1EBY1H0DBGU,"Rajoy said this week the banking intervention would not affect the annual public deficit, which has vowed to slash from 8.5 percent of economic output last year to 5.3 percent this year and 3.0 percent in 2013.",106,114,to slash,0,1,1
3OREP8RUT2C0O5U3B0Z1EBY1H0DBGU,"Rajoy said this week the banking intervention would not affect the annual public deficit, which has vowed to slash from 8.5 percent of economic output last year to 5.3 percent this year and 3.0 percent in 2013.",109,114,slash,1,6,7
3OREP8RUT2C0O5U3B0Z1EBY1H0DBGU,"Rajoy said this week the banking intervention would not affect the annual public deficit, which has vowed to slash from 8.5 percent of economic output last year to 5.3 percent this year and 3.0 percent in 2013.",135,143,economic,1,1,2
3OREP8RUT2C0O5U3B0Z1EBY1H0DBGU,"Rajoy said this week the banking intervention would not affect the annual public deficit, which has vowed to slash from 8.5 percent of economic output last year to 5.3 percent this year and 3.0 percent in 2013.",135,150,economic output,3,2,5
3OREP8RUT2C0O5U3B0Z1EBY1H0DBGU,"Rajoy said this week the banking intervention would not affect the annual public deficit, which has vowed to slash from 8.5 percent of economic output last year to 5.3 percent this year and 3.0 percent in 2013.",144,150,output,0,1,1
3OREP8RUT2C0O5U3B0Z1EBY1H0DBGU,The European Union has already discounted Spain's promise to trim the deficit in a time of recession and with an unemployment rate in the first quarter of 24.4 percent.,31,41,discounted,5,8,13
3OREP8RUT2C0O5U3B0Z1EBY1H0DBGU,The European Union has already discounted Spain's promise to trim the deficit in a time of recession and with an unemployment rate in the first quarter of 24.4 percent.,50,65,promise to trim,0,1,1
3OREP8RUT2C0O5U3B0Z1EBY1H0DBGU,The European Union has already discounted Spain's promise to trim the deficit in a time of recession and with an unemployment rate in the first quarter of 24.4 percent.,61,65,trim,1,4,5
3OREP8RUT2C0O5U3B0Z1EBY1H0DBGU,The European Union has already discounted Spain's promise to trim the deficit in a time of recession and with an unemployment rate in the first quarter of 24.4 percent.,61,77,trim the deficit,4,1,5
3OREP8RUT2C0O5U3B0Z1EBY1H0DBGU,The European Union has already discounted Spain's promise to trim the deficit in a time of recession and with an unemployment rate in the first quarter of 24.4 percent.,70,77,deficit,3,2,5
3OREP8RUT2C0O5U3B0Z1EBY1H0DBGU,The European Union has already discounted Spain's promise to trim the deficit in a time of recession and with an unemployment rate in the first quarter of 24.4 percent.,91,100,recession,10,9,19
3OREP8RUT2C0O5U3B0Z1EBY1H0DBGU,The European Union has already discounted Spain's promise to trim the deficit in a time of recession and with an unemployment rate in the first quarter of 24.4 percent.,113,125,unemployment,1,1,2
3OREP8RUT2C0O5U3B0Z1EBY1H0DBGU,The European Union has already discounted Spain's promise to trim the deficit in a time of recession and with an unemployment rate in the first quarter of 24.4 percent.,113,130,unemployment rate,1,0,1
3OREP8RUT2C0O5U3B0Z1EBY1H0DBGU,The European Union has already discounted Spain's promise to trim the deficit in a time of recession and with an unemployment rate in the first quarter of 24.4 percent.,138,151,first quarter,1,0,1
3OREP8RUT2C0O5U3B0Z1EBY1H0DBGU,"At least 30 people - including 23 soldiers - have died in heavy overnight clashes in the central Syrian city of Rastan, according to activists.",58,81,heavy overnight clashes,2,0,2
3OREP8RUT2C0O5U3B0Z1EBY1H0DBGU,"At least 30 people - including 23 soldiers - have died in heavy overnight clashes in the central Syrian city of Rastan, according to activists.",64,73,overnight,1,3,4
3OREP8RUT2C0O5U3B0Z1EBY1H0DBGU,"At least 30 people - including 23 soldiers - have died in heavy overnight clashes in the central Syrian city of Rastan, according to activists.",64,81,overnight clashes,0,3,3
3OREP8RUT2C0O5U3B0Z1EBY1H0DBGU,"At least 30 people - including 23 soldiers - have died in heavy overnight clashes in the central Syrian city of Rastan, according to activists.",74,81,clashes,1,0,1
3OREP8RUT2C0O5U3B0Z1EBY1H0DBGU,"At least 30 people - including 23 soldiers - have died in heavy overnight clashes in the central Syrian city of Rastan, according to activists.",133,142,activists,4,5,9
3OREP8RUT2C0O5U3B0Z1EBY1H0DBGU,"The Syrian Observatory for Human Rights said dozens of others were wounded in the city, in the restive Homs province.",4,22,Syrian Observatory,1,0,1
3OREP8RUT2C0O5U3B0Z1EBY1H0DBGU,"The Syrian Observatory for Human Rights said dozens of others were wounded in the city, in the restive Homs province.",11,22,Observatory,1,1,2
3OREP8RUT2C0O5U3B0Z1EBY1H0DBGU,"The Syrian Observatory for Human Rights said dozens of others were wounded in the city, in the restive Homs province.",67,74,wounded,0,3,3
3OREP8RUT2C0O5U3B0Z1EBY1H0DBGU,"The Syrian Observatory for Human Rights said dozens of others were wounded in the city, in the restive Homs province.",95,102,restive,6,5,11
3OREP8RUT2C0O5U3B0Z1EBY1H0DBGU,"The Syrian Observatory for Human Rights said dozens of others were wounded in the city, in the restive Homs province.",95,116,restive Homs province,3,1,4
3OREP8RUT2C0O5U3B0Z1EBY1H0DBGU,"The Syrian Observatory for Human Rights said dozens of others were wounded in the city, in the restive Homs province.",108,116,province,2,1,3
3OREP8RUT2C0O5U3B0Z1EBY1H0DBGU,"Three troop carriers were destroyed in fighting, the UK-based group said.",6,11,troop,1,1,2
3OREP8RUT2C0O5U3B0Z1EBY1H0DBGU,"Three troop carriers were destroyed in fighting, the UK-based group said.",6,20,troop carriers,4,2,6
3OREP8RUT2C0O5U3B0Z1EBY1H0DBGU,"Three troop carriers were destroyed in fighting, the UK-based group said.",12,20,carriers,1,0,1
3OREP8RUT2C0O5U3B0Z1EBY1H0DBGU,"Three troop carriers were destroyed in fighting, the UK-based group said.",26,35,destroyed,0,2,2
3OREP8RUT2C0O5U3B0Z1EBY1H0DBGU,"Three troop carriers were destroyed in fighting, the UK-based group said.",53,61,UK-based,1,0,1
3RHLQY6EDT5DRMZ3UVO60CPYVTJD4A,"The neighbors say that they called out to the children, begging them not to go back to the house.",4,13,neighbors,1,2,3
3RHLQY6EDT5DRMZ3UVO60CPYVTJD4A,"The neighbors say that they called out to the children, begging them not to go back to the house.",56,63,begging,2,4,6
3RHLQY6EDT5DRMZ3UVO60CPYVTJD4A,"The neighbors say that they called out to the children, begging them not to go back to the house.",56,68,begging them,0,1,1
3RHLQY6EDT5DRMZ3UVO60CPYVTJD4A,The neighbors called police immediately who heard gunshots upon arrival.,4,13,neighbors,1,0,1
3RHLQY6EDT5DRMZ3UVO60CPYVTJD4A,The neighbors called police immediately who heard gunshots upon arrival.,28,39,immediately,4,1,5
3RHLQY6EDT5DRMZ3UVO60CPYVTJD4A,The neighbors called police immediately who heard gunshots upon arrival.,50,58,gunshots,1,2,3
3RHLQY6EDT5DRMZ3UVO60CPYVTJD4A,The neighbors called police immediately who heard gunshots upon arrival.,59,71,upon arrival,0,1,1
3RHLQY6EDT5DRMZ3UVO60CPYVTJD4A,"We set up a perimeter, found the oldest girl lying in the yard and took her out to ambulance, Goodyear said.",13,22,perimeter,10,10,20
3RHLQY6EDT5DRMZ3UVO60CPYVTJD4A,"We set up a perimeter, found the oldest girl lying in the yard and took her out to ambulance, Goodyear said.",46,51,lying,0,1,1
3RHLQY6EDT5DRMZ3UVO60CPYVTJD4A,"We set up a perimeter, found the oldest girl lying in the yard and took her out to ambulance, Goodyear said.",84,93,ambulance,6,1,7
3RHLQY6EDT5DRMZ3UVO60CPYVTJD4A,EMTs pronounced Pebbles dead in the ambulance and a SWAT team was called for further investigation.,0,4,EMTs,0,2,2
3RHLQY6EDT5DRMZ3UVO60CPYVTJD4A,EMTs pronounced Pebbles dead in the ambulance and a SWAT team was called for further investigation.,5,15,pronounced,10,6,16
3RHLQY6EDT5DRMZ3UVO60CPYVTJD4A,EMTs pronounced Pebbles dead in the ambulance and a SWAT team was called for further investigation.,16,23,Pebbles,0,2,2
3RHLQY6EDT5DRMZ3UVO60CPYVTJD4A,EMTs pronounced Pebbles dead in the ambulance and a SWAT team was called for further investigation.,52,56,SWAT,1,2,3
3RHLQY6EDT5DRMZ3UVO60CPYVTJD4A,EMTs pronounced Pebbles dead in the ambulance and a SWAT team was called for further investigation.,52,61,SWAT team,3,1,4
3RHLQY6EDT5DRMZ3UVO60CPYVTJD4A,EMTs pronounced Pebbles dead in the ambulance and a SWAT team was called for further investigation.,77,98,further investigation,1,1,2
3RHLQY6EDT5DRMZ3UVO60CPYVTJD4A,EMTs pronounced Pebbles dead in the ambulance and a SWAT team was called for further investigation.,85,98,investigation,4,4,8
3RHLQY6EDT5DRMZ3UVO60CPYVTJD4A,Police say they heard another gun shot.,16,21,heard,0,1,1
3RHLQY6EDT5DRMZ3UVO60CPYVTJD4A,Police say they heard another gun shot.,34,38,shot,0,1,1
3RHLQY6EDT5DRMZ3UVO60CPYVTJD4A,"Goodyear says the father of the family lives in Titusville, Fla., and hadn't been home in a few months.",60,63,Fla,1,0,1
3RHLQY6EDT5DRMZ3UVO60CPYVTJD4A,"Goodyear says the father of the family lives in Titusville, Fla., and hadn't been home in a few months.",70,75,hadnt,0,1,1
3RHLQY6EDT5DRMZ3UVO60CPYVTJD4A,The family has a history of domestic violence.,28,36,domestic,2,2,4
3RHLQY6EDT5DRMZ3UVO60CPYVTJD4A,The family has a history of domestic violence.,28,45,domestic violence,8,4,12
3RHLQY6EDT5DRMZ3UVO60CPYVTJD4A,The family has a history of domestic violence.,37,45,violence,0,2,2
3EFNPKWBMSPYA6F5I5VSB0D9N4E30M,"In April, Jaxs threw a bicycle through a window in the house and threatened Thomas, according to a police report.",15,20,threw,0,2,2
3EFNPKWBMSPYA6F5I5VSB0D9N4E30M,"In April, Jaxs threw a bicycle through a window in the house and threatened Thomas, according to a police report.",65,75,threatened,7,8,15
3EFNPKWBMSPYA6F5I5VSB0D9N4E30M,"In April, Jaxs threw a bicycle through a window in the house and threatened Thomas, according to a police report.",84,93,according,0,1,1
3EFNPKWBMSPYA6F5I5VSB0D9N4E30M,"In April, Jaxs threw a bicycle through a window in the house and threatened Thomas, according to a police report.",99,112,police report,1,0,1
3EFNPKWBMSPYA6F5I5VSB0D9N4E30M,"That next day, when she woke him up for school, he kicked and punched her repeatedly, the report said.",51,57,kicked,0,1,1
3EFNPKWBMSPYA6F5I5VSB0D9N4E30M,"That next day, when she woke him up for school, he kicked and punched her repeatedly, the report said.",51,69,kicked and punched,0,1,1
3EFNPKWBMSPYA6F5I5VSB0D9N4E30M,"That next day, when she woke him up for school, he kicked and punched her repeatedly, the report said.",62,69,punched,1,2,3
3EFNPKWBMSPYA6F5I5VSB0D9N4E30M,"That next day, when she woke him up for school, he kicked and punched her repeatedly, the report said.",74,84,repeatedly,1,1,2
3EFNPKWBMSPYA6F5I5VSB0D9N4E30M,She pushed back and they began to scuffle.,4,15,pushed back,0,1,1
3EFNPKWBMSPYA6F5I5VSB0D9N4E30M,She pushed back and they began to scuffle.,34,41,scuffle,9,10,19
3EFNPKWBMSPYA6F5I5VSB0D9N4E30M,Police were called later that day and police say neighbors often complained of hearing shouts and yells emanating from the house.,49,58,neighbors,1,0,1
3EFNPKWBMSPYA6F5I5VSB0D9N4E30M,Police were called later that day and police say neighbors often complained of hearing shouts and yells emanating from the house.,65,75,complained,3,2,5
3EFNPKWBMSPYA6F5I5VSB0D9N4E30M,Police were called later that day and police say neighbors often complained of hearing shouts and yells emanating from the house.,87,93,shouts,2,0,2
3EFNPKWBMSPYA6F5I5VSB0D9N4E30M,Police were called later that day and police say neighbors often complained of hearing shouts and yells emanating from the house.,87,113,shouts and yells emanating,0,1,1
3EFNPKWBMSPYA6F5I5VSB0D9N4E30M,Police were called later that day and police say neighbors often complained of hearing shouts and yells emanating from the house.,98,103,yells,0,1,1
3EFNPKWBMSPYA6F5I5VSB0D9N4E30M,Police were called later that day and police say neighbors often complained of hearing shouts and yells emanating from the house.,98,113,yells emanating,1,1,2
3EFNPKWBMSPYA6F5I5VSB0D9N4E30M,Police were called later that day and police say neighbors often complained of hearing shouts and yells emanating from the house.,104,113,emanating,10,10,20
3EFNPKWBMSPYA6F5I5VSB0D9N4E30M,"It's sad, even if they were troublemakers.	29	42	troublemakers	8	6	14
3EFNPKWBMSPYA6F5I5VSB0D9N4E30M	It's very distressing, Goodyear said.",10,21,distressing,8,10,18
3EFNPKWBMSPYA6F5I5VSB0D9N4E30M,"As a parent, I could never fathom doing this to my kids.",28,34,fathom,8,9,17
3EFNPKWBMSPYA6F5I5VSB0D9N4E30M,A 32 year old man was sitting his car when he was approached by a lone male who fire a number of shots hitting the man at least once in the side.,50,60,approached,2,2,4
3EFNPKWBMSPYA6F5I5VSB0D9N4E30M,A 32 year old man was sitting his car when he was approached by a lone male who fire a number of shots hitting the man at least once in the side.,66,70,lone,2,1,3
3EFNPKWBMSPYA6F5I5VSB0D9N4E30M,A 32 year old man was sitting his car when he was approached by a lone male who fire a number of shots hitting the man at least once in the side.,66,75,lone male,2,1,3
3126F2F5F8448LZMOARE9SIEM1GEPV,She was killed in a gun attack at William Court.,20,30,gun attack,0,1,1
3126F2F5F8448LZMOARE9SIEM1GEPV,She was killed in a gun attack at William Court.,34,47,William Court,1,0,1
3126F2F5F8448LZMOARE9SIEM1GEPV,Her 21-year-old sister was seriously injured and remains in a critical condition at Belfast's Royal Victoria Hospital.,27,36,seriously,0,1,1
3126F2F5F8448LZMOARE9SIEM1GEPV,Her 21-year-old sister was seriously injured and remains in a critical condition at Belfast's Royal Victoria Hospital.,27,44,seriously injured,0,3,3
3126F2F5F8448LZMOARE9SIEM1GEPV,Her 21-year-old sister was seriously injured and remains in a critical condition at Belfast's Royal Victoria Hospital.,62,70,critical,3,4,7
3126F2F5F8448LZMOARE9SIEM1GEPV,Her 21-year-old sister was seriously injured and remains in a critical condition at Belfast's Royal Victoria Hospital.,62,80,critical condition,8,2,10
3126F2F5F8448LZMOARE9SIEM1GEPV,Her 21-year-old sister was seriously injured and remains in a critical condition at Belfast's Royal Victoria Hospital.,71,80,condition,0,1,1
3126F2F5F8448LZMOARE9SIEM1GEPV,Her 21-year-old sister was seriously injured and remains in a critical condition at Belfast's Royal Victoria Hospital.,84,116,Belfasts Royal Victoria Hospital,1,0,1
3126F2F5F8448LZMOARE9SIEM1GEPV,A Belfast Trust spokesperson confirmed that she had undergone surgery on Saturday afternoon.,2,9,Belfast,0,2,2
3126F2F5F8448LZMOARE9SIEM1GEPV,A Belfast Trust spokesperson confirmed that she had undergone surgery on Saturday afternoon.,16,28,spokesperson,5,8,13
3126F2F5F8448LZMOARE9SIEM1GEPV,A Belfast Trust spokesperson confirmed that she had undergone surgery on Saturday afternoon.,29,38,confirmed,1,2,3
3126F2F5F8448LZMOARE9SIEM1GEPV,A Belfast Trust spokesperson confirmed that she had undergone surgery on Saturday afternoon.,52,61,undergone,9,3,12
3126F2F5F8448LZMOARE9SIEM1GEPV,A Belfast Trust spokesperson confirmed that she had undergone surgery on Saturday afternoon.,52,69,undergone surgery,2,2,4
3126F2F5F8448LZMOARE9SIEM1GEPV,A Belfast Trust spokesperson confirmed that she had undergone surgery on Saturday afternoon.,62,69,surgery,1,2,3
3126F2F5F8448LZMOARE9SIEM1GEPV,She is believed to be a mother of two young children.,7,15,believed,0,1,1
3126F2F5F8448LZMOARE9SIEM1GEPV,A 26-year-old man is still being questioned by police on suspicion of murder.,33,43,questioned,2,0,2
3126F2F5F8448LZMOARE9SIEM1GEPV,A 26-year-old man is still being questioned by police on suspicion of murder.,57,66,suspicion,6,9,15
3126F2F5F8448LZMOARE9SIEM1GEPV,A 26-year-old man is still being questioned by police on suspicion of murder.,57,76,suspicion of murder,3,2,5
3126F2F5F8448LZMOARE9SIEM1GEPV,A 26-year-old man is still being questioned by police on suspicion of murder.,70,76,murder,1,0,1
3126F2F5F8448LZMOARE9SIEM1GEPV,"A man and woman, both aged 28, arrested on suspicion of assisting an offender were released, without charge, on Saturday evening.",43,52,suspicion,4,2,6
3126F2F5F8448LZMOARE9SIEM1GEPV,"A man and woman, both aged 28, arrested on suspicion of assisting an offender were released, without charge, on Saturday evening.",43,77,suspicion of assisting an offender,4,0,4
3126F2F5F8448LZMOARE9SIEM1GEPV,"A man and woman, both aged 28, arrested on suspicion of assisting an offender were released, without charge, on Saturday evening.",56,65,assisting,0,4,4
3126F2F5F8448LZMOARE9SIEM1GEPV,"A man and woman, both aged 28, arrested on suspicion of assisting an offender were released, without charge, on Saturday evening.",56,77,assisting an offender,1,1,2
3126F2F5F8448LZMOARE9SIEM1GEPV,"A man and woman, both aged 28, arrested on suspicion of assisting an offender were released, without charge, on Saturday evening.",69,77,offender,4,9,13
3126F2F5F8448LZMOARE9SIEM1GEPV,"A man and woman, both aged 28, arrested on suspicion of assisting an offender were released, without charge, on Saturday evening.",83,91,released,0,2,2
3126F2F5F8448LZMOARE9SIEM1GEPV,"A man and woman, both aged 28, arrested on suspicion of assisting an offender were released, without charge, on Saturday evening.",93,107,without charge,3,0,3
3126F2F5F8448LZMOARE9SIEM1GEPV,"A man and woman, both aged 28, arrested on suspicion of assisting an offender were released, without charge, on Saturday evening.",101,107,charge,0,2,2
3126F2F5F8448LZMOARE9SIEM1GEPV,They were all arrested in the Toome area within an hour on the shooting.,14,22,arrested,0,1,1
3126F2F5F8448LZMOARE9SIEM1GEPV,They were all arrested in the Toome area within an hour on the shooting.,30,35,Toome,0,2,2
3126F2F5F8448LZMOARE9SIEM1GEPV,"Parish priest Fr Andy Dolan told UTV the feeling in the area is one of ""shock and horror.""",0,6,Parish,1,0,1
3126F2F5F8448LZMOARE9SIEM1GEPV,"Parish priest Fr Andy Dolan told UTV the feeling in the area is one of ""shock and horror.""",0,13,Parish priest,2,1,3
3126F2F5F8448LZMOARE9SIEM1GEPV,"Parish priest Fr Andy Dolan told UTV the feeling in the area is one of ""shock and horror.""",14,27,Fr Andy Dolan,1,0,1
3126F2F5F8448LZMOARE9SIEM1GEPV,"Parish priest Fr Andy Dolan told UTV the feeling in the area is one of ""shock and horror.""",33,36,UTV,1,0,1
3126F2F5F8448LZMOARE9SIEM1GEPV,"Parish priest Fr Andy Dolan told UTV the feeling in the area is one of ""shock and horror.""",72,88,shock and horror,1,3,4
3126F2F5F8448LZMOARE9SIEM1GEPV,"Parish priest Fr Andy Dolan told UTV the feeling in the area is one of ""shock and horror.""",82,88,horror,1,1,2
3126F2F5F8448LZMOARE9SIEM1GEPV,"He said that the siblings were always together - if you ""saw one you saw the other.""",17,25,siblings,5,10,15
3JMQI2OLFZ6ZDU99C032ZLVYLXBDNB,Successive waves of bank sector clean-ups have failed to convince investors.,0,10,Successive,4,5,9
3JMQI2OLFZ6ZDU99C032ZLVYLXBDNB,Successive waves of bank sector clean-ups have failed to convince investors.,0,16,Successive waves,3,4,7
3JMQI2OLFZ6ZDU99C032ZLVYLXBDNB,Successive waves of bank sector clean-ups have failed to convince investors.,0,41,Successive waves of bank sector clean-ups,1,0,1
3JMQI2OLFZ6ZDU99C032ZLVYLXBDNB,Successive waves of bank sector clean-ups have failed to convince investors.,11,16,waves,1,1,2
3JMQI2OLFZ6ZDU99C032ZLVYLXBDNB,Successive waves of bank sector clean-ups have failed to convince investors.,20,31,bank sector,1,0,1
3JMQI2OLFZ6ZDU99C032ZLVYLXBDNB,Successive waves of bank sector clean-ups have failed to convince investors.,20,41,bank sector clean-ups,3,0,3
3JMQI2OLFZ6ZDU99C032ZLVYLXBDNB,Successive waves of bank sector clean-ups have failed to convince investors.,25,31,sector,1,0,1
3JMQI2OLFZ6ZDU99C032ZLVYLXBDNB,Successive waves of bank sector clean-ups have failed to convince investors.,32,41,clean-ups,1,4,5
3JMQI2OLFZ6ZDU99C032ZLVYLXBDNB,Successive waves of bank sector clean-ups have failed to convince investors.,57,65,convince,1,5,6
3JMQI2OLFZ6ZDU99C032ZLVYLXBDNB,Successive waves of bank sector clean-ups have failed to convince investors.,57,75,convince investors,0,1,1
3JMQI2OLFZ6ZDU99C032ZLVYLXBDNB,Successive waves of bank sector clean-ups have failed to convince investors.,66,75,investors,0,1,1
3JMQI2OLFZ6ZDU99C032ZLVYLXBDNB,"According to our correspondent, the toxic assets are a result of a property bubble experienced in Spain before the recession.",17,30,correspondent,4,5,9
3JMQI2OLFZ6ZDU99C032ZLVYLXBDNB,"According to our correspondent, the toxic assets are a result of a property bubble experienced in Spain before the recession.",36,41,toxic,0,2,2
3JMQI2OLFZ6ZDU99C032ZLVYLXBDNB,"According to our correspondent, the toxic assets are a result of a property bubble experienced in Spain before the recession.",36,48,toxic assets,6,6,12
3JMQI2OLFZ6ZDU99C032ZLVYLXBDNB,"According to our correspondent, the toxic assets are a result of a property bubble experienced in Spain before the recession.",42,48,assets,1,1,2
3JMQI2OLFZ6ZDU99C032ZLVYLXBDNB,"According to our correspondent, the toxic assets are a result of a property bubble experienced in Spain before the recession.",67,82,property bubble,9,5,14
3JMQI2OLFZ6ZDU99C032ZLVYLXBDNB,"According to our correspondent, the toxic assets are a result of a property bubble experienced in Spain before the recession.",76,82,bubble,0,2,2
3JMQI2OLFZ6ZDU99C032ZLVYLXBDNB,"According to our correspondent, the toxic assets are a result of a property bubble experienced in Spain before the recession.",115,124,recession,8,7,15
3JMQI2OLFZ6ZDU99C032ZLVYLXBDNB,"As a result, with the recession, so many people were left unable to pay for their mortgages, and the banks are left to deal with the after-effects.",23,32,recession,5,2,7
3JMQI2OLFZ6ZDU99C032ZLVYLXBDNB,"As a result, with the recession, so many people were left unable to pay for their mortgages, and the banks are left to deal with the after-effects.",83,92,mortgages,8,10,18
3JMQI2OLFZ6ZDU99C032ZLVYLXBDNB,"As a result, with the recession, so many people were left unable to pay for their mortgages, and the banks are left to deal with the after-effects.",134,147,after-effects,6,4,10
3JMQI2OLFZ6ZDU99C032ZLVYLXBDNB,"Banking reform is seen as urgent by many analysts, with yields on benchmark Spanish bonds currently close to six percent, meaning the country faces very high borrowing costs.",0,14,Banking reform,1,1,2
3JMQI2OLFZ6ZDU99C032ZLVYLXBDNB,"Banking reform is seen as urgent by many analysts, with yields on benchmark Spanish bonds currently close to six percent, meaning the country faces very high borrowing costs.",8,14,reform,0,1,1
3JMQI2OLFZ6ZDU99C032ZLVYLXBDNB,"Banking reform is seen as urgent by many analysts, with yields on benchmark Spanish bonds currently close to six percent, meaning the country faces very high borrowing costs.",26,32,urgent,1,0,1
3JMQI2OLFZ6ZDU99C032ZLVYLXBDNB,"Banking reform is seen as urgent by many analysts, with yields on benchmark Spanish bonds currently close to six percent, meaning the country faces very high borrowing costs.",41,49,analysts,6,2,8
3JMQI2OLFZ6ZDU99C032ZLVYLXBDNB,"Banking reform is seen as urgent by many analysts, with yields on benchmark Spanish bonds currently close to six percent, meaning the country faces very high borrowing costs.",56,62,yields,5,4,9
3JMQI2OLFZ6ZDU99C032ZLVYLXBDNB,"Banking reform is seen as urgent by many analysts, with yields on benchmark Spanish bonds currently close to six percent, meaning the country faces very high borrowing costs.",56,75,yields on benchmark,1,1,2
3JMQI2OLFZ6ZDU99C032ZLVYLXBDNB,"Banking reform is seen as urgent by many analysts, with yields on benchmark Spanish bonds currently close to six percent, meaning the country faces very high borrowing costs.",56,89,yields on benchmark Spanish bonds,2,0,2
3JMQI2OLFZ6ZDU99C032ZLVYLXBDNB,"Banking reform is seen as urgent by many analysts, with yields on benchmark Spanish bonds currently close to six percent, meaning the country faces very high borrowing costs.",66,75,benchmark,7,4,11
3JMQI2OLFZ6ZDU99C032ZLVYLXBDNB,"Banking reform is seen as urgent by many analysts, with yields on benchmark Spanish bonds currently close to six percent, meaning the country faces very high borrowing costs.",66,89,benchmark Spanish bonds,1,2,3
3JMQI2OLFZ6ZDU99C032ZLVYLXBDNB,"Banking reform is seen as urgent by many analysts, with yields on benchmark Spanish bonds currently close to six percent, meaning the country faces very high borrowing costs.",153,173,high borrowing costs,1,1,2
3JMQI2OLFZ6ZDU99C032ZLVYLXBDNB,"Banking reform is seen as urgent by many analysts, with yields on benchmark Spanish bonds currently close to six percent, meaning the country faces very high borrowing costs.",158,167,borrowing,1,2,3
3JMQI2OLFZ6ZDU99C032ZLVYLXBDNB,"Banking reform is seen as urgent by many analysts, with yields on benchmark Spanish bonds currently close to six percent, meaning the country faces very high borrowing costs.",158,173,borrowing costs,1,2,3
3JMQI2OLFZ6ZDU99C032ZLVYLXBDNB,"The pressure right now is very high and the discredit would be huge if the reform was not to be approved this Friday, a banking source told",45,54,discredit,10,9,19
3JMQI2OLFZ6ZDU99C032ZLVYLXBDNB,The Spanish Government is expected to announce a new round of financial sector reforms later today.,26,34,expected,0,1,1
3JMQI2OLFZ6ZDU99C032ZLVYLXBDNB,The Spanish Government is expected to announce a new round of financial sector reforms later today.,38,46,announce,1,1,2
3JMQI2OLFZ6ZDU99C032ZLVYLXBDNB,The Spanish Government is expected to announce a new round of financial sector reforms later today.,62,71,financial,0,1,1
3JMQI2OLFZ6ZDU99C032ZLVYLXBDNB,The Spanish Government is expected to announce a new round of financial sector reforms later today.,62,86,financial sector reforms,5,1,6
3JMQI2OLFZ6ZDU99C032ZLVYLXBDNB,The Spanish Government is expected to announce a new round of financial sector reforms later today.,79,86,reforms,1,1,2
33Q5P9PUSPNJPRHEFSJLA2KPBOACZL,"With the long process of purchasing Motorola Mobility finally drawing to a close, Google seems to be shifting their attention to the process of selling hardware on their own.",14,21,process,0,2,2
33Q5P9PUSPNJPRHEFSJLA2KPBOACZL,"With the long process of purchasing Motorola Mobility finally drawing to a close, Google seems to be shifting their attention to the process of selling hardware on their own.",25,35,purchasing,2,2,4
33Q5P9PUSPNJPRHEFSJLA2KPBOACZL,"With the long process of purchasing Motorola Mobility finally drawing to a close, Google seems to be shifting their attention to the process of selling hardware on their own.",62,69,drawing,1,2,3
33Q5P9PUSPNJPRHEFSJLA2KPBOACZL,"With the long process of purchasing Motorola Mobility finally drawing to a close, Google seems to be shifting their attention to the process of selling hardware on their own.",62,72,drawing to,1,0,1
33Q5P9PUSPNJPRHEFSJLA2KPBOACZL,"With the long process of purchasing Motorola Mobility finally drawing to a close, Google seems to be shifting their attention to the process of selling hardware on their own.",62,80,drawing to a close,3,0,3
33Q5P9PUSPNJPRHEFSJLA2KPBOACZL,"With the long process of purchasing Motorola Mobility finally drawing to a close, Google seems to be shifting their attention to the process of selling hardware on their own.",101,109,shifting,2,3,5
33Q5P9PUSPNJPRHEFSJLA2KPBOACZL,"With the long process of purchasing Motorola Mobility finally drawing to a close, Google seems to be shifting their attention to the process of selling hardware on their own.",101,125,shifting their attention,1,0,1
33Q5P9PUSPNJPRHEFSJLA2KPBOACZL,"With the long process of purchasing Motorola Mobility finally drawing to a close, Google seems to be shifting their attention to the process of selling hardware on their own.",116,125,attention,1,1,2
33Q5P9PUSPNJPRHEFSJLA2KPBOACZL,"With the long process of purchasing Motorola Mobility finally drawing to a close, Google seems to be shifting their attention to the process of selling hardware on their own.",152,160,hardware,1,2,3
33Q5P9PUSPNJPRHEFSJLA2KPBOACZL,The Wall Street Journal reported earlier this week that Google was looking at fleshing out the Devices section of the Google Play Store with unlocked smartphones and tablets - all of them lead devices -  from up to five major hardware manufacturers.,78,86,fleshing,6,8,14
33Q5P9PUSPNJPRHEFSJLA2KPBOACZL,The Wall Street Journal reported earlier this week that Google was looking at fleshing out the Devices section of the Google Play Store with unlocked smartphones and tablets - all of them lead devices -  from up to five major hardware manufacturers.,78,90,fleshing out,6,3,9
33Q5P9PUSPNJPRHEFSJLA2KPBOACZL,The Wall Street Journal reported earlier this week that Google was looking at fleshing out the Devices section of the Google Play Store with unlocked smartphones and tablets - all of them lead devices -  from up to five major hardware manufacturers.,141,149,unlocked,3,3,6
33Q5P9PUSPNJPRHEFSJLA2KPBOACZL,The Wall Street Journal reported earlier this week that Google was looking at fleshing out the Devices section of the Google Play Store with unlocked smartphones and tablets - all of them lead devices -  from up to five major hardware manufacturers.,150,161,smartphones,2,0,2
33Q5P9PUSPNJPRHEFSJLA2KPBOACZL,The Wall Street Journal reported earlier this week that Google was looking at fleshing out the Devices section of the Google Play Store with unlocked smartphones and tablets - all of them lead devices -  from up to five major hardware manufacturers.,188,192,lead,0,1,1
33Q5P9PUSPNJPRHEFSJLA2KPBOACZL,The Wall Street Journal reported earlier this week that Google was looking at fleshing out the Devices section of the Google Play Store with unlocked smartphones and tablets - all of them lead devices -  from up to five major hardware manufacturers.,188,200,lead devices,2,3,5
33Q5P9PUSPNJPRHEFSJLA2KPBOACZL,The Wall Street Journal reported earlier this week that Google was looking at fleshing out the Devices section of the Google Play Store with unlocked smartphones and tablets - all of them lead devices -  from up to five major hardware manufacturers.,193,200,devices,1,0,1
33Q5P9PUSPNJPRHEFSJLA2KPBOACZL,The Wall Street Journal reported earlier this week that Google was looking at fleshing out the Devices section of the Google Play Store with unlocked smartphones and tablets - all of them lead devices -  from up to five major hardware manufacturers.,226,234,hardware,1,1,2
33Q5P9PUSPNJPRHEFSJLA2KPBOACZL,The Wall Street Journal reported earlier this week that Google was looking at fleshing out the Devices section of the Google Play Store with unlocked smartphones and tablets - all of them lead devices -  from up to five major hardware manufacturers.,226,248,hardware manufacturers,1,0,1
33Q5P9PUSPNJPRHEFSJLA2KPBOACZL,The Wall Street Journal reported earlier this week that Google was looking at fleshing out the Devices section of the Google Play Store with unlocked smartphones and tablets - all of them lead devices -  from up to five major hardware manufacturers.,235,248,manufacturers,4,1,5
33Q5P9PUSPNJPRHEFSJLA2KPBOACZL,"Now that Google will have their own in-house hardware team, it stands to reason that they might soon offer their own devices alongside those from hardware partners like Samsung and HTC.",36,44,in-house,5,5,10
33Q5P9PUSPNJPRHEFSJLA2KPBOACZL,"Now that Google will have their own in-house hardware team, it stands to reason that they might soon offer their own devices alongside those from hardware partners like Samsung and HTC.",73,79,reason,0,1,1
33Q5P9PUSPNJPRHEFSJLA2KPBOACZL,"Now that Google will have their own in-house hardware team, it stands to reason that they might soon offer their own devices alongside those from hardware partners like Samsung and HTC.",117,134,devices alongside,1,1,2
33Q5P9PUSPNJPRHEFSJLA2KPBOACZL,"Now that Google will have their own in-house hardware team, it stands to reason that they might soon offer their own devices alongside those from hardware partners like Samsung and HTC.",125,134,alongside,2,5,7
33Q5P9PUSPNJPRHEFSJLA2KPBOACZL,"Now that Google will have their own in-house hardware team, it stands to reason that they might soon offer their own devices alongside those from hardware partners like Samsung and HTC.",146,154,hardware,1,0,1
33Q5P9PUSPNJPRHEFSJLA2KPBOACZL,"Now that Google will have their own in-house hardware team, it stands to reason that they might soon offer their own devices alongside those from hardware partners like Samsung and HTC.",146,163,hardware partners,1,0,1
33Q5P9PUSPNJPRHEFSJLA2KPBOACZL,Motorola is known around the world for innovation in communications and is focused on advancing the way the world connects.,39,49,innovation,10,10,20
33Q5P9PUSPNJPRHEFSJLA2KPBOACZL,Motorola is known around the world for innovation in communications and is focused on advancing the way the world connects.,53,67,communications,2,1,3
33Q5P9PUSPNJPRHEFSJLA2KPBOACZL,Motorola is known around the world for innovation in communications and is focused on advancing the way the world connects.,75,82,focused,1,3,4
33Q5P9PUSPNJPRHEFSJLA2KPBOACZL,Motorola is known around the world for innovation in communications and is focused on advancing the way the world connects.,86,95,advancing,4,1,5
33Q5P9PUSPNJPRHEFSJLA2KPBOACZL,Motorola is known around the world for innovation in communications and is focused on advancing the way the world connects.,114,122,connects,1,0,1
3IKMEYR0LWWB2EQQIYR5BANQVOKK2Y,Gardai investigating a shooting in west Dublin last night have recovered a gun.,0,6,Gardai,1,0,1
3IKMEYR0LWWB2EQQIYR5BANQVOKK2Y,Gardai investigating a shooting in west Dublin last night have recovered a gun.,7,20,investigating,9,5,14
3IKMEYR0LWWB2EQQIYR5BANQVOKK2Y,Gardai investigating a shooting in west Dublin last night have recovered a gun.,23,31,shooting,0,1,1
3IKMEYR0LWWB2EQQIYR5BANQVOKK2Y,Gardai investigating a shooting in west Dublin last night have recovered a gun.,63,72,recovered,4,2,6
3IKMEYR0LWWB2EQQIYR5BANQVOKK2Y,A man (32) was wounded while sitting in a car outside Finnegan's pub on Sarsfield Road in Ballyfermot at about 11.10pm.,15,22,wounded,2,3,5
3IKMEYR0LWWB2EQQIYR5BANQVOKK2Y,A man (32) was wounded while sitting in a car outside Finnegan's pub on Sarsfield Road in Ballyfermot at about 11.10pm.,65,68,pub,0,2,2
3IKMEYR0LWWB2EQQIYR5BANQVOKK2Y,He was targetted by a lone gunman who discharged a number of shots.,7,16,targetted,5,9,14
3IKMEYR0LWWB2EQQIYR5BANQVOKK2Y,He was targetted by a lone gunman who discharged a number of shots.,22,26,lone,2,3,5
3IKMEYR0LWWB2EQQIYR5BANQVOKK2Y,He was targetted by a lone gunman who discharged a number of shots.,22,33,lone gunman,1,0,1
3IKMEYR0LWWB2EQQIYR5BANQVOKK2Y,He was targetted by a lone gunman who discharged a number of shots.,27,33,gunman,0,1,1
3IKMEYR0LWWB2EQQIYR5BANQVOKK2Y,He was targetted by a lone gunman who discharged a number of shots.,38,48,discharged,10,6,16
3IKMEYR0LWWB2EQQIYR5BANQVOKK2Y,The victim was taken to Tallaght Hospital for treatment but his injuries were not said to be serious.,4,10,victim,1,3,4
3IKMEYR0LWWB2EQQIYR5BANQVOKK2Y,The victim was taken to Tallaght Hospital for treatment but his injuries were not said to be serious.,46,55,treatment,2,0,2
3IKMEYR0LWWB2EQQIYR5BANQVOKK2Y,The victim was taken to Tallaght Hospital for treatment but his injuries were not said to be serious.,64,72,injuries,0,3,3
3IKMEYR0LWWB2EQQIYR5BANQVOKK2Y,"The gunman left the scene in a getaway car which was found burned out at Goldenbridge Terrace, Inchicore last night.",31,38,getaway,1,4,5
3IKMEYR0LWWB2EQQIYR5BANQVOKK2Y,"The gunman left the scene in a getaway car which was found burned out at Goldenbridge Terrace, Inchicore last night.",31,42,getaway car,3,3,6
3IKMEYR0LWWB2EQQIYR5BANQVOKK2Y,"The gunman left the scene in a getaway car which was found burned out at Goldenbridge Terrace, Inchicore last night.",59,65,burned,2,0,2
3IKMEYR0LWWB2EQQIYR5BANQVOKK2Y,"The gunman left the scene in a getaway car which was found burned out at Goldenbridge Terrace, Inchicore last night.",95,104,Inchicore,0,1,1
3IKMEYR0LWWB2EQQIYR5BANQVOKK2Y,A gun was recovered close to the burned out car.,10,19,recovered,1,0,1
3IKMEYR0LWWB2EQQIYR5BANQVOKK2Y,A gun was recovered close to the burned out car.,33,47,burned out car,1,0,1
3IKMEYR0LWWB2EQQIYR5BANQVOKK2Y,The scenes of the shooting and fire are being preserved by gardai for a technical examination.,46,55,preserved,4,4,8
3IKMEYR0LWWB2EQQIYR5BANQVOKK2Y,The scenes of the shooting and fire are being preserved by gardai for a technical examination.,59,65,gardai,2,3,5
3IKMEYR0LWWB2EQQIYR5BANQVOKK2Y,The scenes of the shooting and fire are being preserved by gardai for a technical examination.,72,81,technical,3,0,3
3IKMEYR0LWWB2EQQIYR5BANQVOKK2Y,The scenes of the shooting and fire are being preserved by gardai for a technical examination.,72,93,technical examination,6,3,9
3IKMEYR0LWWB2EQQIYR5BANQVOKK2Y,The scenes of the shooting and fire are being preserved by gardai for a technical examination.,82,93,examination,2,0,2
3IKMEYR0LWWB2EQQIYR5BANQVOKK2Y,The Philippines foreign secretary has said he and the Chinese ambassador have agreed to resolve diplomatically a stand-off involving a Philippine warship and two Chinese surveillance vessels in a disputed area of the South China Sea.,16,33,foreign secretary,2,0,2
3IKMEYR0LWWB2EQQIYR5BANQVOKK2Y,The Philippines foreign secretary has said he and the Chinese ambassador have agreed to resolve diplomatically a stand-off involving a Philippine warship and two Chinese surveillance vessels in a disputed area of the South China Sea.,24,33,secretary,1,0,1
3IKMEYR0LWWB2EQQIYR5BANQVOKK2Y,The Philippines foreign secretary has said he and the Chinese ambassador have agreed to resolve diplomatically a stand-off involving a Philippine warship and two Chinese surveillance vessels in a disputed area of the South China Sea.,62,72,ambassador,4,2,6
3IKMEYR0LWWB2EQQIYR5BANQVOKK2Y,The Philippines foreign secretary has said he and the Chinese ambassador have agreed to resolve diplomatically a stand-off involving a Philippine warship and two Chinese surveillance vessels in a disputed area of the South China Sea.,88,95,resolve,1,3,4
3IKMEYR0LWWB2EQQIYR5BANQVOKK2Y,The Philippines foreign secretary has said he and the Chinese ambassador have agreed to resolve diplomatically a stand-off involving a Philippine warship and two Chinese surveillance vessels in a disputed area of the South China Sea.,88,110,resolve diplomatically,3,2,5
3IKMEYR0LWWB2EQQIYR5BANQVOKK2Y,The Philippines foreign secretary has said he and the Chinese ambassador have agreed to resolve diplomatically a stand-off involving a Philippine warship and two Chinese surveillance vessels in a disputed area of the South China Sea.,96,110,diplomatically,7,5,12
3IKMEYR0LWWB2EQQIYR5BANQVOKK2Y,The Philippines foreign secretary has said he and the Chinese ambassador have agreed to resolve diplomatically a stand-off involving a Philippine warship and two Chinese surveillance vessels in a disputed area of the South China Sea.,113,122,stand-off,5,6,11
3IKMEYR0LWWB2EQQIYR5BANQVOKK2Y,The Philippines foreign secretary has said he and the Chinese ambassador have agreed to resolve diplomatically a stand-off involving a Philippine warship and two Chinese surveillance vessels in a disputed area of the South China Sea.,113,132,stand-off involving,0,1,1
3IKMEYR0LWWB2EQQIYR5BANQVOKK2Y,The Philippines foreign secretary has said he and the Chinese ambassador have agreed to resolve diplomatically a stand-off involving a Philippine warship and two Chinese surveillance vessels in a disputed area of the South China Sea.,146,153,warship,3,0,3
3IKMEYR0LWWB2EQQIYR5BANQVOKK2Y,The Philippines foreign secretary has said he and the Chinese ambassador have agreed to resolve diplomatically a stand-off involving a Philippine warship and two Chinese surveillance vessels in a disputed area of the South China Sea.,170,182,surveillance,4,5,9
3IKMEYR0LWWB2EQQIYR5BANQVOKK2Y,The Philippines foreign secretary has said he and the Chinese ambassador have agreed to resolve diplomatically a stand-off involving a Philippine warship and two Chinese surveillance vessels in a disputed area of the South China Sea.,170,190,surveillance vessels,5,4,9
3IKMEYR0LWWB2EQQIYR5BANQVOKK2Y,The Philippines foreign secretary has said he and the Chinese ambassador have agreed to resolve diplomatically a stand-off involving a Philippine warship and two Chinese surveillance vessels in a disputed area of the South China Sea.,183,190,vessels,1,1,2
3IKMEYR0LWWB2EQQIYR5BANQVOKK2Y,The Philippines foreign secretary has said he and the Chinese ambassador have agreed to resolve diplomatically a stand-off involving a Philippine warship and two Chinese surveillance vessels in a disputed area of the South China Sea.,196,204,disputed,4,2,6
3IKMEYR0LWWB2EQQIYR5BANQVOKK2Y,The Philippines foreign secretary has said he and the Chinese ambassador have agreed to resolve diplomatically a stand-off involving a Philippine warship and two Chinese surveillance vessels in a disputed area of the South China Sea.,196,209,disputed area,0,2,2
329E6HTMSW30NWM9MY5AUKSI12KK39,"On Tuesday, Filipino sailors from the warship boarded the Chinese vessels for an inspection, discovering large amounts of illegally collected coral, giant clams and live sharks inside the first boat, the department said.",12,20,Filipino,0,1,1
329E6HTMSW30NWM9MY5AUKSI12KK39,"On Tuesday, Filipino sailors from the warship boarded the Chinese vessels for an inspection, discovering large amounts of illegally collected coral, giant clams and live sharks inside the first boat, the department said.",12,28,Filipino sailors,0,1,1
329E6HTMSW30NWM9MY5AUKSI12KK39,"On Tuesday, Filipino sailors from the warship boarded the Chinese vessels for an inspection, discovering large amounts of illegally collected coral, giant clams and live sharks inside the first boat, the department said.",38,45,warship,3,3,6
329E6HTMSW30NWM9MY5AUKSI12KK39,"On Tuesday, Filipino sailors from the warship boarded the Chinese vessels for an inspection, discovering large amounts of illegally collected coral, giant clams and live sharks inside the first boat, the department said.",46,53,boarded,2,3,5
329E6HTMSW30NWM9MY5AUKSI12KK39,"On Tuesday, Filipino sailors from the warship boarded the Chinese vessels for an inspection, discovering large amounts of illegally collected coral, giant clams and live sharks inside the first boat, the department said.",66,73,vessels,5,2,7
329E6HTMSW30NWM9MY5AUKSI12KK39,"On Tuesday, Filipino sailors from the warship boarded the Chinese vessels for an inspection, discovering large amounts of illegally collected coral, giant clams and live sharks inside the first boat, the department said.",81,91,inspection,6,1,7
329E6HTMSW30NWM9MY5AUKSI12KK39,"On Tuesday, Filipino sailors from the warship boarded the Chinese vessels for an inspection, discovering large amounts of illegally collected coral, giant clams and live sharks inside the first boat, the department said.",93,104,discovering,1,0,1
329E6HTMSW30NWM9MY5AUKSI12KK39,"On Tuesday, Filipino sailors from the warship boarded the Chinese vessels for an inspection, discovering large amounts of illegally collected coral, giant clams and live sharks inside the first boat, the department said.",122,131,illegally,2,3,5
329E6HTMSW30NWM9MY5AUKSI12KK39,"On Tuesday, Filipino sailors from the warship boarded the Chinese vessels for an inspection, discovering large amounts of illegally collected coral, giant clams and live sharks inside the first boat, the department said.",122,141,illegally collected,3,1,4
329E6HTMSW30NWM9MY5AUKSI12KK39,"On Tuesday, Filipino sailors from the warship boarded the Chinese vessels for an inspection, discovering large amounts of illegally collected coral, giant clams and live sharks inside the first boat, the department said.",142,147,coral,2,1,3
329E6HTMSW30NWM9MY5AUKSI12KK39,"On Tuesday, Filipino sailors from the warship boarded the Chinese vessels for an inspection, discovering large amounts of illegally collected coral, giant clams and live sharks inside the first boat, the department said.",149,160,giant clams,1,0,1
329E6HTMSW30NWM9MY5AUKSI12KK39,"On Tuesday, Filipino sailors from the warship boarded the Chinese vessels for an inspection, discovering large amounts of illegally collected coral, giant clams and live sharks inside the first boat, the department said.",155,160,clams,1,2,3
329E6HTMSW30NWM9MY5AUKSI12KK39,"On Tuesday, Filipino sailors from the warship boarded the Chinese vessels for an inspection, discovering large amounts of illegally collected coral, giant clams and live sharks inside the first boat, the department said.",204,214,department,1,0,1
329E6HTMSW30NWM9MY5AUKSI12KK39,"Two Chinese maritime surveillance ships, identified as Zhonggou Haijian 75 and Zhonggou Haijian 84, later approached and positioned themselves between the Philippine warship and the Chinese fishing vessels ""thus preventing the arrests of the erring Chinese fishermen"", the statement said.",12,20,maritime,5,1,6
329E6HTMSW30NWM9MY5AUKSI12KK39,"Two Chinese maritime surveillance ships, identified as Zhonggou Haijian 75 and Zhonggou Haijian 84, later approached and positioned themselves between the Philippine warship and the Chinese fishing vessels ""thus preventing the arrests of the erring Chinese fishermen"", the statement said.",12,33,maritime surveillance,5,2,7
329E6HTMSW30NWM9MY5AUKSI12KK39,"Two Chinese maritime surveillance ships, identified as Zhonggou Haijian 75 and Zhonggou Haijian 84, later approached and positioned themselves between the Philippine warship and the Chinese fishing vessels ""thus preventing the arrests of the erring Chinese fishermen"", the statement said.",12,39,maritime surveillance ships,4,0,4
329E6HTMSW30NWM9MY5AUKSI12KK39,"Two Chinese maritime surveillance ships, identified as Zhonggou Haijian 75 and Zhonggou Haijian 84, later approached and positioned themselves between the Philippine warship and the Chinese fishing vessels ""thus preventing the arrests of the erring Chinese fishermen"", the statement said.",21,33,surveillance,6,3,9
329E6HTMSW30NWM9MY5AUKSI12KK39,"Two Chinese maritime surveillance ships, identified as Zhonggou Haijian 75 and Zhonggou Haijian 84, later approached and positioned themselves between the Philippine warship and the Chinese fishing vessels ""thus preventing the arrests of the erring Chinese fishermen"", the statement said.",21,39,surveillance ships,0,1,1
329E6HTMSW30NWM9MY5AUKSI12KK39,"Two Chinese maritime surveillance ships, identified as Zhonggou Haijian 75 and Zhonggou Haijian 84, later approached and positioned themselves between the Philippine warship and the Chinese fishing vessels ""thus preventing the arrests of the erring Chinese fishermen"", the statement said.",106,116,approached,2,1,3
329E6HTMSW30NWM9MY5AUKSI12KK39,"Two Chinese maritime surveillance ships, identified as Zhonggou Haijian 75 and Zhonggou Haijian 84, later approached and positioned themselves between the Philippine warship and the Chinese fishing vessels ""thus preventing the arrests of the erring Chinese fishermen"", the statement said.",121,131,positioned,3,0,3
329E6HTMSW30NWM9MY5AUKSI12KK39,"Two Chinese maritime surveillance ships, identified as Zhonggou Haijian 75 and Zhonggou Haijian 84, later approached and positioned themselves between the Philippine warship and the Chinese fishing vessels ""thus preventing the arrests of the erring Chinese fishermen"", the statement said.",166,173,warship,0,2,2
329E6HTMSW30NWM9MY5AUKSI12KK39,"Two Chinese maritime surveillance ships, identified as Zhonggou Haijian 75 and Zhonggou Haijian 84, later approached and positioned themselves between the Philippine warship and the Chinese fishing vessels ""thus preventing the arrests of the erring Chinese fishermen"", the statement said.",190,205,fishing vessels,1,1,2
329E6HTMSW30NWM9MY5AUKSI12KK39,"Two Chinese maritime surveillance ships, identified as Zhonggou Haijian 75 and Zhonggou Haijian 84, later approached and positioned themselves between the Philippine warship and the Chinese fishing vessels ""thus preventing the arrests of the erring Chinese fishermen"", the statement said.",198,205,vessels,0,2,2
329E6HTMSW30NWM9MY5AUKSI12KK39,"Two Chinese maritime surveillance ships, identified as Zhonggou Haijian 75 and Zhonggou Haijian 84, later approached and positioned themselves between the Philippine warship and the Chinese fishing vessels ""thus preventing the arrests of the erring Chinese fishermen"", the statement said.",212,222,preventing,1,0,1
329E6HTMSW30NWM9MY5AUKSI12KK39,"Two Chinese maritime surveillance ships, identified as Zhonggou Haijian 75 and Zhonggou Haijian 84, later approached and positioned themselves between the Philippine warship and the Chinese fishing vessels ""thus preventing the arrests of the erring Chinese fishermen"", the statement said.",242,248,erring,10,9,19
329E6HTMSW30NWM9MY5AUKSI12KK39,"Chinese officials, who refer to Scarborough Shoal as Huangyan Island, have in the past asserted Chinese sovereignty over the area.",32,43,Scarborough,1,0,1
329E6HTMSW30NWM9MY5AUKSI12KK39,"Chinese officials, who refer to Scarborough Shoal as Huangyan Island, have in the past asserted Chinese sovereignty over the area.",32,49,Scarborough Shoal,1,0,1
329E6HTMSW30NWM9MY5AUKSI12KK39,"Chinese officials, who refer to Scarborough Shoal as Huangyan Island, have in the past asserted Chinese sovereignty over the area.",53,61,Huangyan,1,0,1
329E6HTMSW30NWM9MY5AUKSI12KK39,"Chinese officials, who refer to Scarborough Shoal as Huangyan Island, have in the past asserted Chinese sovereignty over the area.",87,95,asserted,9,5,14
329E6HTMSW30NWM9MY5AUKSI12KK39,"Chinese officials, who refer to Scarborough Shoal as Huangyan Island, have in the past asserted Chinese sovereignty over the area.",104,115,sovereignty,10,10,20
329E6HTMSW30NWM9MY5AUKSI12KK39,"The Philippines refers to the shoal, a rich fishing ground, as Panatag.",16,22,refers,0,2,2
329E6HTMSW30NWM9MY5AUKSI12KK39,"The Philippines refers to the shoal, a rich fishing ground, as Panatag.",30,35,shoal,9,3,12
329E6HTMSW30NWM9MY5AUKSI12KK39,"Last year the Philippines accused Chinese vessels of intruding into other parts of what it considers Philippine territory near the South China Sea, including the Spratlys.",26,33,accused,0,5,5
329E6HTMSW30NWM9MY5AUKSI12KK39,"Last year the Philippines accused Chinese vessels of intruding into other parts of what it considers Philippine territory near the South China Sea, including the Spratlys.",42,49,vessels,1,1,2
329E6HTMSW30NWM9MY5AUKSI12KK39,"Last year the Philippines accused Chinese vessels of intruding into other parts of what it considers Philippine territory near the South China Sea, including the Spratlys.",53,62,intruding,5,6,11
329E6HTMSW30NWM9MY5AUKSI12KK39,"Last year the Philippines accused Chinese vessels of intruding into other parts of what it considers Philippine territory near the South China Sea, including the Spratlys.",53,67,intruding into,0,1,1
329E6HTMSW30NWM9MY5AUKSI12KK39,"Last year the Philippines accused Chinese vessels of intruding into other parts of what it considers Philippine territory near the South China Sea, including the Spratlys.",112,121,territory,2,2,4
329E6HTMSW30NWM9MY5AUKSI12KK39,"Last year the Philippines accused Chinese vessels of intruding into other parts of what it considers Philippine territory near the South China Sea, including the Spratlys.",162,170,Spratlys,2,0,2
3XD2A6FGFNVKQHOX8GFMCJMEIO7S9F,"Thousands of Russians have rallied in Moscow and St Petersburg in the past two days, facing off against tens of thousands of police and interior ministry troops.",0,9,Thousands,1,0,1
3XD2A6FGFNVKQHOX8GFMCJMEIO7S9F,"Thousands of Russians have rallied in Moscow and St Petersburg in the past two days, facing off against tens of thousands of police and interior ministry troops.",22,34,have rallied,0,1,1
3XD2A6FGFNVKQHOX8GFMCJMEIO7S9F,"Thousands of Russians have rallied in Moscow and St Petersburg in the past two days, facing off against tens of thousands of police and interior ministry troops.",27,34,rallied,3,9,12
3XD2A6FGFNVKQHOX8GFMCJMEIO7S9F,"Thousands of Russians have rallied in Moscow and St Petersburg in the past two days, facing off against tens of thousands of police and interior ministry troops.",52,62,Petersburg,1,0,1
3XD2A6FGFNVKQHOX8GFMCJMEIO7S9F,"Thousands of Russians have rallied in Moscow and St Petersburg in the past two days, facing off against tens of thousands of police and interior ministry troops.",85,95,facing off,1,5,6
3XD2A6FGFNVKQHOX8GFMCJMEIO7S9F,"Thousands of Russians have rallied in Moscow and St Petersburg in the past two days, facing off against tens of thousands of police and interior ministry troops.",112,121,thousands,1,0,1
3XD2A6FGFNVKQHOX8GFMCJMEIO7S9F,"Thousands of Russians have rallied in Moscow and St Petersburg in the past two days, facing off against tens of thousands of police and interior ministry troops.",136,144,interior,1,3,4
3XD2A6FGFNVKQHOX8GFMCJMEIO7S9F,"Thousands of Russians have rallied in Moscow and St Petersburg in the past two days, facing off against tens of thousands of police and interior ministry troops.",136,153,interior ministry,1,0,1
3XD2A6FGFNVKQHOX8GFMCJMEIO7S9F,"Thousands of Russians have rallied in Moscow and St Petersburg in the past two days, facing off against tens of thousands of police and interior ministry troops.",136,160,interior ministry troops,2,1,3
3XD2A6FGFNVKQHOX8GFMCJMEIO7S9F,"Thousands of Russians have rallied in Moscow and St Petersburg in the past two days, facing off against tens of thousands of police and interior ministry troops.",145,153,ministry,2,0,2
3XD2A6FGFNVKQHOX8GFMCJMEIO7S9F,"Thousands of Russians have rallied in Moscow and St Petersburg in the past two days, facing off against tens of thousands of police and interior ministry troops.",154,160,troops,0,2,2
3XD2A6FGFNVKQHOX8GFMCJMEIO7S9F,Hundreds of protesters have been detained in both cities.,0,8,Hundreds,1,0,1
3XD2A6FGFNVKQHOX8GFMCJMEIO7S9F,Hundreds of protesters have been detained in both cities.,12,22,protesters,2,4,6
3XD2A6FGFNVKQHOX8GFMCJMEIO7S9F,Hundreds of protesters have been detained in both cities.,33,41,detained,7,10,17
3XD2A6FGFNVKQHOX8GFMCJMEIO7S9F,Gorbachev told the Interfax news agency that authorities must hold a fresh election or deal with a rising tide of discontent.,0,9,Gorbachev,1,0,1
3XD2A6FGFNVKQHOX8GFMCJMEIO7S9F,Gorbachev told the Interfax news agency that authorities must hold a fresh election or deal with a rising tide of discontent.,19,27,Interfax,1,1,2
3XD2A6FGFNVKQHOX8GFMCJMEIO7S9F,Gorbachev told the Interfax news agency that authorities must hold a fresh election or deal with a rising tide of discontent.,62,83,hold a fresh election,1,0,1
3XD2A6FGFNVKQHOX8GFMCJMEIO7S9F,Gorbachev told the Interfax news agency that authorities must hold a fresh election or deal with a rising tide of discontent.,75,83,election,1,0,1
3XD2A6FGFNVKQHOX8GFMCJMEIO7S9F,Gorbachev told the Interfax news agency that authorities must hold a fresh election or deal with a rising tide of discontent.,97,124,a rising tide of discontent,0,1,1
3XD2A6FGFNVKQHOX8GFMCJMEIO7S9F,Gorbachev told the Interfax news agency that authorities must hold a fresh election or deal with a rising tide of discontent.,99,110,rising tide,1,1,2
3XD2A6FGFNVKQHOX8GFMCJMEIO7S9F,Gorbachev told the Interfax news agency that authorities must hold a fresh election or deal with a rising tide of discontent.,99,124,rising tide of discontent,3,3,6
3XD2A6FGFNVKQHOX8GFMCJMEIO7S9F,Gorbachev told the Interfax news agency that authorities must hold a fresh election or deal with a rising tide of discontent.,106,110,tide,0,3,3
3XD2A6FGFNVKQHOX8GFMCJMEIO7S9F,Gorbachev told the Interfax news agency that authorities must hold a fresh election or deal with a rising tide of discontent.,106,124,tide of discontent,1,1,2
3XD2A6FGFNVKQHOX8GFMCJMEIO7S9F,Gorbachev told the Interfax news agency that authorities must hold a fresh election or deal with a rising tide of discontent.,114,124,discontent,6,8,14
3XD2A6FGFNVKQHOX8GFMCJMEIO7S9F,"Vladimir Putin's United Russia party won less than 50% of Sunday's vote, a steep fall from its earlier two-thirds majority, according to preliminary results.",0,8,Vladimir,1,0,1
3XD2A6FGFNVKQHOX8GFMCJMEIO7S9F,"Vladimir Putin's United Russia party won less than 50% of Sunday's vote, a steep fall from its earlier two-thirds majority, according to preliminary results.",75,80,steep,1,2,3
3XD2A6FGFNVKQHOX8GFMCJMEIO7S9F,"Vladimir Putin's United Russia party won less than 50% of Sunday's vote, a steep fall from its earlier two-thirds majority, according to preliminary results.",75,85,steep fall,1,5,6
3XD2A6FGFNVKQHOX8GFMCJMEIO7S9F,"Vladimir Putin's United Russia party won less than 50% of Sunday's vote, a steep fall from its earlier two-thirds majority, according to preliminary results.",114,122,majority,0,2,2
3XD2A6FGFNVKQHOX8GFMCJMEIO7S9F,"Vladimir Putin's United Russia party won less than 50% of Sunday's vote, a steep fall from its earlier two-thirds majority, according to preliminary results.",137,148,preliminary,9,4,13
3XD2A6FGFNVKQHOX8GFMCJMEIO7S9F,"Vladimir Putin's United Russia party won less than 50% of Sunday's vote, a steep fall from its earlier two-thirds majority, according to preliminary results.",137,156,preliminary results,2,2,4
3XD2A6FGFNVKQHOX8GFMCJMEIO7S9F,"But opposition parties and international observers said the vote was marred by vote-rigging, including alleged ballot-box stuffing and false voter rolls.",4,14,opposition,3,1,4
3XD2A6FGFNVKQHOX8GFMCJMEIO7S9F,"But opposition parties and international observers said the vote was marred by vote-rigging, including alleged ballot-box stuffing and false voter rolls.",4,22,opposition parties,1,0,1
3XD2A6FGFNVKQHOX8GFMCJMEIO7S9F,"But opposition parties and international observers said the vote was marred by vote-rigging, including alleged ballot-box stuffing and false voter rolls.",27,40,international,2,0,2
3XD2A6FGFNVKQHOX8GFMCJMEIO7S9F,"But opposition parties and international observers said the vote was marred by vote-rigging, including alleged ballot-box stuffing and false voter rolls.",27,50,international observers,1,0,1
3XD2A6FGFNVKQHOX8GFMCJMEIO7S9F,"But opposition parties and international observers said the vote was marred by vote-rigging, including alleged ballot-box stuffing and false voter rolls.",41,50,observers,1,3,4
3XD2A6FGFNVKQHOX8GFMCJMEIO7S9F,"But opposition parties and international observers said the vote was marred by vote-rigging, including alleged ballot-box stuffing and false voter rolls.",69,75,marred,7,10,17
3XD2A6FGFNVKQHOX8GFMCJMEIO7S9F,"But opposition parties and international observers said the vote was marred by vote-rigging, including alleged ballot-box stuffing and false voter rolls.",69,91,marred by vote-rigging,0,1,1
3XD2A6FGFNVKQHOX8GFMCJMEIO7S9F,"But opposition parties and international observers said the vote was marred by vote-rigging, including alleged ballot-box stuffing and false voter rolls.",79,91,vote-rigging,8,10,18
3XD2A6FGFNVKQHOX8GFMCJMEIO7S9F,"But opposition parties and international observers said the vote was marred by vote-rigging, including alleged ballot-box stuffing and false voter rolls.",103,110,alleged,5,4,9
3XD2A6FGFNVKQHOX8GFMCJMEIO7S9F,"But opposition parties and international observers said the vote was marred by vote-rigging, including alleged ballot-box stuffing and false voter rolls.",103,121,alleged ballot-box,1,1,2
3XD2A6FGFNVKQHOX8GFMCJMEIO7S9F,"But opposition parties and international observers said the vote was marred by vote-rigging, including alleged ballot-box stuffing and false voter rolls.",103,130,alleged ballot-box stuffing,1,3,4
3XD2A6FGFNVKQHOX8GFMCJMEIO7S9F,"But opposition parties and international observers said the vote was marred by vote-rigging, including alleged ballot-box stuffing and false voter rolls.",111,121,ballot-box,0,2,2
3XD2A6FGFNVKQHOX8GFMCJMEIO7S9F,"But opposition parties and international observers said the vote was marred by vote-rigging, including alleged ballot-box stuffing and false voter rolls.",111,130,ballot-box stuffing,5,2,7
3XD2A6FGFNVKQHOX8GFMCJMEIO7S9F,"But opposition parties and international observers said the vote was marred by vote-rigging, including alleged ballot-box stuffing and false voter rolls.",122,130,stuffing,0,4,4
3XD2A6FGFNVKQHOX8GFMCJMEIO7S9F,"But opposition parties and international observers said the vote was marred by vote-rigging, including alleged ballot-box stuffing and false voter rolls.",135,152,false voter rolls,4,1,5
3XD2A6FGFNVKQHOX8GFMCJMEIO7S9F,"But opposition parties and international observers said the vote was marred by vote-rigging, including alleged ballot-box stuffing and false voter rolls.",141,152,voter rolls,0,2,2
3XD2A6FGFNVKQHOX8GFMCJMEIO7S9F,"But opposition parties and international observers said the vote was marred by vote-rigging, including alleged ballot-box stuffing and false voter rolls.",147,152,rolls,0,2,2
3CMIQF80GNRLVI7MI5N5X9GB9MBQ6J,It was the second major assault in Kabul in less than three weeks and highlighted the Taliban's continued ability to strike in the heavily guarded capital even when security had been tightened for Obama's visit and Wednesday's anniversary of the killing of al-Qaida leader Osama bin Laden in neighboring Pakistan.,18,31,major assault,1,1,2
3CMIQF80GNRLVI7MI5N5X9GB9MBQ6J,It was the second major assault in Kabul in less than three weeks and highlighted the Taliban's continued ability to strike in the heavily guarded capital even when security had been tightened for Obama's visit and Wednesday's anniversary of the killing of al-Qaida leader Osama bin Laden in neighboring Pakistan.,24,31,assault,8,10,18
3CMIQF80GNRLVI7MI5N5X9GB9MBQ6J,It was the second major assault in Kabul in less than three weeks and highlighted the Taliban's continued ability to strike in the heavily guarded capital even when security had been tightened for Obama's visit and Wednesday's anniversary of the killing of al-Qaida leader Osama bin Laden in neighboring Pakistan.,44,53,less than,1,0,1
3CMIQF80GNRLVI7MI5N5X9GB9MBQ6J,It was the second major assault in Kabul in less than three weeks and highlighted the Taliban's continued ability to strike in the heavily guarded capital even when security had been tightened for Obama's visit and Wednesday's anniversary of the killing of al-Qaida leader Osama bin Laden in neighboring Pakistan.,70,81,highlighted,6,6,12
3CMIQF80GNRLVI7MI5N5X9GB9MBQ6J,It was the second major assault in Kabul in less than three weeks and highlighted the Taliban's continued ability to strike in the heavily guarded capital even when security had been tightened for Obama's visit and Wednesday's anniversary of the killing of al-Qaida leader Osama bin Laden in neighboring Pakistan.,106,113,ability,1,0,1
3CMIQF80GNRLVI7MI5N5X9GB9MBQ6J,It was the second major assault in Kabul in less than three weeks and highlighted the Taliban's continued ability to strike in the heavily guarded capital even when security had been tightened for Obama's visit and Wednesday's anniversary of the killing of al-Qaida leader Osama bin Laden in neighboring Pakistan.,117,123,strike,0,2,2
3CMIQF80GNRLVI7MI5N5X9GB9MBQ6J,It was the second major assault in Kabul in less than three weeks and highlighted the Taliban's continued ability to strike in the heavily guarded capital even when security had been tightened for Obama's visit and Wednesday's anniversary of the killing of al-Qaida leader Osama bin Laden in neighboring Pakistan.,131,138,heavily,1,0,1
3CMIQF80GNRLVI7MI5N5X9GB9MBQ6J,It was the second major assault in Kabul in less than three weeks and highlighted the Taliban's continued ability to strike in the heavily guarded capital even when security had been tightened for Obama's visit and Wednesday's anniversary of the killing of al-Qaida leader Osama bin Laden in neighboring Pakistan.,131,146,heavily guarded,1,2,3
3CMIQF80GNRLVI7MI5N5X9GB9MBQ6J,It was the second major assault in Kabul in less than three weeks and highlighted the Taliban's continued ability to strike in the heavily guarded capital even when security had been tightened for Obama's visit and Wednesday's anniversary of the killing of al-Qaida leader Osama bin Laden in neighboring Pakistan.,139,146,guarded,1,3,4
3CMIQF80GNRLVI7MI5N5X9GB9MBQ6J,It was the second major assault in Kabul in less than three weeks and highlighted the Taliban's continued ability to strike in the heavily guarded capital even when security had been tightened for Obama's visit and Wednesday's anniversary of the killing of al-Qaida leader Osama bin Laden in neighboring Pakistan.,183,192,tightened,4,4,8
3CMIQF80GNRLVI7MI5N5X9GB9MBQ6J,It was the second major assault in Kabul in less than three weeks and highlighted the Taliban's continued ability to strike in the heavily guarded capital even when security had been tightened for Obama's visit and Wednesday's anniversary of the killing of al-Qaida leader Osama bin Laden in neighboring Pakistan.,227,238,anniversary,2,3,5
3CMIQF80GNRLVI7MI5N5X9GB9MBQ6J,It was the second major assault in Kabul in less than three weeks and highlighted the Taliban's continued ability to strike in the heavily guarded capital even when security had been tightened for Obama's visit and Wednesday's anniversary of the killing of al-Qaida leader Osama bin Laden in neighboring Pakistan.,292,303,neighboring,5,2,7
3CMIQF80GNRLVI7MI5N5X9GB9MBQ6J,"Obama arrived at Bagram Air Field late Tuesday, then traveled to Kabul by helicopter for a meeting with President Hamid Karzai in which they signed an agreement governing the U.S. presence after combat troops withdraw in 2014.",24,33,Air Field,0,1,1
3CMIQF80GNRLVI7MI5N5X9GB9MBQ6J,"Obama arrived at Bagram Air Field late Tuesday, then traveled to Kabul by helicopter for a meeting with President Hamid Karzai in which they signed an agreement governing the U.S. presence after combat troops withdraw in 2014.",74,84,helicopter,2,0,2
3CMIQF80GNRLVI7MI5N5X9GB9MBQ6J,"Obama arrived at Bagram Air Field late Tuesday, then traveled to Kabul by helicopter for a meeting with President Hamid Karzai in which they signed an agreement governing the U.S. presence after combat troops withdraw in 2014.",151,160,agreement,2,0,2
3CMIQF80GNRLVI7MI5N5X9GB9MBQ6J,"Obama arrived at Bagram Air Field late Tuesday, then traveled to Kabul by helicopter for a meeting with President Hamid Karzai in which they signed an agreement governing the U.S. presence after combat troops withdraw in 2014.",161,170,governing,4,3,7
3CMIQF80GNRLVI7MI5N5X9GB9MBQ6J,"Obama arrived at Bagram Air Field late Tuesday, then traveled to Kabul by helicopter for a meeting with President Hamid Karzai in which they signed an agreement governing the U.S. presence after combat troops withdraw in 2014.",161,188,governing the U.S. presence,1,0,1
3CMIQF80GNRLVI7MI5N5X9GB9MBQ6J,"Obama arrived at Bagram Air Field late Tuesday, then traveled to Kabul by helicopter for a meeting with President Hamid Karzai in which they signed an agreement governing the U.S. presence after combat troops withdraw in 2014.",180,188,presence,2,0,2
3CMIQF80GNRLVI7MI5N5X9GB9MBQ6J,"Obama arrived at Bagram Air Field late Tuesday, then traveled to Kabul by helicopter for a meeting with President Hamid Karzai in which they signed an agreement governing the U.S. presence after combat troops withdraw in 2014.",195,201,combat,2,4,6
3CMIQF80GNRLVI7MI5N5X9GB9MBQ6J,"Obama arrived at Bagram Air Field late Tuesday, then traveled to Kabul by helicopter for a meeting with President Hamid Karzai in which they signed an agreement governing the U.S. presence after combat troops withdraw in 2014.",195,208,combat troops,1,3,4
3CMIQF80GNRLVI7MI5N5X9GB9MBQ6J,"Obama arrived at Bagram Air Field late Tuesday, then traveled to Kabul by helicopter for a meeting with President Hamid Karzai in which they signed an agreement governing the U.S. presence after combat troops withdraw in 2014.",209,217,withdraw,2,3,5
3CMIQF80GNRLVI7MI5N5X9GB9MBQ6J,"Later, back at the base, he was surrounded by U.S. troops, shaking every hand.",19,23,base,1,0,1
3CMIQF80GNRLVI7MI5N5X9GB9MBQ6J,"Later, back at the base, he was surrounded by U.S. troops, shaking every hand.",32,42,surrounded,4,3,7
3CMIQF80GNRLVI7MI5N5X9GB9MBQ6J,"He then gave a speech broadcast to Americans back home, before ending his lightning visit just before 4:30 a.m.",15,31,speech broadcast,1,1,2
3CMIQF80GNRLVI7MI5N5X9GB9MBQ6J,"He then gave a speech broadcast to Americans back home, before ending his lightning visit just before 4:30 a.m.",22,31,broadcast,8,5,13
3CMIQF80GNRLVI7MI5N5X9GB9MBQ6J,"He then gave a speech broadcast to Americans back home, before ending his lightning visit just before 4:30 a.m.",63,89,ending his lightning visit,1,0,1
3CMIQF80GNRLVI7MI5N5X9GB9MBQ6J,"He then gave a speech broadcast to Americans back home, before ending his lightning visit just before 4:30 a.m.",74,83,lightning,2,4,6
3CMIQF80GNRLVI7MI5N5X9GB9MBQ6J,"He then gave a speech broadcast to Americans back home, before ending his lightning visit just before 4:30 a.m.",74,89,lightning visit,5,3,8
3M7OI89LVYPH1HX3DNMAD4RU57A6CU,"The United Nations estimates that at least 9,000 people have died in the 14-month crisis, while opposition groups put the death toll at more than 11,000.",19,28,estimates,6,3,9
3M7OI89LVYPH1HX3DNMAD4RU57A6CU,"The United Nations estimates that at least 9,000 people have died in the 14-month crisis, while opposition groups put the death toll at more than 11,000.",82,88,crisis,1,2,3
3M7OI89LVYPH1HX3DNMAD4RU57A6CU,"The United Nations estimates that at least 9,000 people have died in the 14-month crisis, while opposition groups put the death toll at more than 11,000.",96,106,opposition,6,1,7
3M7OI89LVYPH1HX3DNMAD4RU57A6CU,"The United Nations estimates that at least 9,000 people have died in the 14-month crisis, while opposition groups put the death toll at more than 11,000.",96,113,opposition groups,2,0,2
3M7OI89LVYPH1HX3DNMAD4RU57A6CU,"The United Nations estimates that at least 9,000 people have died in the 14-month crisis, while opposition groups put the death toll at more than 11,000.",122,132,death toll,3,1,4
3M7OI89LVYPH1HX3DNMAD4RU57A6CU,"The United Nations estimates that at least 9,000 people have died in the 14-month crisis, while opposition groups put the death toll at more than 11,000.",128,132,toll,1,3,4
3M7OI89LVYPH1HX3DNMAD4RU57A6CU,"Despite the ongoing chaos, Syrian state-run media announced that results from recent parliamentary elections will be announced Tuesday.",0,7,Despite,1,2,3
3M7OI89LVYPH1HX3DNMAD4RU57A6CU,"Despite the ongoing chaos, Syrian state-run media announced that results from recent parliamentary elections will be announced Tuesday.",12,19,ongoing,2,2,4
3M7OI89LVYPH1HX3DNMAD4RU57A6CU,"Despite the ongoing chaos, Syrian state-run media announced that results from recent parliamentary elections will be announced Tuesday.",12,25,ongoing chaos,2,2,4
3M7OI89LVYPH1HX3DNMAD4RU57A6CU,"Despite the ongoing chaos, Syrian state-run media announced that results from recent parliamentary elections will be announced Tuesday.",20,25,chaos,10,4,14
3M7OI89LVYPH1HX3DNMAD4RU57A6CU,"Despite the ongoing chaos, Syrian state-run media announced that results from recent parliamentary elections will be announced Tuesday.",34,43,state-run,1,1,2
3M7OI89LVYPH1HX3DNMAD4RU57A6CU,"Despite the ongoing chaos, Syrian state-run media announced that results from recent parliamentary elections will be announced Tuesday.",34,49,state-run media,1,0,1
3M7OI89LVYPH1HX3DNMAD4RU57A6CU,"Despite the ongoing chaos, Syrian state-run media announced that results from recent parliamentary elections will be announced Tuesday.",50,59,announced,1,1,2
3M7OI89LVYPH1HX3DNMAD4RU57A6CU,"Despite the ongoing chaos, Syrian state-run media announced that results from recent parliamentary elections will be announced Tuesday.",78,84,recent,1,1,2
3M7OI89LVYPH1HX3DNMAD4RU57A6CU,"Despite the ongoing chaos, Syrian state-run media announced that results from recent parliamentary elections will be announced Tuesday.",85,98,parliamentary,9,2,11
3M7OI89LVYPH1HX3DNMAD4RU57A6CU,"Despite the ongoing chaos, Syrian state-run media announced that results from recent parliamentary elections will be announced Tuesday.",85,108,parliamentary elections,1,0,1
3M7OI89LVYPH1HX3DNMAD4RU57A6CU,"Despite the ongoing chaos, Syrian state-run media announced that results from recent parliamentary elections will be announced Tuesday.",99,108,elections,1,0,1
3M7OI89LVYPH1HX3DNMAD4RU57A6CU,"Despite the ongoing chaos, Syrian state-run media announced that results from recent parliamentary elections will be announced Tuesday.",117,126,announced,0,1,1
3M7OI89LVYPH1HX3DNMAD4RU57A6CU,"More than 7,000 candidates vied for 250 parliamentary seats.",16,26,candidates,2,1,3
3M7OI89LVYPH1HX3DNMAD4RU57A6CU,"More than 7,000 candidates vied for 250 parliamentary seats.",27,31,vied,1,5,6
3M7OI89LVYPH1HX3DNMAD4RU57A6CU,"More than 7,000 candidates vied for 250 parliamentary seats.",40,53,parliamentary,2,1,3
3M7OI89LVYPH1HX3DNMAD4RU57A6CU,"More than 7,000 candidates vied for 250 parliamentary seats.",40,59,parliamentary seats,1,0,1
3M7OI89LVYPH1HX3DNMAD4RU57A6CU,"But members of the opposition had urged Syrians to boycott the elections, saying a vote for any of the candidates amounted to a vote for al-Assad, whose family has ruled the country for 42 years.",19,29,opposition,3,0,3
3M7OI89LVYPH1HX3DNMAD4RU57A6CU,"But members of the opposition had urged Syrians to boycott the elections, saying a vote for any of the candidates amounted to a vote for al-Assad, whose family has ruled the country for 42 years.",34,39,urged,2,5,7
3M7OI89LVYPH1HX3DNMAD4RU57A6CU,"But members of the opposition had urged Syrians to boycott the elections, saying a vote for any of the candidates amounted to a vote for al-Assad, whose family has ruled the country for 42 years.",51,58,boycott,10,6,16
3M7OI89LVYPH1HX3DNMAD4RU57A6CU,"But members of the opposition had urged Syrians to boycott the elections, saying a vote for any of the candidates amounted to a vote for al-Assad, whose family has ruled the country for 42 years.",103,113,candidates,1,0,1
3M7OI89LVYPH1HX3DNMAD4RU57A6CU,"But members of the opposition had urged Syrians to boycott the elections, saying a vote for any of the candidates amounted to a vote for al-Assad, whose family has ruled the country for 42 years.",114,122,amounted,4,4,8
3M7OI89LVYPH1HX3DNMAD4RU57A6CU,"This reform will grant credibility and build confidence in the financial sector, increase credit flow in our country and lead to home sales at reasonable prices, Deputy Prime Minister Soraya Saenz de Santamaria said at a news conference.",6,12,reform,4,2,6
3M7OI89LVYPH1HX3DNMAD4RU57A6CU,"This reform will grant credibility and build confidence in the financial sector, increase credit flow in our country and lead to home sales at reasonable prices, Deputy Prime Minister Soraya Saenz de Santamaria said at a news conference.",18,23,grant,0,1,1
3M7OI89LVYPH1HX3DNMAD4RU57A6CU,"This reform will grant credibility and build confidence in the financial sector, increase credit flow in our country and lead to home sales at reasonable prices, Deputy Prime Minister Soraya Saenz de Santamaria said at a news conference.",18,35,grant credibility,2,0,2
3M7OI89LVYPH1HX3DNMAD4RU57A6CU,"This reform will grant credibility and build confidence in the financial sector, increase credit flow in our country and lead to home sales at reasonable prices, Deputy Prime Minister Soraya Saenz de Santamaria said at a news conference.",24,35,credibility,10,6,16
3M7OI89LVYPH1HX3DNMAD4RU57A6CU,"This reform will grant credibility and build confidence in the financial sector, increase credit flow in our country and lead to home sales at reasonable prices, Deputy Prime Minister Soraya Saenz de Santamaria said at a news conference.",46,56,confidence,2,1,3
3M7OI89LVYPH1HX3DNMAD4RU57A6CU,"This reform will grant credibility and build confidence in the financial sector, increase credit flow in our country and lead to home sales at reasonable prices, Deputy Prime Minister Soraya Saenz de Santamaria said at a news conference.",64,80,financial sector,3,0,3
3M7OI89LVYPH1HX3DNMAD4RU57A6CU,"This reform will grant credibility and build confidence in the financial sector, increase credit flow in our country and lead to home sales at reasonable prices, Deputy Prime Minister Soraya Saenz de Santamaria said at a news conference.",74,80,sector,3,0,3
3M7OI89LVYPH1HX3DNMAD4RU57A6CU,"This reform will grant credibility and build confidence in the financial sector, increase credit flow in our country and lead to home sales at reasonable prices, Deputy Prime Minister Soraya Saenz de Santamaria said at a news conference.",82,102,increase credit flow,1,0,1
3M7OI89LVYPH1HX3DNMAD4RU57A6CU,"This reform will grant credibility and build confidence in the financial sector, increase credit flow in our country and lead to home sales at reasonable prices, Deputy Prime Minister Soraya Saenz de Santamaria said at a news conference.",91,97,credit,1,0,1
3M7OI89LVYPH1HX3DNMAD4RU57A6CU,"This reform will grant credibility and build confidence in the financial sector, increase credit flow in our country and lead to home sales at reasonable prices, Deputy Prime Minister Soraya Saenz de Santamaria said at a news conference.",91,102,credit flow,3,1,4
3M7OI89LVYPH1HX3DNMAD4RU57A6CU,"This reform will grant credibility and build confidence in the financial sector, increase credit flow in our country and lead to home sales at reasonable prices, Deputy Prime Minister Soraya Saenz de Santamaria said at a news conference.",98,102,flow,0,1,1
3M7OI89LVYPH1HX3DNMAD4RU57A6CU,"This reform will grant credibility and build confidence in the financial sector, increase credit flow in our country and lead to home sales at reasonable prices, Deputy Prime Minister Soraya Saenz de Santamaria said at a news conference.",144,154,reasonable,2,1,3
3M7OI89LVYPH1HX3DNMAD4RU57A6CU,"This reform will grant credibility and build confidence in the financial sector, increase credit flow in our country and lead to home sales at reasonable prices, Deputy Prime Minister Soraya Saenz de Santamaria said at a news conference.",228,238,conference,2,1,3
356ZPKYPUHI2EQGDOB38GVAU4DLPYL,"Mr McGuinness, who is MP for the area, said: ""This family is clearly deeply shocked and traumatised by what has happened over the weekend.",15,37,who is MP for the area,1,0,1
356ZPKYPUHI2EQGDOB38GVAU4DLPYL,"Mr McGuinness, who is MP for the area, said: ""This family is clearly deeply shocked and traumatised by what has happened over the weekend.",69,75,deeply,0,1,1
356ZPKYPUHI2EQGDOB38GVAU4DLPYL,"Mr McGuinness, who is MP for the area, said: ""This family is clearly deeply shocked and traumatised by what has happened over the weekend.",69,83,deeply shocked,0,1,1
356ZPKYPUHI2EQGDOB38GVAU4DLPYL,"Mr McGuinness, who is MP for the area, said: ""This family is clearly deeply shocked and traumatised by what has happened over the weekend.",76,83,shocked,1,0,1
356ZPKYPUHI2EQGDOB38GVAU4DLPYL,"Mr McGuinness, who is MP for the area, said: ""This family is clearly deeply shocked and traumatised by what has happened over the weekend.",76,99,shocked and traumatised,0,1,1
356ZPKYPUHI2EQGDOB38GVAU4DLPYL,"Mr McGuinness, who is MP for the area, said: ""This family is clearly deeply shocked and traumatised by what has happened over the weekend.",88,99,traumatised,10,10,20
356ZPKYPUHI2EQGDOB38GVAU4DLPYL,"Their daughter has been murdered and another daughter seriously injured.	25	33	murdered	2	3	5
356ZPKYPUHI2EQGDOB38GVAU4DLPYL	Their daughter has been murdered and another daughter seriously injured.",55,64,seriously,0,1,1
356ZPKYPUHI2EQGDOB38GVAU4DLPYL,"Their daughter has been murdered and another daughter seriously injured.	55	72	seriously injured	2	1	3
356ZPKYPUHI2EQGDOB38GVAU4DLPYL	I spent some time with the family and offered our support and that of the wider community at this time.",62,89,that of the wider community,1,0,1
356ZPKYPUHI2EQGDOB38GVAU4DLPYL,"I spent some time with the family and offered our support and that of the wider community at this time.""",74,79,wider,0,2,2
356ZPKYPUHI2EQGDOB38GVAU4DLPYL,"I spent some time with the family and offered our support and that of the wider community at this time.""",74,89,wider community,4,4,8
356ZPKYPUHI2EQGDOB38GVAU4DLPYL,"I spent some time with the family and offered our support and that of the wider community at this time.""",80,89,community,1,0,1
356ZPKYPUHI2EQGDOB38GVAU4DLPYL,"It is understood the dead girl was living at her family home, in a neighbouring housing estate, and was visiting her older sister at the time of the shooting.",6,16,understood,1,0,1
356ZPKYPUHI2EQGDOB38GVAU4DLPYL,"It is understood the dead girl was living at her family home, in a neighbouring housing estate, and was visiting her older sister at the time of the shooting.",67,79,neighbouring,3,5,8
356ZPKYPUHI2EQGDOB38GVAU4DLPYL,"It is understood the dead girl was living at her family home, in a neighbouring housing estate, and was visiting her older sister at the time of the shooting.",67,94,neighbouring housing estate,4,1,5
356ZPKYPUHI2EQGDOB38GVAU4DLPYL,"It is understood the dead girl was living at her family home, in a neighbouring housing estate, and was visiting her older sister at the time of the shooting.",80,87,housing,0,1,1
356ZPKYPUHI2EQGDOB38GVAU4DLPYL,"It is understood the dead girl was living at her family home, in a neighbouring housing estate, and was visiting her older sister at the time of the shooting.",80,94,housing estate,1,1,2
356ZPKYPUHI2EQGDOB38GVAU4DLPYL,"It is understood the dead girl was living at her family home, in a neighbouring housing estate, and was visiting her older sister at the time of the shooting.",149,157,shooting,0,1,1
356ZPKYPUHI2EQGDOB38GVAU4DLPYL,"Bellaghy parish priest Fr Andrew Dolan said the teenager died trying to protect her sister: ""When Brenda was under attack, Lauren dived in to save her and in the process lost her own life.",0,8,Bellaghy,1,0,1
356ZPKYPUHI2EQGDOB38GVAU4DLPYL,"Bellaghy parish priest Fr Andrew Dolan said the teenager died trying to protect her sister: ""When Brenda was under attack, Lauren dived in to save her and in the process lost her own life.",0,22,Bellaghy parish priest,1,0,1
356ZPKYPUHI2EQGDOB38GVAU4DLPYL,"Bellaghy parish priest Fr Andrew Dolan said the teenager died trying to protect her sister: ""When Brenda was under attack, Lauren dived in to save her and in the process lost her own life.",9,15,parish,2,4,6
356ZPKYPUHI2EQGDOB38GVAU4DLPYL,"Bellaghy parish priest Fr Andrew Dolan said the teenager died trying to protect her sister: ""When Brenda was under attack, Lauren dived in to save her and in the process lost her own life.",9,22,parish priest,0,1,1
356ZPKYPUHI2EQGDOB38GVAU4DLPYL,"Bellaghy parish priest Fr Andrew Dolan said the teenager died trying to protect her sister: ""When Brenda was under attack, Lauren dived in to save her and in the process lost her own life.",23,25,Fr,1,0,1
356ZPKYPUHI2EQGDOB38GVAU4DLPYL,"Bellaghy parish priest Fr Andrew Dolan said the teenager died trying to protect her sister: ""When Brenda was under attack, Lauren dived in to save her and in the process lost her own life.",123,150,Lauren dived in to save her,1,0,1
356ZPKYPUHI2EQGDOB38GVAU4DLPYL,"Bellaghy parish priest Fr Andrew Dolan said the teenager died trying to protect her sister: ""When Brenda was under attack, Lauren dived in to save her and in the process lost her own life.",130,135,dived,1,1,2
356ZPKYPUHI2EQGDOB38GVAU4DLPYL,"Bellaghy parish priest Fr Andrew Dolan said the teenager died trying to protect her sister: ""When Brenda was under attack, Lauren dived in to save her and in the process lost her own life.",130,138,dived in,1,4,5
356ZPKYPUHI2EQGDOB38GVAU4DLPYL,"Bellaghy parish priest Fr Andrew Dolan said the teenager died trying to protect her sister: ""When Brenda was under attack, Lauren dived in to save her and in the process lost her own life.",155,169,in the process,1,0,1
356ZPKYPUHI2EQGDOB38GVAU4DLPYL,"Bellaghy parish priest Fr Andrew Dolan said the teenager died trying to protect her sister: ""When Brenda was under attack, Lauren dived in to save her and in the process lost her own life.",162,169,process,3,1,4
356ZPKYPUHI2EQGDOB38GVAU4DLPYL,"He told the BBC: ""I'd say they were close in life and in death couldn't be closer.""",54,80,in death couldnt be closer,1,0,1
356ZPKYPUHI2EQGDOB38GVAU4DLPYL,"He told the BBC: ""I'd say they were close in life and in death couldn't be closer.""",63,80,couldnt be closer,0,1,1
3ICOHX7ENCC1K4V27PCOURH6ET40EA,"China's official approval of the deal has been a long time coming - Google managed to score regulatory approvals from the U.S. Department of Justice and the European Commission back in February (on the same day no less), but China's anti-monopoly bureau leapt into action just a few days later.",8,16,official,0,1,1
3ICOHX7ENCC1K4V27PCOURH6ET40EA,"China's official approval of the deal has been a long time coming - Google managed to score regulatory approvals from the U.S. Department of Justice and the European Commission back in February (on the same day no less), but China's anti-monopoly bureau leapt into action just a few days later.",8,25,official approval,2,0,2
3ICOHX7ENCC1K4V27PCOURH6ET40EA,"China's official approval of the deal has been a long time coming - Google managed to score regulatory approvals from the U.S. Department of Justice and the European Commission back in February (on the same day no less), but China's anti-monopoly bureau leapt into action just a few days later.",17,25,approval,1,3,4
3ICOHX7ENCC1K4V27PCOURH6ET40EA,"China's official approval of the deal has been a long time coming - Google managed to score regulatory approvals from the U.S. Department of Justice and the European Commission back in February (on the same day no less), but China's anti-monopoly bureau leapt into action just a few days later.",33,37,deal,0,1,1
3ICOHX7ENCC1K4V27PCOURH6ET40EA,"China's official approval of the deal has been a long time coming - Google managed to score regulatory approvals from the U.S. Department of Justice and the European Commission back in February (on the same day no less), but China's anti-monopoly bureau leapt into action just a few days later.",47,65,a long time coming,1,0,1
3ICOHX7ENCC1K4V27PCOURH6ET40EA,"China's official approval of the deal has been a long time coming - Google managed to score regulatory approvals from the U.S. Department of Justice and the European Commission back in February (on the same day no less), but China's anti-monopoly bureau leapt into action just a few days later.",49,65,long time coming,0,1,1
3ICOHX7ENCC1K4V27PCOURH6ET40EA,"China's official approval of the deal has been a long time coming - Google managed to score regulatory approvals from the U.S. Department of Justice and the European Commission back in February (on the same day no less), but China's anti-monopoly bureau leapt into action just a few days later.",86,91,score,1,1,2
3ICOHX7ENCC1K4V27PCOURH6ET40EA,"China's official approval of the deal has been a long time coming - Google managed to score regulatory approvals from the U.S. Department of Justice and the European Commission back in February (on the same day no less), but China's anti-monopoly bureau leapt into action just a few days later.",92,102,regulatory,7,3,10
3ICOHX7ENCC1K4V27PCOURH6ET40EA,"China's official approval of the deal has been a long time coming - Google managed to score regulatory approvals from the U.S. Department of Justice and the European Commission back in February (on the same day no less), but China's anti-monopoly bureau leapt into action just a few days later.",92,112,regulatory approvals,4,4,8
3ICOHX7ENCC1K4V27PCOURH6ET40EA,"China's official approval of the deal has been a long time coming - Google managed to score regulatory approvals from the U.S. Department of Justice and the European Commission back in February (on the same day no less), but China's anti-monopoly bureau leapt into action just a few days later.",157,176,European Commission,2,0,2
3ICOHX7ENCC1K4V27PCOURH6ET40EA,"China's official approval of the deal has been a long time coming - Google managed to score regulatory approvals from the U.S. Department of Justice and the European Commission back in February (on the same day no less), but China's anti-monopoly bureau leapt into action just a few days later.",166,176,Commission,1,0,1
3ICOHX7ENCC1K4V27PCOURH6ET40EA,"China's official approval of the deal has been a long time coming - Google managed to score regulatory approvals from the U.S. Department of Justice and the European Commission back in February (on the same day no less), but China's anti-monopoly bureau leapt into action just a few days later.",233,246,anti-monopoly,8,7,15
3ICOHX7ENCC1K4V27PCOURH6ET40EA,"China's official approval of the deal has been a long time coming - Google managed to score regulatory approvals from the U.S. Department of Justice and the European Commission back in February (on the same day no less), but China's anti-monopoly bureau leapt into action just a few days later.",233,253,anti-monopoly bureau,4,2,6
3ICOHX7ENCC1K4V27PCOURH6ET40EA,"China's official approval of the deal has been a long time coming - Google managed to score regulatory approvals from the U.S. Department of Justice and the European Commission back in February (on the same day no less), but China's anti-monopoly bureau leapt into action just a few days later.",233,259,anti-monopoly bureau leapt,2,0,2
3ICOHX7ENCC1K4V27PCOURH6ET40EA,"China's official approval of the deal has been a long time coming - Google managed to score regulatory approvals from the U.S. Department of Justice and the European Commission back in February (on the same day no less), but China's anti-monopoly bureau leapt into action just a few days later.",233,271,anti-monopoly bureau leapt into action,0,1,1
3ICOHX7ENCC1K4V27PCOURH6ET40EA,"China's official approval of the deal has been a long time coming - Google managed to score regulatory approvals from the U.S. Department of Justice and the European Commission back in February (on the same day no less), but China's anti-monopoly bureau leapt into action just a few days later.",247,253,bureau,8,1,9
3ICOHX7ENCC1K4V27PCOURH6ET40EA,"China's official approval of the deal has been a long time coming - Google managed to score regulatory approvals from the U.S. Department of Justice and the European Commission back in February (on the same day no less), but China's anti-monopoly bureau leapt into action just a few days later.",247,259,bureau leapt,0,1,1
3ICOHX7ENCC1K4V27PCOURH6ET40EA,"China's official approval of the deal has been a long time coming - Google managed to score regulatory approvals from the U.S. Department of Justice and the European Commission back in February (on the same day no less), but China's anti-monopoly bureau leapt into action just a few days later.",254,259,leapt,1,8,9
3ICOHX7ENCC1K4V27PCOURH6ET40EA,"That period of intense regulatory scrutiny is a routine part of the purchasing process, as every company that makes more than 400 million yuan ($63 million) in China and 10 billion yuan ($1.6 billion) globally is subject to the process.",5,11,period,1,0,1
3ICOHX7ENCC1K4V27PCOURH6ET40EA,"That period of intense regulatory scrutiny is a routine part of the purchasing process, as every company that makes more than 400 million yuan ($63 million) in China and 10 billion yuan ($1.6 billion) globally is subject to the process.",15,22,intense,1,5,6
3ICOHX7ENCC1K4V27PCOURH6ET40EA,"That period of intense regulatory scrutiny is a routine part of the purchasing process, as every company that makes more than 400 million yuan ($63 million) in China and 10 billion yuan ($1.6 billion) globally is subject to the process.",15,42,intense regulatory scrutiny,2,1,3
3ICOHX7ENCC1K4V27PCOURH6ET40EA,"That period of intense regulatory scrutiny is a routine part of the purchasing process, as every company that makes more than 400 million yuan ($63 million) in China and 10 billion yuan ($1.6 billion) globally is subject to the process.",23,33,regulatory,2,0,2
3ICOHX7ENCC1K4V27PCOURH6ET40EA,"That period of intense regulatory scrutiny is a routine part of the purchasing process, as every company that makes more than 400 million yuan ($63 million) in China and 10 billion yuan ($1.6 billion) globally is subject to the process.",23,42,regulatory scrutiny,7,0,7
3ICOHX7ENCC1K4V27PCOURH6ET40EA,"That period of intense regulatory scrutiny is a routine part of the purchasing process, as every company that makes more than 400 million yuan ($63 million) in China and 10 billion yuan ($1.6 billion) globally is subject to the process.",34,42,scrutiny,6,8,14
3ICOHX7ENCC1K4V27PCOURH6ET40EA,"That period of intense regulatory scrutiny is a routine part of the purchasing process, as every company that makes more than 400 million yuan ($63 million) in China and 10 billion yuan ($1.6 billion) globally is subject to the process.",48,55,routine,1,2,3
3ICOHX7ENCC1K4V27PCOURH6ET40EA,"That period of intense regulatory scrutiny is a routine part of the purchasing process, as every company that makes more than 400 million yuan ($63 million) in China and 10 billion yuan ($1.6 billion) globally is subject to the process.",68,78,purchasing,1,0,1
3ICOHX7ENCC1K4V27PCOURH6ET40EA,"That period of intense regulatory scrutiny is a routine part of the purchasing process, as every company that makes more than 400 million yuan ($63 million) in China and 10 billion yuan ($1.6 billion) globally is subject to the process.",68,86,purchasing process,1,0,1
3ICOHX7ENCC1K4V27PCOURH6ET40EA,"That period of intense regulatory scrutiny is a routine part of the purchasing process, as every company that makes more than 400 million yuan ($63 million) in China and 10 billion yuan ($1.6 billion) globally is subject to the process.",181,185,yuan,1,0,1
3ICOHX7ENCC1K4V27PCOURH6ET40EA,"That period of intense regulatory scrutiny is a routine part of the purchasing process, as every company that makes more than 400 million yuan ($63 million) in China and 10 billion yuan ($1.6 billion) globally is subject to the process.",201,209,globally,4,3,7
3ICOHX7ENCC1K4V27PCOURH6ET40EA,"That period of intense regulatory scrutiny is a routine part of the purchasing process, as every company that makes more than 400 million yuan ($63 million) in China and 10 billion yuan ($1.6 billion) globally is subject to the process.",210,220,is subject,1,0,1
3ICOHX7ENCC1K4V27PCOURH6ET40EA,"That period of intense regulatory scrutiny is a routine part of the purchasing process, as every company that makes more than 400 million yuan ($63 million) in China and 10 billion yuan ($1.6 billion) globally is subject to the process.",213,220,subject,1,0,1
3ICOHX7ENCC1K4V27PCOURH6ET40EA,"Google and Motorola originally expected to close the deal in early 2012″, and it turns out they weren't too far from the market.",20,30,originally,1,1,2
3ICOHX7ENCC1K4V27PCOURH6ET40EA,"Google and Motorola originally expected to close the deal in early 2012″, and it turns out they weren't too far from the market.",20,39,originally expected,1,0,1
3ICOHX7ENCC1K4V27PCOURH6ET40EA,"Google and Motorola originally expected to close the deal in early 2012″, and it turns out they weren't too far from the market.",43,57,close the deal,2,0,2
3ICOHX7ENCC1K4V27PCOURH6ET40EA,"Google and Motorola originally expected to close the deal in early 2012″, and it turns out they weren't too far from the market.",53,57,deal,0,1,1
3ICOHX7ENCC1K4V27PCOURH6ET40EA,"Google and Motorola originally expected to close the deal in early 2012″, and it turns out they weren't too far from the market.",97,103,werent,1,1,2
3ICOHX7ENCC1K4V27PCOURH6ET40EA,"With this final approval in place, Google has confirmed that they expect purchase to be completed some time next week.",10,24,final approval,0,1,1
3ICOHX7ENCC1K4V27PCOURH6ET40EA,"With this final approval in place, Google has confirmed that they expect purchase to be completed some time next week.",46,55,confirmed,3,3,6
3ICOHX7ENCC1K4V27PCOURH6ET40EA,"With this final approval in place, Google has confirmed that they expect purchase to be completed some time next week.",73,81,purchase,0,2,2
3UEDKCTP9VRIOFNWOA80714Y53I7KA,"The insurgency also claimed their spring offensive, which began two weeks ago with attacks in Kabul, would be renewed on Thursday, despite a security clamp-down in the capital.",4,14,insurgency,10,10,20
3UEDKCTP9VRIOFNWOA80714Y53I7KA,"The insurgency also claimed their spring offensive, which began two weeks ago with attacks in Kabul, would be renewed on Thursday, despite a security clamp-down in the capital.",20,27,claimed,1,0,1
3UEDKCTP9VRIOFNWOA80714Y53I7KA,"The insurgency also claimed their spring offensive, which began two weeks ago with attacks in Kabul, would be renewed on Thursday, despite a security clamp-down in the capital.",34,40,spring,0,1,1
3UEDKCTP9VRIOFNWOA80714Y53I7KA,"The insurgency also claimed their spring offensive, which began two weeks ago with attacks in Kabul, would be renewed on Thursday, despite a security clamp-down in the capital.",34,50,spring offensive,4,2,6
3UEDKCTP9VRIOFNWOA80714Y53I7KA,"The insurgency also claimed their spring offensive, which began two weeks ago with attacks in Kabul, would be renewed on Thursday, despite a security clamp-down in the capital.",41,50,offensive,5,3,8
3UEDKCTP9VRIOFNWOA80714Y53I7KA,"The insurgency also claimed their spring offensive, which began two weeks ago with attacks in Kabul, would be renewed on Thursday, despite a security clamp-down in the capital.",110,117,renewed,4,1,5
3UEDKCTP9VRIOFNWOA80714Y53I7KA,"The insurgency also claimed their spring offensive, which began two weeks ago with attacks in Kabul, would be renewed on Thursday, despite a security clamp-down in the capital.",131,138,despite,0,2,2
3UEDKCTP9VRIOFNWOA80714Y53I7KA,"The insurgency also claimed their spring offensive, which began two weeks ago with attacks in Kabul, would be renewed on Thursday, despite a security clamp-down in the capital.",141,160,security clamp-down,4,1,5
3UEDKCTP9VRIOFNWOA80714Y53I7KA,"The insurgency also claimed their spring offensive, which began two weeks ago with attacks in Kabul, would be renewed on Thursday, despite a security clamp-down in the capital.",150,160,clamp-down,8,10,18
3UEDKCTP9VRIOFNWOA80714Y53I7KA,"Obama's visit came a year after U.S. special forces troops killed al Qaeda leader Osama bin Laden, the architect of the September 11, 2001, attacks, in a raid in neighboring Pakistan.",37,51,special forces,1,0,1
3UEDKCTP9VRIOFNWOA80714Y53I7KA,"Obama's visit came a year after U.S. special forces troops killed al Qaeda leader Osama bin Laden, the architect of the September 11, 2001, attacks, in a raid in neighboring Pakistan.",37,58,special forces troops,1,0,1
3UEDKCTP9VRIOFNWOA80714Y53I7KA,"Obama's visit came a year after U.S. special forces troops killed al Qaeda leader Osama bin Laden, the architect of the September 11, 2001, attacks, in a raid in neighboring Pakistan.",103,112,architect,9,5,14
3UEDKCTP9VRIOFNWOA80714Y53I7KA,"Obama's visit came a year after U.S. special forces troops killed al Qaeda leader Osama bin Laden, the architect of the September 11, 2001, attacks, in a raid in neighboring Pakistan.",154,158,raid,3,2,5
3UEDKCTP9VRIOFNWOA80714Y53I7KA,"In a televised address to the American people from a base north of Kabul, he said the war in Afghanistan was winding down.",5,14,televised,1,0,1
3UEDKCTP9VRIOFNWOA80714Y53I7KA,"In a televised address to the American people from a base north of Kabul, he said the war in Afghanistan was winding down.",5,22,televised address,1,1,2
3UEDKCTP9VRIOFNWOA80714Y53I7KA,"In a televised address to the American people from a base north of Kabul, he said the war in Afghanistan was winding down.",15,22,address,1,0,1
3UEDKCTP9VRIOFNWOA80714Y53I7KA,"In a televised address to the American people from a base north of Kabul, he said the war in Afghanistan was winding down.",53,57,base,1,0,1
3UEDKCTP9VRIOFNWOA80714Y53I7KA,"In a televised address to the American people from a base north of Kabul, he said the war in Afghanistan was winding down.",109,116,winding,0,5,5
3UEDKCTP9VRIOFNWOA80714Y53I7KA,"In a televised address to the American people from a base north of Kabul, he said the war in Afghanistan was winding down.",109,121,winding down,6,4,10
3UEDKCTP9VRIOFNWOA80714Y53I7KA,"As we emerge from a decade of conflict abroad and economic crisis at home, it's time to renew America, Obama said, speaking against a backdrop of armored vehicles and a U.S. flag.",7,13,emerge,1,5,6
3UEDKCTP9VRIOFNWOA80714Y53I7KA,"As we emerge from a decade of conflict abroad and economic crisis at home, it's time to renew America, Obama said, speaking against a backdrop of armored vehicles and a U.S. flag.",21,27,decade,1,2,3
3UEDKCTP9VRIOFNWOA80714Y53I7KA,"As we emerge from a decade of conflict abroad and economic crisis at home, it's time to renew America, Obama said, speaking against a backdrop of armored vehicles and a U.S. flag.",31,39,conflict,1,1,2
3UEDKCTP9VRIOFNWOA80714Y53I7KA,"As we emerge from a decade of conflict abroad and economic crisis at home, it's time to renew America, Obama said, speaking against a backdrop of armored vehicles and a U.S. flag.",31,46,conflict abroad,1,0,1
3UEDKCTP9VRIOFNWOA80714Y53I7KA,"As we emerge from a decade of conflict abroad and economic crisis at home, it's time to renew America, Obama said, speaking against a backdrop of armored vehicles and a U.S. flag.",40,46,abroad,0,3,3
3UEDKCTP9VRIOFNWOA80714Y53I7KA,"As we emerge from a decade of conflict abroad and economic crisis at home, it's time to renew America, Obama said, speaking against a backdrop of armored vehicles and a U.S. flag.",51,59,economic,1,0,1
3UEDKCTP9VRIOFNWOA80714Y53I7KA,"As we emerge from a decade of conflict abroad and economic crisis at home, it's time to renew America, Obama said, speaking against a backdrop of armored vehicles and a U.S. flag.",51,66,economic crisis,3,0,3
3UEDKCTP9VRIOFNWOA80714Y53I7KA,"As we emerge from a decade of conflict abroad and economic crisis at home, it's time to renew America, Obama said, speaking against a backdrop of armored vehicles and a U.S. flag.",60,66,crisis,0,1,1
3UEDKCTP9VRIOFNWOA80714Y53I7KA,"As we emerge from a decade of conflict abroad and economic crisis at home, it's time to renew America, Obama said, speaking against a backdrop of armored vehicles and a U.S. flag.",89,94,renew,2,1,3
3UEDKCTP9VRIOFNWOA80714Y53I7KA,"As we emerge from a decade of conflict abroad and economic crisis at home, it's time to renew America, Obama said, speaking against a backdrop of armored vehicles and a U.S. flag.",136,144,backdrop,9,10,19
3UEDKCTP9VRIOFNWOA80714Y53I7KA,"As we emerge from a decade of conflict abroad and economic crisis at home, it's time to renew America, Obama said, speaking against a backdrop of armored vehicles and a U.S. flag.",136,164,backdrop of armored vehicles,1,0,1
3UEDKCTP9VRIOFNWOA80714Y53I7KA,"As we emerge from a decade of conflict abroad and economic crisis at home, it's time to renew America, Obama said, speaking against a backdrop of armored vehicles and a U.S. flag.",148,155,armored,3,2,5
3UEDKCTP9VRIOFNWOA80714Y53I7KA,"As we emerge from a decade of conflict abroad and economic crisis at home, it's time to renew America, Obama said, speaking against a backdrop of armored vehicles and a U.S. flag.",148,164,armored vehicles,3,3,6
32204AGAABDAFIXPBS9X0M1ZCDIGHF,A lieutenant who had defected was also killed in the clashes.,2,12,lieutenant,10,3,13
32204AGAABDAFIXPBS9X0M1ZCDIGHF,A lieutenant who had defected was also killed in the clashes.,21,29,defected,7,8,15
32204AGAABDAFIXPBS9X0M1ZCDIGHF,A lieutenant who had defected was also killed in the clashes.,53,60,clashes,4,4,8
32204AGAABDAFIXPBS9X0M1ZCDIGHF,Regime forces launched an offensive on Rastan at the weekend but met with sharp resistance from rebels seeking the ouster of the regime of President Bashar al-Assad.,0,6,Regime,4,2,6
32204AGAABDAFIXPBS9X0M1ZCDIGHF,Regime forces launched an offensive on Rastan at the weekend but met with sharp resistance from rebels seeking the ouster of the regime of President Bashar al-Assad.,0,13,Regime forces,2,2,4
32204AGAABDAFIXPBS9X0M1ZCDIGHF,Regime forces launched an offensive on Rastan at the weekend but met with sharp resistance from rebels seeking the ouster of the regime of President Bashar al-Assad.,14,22,launched,0,2,2
32204AGAABDAFIXPBS9X0M1ZCDIGHF,Regime forces launched an offensive on Rastan at the weekend but met with sharp resistance from rebels seeking the ouster of the regime of President Bashar al-Assad.,26,35,offensive,5,4,9
32204AGAABDAFIXPBS9X0M1ZCDIGHF,Regime forces launched an offensive on Rastan at the weekend but met with sharp resistance from rebels seeking the ouster of the regime of President Bashar al-Assad.,74,79,sharp,0,1,1
32204AGAABDAFIXPBS9X0M1ZCDIGHF,Regime forces launched an offensive on Rastan at the weekend but met with sharp resistance from rebels seeking the ouster of the regime of President Bashar al-Assad.,74,90,sharp resistance,2,0,2
32204AGAABDAFIXPBS9X0M1ZCDIGHF,Regime forces launched an offensive on Rastan at the weekend but met with sharp resistance from rebels seeking the ouster of the regime of President Bashar al-Assad.,80,90,resistance,5,4,9
32204AGAABDAFIXPBS9X0M1ZCDIGHF,Regime forces launched an offensive on Rastan at the weekend but met with sharp resistance from rebels seeking the ouster of the regime of President Bashar al-Assad.,96,102,rebels,1,2,3
32204AGAABDAFIXPBS9X0M1ZCDIGHF,Regime forces launched an offensive on Rastan at the weekend but met with sharp resistance from rebels seeking the ouster of the regime of President Bashar al-Assad.,103,110,seeking,0,1,1
32204AGAABDAFIXPBS9X0M1ZCDIGHF,Regime forces launched an offensive on Rastan at the weekend but met with sharp resistance from rebels seeking the ouster of the regime of President Bashar al-Assad.,115,121,ouster,7,8,15
32204AGAABDAFIXPBS9X0M1ZCDIGHF,Regime forces launched an offensive on Rastan at the weekend but met with sharp resistance from rebels seeking the ouster of the regime of President Bashar al-Assad.,129,135,regime,4,2,6
32204AGAABDAFIXPBS9X0M1ZCDIGHF,Regime forces launched an offensive on Rastan at the weekend but met with sharp resistance from rebels seeking the ouster of the regime of President Bashar al-Assad.,149,164,Bashar al-Assad,1,0,1
32204AGAABDAFIXPBS9X0M1ZCDIGHF,The Observatory said dozens had been wounded in shelling of the city by Syrian troops.,4,15,Observatory,2,2,4
32204AGAABDAFIXPBS9X0M1ZCDIGHF,The Observatory said dozens had been wounded in shelling of the city by Syrian troops.,37,44,wounded,0,2,2
32204AGAABDAFIXPBS9X0M1ZCDIGHF,The Observatory said dozens had been wounded in shelling of the city by Syrian troops.,48,56,shelling,4,6,10
32204AGAABDAFIXPBS9X0M1ZCDIGHF,"The bombardment by regime forces resumed following the deadly clashes, it added.",4,15,bombardment,10,7,17
32204AGAABDAFIXPBS9X0M1ZCDIGHF,"The bombardment by regime forces resumed following the deadly clashes, it added.",19,25,regime,2,1,3
32204AGAABDAFIXPBS9X0M1ZCDIGHF,"The bombardment by regime forces resumed following the deadly clashes, it added.",33,40,resumed,0,3,3
32204AGAABDAFIXPBS9X0M1ZCDIGHF,"The bombardment by regime forces resumed following the deadly clashes, it added.",55,69,deadly clashes,1,1,2
32204AGAABDAFIXPBS9X0M1ZCDIGHF,"In Quraya in the eastern province of Deir az-Zour, a 15-year-old boy was killed by machinegun fire as regime forces raided the town, the Observatory said, bringing the total number of people killed on Monday to 25.",3,9,Quraya,1,0,1
32204AGAABDAFIXPBS9X0M1ZCDIGHF,"In Quraya in the eastern province of Deir az-Zour, a 15-year-old boy was killed by machinegun fire as regime forces raided the town, the Observatory said, bringing the total number of people killed on Monday to 25.",17,33,eastern province,1,0,1
32204AGAABDAFIXPBS9X0M1ZCDIGHF,"In Quraya in the eastern province of Deir az-Zour, a 15-year-old boy was killed by machinegun fire as regime forces raided the town, the Observatory said, bringing the total number of people killed on Monday to 25.",25,33,province,1,1,2
32204AGAABDAFIXPBS9X0M1ZCDIGHF,"In Quraya in the eastern province of Deir az-Zour, a 15-year-old boy was killed by machinegun fire as regime forces raided the town, the Observatory said, bringing the total number of people killed on Monday to 25.",37,49,Deir az-Zour,1,0,1
32204AGAABDAFIXPBS9X0M1ZCDIGHF,"In Quraya in the eastern province of Deir az-Zour, a 15-year-old boy was killed by machinegun fire as regime forces raided the town, the Observatory said, bringing the total number of people killed on Monday to 25.",83,93,machinegun,3,0,3
32204AGAABDAFIXPBS9X0M1ZCDIGHF,"In Quraya in the eastern province of Deir az-Zour, a 15-year-old boy was killed by machinegun fire as regime forces raided the town, the Observatory said, bringing the total number of people killed on Monday to 25.",102,108,regime,2,0,2
32204AGAABDAFIXPBS9X0M1ZCDIGHF,"In Quraya in the eastern province of Deir az-Zour, a 15-year-old boy was killed by machinegun fire as regime forces raided the town, the Observatory said, bringing the total number of people killed on Monday to 25.",102,115,regime forces,1,1,2
32204AGAABDAFIXPBS9X0M1ZCDIGHF,"In Quraya in the eastern province of Deir az-Zour, a 15-year-old boy was killed by machinegun fire as regime forces raided the town, the Observatory said, bringing the total number of people killed on Monday to 25.",116,122,raided,0,5,5
32204AGAABDAFIXPBS9X0M1ZCDIGHF,The watchdog added that 15 residents of the city were arrested.,4,12,watchdog,8,5,13
32204AGAABDAFIXPBS9X0M1ZCDIGHF,"And in the capital Damascus, regime forces raided the neighborhood of Qaboon, while snipers were stationed on the roofs of some buildings.",19,27,Damascus,1,0,1
32204AGAABDAFIXPBS9X0M1ZCDIGHF,"And in the capital Damascus, regime forces raided the neighborhood of Qaboon, while snipers were stationed on the roofs of some buildings.",29,35,regime,4,0,4
32204AGAABDAFIXPBS9X0M1ZCDIGHF,"And in the capital Damascus, regime forces raided the neighborhood of Qaboon, while snipers were stationed on the roofs of some buildings.",43,49,raided,2,1,3
32204AGAABDAFIXPBS9X0M1ZCDIGHF,"And in the capital Damascus, regime forces raided the neighborhood of Qaboon, while snipers were stationed on the roofs of some buildings.",54,66,neighborhood,1,0,1
32204AGAABDAFIXPBS9X0M1ZCDIGHF,"And in the capital Damascus, regime forces raided the neighborhood of Qaboon, while snipers were stationed on the roofs of some buildings.",70,76,Qaboon,1,0,1
32204AGAABDAFIXPBS9X0M1ZCDIGHF,"And in the capital Damascus, regime forces raided the neighborhood of Qaboon, while snipers were stationed on the roofs of some buildings.",84,91,snipers,6,9,15
32204AGAABDAFIXPBS9X0M1ZCDIGHF,"And in the capital Damascus, regime forces raided the neighborhood of Qaboon, while snipers were stationed on the roofs of some buildings.",97,106,stationed,4,4,8
3M0556243SLWBEN536YSNLYJXARNFW,"The goal that I set - to defeat al Qaeda, and deny it a chance to rebuild - is within our reach, Mr. Obama said, adding that ""there will be difficult days ahead.",26,32,defeat,1,1,2
3M0556243SLWBEN536YSNLYJXARNFW,"The goal that I set - to defeat al Qaeda, and deny it a chance to rebuild - is within our reach, Mr. Obama said, adding that ""there will be difficult days ahead.",47,51,deny,1,2,3
3M0556243SLWBEN536YSNLYJXARNFW,"The goal that I set - to defeat al Qaeda, and deny it a chance to rebuild - is within our reach, Mr. Obama said, adding that ""there will be difficult days ahead.",67,74,rebuild,2,2,4
3M0556243SLWBEN536YSNLYJXARNFW,"The goal that I set - to defeat al Qaeda, and deny it a chance to rebuild - is within our reach, Mr. Obama said, adding that ""there will be difficult days ahead.",80,96,within our reach,1,0,1
3M0556243SLWBEN536YSNLYJXARNFW,"The goal that I set - to defeat al Qaeda, and deny it a chance to rebuild - is within our reach, Mr. Obama said, adding that ""there will be difficult days ahead.",142,151,difficult,2,0,2
3M0556243SLWBEN536YSNLYJXARNFW,"The enormous sacrifices of our men and women are not over.""",4,12,enormous,4,5,9
3M0556243SLWBEN536YSNLYJXARNFW,"The enormous sacrifices of our men and women are not over.""",4,23,enormous sacrifices,4,1,5
3M0556243SLWBEN536YSNLYJXARNFW,"The enormous sacrifices of our men and women are not over.""",13,23,sacrifices,4,5,9
3M0556243SLWBEN536YSNLYJXARNFW,"U.S. military's future in Afghanistan Issued twice a year to Congress, the Defense Department report said overall insurgent attacks in Afghanistan fell last year for the first drop in five years and praised Afghan forces for their increased security capabilities.",38,44,Issued,0,2,2
3M0556243SLWBEN536YSNLYJXARNFW,"U.S. military's future in Afghanistan Issued twice a year to Congress, the Defense Department report said overall insurgent attacks in Afghanistan fell last year for the first drop in five years and praised Afghan forces for their increased security capabilities.",38,69,Issued twice a year to Congress,1,0,1
3M0556243SLWBEN536YSNLYJXARNFW,"U.S. military's future in Afghanistan Issued twice a year to Congress, the Defense Department report said overall insurgent attacks in Afghanistan fell last year for the first drop in five years and praised Afghan forces for their increased security capabilities.",61,69,Congress,4,0,4
3M0556243SLWBEN536YSNLYJXARNFW,"U.S. military's future in Afghanistan Issued twice a year to Congress, the Defense Department report said overall insurgent attacks in Afghanistan fell last year for the first drop in five years and praised Afghan forces for their increased security capabilities.",75,82,Defense,1,0,1
3M0556243SLWBEN536YSNLYJXARNFW,"U.S. military's future in Afghanistan Issued twice a year to Congress, the Defense Department report said overall insurgent attacks in Afghanistan fell last year for the first drop in five years and praised Afghan forces for their increased security capabilities.",106,113,overall,0,1,1
3M0556243SLWBEN536YSNLYJXARNFW,"U.S. military's future in Afghanistan Issued twice a year to Congress, the Defense Department report said overall insurgent attacks in Afghanistan fell last year for the first drop in five years and praised Afghan forces for their increased security capabilities.",106,123,overall insurgent,1,0,1
3M0556243SLWBEN536YSNLYJXARNFW,"U.S. military's future in Afghanistan Issued twice a year to Congress, the Defense Department report said overall insurgent attacks in Afghanistan fell last year for the first drop in five years and praised Afghan forces for their increased security capabilities.",106,131,overall insurgent attacks,0,1,1
3M0556243SLWBEN536YSNLYJXARNFW,"U.S. military's future in Afghanistan Issued twice a year to Congress, the Defense Department report said overall insurgent attacks in Afghanistan fell last year for the first drop in five years and praised Afghan forces for their increased security capabilities.",114,123,insurgent,10,8,18
3M0556243SLWBEN536YSNLYJXARNFW,"U.S. military's future in Afghanistan Issued twice a year to Congress, the Defense Department report said overall insurgent attacks in Afghanistan fell last year for the first drop in five years and praised Afghan forces for their increased security capabilities.",114,131,insurgent attacks,4,1,5
3M0556243SLWBEN536YSNLYJXARNFW,"U.S. military's future in Afghanistan Issued twice a year to Congress, the Defense Department report said overall insurgent attacks in Afghanistan fell last year for the first drop in five years and praised Afghan forces for their increased security capabilities.",199,206,praised,1,3,4
3M0556243SLWBEN536YSNLYJXARNFW,"U.S. military's future in Afghanistan Issued twice a year to Congress, the Defense Department report said overall insurgent attacks in Afghanistan fell last year for the first drop in five years and praised Afghan forces for their increased security capabilities.",231,262,increased security capabilities,3,0,3
3M0556243SLWBEN536YSNLYJXARNFW,"U.S. military's future in Afghanistan Issued twice a year to Congress, the Defense Department report said overall insurgent attacks in Afghanistan fell last year for the first drop in five years and praised Afghan forces for their increased security capabilities.",241,249,security,1,0,1
3M0556243SLWBEN536YSNLYJXARNFW,"U.S. military's future in Afghanistan Issued twice a year to Congress, the Defense Department report said overall insurgent attacks in Afghanistan fell last year for the first drop in five years and praised Afghan forces for their increased security capabilities.",241,262,security capabilities,4,3,7
3M0556243SLWBEN536YSNLYJXARNFW,"U.S. military's future in Afghanistan Issued twice a year to Congress, the Defense Department report said overall insurgent attacks in Afghanistan fell last year for the first drop in five years and praised Afghan forces for their increased security capabilities.",250,262,capabilities,5,0,5
3M0556243SLWBEN536YSNLYJXARNFW,"At the same time, the Defense Department said corruption remains widespread and violence in the southern region of Kandahar has increased.",46,56,corruption,10,7,17
3M0556243SLWBEN536YSNLYJXARNFW,"At the same time, the Defense Department said corruption remains widespread and violence in the southern region of Kandahar has increased.",46,75,corruption remains widespread,2,0,2
3M0556243SLWBEN536YSNLYJXARNFW,"At the same time, the Defense Department said corruption remains widespread and violence in the southern region of Kandahar has increased.",57,64,remains,0,1,1
3M0556243SLWBEN536YSNLYJXARNFW,"At the same time, the Defense Department said corruption remains widespread and violence in the southern region of Kandahar has increased.",65,75,widespread,3,7,10
3M0556243SLWBEN536YSNLYJXARNFW,"At the same time, the Defense Department said corruption remains widespread and violence in the southern region of Kandahar has increased.",80,88,violence,0,3,3
3M0556243SLWBEN536YSNLYJXARNFW,"There are around 130,000 forces in Afghanistan, including around 90,000 U.S. forces and 40,000 troops from other nations.",95,101,troops,1,1,2
3K3IX1W4S6S1I8IA85PSD9SN0LUPAK,"In his speech, Obama turned the signing of the promise to stay in Afghanistan into a vehicle for his other promise — to go.",32,39,signing,2,0,2
3K3IX1W4S6S1I8IA85PSD9SN0LUPAK,"In his speech, Obama turned the signing of the promise to stay in Afghanistan into a vehicle for his other promise — to go.",47,54,promise,0,1,1
3K3IX1W4S6S1I8IA85PSD9SN0LUPAK,"In his speech, Obama turned the signing of the promise to stay in Afghanistan into a vehicle for his other promise — to go.",47,62,promise to stay,0,1,1
3K3IX1W4S6S1I8IA85PSD9SN0LUPAK,"In his speech, Obama turned the signing of the promise to stay in Afghanistan into a vehicle for his other promise — to go.",85,92,vehicle,2,0,2
3K3IX1W4S6S1I8IA85PSD9SN0LUPAK,"In his speech, Obama turned the signing of the promise to stay in Afghanistan into a vehicle for his other promise — to go.",107,122,promise — to go,1,0,1
3K3IX1W4S6S1I8IA85PSD9SN0LUPAK,The signing was a quick and businesslike affair at Karzai's palace in Kabul.,28,40,businesslike,3,3,6
3K3IX1W4S6S1I8IA85PSD9SN0LUPAK,The signing was a quick and businesslike affair at Karzai's palace in Kabul.,28,47,businesslike affair,1,4,5
3K3IX1W4S6S1I8IA85PSD9SN0LUPAK,The signing was a quick and businesslike affair at Karzai's palace in Kabul.,41,47,affair,1,1,2
3K3IX1W4S6S1I8IA85PSD9SN0LUPAK,The signing was a quick and businesslike affair at Karzai's palace in Kabul.,60,66,palace,1,0,1
3K3IX1W4S6S1I8IA85PSD9SN0LUPAK,"There were pleasantries, but no pageantry.",11,23,pleasantries,10,10,20
3K3IX1W4S6S1I8IA85PSD9SN0LUPAK,"There were pleasantries, but no pageantry.",32,41,pageantry,10,10,20
3K3IX1W4S6S1I8IA85PSD9SN0LUPAK,"There was also no opportunity for Karzai to make one of the off-message demands or denunciations of U.S. behavior that have exasperated U.S. officials in the past, even when they acknowledged Karzai had a point.",18,29,opportunity,1,1,2
3K3IX1W4S6S1I8IA85PSD9SN0LUPAK,"There was also no opportunity for Karzai to make one of the off-message demands or denunciations of U.S. behavior that have exasperated U.S. officials in the past, even when they acknowledged Karzai had a point.",60,71,off-message,4,3,7
3K3IX1W4S6S1I8IA85PSD9SN0LUPAK,"There was also no opportunity for Karzai to make one of the off-message demands or denunciations of U.S. behavior that have exasperated U.S. officials in the past, even when they acknowledged Karzai had a point.",60,79,off-message demands,2,1,3
3K3IX1W4S6S1I8IA85PSD9SN0LUPAK,"There was also no opportunity for Karzai to make one of the off-message demands or denunciations of U.S. behavior that have exasperated U.S. officials in the past, even when they acknowledged Karzai had a point.",72,79,demands,0,1,1
3K3IX1W4S6S1I8IA85PSD9SN0LUPAK,"There was also no opportunity for Karzai to make one of the off-message demands or denunciations of U.S. behavior that have exasperated U.S. officials in the past, even when they acknowledged Karzai had a point.",83,96,denunciations,10,10,20
3K3IX1W4S6S1I8IA85PSD9SN0LUPAK,"There was also no opportunity for Karzai to make one of the off-message demands or denunciations of U.S. behavior that have exasperated U.S. officials in the past, even when they acknowledged Karzai had a point.",124,135,exasperated,10,10,20
3K3IX1W4S6S1I8IA85PSD9SN0LUPAK,"There was also no opportunity for Karzai to make one of the off-message demands or denunciations of U.S. behavior that have exasperated U.S. officials in the past, even when they acknowledged Karzai had a point.",179,191,acknowledged,5,5,10
3K3IX1W4S6S1I8IA85PSD9SN0LUPAK,"The Afghan people will understand that the United States will stand by them, Obama said, with Karzai seated beside him at the signing table.",63,76,stand by them,1,0,1
3K3IX1W4S6S1I8IA85PSD9SN0LUPAK,"The Afghan people will understand that the United States will stand by them, Obama said, with Karzai seated beside him at the signing table.",128,141,signing table,1,0,1
3K3IX1W4S6S1I8IA85PSD9SN0LUPAK,"They will know that the United States can achieve our goals of destroying al-Qaida and denying it a safe haven, but at the same time we have the capacity to wind down this war and usher in a new era of peace here in Afghanistan.",43,50,achieve,1,0,1
3K3IX1W4S6S1I8IA85PSD9SN0LUPAK,"They will know that the United States can achieve our goals of destroying al-Qaida and denying it a safe haven, but at the same time we have the capacity to wind down this war and usher in a new era of peace here in Afghanistan.",64,74,destroying,1,2,3
3K3IX1W4S6S1I8IA85PSD9SN0LUPAK,"They will know that the United States can achieve our goals of destroying al-Qaida and denying it a safe haven, but at the same time we have the capacity to wind down this war and usher in a new era of peace here in Afghanistan.",88,95,denying,1,2,3
3K3IX1W4S6S1I8IA85PSD9SN0LUPAK,"They will know that the United States can achieve our goals of destroying al-Qaida and denying it a safe haven, but at the same time we have the capacity to wind down this war and usher in a new era of peace here in Afghanistan.",101,111,safe haven,5,5,10
3K3IX1W4S6S1I8IA85PSD9SN0LUPAK,"They will know that the United States can achieve our goals of destroying al-Qaida and denying it a safe haven, but at the same time we have the capacity to wind down this war and usher in a new era of peace here in Afghanistan.",106,111,haven,2,1,3
3K3IX1W4S6S1I8IA85PSD9SN0LUPAK,"They will know that the United States can achieve our goals of destroying al-Qaida and denying it a safe haven, but at the same time we have the capacity to wind down this war and usher in a new era of peace here in Afghanistan.",146,154,capacity,6,1,7
3K3IX1W4S6S1I8IA85PSD9SN0LUPAK,"They will know that the United States can achieve our goals of destroying al-Qaida and denying it a safe haven, but at the same time we have the capacity to wind down this war and usher in a new era of peace here in Afghanistan.",158,167,wind down,0,2,2
3K3IX1W4S6S1I8IA85PSD9SN0LUPAK,"They will know that the United States can achieve our goals of destroying al-Qaida and denying it a safe haven, but at the same time we have the capacity to wind down this war and usher in a new era of peace here in Afghanistan.",181,186,usher,9,9,18
3K3IX1W4S6S1I8IA85PSD9SN0LUPAK,"They will know that the United States can achieve our goals of destroying al-Qaida and denying it a safe haven, but at the same time we have the capacity to wind down this war and usher in a new era of peace here in Afghanistan.",192,199,new era,1,0,1
3K3IX1W4S6S1I8IA85PSD9SN0LUPAK,"They will know that the United States can achieve our goals of destroying al-Qaida and denying it a safe haven, but at the same time we have the capacity to wind down this war and usher in a new era of peace here in Afghanistan.",196,199,era,1,0,1
38B7Q9C28G6F3JQ013CJBEQMZM796G,"Its strategic location and the terrain has helped deserters from disparate units mount raids against army buses and roadblocks manned by Military Intelligence and pro-Assad militia, opposition activists said.",4,13,strategic,8,7,15
38B7Q9C28G6F3JQ013CJBEQMZM796G,"Its strategic location and the terrain has helped deserters from disparate units mount raids against army buses and roadblocks manned by Military Intelligence and pro-Assad militia, opposition activists said.",4,22,strategic location,2,3,5
38B7Q9C28G6F3JQ013CJBEQMZM796G,"Its strategic location and the terrain has helped deserters from disparate units mount raids against army buses and roadblocks manned by Military Intelligence and pro-Assad militia, opposition activists said.",31,38,terrain,5,8,13
38B7Q9C28G6F3JQ013CJBEQMZM796G,"Its strategic location and the terrain has helped deserters from disparate units mount raids against army buses and roadblocks manned by Military Intelligence and pro-Assad militia, opposition activists said.",50,59,deserters,5,10,15
38B7Q9C28G6F3JQ013CJBEQMZM796G,"Its strategic location and the terrain has helped deserters from disparate units mount raids against army buses and roadblocks manned by Military Intelligence and pro-Assad militia, opposition activists said.",50,80,deserters from disparate units,1,0,1
38B7Q9C28G6F3JQ013CJBEQMZM796G,"Its strategic location and the terrain has helped deserters from disparate units mount raids against army buses and roadblocks manned by Military Intelligence and pro-Assad militia, opposition activists said.",65,74,disparate,9,5,14
38B7Q9C28G6F3JQ013CJBEQMZM796G,"Its strategic location and the terrain has helped deserters from disparate units mount raids against army buses and roadblocks manned by Military Intelligence and pro-Assad militia, opposition activists said.",65,80,disparate units,2,2,4
38B7Q9C28G6F3JQ013CJBEQMZM796G,"Its strategic location and the terrain has helped deserters from disparate units mount raids against army buses and roadblocks manned by Military Intelligence and pro-Assad militia, opposition activists said.",81,86,mount,0,1,1
38B7Q9C28G6F3JQ013CJBEQMZM796G,"Its strategic location and the terrain has helped deserters from disparate units mount raids against army buses and roadblocks manned by Military Intelligence and pro-Assad militia, opposition activists said.",81,92,mount raids,1,0,1
38B7Q9C28G6F3JQ013CJBEQMZM796G,"Its strategic location and the terrain has helped deserters from disparate units mount raids against army buses and roadblocks manned by Military Intelligence and pro-Assad militia, opposition activists said.",87,92,raids,2,0,2
38B7Q9C28G6F3JQ013CJBEQMZM796G,"Its strategic location and the terrain has helped deserters from disparate units mount raids against army buses and roadblocks manned by Military Intelligence and pro-Assad militia, opposition activists said.",106,111,buses,0,1,1
38B7Q9C28G6F3JQ013CJBEQMZM796G,"Its strategic location and the terrain has helped deserters from disparate units mount raids against army buses and roadblocks manned by Military Intelligence and pro-Assad militia, opposition activists said.",116,126,roadblocks,1,2,3
38B7Q9C28G6F3JQ013CJBEQMZM796G,"Its strategic location and the terrain has helped deserters from disparate units mount raids against army buses and roadblocks manned by Military Intelligence and pro-Assad militia, opposition activists said.",116,133,roadblocks manned,0,2,2
38B7Q9C28G6F3JQ013CJBEQMZM796G,"Its strategic location and the terrain has helped deserters from disparate units mount raids against army buses and roadblocks manned by Military Intelligence and pro-Assad militia, opposition activists said.",127,133,manned,2,2,4
38B7Q9C28G6F3JQ013CJBEQMZM796G,"Its strategic location and the terrain has helped deserters from disparate units mount raids against army buses and roadblocks manned by Military Intelligence and pro-Assad militia, opposition activists said.",137,180,Military Intelligence and pro-Assad militia,1,1,2
38B7Q9C28G6F3JQ013CJBEQMZM796G,"Its strategic location and the terrain has helped deserters from disparate units mount raids against army buses and roadblocks manned by Military Intelligence and pro-Assad militia, opposition activists said.",146,158,Intelligence,1,0,1
38B7Q9C28G6F3JQ013CJBEQMZM796G,"Its strategic location and the terrain has helped deserters from disparate units mount raids against army buses and roadblocks manned by Military Intelligence and pro-Assad militia, opposition activists said.",182,192,opposition,2,1,3
38B7Q9C28G6F3JQ013CJBEQMZM796G,"Its strategic location and the terrain has helped deserters from disparate units mount raids against army buses and roadblocks manned by Military Intelligence and pro-Assad militia, opposition activists said.",182,202,opposition activists,4,0,4
38B7Q9C28G6F3JQ013CJBEQMZM796G,"Its strategic location and the terrain has helped deserters from disparate units mount raids against army buses and roadblocks manned by Military Intelligence and pro-Assad militia, opposition activists said.",193,202,activists,1,0,1
38B7Q9C28G6F3JQ013CJBEQMZM796G,"Rastan lies about 180 km (110 miles) north of Damascus, among farmland and wheat fields on the Orontes River and on the northern highway leading to Aleppo.",75,80,wheat,0,1,1
38B7Q9C28G6F3JQ013CJBEQMZM796G,"Rastan lies about 180 km (110 miles) north of Damascus, among farmland and wheat fields on the Orontes River and on the northern highway leading to Aleppo.",137,144,leading,0,1,1
38B7Q9C28G6F3JQ013CJBEQMZM796G,"U.N. Secretary General Ban Ki-moon said on Wednesday there was only a narrow window of opportunity to avert full-scale civil war in Syria, which sits at a crossroads of Middle East conflict bordering Turkey, Jordan, Israel, Iraq and Lebanon.",5,34,Secretary General Ban Ki-moon,1,0,1
38B7Q9C28G6F3JQ013CJBEQMZM796G,"U.N. Secretary General Ban Ki-moon said on Wednesday there was only a narrow window of opportunity to avert full-scale civil war in Syria, which sits at a crossroads of Middle East conflict bordering Turkey, Jordan, Israel, Iraq and Lebanon.",70,76,narrow,0,1,1
38B7Q9C28G6F3JQ013CJBEQMZM796G,"U.N. Secretary General Ban Ki-moon said on Wednesday there was only a narrow window of opportunity to avert full-scale civil war in Syria, which sits at a crossroads of Middle East conflict bordering Turkey, Jordan, Israel, Iraq and Lebanon.",70,98,narrow window of opportunity,2,1,3
38B7Q9C28G6F3JQ013CJBEQMZM796G,"U.N. Secretary General Ban Ki-moon said on Wednesday there was only a narrow window of opportunity to avert full-scale civil war in Syria, which sits at a crossroads of Middle East conflict bordering Turkey, Jordan, Israel, Iraq and Lebanon.",77,98,window of opportunity,1,0,1
38B7Q9C28G6F3JQ013CJBEQMZM796G,"U.N. Secretary General Ban Ki-moon said on Wednesday there was only a narrow window of opportunity to avert full-scale civil war in Syria, which sits at a crossroads of Middle East conflict bordering Turkey, Jordan, Israel, Iraq and Lebanon.",102,107,avert,4,10,14
38B7Q9C28G6F3JQ013CJBEQMZM796G,"U.N. Secretary General Ban Ki-moon said on Wednesday there was only a narrow window of opportunity to avert full-scale civil war in Syria, which sits at a crossroads of Middle East conflict bordering Turkey, Jordan, Israel, Iraq and Lebanon.",102,118,avert full-scale,2,0,2
38B7Q9C28G6F3JQ013CJBEQMZM796G,"U.N. Secretary General Ban Ki-moon said on Wednesday there was only a narrow window of opportunity to avert full-scale civil war in Syria, which sits at a crossroads of Middle East conflict bordering Turkey, Jordan, Israel, Iraq and Lebanon.",108,118,full-scale,0,1,1
38B7Q9C28G6F3JQ013CJBEQMZM796G,"U.N. Secretary General Ban Ki-moon said on Wednesday there was only a narrow window of opportunity to avert full-scale civil war in Syria, which sits at a crossroads of Middle East conflict bordering Turkey, Jordan, Israel, Iraq and Lebanon.",119,128,civil war,1,0,1
38B7Q9C28G6F3JQ013CJBEQMZM796G,"U.N. Secretary General Ban Ki-moon said on Wednesday there was only a narrow window of opportunity to avert full-scale civil war in Syria, which sits at a crossroads of Middle East conflict bordering Turkey, Jordan, Israel, Iraq and Lebanon.",155,165,crossroads,2,4,6
38B7Q9C28G6F3JQ013CJBEQMZM796G,"U.N. Secretary General Ban Ki-moon said on Wednesday there was only a narrow window of opportunity to avert full-scale civil war in Syria, which sits at a crossroads of Middle East conflict bordering Turkey, Jordan, Israel, Iraq and Lebanon.",181,189,conflict,2,0,2
38B7Q9C28G6F3JQ013CJBEQMZM796G,"Its 23-million population comprises a mix of faiths, sects and ethnic groups whose tensions resonate in neighboring states.",26,35,comprises,5,3,8
38B7Q9C28G6F3JQ013CJBEQMZM796G,"Its 23-million population comprises a mix of faiths, sects and ethnic groups whose tensions resonate in neighboring states.",45,51,faiths,0,1,1
38B7Q9C28G6F3JQ013CJBEQMZM796G,"Its 23-million population comprises a mix of faiths, sects and ethnic groups whose tensions resonate in neighboring states.",53,58,sects,2,4,6
38B7Q9C28G6F3JQ013CJBEQMZM796G,"Its 23-million population comprises a mix of faiths, sects and ethnic groups whose tensions resonate in neighboring states.",63,69,ethnic,1,1,2
38B7Q9C28G6F3JQ013CJBEQMZM796G,"Its 23-million population comprises a mix of faiths, sects and ethnic groups whose tensions resonate in neighboring states.",63,76,ethnic groups,0,1,1
38B7Q9C28G6F3JQ013CJBEQMZM796G,"Its 23-million population comprises a mix of faiths, sects and ethnic groups whose tensions resonate in neighboring states.",83,91,tensions,2,0,2
38B7Q9C28G6F3JQ013CJBEQMZM796G,"Its 23-million population comprises a mix of faiths, sects and ethnic groups whose tensions resonate in neighboring states.",83,100,tensions resonate,1,0,1
38B7Q9C28G6F3JQ013CJBEQMZM796G,"Its 23-million population comprises a mix of faiths, sects and ethnic groups whose tensions resonate in neighboring states.",83,122,tensions resonate in neighboring states,1,0,1
38B7Q9C28G6F3JQ013CJBEQMZM796G,"Its 23-million population comprises a mix of faiths, sects and ethnic groups whose tensions resonate in neighboring states.",92,100,resonate,9,10,19
38B7Q9C28G6F3JQ013CJBEQMZM796G,"Its 23-million population comprises a mix of faiths, sects and ethnic groups whose tensions resonate in neighboring states.",104,115,neighboring,1,1,2
38B7Q9C28G6F3JQ013CJBEQMZM796G,"The United States, Europe and Gulf Arab states want Assad to step down but his ally Russia has blocked more robust action against the Syrian authorities in the U.N. Security Council and remains firmly behind Annan's six-point peace plan.",79,83,ally,3,0,3
38B7Q9C28G6F3JQ013CJBEQMZM796G,"The United States, Europe and Gulf Arab states want Assad to step down but his ally Russia has blocked more robust action against the Syrian authorities in the U.N. Security Council and remains firmly behind Annan's six-point peace plan.",108,114,robust,6,6,12
38B7Q9C28G6F3JQ013CJBEQMZM796G,"The United States, Europe and Gulf Arab states want Assad to step down but his ally Russia has blocked more robust action against the Syrian authorities in the U.N. Security Council and remains firmly behind Annan's six-point peace plan.",108,121,robust action,1,2,3
38B7Q9C28G6F3JQ013CJBEQMZM796G,"The United States, Europe and Gulf Arab states want Assad to step down but his ally Russia has blocked more robust action against the Syrian authorities in the U.N. Security Council and remains firmly behind Annan's six-point peace plan.",141,152,authorities,0,2,2
38B7Q9C28G6F3JQ013CJBEQMZM796G,"The United States, Europe and Gulf Arab states want Assad to step down but his ally Russia has blocked more robust action against the Syrian authorities in the U.N. Security Council and remains firmly behind Annan's six-point peace plan.",186,207,remains firmly behind,1,0,1
38B7Q9C28G6F3JQ013CJBEQMZM796G,"The United States, Europe and Gulf Arab states want Assad to step down but his ally Russia has blocked more robust action against the Syrian authorities in the U.N. Security Council and remains firmly behind Annan's six-point peace plan.",194,200,firmly,1,0,1
38B7Q9C28G6F3JQ013CJBEQMZM796G,"The United States, Europe and Gulf Arab states want Assad to step down but his ally Russia has blocked more robust action against the Syrian authorities in the U.N. Security Council and remains firmly behind Annan's six-point peace plan.",216,236,six-point peace plan,2,0,2
3RZS0FBRWKBPBNF8SJLJJ4IB1P3CP0,"Shock: Locals in Bellaghy, County Derry, are said to be stunned by the tragic shooting, which happened in Brenda O'Neill's rented house 'All three were arrested in the Toome area and have been taken to the Serious Crime Suite at Antrim police station.'",17,25,Bellaghy,0,1,1
3RZS0FBRWKBPBNF8SJLJJ4IB1P3CP0,"Shock: Locals in Bellaghy, County Derry, are said to be stunned by the tragic shooting, which happened in Brenda O'Neill's rented house 'All three were arrested in the Toome area and have been taken to the Serious Crime Suite at Antrim police station.'",53,63,be stunned,0,1,1
3RZS0FBRWKBPBNF8SJLJJ4IB1P3CP0,"Shock: Locals in Bellaghy, County Derry, are said to be stunned by the tragic shooting, which happened in Brenda O'Neill's rented house 'All three were arrested in the Toome area and have been taken to the Serious Crime Suite at Antrim police station.'",56,63,stunned,8,10,18
3RZS0FBRWKBPBNF8SJLJJ4IB1P3CP0,"Shock: Locals in Bellaghy, County Derry, are said to be stunned by the tragic shooting, which happened in Brenda O'Neill's rented house 'All three were arrested in the Toome area and have been taken to the Serious Crime Suite at Antrim police station.'",71,77,tragic,4,6,10
3RZS0FBRWKBPBNF8SJLJJ4IB1P3CP0,"Shock: Locals in Bellaghy, County Derry, are said to be stunned by the tragic shooting, which happened in Brenda O'Neill's rented house 'All three were arrested in the Toome area and have been taken to the Serious Crime Suite at Antrim police station.'",71,86,tragic shooting,1,0,1
3RZS0FBRWKBPBNF8SJLJJ4IB1P3CP0,"Shock: Locals in Bellaghy, County Derry, are said to be stunned by the tragic shooting, which happened in Brenda O'Neill's rented house 'All three were arrested in the Toome area and have been taken to the Serious Crime Suite at Antrim police station.'",113,120,ONeills,0,1,1
3RZS0FBRWKBPBNF8SJLJJ4IB1P3CP0,"Shock: Locals in Bellaghy, County Derry, are said to be stunned by the tragic shooting, which happened in Brenda O'Neill's rented house 'All three were arrested in the Toome area and have been taken to the Serious Crime Suite at Antrim police station.'",152,160,arrested,1,0,1
3RZS0FBRWKBPBNF8SJLJJ4IB1P3CP0,"Shock: Locals in Bellaghy, County Derry, are said to be stunned by the tragic shooting, which happened in Brenda O'Neill's rented house 'All three were arrested in the Toome area and have been taken to the Serious Crime Suite at Antrim police station.'",168,173,Toome,0,1,1
3RZS0FBRWKBPBNF8SJLJJ4IB1P3CP0,"Shock: Locals in Bellaghy, County Derry, are said to be stunned by the tragic shooting, which happened in Brenda O'Neill's rented house 'All three were arrested in the Toome area and have been taken to the Serious Crime Suite at Antrim police station.'",206,225,Serious Crime Suite,0,1,1
3RZS0FBRWKBPBNF8SJLJJ4IB1P3CP0,"Shock: Locals in Bellaghy, County Derry, are said to be stunned by the tragic shooting, which happened in Brenda O'Neill's rented house 'All three were arrested in the Toome area and have been taken to the Serious Crime Suite at Antrim police station.'",206,250,Serious Crime Suite at Antrim police station,1,0,1
3RZS0FBRWKBPBNF8SJLJJ4IB1P3CP0,"Shock: Locals in Bellaghy, County Derry, are said to be stunned by the tragic shooting, which happened in Brenda O'Neill's rented house 'All three were arrested in the Toome area and have been taken to the Serious Crime Suite at Antrim police station.'",214,225,Crime Suite,0,1,1
3RZS0FBRWKBPBNF8SJLJJ4IB1P3CP0,"Shock: Locals in Bellaghy, County Derry, are said to be stunned by the tragic shooting, which happened in Brenda O'Neill's rented house 'All three were arrested in the Toome area and have been taken to the Serious Crime Suite at Antrim police station.'",220,225,Suite,2,1,3
3RZS0FBRWKBPBNF8SJLJJ4IB1P3CP0,"Shock: Locals in Bellaghy, County Derry, are said to be stunned by the tragic shooting, which happened in Brenda O'Neill's rented house 'All three were arrested in the Toome area and have been taken to the Serious Crime Suite at Antrim police station.'",229,235,Antrim,0,2,2
3RZS0FBRWKBPBNF8SJLJJ4IB1P3CP0,Investigating officers have appealed for anyone with information about the incident to contact them.,0,13,Investigating,7,4,11
3RZS0FBRWKBPBNF8SJLJJ4IB1P3CP0,Investigating officers have appealed for anyone with information about the incident to contact them.,23,36,have appealed,0,1,1
3RZS0FBRWKBPBNF8SJLJJ4IB1P3CP0,Investigating officers have appealed for anyone with information about the incident to contact them.,28,36,appealed,7,7,14
3RZS0FBRWKBPBNF8SJLJJ4IB1P3CP0,Investigating officers have appealed for anyone with information about the incident to contact them.,53,64,information,2,1,3
3RZS0FBRWKBPBNF8SJLJJ4IB1P3CP0,Investigating officers have appealed for anyone with information about the incident to contact them.,75,83,incident,6,3,9
3RZS0FBRWKBPBNF8SJLJJ4IB1P3CP0,"Caoimhe Scullion, Sinn Fein councillor on Magherafelt District Council who lives in Bellaghy, said the tight-knit village had been plunged into shock over the gun attack.",0,7,Caoimhe,0,1,1
3RZS0FBRWKBPBNF8SJLJJ4IB1P3CP0,"Caoimhe Scullion, Sinn Fein councillor on Magherafelt District Council who lives in Bellaghy, said the tight-knit village had been plunged into shock over the gun attack.",28,38,councillor,7,5,12
3RZS0FBRWKBPBNF8SJLJJ4IB1P3CP0,"Caoimhe Scullion, Sinn Fein councillor on Magherafelt District Council who lives in Bellaghy, said the tight-knit village had been plunged into shock over the gun attack.",42,53,Magherafelt,0,1,1
3RZS0FBRWKBPBNF8SJLJJ4IB1P3CP0,"Caoimhe Scullion, Sinn Fein councillor on Magherafelt District Council who lives in Bellaghy, said the tight-knit village had been plunged into shock over the gun attack.",103,113,tight-knit,10,6,16
3RZS0FBRWKBPBNF8SJLJJ4IB1P3CP0,"Caoimhe Scullion, Sinn Fein councillor on Magherafelt District Council who lives in Bellaghy, said the tight-knit village had been plunged into shock over the gun attack.",103,121,tight-knit village,0,1,1
3RZS0FBRWKBPBNF8SJLJJ4IB1P3CP0,"Caoimhe Scullion, Sinn Fein councillor on Magherafelt District Council who lives in Bellaghy, said the tight-knit village had been plunged into shock over the gun attack.",131,138,plunged,8,10,18
3RZS0FBRWKBPBNF8SJLJJ4IB1P3CP0,"Caoimhe Scullion, Sinn Fein councillor on Magherafelt District Council who lives in Bellaghy, said the tight-knit village had been plunged into shock over the gun attack.",131,149,plunged into shock,0,1,1
3RZS0FBRWKBPBNF8SJLJJ4IB1P3CP0,"Caoimhe Scullion, Sinn Fein councillor on Magherafelt District Council who lives in Bellaghy, said the tight-knit village had been plunged into shock over the gun attack.",144,149,shock,1,0,1
3RZS0FBRWKBPBNF8SJLJJ4IB1P3CP0,"'Everybody is in complete shock,' she said.",17,31,complete shock,0,1,1
3RZS0FBRWKBPBNF8SJLJJ4IB1P3CP0,"'Everybody is in complete shock,' she said.",26,31,shock,1,0,1
3RZS0FBRWKBPBNF8SJLJJ4IB1P3CP0,"'We hear these stories happening everywhere else, but you never think it will happen on your doorstep.'",23,43,happening everywhere,1,0,1
3RZS0FBRWKBPBNF8SJLJJ4IB1P3CP0,"'We hear these stories happening everywhere else, but you never think it will happen on your doorstep.'",93,101,doorstep,1,5,6
3RZS0FBRWKBPBNF8SJLJJ4IB1P3CP0,Ms Scullion said everybody knows everybody else in the small village.,3,11,Scullion,0,1,1
3RZS0FBRWKBPBNF8SJLJJ4IB1P3CP0,"Ian Milne, also a Sinn Fein councillor who lives in Bellaghy, said the dead girl marked her 18th birthday within the last two weeks.",18,38,Sinn Fein councillor,1,1,2
3RZS0FBRWKBPBNF8SJLJJ4IB1P3CP0,"Ian Milne, also a Sinn Fein councillor who lives in Bellaghy, said the dead girl marked her 18th birthday within the last two weeks.",23,27,Fein,0,1,1
3RZS0FBRWKBPBNF8SJLJJ4IB1P3CP0,"Ian Milne, also a Sinn Fein councillor who lives in Bellaghy, said the dead girl marked her 18th birthday within the last two weeks.",28,38,councillor,6,2,8
3RZS0FBRWKBPBNF8SJLJJ4IB1P3CP0,"Ian Milne, also a Sinn Fein councillor who lives in Bellaghy, said the dead girl marked her 18th birthday within the last two weeks.",71,87,dead girl marked,0,1,1
3RZS0FBRWKBPBNF8SJLJJ4IB1P3CP0,"Ian Milne, also a Sinn Fein councillor who lives in Bellaghy, said the dead girl marked her 18th birthday within the last two weeks.",81,87,marked,1,0,1
3BFF0DJK8XD3AWXB6MK33JNQBI7STL,National security expert Michael O'Hanlon of the Brookings Institution said he is more encouraged about the prospects for success in Afghanistan after President Obama's speech.,0,24,National security expert,1,1,2
3BFF0DJK8XD3AWXB6MK33JNQBI7STL,National security expert Michael O'Hanlon of the Brookings Institution said he is more encouraged about the prospects for success in Afghanistan after President Obama's speech.,9,17,security,0,2,2
3BFF0DJK8XD3AWXB6MK33JNQBI7STL,National security expert Michael O'Hanlon of the Brookings Institution said he is more encouraged about the prospects for success in Afghanistan after President Obama's speech.,9,24,security expert,0,1,1
3BFF0DJK8XD3AWXB6MK33JNQBI7STL,National security expert Michael O'Hanlon of the Brookings Institution said he is more encouraged about the prospects for success in Afghanistan after President Obama's speech.,49,58,Brookings,1,0,1
3BFF0DJK8XD3AWXB6MK33JNQBI7STL,National security expert Michael O'Hanlon of the Brookings Institution said he is more encouraged about the prospects for success in Afghanistan after President Obama's speech.,59,70,Institution,2,2,4
3BFF0DJK8XD3AWXB6MK33JNQBI7STL,National security expert Michael O'Hanlon of the Brookings Institution said he is more encouraged about the prospects for success in Afghanistan after President Obama's speech.,87,97,encouraged,2,4,6
3BFF0DJK8XD3AWXB6MK33JNQBI7STL,National security expert Michael O'Hanlon of the Brookings Institution said he is more encouraged about the prospects for success in Afghanistan after President Obama's speech.,108,117,prospects,8,8,16
3BFF0DJK8XD3AWXB6MK33JNQBI7STL,"To see the president emphatically state as a matter of wartime leadership that we are really working closely in a committed way with our Afghan partners I think it was an important message, he said.",22,34,emphatically,10,10,20
3BFF0DJK8XD3AWXB6MK33JNQBI7STL,"To see the president emphatically state as a matter of wartime leadership that we are really working closely in a committed way with our Afghan partners I think it was an important message, he said.",22,40,emphatically state,1,0,1
3BFF0DJK8XD3AWXB6MK33JNQBI7STL,"To see the president emphatically state as a matter of wartime leadership that we are really working closely in a committed way with our Afghan partners I think it was an important message, he said.",56,63,wartime,2,3,5
3BFF0DJK8XD3AWXB6MK33JNQBI7STL,"To see the president emphatically state as a matter of wartime leadership that we are really working closely in a committed way with our Afghan partners I think it was an important message, he said.",56,74,wartime leadership,0,1,1
3BFF0DJK8XD3AWXB6MK33JNQBI7STL,"To see the president emphatically state as a matter of wartime leadership that we are really working closely in a committed way with our Afghan partners I think it was an important message, he said.",64,74,leadership,1,1,2
3BFF0DJK8XD3AWXB6MK33JNQBI7STL,"To see the president emphatically state as a matter of wartime leadership that we are really working closely in a committed way with our Afghan partners I think it was an important message, he said.",115,124,committed,3,4,7
3BFF0DJK8XD3AWXB6MK33JNQBI7STL,"To see the president emphatically state as a matter of wartime leadership that we are really working closely in a committed way with our Afghan partners I think it was an important message, he said.",115,128,committed way,1,3,4
3BFF0DJK8XD3AWXB6MK33JNQBI7STL,"He made it pretty clear that, if he's reelected at least, he'll see the mission past 2014 as important but very limited and very focused, O'Hanlon said.",12,18,pretty,1,1,2
3BFF0DJK8XD3AWXB6MK33JNQBI7STL,"He made it pretty clear that, if he's reelected at least, he'll see the mission past 2014 as important but very limited and very focused, O'Hanlon said.",39,48,reelected,5,5,10
3BFF0DJK8XD3AWXB6MK33JNQBI7STL,"He made it pretty clear that, if he's reelected at least, he'll see the mission past 2014 as important but very limited and very focused, O'Hanlon said.",73,80,mission,0,1,1
3BFF0DJK8XD3AWXB6MK33JNQBI7STL,"He made it pretty clear that, if he's reelected at least, he'll see the mission past 2014 as important but very limited and very focused, O'Hanlon said.",130,137,focused,2,3,5
3BFF0DJK8XD3AWXB6MK33JNQBI7STL,"Obama's surprise trip is sure to draw criticism from Republicans, who have accused Mr. Obama of ""spiking the football"" in the days leading up to the one year anniversary of the death of bin Laden.",33,37,draw,0,2,2
3BFF0DJK8XD3AWXB6MK33JNQBI7STL,"Obama's surprise trip is sure to draw criticism from Republicans, who have accused Mr. Obama of ""spiking the football"" in the days leading up to the one year anniversary of the death of bin Laden.",33,47,draw criticism,2,3,5
3BFF0DJK8XD3AWXB6MK33JNQBI7STL,"Obama's surprise trip is sure to draw criticism from Republicans, who have accused Mr. Obama of ""spiking the football"" in the days leading up to the one year anniversary of the death of bin Laden.",38,47,criticism,5,7,12
3BFF0DJK8XD3AWXB6MK33JNQBI7STL,"Obama's surprise trip is sure to draw criticism from Republicans, who have accused Mr. Obama of ""spiking the football"" in the days leading up to the one year anniversary of the death of bin Laden.",75,82,accused,2,5,7
3BFF0DJK8XD3AWXB6MK33JNQBI7STL,"Obama's surprise trip is sure to draw criticism from Republicans, who have accused Mr. Obama of ""spiking the football"" in the days leading up to the one year anniversary of the death of bin Laden.",97,117,spiking the football,6,3,9
3BFF0DJK8XD3AWXB6MK33JNQBI7STL,"Obama's surprise trip is sure to draw criticism from Republicans, who have accused Mr. Obama of ""spiking the football"" in the days leading up to the one year anniversary of the death of bin Laden.",97,104,spiking,1,2,3
3BFF0DJK8XD3AWXB6MK33JNQBI7STL,"Obama's surprise trip is sure to draw criticism from Republicans, who have accused Mr. Obama of ""spiking the football"" in the days leading up to the one year anniversary of the death of bin Laden.",131,138,leading,0,1,1
3BFF0DJK8XD3AWXB6MK33JNQBI7STL,"Obama's surprise trip is sure to draw criticism from Republicans, who have accused Mr. Obama of ""spiking the football"" in the days leading up to the one year anniversary of the death of bin Laden.",158,169,anniversary,3,2,5
3UUIU9GZC5624UZ0UQ7VA8DYYB25TQ,"That prompted the military to deploy its largest warship, the BRP Gregorio del Pilar, which was recently acquired from the United States.",5,13,prompted,3,9,12
3UUIU9GZC5624UZ0UQ7VA8DYYB25TQ,"That prompted the military to deploy its largest warship, the BRP Gregorio del Pilar, which was recently acquired from the United States.",18,26,military,2,0,2
3UUIU9GZC5624UZ0UQ7VA8DYYB25TQ,"That prompted the military to deploy its largest warship, the BRP Gregorio del Pilar, which was recently acquired from the United States.",30,36,deploy,9,10,19
3UUIU9GZC5624UZ0UQ7VA8DYYB25TQ,"That prompted the military to deploy its largest warship, the BRP Gregorio del Pilar, which was recently acquired from the United States.",49,56,warship,1,0,1
3UUIU9GZC5624UZ0UQ7VA8DYYB25TQ,"That prompted the military to deploy its largest warship, the BRP Gregorio del Pilar, which was recently acquired from the United States.",96,113,recently acquired,2,0,2
3UUIU9GZC5624UZ0UQ7VA8DYYB25TQ,"That prompted the military to deploy its largest warship, the BRP Gregorio del Pilar, which was recently acquired from the United States.",105,113,acquired,8,7,15
3UUIU9GZC5624UZ0UQ7VA8DYYB25TQ,"On Tuesday, Filipino sailors from the warship boarded the Chinese vessels for an inspection, discovering large amounts of illegally collected coral, giant clams and live sharks inside the first boat.",12,20,Filipino,0,1,1
3UUIU9GZC5624UZ0UQ7VA8DYYB25TQ,"On Tuesday, Filipino sailors from the warship boarded the Chinese vessels for an inspection, discovering large amounts of illegally collected coral, giant clams and live sharks inside the first boat.",38,45,warship,1,0,1
3UUIU9GZC5624UZ0UQ7VA8DYYB25TQ,"On Tuesday, Filipino sailors from the warship boarded the Chinese vessels for an inspection, discovering large amounts of illegally collected coral, giant clams and live sharks inside the first boat.",46,53,boarded,1,2,3
3UUIU9GZC5624UZ0UQ7VA8DYYB25TQ,"On Tuesday, Filipino sailors from the warship boarded the Chinese vessels for an inspection, discovering large amounts of illegally collected coral, giant clams and live sharks inside the first boat.",58,73,Chinese vessels,0,1,1
3UUIU9GZC5624UZ0UQ7VA8DYYB25TQ,"On Tuesday, Filipino sailors from the warship boarded the Chinese vessels for an inspection, discovering large amounts of illegally collected coral, giant clams and live sharks inside the first boat.",66,73,vessels,5,2,7
3UUIU9GZC5624UZ0UQ7VA8DYYB25TQ,"On Tuesday, Filipino sailors from the warship boarded the Chinese vessels for an inspection, discovering large amounts of illegally collected coral, giant clams and live sharks inside the first boat.",81,91,inspection,3,0,3
3UUIU9GZC5624UZ0UQ7VA8DYYB25TQ,"On Tuesday, Filipino sailors from the warship boarded the Chinese vessels for an inspection, discovering large amounts of illegally collected coral, giant clams and live sharks inside the first boat.",122,131,illegally,2,2,4
3UUIU9GZC5624UZ0UQ7VA8DYYB25TQ,"On Tuesday, Filipino sailors from the warship boarded the Chinese vessels for an inspection, discovering large amounts of illegally collected coral, giant clams and live sharks inside the first boat.",122,147,illegally collected coral,2,1,3
3UUIU9GZC5624UZ0UQ7VA8DYYB25TQ,"On Tuesday, Filipino sailors from the warship boarded the Chinese vessels for an inspection, discovering large amounts of illegally collected coral, giant clams and live sharks inside the first boat.",142,147,coral,2,1,3
3UUIU9GZC5624UZ0UQ7VA8DYYB25TQ,"On Tuesday, Filipino sailors from the warship boarded the Chinese vessels for an inspection, discovering large amounts of illegally collected coral, giant clams and live sharks inside the first boat.",155,160,clams,1,4,5
3UUIU9GZC5624UZ0UQ7VA8DYYB25TQ,"Del Rosario said that the Chinese fishermen had been ""engaged in illegal fishing and harvesting of endangered marine species.""",54,61,engaged,1,1,2
3UUIU9GZC5624UZ0UQ7VA8DYYB25TQ,"Del Rosario said that the Chinese fishermen had been ""engaged in illegal fishing and harvesting of endangered marine species.""",54,80,engaged in illegal fishing,1,0,1
3UUIU9GZC5624UZ0UQ7VA8DYYB25TQ,"Del Rosario said that the Chinese fishermen had been ""engaged in illegal fishing and harvesting of endangered marine species.""",65,72,illegal,1,1,2
3UUIU9GZC5624UZ0UQ7VA8DYYB25TQ,"Del Rosario said that the Chinese fishermen had been ""engaged in illegal fishing and harvesting of endangered marine species.""",85,95,harvesting,3,4,7
3UUIU9GZC5624UZ0UQ7VA8DYYB25TQ,"Del Rosario said that the Chinese fishermen had been ""engaged in illegal fishing and harvesting of endangered marine species.""",85,124,harvesting of endangered marine species,2,0,2
3UUIU9GZC5624UZ0UQ7VA8DYYB25TQ,"Del Rosario said that the Chinese fishermen had been ""engaged in illegal fishing and harvesting of endangered marine species.""",99,109,endangered,5,10,15
3UUIU9GZC5624UZ0UQ7VA8DYYB25TQ,"Del Rosario said that the Chinese fishermen had been ""engaged in illegal fishing and harvesting of endangered marine species.""",99,124,endangered marine species,3,0,3
3UUIU9GZC5624UZ0UQ7VA8DYYB25TQ,"Del Rosario said that the Chinese fishermen had been ""engaged in illegal fishing and harvesting of endangered marine species.""",110,116,marine,1,0,1
3UUIU9GZC5624UZ0UQ7VA8DYYB25TQ,"Del Rosario said that the Chinese fishermen had been ""engaged in illegal fishing and harvesting of endangered marine species.""",117,124,species,2,0,2
3UUIU9GZC5624UZ0UQ7VA8DYYB25TQ,"Two Chinese maritime surveillance ships later approached and positioned themselves between the Philippine warship and the Chinese fishing vessels ""thus preventing the arrests of the erring Chinese fishermen,"" the Philippine statement said.",12,20,maritime,3,3,6
3UUIU9GZC5624UZ0UQ7VA8DYYB25TQ,"Two Chinese maritime surveillance ships later approached and positioned themselves between the Philippine warship and the Chinese fishing vessels ""thus preventing the arrests of the erring Chinese fishermen,"" the Philippine statement said.",12,33,maritime surveillance,3,1,4
3UUIU9GZC5624UZ0UQ7VA8DYYB25TQ,"Two Chinese maritime surveillance ships later approached and positioned themselves between the Philippine warship and the Chinese fishing vessels ""thus preventing the arrests of the erring Chinese fishermen,"" the Philippine statement said.",12,39,maritime surveillance ships,2,0,2
3UUIU9GZC5624UZ0UQ7VA8DYYB25TQ,"Two Chinese maritime surveillance ships later approached and positioned themselves between the Philippine warship and the Chinese fishing vessels ""thus preventing the arrests of the erring Chinese fishermen,"" the Philippine statement said.",21,33,surveillance,4,4,8
3UUIU9GZC5624UZ0UQ7VA8DYYB25TQ,"Two Chinese maritime surveillance ships later approached and positioned themselves between the Philippine warship and the Chinese fishing vessels ""thus preventing the arrests of the erring Chinese fishermen,"" the Philippine statement said.",21,39,surveillance ships,1,1,2
3UUIU9GZC5624UZ0UQ7VA8DYYB25TQ,"Two Chinese maritime surveillance ships later approached and positioned themselves between the Philippine warship and the Chinese fishing vessels ""thus preventing the arrests of the erring Chinese fishermen,"" the Philippine statement said.",46,56,approached,1,0,1
3UUIU9GZC5624UZ0UQ7VA8DYYB25TQ,"Two Chinese maritime surveillance ships later approached and positioned themselves between the Philippine warship and the Chinese fishing vessels ""thus preventing the arrests of the erring Chinese fishermen,"" the Philippine statement said.",61,71,positioned,2,1,3
3UUIU9GZC5624UZ0UQ7VA8DYYB25TQ,"Two Chinese maritime surveillance ships later approached and positioned themselves between the Philippine warship and the Chinese fishing vessels ""thus preventing the arrests of the erring Chinese fishermen,"" the Philippine statement said.",106,113,warship,1,0,1
3UUIU9GZC5624UZ0UQ7VA8DYYB25TQ,"Two Chinese maritime surveillance ships later approached and positioned themselves between the Philippine warship and the Chinese fishing vessels ""thus preventing the arrests of the erring Chinese fishermen,"" the Philippine statement said.",138,145,vessels,1,2,3
3UUIU9GZC5624UZ0UQ7VA8DYYB25TQ,"Two Chinese maritime surveillance ships later approached and positioned themselves between the Philippine warship and the Chinese fishing vessels ""thus preventing the arrests of the erring Chinese fishermen,"" the Philippine statement said.",152,162,preventing,1,0,1
3UUIU9GZC5624UZ0UQ7VA8DYYB25TQ,"Two Chinese maritime surveillance ships later approached and positioned themselves between the Philippine warship and the Chinese fishing vessels ""thus preventing the arrests of the erring Chinese fishermen,"" the Philippine statement said.",182,188,erring,8,8,16
3UUIU9GZC5624UZ0UQ7VA8DYYB25TQ,"The Chinese Embassy said the fishing boats had taken shelter from a storm in the lagoon, and that Philippine troops including some who were armed went into the lagoon and harassed the fishermen.",12,19,Embassy,2,0,2
3UUIU9GZC5624UZ0UQ7VA8DYYB25TQ,"The Chinese Embassy said the fishing boats had taken shelter from a storm in the lagoon, and that Philippine troops including some who were armed went into the lagoon and harassed the fishermen.",53,60,shelter,1,2,3
3UUIU9GZC5624UZ0UQ7VA8DYYB25TQ,"The Chinese Embassy said the fishing boats had taken shelter from a storm in the lagoon, and that Philippine troops including some who were armed went into the lagoon and harassed the fishermen.",81,87,lagoon,6,5,11
3UUIU9GZC5624UZ0UQ7VA8DYYB25TQ,"The Chinese Embassy said the fishing boats had taken shelter from a storm in the lagoon, and that Philippine troops including some who were armed went into the lagoon and harassed the fishermen.",160,166,lagoon,3,1,4
3UUIU9GZC5624UZ0UQ7VA8DYYB25TQ,"The Chinese Embassy said the fishing boats had taken shelter from a storm in the lagoon, and that Philippine troops including some who were armed went into the lagoon and harassed the fishermen.",171,179,harassed,9,7,16
3Y3N5A7N4GAWTNJ0WVBGZRGZY7MMYV,“Obama’s visit to Afghanistan came under huge security preparations.,41,45,huge,0,2,2
3Y3N5A7N4GAWTNJ0WVBGZRGZY7MMYV,“Obama’s visit to Afghanistan came under huge security preparations.,41,67,huge security preparations,1,1,2
3Y3N5A7N4GAWTNJ0WVBGZRGZY7MMYV,“Obama’s visit to Afghanistan came under huge security preparations.,46,54,security,1,1,2
3Y3N5A7N4GAWTNJ0WVBGZRGZY7MMYV,“Obama’s visit to Afghanistan came under huge security preparations.,46,67,security preparations,1,2,3
3Y3N5A7N4GAWTNJ0WVBGZRGZY7MMYV,“Obama’s visit to Afghanistan came under huge security preparations.,55,67,preparations,6,2,8
3Y3N5A7N4GAWTNJ0WVBGZRGZY7MMYV,"Of course it was not risky for him, but it created concerns for citizens of Kabul.",21,26,risky,2,2,4
3Y3N5A7N4GAWTNJ0WVBGZRGZY7MMYV,"Of course it was not risky for him, but it created concerns for citizens of Kabul.",43,59,created concerns,0,1,1
3Y3N5A7N4GAWTNJ0WVBGZRGZY7MMYV,"Of course it was not risky for him, but it created concerns for citizens of Kabul.",51,59,concerns,0,4,4
3Y3N5A7N4GAWTNJ0WVBGZRGZY7MMYV,"Of course it was not risky for him, but it created concerns for citizens of Kabul.",64,72,citizens,1,0,1
3Y3N5A7N4GAWTNJ0WVBGZRGZY7MMYV,"People were worried that many things would happen,” says Muhammad Hassan Haqyar, an independent political analyst in Kabul.",84,95,independent,3,1,4
3Y3N5A7N4GAWTNJ0WVBGZRGZY7MMYV,"People were worried that many things would happen,” says Muhammad Hassan Haqyar, an independent political analyst in Kabul.",84,113,independent political analyst,6,0,6
3Y3N5A7N4GAWTNJ0WVBGZRGZY7MMYV,"People were worried that many things would happen,” says Muhammad Hassan Haqyar, an independent political analyst in Kabul.",96,105,political,2,0,2
3Y3N5A7N4GAWTNJ0WVBGZRGZY7MMYV,"People were worried that many things would happen,” says Muhammad Hassan Haqyar, an independent political analyst in Kabul.",96,113,political analyst,0,1,1
3Y3N5A7N4GAWTNJ0WVBGZRGZY7MMYV,"People were worried that many things would happen,” says Muhammad Hassan Haqyar, an independent political analyst in Kabul.",106,113,analyst,4,2,6
3Y3N5A7N4GAWTNJ0WVBGZRGZY7MMYV,"“We saw the attack this morning that took the lives of many innocent people, but it was completely safe for Obama.”",24,31,morning,1,0,1
3Y3N5A7N4GAWTNJ0WVBGZRGZY7MMYV,"“We saw the attack this morning that took the lives of many innocent people, but it was completely safe for Obama.”",60,68,innocent,2,5,7
3Y3N5A7N4GAWTNJ0WVBGZRGZY7MMYV,"RELATED Afghanistan: 5 areas of concern after the US leaves The Taliban immediately claimed responsibility for the attack, saying they planned and conducted the attack on extremely short notice as soon as they learned about Obama’s arrival in Afghanistan.",0,7,RELATED,0,1,1
3Y3N5A7N4GAWTNJ0WVBGZRGZY7MMYV,"RELATED Afghanistan: 5 areas of concern after the US leaves The Taliban immediately claimed responsibility for the attack, saying they planned and conducted the attack on extremely short notice as soon as they learned about Obama’s arrival in Afghanistan.",32,39,concern,2,1,3
3Y3N5A7N4GAWTNJ0WVBGZRGZY7MMYV,"RELATED Afghanistan: 5 areas of concern after the US leaves The Taliban immediately claimed responsibility for the attack, saying they planned and conducted the attack on extremely short notice as soon as they learned about Obama’s arrival in Afghanistan.",64,71,Taliban,1,0,1
3Y3N5A7N4GAWTNJ0WVBGZRGZY7MMYV,"RELATED Afghanistan: 5 areas of concern after the US leaves The Taliban immediately claimed responsibility for the attack, saying they planned and conducted the attack on extremely short notice as soon as they learned about Obama’s arrival in Afghanistan.",72,83,immediately,2,0,2
3Y3N5A7N4GAWTNJ0WVBGZRGZY7MMYV,"RELATED Afghanistan: 5 areas of concern after the US leaves The Taliban immediately claimed responsibility for the attack, saying they planned and conducted the attack on extremely short notice as soon as they learned about Obama’s arrival in Afghanistan.",84,91,claimed,0,4,4
3Y3N5A7N4GAWTNJ0WVBGZRGZY7MMYV,"RELATED Afghanistan: 5 areas of concern after the US leaves The Taliban immediately claimed responsibility for the attack, saying they planned and conducted the attack on extremely short notice as soon as they learned about Obama’s arrival in Afghanistan.",84,106,claimed responsibility,1,0,1
3Y3N5A7N4GAWTNJ0WVBGZRGZY7MMYV,"RELATED Afghanistan: 5 areas of concern after the US leaves The Taliban immediately claimed responsibility for the attack, saying they planned and conducted the attack on extremely short notice as soon as they learned about Obama’s arrival in Afghanistan.",92,106,responsibility,0,1,1
3Y3N5A7N4GAWTNJ0WVBGZRGZY7MMYV,"RELATED Afghanistan: 5 areas of concern after the US leaves The Taliban immediately claimed responsibility for the attack, saying they planned and conducted the attack on extremely short notice as soon as they learned about Obama’s arrival in Afghanistan.",147,156,conducted,5,3,8
3Y3N5A7N4GAWTNJ0WVBGZRGZY7MMYV,"RELATED Afghanistan: 5 areas of concern after the US leaves The Taliban immediately claimed responsibility for the attack, saying they planned and conducted the attack on extremely short notice as soon as they learned about Obama’s arrival in Afghanistan.",171,180,extremely,2,3,5
3Y3N5A7N4GAWTNJ0WVBGZRGZY7MMYV,"RELATED Afghanistan: 5 areas of concern after the US leaves The Taliban immediately claimed responsibility for the attack, saying they planned and conducted the attack on extremely short notice as soon as they learned about Obama’s arrival in Afghanistan.",171,193,extremely short notice,2,1,3
3Y3N5A7N4GAWTNJ0WVBGZRGZY7MMYV,"RELATED Afghanistan: 5 areas of concern after the US leaves The Taliban immediately claimed responsibility for the attack, saying they planned and conducted the attack on extremely short notice as soon as they learned about Obama’s arrival in Afghanistan.",181,193,short notice,1,0,1
3Y3N5A7N4GAWTNJ0WVBGZRGZY7MMYV,The unsophisticated nature of the attack suggests little planning beyond having fighters and some explosives pre-positioned in the vicinity of Kabul.,4,19,unsophisticated,10,10,20
3Y3N5A7N4GAWTNJ0WVBGZRGZY7MMYV,The unsophisticated nature of the attack suggests little planning beyond having fighters and some explosives pre-positioned in the vicinity of Kabul.,4,26,unsophisticated nature,3,1,4
3Y3N5A7N4GAWTNJ0WVBGZRGZY7MMYV,The unsophisticated nature of the attack suggests little planning beyond having fighters and some explosives pre-positioned in the vicinity of Kabul.,66,72,beyond,0,4,4
3Y3N5A7N4GAWTNJ0WVBGZRGZY7MMYV,The unsophisticated nature of the attack suggests little planning beyond having fighters and some explosives pre-positioned in the vicinity of Kabul.,98,108,explosives,2,3,5
3Y3N5A7N4GAWTNJ0WVBGZRGZY7MMYV,The unsophisticated nature of the attack suggests little planning beyond having fighters and some explosives pre-positioned in the vicinity of Kabul.,109,123,pre-positioned,10,3,13
3Y3N5A7N4GAWTNJ0WVBGZRGZY7MMYV,The unsophisticated nature of the attack suggests little planning beyond having fighters and some explosives pre-positioned in the vicinity of Kabul.,131,139,vicinity,9,8,17
3E6L1VR4XWNO4THD4PCBLACX2WHF6H,"With that, it was back to the sprawling U.S. air base outside the capital to underscore that last point, that he will close down the war and bring U.S. forces home.",30,39,sprawling,10,10,20
3E6L1VR4XWNO4THD4PCBLACX2WHF6H,"With that, it was back to the sprawling U.S. air base outside the capital to underscore that last point, that he will close down the war and bring U.S. forces home.",77,87,underscore,10,10,20
3E6L1VR4XWNO4THD4PCBLACX2WHF6H,"With that, it was back to the sprawling U.S. air base outside the capital to underscore that last point, that he will close down the war and bring U.S. forces home.",118,128,close down,1,0,1
3E6L1VR4XWNO4THD4PCBLACX2WHF6H,"With that, it was back to the sprawling U.S. air base outside the capital to underscore that last point, that he will close down the war and bring U.S. forces home.",152,158,forces,1,0,1
3E6L1VR4XWNO4THD4PCBLACX2WHF6H,"By alighting in Afghanistan on the anniversary of the raid that killed Sept. 11 mastermind Osama bin Laden, Obama was also making an unsubtle show of the power of the presidency.",3,12,alighting,10,10,20
3E6L1VR4XWNO4THD4PCBLACX2WHF6H,"By alighting in Afghanistan on the anniversary of the raid that killed Sept. 11 mastermind Osama bin Laden, Obama was also making an unsubtle show of the power of the presidency.",3,27,alighting in Afghanistan,1,0,1
3E6L1VR4XWNO4THD4PCBLACX2WHF6H,"By alighting in Afghanistan on the anniversary of the raid that killed Sept. 11 mastermind Osama bin Laden, Obama was also making an unsubtle show of the power of the presidency.",35,46,anniversary,2,2,4
3E6L1VR4XWNO4THD4PCBLACX2WHF6H,"By alighting in Afghanistan on the anniversary of the raid that killed Sept. 11 mastermind Osama bin Laden, Obama was also making an unsubtle show of the power of the presidency.",54,58,raid,1,1,2
3E6L1VR4XWNO4THD4PCBLACX2WHF6H,"By alighting in Afghanistan on the anniversary of the raid that killed Sept. 11 mastermind Osama bin Laden, Obama was also making an unsubtle show of the power of the presidency.",80,90,mastermind,6,7,13
3E6L1VR4XWNO4THD4PCBLACX2WHF6H,"By alighting in Afghanistan on the anniversary of the raid that killed Sept. 11 mastermind Osama bin Laden, Obama was also making an unsubtle show of the power of the presidency.",133,141,unsubtle,10,10,20
3E6L1VR4XWNO4THD4PCBLACX2WHF6H,"By alighting in Afghanistan on the anniversary of the raid that killed Sept. 11 mastermind Osama bin Laden, Obama was also making an unsubtle show of the power of the presidency.",133,146,unsubtle show,0,1,1
3E6L1VR4XWNO4THD4PCBLACX2WHF6H,"By alighting in Afghanistan on the anniversary of the raid that killed Sept. 11 mastermind Osama bin Laden, Obama was also making an unsubtle show of the power of the presidency.",133,159,unsubtle show of the power,1,0,1
3E6L1VR4XWNO4THD4PCBLACX2WHF6H,"By alighting in Afghanistan on the anniversary of the raid that killed Sept. 11 mastermind Osama bin Laden, Obama was also making an unsubtle show of the power of the presidency.",167,177,presidency,2,0,2
3E6L1VR4XWNO4THD4PCBLACX2WHF6H,Not only is he the commander in chief who can finally end what many Americans see as an unwinnable war  — Obama was telling Americans that he is the commander in chief who bagged the biggest bad guy in America's recent history.,19,28,commander,1,0,1
3E6L1VR4XWNO4THD4PCBLACX2WHF6H,Not only is he the commander in chief who can finally end what many Americans see as an unwinnable war  — Obama was telling Americans that he is the commander in chief who bagged the biggest bad guy in America's recent history.,19,37,commander in chief,1,0,1
3E6L1VR4XWNO4THD4PCBLACX2WHF6H,Not only is he the commander in chief who can finally end what many Americans see as an unwinnable war  — Obama was telling Americans that he is the commander in chief who bagged the biggest bad guy in America's recent history.,46,53,finally,1,0,1
3E6L1VR4XWNO4THD4PCBLACX2WHF6H,Not only is he the commander in chief who can finally end what many Americans see as an unwinnable war  — Obama was telling Americans that he is the commander in chief who bagged the biggest bad guy in America's recent history.,88,98,unwinnable,5,7,12
3E6L1VR4XWNO4THD4PCBLACX2WHF6H,Not only is he the commander in chief who can finally end what many Americans see as an unwinnable war  — Obama was telling Americans that he is the commander in chief who bagged the biggest bad guy in America's recent history.,88,102,unwinnable war,1,1,2
3E6L1VR4XWNO4THD4PCBLACX2WHF6H,Not only is he the commander in chief who can finally end what many Americans see as an unwinnable war  — Obama was telling Americans that he is the commander in chief who bagged the biggest bad guy in America's recent history.,149,167,commander in chief,2,0,2
3E6L1VR4XWNO4THD4PCBLACX2WHF6H,Not only is he the commander in chief who can finally end what many Americans see as an unwinnable war  — Obama was telling Americans that he is the commander in chief who bagged the biggest bad guy in America's recent history.,172,178,bagged,8,10,18
3E6L1VR4XWNO4THD4PCBLACX2WHF6H,Not only is he the commander in chief who can finally end what many Americans see as an unwinnable war  — Obama was telling Americans that he is the commander in chief who bagged the biggest bad guy in America's recent history.,212,218,recent,0,1,1
3ZUE82NE0A2B8701X4995O8O8R7F83,"  They said it was in response to the  U.S. president's visit and promised more attacks as they launch their  usual ""spring offensive"" across the country.",22,30,response,1,1,2
3ZUE82NE0A2B8701X4995O8O8R7F83,"  They said it was in response to the  U.S. president's visit and promised more attacks as they launch their  usual ""spring offensive"" across the country.",44,54,presidents,1,0,1
3ZUE82NE0A2B8701X4995O8O8R7F83,"  They said it was in response to the  U.S. president's visit and promised more attacks as they launch their  usual ""spring offensive"" across the country.",96,102,launch,1,4,5
3ZUE82NE0A2B8701X4995O8O8R7F83,"  They said it was in response to the  U.S. president's visit and promised more attacks as they launch their  usual ""spring offensive"" across the country.",117,133,spring offensive,9,5,14
3ZUE82NE0A2B8701X4995O8O8R7F83,"  They said it was in response to the  U.S. president's visit and promised more attacks as they launch their  usual ""spring offensive"" across the country.",117,123,spring,0,1,1
3ZUE82NE0A2B8701X4995O8O8R7F83,"  They said it was in response to the  U.S. president's visit and promised more attacks as they launch their  usual ""spring offensive"" across the country.",124,133,offensive,2,1,3
3ZUE82NE0A2B8701X4995O8O8R7F83,"  They said it was in response to the  U.S. president's visit and promised more attacks as they launch their  usual ""spring offensive"" across the country.",135,153,across the country,0,1,1
3ZUE82NE0A2B8701X4995O8O8R7F83,"Afghan officials and eyewitnesses say a suicide car bomber and militants  disguised as women were involved in the deadly assault, which also  wounded 17 people, mostly children.",21,33,eyewitnesses,5,8,13
3ZUE82NE0A2B8701X4995O8O8R7F83,"Afghan officials and eyewitnesses say a suicide car bomber and militants  disguised as women were involved in the deadly assault, which also  wounded 17 people, mostly children.",40,47,suicide,2,1,3
3ZUE82NE0A2B8701X4995O8O8R7F83,"Afghan officials and eyewitnesses say a suicide car bomber and militants  disguised as women were involved in the deadly assault, which also  wounded 17 people, mostly children.",40,58,suicide car bomber,2,0,2
3ZUE82NE0A2B8701X4995O8O8R7F83,"Afghan officials and eyewitnesses say a suicide car bomber and militants  disguised as women were involved in the deadly assault, which also  wounded 17 people, mostly children.",63,72,militants,7,2,9
3ZUE82NE0A2B8701X4995O8O8R7F83,"Afghan officials and eyewitnesses say a suicide car bomber and militants  disguised as women were involved in the deadly assault, which also  wounded 17 people, mostly children.",74,83,disguised,3,9,12
3ZUE82NE0A2B8701X4995O8O8R7F83,"Afghan officials and eyewitnesses say a suicide car bomber and militants  disguised as women were involved in the deadly assault, which also  wounded 17 people, mostly children.",114,128,deadly assault,1,4,5
3ZUE82NE0A2B8701X4995O8O8R7F83,"Afghan officials and eyewitnesses say a suicide car bomber and militants  disguised as women were involved in the deadly assault, which also  wounded 17 people, mostly children.",121,128,assault,4,2,6
3ZUE82NE0A2B8701X4995O8O8R7F83,"Afghan officials and eyewitnesses say a suicide car bomber and militants  disguised as women were involved in the deadly assault, which also  wounded 17 people, mostly children.",142,149,wounded,0,1,1
3ZUE82NE0A2B8701X4995O8O8R7F83,  Afghan security forces swarmed the  area and regained control after hours of gunfire.,9,24,security forces,1,0,1
3ZUE82NE0A2B8701X4995O8O8R7F83,  Afghan security forces swarmed the  area and regained control after hours of gunfire.,25,32,swarmed,8,10,18
3ZUE82NE0A2B8701X4995O8O8R7F83,  Afghan security forces swarmed the  area and regained control after hours of gunfire.,47,55,regained,1,3,4
3ZUE82NE0A2B8701X4995O8O8R7F83,  Afghan security forces swarmed the  area and regained control after hours of gunfire.,47,63,regained control,0,1,1
3ZUE82NE0A2B8701X4995O8O8R7F83,"NATO spokesman General Carsten Jacobson called the bombing ""another   desperate attack"" that resulted in the deaths of innocent Afghan   civilians.",5,14,spokesman,0,1,1
3ZUE82NE0A2B8701X4995O8O8R7F83,"NATO spokesman General Carsten Jacobson called the bombing ""another   desperate attack"" that resulted in the deaths of innocent Afghan   civilians.",70,79,desperate,6,4,10
3ZUE82NE0A2B8701X4995O8O8R7F83,"NATO spokesman General Carsten Jacobson called the bombing ""another   desperate attack"" that resulted in the deaths of innocent Afghan   civilians.",70,86,desperate attack,0,1,1
3ZUE82NE0A2B8701X4995O8O8R7F83,"NATO spokesman General Carsten Jacobson called the bombing ""another   desperate attack"" that resulted in the deaths of innocent Afghan   civilians.",119,127,innocent,2,2,4
3ZUE82NE0A2B8701X4995O8O8R7F83,"NATO spokesman General Carsten Jacobson called the bombing ""another   desperate attack"" that resulted in the deaths of innocent Afghan   civilians.",137,146,civilians,1,0,1
3ZUE82NE0A2B8701X4995O8O8R7F83,"  He credited the Afghan security forces for quickly   responding and said there was no failure in intelligence leading up to   the incident.Meanwhile, NATO officials said a bomb attack killed two service members in the eastern part of the country.Last month, militants staged one of the largest coordinated assaults in Kabul, which paralyzed the city's center and diplomatic area for nearly 18 hours.",5,13,credited,2,2,4
3ZUE82NE0A2B8701X4995O8O8R7F83,"  He credited the Afghan security forces for quickly   responding and said there was no failure in intelligence leading up to   the incident.Meanwhile, NATO officials said a bomb attack killed two service members in the eastern part of the country.Last month, militants staged one of the largest coordinated assaults in Kabul, which paralyzed the city's center and diplomatic area for nearly 18 hours.",55,65,responding,0,1,1
3ZUE82NE0A2B8701X4995O8O8R7F83,"  He credited the Afghan security forces for quickly   responding and said there was no failure in intelligence leading up to   the incident.Meanwhile, NATO officials said a bomb attack killed two service members in the eastern part of the country.Last month, militants staged one of the largest coordinated assaults in Kabul, which paralyzed the city's center and diplomatic area for nearly 18 hours.",88,95,failure,0,1,1
3ZUE82NE0A2B8701X4995O8O8R7F83,"  He credited the Afghan security forces for quickly   responding and said there was no failure in intelligence leading up to   the incident.Meanwhile, NATO officials said a bomb attack killed two service members in the eastern part of the country.Last month, militants staged one of the largest coordinated assaults in Kabul, which paralyzed the city's center and diplomatic area for nearly 18 hours.",88,111,failure in intelligence,1,0,1
3ZUE82NE0A2B8701X4995O8O8R7F83,"  He credited the Afghan security forces for quickly   responding and said there was no failure in intelligence leading up to   the incident.Meanwhile, NATO officials said a bomb attack killed two service members in the eastern part of the country.Last month, militants staged one of the largest coordinated assaults in Kabul, which paralyzed the city's center and diplomatic area for nearly 18 hours.",99,111,intelligence,4,1,5
3ZUE82NE0A2B8701X4995O8O8R7F83,"  He credited the Afghan security forces for quickly   responding and said there was no failure in intelligence leading up to   the incident.Meanwhile, NATO officials said a bomb attack killed two service members in the eastern part of the country.Last month, militants staged one of the largest coordinated assaults in Kabul, which paralyzed the city's center and diplomatic area for nearly 18 hours.",112,119,leading,0,1,1
3ZUE82NE0A2B8701X4995O8O8R7F83,"  He credited the Afghan security forces for quickly   responding and said there was no failure in intelligence leading up to   the incident.Meanwhile, NATO officials said a bomb attack killed two service members in the eastern part of the country.Last month, militants staged one of the largest coordinated assaults in Kabul, which paralyzed the city's center and diplomatic area for nearly 18 hours.",260,269,militants,4,1,5
3ZUE82NE0A2B8701X4995O8O8R7F83,"  He credited the Afghan security forces for quickly   responding and said there was no failure in intelligence leading up to   the incident.Meanwhile, NATO officials said a bomb attack killed two service members in the eastern part of the country.Last month, militants staged one of the largest coordinated assaults in Kabul, which paralyzed the city's center and diplomatic area for nearly 18 hours.",270,276,staged,1,3,4
3ZUE82NE0A2B8701X4995O8O8R7F83,"  He credited the Afghan security forces for quickly   responding and said there was no failure in intelligence leading up to   the incident.Meanwhile, NATO officials said a bomb attack killed two service members in the eastern part of the country.Last month, militants staged one of the largest coordinated assaults in Kabul, which paralyzed the city's center and diplomatic area for nearly 18 hours.",296,307,coordinated,5,4,9
3ZUE82NE0A2B8701X4995O8O8R7F83,"  He credited the Afghan security forces for quickly   responding and said there was no failure in intelligence leading up to   the incident.Meanwhile, NATO officials said a bomb attack killed two service members in the eastern part of the country.Last month, militants staged one of the largest coordinated assaults in Kabul, which paralyzed the city's center and diplomatic area for nearly 18 hours.",296,316,coordinated assaults,4,2,6
3ZUE82NE0A2B8701X4995O8O8R7F83,"  He credited the Afghan security forces for quickly   responding and said there was no failure in intelligence leading up to   the incident.Meanwhile, NATO officials said a bomb attack killed two service members in the eastern part of the country.Last month, militants staged one of the largest coordinated assaults in Kabul, which paralyzed the city's center and diplomatic area for nearly 18 hours.",308,316,assaults,0,1,1
3ZUE82NE0A2B8701X4995O8O8R7F83,"  He credited the Afghan security forces for quickly   responding and said there was no failure in intelligence leading up to   the incident.Meanwhile, NATO officials said a bomb attack killed two service members in the eastern part of the country.Last month, militants staged one of the largest coordinated assaults in Kabul, which paralyzed the city's center and diplomatic area for nearly 18 hours.",333,342,paralyzed,10,10,20
3ZUE82NE0A2B8701X4995O8O8R7F83,"  He credited the Afghan security forces for quickly   responding and said there was no failure in intelligence leading up to   the incident.Meanwhile, NATO officials said a bomb attack killed two service members in the eastern part of the country.Last month, militants staged one of the largest coordinated assaults in Kabul, which paralyzed the city's center and diplomatic area for nearly 18 hours.",365,375,diplomatic,3,0,3
3ZUE82NE0A2B8701X4995O8O8R7F83,"  He credited the Afghan security forces for quickly   responding and said there was no failure in intelligence leading up to   the incident.Meanwhile, NATO officials said a bomb attack killed two service members in the eastern part of the country.Last month, militants staged one of the largest coordinated assaults in Kabul, which paralyzed the city's center and diplomatic area for nearly 18 hours.",365,380,diplomatic area,2,1,3
3UV0D2KX1MKAP6DZL1JWOCSJ65BF4W,"Yet here, in the pre-dawn darkness of Afghanistan, we can see the light of a new day on the horizon, said Obama, seeking a second White House term later this year.",18,26,pre-dawn,7,9,16
3UV0D2KX1MKAP6DZL1JWOCSJ65BF4W,"Yet here, in the pre-dawn darkness of Afghanistan, we can see the light of a new day on the horizon, said Obama, seeking a second White House term later this year.",18,35,pre-dawn darkness,3,2,5
3UV0D2KX1MKAP6DZL1JWOCSJ65BF4W,"Yet here, in the pre-dawn darkness of Afghanistan, we can see the light of a new day on the horizon, said Obama, seeking a second White House term later this year.",59,100,see the light of a new day on the horizon,1,0,1
3UV0D2KX1MKAP6DZL1JWOCSJ65BF4W,"Yet here, in the pre-dawn darkness of Afghanistan, we can see the light of a new day on the horizon, said Obama, seeking a second White House term later this year.",93,100,horizon,4,2,6
3UV0D2KX1MKAP6DZL1JWOCSJ65BF4W,"Yet here, in the pre-dawn darkness of Afghanistan, we can see the light of a new day on the horizon, said Obama, seeking a second White House term later this year.",115,122,seeking,0,1,1
3UV0D2KX1MKAP6DZL1JWOCSJ65BF4W,"Obama flew into Kabul in secret in the dead of night and signed the deal with President Hamid Karzai, cementing 10 years of US aid for Afghanistan after NATO combat troops leave in 2014.",6,10,flew,0,2,2
3UV0D2KX1MKAP6DZL1JWOCSJ65BF4W,"Obama flew into Kabul in secret in the dead of night and signed the deal with President Hamid Karzai, cementing 10 years of US aid for Afghanistan after NATO combat troops leave in 2014.",25,31,secret,0,1,1
3UV0D2KX1MKAP6DZL1JWOCSJ65BF4W,"Obama flew into Kabul in secret in the dead of night and signed the deal with President Hamid Karzai, cementing 10 years of US aid for Afghanistan after NATO combat troops leave in 2014.",39,52,dead of night,6,2,8
3UV0D2KX1MKAP6DZL1JWOCSJ65BF4W,"Obama flew into Kabul in secret in the dead of night and signed the deal with President Hamid Karzai, cementing 10 years of US aid for Afghanistan after NATO combat troops leave in 2014.",102,111,cementing,6,6,12
3UV0D2KX1MKAP6DZL1JWOCSJ65BF4W,"Obama flew into Kabul in secret in the dead of night and signed the deal with President Hamid Karzai, cementing 10 years of US aid for Afghanistan after NATO combat troops leave in 2014.",153,171,NATO combat troops,1,0,1
3UV0D2KX1MKAP6DZL1JWOCSJ65BF4W,"Obama flew into Kabul in secret in the dead of night and signed the deal with President Hamid Karzai, cementing 10 years of US aid for Afghanistan after NATO combat troops leave in 2014.",158,164,combat,1,2,3
3UV0D2KX1MKAP6DZL1JWOCSJ65BF4W,Most Afghans were asleep and he left after about six hours.,18,24,asleep,0,3,3
3UV0D2KX1MKAP6DZL1JWOCSJ65BF4W,"We look forward to a future of peace.	22	28	future	1	0	1
3UV0D2KX1MKAP6DZL1JWOCSJ65BF4W	We look forward to a future of peace.",22,37,future of peace,0,1,1
3UV0D2KX1MKAP6DZL1JWOCSJ65BF4W,"We're agreeing to be long-term partners,"" Obama said at Karzai's palace.",6,14,agreeing,0,1,1
3UV0D2KX1MKAP6DZL1JWOCSJ65BF4W,"We're agreeing to be long-term partners,"" Obama said at Karzai's palace.",21,30,long-term,2,0,2
3UV0D2KX1MKAP6DZL1JWOCSJ65BF4W,"We're agreeing to be long-term partners,"" Obama said at Karzai's palace.",21,39,long-term partners,1,0,1
3UV0D2KX1MKAP6DZL1JWOCSJ65BF4W,"We're agreeing to be long-term partners,"" Obama said at Karzai's palace.",56,63,Karzais,1,0,1
3UV0D2KX1MKAP6DZL1JWOCSJ65BF4W,The Taliban said Karzai had no right to sign the deal and accused him of selling Afghan sovereignty to the Americans.,17,23,Karzai,1,0,1
3UV0D2KX1MKAP6DZL1JWOCSJ65BF4W,The Taliban said Karzai had no right to sign the deal and accused him of selling Afghan sovereignty to the Americans.,58,65,accused,1,5,6
3UV0D2KX1MKAP6DZL1JWOCSJ65BF4W,The Taliban said Karzai had no right to sign the deal and accused him of selling Afghan sovereignty to the Americans.,73,99,selling Afghan sovereignty,1,0,1
3UV0D2KX1MKAP6DZL1JWOCSJ65BF4W,The Taliban said Karzai had no right to sign the deal and accused him of selling Afghan sovereignty to the Americans.,81,99,Afghan sovereignty,1,0,1
3UV0D2KX1MKAP6DZL1JWOCSJ65BF4W,The Taliban said Karzai had no right to sign the deal and accused him of selling Afghan sovereignty to the Americans.,88,99,sovereignty,10,10,20
3UV0D2KX1MKAP6DZL1JWOCSJ65BF4W,"The militants vowed to continue their armed struggle ""against all the contents of this illegitimate document until the full withdrawal of all invading forces and their puppets"" -- referring to the Karzai government.",4,13,militants,3,2,5
3UV0D2KX1MKAP6DZL1JWOCSJ65BF4W,"The militants vowed to continue their armed struggle ""against all the contents of this illegitimate document until the full withdrawal of all invading forces and their puppets"" -- referring to the Karzai government.",4,19,militants vowed,0,1,1
3UV0D2KX1MKAP6DZL1JWOCSJ65BF4W,"The militants vowed to continue their armed struggle ""against all the contents of this illegitimate document until the full withdrawal of all invading forces and their puppets"" -- referring to the Karzai government.",14,19,vowed,2,5,7
3UV0D2KX1MKAP6DZL1JWOCSJ65BF4W,"The militants vowed to continue their armed struggle ""against all the contents of this illegitimate document until the full withdrawal of all invading forces and their puppets"" -- referring to the Karzai government.",14,31,vowed to continue,0,1,1
3UV0D2KX1MKAP6DZL1JWOCSJ65BF4W,"The militants vowed to continue their armed struggle ""against all the contents of this illegitimate document until the full withdrawal of all invading forces and their puppets"" -- referring to the Karzai government.",38,52,armed struggle,4,1,5
3UV0D2KX1MKAP6DZL1JWOCSJ65BF4W,"The militants vowed to continue their armed struggle ""against all the contents of this illegitimate document until the full withdrawal of all invading forces and their puppets"" -- referring to the Karzai government.",44,52,struggle,0,2,2
3UV0D2KX1MKAP6DZL1JWOCSJ65BF4W,"The militants vowed to continue their armed struggle ""against all the contents of this illegitimate document until the full withdrawal of all invading forces and their puppets"" -- referring to the Karzai government.",70,78,contents,1,0,1
3UV0D2KX1MKAP6DZL1JWOCSJ65BF4W,"The militants vowed to continue their armed struggle ""against all the contents of this illegitimate document until the full withdrawal of all invading forces and their puppets"" -- referring to the Karzai government.",70,108,contents of this illegitimate document,1,0,1
3UV0D2KX1MKAP6DZL1JWOCSJ65BF4W,"The militants vowed to continue their armed struggle ""against all the contents of this illegitimate document until the full withdrawal of all invading forces and their puppets"" -- referring to the Karzai government.",87,99,illegitimate,8,9,17
3UV0D2KX1MKAP6DZL1JWOCSJ65BF4W,"The militants vowed to continue their armed struggle ""against all the contents of this illegitimate document until the full withdrawal of all invading forces and their puppets"" -- referring to the Karzai government.",87,108,illegitimate document,3,0,3
3UV0D2KX1MKAP6DZL1JWOCSJ65BF4W,"The militants vowed to continue their armed struggle ""against all the contents of this illegitimate document until the full withdrawal of all invading forces and their puppets"" -- referring to the Karzai government.",124,134,withdrawal,0,3,3
3UV0D2KX1MKAP6DZL1JWOCSJ65BF4W,"The militants vowed to continue their armed struggle ""against all the contents of this illegitimate document until the full withdrawal of all invading forces and their puppets"" -- referring to the Karzai government.",142,150,invading,2,5,7
3UV0D2KX1MKAP6DZL1JWOCSJ65BF4W,"The militants vowed to continue their armed struggle ""against all the contents of this illegitimate document until the full withdrawal of all invading forces and their puppets"" -- referring to the Karzai government.",142,157,invading forces,2,1,3
3UV0D2KX1MKAP6DZL1JWOCSJ65BF4W,"The militants vowed to continue their armed struggle ""against all the contents of this illegitimate document until the full withdrawal of all invading forces and their puppets"" -- referring to the Karzai government.",142,175,invading forces and their puppets,2,0,2
3UV0D2KX1MKAP6DZL1JWOCSJ65BF4W,"The militants vowed to continue their armed struggle ""against all the contents of this illegitimate document until the full withdrawal of all invading forces and their puppets"" -- referring to the Karzai government.",168,175,puppets,5,6,11
3UV0D2KX1MKAP6DZL1JWOCSJ65BF4W,"The militants vowed to continue their armed struggle ""against all the contents of this illegitimate document until the full withdrawal of all invading forces and their puppets"" -- referring to the Karzai government.",180,189,referring,0,1,1
3UV0D2KX1MKAP6DZL1JWOCSJ65BF4W,"The militants vowed to continue their armed struggle ""against all the contents of this illegitimate document until the full withdrawal of all invading forces and their puppets"" -- referring to the Karzai government.",197,203,Karzai,1,0,1
3UV0D2KX1MKAP6DZL1JWOCSJ65BF4W,"The militants vowed to continue their armed struggle ""against all the contents of this illegitimate document until the full withdrawal of all invading forces and their puppets"" -- referring to the Karzai government.",204,214,government,1,0,1
3BVS8WK9Q0WEKW0Y1OZ4ZNBHWD5BIM,The EU believes the deficit will be 6.4 percent this year and will only be reduced by 0.1 percent in 2013.,20,27,deficit,10,8,18
3BVS8WK9Q0WEKW0Y1OZ4ZNBHWD5BIM,"Apart from recent government spending cuts, another reason for this is ""the necessary adjustment of bank balance sheets,"" that will further reduce their willingness to gives loans thereby restricting growth.",18,28,government,1,0,1
3BVS8WK9Q0WEKW0Y1OZ4ZNBHWD5BIM,"Apart from recent government spending cuts, another reason for this is ""the necessary adjustment of bank balance sheets,"" that will further reduce their willingness to gives loans thereby restricting growth.",29,42,spending cuts,2,1,3
3BVS8WK9Q0WEKW0Y1OZ4ZNBHWD5BIM,"Apart from recent government spending cuts, another reason for this is ""the necessary adjustment of bank balance sheets,"" that will further reduce their willingness to gives loans thereby restricting growth.",72,119,the necessary adjustment of bank balance sheets,1,0,1
3BVS8WK9Q0WEKW0Y1OZ4ZNBHWD5BIM,"Apart from recent government spending cuts, another reason for this is ""the necessary adjustment of bank balance sheets,"" that will further reduce their willingness to gives loans thereby restricting growth.",76,96,necessary adjustment,1,2,3
3BVS8WK9Q0WEKW0Y1OZ4ZNBHWD5BIM,"Apart from recent government spending cuts, another reason for this is ""the necessary adjustment of bank balance sheets,"" that will further reduce their willingness to gives loans thereby restricting growth.",86,96,adjustment,2,1,3
3BVS8WK9Q0WEKW0Y1OZ4ZNBHWD5BIM,"Apart from recent government spending cuts, another reason for this is ""the necessary adjustment of bank balance sheets,"" that will further reduce their willingness to gives loans thereby restricting growth.",86,119,adjustment of bank balance sheets,1,0,1
3BVS8WK9Q0WEKW0Y1OZ4ZNBHWD5BIM,"Apart from recent government spending cuts, another reason for this is ""the necessary adjustment of bank balance sheets,"" that will further reduce their willingness to gives loans thereby restricting growth.",100,119,bank balance sheets,2,0,2
3BVS8WK9Q0WEKW0Y1OZ4ZNBHWD5BIM,"Apart from recent government spending cuts, another reason for this is ""the necessary adjustment of bank balance sheets,"" that will further reduce their willingness to gives loans thereby restricting growth.",105,119,balance sheets,0,1,1
3BVS8WK9Q0WEKW0Y1OZ4ZNBHWD5BIM,"Apart from recent government spending cuts, another reason for this is ""the necessary adjustment of bank balance sheets,"" that will further reduce their willingness to gives loans thereby restricting growth.",153,164,willingness,2,7,9
3BVS8WK9Q0WEKW0Y1OZ4ZNBHWD5BIM,"Apart from recent government spending cuts, another reason for this is ""the necessary adjustment of bank balance sheets,"" that will further reduce their willingness to gives loans thereby restricting growth.",180,187,thereby,0,1,1
3BVS8WK9Q0WEKW0Y1OZ4ZNBHWD5BIM,"Apart from recent government spending cuts, another reason for this is ""the necessary adjustment of bank balance sheets,"" that will further reduce their willingness to gives loans thereby restricting growth.",188,199,restricting,6,4,10
3BVS8WK9Q0WEKW0Y1OZ4ZNBHWD5BIM,"The EU expects the Spanish economy to contract by 1.8 percent this year, extending the recession till 2013 when the economy will shrink by a further 0.3 percent.",27,46,economy to contract,1,0,1
3BVS8WK9Q0WEKW0Y1OZ4ZNBHWD5BIM,"The EU expects the Spanish economy to contract by 1.8 percent this year, extending the recession till 2013 when the economy will shrink by a further 0.3 percent.",38,46,contract,2,0,2
3BVS8WK9Q0WEKW0Y1OZ4ZNBHWD5BIM,"The EU expects the Spanish economy to contract by 1.8 percent this year, extending the recession till 2013 when the economy will shrink by a further 0.3 percent.",73,82,extending,0,1,1
3BVS8WK9Q0WEKW0Y1OZ4ZNBHWD5BIM,"The EU expects the Spanish economy to contract by 1.8 percent this year, extending the recession till 2013 when the economy will shrink by a further 0.3 percent.",87,96,recession,10,5,15
3BVS8WK9Q0WEKW0Y1OZ4ZNBHWD5BIM,"The EU expects the Spanish economy to contract by 1.8 percent this year, extending the recession till 2013 when the economy will shrink by a further 0.3 percent.",116,123,economy,1,0,1
3BVS8WK9Q0WEKW0Y1OZ4ZNBHWD5BIM,"The EU expects the Spanish economy to contract by 1.8 percent this year, extending the recession till 2013 when the economy will shrink by a further 0.3 percent.",129,135,shrink,0,6,6
3BVS8WK9Q0WEKW0Y1OZ4ZNBHWD5BIM,"Shortly after arriving, about midnight local time, Mr. Obama and Karzai inked a pact to designate Afghanistan a major non-NATO ally.",65,71,Karzai,1,0,1
3BVS8WK9Q0WEKW0Y1OZ4ZNBHWD5BIM,"Shortly after arriving, about midnight local time, Mr. Obama and Karzai inked a pact to designate Afghanistan a major non-NATO ally.",72,77,inked,1,3,4
3BVS8WK9Q0WEKW0Y1OZ4ZNBHWD5BIM,"Shortly after arriving, about midnight local time, Mr. Obama and Karzai inked a pact to designate Afghanistan a major non-NATO ally.",72,84,inked a pact,3,1,4
3BVS8WK9Q0WEKW0Y1OZ4ZNBHWD5BIM,"Shortly after arriving, about midnight local time, Mr. Obama and Karzai inked a pact to designate Afghanistan a major non-NATO ally.",80,84,pact,3,2,5
3BVS8WK9Q0WEKW0Y1OZ4ZNBHWD5BIM,"Shortly after arriving, about midnight local time, Mr. Obama and Karzai inked a pact to designate Afghanistan a major non-NATO ally.",88,97,designate,10,4,14
3BVS8WK9Q0WEKW0Y1OZ4ZNBHWD5BIM,"Shortly after arriving, about midnight local time, Mr. Obama and Karzai inked a pact to designate Afghanistan a major non-NATO ally.",118,126,non-NATO,3,0,3
3BVS8WK9Q0WEKW0Y1OZ4ZNBHWD5BIM,"Shortly after arriving, about midnight local time, Mr. Obama and Karzai inked a pact to designate Afghanistan a major non-NATO ally.",118,131,non-NATO ally,2,1,3
3BVS8WK9Q0WEKW0Y1OZ4ZNBHWD5BIM,"Shortly after arriving, about midnight local time, Mr. Obama and Karzai inked a pact to designate Afghanistan a major non-NATO ally.",127,131,ally,1,2,3
3BVS8WK9Q0WEKW0Y1OZ4ZNBHWD5BIM,"The agreement says the U.S. will provide aid, advisers and support after NATO combat troops leave in 2014.",41,44,aid,0,1,1
3BVS8WK9Q0WEKW0Y1OZ4ZNBHWD5BIM,"The agreement says the U.S. will provide aid, advisers and support after NATO combat troops leave in 2014.",46,54,advisers,2,0,2
3BVS8WK9Q0WEKW0Y1OZ4ZNBHWD5BIM,"The agreement says the U.S. will provide aid, advisers and support after NATO combat troops leave in 2014.",73,91,NATO combat troops,0,1,1
3BVS8WK9Q0WEKW0Y1OZ4ZNBHWD5BIM,"The agreement says the U.S. will provide aid, advisers and support after NATO combat troops leave in 2014.",78,84,combat,2,0,2
3BVS8WK9Q0WEKW0Y1OZ4ZNBHWD5BIM,"The agreement says the U.S. will provide aid, advisers and support after NATO combat troops leave in 2014.",78,91,combat troops,0,1,1
3BVS8WK9Q0WEKW0Y1OZ4ZNBHWD5BIM,"Obama, Karzai ink partnership deal The visit comes on both the one-year anniversary of the death of Osama bin Laden and the day a new report from the Pentagon giving the war in Afghanistan a mixed review was released.",0,34,"Obama, Karzai ink partnership deal",1,0,1
3BVS8WK9Q0WEKW0Y1OZ4ZNBHWD5BIM,"Obama, Karzai ink partnership deal The visit comes on both the one-year anniversary of the death of Osama bin Laden and the day a new report from the Pentagon giving the war in Afghanistan a mixed review was released.",7,13,Karzai,1,0,1
3BVS8WK9Q0WEKW0Y1OZ4ZNBHWD5BIM,"Obama, Karzai ink partnership deal The visit comes on both the one-year anniversary of the death of Osama bin Laden and the day a new report from the Pentagon giving the war in Afghanistan a mixed review was released.",14,17,ink,1,2,3
3BVS8WK9Q0WEKW0Y1OZ4ZNBHWD5BIM,"Obama, Karzai ink partnership deal The visit comes on both the one-year anniversary of the death of Osama bin Laden and the day a new report from the Pentagon giving the war in Afghanistan a mixed review was released.",14,34,ink partnership deal,1,1,2
3BVS8WK9Q0WEKW0Y1OZ4ZNBHWD5BIM,"Obama, Karzai ink partnership deal The visit comes on both the one-year anniversary of the death of Osama bin Laden and the day a new report from the Pentagon giving the war in Afghanistan a mixed review was released.",18,34,partnership deal,1,0,1
3BVS8WK9Q0WEKW0Y1OZ4ZNBHWD5BIM,"Obama, Karzai ink partnership deal The visit comes on both the one-year anniversary of the death of Osama bin Laden and the day a new report from the Pentagon giving the war in Afghanistan a mixed review was released.",72,83,anniversary,0,2,2
3BVS8WK9Q0WEKW0Y1OZ4ZNBHWD5BIM,"Obama, Karzai ink partnership deal The visit comes on both the one-year anniversary of the death of Osama bin Laden and the day a new report from the Pentagon giving the war in Afghanistan a mixed review was released.",150,158,Pentagon,2,1,3
3BVS8WK9Q0WEKW0Y1OZ4ZNBHWD5BIM,"Obama, Karzai ink partnership deal The visit comes on both the one-year anniversary of the death of Osama bin Laden and the day a new report from the Pentagon giving the war in Afghanistan a mixed review was released.",191,203,mixed review,1,1,2
3BVS8WK9Q0WEKW0Y1OZ4ZNBHWD5BIM,"Obama, Karzai ink partnership deal The visit comes on both the one-year anniversary of the death of Osama bin Laden and the day a new report from the Pentagon giving the war in Afghanistan a mixed review was released.",197,203,review,0,3,3
3BVS8WK9Q0WEKW0Y1OZ4ZNBHWD5BIM,"Obama, Karzai ink partnership deal The visit comes on both the one-year anniversary of the death of Osama bin Laden and the day a new report from the Pentagon giving the war in Afghanistan a mixed review was released.",208,216,released,0,1,1
33CLA8O0MICHQCFXWDF9W53TZKJFR6,"More shots were heard inside the house as a SWAT team arrived and entered through a back entrance, he said.",16,21,heard,0,1,1
33CLA8O0MICHQCFXWDF9W53TZKJFR6,"More shots were heard inside the house as a SWAT team arrived and entered through a back entrance, he said.",44,48,SWAT,3,1,4
33CLA8O0MICHQCFXWDF9W53TZKJFR6,"More shots were heard inside the house as a SWAT team arrived and entered through a back entrance, he said.",44,53,SWAT team,3,2,5
33CLA8O0MICHQCFXWDF9W53TZKJFR6,"More shots were heard inside the house as a SWAT team arrived and entered through a back entrance, he said.",66,73,entered,0,1,1
33CLA8O0MICHQCFXWDF9W53TZKJFR6,"More shots were heard inside the house as a SWAT team arrived and entered through a back entrance, he said.",84,97,back entrance,1,2,3
33CLA8O0MICHQCFXWDF9W53TZKJFR6,"More shots were heard inside the house as a SWAT team arrived and entered through a back entrance, he said.",89,97,entrance,1,2,3
33CLA8O0MICHQCFXWDF9W53TZKJFR6,"A neighbor told police that three of the children had banged on his door shortly before 5 a.m., Goodyear said.",2,10,neighbor,0,1,1
33CLA8O0MICHQCFXWDF9W53TZKJFR6,"A neighbor told police that three of the children had banged on his door shortly before 5 a.m., Goodyear said.",54,60,banged,3,9,12
33CLA8O0MICHQCFXWDF9W53TZKJFR6,"One of them may have been shot and was bleeding, so the neighbor got a towel for the child, he said.",40,48,bleeding,0,5,5
33CLA8O0MICHQCFXWDF9W53TZKJFR6,"One of them may have been shot and was bleeding, so the neighbor got a towel for the child, he said.",57,65,neighbor,0,2,2
33CLA8O0MICHQCFXWDF9W53TZKJFR6,"One of them may have been shot and was bleeding, so the neighbor got a towel for the child, he said.",72,77,towel,0,1,1
33CLA8O0MICHQCFXWDF9W53TZKJFR6,"Tonya Thomas then appeared at the neighbor's door and ordered the children to return home, he said, adding: ""They did.",18,26,appeared,4,2,6
33CLA8O0MICHQCFXWDF9W53TZKJFR6,"It was the worst multiple homicide Goodyear could recall in Brevard County since a shooting in 1987 claimed six lives, including those of two police officers.",11,16,worst,0,2,2
33CLA8O0MICHQCFXWDF9W53TZKJFR6,"It was the worst multiple homicide Goodyear could recall in Brevard County since a shooting in 1987 claimed six lives, including those of two police officers.",11,34,worst multiple homicide,0,1,1
33CLA8O0MICHQCFXWDF9W53TZKJFR6,"It was the worst multiple homicide Goodyear could recall in Brevard County since a shooting in 1987 claimed six lives, including those of two police officers.",17,34,multiple homicide,5,3,8
33CLA8O0MICHQCFXWDF9W53TZKJFR6,"It was the worst multiple homicide Goodyear could recall in Brevard County since a shooting in 1987 claimed six lives, including those of two police officers.",26,34,homicide,8,9,17
33CLA8O0MICHQCFXWDF9W53TZKJFR6,"It was the worst multiple homicide Goodyear could recall in Brevard County since a shooting in 1987 claimed six lives, including those of two police officers.",50,56,recall,1,1,2
33CLA8O0MICHQCFXWDF9W53TZKJFR6,"It was the worst multiple homicide Goodyear could recall in Brevard County since a shooting in 1987 claimed six lives, including those of two police officers.",100,107,claimed,2,2,4
33CLA8O0MICHQCFXWDF9W53TZKJFR6,"It was the worst multiple homicide Goodyear could recall in Brevard County since a shooting in 1987 claimed six lives, including those of two police officers.",119,128,including,0,1,1
33CLA8O0MICHQCFXWDF9W53TZKJFR6,"Goodyear said police had been called to the house on several occasions in the past and the 15-year-old child, a boy, was arrested last month for domestic violence against his mother.",53,70,several occasions,0,1,1
33CLA8O0MICHQCFXWDF9W53TZKJFR6,"Goodyear said police had been called to the house on several occasions in the past and the 15-year-old child, a boy, was arrested last month for domestic violence against his mother.",61,70,occasions,4,2,6
33CLA8O0MICHQCFXWDF9W53TZKJFR6,"Goodyear said police had been called to the house on several occasions in the past and the 15-year-old child, a boy, was arrested last month for domestic violence against his mother.",121,129,arrested,1,2,3
33CLA8O0MICHQCFXWDF9W53TZKJFR6,"Goodyear said police had been called to the house on several occasions in the past and the 15-year-old child, a boy, was arrested last month for domestic violence against his mother.",145,153,domestic,5,1,6
33CLA8O0MICHQCFXWDF9W53TZKJFR6,"Goodyear said police had been called to the house on several occasions in the past and the 15-year-old child, a boy, was arrested last month for domestic violence against his mother.",145,162,domestic violence,6,7,13
33CLA8O0MICHQCFXWDF9W53TZKJFR6,"Goodyear said police had been called to the house on several occasions in the past and the 15-year-old child, a boy, was arrested last month for domestic violence against his mother.",154,162,violence,0,2,2
38VTL6WC4AEYLGYU4WUUIP5DDDK5YF,Others oppose Assad and accuse Damascus of heavy-handed meddling in Lebanese politics.,7,13,oppose,4,1,5
38VTL6WC4AEYLGYU4WUUIP5DDDK5YF,Others oppose Assad and accuse Damascus of heavy-handed meddling in Lebanese politics.,14,19,Assad,1,0,1
38VTL6WC4AEYLGYU4WUUIP5DDDK5YF,Others oppose Assad and accuse Damascus of heavy-handed meddling in Lebanese politics.,24,30,accuse,2,2,4
38VTL6WC4AEYLGYU4WUUIP5DDDK5YF,Others oppose Assad and accuse Damascus of heavy-handed meddling in Lebanese politics.,31,39,Damascus,1,1,2
38VTL6WC4AEYLGYU4WUUIP5DDDK5YF,Others oppose Assad and accuse Damascus of heavy-handed meddling in Lebanese politics.,43,55,heavy-handed,7,3,10
38VTL6WC4AEYLGYU4WUUIP5DDDK5YF,Others oppose Assad and accuse Damascus of heavy-handed meddling in Lebanese politics.,43,64,heavy-handed meddling,2,5,7
38VTL6WC4AEYLGYU4WUUIP5DDDK5YF,Others oppose Assad and accuse Damascus of heavy-handed meddling in Lebanese politics.,56,64,meddling,10,8,18
38VTL6WC4AEYLGYU4WUUIP5DDDK5YF,Others oppose Assad and accuse Damascus of heavy-handed meddling in Lebanese politics.,68,76,Lebanese,1,0,1
38VTL6WC4AEYLGYU4WUUIP5DDDK5YF,"The two sides are the legacy of, and backlash against, Syria's virtual rule over Lebanon from 1976 to 2005 and its continued influence since.",22,28,legacy,4,6,10
38VTL6WC4AEYLGYU4WUUIP5DDDK5YF,"The two sides are the legacy of, and backlash against, Syria's virtual rule over Lebanon from 1976 to 2005 and its continued influence since.",22,31,legacy of,0,2,2
38VTL6WC4AEYLGYU4WUUIP5DDDK5YF,"The two sides are the legacy of, and backlash against, Syria's virtual rule over Lebanon from 1976 to 2005 and its continued influence since.",37,45,backlash,7,9,16
38VTL6WC4AEYLGYU4WUUIP5DDDK5YF,"The two sides are the legacy of, and backlash against, Syria's virtual rule over Lebanon from 1976 to 2005 and its continued influence since.",37,53,backlash against,0,1,1
38VTL6WC4AEYLGYU4WUUIP5DDDK5YF,"The two sides are the legacy of, and backlash against, Syria's virtual rule over Lebanon from 1976 to 2005 and its continued influence since.",63,70,virtual,1,3,4
38VTL6WC4AEYLGYU4WUUIP5DDDK5YF,"The two sides are the legacy of, and backlash against, Syria's virtual rule over Lebanon from 1976 to 2005 and its continued influence since.",63,75,virtual rule,1,3,4
38VTL6WC4AEYLGYU4WUUIP5DDDK5YF,"The two sides are the legacy of, and backlash against, Syria's virtual rule over Lebanon from 1976 to 2005 and its continued influence since.",125,134,influence,1,1,2
38VTL6WC4AEYLGYU4WUUIP5DDDK5YF,Syria's uprising started in March 2011 with protests calling for political reform.,8,16,uprising,6,7,13
38VTL6WC4AEYLGYU4WUUIP5DDDK5YF,Syria's uprising started in March 2011 with protests calling for political reform.,65,81,political reform,3,1,4
38VTL6WC4AEYLGYU4WUUIP5DDDK5YF,Syria's uprising started in March 2011 with protests calling for political reform.,75,81,reform,2,3,5
38VTL6WC4AEYLGYU4WUUIP5DDDK5YF,"The government brutally cracked down on dissent, and many in the opposition have since taken up arms to defend themselves and attack government troops.",4,14,government,1,0,1
38VTL6WC4AEYLGYU4WUUIP5DDDK5YF,"The government brutally cracked down on dissent, and many in the opposition have since taken up arms to defend themselves and attack government troops.",4,23,government brutally,1,0,1
38VTL6WC4AEYLGYU4WUUIP5DDDK5YF,"The government brutally cracked down on dissent, and many in the opposition have since taken up arms to defend themselves and attack government troops.",15,23,brutally,1,4,5
38VTL6WC4AEYLGYU4WUUIP5DDDK5YF,"The government brutally cracked down on dissent, and many in the opposition have since taken up arms to defend themselves and attack government troops.",15,36,brutally cracked down,1,3,4
38VTL6WC4AEYLGYU4WUUIP5DDDK5YF,"The government brutally cracked down on dissent, and many in the opposition have since taken up arms to defend themselves and attack government troops.",24,31,cracked,0,3,3
38VTL6WC4AEYLGYU4WUUIP5DDDK5YF,"The government brutally cracked down on dissent, and many in the opposition have since taken up arms to defend themselves and attack government troops.",24,36,cracked down,0,1,1
38VTL6WC4AEYLGYU4WUUIP5DDDK5YF,"The government brutally cracked down on dissent, and many in the opposition have since taken up arms to defend themselves and attack government troops.",40,47,dissent,10,10,20
38VTL6WC4AEYLGYU4WUUIP5DDDK5YF,"The government brutally cracked down on dissent, and many in the opposition have since taken up arms to defend themselves and attack government troops.",65,75,opposition,4,0,4
38VTL6WC4AEYLGYU4WUUIP5DDDK5YF,"The government brutally cracked down on dissent, and many in the opposition have since taken up arms to defend themselves and attack government troops.",133,143,government,1,0,1
38VTL6WC4AEYLGYU4WUUIP5DDDK5YF,Some soldiers also have switched sides and joined forces with the rebels.,19,38,have switched sides,0,1,1
38VTL6WC4AEYLGYU4WUUIP5DDDK5YF,Some soldiers also have switched sides and joined forces with the rebels.,24,32,switched,1,2,3
38VTL6WC4AEYLGYU4WUUIP5DDDK5YF,Some soldiers also have switched sides and joined forces with the rebels.,24,38,switched sides,1,3,4
38VTL6WC4AEYLGYU4WUUIP5DDDK5YF,Some soldiers also have switched sides and joined forces with the rebels.,43,56,joined forces,1,0,1
38VTL6WC4AEYLGYU4WUUIP5DDDK5YF,Some soldiers also have switched sides and joined forces with the rebels.,66,72,rebels,1,2,3
38VTL6WC4AEYLGYU4WUUIP5DDDK5YF,"World powers have backed the peace plan, which was put forward by U.N.-Arab League envoy Kofi Annan to end the crisis, but the bloodshed has not stopped.",0,12,World powers,1,0,1
38VTL6WC4AEYLGYU4WUUIP5DDDK5YF,"World powers have backed the peace plan, which was put forward by U.N.-Arab League envoy Kofi Annan to end the crisis, but the bloodshed has not stopped.",29,39,peace plan,1,0,1
38VTL6WC4AEYLGYU4WUUIP5DDDK5YF,"World powers have backed the peace plan, which was put forward by U.N.-Arab League envoy Kofi Annan to end the crisis, but the bloodshed has not stopped.",83,88,envoy,6,6,12
38VTL6WC4AEYLGYU4WUUIP5DDDK5YF,"World powers have backed the peace plan, which was put forward by U.N.-Arab League envoy Kofi Annan to end the crisis, but the bloodshed has not stopped.",111,117,crisis,1,0,1
38VTL6WC4AEYLGYU4WUUIP5DDDK5YF,"World powers have backed the peace plan, which was put forward by U.N.-Arab League envoy Kofi Annan to end the crisis, but the bloodshed has not stopped.",127,136,bloodshed,8,5,13
38VTL6WC4AEYLGYU4WUUIP5DDDK5YF,More than 100 U.N. observers have been deployed in Syria to oversee the truce between the government and armed rebels.,19,28,observers,1,0,1
38VTL6WC4AEYLGYU4WUUIP5DDDK5YF,More than 100 U.N. observers have been deployed in Syria to oversee the truce between the government and armed rebels.,39,47,deployed,7,5,12
38VTL6WC4AEYLGYU4WUUIP5DDDK5YF,More than 100 U.N. observers have been deployed in Syria to oversee the truce between the government and armed rebels.,72,77,truce,7,6,13
38VTL6WC4AEYLGYU4WUUIP5DDDK5YF,More than 100 U.N. observers have been deployed in Syria to oversee the truce between the government and armed rebels.,90,100,government,2,0,2
38VTL6WC4AEYLGYU4WUUIP5DDDK5YF,More than 100 U.N. observers have been deployed in Syria to oversee the truce between the government and armed rebels.,105,117,armed rebels,1,0,1
31MBOZ6PAOSZK20A0RSC2N9RWF2CL2,"In the wake of the incident, Netanyahu said Israel sought to preserve the 1979 peace treaty with Egypt, but would seek to ensure that security arrangements would be revamped prior to the resumption of diplomatic activity in Cairo.",0,11,In the wake,1,1,2
31MBOZ6PAOSZK20A0RSC2N9RWF2CL2,"In the wake of the incident, Netanyahu said Israel sought to preserve the 1979 peace treaty with Egypt, but would seek to ensure that security arrangements would be revamped prior to the resumption of diplomatic activity in Cairo.",0,14,In the wake of,0,1,1
31MBOZ6PAOSZK20A0RSC2N9RWF2CL2,"In the wake of the incident, Netanyahu said Israel sought to preserve the 1979 peace treaty with Egypt, but would seek to ensure that security arrangements would be revamped prior to the resumption of diplomatic activity in Cairo.",7,11,wake,1,2,3
31MBOZ6PAOSZK20A0RSC2N9RWF2CL2,"In the wake of the incident, Netanyahu said Israel sought to preserve the 1979 peace treaty with Egypt, but would seek to ensure that security arrangements would be revamped prior to the resumption of diplomatic activity in Cairo.",7,14,wake of,0,1,1
31MBOZ6PAOSZK20A0RSC2N9RWF2CL2,"In the wake of the incident, Netanyahu said Israel sought to preserve the 1979 peace treaty with Egypt, but would seek to ensure that security arrangements would be revamped prior to the resumption of diplomatic activity in Cairo.",7,27,wake of the incident,2,0,2
31MBOZ6PAOSZK20A0RSC2N9RWF2CL2,"In the wake of the incident, Netanyahu said Israel sought to preserve the 1979 peace treaty with Egypt, but would seek to ensure that security arrangements would be revamped prior to the resumption of diplomatic activity in Cairo.",19,27,incident,3,2,5
31MBOZ6PAOSZK20A0RSC2N9RWF2CL2,"In the wake of the incident, Netanyahu said Israel sought to preserve the 1979 peace treaty with Egypt, but would seek to ensure that security arrangements would be revamped prior to the resumption of diplomatic activity in Cairo.",29,38,Netanyahu,1,1,2
31MBOZ6PAOSZK20A0RSC2N9RWF2CL2,"In the wake of the incident, Netanyahu said Israel sought to preserve the 1979 peace treaty with Egypt, but would seek to ensure that security arrangements would be revamped prior to the resumption of diplomatic activity in Cairo.",51,57,sought,5,4,9
31MBOZ6PAOSZK20A0RSC2N9RWF2CL2,"In the wake of the incident, Netanyahu said Israel sought to preserve the 1979 peace treaty with Egypt, but would seek to ensure that security arrangements would be revamped prior to the resumption of diplomatic activity in Cairo.",51,69,sought to preserve,1,1,2
31MBOZ6PAOSZK20A0RSC2N9RWF2CL2,"In the wake of the incident, Netanyahu said Israel sought to preserve the 1979 peace treaty with Egypt, but would seek to ensure that security arrangements would be revamped prior to the resumption of diplomatic activity in Cairo.",61,69,preserve,3,4,7
31MBOZ6PAOSZK20A0RSC2N9RWF2CL2,"In the wake of the incident, Netanyahu said Israel sought to preserve the 1979 peace treaty with Egypt, but would seek to ensure that security arrangements would be revamped prior to the resumption of diplomatic activity in Cairo.",79,91,peace treaty,3,2,5
31MBOZ6PAOSZK20A0RSC2N9RWF2CL2,"In the wake of the incident, Netanyahu said Israel sought to preserve the 1979 peace treaty with Egypt, but would seek to ensure that security arrangements would be revamped prior to the resumption of diplomatic activity in Cairo.",85,91,treaty,0,3,3
31MBOZ6PAOSZK20A0RSC2N9RWF2CL2,"In the wake of the incident, Netanyahu said Israel sought to preserve the 1979 peace treaty with Egypt, but would seek to ensure that security arrangements would be revamped prior to the resumption of diplomatic activity in Cairo.",122,128,ensure,3,2,5
31MBOZ6PAOSZK20A0RSC2N9RWF2CL2,"In the wake of the incident, Netanyahu said Israel sought to preserve the 1979 peace treaty with Egypt, but would seek to ensure that security arrangements would be revamped prior to the resumption of diplomatic activity in Cairo.",134,155,security arrangements,2,2,4
31MBOZ6PAOSZK20A0RSC2N9RWF2CL2,"In the wake of the incident, Netanyahu said Israel sought to preserve the 1979 peace treaty with Egypt, but would seek to ensure that security arrangements would be revamped prior to the resumption of diplomatic activity in Cairo.",165,173,revamped,10,10,20
31MBOZ6PAOSZK20A0RSC2N9RWF2CL2,"In the wake of the incident, Netanyahu said Israel sought to preserve the 1979 peace treaty with Egypt, but would seek to ensure that security arrangements would be revamped prior to the resumption of diplomatic activity in Cairo.",165,179,revamped prior,1,0,1
31MBOZ6PAOSZK20A0RSC2N9RWF2CL2,"In the wake of the incident, Netanyahu said Israel sought to preserve the 1979 peace treaty with Egypt, but would seek to ensure that security arrangements would be revamped prior to the resumption of diplomatic activity in Cairo.",165,182,revamped prior to,1,0,1
31MBOZ6PAOSZK20A0RSC2N9RWF2CL2,"In the wake of the incident, Netanyahu said Israel sought to preserve the 1979 peace treaty with Egypt, but would seek to ensure that security arrangements would be revamped prior to the resumption of diplomatic activity in Cairo.",187,197,resumption,10,9,19
31MBOZ6PAOSZK20A0RSC2N9RWF2CL2,"In the wake of the incident, Netanyahu said Israel sought to preserve the 1979 peace treaty with Egypt, but would seek to ensure that security arrangements would be revamped prior to the resumption of diplomatic activity in Cairo.",187,220,resumption of diplomatic activity,1,0,1
31MBOZ6PAOSZK20A0RSC2N9RWF2CL2,"In the wake of the incident, Netanyahu said Israel sought to preserve the 1979 peace treaty with Egypt, but would seek to ensure that security arrangements would be revamped prior to the resumption of diplomatic activity in Cairo.",201,211,diplomatic,2,2,4
31MBOZ6PAOSZK20A0RSC2N9RWF2CL2,"In the wake of the incident, Netanyahu said Israel sought to preserve the 1979 peace treaty with Egypt, but would seek to ensure that security arrangements would be revamped prior to the resumption of diplomatic activity in Cairo.",201,220,diplomatic activity,4,3,7
31MBOZ6PAOSZK20A0RSC2N9RWF2CL2,"Ben-Dor said that Levanon's recently named successor, Ya'akov Amitai, would leave for Cairo ""as soon as proper security arrangements"" are agreed upon and implemented.",18,26,Levanons,0,1,1
31MBOZ6PAOSZK20A0RSC2N9RWF2CL2,"Ben-Dor said that Levanon's recently named successor, Ya'akov Amitai, would leave for Cairo ""as soon as proper security arrangements"" are agreed upon and implemented.",43,52,successor,7,4,11
31MBOZ6PAOSZK20A0RSC2N9RWF2CL2,"Ben-Dor said that Levanon's recently named successor, Ya'akov Amitai, would leave for Cairo ""as soon as proper security arrangements"" are agreed upon and implemented.",104,132,proper security arrangements,1,0,1
31MBOZ6PAOSZK20A0RSC2N9RWF2CL2,"Ben-Dor said that Levanon's recently named successor, Ya'akov Amitai, would leave for Cairo ""as soon as proper security arrangements"" are agreed upon and implemented.",111,132,security arrangements,2,0,2
31MBOZ6PAOSZK20A0RSC2N9RWF2CL2,"Ben-Dor said that Levanon's recently named successor, Ya'akov Amitai, would leave for Cairo ""as soon as proper security arrangements"" are agreed upon and implemented.",120,132,arrangements,1,1,2
31MBOZ6PAOSZK20A0RSC2N9RWF2CL2,"Ben-Dor said that Levanon's recently named successor, Ya'akov Amitai, would leave for Cairo ""as soon as proper security arrangements"" are agreed upon and implemented.",154,165,implemented,10,5,15
31MBOZ6PAOSZK20A0RSC2N9RWF2CL2,"Israel's internal security agency, Shin Bet, which is responsible for setting the security guidelines for all Israeli diplomatic missions around the world, will okay Amita's departure pending the willingness of Egyptian authorities to approve its request for upgraded security measures, the Ha'aretz daily reported on Sunday.",18,33,security agency,1,0,1
31MBOZ6PAOSZK20A0RSC2N9RWF2CL2,"Israel's internal security agency, Shin Bet, which is responsible for setting the security guidelines for all Israeli diplomatic missions around the world, will okay Amita's departure pending the willingness of Egyptian authorities to approve its request for upgraded security measures, the Ha'aretz daily reported on Sunday.",82,101,security guidelines,1,1,2
31MBOZ6PAOSZK20A0RSC2N9RWF2CL2,"Israel's internal security agency, Shin Bet, which is responsible for setting the security guidelines for all Israeli diplomatic missions around the world, will okay Amita's departure pending the willingness of Egyptian authorities to approve its request for upgraded security measures, the Ha'aretz daily reported on Sunday.",91,101,guidelines,0,2,2
31MBOZ6PAOSZK20A0RSC2N9RWF2CL2,"Israel's internal security agency, Shin Bet, which is responsible for setting the security guidelines for all Israeli diplomatic missions around the world, will okay Amita's departure pending the willingness of Egyptian authorities to approve its request for upgraded security measures, the Ha'aretz daily reported on Sunday.",110,137,Israeli diplomatic missions,1,0,1
31MBOZ6PAOSZK20A0RSC2N9RWF2CL2,"Israel's internal security agency, Shin Bet, which is responsible for setting the security guidelines for all Israeli diplomatic missions around the world, will okay Amita's departure pending the willingness of Egyptian authorities to approve its request for upgraded security measures, the Ha'aretz daily reported on Sunday.",118,128,diplomatic,5,0,5
31MBOZ6PAOSZK20A0RSC2N9RWF2CL2,"Israel's internal security agency, Shin Bet, which is responsible for setting the security guidelines for all Israeli diplomatic missions around the world, will okay Amita's departure pending the willingness of Egyptian authorities to approve its request for upgraded security measures, the Ha'aretz daily reported on Sunday.",118,137,diplomatic missions,2,1,3
31MBOZ6PAOSZK20A0RSC2N9RWF2CL2,"Israel's internal security agency, Shin Bet, which is responsible for setting the security guidelines for all Israeli diplomatic missions around the world, will okay Amita's departure pending the willingness of Egyptian authorities to approve its request for upgraded security measures, the Ha'aretz daily reported on Sunday.",166,172,Amitas,0,1,1
31MBOZ6PAOSZK20A0RSC2N9RWF2CL2,"Israel's internal security agency, Shin Bet, which is responsible for setting the security guidelines for all Israeli diplomatic missions around the world, will okay Amita's departure pending the willingness of Egyptian authorities to approve its request for upgraded security measures, the Ha'aretz daily reported on Sunday.",174,183,departure,1,3,4
31MBOZ6PAOSZK20A0RSC2N9RWF2CL2,"Israel's internal security agency, Shin Bet, which is responsible for setting the security guidelines for all Israeli diplomatic missions around the world, will okay Amita's departure pending the willingness of Egyptian authorities to approve its request for upgraded security measures, the Ha'aretz daily reported on Sunday.",184,191,pending,3,2,5
31MBOZ6PAOSZK20A0RSC2N9RWF2CL2,"Israel's internal security agency, Shin Bet, which is responsible for setting the security guidelines for all Israeli diplomatic missions around the world, will okay Amita's departure pending the willingness of Egyptian authorities to approve its request for upgraded security measures, the Ha'aretz daily reported on Sunday.",196,207,willingness,1,2,3
31MBOZ6PAOSZK20A0RSC2N9RWF2CL2,"Israel's internal security agency, Shin Bet, which is responsible for setting the security guidelines for all Israeli diplomatic missions around the world, will okay Amita's departure pending the willingness of Egyptian authorities to approve its request for upgraded security measures, the Ha'aretz daily reported on Sunday.",220,231,authorities,1,0,1
31MBOZ6PAOSZK20A0RSC2N9RWF2CL2,"Israel's internal security agency, Shin Bet, which is responsible for setting the security guidelines for all Israeli diplomatic missions around the world, will okay Amita's departure pending the willingness of Egyptian authorities to approve its request for upgraded security measures, the Ha'aretz daily reported on Sunday.",235,242,approve,1,0,1
31MBOZ6PAOSZK20A0RSC2N9RWF2CL2,"Israel's internal security agency, Shin Bet, which is responsible for setting the security guidelines for all Israeli diplomatic missions around the world, will okay Amita's departure pending the willingness of Egyptian authorities to approve its request for upgraded security measures, the Ha'aretz daily reported on Sunday.",259,267,upgraded,0,2,2
31MBOZ6PAOSZK20A0RSC2N9RWF2CL2,"Israel's internal security agency, Shin Bet, which is responsible for setting the security guidelines for all Israeli diplomatic missions around the world, will okay Amita's departure pending the willingness of Egyptian authorities to approve its request for upgraded security measures, the Ha'aretz daily reported on Sunday.",259,285,upgraded security measures,1,0,1
31MBOZ6PAOSZK20A0RSC2N9RWF2CL2,"Israel's internal security agency, Shin Bet, which is responsible for setting the security guidelines for all Israeli diplomatic missions around the world, will okay Amita's departure pending the willingness of Egyptian authorities to approve its request for upgraded security measures, the Ha'aretz daily reported on Sunday.",268,285,security measures,1,0,1
31MBOZ6PAOSZK20A0RSC2N9RWF2CL2,"Such measures are to include new quarters for the embassy, more guards, closed-circuit cameras and electronic surveillance measures.",50,57,embassy,1,1,2
31MBOZ6PAOSZK20A0RSC2N9RWF2CL2,"Such measures are to include new quarters for the embassy, more guards, closed-circuit cameras and electronic surveillance measures.",72,86,closed-circuit,2,3,5
31MBOZ6PAOSZK20A0RSC2N9RWF2CL2,"Such measures are to include new quarters for the embassy, more guards, closed-circuit cameras and electronic surveillance measures.",72,94,closed-circuit cameras,2,0,2
31MBOZ6PAOSZK20A0RSC2N9RWF2CL2,"Such measures are to include new quarters for the embassy, more guards, closed-circuit cameras and electronic surveillance measures.",99,122,electronic surveillance,0,2,2
31MBOZ6PAOSZK20A0RSC2N9RWF2CL2,"Such measures are to include new quarters for the embassy, more guards, closed-circuit cameras and electronic surveillance measures.",99,131,electronic surveillance measures,5,0,5
31MBOZ6PAOSZK20A0RSC2N9RWF2CL2,"Such measures are to include new quarters for the embassy, more guards, closed-circuit cameras and electronic surveillance measures.",110,122,surveillance,5,6,11
3KLL7H3EGD2TXFNK0N8J0N49059HVZ,Philippine Foreign Secretary Albert Del Rosario said he met with Chinese Ambassador Ma Keqing and both reaffirmed their governments' positions that the Scarborough Shoal where the ships are facing off was part of their own country's territory and neither was ready to stand down.,11,18,Foreign,1,0,1
3KLL7H3EGD2TXFNK0N8J0N49059HVZ,Philippine Foreign Secretary Albert Del Rosario said he met with Chinese Ambassador Ma Keqing and both reaffirmed their governments' positions that the Scarborough Shoal where the ships are facing off was part of their own country's territory and neither was ready to stand down.,11,28,Foreign Secretary,3,0,3
3KLL7H3EGD2TXFNK0N8J0N49059HVZ,Philippine Foreign Secretary Albert Del Rosario said he met with Chinese Ambassador Ma Keqing and both reaffirmed their governments' positions that the Scarborough Shoal where the ships are facing off was part of their own country's territory and neither was ready to stand down.,19,28,Secretary,1,0,1
3KLL7H3EGD2TXFNK0N8J0N49059HVZ,Philippine Foreign Secretary Albert Del Rosario said he met with Chinese Ambassador Ma Keqing and both reaffirmed their governments' positions that the Scarborough Shoal where the ships are facing off was part of their own country's territory and neither was ready to stand down.,73,83,Ambassador,3,2,5
3KLL7H3EGD2TXFNK0N8J0N49059HVZ,Philippine Foreign Secretary Albert Del Rosario said he met with Chinese Ambassador Ma Keqing and both reaffirmed their governments' positions that the Scarborough Shoal where the ships are facing off was part of their own country's territory and neither was ready to stand down.,103,113,reaffirmed,10,10,20
3KLL7H3EGD2TXFNK0N8J0N49059HVZ,Philippine Foreign Secretary Albert Del Rosario said he met with Chinese Ambassador Ma Keqing and both reaffirmed their governments' positions that the Scarborough Shoal where the ships are facing off was part of their own country's territory and neither was ready to stand down.,120,131,governments,1,0,1
3KLL7H3EGD2TXFNK0N8J0N49059HVZ,Philippine Foreign Secretary Albert Del Rosario said he met with Chinese Ambassador Ma Keqing and both reaffirmed their governments' positions that the Scarborough Shoal where the ships are facing off was part of their own country's territory and neither was ready to stand down.,120,141,governments positions,2,0,2
3KLL7H3EGD2TXFNK0N8J0N49059HVZ,Philippine Foreign Secretary Albert Del Rosario said he met with Chinese Ambassador Ma Keqing and both reaffirmed their governments' positions that the Scarborough Shoal where the ships are facing off was part of their own country's territory and neither was ready to stand down.,152,163,Scarborough,0,1,1
3KLL7H3EGD2TXFNK0N8J0N49059HVZ,Philippine Foreign Secretary Albert Del Rosario said he met with Chinese Ambassador Ma Keqing and both reaffirmed their governments' positions that the Scarborough Shoal where the ships are facing off was part of their own country's territory and neither was ready to stand down.,152,169,Scarborough Shoal,1,1,2
3KLL7H3EGD2TXFNK0N8J0N49059HVZ,Philippine Foreign Secretary Albert Del Rosario said he met with Chinese Ambassador Ma Keqing and both reaffirmed their governments' positions that the Scarborough Shoal where the ships are facing off was part of their own country's territory and neither was ready to stand down.,164,169,Shoal,0,2,2
3KLL7H3EGD2TXFNK0N8J0N49059HVZ,Philippine Foreign Secretary Albert Del Rosario said he met with Chinese Ambassador Ma Keqing and both reaffirmed their governments' positions that the Scarborough Shoal where the ships are facing off was part of their own country's territory and neither was ready to stand down.,190,200,facing off,1,3,4
3KLL7H3EGD2TXFNK0N8J0N49059HVZ,Philippine Foreign Secretary Albert Del Rosario said he met with Chinese Ambassador Ma Keqing and both reaffirmed their governments' positions that the Scarborough Shoal where the ships are facing off was part of their own country's territory and neither was ready to stand down.,233,242,territory,1,3,4
3KLL7H3EGD2TXFNK0N8J0N49059HVZ,Philippine Foreign Secretary Albert Del Rosario said he met with Chinese Ambassador Ma Keqing and both reaffirmed their governments' positions that the Scarborough Shoal where the ships are facing off was part of their own country's territory and neither was ready to stand down.,265,278,to stand down,1,0,1
3KLL7H3EGD2TXFNK0N8J0N49059HVZ,Philippine Foreign Secretary Albert Del Rosario said he met with Chinese Ambassador Ma Keqing and both reaffirmed their governments' positions that the Scarborough Shoal where the ships are facing off was part of their own country's territory and neither was ready to stand down.,268,278,stand down,1,4,5
3KLL7H3EGD2TXFNK0N8J0N49059HVZ,"Del Rosario said that despite the impasse, ""we resolved to seek a diplomatic solution to the issue.""",22,29,despite,0,4,4
3KLL7H3EGD2TXFNK0N8J0N49059HVZ,"Del Rosario said that despite the impasse, ""we resolved to seek a diplomatic solution to the issue.""",34,41,impasse,10,10,20
3KLL7H3EGD2TXFNK0N8J0N49059HVZ,"Del Rosario said that despite the impasse, ""we resolved to seek a diplomatic solution to the issue.""",47,55,resolved,0,5,5
3KLL7H3EGD2TXFNK0N8J0N49059HVZ,"Del Rosario said that despite the impasse, ""we resolved to seek a diplomatic solution to the issue.""",59,63,seek,0,1,1
3KLL7H3EGD2TXFNK0N8J0N49059HVZ,"Del Rosario said that despite the impasse, ""we resolved to seek a diplomatic solution to the issue.""",66,76,diplomatic,4,4,8
3KLL7H3EGD2TXFNK0N8J0N49059HVZ,"Del Rosario said that despite the impasse, ""we resolved to seek a diplomatic solution to the issue.""",66,85,diplomatic solution,5,1,6
3KLL7H3EGD2TXFNK0N8J0N49059HVZ,"Del Rosario said that despite the impasse, ""we resolved to seek a diplomatic solution to the issue.""",93,98,issue,1,0,1
3KLL7H3EGD2TXFNK0N8J0N49059HVZ,The Philippine government said the standoff began when its navy tried to detain Chinese boats fishing in its waters but was stopped by two Chinese surveillance craft.,15,25,government,2,0,2
3KLL7H3EGD2TXFNK0N8J0N49059HVZ,The Philippine government said the standoff began when its navy tried to detain Chinese boats fishing in its waters but was stopped by two Chinese surveillance craft.,35,43,standoff,7,8,15
3KLL7H3EGD2TXFNK0N8J0N49059HVZ,The Philippine government said the standoff began when its navy tried to detain Chinese boats fishing in its waters but was stopped by two Chinese surveillance craft.,73,79,detain,5,3,8
3KLL7H3EGD2TXFNK0N8J0N49059HVZ,The Philippine government said the standoff began when its navy tried to detain Chinese boats fishing in its waters but was stopped by two Chinese surveillance craft.,147,159,surveillance,7,6,13
3KLL7H3EGD2TXFNK0N8J0N49059HVZ,The Philippine government said the standoff began when its navy tried to detain Chinese boats fishing in its waters but was stopped by two Chinese surveillance craft.,147,165,surveillance craft,6,2,8
3KLL7H3EGD2TXFNK0N8J0N49059HVZ,The Philippine government said the standoff began when its navy tried to detain Chinese boats fishing in its waters but was stopped by two Chinese surveillance craft.,160,165,craft,0,1,1
3KLL7H3EGD2TXFNK0N8J0N49059HVZ,The Chinese Embassy accused the Philippine warship of harassing the fishermen and called for it to leave Chinese territory.,20,27,accused,1,1,2
3KLL7H3EGD2TXFNK0N8J0N49059HVZ,The Chinese Embassy accused the Philippine warship of harassing the fishermen and called for it to leave Chinese territory.,54,63,harassing,10,9,19
3KLL7H3EGD2TXFNK0N8J0N49059HVZ,The Chinese Embassy accused the Philippine warship of harassing the fishermen and called for it to leave Chinese territory.,113,122,territory,1,1,2
3KLL7H3EGD2TXFNK0N8J0N49059HVZ,"The South China Sea is home to a myriad of competing territorial claims, most notably the Spratly Islands south of the shoal, an island chain claimed by China, the Philippines, Vietnam, Brunei, Malaysia and Taiwan.",33,39,myriad,8,7,15
3KLL7H3EGD2TXFNK0N8J0N49059HVZ,"The South China Sea is home to a myriad of competing territorial claims, most notably the Spratly Islands south of the shoal, an island chain claimed by China, the Philippines, Vietnam, Brunei, Malaysia and Taiwan.",33,42,myriad of,0,1,1
3KLL7H3EGD2TXFNK0N8J0N49059HVZ,"The South China Sea is home to a myriad of competing territorial claims, most notably the Spratly Islands south of the shoal, an island chain claimed by China, the Philippines, Vietnam, Brunei, Malaysia and Taiwan.",33,71,myriad of competing territorial claims,2,0,2
3KLL7H3EGD2TXFNK0N8J0N49059HVZ,"The South China Sea is home to a myriad of competing territorial claims, most notably the Spratly Islands south of the shoal, an island chain claimed by China, the Philippines, Vietnam, Brunei, Malaysia and Taiwan.",43,52,competing,1,2,3
3KLL7H3EGD2TXFNK0N8J0N49059HVZ,"The South China Sea is home to a myriad of competing territorial claims, most notably the Spratly Islands south of the shoal, an island chain claimed by China, the Philippines, Vietnam, Brunei, Malaysia and Taiwan.",43,71,competing territorial claims,2,0,2
3KLL7H3EGD2TXFNK0N8J0N49059HVZ,"The South China Sea is home to a myriad of competing territorial claims, most notably the Spratly Islands south of the shoal, an island chain claimed by China, the Philippines, Vietnam, Brunei, Malaysia and Taiwan.",53,64,territorial,2,1,3
3KLL7H3EGD2TXFNK0N8J0N49059HVZ,"The South China Sea is home to a myriad of competing territorial claims, most notably the Spratly Islands south of the shoal, an island chain claimed by China, the Philippines, Vietnam, Brunei, Malaysia and Taiwan.",53,71,territorial claims,2,0,2
3KLL7H3EGD2TXFNK0N8J0N49059HVZ,"The South China Sea is home to a myriad of competing territorial claims, most notably the Spratly Islands south of the shoal, an island chain claimed by China, the Philippines, Vietnam, Brunei, Malaysia and Taiwan.",78,85,notably,1,0,1
3KLL7H3EGD2TXFNK0N8J0N49059HVZ,"The South China Sea is home to a myriad of competing territorial claims, most notably the Spratly Islands south of the shoal, an island chain claimed by China, the Philippines, Vietnam, Brunei, Malaysia and Taiwan.",90,97,Spratly,0,2,2
3KLL7H3EGD2TXFNK0N8J0N49059HVZ,"The South China Sea is home to a myriad of competing territorial claims, most notably the Spratly Islands south of the shoal, an island chain claimed by China, the Philippines, Vietnam, Brunei, Malaysia and Taiwan.",119,124,shoal,5,2,7
3KLL7H3EGD2TXFNK0N8J0N49059HVZ,"The South China Sea is home to a myriad of competing territorial claims, most notably the Spratly Islands south of the shoal, an island chain claimed by China, the Philippines, Vietnam, Brunei, Malaysia and Taiwan.",129,135,island,0,1,1
3KLL7H3EGD2TXFNK0N8J0N49059HVZ,"The South China Sea is home to a myriad of competing territorial claims, most notably the Spratly Islands south of the shoal, an island chain claimed by China, the Philippines, Vietnam, Brunei, Malaysia and Taiwan.",142,149,claimed,0,1,1
3N3WJQXELSRMMK883Y36QA05JBML28,De Guindos said even the slightest doubt regarding the values of accounts would make economic recovery more complicated.,25,34,slightest,4,7,11
3N3WJQXELSRMMK883Y36QA05JBML28,De Guindos said even the slightest doubt regarding the values of accounts would make economic recovery more complicated.,25,40,slightest doubt,0,2,2
3N3WJQXELSRMMK883Y36QA05JBML28,De Guindos said even the slightest doubt regarding the values of accounts would make economic recovery more complicated.,55,61,values,1,0,1
3N3WJQXELSRMMK883Y36QA05JBML28,De Guindos said even the slightest doubt regarding the values of accounts would make economic recovery more complicated.,55,73,values of accounts,1,1,2
3N3WJQXELSRMMK883Y36QA05JBML28,De Guindos said even the slightest doubt regarding the values of accounts would make economic recovery more complicated.,85,93,economic,2,0,2
3N3WJQXELSRMMK883Y36QA05JBML28,De Guindos said even the slightest doubt regarding the values of accounts would make economic recovery more complicated.,85,102,economic recovery,4,1,5
3N3WJQXELSRMMK883Y36QA05JBML28,De Guindos said even the slightest doubt regarding the values of accounts would make economic recovery more complicated.,94,102,recovery,0,2,2
3N3WJQXELSRMMK883Y36QA05JBML28,De Guindos said even the slightest doubt regarding the values of accounts would make economic recovery more complicated.,108,119,complicated,5,4,9
3N3WJQXELSRMMK883Y36QA05JBML28,"In Spain, the collapse of the housing market left the country's banks with properties that declined steeply in value over the last three years.",14,22,collapse,5,5,10
3N3WJQXELSRMMK883Y36QA05JBML28,"In Spain, the collapse of the housing market left the country's banks with properties that declined steeply in value over the last three years.",14,44,collapse of the housing market,1,0,1
3N3WJQXELSRMMK883Y36QA05JBML28,"In Spain, the collapse of the housing market left the country's banks with properties that declined steeply in value over the last three years.",30,44,housing market,2,2,4
3N3WJQXELSRMMK883Y36QA05JBML28,"In Spain, the collapse of the housing market left the country's banks with properties that declined steeply in value over the last three years.",91,99,declined,0,3,3
3N3WJQXELSRMMK883Y36QA05JBML28,"In Spain, the collapse of the housing market left the country's banks with properties that declined steeply in value over the last three years.",91,107,declined steeply,2,1,3
3N3WJQXELSRMMK883Y36QA05JBML28,"In Spain, the collapse of the housing market left the country's banks with properties that declined steeply in value over the last three years.",100,107,steeply,5,7,12
3N3WJQXELSRMMK883Y36QA05JBML28,Many individuals are also having problems in meeting their mortgage payments.,5,16,individuals,0,1,1
3N3WJQXELSRMMK883Y36QA05JBML28,Many individuals are also having problems in meeting their mortgage payments.,59,67,mortgage,7,10,17
3N3WJQXELSRMMK883Y36QA05JBML28,Many individuals are also having problems in meeting their mortgage payments.,59,76,mortgage payments,4,3,7
3N3WJQXELSRMMK883Y36QA05JBML28,"Banks will be forced to put some of their mortgages into separate companies, it was announced on Friday.",42,51,mortgages,7,3,10
3N3WJQXELSRMMK883Y36QA05JBML28,"Banks will be forced to put some of their mortgages into separate companies, it was announced on Friday.",57,65,separate,1,0,1
3N3WJQXELSRMMK883Y36QA05JBML28,"Banks will be forced to put some of their mortgages into separate companies, it was announced on Friday.",84,93,announced,1,1,2
3N3WJQXELSRMMK883Y36QA05JBML28,Spain will be liberalize regulations for property rentals in an attempt to make it easier for banks to sell their portfolios of property debt.,14,24,liberalize,10,8,18
3N3WJQXELSRMMK883Y36QA05JBML28,Spain will be liberalize regulations for property rentals in an attempt to make it easier for banks to sell their portfolios of property debt.,14,36,liberalize regulations,6,1,7
3N3WJQXELSRMMK883Y36QA05JBML28,Spain will be liberalize regulations for property rentals in an attempt to make it easier for banks to sell their portfolios of property debt.,41,57,property rentals,2,0,2
3N3WJQXELSRMMK883Y36QA05JBML28,Spain will be liberalize regulations for property rentals in an attempt to make it easier for banks to sell their portfolios of property debt.,50,57,rentals,1,1,2
3N3WJQXELSRMMK883Y36QA05JBML28,Spain will be liberalize regulations for property rentals in an attempt to make it easier for banks to sell their portfolios of property debt.,64,71,attempt,0,2,2
3N3WJQXELSRMMK883Y36QA05JBML28,Spain will be liberalize regulations for property rentals in an attempt to make it easier for banks to sell their portfolios of property debt.,114,124,portfolios,10,10,20
3N3WJQXELSRMMK883Y36QA05JBML28,Spain will be liberalize regulations for property rentals in an attempt to make it easier for banks to sell their portfolios of property debt.,114,141,portfolios of property debt,2,0,2
3N3WJQXELSRMMK883Y36QA05JBML28,Spain will be liberalize regulations for property rentals in an attempt to make it easier for banks to sell their portfolios of property debt.,128,141,property debt,2,0,2
3N3WJQXELSRMMK883Y36QA05JBML28,Spain will be liberalize regulations for property rentals in an attempt to make it easier for banks to sell their portfolios of property debt.,137,141,debt,2,0,2
3N3WJQXELSRMMK883Y36QA05JBML28,These decisions come the same day the European Commission warned that Spain will not meet its target of reducing the state deficit to 5.3 percent this year and to 3 percent in 2013.,38,57,European Commission,1,0,1
3N3WJQXELSRMMK883Y36QA05JBML28,These decisions come the same day the European Commission warned that Spain will not meet its target of reducing the state deficit to 5.3 percent this year and to 3 percent in 2013.,47,57,Commission,1,1,2
3N3WJQXELSRMMK883Y36QA05JBML28,These decisions come the same day the European Commission warned that Spain will not meet its target of reducing the state deficit to 5.3 percent this year and to 3 percent in 2013.,117,130,state deficit,3,2,5
3N3WJQXELSRMMK883Y36QA05JBML28,These decisions come the same day the European Commission warned that Spain will not meet its target of reducing the state deficit to 5.3 percent this year and to 3 percent in 2013.,123,130,deficit,6,6,12
35NNO802AVXGL5PV4E4DQIBBD2JNIN,"The Spanish government unveiled a new reform package for its troubled banks Friday in a desperate bid to convince investors that the sector is solvent and the country has a strategy to avoid the bailout fate of Greece, Ireland and Portugal.",12,22,government,1,0,1
35NNO802AVXGL5PV4E4DQIBBD2JNIN,"The Spanish government unveiled a new reform package for its troubled banks Friday in a desperate bid to convince investors that the sector is solvent and the country has a strategy to avoid the bailout fate of Greece, Ireland and Portugal.",23,31,unveiled,10,10,20
35NNO802AVXGL5PV4E4DQIBBD2JNIN,"The Spanish government unveiled a new reform package for its troubled banks Friday in a desperate bid to convince investors that the sector is solvent and the country has a strategy to avoid the bailout fate of Greece, Ireland and Portugal.",38,44,reform,3,2,5
35NNO802AVXGL5PV4E4DQIBBD2JNIN,"The Spanish government unveiled a new reform package for its troubled banks Friday in a desperate bid to convince investors that the sector is solvent and the country has a strategy to avoid the bailout fate of Greece, Ireland and Portugal.",38,52,reform package,2,0,2
35NNO802AVXGL5PV4E4DQIBBD2JNIN,"The Spanish government unveiled a new reform package for its troubled banks Friday in a desperate bid to convince investors that the sector is solvent and the country has a strategy to avoid the bailout fate of Greece, Ireland and Portugal.",61,69,troubled,0,2,2
35NNO802AVXGL5PV4E4DQIBBD2JNIN,"The Spanish government unveiled a new reform package for its troubled banks Friday in a desperate bid to convince investors that the sector is solvent and the country has a strategy to avoid the bailout fate of Greece, Ireland and Portugal.",61,75,troubled banks,0,1,1
35NNO802AVXGL5PV4E4DQIBBD2JNIN,"The Spanish government unveiled a new reform package for its troubled banks Friday in a desperate bid to convince investors that the sector is solvent and the country has a strategy to avoid the bailout fate of Greece, Ireland and Portugal.",88,97,desperate,4,3,7
35NNO802AVXGL5PV4E4DQIBBD2JNIN,"The Spanish government unveiled a new reform package for its troubled banks Friday in a desperate bid to convince investors that the sector is solvent and the country has a strategy to avoid the bailout fate of Greece, Ireland and Portugal.",88,101,desperate bid,3,0,3
35NNO802AVXGL5PV4E4DQIBBD2JNIN,"The Spanish government unveiled a new reform package for its troubled banks Friday in a desperate bid to convince investors that the sector is solvent and the country has a strategy to avoid the bailout fate of Greece, Ireland and Portugal.",98,101,bid,0,1,1
35NNO802AVXGL5PV4E4DQIBBD2JNIN,"The Spanish government unveiled a new reform package for its troubled banks Friday in a desperate bid to convince investors that the sector is solvent and the country has a strategy to avoid the bailout fate of Greece, Ireland and Portugal.",105,113,convince,1,1,2
35NNO802AVXGL5PV4E4DQIBBD2JNIN,"The Spanish government unveiled a new reform package for its troubled banks Friday in a desperate bid to convince investors that the sector is solvent and the country has a strategy to avoid the bailout fate of Greece, Ireland and Portugal.",105,123,convince investors,1,0,1
35NNO802AVXGL5PV4E4DQIBBD2JNIN,"The Spanish government unveiled a new reform package for its troubled banks Friday in a desperate bid to convince investors that the sector is solvent and the country has a strategy to avoid the bailout fate of Greece, Ireland and Portugal.",114,123,investors,2,1,3
35NNO802AVXGL5PV4E4DQIBBD2JNIN,"The Spanish government unveiled a new reform package for its troubled banks Friday in a desperate bid to convince investors that the sector is solvent and the country has a strategy to avoid the bailout fate of Greece, Ireland and Portugal.",133,139,sector,1,0,1
35NNO802AVXGL5PV4E4DQIBBD2JNIN,"The Spanish government unveiled a new reform package for its troubled banks Friday in a desperate bid to convince investors that the sector is solvent and the country has a strategy to avoid the bailout fate of Greece, Ireland and Portugal.",133,150,sector is solvent,1,0,1
35NNO802AVXGL5PV4E4DQIBBD2JNIN,"The Spanish government unveiled a new reform package for its troubled banks Friday in a desperate bid to convince investors that the sector is solvent and the country has a strategy to avoid the bailout fate of Greece, Ireland and Portugal.",143,150,solvent,9,9,18
35NNO802AVXGL5PV4E4DQIBBD2JNIN,"The Spanish government unveiled a new reform package for its troubled banks Friday in a desperate bid to convince investors that the sector is solvent and the country has a strategy to avoid the bailout fate of Greece, Ireland and Portugal.",173,181,strategy,1,4,5
35NNO802AVXGL5PV4E4DQIBBD2JNIN,"The Spanish government unveiled a new reform package for its troubled banks Friday in a desperate bid to convince investors that the sector is solvent and the country has a strategy to avoid the bailout fate of Greece, Ireland and Portugal.",195,202,bailout,8,9,17
35NNO802AVXGL5PV4E4DQIBBD2JNIN,"The Spanish government unveiled a new reform package for its troubled banks Friday in a desperate bid to convince investors that the sector is solvent and the country has a strategy to avoid the bailout fate of Greece, Ireland and Portugal.",195,207,bailout fate,3,2,5
35NNO802AVXGL5PV4E4DQIBBD2JNIN,"The Spanish government unveiled a new reform package for its troubled banks Friday in a desperate bid to convince investors that the sector is solvent and the country has a strategy to avoid the bailout fate of Greece, Ireland and Portugal.",203,207,fate,0,1,1
35NNO802AVXGL5PV4E4DQIBBD2JNIN,Economy Minister Luis de Guindos announced that banks will be forced to set aside a new €30 billion ($39 billion Cdn) financial cushion against bad loans and to separate property assets from their balance sheets.,33,42,announced,1,0,1
35NNO802AVXGL5PV4E4DQIBBD2JNIN,Economy Minister Luis de Guindos announced that banks will be forced to set aside a new €30 billion ($39 billion Cdn) financial cushion against bad loans and to separate property assets from their balance sheets.,72,81,set aside,1,1,2
35NNO802AVXGL5PV4E4DQIBBD2JNIN,Economy Minister Luis de Guindos announced that banks will be forced to set aside a new €30 billion ($39 billion Cdn) financial cushion against bad loans and to separate property assets from their balance sheets.,76,81,aside,0,1,1
35NNO802AVXGL5PV4E4DQIBBD2JNIN,Economy Minister Luis de Guindos announced that banks will be forced to set aside a new €30 billion ($39 billion Cdn) financial cushion against bad loans and to separate property assets from their balance sheets.,118,135,financial cushion,9,5,14
35NNO802AVXGL5PV4E4DQIBBD2JNIN,Economy Minister Luis de Guindos announced that banks will be forced to set aside a new €30 billion ($39 billion Cdn) financial cushion against bad loans and to separate property assets from their balance sheets.,128,135,cushion,2,2,4
35NNO802AVXGL5PV4E4DQIBBD2JNIN,Economy Minister Luis de Guindos announced that banks will be forced to set aside a new €30 billion ($39 billion Cdn) financial cushion against bad loans and to separate property assets from their balance sheets.,144,153,bad loans,1,2,3
35NNO802AVXGL5PV4E4DQIBBD2JNIN,Economy Minister Luis de Guindos announced that banks will be forced to set aside a new €30 billion ($39 billion Cdn) financial cushion against bad loans and to separate property assets from their balance sheets.,161,185,separate property assets,1,0,1
35NNO802AVXGL5PV4E4DQIBBD2JNIN,Economy Minister Luis de Guindos announced that banks will be forced to set aside a new €30 billion ($39 billion Cdn) financial cushion against bad loans and to separate property assets from their balance sheets.,170,185,property assets,4,0,4
35NNO802AVXGL5PV4E4DQIBBD2JNIN,Economy Minister Luis de Guindos announced that banks will be forced to set aside a new €30 billion ($39 billion Cdn) financial cushion against bad loans and to separate property assets from their balance sheets.,179,185,assets,0,1,1
35NNO802AVXGL5PV4E4DQIBBD2JNIN,Economy Minister Luis de Guindos announced that banks will be forced to set aside a new €30 billion ($39 billion Cdn) financial cushion against bad loans and to separate property assets from their balance sheets.,197,211,balance sheets,4,0,4
35NNO802AVXGL5PV4E4DQIBBD2JNIN,The package is the second by the new conservative government in three months and Spain's fourth in three years.,37,49,conservative,7,3,10
35NNO802AVXGL5PV4E4DQIBBD2JNIN,The government in February told banks to set aside €50 billion ($64.5 billion) in rainy-day funds to protect them against losses in the property market and elsewhere.,45,50,aside,0,1,1
35NNO802AVXGL5PV4E4DQIBBD2JNIN,The government in February told banks to set aside €50 billion ($64.5 billion) in rainy-day funds to protect them against losses in the property market and elsewhere.,82,91,rainy-day,2,2,4
35NNO802AVXGL5PV4E4DQIBBD2JNIN,The government in February told banks to set aside €50 billion ($64.5 billion) in rainy-day funds to protect them against losses in the property market and elsewhere.,82,97,rainy-day funds,4,3,7
35NNO802AVXGL5PV4E4DQIBBD2JNIN,The government in February told banks to set aside €50 billion ($64.5 billion) in rainy-day funds to protect them against losses in the property market and elsewhere.,136,151,property market,2,0,2
35NNO802AVXGL5PV4E4DQIBBD2JNIN,The government in February told banks to set aside €50 billion ($64.5 billion) in rainy-day funds to protect them against losses in the property market and elsewhere.,156,165,elsewhere,0,2,2
3TKXBROM5TBK2FYAPGCLXBUU5VHIJ8,"The news came a day after thousands of Russians rallied in Moscow and St. Petersburg and faced off with police and Interior Ministry troops, who detained and arrested hundreds of protesters, including journalists.",26,35,thousands,2,0,2
3TKXBROM5TBK2FYAPGCLXBUU5VHIJ8,"The news came a day after thousands of Russians rallied in Moscow and St. Petersburg and faced off with police and Interior Ministry troops, who detained and arrested hundreds of protesters, including journalists.",48,55,rallied,7,7,14
3TKXBROM5TBK2FYAPGCLXBUU5VHIJ8,"The news came a day after thousands of Russians rallied in Moscow and St. Petersburg and faced off with police and Interior Ministry troops, who detained and arrested hundreds of protesters, including journalists.",89,98,faced off,1,2,3
3TKXBROM5TBK2FYAPGCLXBUU5VHIJ8,"The news came a day after thousands of Russians rallied in Moscow and St. Petersburg and faced off with police and Interior Ministry troops, who detained and arrested hundreds of protesters, including journalists.",115,132,Interior Ministry,2,1,3
3TKXBROM5TBK2FYAPGCLXBUU5VHIJ8,"The news came a day after thousands of Russians rallied in Moscow and St. Petersburg and faced off with police and Interior Ministry troops, who detained and arrested hundreds of protesters, including journalists.",115,139,Interior Ministry troops,1,0,1
3TKXBROM5TBK2FYAPGCLXBUU5VHIJ8,"The news came a day after thousands of Russians rallied in Moscow and St. Petersburg and faced off with police and Interior Ministry troops, who detained and arrested hundreds of protesters, including journalists.",145,153,detained,9,10,19
3TKXBROM5TBK2FYAPGCLXBUU5VHIJ8,"The news came a day after thousands of Russians rallied in Moscow and St. Petersburg and faced off with police and Interior Ministry troops, who detained and arrested hundreds of protesters, including journalists.",158,166,arrested,1,0,1
3TKXBROM5TBK2FYAPGCLXBUU5VHIJ8,"The news came a day after thousands of Russians rallied in Moscow and St. Petersburg and faced off with police and Interior Ministry troops, who detained and arrested hundreds of protesters, including journalists.",167,175,hundreds,1,0,1
3TKXBROM5TBK2FYAPGCLXBUU5VHIJ8,"The news came a day after thousands of Russians rallied in Moscow and St. Petersburg and faced off with police and Interior Ministry troops, who detained and arrested hundreds of protesters, including journalists.",179,189,protesters,3,3,6
3TKXBROM5TBK2FYAPGCLXBUU5VHIJ8,"The news came a day after thousands of Russians rallied in Moscow and St. Petersburg and faced off with police and Interior Ministry troops, who detained and arrested hundreds of protesters, including journalists.",191,212,including journalists,0,1,1
3TKXBROM5TBK2FYAPGCLXBUU5VHIJ8,"The news came a day after thousands of Russians rallied in Moscow and St. Petersburg and faced off with police and Interior Ministry troops, who detained and arrested hundreds of protesters, including journalists.",201,212,journalists,5,0,5
3TKXBROM5TBK2FYAPGCLXBUU5VHIJ8,"The country's leaders have to admit that there were numerous falsifications and rigging and the results do not reflect the will of the people, Gorbachev told Interfax, according to the AFP.",31,36,admit,0,2,2
3TKXBROM5TBK2FYAPGCLXBUU5VHIJ8,"The country's leaders have to admit that there were numerous falsifications and rigging and the results do not reflect the will of the people, Gorbachev told Interfax, according to the AFP.",53,61,numerous,1,2,3
3TKXBROM5TBK2FYAPGCLXBUU5VHIJ8,"The country's leaders have to admit that there were numerous falsifications and rigging and the results do not reflect the will of the people, Gorbachev told Interfax, according to the AFP.",53,76,numerous falsifications,5,0,5
3TKXBROM5TBK2FYAPGCLXBUU5VHIJ8,"The country's leaders have to admit that there were numerous falsifications and rigging and the results do not reflect the will of the people, Gorbachev told Interfax, according to the AFP.",53,88,numerous falsifications and rigging,0,1,1
3TKXBROM5TBK2FYAPGCLXBUU5VHIJ8,"The country's leaders have to admit that there were numerous falsifications and rigging and the results do not reflect the will of the people, Gorbachev told Interfax, according to the AFP.",62,76,falsifications,10,10,20
3TKXBROM5TBK2FYAPGCLXBUU5VHIJ8,"The country's leaders have to admit that there were numerous falsifications and rigging and the results do not reflect the will of the people, Gorbachev told Interfax, according to the AFP.",81,88,rigging,10,10,20
3TKXBROM5TBK2FYAPGCLXBUU5VHIJ8,"The country's leaders have to admit that there were numerous falsifications and rigging and the results do not reflect the will of the people, Gorbachev told Interfax, according to the AFP.",112,119,reflect,0,2,2
3TKXBROM5TBK2FYAPGCLXBUU5VHIJ8,"The country's leaders have to admit that there were numerous falsifications and rigging and the results do not reflect the will of the people, Gorbachev told Interfax, according to the AFP.",170,179,according,0,1,1
3TKXBROM5TBK2FYAPGCLXBUU5VHIJ8,"The country's leaders have to admit that there were numerous falsifications and rigging and the results do not reflect the will of the people, Gorbachev told Interfax, according to the AFP.",187,190,AFP,1,0,1
3TKXBROM5TBK2FYAPGCLXBUU5VHIJ8,Therefore I think they can only take one decision — annul the results of the election and hold new ones.,42,50,decision,1,0,1
3TKXBROM5TBK2FYAPGCLXBUU5VHIJ8,Therefore I think they can only take one decision — annul the results of the election and hold new ones.,53,58,annul,7,4,11
3TKXBROM5TBK2FYAPGCLXBUU5VHIJ8,Therefore I think they can only take one decision — annul the results of the election and hold new ones.,78,86,election,1,0,1
3TKXBROM5TBK2FYAPGCLXBUU5VHIJ8,Thousands of security forces were out in the Russian capital and helicopters roamed the sky Wednesday in a show of force following the protests over the election that saw Prime Minister Vladimir Putin's party struggle to keep a majority.,13,28,security forces,3,0,3
3TKXBROM5TBK2FYAPGCLXBUU5VHIJ8,Thousands of security forces were out in the Russian capital and helicopters roamed the sky Wednesday in a show of force following the protests over the election that saw Prime Minister Vladimir Putin's party struggle to keep a majority.,65,76,helicopters,1,0,1
3TKXBROM5TBK2FYAPGCLXBUU5VHIJ8,Thousands of security forces were out in the Russian capital and helicopters roamed the sky Wednesday in a show of force following the protests over the election that saw Prime Minister Vladimir Putin's party struggle to keep a majority.,77,83,roamed,6,3,9
3TKXBROM5TBK2FYAPGCLXBUU5VHIJ8,Thousands of security forces were out in the Russian capital and helicopters roamed the sky Wednesday in a show of force following the protests over the election that saw Prime Minister Vladimir Putin's party struggle to keep a majority.,107,120,show of force,1,0,1
3TKXBROM5TBK2FYAPGCLXBUU5VHIJ8,Thousands of security forces were out in the Russian capital and helicopters roamed the sky Wednesday in a show of force following the protests over the election that saw Prime Minister Vladimir Putin's party struggle to keep a majority.,115,120,force,1,0,1
3TKXBROM5TBK2FYAPGCLXBUU5VHIJ8,Thousands of security forces were out in the Russian capital and helicopters roamed the sky Wednesday in a show of force following the protests over the election that saw Prime Minister Vladimir Putin's party struggle to keep a majority.,203,217,party struggle,1,0,1
3TKXBROM5TBK2FYAPGCLXBUU5VHIJ8,Thousands of security forces were out in the Russian capital and helicopters roamed the sky Wednesday in a show of force following the protests over the election that saw Prime Minister Vladimir Putin's party struggle to keep a majority.,209,217,struggle,0,2,2
3TKXBROM5TBK2FYAPGCLXBUU5VHIJ8,Thousands of security forces were out in the Russian capital and helicopters roamed the sky Wednesday in a show of force following the protests over the election that saw Prime Minister Vladimir Putin's party struggle to keep a majority.,228,236,majority,3,0,3
3B9XR6P1WEWAF7K4J6K4BOQH9SUBJY,"The market was bracing itself for at least 50 billion euros in new cash.	16	23	bracing	10	10	20
3B9XR6P1WEWAF7K4J6K4BOQH9SUBJY	The market was bracing itself for at least 50 billion euros in new cash.",16,30,bracing itself,2,0,2
3B9XR6P1WEWAF7K4J6K4BOQH9SUBJY,"The market was bracing itself for at least 50 billion euros in new cash.	64	72	new cash	1	0	1
3B9XR6P1WEWAF7K4J6K4BOQH9SUBJY	You can't put out a number as low as 15 billion without an explanation, said a London-based banking analyst who did not want to be named.",59,70,explanation,3,1,4
3B9XR6P1WEWAF7K4J6K4BOQH9SUBJY,"You can't put out a number as low as 15 billion without an explanation,"" said a London-based banking analyst who did not want to be named.",93,108,banking analyst,5,1,6
3B9XR6P1WEWAF7K4J6K4BOQH9SUBJY,"You can't put out a number as low as 15 billion without an explanation,"" said a London-based banking analyst who did not want to be named.",101,108,analyst,4,5,9
3B9XR6P1WEWAF7K4J6K4BOQH9SUBJY,"Spanish lenders must set aside 30 billion euros, on top of 54 billion euros ordered in February, as provisions against loans which are still performing as well as bad ones while defaults rise in an recession which has sent unemployment to 24 percent.",8,15,lenders,0,3,3
3B9XR6P1WEWAF7K4J6K4BOQH9SUBJY,"Spanish lenders must set aside 30 billion euros, on top of 54 billion euros ordered in February, as provisions against loans which are still performing as well as bad ones while defaults rise in an recession which has sent unemployment to 24 percent.",25,30,aside,1,0,1
3B9XR6P1WEWAF7K4J6K4BOQH9SUBJY,"Spanish lenders must set aside 30 billion euros, on top of 54 billion euros ordered in February, as provisions against loans which are still performing as well as bad ones while defaults rise in an recession which has sent unemployment to 24 percent.",42,47,euros,1,0,1
3B9XR6P1WEWAF7K4J6K4BOQH9SUBJY,"Spanish lenders must set aside 30 billion euros, on top of 54 billion euros ordered in February, as provisions against loans which are still performing as well as bad ones while defaults rise in an recession which has sent unemployment to 24 percent.",100,110,provisions,9,9,18
3B9XR6P1WEWAF7K4J6K4BOQH9SUBJY,"Spanish lenders must set aside 30 billion euros, on top of 54 billion euros ordered in February, as provisions against loans which are still performing as well as bad ones while defaults rise in an recession which has sent unemployment to 24 percent.",100,124,provisions against loans,1,0,1
3B9XR6P1WEWAF7K4J6K4BOQH9SUBJY,"Spanish lenders must set aside 30 billion euros, on top of 54 billion euros ordered in February, as provisions against loans which are still performing as well as bad ones while defaults rise in an recession which has sent unemployment to 24 percent.",141,151,performing,1,2,3
3B9XR6P1WEWAF7K4J6K4BOQH9SUBJY,"Spanish lenders must set aside 30 billion euros, on top of 54 billion euros ordered in February, as provisions against loans which are still performing as well as bad ones while defaults rise in an recession which has sent unemployment to 24 percent.",178,186,defaults,9,6,15
3B9XR6P1WEWAF7K4J6K4BOQH9SUBJY,"Spanish lenders must set aside 30 billion euros, on top of 54 billion euros ordered in February, as provisions against loans which are still performing as well as bad ones while defaults rise in an recession which has sent unemployment to 24 percent.",187,191,rise,0,1,1
3B9XR6P1WEWAF7K4J6K4BOQH9SUBJY,"Spanish lenders must set aside 30 billion euros, on top of 54 billion euros ordered in February, as provisions against loans which are still performing as well as bad ones while defaults rise in an recession which has sent unemployment to 24 percent.",198,207,recession,10,8,18
3B9XR6P1WEWAF7K4J6K4BOQH9SUBJY,"Spanish lenders must set aside 30 billion euros, on top of 54 billion euros ordered in February, as provisions against loans which are still performing as well as bad ones while defaults rise in an recession which has sent unemployment to 24 percent.",223,235,unemployment,1,0,1
3B9XR6P1WEWAF7K4J6K4BOQH9SUBJY,"For banks unable to raise the necessary funds, the government will provide five-year loans, convertible into shares with an interest rate double the rate on government bonds.",20,25,raise,0,1,1
3B9XR6P1WEWAF7K4J6K4BOQH9SUBJY,"For banks unable to raise the necessary funds, the government will provide five-year loans, convertible into shares with an interest rate double the rate on government bonds.",92,103,convertible,9,5,14
3B9XR6P1WEWAF7K4J6K4BOQH9SUBJY,"For banks unable to raise the necessary funds, the government will provide five-year loans, convertible into shares with an interest rate double the rate on government bonds.",92,115,convertible into shares,1,0,1
3B9XR6P1WEWAF7K4J6K4BOQH9SUBJY,"For banks unable to raise the necessary funds, the government will provide five-year loans, convertible into shares with an interest rate double the rate on government bonds.",109,115,shares,0,1,1
3B9XR6P1WEWAF7K4J6K4BOQH9SUBJY,"For banks unable to raise the necessary funds, the government will provide five-year loans, convertible into shares with an interest rate double the rate on government bonds.",124,137,interest rate,2,2,4
3B9XR6P1WEWAF7K4J6K4BOQH9SUBJY,"For banks unable to raise the necessary funds, the government will provide five-year loans, convertible into shares with an interest rate double the rate on government bonds.",157,167,government,1,0,1
3B9XR6P1WEWAF7K4J6K4BOQH9SUBJY,"For banks unable to raise the necessary funds, the government will provide five-year loans, convertible into shares with an interest rate double the rate on government bonds.",157,173,government bonds,1,0,1
3B9XR6P1WEWAF7K4J6K4BOQH9SUBJY,"For banks unable to raise the necessary funds, the government will provide five-year loans, convertible into shares with an interest rate double the rate on government bonds.",168,173,bonds,2,1,3
3B9XR6P1WEWAF7K4J6K4BOQH9SUBJY,"The state will have to raise money on debt markets for the loans to the banks, which will be made through an instrument known as contingent convertibles, or CoCos, which carry the risk that the state ends up with ownership of still-troubled banks.",23,34,raise money,0,1,1
3B9XR6P1WEWAF7K4J6K4BOQH9SUBJY,"The state will have to raise money on debt markets for the loans to the banks, which will be made through an instrument known as contingent convertibles, or CoCos, which carry the risk that the state ends up with ownership of still-troubled banks.",38,42,debt,0,1,1
3B9XR6P1WEWAF7K4J6K4BOQH9SUBJY,"The state will have to raise money on debt markets for the loans to the banks, which will be made through an instrument known as contingent convertibles, or CoCos, which carry the risk that the state ends up with ownership of still-troubled banks.",38,50,debt markets,4,2,6
3B9XR6P1WEWAF7K4J6K4BOQH9SUBJY,"The state will have to raise money on debt markets for the loans to the banks, which will be made through an instrument known as contingent convertibles, or CoCos, which carry the risk that the state ends up with ownership of still-troubled banks.",109,119,instrument,5,1,6
3B9XR6P1WEWAF7K4J6K4BOQH9SUBJY,"The state will have to raise money on debt markets for the loans to the banks, which will be made through an instrument known as contingent convertibles, or CoCos, which carry the risk that the state ends up with ownership of still-troubled banks.",129,139,contingent,4,4,8
3B9XR6P1WEWAF7K4J6K4BOQH9SUBJY,"The state will have to raise money on debt markets for the loans to the banks, which will be made through an instrument known as contingent convertibles, or CoCos, which carry the risk that the state ends up with ownership of still-troubled banks.",129,152,contingent convertibles,9,4,13
3B9XR6P1WEWAF7K4J6K4BOQH9SUBJY,"The state will have to raise money on debt markets for the loans to the banks, which will be made through an instrument known as contingent convertibles, or CoCos, which carry the risk that the state ends up with ownership of still-troubled banks.",129,162,"contingent convertibles, or CoCos",1,0,1
3B9XR6P1WEWAF7K4J6K4BOQH9SUBJY,"The state will have to raise money on debt markets for the loans to the banks, which will be made through an instrument known as contingent convertibles, or CoCos, which carry the risk that the state ends up with ownership of still-troubled banks.",140,152,convertibles,3,0,3
3B9XR6P1WEWAF7K4J6K4BOQH9SUBJY,"The state will have to raise money on debt markets for the loans to the banks, which will be made through an instrument known as contingent convertibles, or CoCos, which carry the risk that the state ends up with ownership of still-troubled banks.",157,162,CoCos,2,0,2
3B9XR6P1WEWAF7K4J6K4BOQH9SUBJY,"The state will have to raise money on debt markets for the loans to the banks, which will be made through an instrument known as contingent convertibles, or CoCos, which carry the risk that the state ends up with ownership of still-troubled banks.",213,222,ownership,0,1,1
3B9XR6P1WEWAF7K4J6K4BOQH9SUBJY,"The state will have to raise money on debt markets for the loans to the banks, which will be made through an instrument known as contingent convertibles, or CoCos, which carry the risk that the state ends up with ownership of still-troubled banks.",226,240,still-troubled,1,1,2
3B9XR6P1WEWAF7K4J6K4BOQH9SUBJY,"The state will have to raise money on debt markets for the loans to the banks, which will be made through an instrument known as contingent convertibles, or CoCos, which carry the risk that the state ends up with ownership of still-troubled banks.",226,246,still-troubled banks,2,1,3
3JYPJ2TAYI9WEZZIJLBKRA3EY2VFPE,"Mr McGlone said: ""South Derry has been shaken by the news of this terrible shooting.",30,45,has been shaken,0,1,1
3JYPJ2TAYI9WEZZIJLBKRA3EY2VFPE,"Mr McGlone said: ""South Derry has been shaken by the news of this terrible shooting.",39,45,shaken,4,3,7
3JYPJ2TAYI9WEZZIJLBKRA3EY2VFPE,"Mr McGlone said: ""South Derry has been shaken by the news of this terrible shooting.",66,74,terrible,1,2,3
3JYPJ2TAYI9WEZZIJLBKRA3EY2VFPE,There is an overwhelming sense of shock amongst local people that something like this has happened so close to home in broad daylight.,13,25,overwhelming,9,10,19
3JYPJ2TAYI9WEZZIJLBKRA3EY2VFPE,There is an overwhelming sense of shock amongst local people that something like this has happened so close to home in broad daylight.,26,40,sense of shock,1,0,1
3JYPJ2TAYI9WEZZIJLBKRA3EY2VFPE,There is an overwhelming sense of shock amongst local people that something like this has happened so close to home in broad daylight.,35,40,shock,1,0,1
3JYPJ2TAYI9WEZZIJLBKRA3EY2VFPE,There is an overwhelming sense of shock amongst local people that something like this has happened so close to home in broad daylight.,41,48,amongst,2,0,2
3JYPJ2TAYI9WEZZIJLBKRA3EY2VFPE,There is an overwhelming sense of shock amongst local people that something like this has happened so close to home in broad daylight.,120,125,broad,1,1,2
3JYPJ2TAYI9WEZZIJLBKRA3EY2VFPE,There is an overwhelming sense of shock amongst local people that something like this has happened so close to home in broad daylight.,120,134,broad daylight,1,2,3
3JYPJ2TAYI9WEZZIJLBKRA3EY2VFPE,"Baset al-Megrahi, the Libyan intelligence officer who was convicted in the 1988 Lockerbie bombing has died at his home in Tripoli, nearly three years after he was released from a Scottish prison.Al-Megrahi was released on Aug. 20, 2009, on compassionate grounds in order for him return home to die after he was diagnosed with prostate cancer.",22,49,Libyan intelligence officer,1,0,1
3JYPJ2TAYI9WEZZIJLBKRA3EY2VFPE,"Baset al-Megrahi, the Libyan intelligence officer who was convicted in the 1988 Lockerbie bombing has died at his home in Tripoli, nearly three years after he was released from a Scottish prison.Al-Megrahi was released on Aug. 20, 2009, on compassionate grounds in order for him return home to die after he was diagnosed with prostate cancer.",29,41,intelligence,2,3,5
3JYPJ2TAYI9WEZZIJLBKRA3EY2VFPE,"Baset al-Megrahi, the Libyan intelligence officer who was convicted in the 1988 Lockerbie bombing has died at his home in Tripoli, nearly three years after he was released from a Scottish prison.Al-Megrahi was released on Aug. 20, 2009, on compassionate grounds in order for him return home to die after he was diagnosed with prostate cancer.",29,49,intelligence officer,1,1,2
3JYPJ2TAYI9WEZZIJLBKRA3EY2VFPE,"Baset al-Megrahi, the Libyan intelligence officer who was convicted in the 1988 Lockerbie bombing has died at his home in Tripoli, nearly three years after he was released from a Scottish prison.Al-Megrahi was released on Aug. 20, 2009, on compassionate grounds in order for him return home to die after he was diagnosed with prostate cancer.",58,67,convicted,3,6,9
3JYPJ2TAYI9WEZZIJLBKRA3EY2VFPE,"Baset al-Megrahi, the Libyan intelligence officer who was convicted in the 1988 Lockerbie bombing has died at his home in Tripoli, nearly three years after he was released from a Scottish prison.Al-Megrahi was released on Aug. 20, 2009, on compassionate grounds in order for him return home to die after he was diagnosed with prostate cancer.",80,89,Lockerbie,0,2,2
3JYPJ2TAYI9WEZZIJLBKRA3EY2VFPE,"Baset al-Megrahi, the Libyan intelligence officer who was convicted in the 1988 Lockerbie bombing has died at his home in Tripoli, nearly three years after he was released from a Scottish prison.Al-Megrahi was released on Aug. 20, 2009, on compassionate grounds in order for him return home to die after he was diagnosed with prostate cancer.",163,171,released,0,2,2
3JYPJ2TAYI9WEZZIJLBKRA3EY2VFPE,"Baset al-Megrahi, the Libyan intelligence officer who was convicted in the 1988 Lockerbie bombing has died at his home in Tripoli, nearly three years after he was released from a Scottish prison.Al-Megrahi was released on Aug. 20, 2009, on compassionate grounds in order for him return home to die after he was diagnosed with prostate cancer.",240,253,compassionate,7,8,15
3JYPJ2TAYI9WEZZIJLBKRA3EY2VFPE,"Baset al-Megrahi, the Libyan intelligence officer who was convicted in the 1988 Lockerbie bombing has died at his home in Tripoli, nearly three years after he was released from a Scottish prison.Al-Megrahi was released on Aug. 20, 2009, on compassionate grounds in order for him return home to die after he was diagnosed with prostate cancer.",240,261,compassionate grounds,6,4,10
3JYPJ2TAYI9WEZZIJLBKRA3EY2VFPE,"Baset al-Megrahi, the Libyan intelligence officer who was convicted in the 1988 Lockerbie bombing has died at his home in Tripoli, nearly three years after he was released from a Scottish prison.Al-Megrahi was released on Aug. 20, 2009, on compassionate grounds in order for him return home to die after he was diagnosed with prostate cancer.",311,320,diagnosed,6,5,11
3JYPJ2TAYI9WEZZIJLBKRA3EY2VFPE,"Baset al-Megrahi, the Libyan intelligence officer who was convicted in the 1988 Lockerbie bombing has died at his home in Tripoli, nearly three years after he was released from a Scottish prison.Al-Megrahi was released on Aug. 20, 2009, on compassionate grounds in order for him return home to die after he was diagnosed with prostate cancer.",326,334,prostate,4,3,7
3JYPJ2TAYI9WEZZIJLBKRA3EY2VFPE,"Baset al-Megrahi, the Libyan intelligence officer who was convicted in the 1988 Lockerbie bombing has died at his home in Tripoli, nearly three years after he was released from a Scottish prison.Al-Megrahi was released on Aug. 20, 2009, on compassionate grounds in order for him return home to die after he was diagnosed with prostate cancer.",326,341,prostate cancer,2,1,3
3JYPJ2TAYI9WEZZIJLBKRA3EY2VFPE,"Al-Megrahi insisted he was innocent, but he kept a strict silence after his release, living in the family villa surrounded by high walls in a posh Tripoli neighborhood, mostly bedridden or taking a few steps with a cane.His son, Khaled al-Megrahi, confirmed that he died in Tripoli in a telephone interview but hung up before giving more details.Saad Nasser al-Megrahi, a relative and a member of the ruling National Transitional Council, said al-Megrahi's health had seriously deteriorated in recent days and he died of cancer-related complications.Al-Megrahi insisted he had nothing to do with the bombing, which killed 270 people, most of them Americans.",11,19,insisted,2,2,4
3JYPJ2TAYI9WEZZIJLBKRA3EY2VFPE,"Al-Megrahi insisted he was innocent, but he kept a strict silence after his release, living in the family villa surrounded by high walls in a posh Tripoli neighborhood, mostly bedridden or taking a few steps with a cane.His son, Khaled al-Megrahi, confirmed that he died in Tripoli in a telephone interview but hung up before giving more details.Saad Nasser al-Megrahi, a relative and a member of the ruling National Transitional Council, said al-Megrahi's health had seriously deteriorated in recent days and he died of cancer-related complications.Al-Megrahi insisted he had nothing to do with the bombing, which killed 270 people, most of them Americans.",27,35,innocent,0,2,2
3JYPJ2TAYI9WEZZIJLBKRA3EY2VFPE,"Al-Megrahi insisted he was innocent, but he kept a strict silence after his release, living in the family villa surrounded by high walls in a posh Tripoli neighborhood, mostly bedridden or taking a few steps with a cane.His son, Khaled al-Megrahi, confirmed that he died in Tripoli in a telephone interview but hung up before giving more details.Saad Nasser al-Megrahi, a relative and a member of the ruling National Transitional Council, said al-Megrahi's health had seriously deteriorated in recent days and he died of cancer-related complications.Al-Megrahi insisted he had nothing to do with the bombing, which killed 270 people, most of them Americans.",51,65,strict silence,1,1,2
3JYPJ2TAYI9WEZZIJLBKRA3EY2VFPE,"Al-Megrahi insisted he was innocent, but he kept a strict silence after his release, living in the family villa surrounded by high walls in a posh Tripoli neighborhood, mostly bedridden or taking a few steps with a cane.His son, Khaled al-Megrahi, confirmed that he died in Tripoli in a telephone interview but hung up before giving more details.Saad Nasser al-Megrahi, a relative and a member of the ruling National Transitional Council, said al-Megrahi's health had seriously deteriorated in recent days and he died of cancer-related complications.Al-Megrahi insisted he had nothing to do with the bombing, which killed 270 people, most of them Americans.",106,111,villa,1,0,1
3JYPJ2TAYI9WEZZIJLBKRA3EY2VFPE,"Al-Megrahi insisted he was innocent, but he kept a strict silence after his release, living in the family villa surrounded by high walls in a posh Tripoli neighborhood, mostly bedridden or taking a few steps with a cane.His son, Khaled al-Megrahi, confirmed that he died in Tripoli in a telephone interview but hung up before giving more details.Saad Nasser al-Megrahi, a relative and a member of the ruling National Transitional Council, said al-Megrahi's health had seriously deteriorated in recent days and he died of cancer-related complications.Al-Megrahi insisted he had nothing to do with the bombing, which killed 270 people, most of them Americans.",112,122,surrounded,2,2,4
3JYPJ2TAYI9WEZZIJLBKRA3EY2VFPE,"Al-Megrahi insisted he was innocent, but he kept a strict silence after his release, living in the family villa surrounded by high walls in a posh Tripoli neighborhood, mostly bedridden or taking a few steps with a cane.His son, Khaled al-Megrahi, confirmed that he died in Tripoli in a telephone interview but hung up before giving more details.Saad Nasser al-Megrahi, a relative and a member of the ruling National Transitional Council, said al-Megrahi's health had seriously deteriorated in recent days and he died of cancer-related complications.Al-Megrahi insisted he had nothing to do with the bombing, which killed 270 people, most of them Americans.",142,146,posh,3,4,7
3JYPJ2TAYI9WEZZIJLBKRA3EY2VFPE,"Al-Megrahi insisted he was innocent, but he kept a strict silence after his release, living in the family villa surrounded by high walls in a posh Tripoli neighborhood, mostly bedridden or taking a few steps with a cane.His son, Khaled al-Megrahi, confirmed that he died in Tripoli in a telephone interview but hung up before giving more details.Saad Nasser al-Megrahi, a relative and a member of the ruling National Transitional Council, said al-Megrahi's health had seriously deteriorated in recent days and he died of cancer-related complications.Al-Megrahi insisted he had nothing to do with the bombing, which killed 270 people, most of them Americans.",155,167,neighborhood,2,0,2
3JYPJ2TAYI9WEZZIJLBKRA3EY2VFPE,"Al-Megrahi insisted he was innocent, but he kept a strict silence after his release, living in the family villa surrounded by high walls in a posh Tripoli neighborhood, mostly bedridden or taking a few steps with a cane.His son, Khaled al-Megrahi, confirmed that he died in Tripoli in a telephone interview but hung up before giving more details.Saad Nasser al-Megrahi, a relative and a member of the ruling National Transitional Council, said al-Megrahi's health had seriously deteriorated in recent days and he died of cancer-related complications.Al-Megrahi insisted he had nothing to do with the bombing, which killed 270 people, most of them Americans.",176,185,bedridden,9,10,19
3JYPJ2TAYI9WEZZIJLBKRA3EY2VFPE,"Al-Megrahi insisted he was innocent, but he kept a strict silence after his release, living in the family villa surrounded by high walls in a posh Tripoli neighborhood, mostly bedridden or taking a few steps with a cane.His son, Khaled al-Megrahi, confirmed that he died in Tripoli in a telephone interview but hung up before giving more details.Saad Nasser al-Megrahi, a relative and a member of the ruling National Transitional Council, said al-Megrahi's health had seriously deteriorated in recent days and he died of cancer-related complications.Al-Megrahi insisted he had nothing to do with the bombing, which killed 270 people, most of them Americans.",215,219,cane,0,1,1
3JYPJ2TAYI9WEZZIJLBKRA3EY2VFPE,"Al-Megrahi insisted he was innocent, but he kept a strict silence after his release, living in the family villa surrounded by high walls in a posh Tripoli neighborhood, mostly bedridden or taking a few steps with a cane.His son, Khaled al-Megrahi, confirmed that he died in Tripoli in a telephone interview but hung up before giving more details.Saad Nasser al-Megrahi, a relative and a member of the ruling National Transitional Council, said al-Megrahi's health had seriously deteriorated in recent days and he died of cancer-related complications.Al-Megrahi insisted he had nothing to do with the bombing, which killed 270 people, most of them Americans.",311,315,hung,0,1,1
3JYPJ2TAYI9WEZZIJLBKRA3EY2VFPE,"Al-Megrahi insisted he was innocent, but he kept a strict silence after his release, living in the family villa surrounded by high walls in a posh Tripoli neighborhood, mostly bedridden or taking a few steps with a cane.His son, Khaled al-Megrahi, confirmed that he died in Tripoli in a telephone interview but hung up before giving more details.Saad Nasser al-Megrahi, a relative and a member of the ruling National Transitional Council, said al-Megrahi's health had seriously deteriorated in recent days and he died of cancer-related complications.Al-Megrahi insisted he had nothing to do with the bombing, which killed 270 people, most of them Americans.",311,318,hung up,0,1,1
3JYPJ2TAYI9WEZZIJLBKRA3EY2VFPE,"Al-Megrahi insisted he was innocent, but he kept a strict silence after his release, living in the family villa surrounded by high walls in a posh Tripoli neighborhood, mostly bedridden or taking a few steps with a cane.His son, Khaled al-Megrahi, confirmed that he died in Tripoli in a telephone interview but hung up before giving more details.Saad Nasser al-Megrahi, a relative and a member of the ruling National Transitional Council, said al-Megrahi's health had seriously deteriorated in recent days and he died of cancer-related complications.Al-Megrahi insisted he had nothing to do with the bombing, which killed 270 people, most of them Americans.",401,407,ruling,0,1,1
3JYPJ2TAYI9WEZZIJLBKRA3EY2VFPE,"Al-Megrahi insisted he was innocent, but he kept a strict silence after his release, living in the family villa surrounded by high walls in a posh Tripoli neighborhood, mostly bedridden or taking a few steps with a cane.His son, Khaled al-Megrahi, confirmed that he died in Tripoli in a telephone interview but hung up before giving more details.Saad Nasser al-Megrahi, a relative and a member of the ruling National Transitional Council, said al-Megrahi's health had seriously deteriorated in recent days and he died of cancer-related complications.Al-Megrahi insisted he had nothing to do with the bombing, which killed 270 people, most of them Americans.",417,429,Transitional,0,1,1
3JYPJ2TAYI9WEZZIJLBKRA3EY2VFPE,"Al-Megrahi insisted he was innocent, but he kept a strict silence after his release, living in the family villa surrounded by high walls in a posh Tripoli neighborhood, mostly bedridden or taking a few steps with a cane.His son, Khaled al-Megrahi, confirmed that he died in Tripoli in a telephone interview but hung up before giving more details.Saad Nasser al-Megrahi, a relative and a member of the ruling National Transitional Council, said al-Megrahi's health had seriously deteriorated in recent days and he died of cancer-related complications.Al-Megrahi insisted he had nothing to do with the bombing, which killed 270 people, most of them Americans.",468,490,seriously deteriorated,2,0,2
3JYPJ2TAYI9WEZZIJLBKRA3EY2VFPE,"Al-Megrahi insisted he was innocent, but he kept a strict silence after his release, living in the family villa surrounded by high walls in a posh Tripoli neighborhood, mostly bedridden or taking a few steps with a cane.His son, Khaled al-Megrahi, confirmed that he died in Tripoli in a telephone interview but hung up before giving more details.Saad Nasser al-Megrahi, a relative and a member of the ruling National Transitional Council, said al-Megrahi's health had seriously deteriorated in recent days and he died of cancer-related complications.Al-Megrahi insisted he had nothing to do with the bombing, which killed 270 people, most of them Americans.",478,490,deteriorated,10,10,20
3JYPJ2TAYI9WEZZIJLBKRA3EY2VFPE,"Al-Megrahi insisted he was innocent, but he kept a strict silence after his release, living in the family villa surrounded by high walls in a posh Tripoli neighborhood, mostly bedridden or taking a few steps with a cane.His son, Khaled al-Megrahi, confirmed that he died in Tripoli in a telephone interview but hung up before giving more details.Saad Nasser al-Megrahi, a relative and a member of the ruling National Transitional Council, said al-Megrahi's health had seriously deteriorated in recent days and he died of cancer-related complications.Al-Megrahi insisted he had nothing to do with the bombing, which killed 270 people, most of them Americans.",521,549,cancer-related complications,2,0,2
3JYPJ2TAYI9WEZZIJLBKRA3EY2VFPE,"Al-Megrahi insisted he was innocent, but he kept a strict silence after his release, living in the family villa surrounded by high walls in a posh Tripoli neighborhood, mostly bedridden or taking a few steps with a cane.His son, Khaled al-Megrahi, confirmed that he died in Tripoli in a telephone interview but hung up before giving more details.Saad Nasser al-Megrahi, a relative and a member of the ruling National Transitional Council, said al-Megrahi's health had seriously deteriorated in recent days and he died of cancer-related complications.Al-Megrahi insisted he had nothing to do with the bombing, which killed 270 people, most of them Americans.",536,549,complications,6,1,7
3JYPJ2TAYI9WEZZIJLBKRA3EY2VFPE,"Al-Megrahi insisted he was innocent, but he kept a strict silence after his release, living in the family villa surrounded by high walls in a posh Tripoli neighborhood, mostly bedridden or taking a few steps with a cane.His son, Khaled al-Megrahi, confirmed that he died in Tripoli in a telephone interview but hung up before giving more details.Saad Nasser al-Megrahi, a relative and a member of the ruling National Transitional Council, said al-Megrahi's health had seriously deteriorated in recent days and he died of cancer-related complications.Al-Megrahi insisted he had nothing to do with the bombing, which killed 270 people, most of them Americans.",561,569,insisted,0,1,1
3AXFSPQOYQZ0SOWKO860UEH2P3PFJE,The Philippine government says its navy tried to detain Chinese fishermen but was prevented by the Chinese surveillance craft.,15,25,government,2,1,3
3AXFSPQOYQZ0SOWKO860UEH2P3PFJE,The Philippine government says its navy tried to detain Chinese fishermen but was prevented by the Chinese surveillance craft.,40,55,tried to detain,0,1,1
3AXFSPQOYQZ0SOWKO860UEH2P3PFJE,The Philippine government says its navy tried to detain Chinese fishermen but was prevented by the Chinese surveillance craft.,49,55,detain,8,6,14
3AXFSPQOYQZ0SOWKO860UEH2P3PFJE,The Philippine government says its navy tried to detain Chinese fishermen but was prevented by the Chinese surveillance craft.,107,119,surveillance,9,6,15
3AXFSPQOYQZ0SOWKO860UEH2P3PFJE,The Philippine government says its navy tried to detain Chinese fishermen but was prevented by the Chinese surveillance craft.,107,125,surveillance craft,5,5,10
3AXFSPQOYQZ0SOWKO860UEH2P3PFJE,The Philippine government says its navy tried to detain Chinese fishermen but was prevented by the Chinese surveillance craft.,120,125,craft,0,1,1
3AXFSPQOYQZ0SOWKO860UEH2P3PFJE,The shoal lies off the north-western province of Zambales.,4,9,shoal,8,5,13
3AXFSPQOYQZ0SOWKO860UEH2P3PFJE,The shoal lies off the north-western province of Zambales.,23,36,north-western,0,1,1
3AXFSPQOYQZ0SOWKO860UEH2P3PFJE,The shoal lies off the north-western province of Zambales.,37,45,province,4,1,5
3AXFSPQOYQZ0SOWKO860UEH2P3PFJE,The shoal lies off the north-western province of Zambales.,49,57,Zambales,1,0,1
3AXFSPQOYQZ0SOWKO860UEH2P3PFJE,"China and the Philippines have been disputing ownership of the shoal, in addition to the Spratly Islands and other areas in the South China Sea.",36,45,disputing,4,5,9
3AXFSPQOYQZ0SOWKO860UEH2P3PFJE,"China and the Philippines have been disputing ownership of the shoal, in addition to the Spratly Islands and other areas in the South China Sea.",36,55,disputing ownership,1,1,2
3AXFSPQOYQZ0SOWKO860UEH2P3PFJE,"China and the Philippines have been disputing ownership of the shoal, in addition to the Spratly Islands and other areas in the South China Sea.",46,55,ownership,1,1,2
3AXFSPQOYQZ0SOWKO860UEH2P3PFJE,"China and the Philippines have been disputing ownership of the shoal, in addition to the Spratly Islands and other areas in the South China Sea.",46,68,ownership of the shoal,1,0,1
3AXFSPQOYQZ0SOWKO860UEH2P3PFJE,"China and the Philippines have been disputing ownership of the shoal, in addition to the Spratly Islands and other areas in the South China Sea.",63,68,shoal,6,3,9
3AXFSPQOYQZ0SOWKO860UEH2P3PFJE,"China and the Philippines have been disputing ownership of the shoal, in addition to the Spratly Islands and other areas in the South China Sea.",89,96,Spratly,0,2,2
3AXFSPQOYQZ0SOWKO860UEH2P3PFJE,"China and the Philippines have been disputing ownership of the shoal, in addition to the Spratly Islands and other areas in the South China Sea.",89,104,Spratly Islands,1,0,1
3AXFSPQOYQZ0SOWKO860UEH2P3PFJE,"The Philippine Department of Foreign Affairs said that on Sunday, a Philippine navy surveillance plane sighted eight Chinese fishing vessels anchored in a lagoon at Scarborough, prompting the military to deploy its largest warship, the BRP Gregorio del Pilar, which was recently acquired from the United States.",29,44,Foreign Affairs,1,1,2
3AXFSPQOYQZ0SOWKO860UEH2P3PFJE,"The Philippine Department of Foreign Affairs said that on Sunday, a Philippine navy surveillance plane sighted eight Chinese fishing vessels anchored in a lagoon at Scarborough, prompting the military to deploy its largest warship, the BRP Gregorio del Pilar, which was recently acquired from the United States.",84,96,surveillance,7,1,8
3AXFSPQOYQZ0SOWKO860UEH2P3PFJE,"The Philippine Department of Foreign Affairs said that on Sunday, a Philippine navy surveillance plane sighted eight Chinese fishing vessels anchored in a lagoon at Scarborough, prompting the military to deploy its largest warship, the BRP Gregorio del Pilar, which was recently acquired from the United States.",84,102,surveillance plane,1,1,2
3AXFSPQOYQZ0SOWKO860UEH2P3PFJE,"The Philippine Department of Foreign Affairs said that on Sunday, a Philippine navy surveillance plane sighted eight Chinese fishing vessels anchored in a lagoon at Scarborough, prompting the military to deploy its largest warship, the BRP Gregorio del Pilar, which was recently acquired from the United States.",103,110,sighted,0,3,3
3AXFSPQOYQZ0SOWKO860UEH2P3PFJE,"The Philippine Department of Foreign Affairs said that on Sunday, a Philippine navy surveillance plane sighted eight Chinese fishing vessels anchored in a lagoon at Scarborough, prompting the military to deploy its largest warship, the BRP Gregorio del Pilar, which was recently acquired from the United States.",125,140,fishing vessels,0,1,1
3AXFSPQOYQZ0SOWKO860UEH2P3PFJE,"The Philippine Department of Foreign Affairs said that on Sunday, a Philippine navy surveillance plane sighted eight Chinese fishing vessels anchored in a lagoon at Scarborough, prompting the military to deploy its largest warship, the BRP Gregorio del Pilar, which was recently acquired from the United States.",133,140,vessels,2,4,6
3AXFSPQOYQZ0SOWKO860UEH2P3PFJE,"The Philippine Department of Foreign Affairs said that on Sunday, a Philippine navy surveillance plane sighted eight Chinese fishing vessels anchored in a lagoon at Scarborough, prompting the military to deploy its largest warship, the BRP Gregorio del Pilar, which was recently acquired from the United States.",133,149,vessels anchored,1,1,2
3AXFSPQOYQZ0SOWKO860UEH2P3PFJE,"The Philippine Department of Foreign Affairs said that on Sunday, a Philippine navy surveillance plane sighted eight Chinese fishing vessels anchored in a lagoon at Scarborough, prompting the military to deploy its largest warship, the BRP Gregorio del Pilar, which was recently acquired from the United States.",141,149,anchored,4,3,7
3AXFSPQOYQZ0SOWKO860UEH2P3PFJE,"The Philippine Department of Foreign Affairs said that on Sunday, a Philippine navy surveillance plane sighted eight Chinese fishing vessels anchored in a lagoon at Scarborough, prompting the military to deploy its largest warship, the BRP Gregorio del Pilar, which was recently acquired from the United States.",155,161,lagoon,7,3,10
3AXFSPQOYQZ0SOWKO860UEH2P3PFJE,"The Philippine Department of Foreign Affairs said that on Sunday, a Philippine navy surveillance plane sighted eight Chinese fishing vessels anchored in a lagoon at Scarborough, prompting the military to deploy its largest warship, the BRP Gregorio del Pilar, which was recently acquired from the United States.",178,187,prompting,3,4,7
3AXFSPQOYQZ0SOWKO860UEH2P3PFJE,"The Philippine Department of Foreign Affairs said that on Sunday, a Philippine navy surveillance plane sighted eight Chinese fishing vessels anchored in a lagoon at Scarborough, prompting the military to deploy its largest warship, the BRP Gregorio del Pilar, which was recently acquired from the United States.",192,200,military,1,0,1
3AXFSPQOYQZ0SOWKO860UEH2P3PFJE,"The Philippine Department of Foreign Affairs said that on Sunday, a Philippine navy surveillance plane sighted eight Chinese fishing vessels anchored in a lagoon at Scarborough, prompting the military to deploy its largest warship, the BRP Gregorio del Pilar, which was recently acquired from the United States.",204,210,deploy,4,4,8
3AXFSPQOYQZ0SOWKO860UEH2P3PFJE,"The Philippine Department of Foreign Affairs said that on Sunday, a Philippine navy surveillance plane sighted eight Chinese fishing vessels anchored in a lagoon at Scarborough, prompting the military to deploy its largest warship, the BRP Gregorio del Pilar, which was recently acquired from the United States.",223,230,warship,0,1,1
3AXFSPQOYQZ0SOWKO860UEH2P3PFJE,"The Philippine Department of Foreign Affairs said that on Sunday, a Philippine navy surveillance plane sighted eight Chinese fishing vessels anchored in a lagoon at Scarborough, prompting the military to deploy its largest warship, the BRP Gregorio del Pilar, which was recently acquired from the United States.",279,287,acquired,3,6,9
3AXFSPQOYQZ0SOWKO860UEH2P3PFJE,"On Tuesday, Filipino sailors from the warship boarded the Chinese vessels for an inspection, discovering large amounts of illegally collected coral, giant clams and live sharks inside the first boat, the department said.",12,28,Filipino sailors,1,0,1
3AXFSPQOYQZ0SOWKO860UEH2P3PFJE,"On Tuesday, Filipino sailors from the warship boarded the Chinese vessels for an inspection, discovering large amounts of illegally collected coral, giant clams and live sharks inside the first boat, the department said.",38,45,warship,1,0,1
3AXFSPQOYQZ0SOWKO860UEH2P3PFJE,"On Tuesday, Filipino sailors from the warship boarded the Chinese vessels for an inspection, discovering large amounts of illegally collected coral, giant clams and live sharks inside the first boat, the department said.",46,53,boarded,0,1,1
3AXFSPQOYQZ0SOWKO860UEH2P3PFJE,"On Tuesday, Filipino sailors from the warship boarded the Chinese vessels for an inspection, discovering large amounts of illegally collected coral, giant clams and live sharks inside the first boat, the department said.",66,73,vessels,2,2,4
3AXFSPQOYQZ0SOWKO860UEH2P3PFJE,"On Tuesday, Filipino sailors from the warship boarded the Chinese vessels for an inspection, discovering large amounts of illegally collected coral, giant clams and live sharks inside the first boat, the department said.",81,91,inspection,2,0,2
3AXFSPQOYQZ0SOWKO860UEH2P3PFJE,"On Tuesday, Filipino sailors from the warship boarded the Chinese vessels for an inspection, discovering large amounts of illegally collected coral, giant clams and live sharks inside the first boat, the department said.",105,147,large amounts of illegally collected coral,2,0,2
3AXFSPQOYQZ0SOWKO860UEH2P3PFJE,"On Tuesday, Filipino sailors from the warship boarded the Chinese vessels for an inspection, discovering large amounts of illegally collected coral, giant clams and live sharks inside the first boat, the department said.",122,131,illegally,0,3,3
3AXFSPQOYQZ0SOWKO860UEH2P3PFJE,"On Tuesday, Filipino sailors from the warship boarded the Chinese vessels for an inspection, discovering large amounts of illegally collected coral, giant clams and live sharks inside the first boat, the department said.",122,141,illegally collected,2,1,3
3AXFSPQOYQZ0SOWKO860UEH2P3PFJE,"On Tuesday, Filipino sailors from the warship boarded the Chinese vessels for an inspection, discovering large amounts of illegally collected coral, giant clams and live sharks inside the first boat, the department said.",142,147,coral,0,2,2
3AXFSPQOYQZ0SOWKO860UEH2P3PFJE,"On Tuesday, Filipino sailors from the warship boarded the Chinese vessels for an inspection, discovering large amounts of illegally collected coral, giant clams and live sharks inside the first boat, the department said.",155,160,clams,1,2,3
362E9TQF2HRABD89HARI0Y2ECQXIGA,"Separately, Spain said early this week it would take over Bankia SA, the largest real estate holder, to boost financial confidence.",0,10,Separately,1,1,2
362E9TQF2HRABD89HARI0Y2ECQXIGA,"Separately, Spain said early this week it would take over Bankia SA, the largest real estate holder, to boost financial confidence.",48,57,take over,0,1,1
362E9TQF2HRABD89HARI0Y2ECQXIGA,"Separately, Spain said early this week it would take over Bankia SA, the largest real estate holder, to boost financial confidence.",81,99,real estate holder,4,1,5
362E9TQF2HRABD89HARI0Y2ECQXIGA,"Separately, Spain said early this week it would take over Bankia SA, the largest real estate holder, to boost financial confidence.",86,92,estate,1,0,1
362E9TQF2HRABD89HARI0Y2ECQXIGA,"Separately, Spain said early this week it would take over Bankia SA, the largest real estate holder, to boost financial confidence.",93,99,holder,0,1,1
362E9TQF2HRABD89HARI0Y2ECQXIGA,"Separately, Spain said early this week it would take over Bankia SA, the largest real estate holder, to boost financial confidence.",104,109,boost,2,4,6
362E9TQF2HRABD89HARI0Y2ECQXIGA,"Separately, Spain said early this week it would take over Bankia SA, the largest real estate holder, to boost financial confidence.",104,130,boost financial confidence,1,1,2
362E9TQF2HRABD89HARI0Y2ECQXIGA,"Separately, Spain said early this week it would take over Bankia SA, the largest real estate holder, to boost financial confidence.",110,119,financial,0,1,1
362E9TQF2HRABD89HARI0Y2ECQXIGA,"Separately, Spain said early this week it would take over Bankia SA, the largest real estate holder, to boost financial confidence.",110,130,financial confidence,3,2,5
362E9TQF2HRABD89HARI0Y2ECQXIGA,"Separately, Spain said early this week it would take over Bankia SA, the largest real estate holder, to boost financial confidence.",120,130,confidence,0,3,3
362E9TQF2HRABD89HARI0Y2ECQXIGA,Spain's 10-year bond yield was up as much as 6.04 percent after the announcement.,16,20,bond,0,1,1
362E9TQF2HRABD89HARI0Y2ECQXIGA,Spain's 10-year bond yield was up as much as 6.04 percent after the announcement.,16,26,bond yield,5,2,7
362E9TQF2HRABD89HARI0Y2ECQXIGA,Spain's 10-year bond yield was up as much as 6.04 percent after the announcement.,21,26,yield,2,7,9
362E9TQF2HRABD89HARI0Y2ECQXIGA,Spain's 10-year bond yield was up as much as 6.04 percent after the announcement.,68,80,announcement,2,4,6
362E9TQF2HRABD89HARI0Y2ECQXIGA,"Banks have until the end of the year to move their holdings of repossessed property into asset management firms for a fire sale, Economy Minister Luis de Guindos told a news conference.",51,59,holdings,1,2,3
362E9TQF2HRABD89HARI0Y2ECQXIGA,"Banks have until the end of the year to move their holdings of repossessed property into asset management firms for a fire sale, Economy Minister Luis de Guindos told a news conference.",51,83,holdings of repossessed property,1,1,2
362E9TQF2HRABD89HARI0Y2ECQXIGA,"Banks have until the end of the year to move their holdings of repossessed property into asset management firms for a fire sale, Economy Minister Luis de Guindos told a news conference.",63,74,repossessed,6,10,16
362E9TQF2HRABD89HARI0Y2ECQXIGA,"Banks have until the end of the year to move their holdings of repossessed property into asset management firms for a fire sale, Economy Minister Luis de Guindos told a news conference.",63,83,repossessed property,4,2,6
362E9TQF2HRABD89HARI0Y2ECQXIGA,"Banks have until the end of the year to move their holdings of repossessed property into asset management firms for a fire sale, Economy Minister Luis de Guindos told a news conference.",89,94,asset,2,0,2
362E9TQF2HRABD89HARI0Y2ECQXIGA,"Banks have until the end of the year to move their holdings of repossessed property into asset management firms for a fire sale, Economy Minister Luis de Guindos told a news conference.",89,105,asset management,1,2,3
362E9TQF2HRABD89HARI0Y2ECQXIGA,"Banks have until the end of the year to move their holdings of repossessed property into asset management firms for a fire sale, Economy Minister Luis de Guindos told a news conference.",89,111,asset management firms,3,2,5
362E9TQF2HRABD89HARI0Y2ECQXIGA,"Banks have until the end of the year to move their holdings of repossessed property into asset management firms for a fire sale, Economy Minister Luis de Guindos told a news conference.",95,105,management,1,0,1
362E9TQF2HRABD89HARI0Y2ECQXIGA,"Banks have until the end of the year to move their holdings of repossessed property into asset management firms for a fire sale, Economy Minister Luis de Guindos told a news conference.",116,127,a fire sale,1,0,1
362E9TQF2HRABD89HARI0Y2ECQXIGA,"Banks have until the end of the year to move their holdings of repossessed property into asset management firms for a fire sale, Economy Minister Luis de Guindos told a news conference.",118,127,fire sale,2,4,6
362E9TQF2HRABD89HARI0Y2ECQXIGA,"Banks have until the end of the year to move their holdings of repossessed property into asset management firms for a fire sale, Economy Minister Luis de Guindos told a news conference.",174,184,conference,1,2,3
362E9TQF2HRABD89HARI0Y2ECQXIGA,"A Spanish government source, however, later said that banks able to cover by themselves losses on their toxic property assets will not be forced to remove them from their books while it will be compulsory for those receiving public help.",10,20,government,1,0,1
362E9TQF2HRABD89HARI0Y2ECQXIGA,"A Spanish government source, however, later said that banks able to cover by themselves losses on their toxic property assets will not be forced to remove them from their books while it will be compulsory for those receiving public help.",104,109,toxic,2,4,6
362E9TQF2HRABD89HARI0Y2ECQXIGA,"A Spanish government source, however, later said that banks able to cover by themselves losses on their toxic property assets will not be forced to remove them from their books while it will be compulsory for those receiving public help.",104,118,toxic property,1,2,3
362E9TQF2HRABD89HARI0Y2ECQXIGA,"A Spanish government source, however, later said that banks able to cover by themselves losses on their toxic property assets will not be forced to remove them from their books while it will be compulsory for those receiving public help.",104,125,toxic property assets,6,4,10
362E9TQF2HRABD89HARI0Y2ECQXIGA,"A Spanish government source, however, later said that banks able to cover by themselves losses on their toxic property assets will not be forced to remove them from their books while it will be compulsory for those receiving public help.",119,125,assets,1,2,3
362E9TQF2HRABD89HARI0Y2ECQXIGA,"A Spanish government source, however, later said that banks able to cover by themselves losses on their toxic property assets will not be forced to remove them from their books while it will be compulsory for those receiving public help.",194,204,compulsory,10,7,17
362E9TQF2HRABD89HARI0Y2ECQXIGA,"A Spanish government source, however, later said that banks able to cover by themselves losses on their toxic property assets will not be forced to remove them from their books while it will be compulsory for those receiving public help.",215,224,receiving,0,1,1
362E9TQF2HRABD89HARI0Y2ECQXIGA,"The state will put less than 15 billion euros into the latest of the four separate bank rescues that Spain has enacted over the past three years, de Guindos estimated.",40,45,euros,1,0,1
362E9TQF2HRABD89HARI0Y2ECQXIGA,"The state will put less than 15 billion euros into the latest of the four separate bank rescues that Spain has enacted over the past three years, de Guindos estimated.",74,82,separate,1,1,2
362E9TQF2HRABD89HARI0Y2ECQXIGA,"The state will put less than 15 billion euros into the latest of the four separate bank rescues that Spain has enacted over the past three years, de Guindos estimated.",83,95,bank rescues,0,1,1
362E9TQF2HRABD89HARI0Y2ECQXIGA,"The state will put less than 15 billion euros into the latest of the four separate bank rescues that Spain has enacted over the past three years, de Guindos estimated.",88,95,rescues,1,2,3
362E9TQF2HRABD89HARI0Y2ECQXIGA,"The state will put less than 15 billion euros into the latest of the four separate bank rescues that Spain has enacted over the past three years, de Guindos estimated.",111,118,enacted,5,7,12
362E9TQF2HRABD89HARI0Y2ECQXIGA,"The state will put less than 15 billion euros into the latest of the four separate bank rescues that Spain has enacted over the past three years, de Guindos estimated.",157,166,estimated,1,1,2
3J6BHNX0U9T7R0FJ4HPP3YQO5INKNY,"President Barack Obama spoke to U.S. troops on the one-year anniversary of Osama bin Laden's death, telling them that as the war winds down both America and Afghanistan are grateful for their sacrifice.",60,71,anniversary,3,3,6
3J6BHNX0U9T7R0FJ4HPP3YQO5INKNY,"President Barack Obama spoke to U.S. troops on the one-year anniversary of Osama bin Laden's death, telling them that as the war winds down both America and Afghanistan are grateful for their sacrifice.",125,134,war winds,0,1,1
3J6BHNX0U9T7R0FJ4HPP3YQO5INKNY,"President Barack Obama spoke to U.S. troops on the one-year anniversary of Osama bin Laden's death, telling them that as the war winds down both America and Afghanistan are grateful for their sacrifice.",125,139,war winds down,1,0,1
3J6BHNX0U9T7R0FJ4HPP3YQO5INKNY,"President Barack Obama spoke to U.S. troops on the one-year anniversary of Osama bin Laden's death, telling them that as the war winds down both America and Afghanistan are grateful for their sacrifice.",129,134,winds,1,0,1
3J6BHNX0U9T7R0FJ4HPP3YQO5INKNY,"President Barack Obama spoke to U.S. troops on the one-year anniversary of Osama bin Laden's death, telling them that as the war winds down both America and Afghanistan are grateful for their sacrifice.",129,139,winds down,4,5,9
3J6BHNX0U9T7R0FJ4HPP3YQO5INKNY,"President Barack Obama spoke to U.S. troops on the one-year anniversary of Osama bin Laden's death, telling them that as the war winds down both America and Afghanistan are grateful for their sacrifice.",173,181,grateful,4,3,7
3J6BHNX0U9T7R0FJ4HPP3YQO5INKNY,"President Barack Obama spoke to U.S. troops on the one-year anniversary of Osama bin Laden's death, telling them that as the war winds down both America and Afghanistan are grateful for their sacrifice.",192,201,sacrifice,7,7,14
3J6BHNX0U9T7R0FJ4HPP3YQO5INKNY,"As that debate raged, the president, acting as commander in chief, landed in Afghanistan on Tuesday afternoon for an unannounced visit to the war zone.",8,14,debate,1,3,4
3J6BHNX0U9T7R0FJ4HPP3YQO5INKNY,"As that debate raged, the president, acting as commander in chief, landed in Afghanistan on Tuesday afternoon for an unannounced visit to the war zone.",8,20,debate raged,1,0,1
3J6BHNX0U9T7R0FJ4HPP3YQO5INKNY,"As that debate raged, the president, acting as commander in chief, landed in Afghanistan on Tuesday afternoon for an unannounced visit to the war zone.",15,20,raged,9,8,17
3J6BHNX0U9T7R0FJ4HPP3YQO5INKNY,"As that debate raged, the president, acting as commander in chief, landed in Afghanistan on Tuesday afternoon for an unannounced visit to the war zone.",47,56,commander,1,0,1
3J6BHNX0U9T7R0FJ4HPP3YQO5INKNY,"As that debate raged, the president, acting as commander in chief, landed in Afghanistan on Tuesday afternoon for an unannounced visit to the war zone.",47,65,commander in chief,0,1,1
3J6BHNX0U9T7R0FJ4HPP3YQO5INKNY,"As that debate raged, the president, acting as commander in chief, landed in Afghanistan on Tuesday afternoon for an unannounced visit to the war zone.",67,73,landed,1,1,2
3J6BHNX0U9T7R0FJ4HPP3YQO5INKNY,"As that debate raged, the president, acting as commander in chief, landed in Afghanistan on Tuesday afternoon for an unannounced visit to the war zone.",117,128,unannounced,6,7,13
3J6BHNX0U9T7R0FJ4HPP3YQO5INKNY,"As that debate raged, the president, acting as commander in chief, landed in Afghanistan on Tuesday afternoon for an unannounced visit to the war zone.",117,134,unannounced visit,1,0,1
3J6BHNX0U9T7R0FJ4HPP3YQO5INKNY,"As that debate raged, the president, acting as commander in chief, landed in Afghanistan on Tuesday afternoon for an unannounced visit to the war zone.",142,150,war zone,1,1,2
3J6BHNX0U9T7R0FJ4HPP3YQO5INKNY,"There, he signed a new security agreement with President Hamid Karzai that outlines a partnership between the two countries that will continue after U.S. combat forces end their mission in 2014.",23,41,security agreement,1,1,2
3J6BHNX0U9T7R0FJ4HPP3YQO5INKNY,"There, he signed a new security agreement with President Hamid Karzai that outlines a partnership between the two countries that will continue after U.S. combat forces end their mission in 2014.",32,41,agreement,1,1,2
3J6BHNX0U9T7R0FJ4HPP3YQO5INKNY,"There, he signed a new security agreement with President Hamid Karzai that outlines a partnership between the two countries that will continue after U.S. combat forces end their mission in 2014.",75,83,outlines,4,7,11
3J6BHNX0U9T7R0FJ4HPP3YQO5INKNY,"There, he signed a new security agreement with President Hamid Karzai that outlines a partnership between the two countries that will continue after U.S. combat forces end their mission in 2014.",86,97,partnership,3,0,3
3J6BHNX0U9T7R0FJ4HPP3YQO5INKNY,"There, he signed a new security agreement with President Hamid Karzai that outlines a partnership between the two countries that will continue after U.S. combat forces end their mission in 2014.",154,160,combat,2,1,3
3J6BHNX0U9T7R0FJ4HPP3YQO5INKNY,"There, he signed a new security agreement with President Hamid Karzai that outlines a partnership between the two countries that will continue after U.S. combat forces end their mission in 2014.",154,167,combat forces,1,3,4
3J6BHNX0U9T7R0FJ4HPP3YQO5INKNY,"There, he signed a new security agreement with President Hamid Karzai that outlines a partnership between the two countries that will continue after U.S. combat forces end their mission in 2014.",178,185,mission,0,2,2
3J6BHNX0U9T7R0FJ4HPP3YQO5INKNY,"The president's trip muted, at least for a few hours, the partisan exchanges over whether his campaign had crossed a line with its bin Laden video.",16,26,trip muted,0,1,1
3J6BHNX0U9T7R0FJ4HPP3YQO5INKNY,"The president's trip muted, at least for a few hours, the partisan exchanges over whether his campaign had crossed a line with its bin Laden video.",21,26,muted,10,9,19
3J6BHNX0U9T7R0FJ4HPP3YQO5INKNY,"The president's trip muted, at least for a few hours, the partisan exchanges over whether his campaign had crossed a line with its bin Laden video.",58,66,partisan,7,7,14
3J6BHNX0U9T7R0FJ4HPP3YQO5INKNY,"The president's trip muted, at least for a few hours, the partisan exchanges over whether his campaign had crossed a line with its bin Laden video.",58,76,partisan exchanges,4,0,4
3J6BHNX0U9T7R0FJ4HPP3YQO5INKNY,"The president's trip muted, at least for a few hours, the partisan exchanges over whether his campaign had crossed a line with its bin Laden video.",67,76,exchanges,2,2,4
3J6BHNX0U9T7R0FJ4HPP3YQO5INKNY,"The president's trip muted, at least for a few hours, the partisan exchanges over whether his campaign had crossed a line with its bin Laden video.",94,102,campaign,5,6,11
3J6BHNX0U9T7R0FJ4HPP3YQO5INKNY,"The president's trip muted, at least for a few hours, the partisan exchanges over whether his campaign had crossed a line with its bin Laden video.",107,121,crossed a line,2,0,2
3QREJ3J433YH30CYS49AQ6MZ0NNKLW,The Green Village assault began around two hours after Obama left.,4,17,Green Village,1,0,1
3QREJ3J433YH30CYS49AQ6MZ0NNKLW,The Green Village assault began around two hours after Obama left.,18,25,assault,5,7,12
3QREJ3J433YH30CYS49AQ6MZ0NNKLW,"Police said suicide attackers wearing burqas struck at 6:15 am (0145 GMT), detonating a car bomb before clashing with guards.",12,19,suicide,3,1,4
3QREJ3J433YH30CYS49AQ6MZ0NNKLW,"Police said suicide attackers wearing burqas struck at 6:15 am (0145 GMT), detonating a car bomb before clashing with guards.",12,29,suicide attackers,2,2,4
3QREJ3J433YH30CYS49AQ6MZ0NNKLW,"Police said suicide attackers wearing burqas struck at 6:15 am (0145 GMT), detonating a car bomb before clashing with guards.",38,44,burqas,8,2,10
3QREJ3J433YH30CYS49AQ6MZ0NNKLW,"Police said suicide attackers wearing burqas struck at 6:15 am (0145 GMT), detonating a car bomb before clashing with guards.",45,51,struck,0,3,3
3QREJ3J433YH30CYS49AQ6MZ0NNKLW,"Police said suicide attackers wearing burqas struck at 6:15 am (0145 GMT), detonating a car bomb before clashing with guards.",75,85,detonating,10,7,17
3QREJ3J433YH30CYS49AQ6MZ0NNKLW,"Police said suicide attackers wearing burqas struck at 6:15 am (0145 GMT), detonating a car bomb before clashing with guards.",104,112,clashing,4,7,11
3QREJ3J433YH30CYS49AQ6MZ0NNKLW,"Police said suicide attackers wearing burqas struck at 6:15 am (0145 GMT), detonating a car bomb before clashing with guards.",104,124,clashing with guards,1,0,1
3QREJ3J433YH30CYS49AQ6MZ0NNKLW,"The interior ministry said seven people were killed, including at least six Afghans.",4,12,interior,2,2,4
3QREJ3J433YH30CYS49AQ6MZ0NNKLW,"The interior ministry said seven people were killed, including at least six Afghans.",4,21,interior ministry,5,1,6
3QREJ3J433YH30CYS49AQ6MZ0NNKLW,"The interior ministry said seven people were killed, including at least six Afghans.",13,21,ministry,4,0,4
3QREJ3J433YH30CYS49AQ6MZ0NNKLW,"The interior ministry said seven people were killed, including at least six Afghans.",53,62,including,0,1,1
3QREJ3J433YH30CYS49AQ6MZ0NNKLW,"There were three attackers, the ministry said, one in the suicide car bomb and two who got inside the complex.",32,40,ministry,2,0,2
3QREJ3J433YH30CYS49AQ6MZ0NNKLW,"There were three attackers, the ministry said, one in the suicide car bomb and two who got inside the complex.",58,65,suicide,2,0,2
3QREJ3J433YH30CYS49AQ6MZ0NNKLW,"There were three attackers, the ministry said, one in the suicide car bomb and two who got inside the complex.",58,74,suicide car bomb,1,0,1
3QREJ3J433YH30CYS49AQ6MZ0NNKLW,"There were three attackers, the ministry said, one in the suicide car bomb and two who got inside the complex.",102,109,complex,6,2,8
3QREJ3J433YH30CYS49AQ6MZ0NNKLW,One blew himself up while the other was shot dead by security forces.,4,8,blew,0,4,4
3QREJ3J433YH30CYS49AQ6MZ0NNKLW,One blew himself up while the other was shot dead by security forces.,4,16,blew himself,0,1,1
3QREJ3J433YH30CYS49AQ6MZ0NNKLW,One blew himself up while the other was shot dead by security forces.,53,68,security forces,1,0,1
3QREJ3J433YH30CYS49AQ6MZ0NNKLW,"Mangled bodies were seen lying in the road after the attack, which left two vehicles completely destroyed and blew out the windows of a nearby school.",0,7,Mangled,10,10,20
3QREJ3J433YH30CYS49AQ6MZ0NNKLW,"Mangled bodies were seen lying in the road after the attack, which left two vehicles completely destroyed and blew out the windows of a nearby school.",0,14,Mangled bodies,1,2,3
3QREJ3J433YH30CYS49AQ6MZ0NNKLW,"Mangled bodies were seen lying in the road after the attack, which left two vehicles completely destroyed and blew out the windows of a nearby school.",76,84,vehicles,1,0,1
3QREJ3J433YH30CYS49AQ6MZ0NNKLW,"Mangled bodies were seen lying in the road after the attack, which left two vehicles completely destroyed and blew out the windows of a nearby school.",96,105,destroyed,1,1,2
3QREJ3J433YH30CYS49AQ6MZ0NNKLW,"Mangled bodies were seen lying in the road after the attack, which left two vehicles completely destroyed and blew out the windows of a nearby school.",110,114,blew,0,2,2
3QREJ3J433YH30CYS49AQ6MZ0NNKLW,"Mangled bodies were seen lying in the road after the attack, which left two vehicles completely destroyed and blew out the windows of a nearby school.",110,118,blew out,0,2,2
3QREJ3J433YH30CYS49AQ6MZ0NNKLW,Health ministry spokesman Kargar Noorughli said 18 people were wounded and eight admitted to hospital.,0,15,Health ministry,1,0,1
3QREJ3J433YH30CYS49AQ6MZ0NNKLW,Health ministry spokesman Kargar Noorughli said 18 people were wounded and eight admitted to hospital.,7,15,ministry,1,0,1
3QREJ3J433YH30CYS49AQ6MZ0NNKLW,Health ministry spokesman Kargar Noorughli said 18 people were wounded and eight admitted to hospital.,16,25,spokesman,3,4,7
3QREJ3J433YH30CYS49AQ6MZ0NNKLW,Health ministry spokesman Kargar Noorughli said 18 people were wounded and eight admitted to hospital.,26,42,Kargar Noorughli,0,1,1
3QREJ3J433YH30CYS49AQ6MZ0NNKLW,Health ministry spokesman Kargar Noorughli said 18 people were wounded and eight admitted to hospital.,63,70,wounded,0,3,3
3QREJ3J433YH30CYS49AQ6MZ0NNKLW,Health ministry spokesman Kargar Noorughli said 18 people were wounded and eight admitted to hospital.,81,89,admitted,2,1,3
3QREJ3J433YH30CYS49AQ6MZ0NNKLW,Health ministry spokesman Kargar Noorughli said 18 people were wounded and eight admitted to hospital.,81,101,admitted to hospital,1,0,1
3QREJ3J433YH30CYS49AQ6MZ0NNKLW,Taliban spokesman Zabiullah Mujahid told AFP the attack was a message to Obama to say the militants would continue to fight until all foreign forces had left.,8,17,spokesman,4,0,4
3QREJ3J433YH30CYS49AQ6MZ0NNKLW,Taliban spokesman Zabiullah Mujahid told AFP the attack was a message to Obama to say the militants would continue to fight until all foreign forces had left.,41,44,AFP,1,0,1
3QREJ3J433YH30CYS49AQ6MZ0NNKLW,Taliban spokesman Zabiullah Mujahid told AFP the attack was a message to Obama to say the militants would continue to fight until all foreign forces had left.,90,99,militants,5,2,7
3QREJ3J433YH30CYS49AQ6MZ0NNKLW,Taliban spokesman Zabiullah Mujahid told AFP the attack was a message to Obama to say the militants would continue to fight until all foreign forces had left.,106,114,continue,1,0,1
3QREJ3J433YH30CYS49AQ6MZ0NNKLW,Taliban spokesman Zabiullah Mujahid told AFP the attack was a message to Obama to say the militants would continue to fight until all foreign forces had left.,134,141,foreign,1,0,1
3QREJ3J433YH30CYS49AQ6MZ0NNKLW,Taliban spokesman Zabiullah Mujahid told AFP the attack was a message to Obama to say the militants would continue to fight until all foreign forces had left.,134,148,foreign forces,2,0,2
3IH9TRB0FB0D7YI6ZR6FTBY8ADTI1D,"Nearly 3,000 U.S. and NATO soldiers have been killed in Afghanistan since the Taliban rulers were ousted in 2001.",0,6,Nearly,1,0,1
3IH9TRB0FB0D7YI6ZR6FTBY8ADTI1D,"Nearly 3,000 U.S. and NATO soldiers have been killed in Afghanistan since the Taliban rulers were ousted in 2001.",22,35,NATO soldiers,1,1,2
3IH9TRB0FB0D7YI6ZR6FTBY8ADTI1D,"Nearly 3,000 U.S. and NATO soldiers have been killed in Afghanistan since the Taliban rulers were ousted in 2001.",78,85,Taliban,1,0,1
3IH9TRB0FB0D7YI6ZR6FTBY8ADTI1D,"Nearly 3,000 U.S. and NATO soldiers have been killed in Afghanistan since the Taliban rulers were ousted in 2001.",86,92,rulers,0,2,2
3IH9TRB0FB0D7YI6ZR6FTBY8ADTI1D,"Nearly 3,000 U.S. and NATO soldiers have been killed in Afghanistan since the Taliban rulers were ousted in 2001.",98,104,ousted,7,10,17
3IH9TRB0FB0D7YI6ZR6FTBY8ADTI1D,"The Taliban, overthrown by U.S.-backed Afghan forces for harboring bin Laden and other militants, were quick to take credit for Wednesday's attack at Green Village, one of several compounds for Westerners on a main road out of the capital.",13,23,overthrown,5,10,15
3IH9TRB0FB0D7YI6ZR6FTBY8ADTI1D,"The Taliban, overthrown by U.S.-backed Afghan forces for harboring bin Laden and other militants, were quick to take credit for Wednesday's attack at Green Village, one of several compounds for Westerners on a main road out of the capital.",27,38,U.S.-backed,1,0,1
3IH9TRB0FB0D7YI6ZR6FTBY8ADTI1D,"The Taliban, overthrown by U.S.-backed Afghan forces for harboring bin Laden and other militants, were quick to take credit for Wednesday's attack at Green Village, one of several compounds for Westerners on a main road out of the capital.",57,66,harboring,10,10,20
3IH9TRB0FB0D7YI6ZR6FTBY8ADTI1D,"The Taliban, overthrown by U.S.-backed Afghan forces for harboring bin Laden and other militants, were quick to take credit for Wednesday's attack at Green Village, one of several compounds for Westerners on a main road out of the capital.",87,96,militants,4,2,6
3IH9TRB0FB0D7YI6ZR6FTBY8ADTI1D,"The Taliban, overthrown by U.S.-backed Afghan forces for harboring bin Laden and other militants, were quick to take credit for Wednesday's attack at Green Village, one of several compounds for Westerners on a main road out of the capital.",117,123,credit,1,0,1
3IH9TRB0FB0D7YI6ZR6FTBY8ADTI1D,"The Taliban, overthrown by U.S.-backed Afghan forces for harboring bin Laden and other militants, were quick to take credit for Wednesday's attack at Green Village, one of several compounds for Westerners on a main road out of the capital.",150,163,Green Village,0,1,1
3IH9TRB0FB0D7YI6ZR6FTBY8ADTI1D,"The Taliban, overthrown by U.S.-backed Afghan forces for harboring bin Laden and other militants, were quick to take credit for Wednesday's attack at Green Village, one of several compounds for Westerners on a main road out of the capital.",180,189,compounds,4,5,9
3IH9TRB0FB0D7YI6ZR6FTBY8ADTI1D,"The Taliban, overthrown by U.S.-backed Afghan forces for harboring bin Laden and other militants, were quick to take credit for Wednesday's attack at Green Village, one of several compounds for Westerners on a main road out of the capital.",194,204,Westerners,1,0,1
3IH9TRB0FB0D7YI6ZR6FTBY8ADTI1D,"This attack was to make clear our reaction to Obama's trip to Afghanistan.	35	43	reaction	0	1	1
3IH9TRB0FB0D7YI6ZR6FTBY8ADTI1D	The message was that instead of signing a strategic partnership deal with Afghanistan, he should think about taking his troops out from Afghanistan and leave it to Afghans to rebuild their country, Taliban spokesman Zabihullah Mujahid told Reuters by telephone from an undisclosed location.",4,11,message,0,1,1
3IH9TRB0FB0D7YI6ZR6FTBY8ADTI1D,"The message was that instead of signing a strategic partnership deal with Afghanistan, he should think about taking his troops out from Afghanistan and leave it to Afghans to rebuild their country,"" Taliban spokesman Zabihullah Mujahid told Reuters by telephone from an undisclosed location.",21,28,instead,0,1,1
3IH9TRB0FB0D7YI6ZR6FTBY8ADTI1D,"The message was that instead of signing a strategic partnership deal with Afghanistan, he should think about taking his troops out from Afghanistan and leave it to Afghans to rebuild their country,"" Taliban spokesman Zabihullah Mujahid told Reuters by telephone from an undisclosed location.",42,51,strategic,4,5,9
3IH9TRB0FB0D7YI6ZR6FTBY8ADTI1D,"The message was that instead of signing a strategic partnership deal with Afghanistan, he should think about taking his troops out from Afghanistan and leave it to Afghans to rebuild their country,"" Taliban spokesman Zabihullah Mujahid told Reuters by telephone from an undisclosed location.",42,63,strategic partnership,1,6,7
3IH9TRB0FB0D7YI6ZR6FTBY8ADTI1D,"The message was that instead of signing a strategic partnership deal with Afghanistan, he should think about taking his troops out from Afghanistan and leave it to Afghans to rebuild their country,"" Taliban spokesman Zabihullah Mujahid told Reuters by telephone from an undisclosed location.",42,68,strategic partnership deal,4,0,4
3IH9TRB0FB0D7YI6ZR6FTBY8ADTI1D,"The message was that instead of signing a strategic partnership deal with Afghanistan, he should think about taking his troops out from Afghanistan and leave it to Afghans to rebuild their country,"" Taliban spokesman Zabihullah Mujahid told Reuters by telephone from an undisclosed location.",52,63,partnership,1,0,1
3IH9TRB0FB0D7YI6ZR6FTBY8ADTI1D,"The message was that instead of signing a strategic partnership deal with Afghanistan, he should think about taking his troops out from Afghanistan and leave it to Afghans to rebuild their country,"" Taliban spokesman Zabihullah Mujahid told Reuters by telephone from an undisclosed location.",175,182,rebuild,0,2,2
3IH9TRB0FB0D7YI6ZR6FTBY8ADTI1D,"The message was that instead of signing a strategic partnership deal with Afghanistan, he should think about taking his troops out from Afghanistan and leave it to Afghans to rebuild their country,"" Taliban spokesman Zabihullah Mujahid told Reuters by telephone from an undisclosed location.",207,216,spokesman,2,1,3
3IH9TRB0FB0D7YI6ZR6FTBY8ADTI1D,"The message was that instead of signing a strategic partnership deal with Afghanistan, he should think about taking his troops out from Afghanistan and leave it to Afghans to rebuild their country,"" Taliban spokesman Zabihullah Mujahid told Reuters by telephone from an undisclosed location.",241,248,Reuters,0,2,2
3IH9TRB0FB0D7YI6ZR6FTBY8ADTI1D,"The message was that instead of signing a strategic partnership deal with Afghanistan, he should think about taking his troops out from Afghanistan and leave it to Afghans to rebuild their country,"" Taliban spokesman Zabihullah Mujahid told Reuters by telephone from an undisclosed location.",270,281,undisclosed,6,6,12
3IH9TRB0FB0D7YI6ZR6FTBY8ADTI1D,"The message was that instead of signing a strategic partnership deal with Afghanistan, he should think about taking his troops out from Afghanistan and leave it to Afghans to rebuild their country,"" Taliban spokesman Zabihullah Mujahid told Reuters by telephone from an undisclosed location.",270,290,undisclosed location,2,4,6
3IH9TRB0FB0D7YI6ZR6FTBY8ADTI1D,"But America's Kabul ambassador, Ryan Crocker, said involvement of the Haqqani network - which Washington believes is based in Pakistan's North Waziristan region and which it blames for high-profile attacks in Kabul in April - could not be ruled out.",20,30,ambassador,2,0,2
3IH9TRB0FB0D7YI6ZR6FTBY8ADTI1D,"But America's Kabul ambassador, Ryan Crocker, said involvement of the Haqqani network - which Washington believes is based in Pakistan's North Waziristan region and which it blames for high-profile attacks in Kabul in April - could not be ruled out.",51,62,involvement,3,5,8
3IH9TRB0FB0D7YI6ZR6FTBY8ADTI1D,"But America's Kabul ambassador, Ryan Crocker, said involvement of the Haqqani network - which Washington believes is based in Pakistan's North Waziristan region and which it blames for high-profile attacks in Kabul in April - could not be ruled out.",78,85,network,1,1,2
3IH9TRB0FB0D7YI6ZR6FTBY8ADTI1D,"But America's Kabul ambassador, Ryan Crocker, said involvement of the Haqqani network - which Washington believes is based in Pakistan's North Waziristan region and which it blames for high-profile attacks in Kabul in April - could not be ruled out.",143,153,Waziristan,0,1,1
3IH9TRB0FB0D7YI6ZR6FTBY8ADTI1D,"But America's Kabul ambassador, Ryan Crocker, said involvement of the Haqqani network - which Washington believes is based in Pakistan's North Waziristan region and which it blames for high-profile attacks in Kabul in April - could not be ruled out.",174,180,blames,1,2,3
3IH9TRB0FB0D7YI6ZR6FTBY8ADTI1D,"But America's Kabul ambassador, Ryan Crocker, said involvement of the Haqqani network - which Washington believes is based in Pakistan's North Waziristan region and which it blames for high-profile attacks in Kabul in April - could not be ruled out.",185,197,high-profile,3,4,7
3IH9TRB0FB0D7YI6ZR6FTBY8ADTI1D,"But America's Kabul ambassador, Ryan Crocker, said involvement of the Haqqani network - which Washington believes is based in Pakistan's North Waziristan region and which it blames for high-profile attacks in Kabul in April - could not be ruled out.",185,205,high-profile attacks,3,4,7
3IH9TRB0FB0D7YI6ZR6FTBY8ADTI1D,"But America's Kabul ambassador, Ryan Crocker, said involvement of the Haqqani network - which Washington believes is based in Pakistan's North Waziristan region and which it blames for high-profile attacks in Kabul in April - could not be ruled out.",239,244,ruled,0,2,2
3IH9TRB0FB0D7YI6ZR6FTBY8ADTI1D,"But America's Kabul ambassador, Ryan Crocker, said involvement of the Haqqani network - which Washington believes is based in Pakistan's North Waziristan region and which it blames for high-profile attacks in Kabul in April - could not be ruled out.",239,248,ruled out,0,1,1
3U18MJKL1UNP823VC48RFFDG0XZNCL,The LCC also posted dire reports of the military aiming mortars and heavy artillery at the Homs village of Al-Burnhanieh.,4,7,LCC,1,0,1
3U18MJKL1UNP823VC48RFFDG0XZNCL,The LCC also posted dire reports of the military aiming mortars and heavy artillery at the Homs village of Al-Burnhanieh.,20,24,dire,9,4,13
3U18MJKL1UNP823VC48RFFDG0XZNCL,The LCC also posted dire reports of the military aiming mortars and heavy artillery at the Homs village of Al-Burnhanieh.,20,32,dire reports,2,4,6
3U18MJKL1UNP823VC48RFFDG0XZNCL,The LCC also posted dire reports of the military aiming mortars and heavy artillery at the Homs village of Al-Burnhanieh.,40,48,military,1,0,1
3U18MJKL1UNP823VC48RFFDG0XZNCL,The LCC also posted dire reports of the military aiming mortars and heavy artillery at the Homs village of Al-Burnhanieh.,40,63,military aiming mortars,0,2,2
3U18MJKL1UNP823VC48RFFDG0XZNCL,The LCC also posted dire reports of the military aiming mortars and heavy artillery at the Homs village of Al-Burnhanieh.,49,55,aiming,0,2,2
3U18MJKL1UNP823VC48RFFDG0XZNCL,The LCC also posted dire reports of the military aiming mortars and heavy artillery at the Homs village of Al-Burnhanieh.,49,63,aiming mortars,2,0,2
3U18MJKL1UNP823VC48RFFDG0XZNCL,The LCC also posted dire reports of the military aiming mortars and heavy artillery at the Homs village of Al-Burnhanieh.,56,63,mortars,10,4,14
3U18MJKL1UNP823VC48RFFDG0XZNCL,The LCC also posted dire reports of the military aiming mortars and heavy artillery at the Homs village of Al-Burnhanieh.,68,83,heavy artillery,2,2,4
3U18MJKL1UNP823VC48RFFDG0XZNCL,The LCC also posted dire reports of the military aiming mortars and heavy artillery at the Homs village of Al-Burnhanieh.,74,83,artillery,10,2,12
3U18MJKL1UNP823VC48RFFDG0XZNCL,Violence from the Syian conflict isn't confined to the country's borders.,0,8,Violence,0,2,2
3U18MJKL1UNP823VC48RFFDG0XZNCL,Violence from the Syian conflict isn't confined to the country's borders.,24,32,conflict,1,2,3
3U18MJKL1UNP823VC48RFFDG0XZNCL,Violence from the Syian conflict isn't confined to the country's borders.,39,47,confined,5,6,11
3U18MJKL1UNP823VC48RFFDG0XZNCL,"In neighboring Lebanon, at least one person was killed and 45 others wounded in ongoing violence, Lebanon's National News Agency reported Monday.",3,14,neighboring,2,0,2
3U18MJKL1UNP823VC48RFFDG0XZNCL,"In neighboring Lebanon, at least one person was killed and 45 others wounded in ongoing violence, Lebanon's National News Agency reported Monday.",69,76,wounded,0,2,2
3U18MJKL1UNP823VC48RFFDG0XZNCL,"In neighboring Lebanon, at least one person was killed and 45 others wounded in ongoing violence, Lebanon's National News Agency reported Monday.",80,87,ongoing,0,1,1
3U18MJKL1UNP823VC48RFFDG0XZNCL,"In neighboring Lebanon, at least one person was killed and 45 others wounded in ongoing violence, Lebanon's National News Agency reported Monday.",80,96,ongoing violence,2,1,3
3U18MJKL1UNP823VC48RFFDG0XZNCL,"In neighboring Lebanon, at least one person was killed and 45 others wounded in ongoing violence, Lebanon's National News Agency reported Monday.",88,96,violence,0,1,1
3U18MJKL1UNP823VC48RFFDG0XZNCL,"The fighting in Lebanon pits residents of Bab al-Tebbaneh, a Sunni stronghold hostile to the Syrian regime, against Alawite residents of Jabal Mohsen, who support Syrian President Bashar al-Assad.",24,28,pits,5,4,9
3U18MJKL1UNP823VC48RFFDG0XZNCL,"The fighting in Lebanon pits residents of Bab al-Tebbaneh, a Sunni stronghold hostile to the Syrian regime, against Alawite residents of Jabal Mohsen, who support Syrian President Bashar al-Assad.",24,38,pits residents,0,1,1
3U18MJKL1UNP823VC48RFFDG0XZNCL,"The fighting in Lebanon pits residents of Bab al-Tebbaneh, a Sunni stronghold hostile to the Syrian regime, against Alawite residents of Jabal Mohsen, who support Syrian President Bashar al-Assad.",61,66,Sunni,0,1,1
3U18MJKL1UNP823VC48RFFDG0XZNCL,"The fighting in Lebanon pits residents of Bab al-Tebbaneh, a Sunni stronghold hostile to the Syrian regime, against Alawite residents of Jabal Mohsen, who support Syrian President Bashar al-Assad.",67,77,stronghold,4,7,11
3U18MJKL1UNP823VC48RFFDG0XZNCL,"The fighting in Lebanon pits residents of Bab al-Tebbaneh, a Sunni stronghold hostile to the Syrian regime, against Alawite residents of Jabal Mohsen, who support Syrian President Bashar al-Assad.",67,85,stronghold hostile,2,2,4
3U18MJKL1UNP823VC48RFFDG0XZNCL,"The fighting in Lebanon pits residents of Bab al-Tebbaneh, a Sunni stronghold hostile to the Syrian regime, against Alawite residents of Jabal Mohsen, who support Syrian President Bashar al-Assad.",78,85,hostile,5,5,10
3U18MJKL1UNP823VC48RFFDG0XZNCL,"The fighting in Lebanon pits residents of Bab al-Tebbaneh, a Sunni stronghold hostile to the Syrian regime, against Alawite residents of Jabal Mohsen, who support Syrian President Bashar al-Assad.",93,106,Syrian regime,1,0,1
3U18MJKL1UNP823VC48RFFDG0XZNCL,"The fighting in Lebanon pits residents of Bab al-Tebbaneh, a Sunni stronghold hostile to the Syrian regime, against Alawite residents of Jabal Mohsen, who support Syrian President Bashar al-Assad.",100,106,regime,2,2,4
3U18MJKL1UNP823VC48RFFDG0XZNCL,"The fighting in Lebanon pits residents of Bab al-Tebbaneh, a Sunni stronghold hostile to the Syrian regime, against Alawite residents of Jabal Mohsen, who support Syrian President Bashar al-Assad.",116,123,Alawite,0,1,1
3U18MJKL1UNP823VC48RFFDG0XZNCL,"Clashes that began Sunday in Lebanon ignited over the arrest of Islamist activist Chadi Mawlawi, who the Lebanese government accuses of being an operative in Al-Qaeda-inspired group.",0,7,Clashes,1,1,2
3U18MJKL1UNP823VC48RFFDG0XZNCL,"Clashes that began Sunday in Lebanon ignited over the arrest of Islamist activist Chadi Mawlawi, who the Lebanese government accuses of being an operative in Al-Qaeda-inspired group.",37,44,ignited,10,10,20
3U18MJKL1UNP823VC48RFFDG0XZNCL,"Clashes that began Sunday in Lebanon ignited over the arrest of Islamist activist Chadi Mawlawi, who the Lebanese government accuses of being an operative in Al-Qaeda-inspired group.",64,81,Islamist activist,2,1,3
3U18MJKL1UNP823VC48RFFDG0XZNCL,"Clashes that began Sunday in Lebanon ignited over the arrest of Islamist activist Chadi Mawlawi, who the Lebanese government accuses of being an operative in Al-Qaeda-inspired group.",114,124,government,1,0,1
3U18MJKL1UNP823VC48RFFDG0XZNCL,"Clashes that began Sunday in Lebanon ignited over the arrest of Islamist activist Chadi Mawlawi, who the Lebanese government accuses of being an operative in Al-Qaeda-inspired group.",125,132,accuses,2,4,6
3U18MJKL1UNP823VC48RFFDG0XZNCL,"Clashes that began Sunday in Lebanon ignited over the arrest of Islamist activist Chadi Mawlawi, who the Lebanese government accuses of being an operative in Al-Qaeda-inspired group.",145,154,operative,9,1,10
3U18MJKL1UNP823VC48RFFDG0XZNCL,"Clashes that began Sunday in Lebanon ignited over the arrest of Islamist activist Chadi Mawlawi, who the Lebanese government accuses of being an operative in Al-Qaeda-inspired group.",158,175,Al-Qaeda-inspired,0,1,1
3U18MJKL1UNP823VC48RFFDG0XZNCL,But his relatives deny the accusation.,18,22,deny,1,1,2
3U18MJKL1UNP823VC48RFFDG0XZNCL,But his relatives deny the accusation.,18,37,deny the accusation,1,0,1
3U18MJKL1UNP823VC48RFFDG0XZNCL,But his relatives deny the accusation.,27,37,accusation,9,6,15
3U18MJKL1UNP823VC48RFFDG0XZNCL,"Ali Hajar, one of Mawlawi's cousins, said Mawlawi supports the Syrian rebels and is trying to help Syrian refugees by providing them with shelter and food.",70,76,rebels,2,1,3
3U18MJKL1UNP823VC48RFFDG0XZNCL,"Ali Hajar, one of Mawlawi's cousins, said Mawlawi supports the Syrian rebels and is trying to help Syrian refugees by providing them with shelter and food.",99,114,Syrian refugees,1,0,1
3U18MJKL1UNP823VC48RFFDG0XZNCL,"Ali Hajar, one of Mawlawi's cousins, said Mawlawi supports the Syrian rebels and is trying to help Syrian refugees by providing them with shelter and food.",106,114,refugees,2,4,6
3U18MJKL1UNP823VC48RFFDG0XZNCL,"Ali Hajar, one of Mawlawi's cousins, said Mawlawi supports the Syrian rebels and is trying to help Syrian refugees by providing them with shelter and food.",138,145,shelter,1,0,1
3MNJFORX8B5SLPHZZ626T4YX616F51,"In Pictures: Winning hearts and minds in Afghanistan Taliban militants detonated a car bomb outside a private, heavily fortified compound home to mostly foreigners at about 6:15 a.m. on Wednesday morning.",13,27,Winning hearts,1,0,1
3MNJFORX8B5SLPHZZ626T4YX616F51,"In Pictures: Winning hearts and minds in Afghanistan Taliban militants detonated a car bomb outside a private, heavily fortified compound home to mostly foreigners at about 6:15 a.m. on Wednesday morning.",61,70,militants,6,2,8
3MNJFORX8B5SLPHZZ626T4YX616F51,"In Pictures: Winning hearts and minds in Afghanistan Taliban militants detonated a car bomb outside a private, heavily fortified compound home to mostly foreigners at about 6:15 a.m. on Wednesday morning.",61,80,militants detonated,1,1,2
3MNJFORX8B5SLPHZZ626T4YX616F51,"In Pictures: Winning hearts and minds in Afghanistan Taliban militants detonated a car bomb outside a private, heavily fortified compound home to mostly foreigners at about 6:15 a.m. on Wednesday morning.",71,80,detonated,6,10,16
3MNJFORX8B5SLPHZZ626T4YX616F51,"In Pictures: Winning hearts and minds in Afghanistan Taliban militants detonated a car bomb outside a private, heavily fortified compound home to mostly foreigners at about 6:15 a.m. on Wednesday morning.",111,137,heavily fortified compound,1,0,1
3MNJFORX8B5SLPHZZ626T4YX616F51,"In Pictures: Winning hearts and minds in Afghanistan Taliban militants detonated a car bomb outside a private, heavily fortified compound home to mostly foreigners at about 6:15 a.m. on Wednesday morning.",119,128,fortified,10,10,20
3MNJFORX8B5SLPHZZ626T4YX616F51,"In Pictures: Winning hearts and minds in Afghanistan Taliban militants detonated a car bomb outside a private, heavily fortified compound home to mostly foreigners at about 6:15 a.m. on Wednesday morning.",129,137,compound,0,3,3
3MNJFORX8B5SLPHZZ626T4YX616F51,"In Pictures: Winning hearts and minds in Afghanistan Taliban militants detonated a car bomb outside a private, heavily fortified compound home to mostly foreigners at about 6:15 a.m. on Wednesday morning.",129,142,compound home,2,0,2
3MNJFORX8B5SLPHZZ626T4YX616F51,"In Pictures: Winning hearts and minds in Afghanistan Taliban militants detonated a car bomb outside a private, heavily fortified compound home to mostly foreigners at about 6:15 a.m. on Wednesday morning.",153,163,foreigners,0,1,1
3MNJFORX8B5SLPHZZ626T4YX616F51,Afghan security forces and Taliban militants then exchanged gunfire.,7,22,security forces,1,0,1
3MNJFORX8B5SLPHZZ626T4YX616F51,Afghan security forces and Taliban militants then exchanged gunfire.,27,34,Taliban,1,0,1
3MNJFORX8B5SLPHZZ626T4YX616F51,Afghan security forces and Taliban militants then exchanged gunfire.,35,44,militants,5,2,7
3MNJFORX8B5SLPHZZ626T4YX616F51,Afghan security forces and Taliban militants then exchanged gunfire.,50,59,exchanged,1,4,5
3MNJFORX8B5SLPHZZ626T4YX616F51,Afghan security forces and Taliban militants then exchanged gunfire.,50,67,exchanged gunfire,0,1,1
3MNJFORX8B5SLPHZZ626T4YX616F51,Afghan security forces and Taliban militants then exchanged gunfire.,60,67,gunfire,0,1,1
3MNJFORX8B5SLPHZZ626T4YX616F51,"Afghan police officials say the situation was under control by 9:00 a.m., but the incident left at least 7 people dead and some 17 people injured.",32,41,situation,1,1,2
3MNJFORX8B5SLPHZZ626T4YX616F51,"Afghan police officials say the situation was under control by 9:00 a.m., but the incident left at least 7 people dead and some 17 people injured.",82,90,incident,2,4,6
3MNJFORX8B5SLPHZZ626T4YX616F51,"The explosion came shortly after Mr. Obama gave a speech invoking ""a new dawn"" with the signing of a US-Afghanistan strategic partnership agreement.",4,13,explosion,2,4,6
3MNJFORX8B5SLPHZZ626T4YX616F51,"The explosion came shortly after Mr. Obama gave a speech invoking ""a new dawn"" with the signing of a US-Afghanistan strategic partnership agreement.",19,26,shortly,0,1,1
3MNJFORX8B5SLPHZZ626T4YX616F51,"The explosion came shortly after Mr. Obama gave a speech invoking ""a new dawn"" with the signing of a US-Afghanistan strategic partnership agreement.",57,65,invoking,5,6,11
3MNJFORX8B5SLPHZZ626T4YX616F51,"The explosion came shortly after Mr. Obama gave a speech invoking ""a new dawn"" with the signing of a US-Afghanistan strategic partnership agreement.",67,77,a new dawn,0,1,1
3MNJFORX8B5SLPHZZ626T4YX616F51,"The explosion came shortly after Mr. Obama gave a speech invoking ""a new dawn"" with the signing of a US-Afghanistan strategic partnership agreement.",69,77,new dawn,0,2,2
3MNJFORX8B5SLPHZZ626T4YX616F51,"The explosion came shortly after Mr. Obama gave a speech invoking ""a new dawn"" with the signing of a US-Afghanistan strategic partnership agreement.",73,77,dawn,1,1,2
3MNJFORX8B5SLPHZZ626T4YX616F51,"The explosion came shortly after Mr. Obama gave a speech invoking ""a new dawn"" with the signing of a US-Afghanistan strategic partnership agreement.",116,125,strategic,4,4,8
3MNJFORX8B5SLPHZZ626T4YX616F51,"The explosion came shortly after Mr. Obama gave a speech invoking ""a new dawn"" with the signing of a US-Afghanistan strategic partnership agreement.",116,137,strategic partnership,0,2,2
3MNJFORX8B5SLPHZZ626T4YX616F51,"The explosion came shortly after Mr. Obama gave a speech invoking ""a new dawn"" with the signing of a US-Afghanistan strategic partnership agreement.",116,147,strategic partnership agreement,3,0,3
3MNJFORX8B5SLPHZZ626T4YX616F51,"The explosion came shortly after Mr. Obama gave a speech invoking ""a new dawn"" with the signing of a US-Afghanistan strategic partnership agreement.",126,147,partnership agreement,0,1,1
3MNJFORX8B5SLPHZZ626T4YX616F51,"The explosion came shortly after Mr. Obama gave a speech invoking ""a new dawn"" with the signing of a US-Afghanistan strategic partnership agreement.",138,147,agreement,0,1,1
3MNJFORX8B5SLPHZZ626T4YX616F51,"The incident not only underscores the difficulties that remain as Afghan security forces take control of increasingly larger share of the country, but also the potential fallout from the Afghan insurgency during high-profile visits.",22,33,underscores,10,10,20
3MNJFORX8B5SLPHZZ626T4YX616F51,"The incident not only underscores the difficulties that remain as Afghan security forces take control of increasingly larger share of the country, but also the potential fallout from the Afghan insurgency during high-profile visits.",38,50,difficulties,1,1,2
3MNJFORX8B5SLPHZZ626T4YX616F51,"The incident not only underscores the difficulties that remain as Afghan security forces take control of increasingly larger share of the country, but also the potential fallout from the Afghan insurgency during high-profile visits.",73,88,security forces,1,0,1
3MNJFORX8B5SLPHZZ626T4YX616F51,"The incident not only underscores the difficulties that remain as Afghan security forces take control of increasingly larger share of the country, but also the potential fallout from the Afghan insurgency during high-profile visits.",105,117,increasingly,3,1,4
3MNJFORX8B5SLPHZZ626T4YX616F51,"The incident not only underscores the difficulties that remain as Afghan security forces take control of increasingly larger share of the country, but also the potential fallout from the Afghan insurgency during high-profile visits.",160,169,potential,3,5,8
3MNJFORX8B5SLPHZZ626T4YX616F51,"The incident not only underscores the difficulties that remain as Afghan security forces take control of increasingly larger share of the country, but also the potential fallout from the Afghan insurgency during high-profile visits.",160,177,potential fallout,3,4,7
3MNJFORX8B5SLPHZZ626T4YX616F51,"The incident not only underscores the difficulties that remain as Afghan security forces take control of increasingly larger share of the country, but also the potential fallout from the Afghan insurgency during high-profile visits.",170,177,fallout,3,3,6
3MNJFORX8B5SLPHZZ626T4YX616F51,"The incident not only underscores the difficulties that remain as Afghan security forces take control of increasingly larger share of the country, but also the potential fallout from the Afghan insurgency during high-profile visits.",194,204,insurgency,10,9,19
3MNJFORX8B5SLPHZZ626T4YX616F51,"The incident not only underscores the difficulties that remain as Afghan security forces take control of increasingly larger share of the country, but also the potential fallout from the Afghan insurgency during high-profile visits.",212,224,high-profile,1,1,2
3MNJFORX8B5SLPHZZ626T4YX616F51,"The incident not only underscores the difficulties that remain as Afghan security forces take control of increasingly larger share of the country, but also the potential fallout from the Afghan insurgency during high-profile visits.",212,231,high-profile visits,1,1,2
3SSN80MU8CPC3UTN6NCY10HM8XLKX9,"The observatory, a Grade II listed building, is not in use at present.",4,15,observatory,9,10,19
3SSN80MU8CPC3UTN6NCY10HM8XLKX9,"The observatory, a Grade II listed building, is not in use at present.",28,43,listed building,0,1,1
3SSN80MU8CPC3UTN6NCY10HM8XLKX9,"A spokeswoman for Merseyside Police said: ""Crime scene investigators are in attendance at the scene and officers are appealing to anyone who may have seen anyone acting suspiciously on Bidston Hill over the last few days to come forward.",2,13,spokeswoman,5,5,10
3SSN80MU8CPC3UTN6NCY10HM8XLKX9,"A spokeswoman for Merseyside Police said: ""Crime scene investigators are in attendance at the scene and officers are appealing to anyone who may have seen anyone acting suspiciously on Bidston Hill over the last few days to come forward.",43,54,Crime scene,0,1,1
3SSN80MU8CPC3UTN6NCY10HM8XLKX9,"A spokeswoman for Merseyside Police said: ""Crime scene investigators are in attendance at the scene and officers are appealing to anyone who may have seen anyone acting suspiciously on Bidston Hill over the last few days to come forward.",43,68,Crime scene investigators,2,2,4
3SSN80MU8CPC3UTN6NCY10HM8XLKX9,"A spokeswoman for Merseyside Police said: ""Crime scene investigators are in attendance at the scene and officers are appealing to anyone who may have seen anyone acting suspiciously on Bidston Hill over the last few days to come forward.",55,68,investigators,2,2,4
3SSN80MU8CPC3UTN6NCY10HM8XLKX9,"A spokeswoman for Merseyside Police said: ""Crime scene investigators are in attendance at the scene and officers are appealing to anyone who may have seen anyone acting suspiciously on Bidston Hill over the last few days to come forward.",73,86,in attendance,1,0,1
3SSN80MU8CPC3UTN6NCY10HM8XLKX9,"A spokeswoman for Merseyside Police said: ""Crime scene investigators are in attendance at the scene and officers are appealing to anyone who may have seen anyone acting suspiciously on Bidston Hill over the last few days to come forward.",76,86,attendance,3,1,4
3SSN80MU8CPC3UTN6NCY10HM8XLKX9,"A spokeswoman for Merseyside Police said: ""Crime scene investigators are in attendance at the scene and officers are appealing to anyone who may have seen anyone acting suspiciously on Bidston Hill over the last few days to come forward.",117,126,appealing,5,5,10
3SSN80MU8CPC3UTN6NCY10HM8XLKX9,"A spokeswoman for Merseyside Police said: ""Crime scene investigators are in attendance at the scene and officers are appealing to anyone who may have seen anyone acting suspiciously on Bidston Hill over the last few days to come forward.",155,181,anyone acting suspiciously,1,0,1
3SSN80MU8CPC3UTN6NCY10HM8XLKX9,"A spokeswoman for Merseyside Police said: ""Crime scene investigators are in attendance at the scene and officers are appealing to anyone who may have seen anyone acting suspiciously on Bidston Hill over the last few days to come forward.",162,181,acting suspiciously,1,1,2
3SSN80MU8CPC3UTN6NCY10HM8XLKX9,"A spokeswoman for Merseyside Police said: ""Crime scene investigators are in attendance at the scene and officers are appealing to anyone who may have seen anyone acting suspiciously on Bidston Hill over the last few days to come forward.",169,181,suspiciously,10,6,16
3SSN80MU8CPC3UTN6NCY10HM8XLKX9,The 18-year-old man arrested on suspicion of murder has been taken to a police station where he will be interviewed by detectives.,33,42,suspicion,6,5,11
3SSN80MU8CPC3UTN6NCY10HM8XLKX9,The 18-year-old man arrested on suspicion of murder has been taken to a police station where he will be interviewed by detectives.,33,52,suspicion of murder,0,2,2
3SSN80MU8CPC3UTN6NCY10HM8XLKX9,The 18-year-old man arrested on suspicion of murder has been taken to a police station where he will be interviewed by detectives.,105,116,interviewed,2,0,2
3SSN80MU8CPC3UTN6NCY10HM8XLKX9,The 18-year-old man arrested on suspicion of murder has been taken to a police station where he will be interviewed by detectives.,120,130,detectives,1,4,5
3SSN80MU8CPC3UTN6NCY10HM8XLKX9,Google says authorities in China have approved its acquisition of Motorola Mobility.,0,6,Google,0,1,1
3SSN80MU8CPC3UTN6NCY10HM8XLKX9,Google says authorities in China have approved its acquisition of Motorola Mobility.,12,23,authorities,2,1,3
3SSN80MU8CPC3UTN6NCY10HM8XLKX9,Google says authorities in China have approved its acquisition of Motorola Mobility.,38,46,approved,1,0,1
3SSN80MU8CPC3UTN6NCY10HM8XLKX9,Google says authorities in China have approved its acquisition of Motorola Mobility.,51,62,acquisition,10,9,19
3SSN80MU8CPC3UTN6NCY10HM8XLKX9,This brings the Internet search giant closer to completing its biggest deal ever.,5,11,brings,0,1,1
3SSN80MU8CPC3UTN6NCY10HM8XLKX9,This brings the Internet search giant closer to completing its biggest deal ever.,16,37,Internet search giant,0,2,2
3SSN80MU8CPC3UTN6NCY10HM8XLKX9,This brings the Internet search giant closer to completing its biggest deal ever.,25,37,search giant,1,1,2
3SSN80MU8CPC3UTN6NCY10HM8XLKX9,The deal was announced last August and had received all necessary regulatory approvals except in China.,13,22,announced,2,0,2
3SSN80MU8CPC3UTN6NCY10HM8XLKX9,The deal was announced last August and had received all necessary regulatory approvals except in China.,52,86,all necessary regulatory approvals,1,0,1
3SSN80MU8CPC3UTN6NCY10HM8XLKX9,The deal was announced last August and had received all necessary regulatory approvals except in China.,56,76,necessary regulatory,1,0,1
3SSN80MU8CPC3UTN6NCY10HM8XLKX9,The deal was announced last August and had received all necessary regulatory approvals except in China.,56,86,necessary regulatory approvals,2,1,3
3SSN80MU8CPC3UTN6NCY10HM8XLKX9,The deal was announced last August and had received all necessary regulatory approvals except in China.,66,76,regulatory,6,0,6
3SSN80MU8CPC3UTN6NCY10HM8XLKX9,The deal was announced last August and had received all necessary regulatory approvals except in China.,66,86,regulatory approvals,2,4,6
3SSN80MU8CPC3UTN6NCY10HM8XLKX9,The deal was announced last August and had received all necessary regulatory approvals except in China.,77,86,approvals,1,0,1
30Z7M1Q8UYLGCGJTMONHRNXXCCI8AA,He did not describe the nature of the calls.,11,19,describe,0,1,1
30Z7M1Q8UYLGCGJTMONHRNXXCCI8AA,He did not describe the nature of the calls.,20,30,the nature,1,0,1
30Z7M1Q8UYLGCGJTMONHRNXXCCI8AA,He did not describe the nature of the calls.,24,30,nature,3,0,3
30Z7M1Q8UYLGCGJTMONHRNXXCCI8AA,"Google Inc. (GOOG) won approval from Chinese regulators for its $12.5 billion purchase of Motorola Mobility Holdings Inc. (MMI), clearing a final hurdle for a deal that boosts its patents portfolio and steps up competition with Apple Inc. “We are pleased the deal has received approval in all jurisdictions,” Motorola Mobility said in an e-mailed statement yesterday, confirming that the transaction has been approved in China.",13,17,GOOG,1,0,1
30Z7M1Q8UYLGCGJTMONHRNXXCCI8AA,"Google Inc. (GOOG) won approval from Chinese regulators for its $12.5 billion purchase of Motorola Mobility Holdings Inc. (MMI), clearing a final hurdle for a deal that boosts its patents portfolio and steps up competition with Apple Inc. “We are pleased the deal has received approval in all jurisdictions,” Motorola Mobility said in an e-mailed statement yesterday, confirming that the transaction has been approved in China.",23,31,approval,0,2,2
30Z7M1Q8UYLGCGJTMONHRNXXCCI8AA,"Google Inc. (GOOG) won approval from Chinese regulators for its $12.5 billion purchase of Motorola Mobility Holdings Inc. (MMI), clearing a final hurdle for a deal that boosts its patents portfolio and steps up competition with Apple Inc. “We are pleased the deal has received approval in all jurisdictions,” Motorola Mobility said in an e-mailed statement yesterday, confirming that the transaction has been approved in China.",45,55,regulators,7,4,11
30Z7M1Q8UYLGCGJTMONHRNXXCCI8AA,"Google Inc. (GOOG) won approval from Chinese regulators for its $12.5 billion purchase of Motorola Mobility Holdings Inc. (MMI), clearing a final hurdle for a deal that boosts its patents portfolio and steps up competition with Apple Inc. “We are pleased the deal has received approval in all jurisdictions,” Motorola Mobility said in an e-mailed statement yesterday, confirming that the transaction has been approved in China.",108,116,Holdings,1,0,1
30Z7M1Q8UYLGCGJTMONHRNXXCCI8AA,"Google Inc. (GOOG) won approval from Chinese regulators for its $12.5 billion purchase of Motorola Mobility Holdings Inc. (MMI), clearing a final hurdle for a deal that boosts its patents portfolio and steps up competition with Apple Inc. “We are pleased the deal has received approval in all jurisdictions,” Motorola Mobility said in an e-mailed statement yesterday, confirming that the transaction has been approved in China.",140,152,final hurdle,2,2,4
30Z7M1Q8UYLGCGJTMONHRNXXCCI8AA,"Google Inc. (GOOG) won approval from Chinese regulators for its $12.5 billion purchase of Motorola Mobility Holdings Inc. (MMI), clearing a final hurdle for a deal that boosts its patents portfolio and steps up competition with Apple Inc. “We are pleased the deal has received approval in all jurisdictions,” Motorola Mobility said in an e-mailed statement yesterday, confirming that the transaction has been approved in China.",146,152,hurdle,4,10,14
30Z7M1Q8UYLGCGJTMONHRNXXCCI8AA,"Google Inc. (GOOG) won approval from Chinese regulators for its $12.5 billion purchase of Motorola Mobility Holdings Inc. (MMI), clearing a final hurdle for a deal that boosts its patents portfolio and steps up competition with Apple Inc. “We are pleased the deal has received approval in all jurisdictions,” Motorola Mobility said in an e-mailed statement yesterday, confirming that the transaction has been approved in China.",169,175,boosts,3,5,8
30Z7M1Q8UYLGCGJTMONHRNXXCCI8AA,"Google Inc. (GOOG) won approval from Chinese regulators for its $12.5 billion purchase of Motorola Mobility Holdings Inc. (MMI), clearing a final hurdle for a deal that boosts its patents portfolio and steps up competition with Apple Inc. “We are pleased the deal has received approval in all jurisdictions,” Motorola Mobility said in an e-mailed statement yesterday, confirming that the transaction has been approved in China.",180,187,patents,2,2,4
30Z7M1Q8UYLGCGJTMONHRNXXCCI8AA,"Google Inc. (GOOG) won approval from Chinese regulators for its $12.5 billion purchase of Motorola Mobility Holdings Inc. (MMI), clearing a final hurdle for a deal that boosts its patents portfolio and steps up competition with Apple Inc. “We are pleased the deal has received approval in all jurisdictions,” Motorola Mobility said in an e-mailed statement yesterday, confirming that the transaction has been approved in China.",180,197,patents portfolio,6,2,8
30Z7M1Q8UYLGCGJTMONHRNXXCCI8AA,"Google Inc. (GOOG) won approval from Chinese regulators for its $12.5 billion purchase of Motorola Mobility Holdings Inc. (MMI), clearing a final hurdle for a deal that boosts its patents portfolio and steps up competition with Apple Inc. “We are pleased the deal has received approval in all jurisdictions,” Motorola Mobility said in an e-mailed statement yesterday, confirming that the transaction has been approved in China.",188,197,portfolio,2,7,9
30Z7M1Q8UYLGCGJTMONHRNXXCCI8AA,"Google Inc. (GOOG) won approval from Chinese regulators for its $12.5 billion purchase of Motorola Mobility Holdings Inc. (MMI), clearing a final hurdle for a deal that boosts its patents portfolio and steps up competition with Apple Inc. “We are pleased the deal has received approval in all jurisdictions,” Motorola Mobility said in an e-mailed statement yesterday, confirming that the transaction has been approved in China.",211,222,competition,2,2,4
30Z7M1Q8UYLGCGJTMONHRNXXCCI8AA,"Google Inc. (GOOG) won approval from Chinese regulators for its $12.5 billion purchase of Motorola Mobility Holdings Inc. (MMI), clearing a final hurdle for a deal that boosts its patents portfolio and steps up competition with Apple Inc. “We are pleased the deal has received approval in all jurisdictions,” Motorola Mobility said in an e-mailed statement yesterday, confirming that the transaction has been approved in China.",293,306,jurisdictions,9,10,19
30Z7M1Q8UYLGCGJTMONHRNXXCCI8AA,"Google Inc. (GOOG) won approval from Chinese regulators for its $12.5 billion purchase of Motorola Mobility Holdings Inc. (MMI), clearing a final hurdle for a deal that boosts its patents portfolio and steps up competition with Apple Inc. “We are pleased the deal has received approval in all jurisdictions,” Motorola Mobility said in an e-mailed statement yesterday, confirming that the transaction has been approved in China.",293,308,"jurisdictions,”",1,0,1
30Z7M1Q8UYLGCGJTMONHRNXXCCI8AA,"Google Inc. (GOOG) won approval from Chinese regulators for its $12.5 billion purchase of Motorola Mobility Holdings Inc. (MMI), clearing a final hurdle for a deal that boosts its patents portfolio and steps up competition with Apple Inc. “We are pleased the deal has received approval in all jurisdictions,” Motorola Mobility said in an e-mailed statement yesterday, confirming that the transaction has been approved in China.",347,356,statement,2,0,2
30Z7M1Q8UYLGCGJTMONHRNXXCCI8AA,"Google Inc. (GOOG) won approval from Chinese regulators for its $12.5 billion purchase of Motorola Mobility Holdings Inc. (MMI), clearing a final hurdle for a deal that boosts its patents portfolio and steps up competition with Apple Inc. “We are pleased the deal has received approval in all jurisdictions,” Motorola Mobility said in an e-mailed statement yesterday, confirming that the transaction has been approved in China.",368,378,confirming,1,1,2
30Z7M1Q8UYLGCGJTMONHRNXXCCI8AA,"Google Inc. (GOOG) won approval from Chinese regulators for its $12.5 billion purchase of Motorola Mobility Holdings Inc. (MMI), clearing a final hurdle for a deal that boosts its patents portfolio and steps up competition with Apple Inc. “We are pleased the deal has received approval in all jurisdictions,” Motorola Mobility said in an e-mailed statement yesterday, confirming that the transaction has been approved in China.",388,399,transaction,5,1,6
30Z7M1Q8UYLGCGJTMONHRNXXCCI8AA,"Google Inc. (GOOG) won approval from Chinese regulators for its $12.5 billion purchase of Motorola Mobility Holdings Inc. (MMI), clearing a final hurdle for a deal that boosts its patents portfolio and steps up competition with Apple Inc. “We are pleased the deal has received approval in all jurisdictions,” Motorola Mobility said in an e-mailed statement yesterday, confirming that the transaction has been approved in China.",409,417,approved,0,1,1
30Z7M1Q8UYLGCGJTMONHRNXXCCI8AA,“We expect to close imminently.”,20,30,imminently,10,10,20
30Z7M1Q8UYLGCGJTMONHRNXXCCI8AA,"The deal helps Larry Page, the Google co-founder who took over as chief executive officer last year, push the Web company to better compete with Apple’s iPhone and gain more clout for its Android software as it expands in the hardware business.",38,48,co-founder,0,1,1
30Z7M1Q8UYLGCGJTMONHRNXXCCI8AA,"The deal helps Larry Page, the Google co-founder who took over as chief executive officer last year, push the Web company to better compete with Apple’s iPhone and gain more clout for its Android software as it expands in the hardware business.",66,89,chief executive officer,1,0,1
30Z7M1Q8UYLGCGJTMONHRNXXCCI8AA,"The deal helps Larry Page, the Google co-founder who took over as chief executive officer last year, push the Web company to better compete with Apple’s iPhone and gain more clout for its Android software as it expands in the hardware business.",72,81,executive,1,0,1
30Z7M1Q8UYLGCGJTMONHRNXXCCI8AA,"The deal helps Larry Page, the Google co-founder who took over as chief executive officer last year, push the Web company to better compete with Apple’s iPhone and gain more clout for its Android software as it expands in the hardware business.",132,139,compete,1,1,2
30Z7M1Q8UYLGCGJTMONHRNXXCCI8AA,"The deal helps Larry Page, the Google co-founder who took over as chief executive officer last year, push the Web company to better compete with Apple’s iPhone and gain more clout for its Android software as it expands in the hardware business.",174,179,clout,8,8,16
30Z7M1Q8UYLGCGJTMONHRNXXCCI8AA,"The deal helps Larry Page, the Google co-founder who took over as chief executive officer last year, push the Web company to better compete with Apple’s iPhone and gain more clout for its Android software as it expands in the hardware business.",188,204,Android software,1,0,1
30Z7M1Q8UYLGCGJTMONHRNXXCCI8AA,"The deal helps Larry Page, the Google co-founder who took over as chief executive officer last year, push the Web company to better compete with Apple’s iPhone and gain more clout for its Android software as it expands in the hardware business.",196,204,software,0,1,1
30Z7M1Q8UYLGCGJTMONHRNXXCCI8AA,"The deal helps Larry Page, the Google co-founder who took over as chief executive officer last year, push the Web company to better compete with Apple’s iPhone and gain more clout for its Android software as it expands in the hardware business.",211,218,expands,0,1,1
30Z7M1Q8UYLGCGJTMONHRNXXCCI8AA,"The deal helps Larry Page, the Google co-founder who took over as chief executive officer last year, push the Web company to better compete with Apple’s iPhone and gain more clout for its Android software as it expands in the hardware business.",226,234,hardware,0,3,3
30Z7M1Q8UYLGCGJTMONHRNXXCCI8AA,"It also gives Google, the worlds’ biggest maker of smartphone software, a trove of 17,000 patents to protect Android devices in legal disputes with competitors.",51,61,smartphone,1,0,1
30Z7M1Q8UYLGCGJTMONHRNXXCCI8AA,"It also gives Google, the worlds’ biggest maker of smartphone software, a trove of 17,000 patents to protect Android devices in legal disputes with competitors.",51,71,smartphone  software,0,1,1
30Z7M1Q8UYLGCGJTMONHRNXXCCI8AA,"It also gives Google, the worlds’ biggest maker of smartphone software, a trove of 17,000 patents to protect Android devices in legal disputes with competitors.",74,79,trove,5,5,10
30Z7M1Q8UYLGCGJTMONHRNXXCCI8AA,"It also gives Google, the worlds’ biggest maker of smartphone software, a trove of 17,000 patents to protect Android devices in legal disputes with competitors.",90,97,patents,3,1,4
30Z7M1Q8UYLGCGJTMONHRNXXCCI8AA,"It also gives Google, the worlds’ biggest maker of smartphone software, a trove of 17,000 patents to protect Android devices in legal disputes with competitors.",117,124,devices,0,2,2
30Z7M1Q8UYLGCGJTMONHRNXXCCI8AA,"It also gives Google, the worlds’ biggest maker of smartphone software, a trove of 17,000 patents to protect Android devices in legal disputes with competitors.",128,142,legal disputes,3,2,5
30Z7M1Q8UYLGCGJTMONHRNXXCCI8AA,"It also gives Google, the worlds’ biggest maker of smartphone software, a trove of 17,000 patents to protect Android devices in legal disputes with competitors.",134,142,disputes,4,4,8
30Z7M1Q8UYLGCGJTMONHRNXXCCI8AA,"It also gives Google, the worlds’ biggest maker of smartphone software, a trove of 17,000 patents to protect Android devices in legal disputes with competitors.",148,159,competitors,5,1,6
31D0ZWOD0A0YUREQRKA2Y8RFTE6A0P,"The daily death toll in Syria has declined as the number of observers has risen, but few experts expect the U.N. plan to succeed in its entirety.",4,20,daily death toll,1,0,1
31D0ZWOD0A0YUREQRKA2Y8RFTE6A0P,"The daily death toll in Syria has declined as the number of observers has risen, but few experts expect the U.N. plan to succeed in its entirety.",10,20,death toll,1,4,5
31D0ZWOD0A0YUREQRKA2Y8RFTE6A0P,"The daily death toll in Syria has declined as the number of observers has risen, but few experts expect the U.N. plan to succeed in its entirety.",16,20,toll,3,1,4
31D0ZWOD0A0YUREQRKA2Y8RFTE6A0P,"The daily death toll in Syria has declined as the number of observers has risen, but few experts expect the U.N. plan to succeed in its entirety.",34,42,declined,1,3,4
31D0ZWOD0A0YUREQRKA2Y8RFTE6A0P,"The daily death toll in Syria has declined as the number of observers has risen, but few experts expect the U.N. plan to succeed in its entirety.",60,69,observers,5,2,7
31D0ZWOD0A0YUREQRKA2Y8RFTE6A0P,"The daily death toll in Syria has declined as the number of observers has risen, but few experts expect the U.N. plan to succeed in its entirety.",70,79,has risen,0,1,1
31D0ZWOD0A0YUREQRKA2Y8RFTE6A0P,"The daily death toll in Syria has declined as the number of observers has risen, but few experts expect the U.N. plan to succeed in its entirety.",74,79,risen,1,1,2
31D0ZWOD0A0YUREQRKA2Y8RFTE6A0P,"The daily death toll in Syria has declined as the number of observers has risen, but few experts expect the U.N. plan to succeed in its entirety.",121,128,succeed,0,1,1
31D0ZWOD0A0YUREQRKA2Y8RFTE6A0P,"The daily death toll in Syria has declined as the number of observers has risen, but few experts expect the U.N. plan to succeed in its entirety.",121,144,succeed in its entirety,1,0,1
31D0ZWOD0A0YUREQRKA2Y8RFTE6A0P,"The daily death toll in Syria has declined as the number of observers has risen, but few experts expect the U.N. plan to succeed in its entirety.",136,144,entirety,5,7,12
31D0ZWOD0A0YUREQRKA2Y8RFTE6A0P,"The Observatory said a total of 19 civilians were killed nationwide, plus two rebels and 5 regime soldiers.",4,15,Observatory,3,3,6
31D0ZWOD0A0YUREQRKA2Y8RFTE6A0P,"The Observatory said a total of 19 civilians were killed nationwide, plus two rebels and 5 regime soldiers.",35,44,civilians,1,2,3
31D0ZWOD0A0YUREQRKA2Y8RFTE6A0P,"The Observatory said a total of 19 civilians were killed nationwide, plus two rebels and 5 regime soldiers.",57,67,nationwide,2,2,4
31D0ZWOD0A0YUREQRKA2Y8RFTE6A0P,"The Observatory said a total of 19 civilians were killed nationwide, plus two rebels and 5 regime soldiers.",78,84,rebels,2,1,3
31D0ZWOD0A0YUREQRKA2Y8RFTE6A0P,"The Observatory said a total of 19 civilians were killed nationwide, plus two rebels and 5 regime soldiers.",91,97,regime,6,3,9
31D0ZWOD0A0YUREQRKA2Y8RFTE6A0P,"The Observatory said a total of 19 civilians were killed nationwide, plus two rebels and 5 regime soldiers.",91,106,regime soldiers,1,1,2
31D0ZWOD0A0YUREQRKA2Y8RFTE6A0P,Activists also reported government attacks in rebellious Damascus suburbs.,0,9,Activists,0,4,4
31D0ZWOD0A0YUREQRKA2Y8RFTE6A0P,Activists also reported government attacks in rebellious Damascus suburbs.,24,34,government,2,0,2
31D0ZWOD0A0YUREQRKA2Y8RFTE6A0P,Activists also reported government attacks in rebellious Damascus suburbs.,46,56,rebellious,10,9,19
31D0ZWOD0A0YUREQRKA2Y8RFTE6A0P,Activists also reported government attacks in rebellious Damascus suburbs.,57,65,Damascus,0,1,1
31D0ZWOD0A0YUREQRKA2Y8RFTE6A0P,Activists also reported government attacks in rebellious Damascus suburbs.,66,73,suburbs,2,4,6
31D0ZWOD0A0YUREQRKA2Y8RFTE6A0P,Omar Hamza said via Skype that three people were killed early Sunday by shells and machine gun rounds fired at Douma.,72,78,shells,3,6,9
31D0ZWOD0A0YUREQRKA2Y8RFTE6A0P,Omar Hamza said via Skype that three people were killed early Sunday by shells and machine gun rounds fired at Douma.,111,116,Douma,0,1,1
31D0ZWOD0A0YUREQRKA2Y8RFTE6A0P,"The government was raiding other areas looking for activists, he said.",4,14,government,2,0,2
31D0ZWOD0A0YUREQRKA2Y8RFTE6A0P,"The government was raiding other areas looking for activists, he said.",19,26,raiding,2,6,8
31D0ZWOD0A0YUREQRKA2Y8RFTE6A0P,"The government was raiding other areas looking for activists, he said.",51,60,activists,2,1,3
31D0ZWOD0A0YUREQRKA2Y8RFTE6A0P,"The Observatory also reported three killed in suburbs east of the capital, one of them a rebel commander.",4,15,Observatory,1,0,1
31D0ZWOD0A0YUREQRKA2Y8RFTE6A0P,"The Observatory also reported three killed in suburbs east of the capital, one of them a rebel commander.",46,53,suburbs,4,4,8
31D0ZWOD0A0YUREQRKA2Y8RFTE6A0P,"The Observatory also reported three killed in suburbs east of the capital, one of them a rebel commander.",54,58,east,0,1,1
31D0ZWOD0A0YUREQRKA2Y8RFTE6A0P,"The Observatory also reported three killed in suburbs east of the capital, one of them a rebel commander.",89,94,rebel,2,2,4
31D0ZWOD0A0YUREQRKA2Y8RFTE6A0P,"The Observatory also reported three killed in suburbs east of the capital, one of them a rebel commander.",89,104,rebel commander,1,0,1
31D0ZWOD0A0YUREQRKA2Y8RFTE6A0P,"The Observatory also reported three killed in suburbs east of the capital, one of them a rebel commander.",95,104,commander,3,0,3
31D0ZWOD0A0YUREQRKA2Y8RFTE6A0P,Activist claims could not be independently verified.,0,8,Activist,1,0,1
31D0ZWOD0A0YUREQRKA2Y8RFTE6A0P,Activist claims could not be independently verified.,29,42,independently,3,0,3
31D0ZWOD0A0YUREQRKA2Y8RFTE6A0P,Activist claims could not be independently verified.,29,51,independently verified,4,4,8
31D0ZWOD0A0YUREQRKA2Y8RFTE6A0P,Activist claims could not be independently verified.,43,51,verified,2,1,3
31D0ZWOD0A0YUREQRKA2Y8RFTE6A0P,The Syrian government did not comment on the reports and bars most media from working in the country.,11,21,government,1,0,1
31D0ZWOD0A0YUREQRKA2Y8RFTE6A0P,The Syrian government did not comment on the reports and bars most media from working in the country.,57,61,bars,4,4,8
31D0ZWOD0A0YUREQRKA2Y8RFTE6A0P,The Syrian government did not comment on the reports and bars most media from working in the country.,67,72,media,1,0,1
368IUKXGA590V667IS8GX4Q1424P6U,Suicide bombers attacked a compound housing Westerners in Kabul on Wednesday hours after U.S. President Barack Obama signed a security pact during a short visit to a city that remains vulnerable to a resilient insurgency.,0,15,Suicide bombers,3,3,6
368IUKXGA590V667IS8GX4Q1424P6U,Suicide bombers attacked a compound housing Westerners in Kabul on Wednesday hours after U.S. President Barack Obama signed a security pact during a short visit to a city that remains vulnerable to a resilient insurgency.,27,35,compound,4,2,6
368IUKXGA590V667IS8GX4Q1424P6U,Suicide bombers attacked a compound housing Westerners in Kabul on Wednesday hours after U.S. President Barack Obama signed a security pact during a short visit to a city that remains vulnerable to a resilient insurgency.,27,43,compound housing,1,2,3
368IUKXGA590V667IS8GX4Q1424P6U,Suicide bombers attacked a compound housing Westerners in Kabul on Wednesday hours after U.S. President Barack Obama signed a security pact during a short visit to a city that remains vulnerable to a resilient insurgency.,126,139,security pact,5,2,7
368IUKXGA590V667IS8GX4Q1424P6U,Suicide bombers attacked a compound housing Westerners in Kabul on Wednesday hours after U.S. President Barack Obama signed a security pact during a short visit to a city that remains vulnerable to a resilient insurgency.,135,139,pact,0,3,3
368IUKXGA590V667IS8GX4Q1424P6U,Suicide bombers attacked a compound housing Westerners in Kabul on Wednesday hours after U.S. President Barack Obama signed a security pact during a short visit to a city that remains vulnerable to a resilient insurgency.,184,194,vulnerable,9,8,17
368IUKXGA590V667IS8GX4Q1424P6U,Suicide bombers attacked a compound housing Westerners in Kabul on Wednesday hours after U.S. President Barack Obama signed a security pact during a short visit to a city that remains vulnerable to a resilient insurgency.,184,220,vulnerable to a resilient insurgency,0,1,1
368IUKXGA590V667IS8GX4Q1424P6U,Suicide bombers attacked a compound housing Westerners in Kabul on Wednesday hours after U.S. President Barack Obama signed a security pact during a short visit to a city that remains vulnerable to a resilient insurgency.,200,209,resilient,6,4,10
368IUKXGA590V667IS8GX4Q1424P6U,Suicide bombers attacked a compound housing Westerners in Kabul on Wednesday hours after U.S. President Barack Obama signed a security pact during a short visit to a city that remains vulnerable to a resilient insurgency.,200,220,resilient insurgency,7,7,14
368IUKXGA590V667IS8GX4Q1424P6U,Suicide bombers attacked a compound housing Westerners in Kabul on Wednesday hours after U.S. President Barack Obama signed a security pact during a short visit to a city that remains vulnerable to a resilient insurgency.,210,220,insurgency,6,3,9
368IUKXGA590V667IS8GX4Q1424P6U,"The Taliban claimed responsibility for the attack which involved a car bomb and insurgents disguised as women on the eastern outskirts of the capital, killing seven people, a Gurkha guard and six passers-by, and wounding 17.",12,19,claimed,1,0,1
368IUKXGA590V667IS8GX4Q1424P6U,"The Taliban claimed responsibility for the attack which involved a car bomb and insurgents disguised as women on the eastern outskirts of the capital, killing seven people, a Gurkha guard and six passers-by, and wounding 17.",20,34,responsibility,2,0,2
368IUKXGA590V667IS8GX4Q1424P6U,"The Taliban claimed responsibility for the attack which involved a car bomb and insurgents disguised as women on the eastern outskirts of the capital, killing seven people, a Gurkha guard and six passers-by, and wounding 17.",80,90,insurgents,9,4,13
368IUKXGA590V667IS8GX4Q1424P6U,"The Taliban claimed responsibility for the attack which involved a car bomb and insurgents disguised as women on the eastern outskirts of the capital, killing seven people, a Gurkha guard and six passers-by, and wounding 17.",80,100,insurgents disguised,1,0,1
368IUKXGA590V667IS8GX4Q1424P6U,"The Taliban claimed responsibility for the attack which involved a car bomb and insurgents disguised as women on the eastern outskirts of the capital, killing seven people, a Gurkha guard and six passers-by, and wounding 17.",91,100,disguised,4,7,11
368IUKXGA590V667IS8GX4Q1424P6U,"The Taliban claimed responsibility for the attack which involved a car bomb and insurgents disguised as women on the eastern outskirts of the capital, killing seven people, a Gurkha guard and six passers-by, and wounding 17.",117,134,eastern outskirts,0,2,2
368IUKXGA590V667IS8GX4Q1424P6U,"The Taliban claimed responsibility for the attack which involved a car bomb and insurgents disguised as women on the eastern outskirts of the capital, killing seven people, a Gurkha guard and six passers-by, and wounding 17.",125,134,outskirts,7,7,14
368IUKXGA590V667IS8GX4Q1424P6U,"The Taliban claimed responsibility for the attack which involved a car bomb and insurgents disguised as women on the eastern outskirts of the capital, killing seven people, a Gurkha guard and six passers-by, and wounding 17.",175,181,Gurkha,1,0,1
368IUKXGA590V667IS8GX4Q1424P6U,"The Taliban claimed responsibility for the attack which involved a car bomb and insurgents disguised as women on the eastern outskirts of the capital, killing seven people, a Gurkha guard and six passers-by, and wounding 17.",175,187,Gurkha guard,0,1,1
368IUKXGA590V667IS8GX4Q1424P6U,"The Taliban claimed responsibility for the attack which involved a car bomb and insurgents disguised as women on the eastern outskirts of the capital, killing seven people, a Gurkha guard and six passers-by, and wounding 17.",196,206,passers-by,0,1,1
368IUKXGA590V667IS8GX4Q1424P6U,"The Taliban claimed responsibility for the attack which involved a car bomb and insurgents disguised as women on the eastern outskirts of the capital, killing seven people, a Gurkha guard and six passers-by, and wounding 17.",212,220,wounding,0,2,2
368IUKXGA590V667IS8GX4Q1424P6U,"The Taliban said it was in response to Obama's visit and to the strategic partnership deal he signed with Afghan President Hamid Karzai, a pact that sets out a long-term U.S. role after most foreign combat troops leave by the end of 2014.",4,11,Taliban,0,1,1
368IUKXGA590V667IS8GX4Q1424P6U,"The Taliban said it was in response to Obama's visit and to the strategic partnership deal he signed with Afghan President Hamid Karzai, a pact that sets out a long-term U.S. role after most foreign combat troops leave by the end of 2014.",27,35,response,0,1,1
368IUKXGA590V667IS8GX4Q1424P6U,"The Taliban said it was in response to Obama's visit and to the strategic partnership deal he signed with Afghan President Hamid Karzai, a pact that sets out a long-term U.S. role after most foreign combat troops leave by the end of 2014.",64,73,strategic,2,4,6
368IUKXGA590V667IS8GX4Q1424P6U,"The Taliban said it was in response to Obama's visit and to the strategic partnership deal he signed with Afghan President Hamid Karzai, a pact that sets out a long-term U.S. role after most foreign combat troops leave by the end of 2014.",64,85,strategic partnership,3,4,7
368IUKXGA590V667IS8GX4Q1424P6U,"The Taliban said it was in response to Obama's visit and to the strategic partnership deal he signed with Afghan President Hamid Karzai, a pact that sets out a long-term U.S. role after most foreign combat troops leave by the end of 2014.",64,90,strategic partnership deal,2,1,3
368IUKXGA590V667IS8GX4Q1424P6U,"The Taliban said it was in response to Obama's visit and to the strategic partnership deal he signed with Afghan President Hamid Karzai, a pact that sets out a long-term U.S. role after most foreign combat troops leave by the end of 2014.",74,85,partnership,1,0,1
368IUKXGA590V667IS8GX4Q1424P6U,"The Taliban said it was in response to Obama's visit and to the strategic partnership deal he signed with Afghan President Hamid Karzai, a pact that sets out a long-term U.S. role after most foreign combat troops leave by the end of 2014.",86,90,deal,0,1,1
368IUKXGA590V667IS8GX4Q1424P6U,"The Taliban said it was in response to Obama's visit and to the strategic partnership deal he signed with Afghan President Hamid Karzai, a pact that sets out a long-term U.S. role after most foreign combat troops leave by the end of 2014.",139,143,pact,1,1,2
368IUKXGA590V667IS8GX4Q1424P6U,"The Taliban said it was in response to Obama's visit and to the strategic partnership deal he signed with Afghan President Hamid Karzai, a pact that sets out a long-term U.S. role after most foreign combat troops leave by the end of 2014.",191,198,foreign,1,0,1
368IUKXGA590V667IS8GX4Q1424P6U,"The Taliban said it was in response to Obama's visit and to the strategic partnership deal he signed with Afghan President Hamid Karzai, a pact that sets out a long-term U.S. role after most foreign combat troops leave by the end of 2014.",199,212,combat troops,0,3,3
368IUKXGA590V667IS8GX4Q1424P6U,"The insurgency also claimed their spring offensive, which began two weeks ago with attacks in Kabul, would be renewed on Thursday, despite a security clamp-down in the capital.",4,14,insurgency,7,2,9
368IUKXGA590V667IS8GX4Q1424P6U,"The insurgency also claimed their spring offensive, which began two weeks ago with attacks in Kabul, would be renewed on Thursday, despite a security clamp-down in the capital.",34,50,spring offensive,4,5,9
368IUKXGA590V667IS8GX4Q1424P6U,"The insurgency also claimed their spring offensive, which began two weeks ago with attacks in Kabul, would be renewed on Thursday, despite a security clamp-down in the capital.",41,50,offensive,3,1,4
368IUKXGA590V667IS8GX4Q1424P6U,"The insurgency also claimed their spring offensive, which began two weeks ago with attacks in Kabul, would be renewed on Thursday, despite a security clamp-down in the capital.",110,117,renewed,3,2,5
368IUKXGA590V667IS8GX4Q1424P6U,"The insurgency also claimed their spring offensive, which began two weeks ago with attacks in Kabul, would be renewed on Thursday, despite a security clamp-down in the capital.",131,138,despite,2,1,3
368IUKXGA590V667IS8GX4Q1424P6U,"The insurgency also claimed their spring offensive, which began two weeks ago with attacks in Kabul, would be renewed on Thursday, despite a security clamp-down in the capital.",141,160,security clamp-down,4,1,5
368IUKXGA590V667IS8GX4Q1424P6U,"The insurgency also claimed their spring offensive, which began two weeks ago with attacks in Kabul, would be renewed on Thursday, despite a security clamp-down in the capital.",150,160,clamp-down,4,8,12
368IUKXGA590V667IS8GX4Q1424P6U,"The insurgency also claimed their spring offensive, which began two weeks ago with attacks in Kabul, would be renewed on Thursday, despite a security clamp-down in the capital.",150,175,clamp-down in the capital,0,1,1
3XAOZ9UYRZSQOW6PCZBO2DPU1BVQ1L,"Shells and rockets have been hitting the town since three a.m. (midnight GMT) at a rate of one a minute.	1	7	Shells	6	3	9
3XAOZ9UYRZSQOW6PCZBO2DPU1BVQ1L	Shells and rockets have been hitting the town since three a.m. (midnight GMT) at a rate of one a minute.",30,37,hitting,1,1,2
3XAOZ9UYRZSQOW6PCZBO2DPU1BVQ1L,"Shells and rockets have been hitting the town since three a.m. (midnight GMT) at a rate of one a minute.	84	88	rate	1	0	1
3XAOZ9UYRZSQOW6PCZBO2DPU1BVQ1L	Rastan has been destroyed, a member of the rebel Free Syrian Army (FSA)in Rastan who declined to be named told Reuters by satellite phone.",0,6,Rastan,1,0,1
3XAOZ9UYRZSQOW6PCZBO2DPU1BVQ1L,"Rastan has been destroyed,"" a member of the rebel Free Syrian Army (FSA)in Rastan who declined to be named told Reuters by satellite phone.",16,25,destroyed,1,2,3
3XAOZ9UYRZSQOW6PCZBO2DPU1BVQ1L,"Rastan has been destroyed,"" a member of the rebel Free Syrian Army (FSA)in Rastan who declined to be named told Reuters by satellite phone.",44,49,rebel,0,3,3
3XAOZ9UYRZSQOW6PCZBO2DPU1BVQ1L,"Rastan has been destroyed,"" a member of the rebel Free Syrian Army (FSA)in Rastan who declined to be named told Reuters by satellite phone.",44,54,rebel Free,1,0,1
3XAOZ9UYRZSQOW6PCZBO2DPU1BVQ1L,"Rastan has been destroyed,"" a member of the rebel Free Syrian Army (FSA)in Rastan who declined to be named told Reuters by satellite phone.",75,81,Rastan,1,0,1
3XAOZ9UYRZSQOW6PCZBO2DPU1BVQ1L,"Rastan has been destroyed,"" a member of the rebel Free Syrian Army (FSA)in Rastan who declined to be named told Reuters by satellite phone.",86,94,declined,5,4,9
3XAOZ9UYRZSQOW6PCZBO2DPU1BVQ1L,"Rastan has been destroyed,"" a member of the rebel Free Syrian Army (FSA)in Rastan who declined to be named told Reuters by satellite phone.",86,106,declined to be named,0,1,1
3XAOZ9UYRZSQOW6PCZBO2DPU1BVQ1L,"Rastan has been destroyed,"" a member of the rebel Free Syrian Army (FSA)in Rastan who declined to be named told Reuters by satellite phone.",112,119,Reuters,2,0,2
3XAOZ9UYRZSQOW6PCZBO2DPU1BVQ1L,"Rastan has been destroyed,"" a member of the rebel Free Syrian Army (FSA)in Rastan who declined to be named told Reuters by satellite phone.",123,132,satellite,5,1,6
3XAOZ9UYRZSQOW6PCZBO2DPU1BVQ1L,"Rastan has been destroyed,"" a member of the rebel Free Syrian Army (FSA)in Rastan who declined to be named told Reuters by satellite phone.",123,138,satellite phone,3,0,3
3XAOZ9UYRZSQOW6PCZBO2DPU1BVQ1L,"He said among those killed was Ahmad Ayoub, an FSA commander whose fighters were battling the army forces which he said were made up of elite units and members of Military Intelligence.",47,50,FSA,1,0,1
3XAOZ9UYRZSQOW6PCZBO2DPU1BVQ1L,"He said among those killed was Ahmad Ayoub, an FSA commander whose fighters were battling the army forces which he said were made up of elite units and members of Military Intelligence.",47,75,FSA commander whose fighters,1,0,1
3XAOZ9UYRZSQOW6PCZBO2DPU1BVQ1L,"He said among those killed was Ahmad Ayoub, an FSA commander whose fighters were battling the army forces which he said were made up of elite units and members of Military Intelligence.",51,60,commander,1,0,1
3XAOZ9UYRZSQOW6PCZBO2DPU1BVQ1L,"He said among those killed was Ahmad Ayoub, an FSA commander whose fighters were battling the army forces which he said were made up of elite units and members of Military Intelligence.",81,89,battling,2,3,5
3XAOZ9UYRZSQOW6PCZBO2DPU1BVQ1L,"He said among those killed was Ahmad Ayoub, an FSA commander whose fighters were battling the army forces which he said were made up of elite units and members of Military Intelligence.",136,141,elite,6,5,11
3XAOZ9UYRZSQOW6PCZBO2DPU1BVQ1L,"He said among those killed was Ahmad Ayoub, an FSA commander whose fighters were battling the army forces which he said were made up of elite units and members of Military Intelligence.",136,147,elite units,4,1,5
3XAOZ9UYRZSQOW6PCZBO2DPU1BVQ1L,"He said among those killed was Ahmad Ayoub, an FSA commander whose fighters were battling the army forces which he said were made up of elite units and members of Military Intelligence.",163,184,Military Intelligence,0,1,1
3XAOZ9UYRZSQOW6PCZBO2DPU1BVQ1L,"He said among those killed was Ahmad Ayoub, an FSA commander whose fighters were battling the army forces which he said were made up of elite units and members of Military Intelligence.",172,184,Intelligence,2,2,4
3XAOZ9UYRZSQOW6PCZBO2DPU1BVQ1L,"The British-based Observatory said fighting began at dawn on Monday and that rebels destroyed three armored personnel carriers and seized two others, capturing around 15 soldiers.",4,43,British-based Observatory said fighting,1,0,1
3XAOZ9UYRZSQOW6PCZBO2DPU1BVQ1L,"The British-based Observatory said fighting began at dawn on Monday and that rebels destroyed three armored personnel carriers and seized two others, capturing around 15 soldiers.",18,29,Observatory,0,5,5
3XAOZ9UYRZSQOW6PCZBO2DPU1BVQ1L,"The British-based Observatory said fighting began at dawn on Monday and that rebels destroyed three armored personnel carriers and seized two others, capturing around 15 soldiers.",53,57,dawn,2,2,4
3XAOZ9UYRZSQOW6PCZBO2DPU1BVQ1L,"The British-based Observatory said fighting began at dawn on Monday and that rebels destroyed three armored personnel carriers and seized two others, capturing around 15 soldiers.",77,83,rebels,2,2,4
3XAOZ9UYRZSQOW6PCZBO2DPU1BVQ1L,"The British-based Observatory said fighting began at dawn on Monday and that rebels destroyed three armored personnel carriers and seized two others, capturing around 15 soldiers.",84,93,destroyed,1,0,1
3XAOZ9UYRZSQOW6PCZBO2DPU1BVQ1L,"The British-based Observatory said fighting began at dawn on Monday and that rebels destroyed three armored personnel carriers and seized two others, capturing around 15 soldiers.",100,107,armored,5,5,10
3XAOZ9UYRZSQOW6PCZBO2DPU1BVQ1L,"The British-based Observatory said fighting began at dawn on Monday and that rebels destroyed three armored personnel carriers and seized two others, capturing around 15 soldiers.",100,117,armored personnel,1,0,1
3XAOZ9UYRZSQOW6PCZBO2DPU1BVQ1L,"The British-based Observatory said fighting began at dawn on Monday and that rebels destroyed three armored personnel carriers and seized two others, capturing around 15 soldiers.",100,126,armored personnel carriers,5,1,6
3XAOZ9UYRZSQOW6PCZBO2DPU1BVQ1L,"The British-based Observatory said fighting began at dawn on Monday and that rebels destroyed three armored personnel carriers and seized two others, capturing around 15 soldiers.",108,117,personnel,1,2,3
3XAOZ9UYRZSQOW6PCZBO2DPU1BVQ1L,"The British-based Observatory said fighting began at dawn on Monday and that rebels destroyed three armored personnel carriers and seized two others, capturing around 15 soldiers.",108,126,personnel carriers,0,1,1
3XAOZ9UYRZSQOW6PCZBO2DPU1BVQ1L,"The British-based Observatory said fighting began at dawn on Monday and that rebels destroyed three armored personnel carriers and seized two others, capturing around 15 soldiers.",131,137,seized,6,9,15
3XAOZ9UYRZSQOW6PCZBO2DPU1BVQ1L,"The British-based Observatory said fighting began at dawn on Monday and that rebels destroyed three armored personnel carriers and seized two others, capturing around 15 soldiers.",150,159,capturing,1,1,2
3XAOZ9UYRZSQOW6PCZBO2DPU1BVQ1L,Syria's uprising began as a peaceful protest movement but has become increasingly militarized as rebels fight back against Assad's violent crackdown.,8,16,uprising,7,6,13
3XAOZ9UYRZSQOW6PCZBO2DPU1BVQ1L,Syria's uprising began as a peaceful protest movement but has become increasingly militarized as rebels fight back against Assad's violent crackdown.,28,53,peaceful protest movement,1,1,2
3XAOZ9UYRZSQOW6PCZBO2DPU1BVQ1L,Syria's uprising began as a peaceful protest movement but has become increasingly militarized as rebels fight back against Assad's violent crackdown.,69,93,increasingly militarized,1,0,1
3XAOZ9UYRZSQOW6PCZBO2DPU1BVQ1L,Syria's uprising began as a peaceful protest movement but has become increasingly militarized as rebels fight back against Assad's violent crackdown.,69,103,increasingly militarized as rebels,1,0,1
3XAOZ9UYRZSQOW6PCZBO2DPU1BVQ1L,Syria's uprising began as a peaceful protest movement but has become increasingly militarized as rebels fight back against Assad's violent crackdown.,82,93,militarized,10,4,14
3XAOZ9UYRZSQOW6PCZBO2DPU1BVQ1L,Syria's uprising began as a peaceful protest movement but has become increasingly militarized as rebels fight back against Assad's violent crackdown.,97,103,rebels,0,1,1
3XAOZ9UYRZSQOW6PCZBO2DPU1BVQ1L,Syria's uprising began as a peaceful protest movement but has become increasingly militarized as rebels fight back against Assad's violent crackdown.,131,148,violent crackdown,0,1,1
3XAOZ9UYRZSQOW6PCZBO2DPU1BVQ1L,Syria's uprising began as a peaceful protest movement but has become increasingly militarized as rebels fight back against Assad's violent crackdown.,139,148,crackdown,8,10,18
3PA41K45VN5JZ6KC12D83IQXZDO7PB,"Mr Obama sought to portray the withdrawal as an unalloyed achievement, although it remains far from certain that the Afghan government can hold its own against the Taliban with reduced US support, or that what were once considered critical US goals in the country can still be met.",9,15,sought,4,6,10
3PA41K45VN5JZ6KC12D83IQXZDO7PB,"Mr Obama sought to portray the withdrawal as an unalloyed achievement, although it remains far from certain that the Afghan government can hold its own against the Taliban with reduced US support, or that what were once considered critical US goals in the country can still be met.",9,26,sought to portray,0,1,1
3PA41K45VN5JZ6KC12D83IQXZDO7PB,"Mr Obama sought to portray the withdrawal as an unalloyed achievement, although it remains far from certain that the Afghan government can hold its own against the Taliban with reduced US support, or that what were once considered critical US goals in the country can still be met.",19,26,portray,6,10,16
3PA41K45VN5JZ6KC12D83IQXZDO7PB,"Mr Obama sought to portray the withdrawal as an unalloyed achievement, although it remains far from certain that the Afghan government can hold its own against the Taliban with reduced US support, or that what were once considered critical US goals in the country can still be met.",31,41,withdrawal,3,8,11
3PA41K45VN5JZ6KC12D83IQXZDO7PB,"Mr Obama sought to portray the withdrawal as an unalloyed achievement, although it remains far from certain that the Afghan government can hold its own against the Taliban with reduced US support, or that what were once considered critical US goals in the country can still be met.",48,57,unalloyed,9,10,19
3PA41K45VN5JZ6KC12D83IQXZDO7PB,"Mr Obama sought to portray the withdrawal as an unalloyed achievement, although it remains far from certain that the Afghan government can hold its own against the Taliban with reduced US support, or that what were once considered critical US goals in the country can still be met.",48,69,unalloyed achievement,5,3,8
3PA41K45VN5JZ6KC12D83IQXZDO7PB,"Mr Obama sought to portray the withdrawal as an unalloyed achievement, although it remains far from certain that the Afghan government can hold its own against the Taliban with reduced US support, or that what were once considered critical US goals in the country can still be met.",58,69,achievement,1,0,1
3PA41K45VN5JZ6KC12D83IQXZDO7PB,"Mr Obama sought to portray the withdrawal as an unalloyed achievement, although it remains far from certain that the Afghan government can hold its own against the Taliban with reduced US support, or that what were once considered critical US goals in the country can still be met.",91,107,far from certain,1,0,1
3PA41K45VN5JZ6KC12D83IQXZDO7PB,"Mr Obama sought to portray the withdrawal as an unalloyed achievement, although it remains far from certain that the Afghan government can hold its own against the Taliban with reduced US support, or that what were once considered critical US goals in the country can still be met.",177,184,reduced,1,3,4
3PA41K45VN5JZ6KC12D83IQXZDO7PB,"Mr Obama sought to portray the withdrawal as an unalloyed achievement, although it remains far from certain that the Afghan government can hold its own against the Taliban with reduced US support, or that what were once considered critical US goals in the country can still be met.",220,230,considered,1,2,3
3PA41K45VN5JZ6KC12D83IQXZDO7PB,"Mr Obama sought to portray the withdrawal as an unalloyed achievement, although it remains far from certain that the Afghan government can hold its own against the Taliban with reduced US support, or that what were once considered critical US goals in the country can still be met.",231,239,critical,2,3,5
3PA41K45VN5JZ6KC12D83IQXZDO7PB,"Mr Obama's  six-hour visit, ending a year to the day after Osama bin Laden was killed in a raid in  Pakistan, was laden with symbolism, historic and political.",91,95,raid,0,1,1
3PA41K45VN5JZ6KC12D83IQXZDO7PB,"Mr Obama's  six-hour visit, ending a year to the day after Osama bin Laden was killed in a raid in  Pakistan, was laden with symbolism, historic and political.",114,119,laden,6,3,9
3PA41K45VN5JZ6KC12D83IQXZDO7PB,"Mr Obama's  six-hour visit, ending a year to the day after Osama bin Laden was killed in a raid in  Pakistan, was laden with symbolism, historic and political.",114,134,laden with symbolism,1,1,2
3PA41K45VN5JZ6KC12D83IQXZDO7PB,"Mr Obama's  six-hour visit, ending a year to the day after Osama bin Laden was killed in a raid in  Pakistan, was laden with symbolism, historic and political.",125,134,symbolism,10,9,19
3PA41K45VN5JZ6KC12D83IQXZDO7PB,"Mr Obama's  six-hour visit, ending a year to the day after Osama bin Laden was killed in a raid in  Pakistan, was laden with symbolism, historic and political.",136,144,historic,1,1,2
3PA41K45VN5JZ6KC12D83IQXZDO7PB,"Mr Obama's  six-hour visit, ending a year to the day after Osama bin Laden was killed in a raid in  Pakistan, was laden with symbolism, historic and political.",149,158,political,2,0,2
3PA41K45VN5JZ6KC12D83IQXZDO7PB,"Speaking from the country where the September 11 terrorist attacks were incubated, Mr Obama suggested  America had come full circle.''",49,58,terrorist,0,1,1
3PA41K45VN5JZ6KC12D83IQXZDO7PB,"Speaking from the country where the September 11 terrorist attacks were incubated, Mr Obama suggested  America had come full circle.''",72,81,incubated,10,10,20
3PA41K45VN5JZ6KC12D83IQXZDO7PB,"Speaking from the country where the September 11 terrorist attacks were incubated, Mr Obama suggested  America had come full circle.''",92,101,suggested,2,3,5
3PA41K45VN5JZ6KC12D83IQXZDO7PB,"Speaking from the country where the September 11 terrorist attacks were incubated, Mr Obama suggested  America had come full circle.''",111,131,had come full circle,1,1,2
3PA41K45VN5JZ6KC12D83IQXZDO7PB,"Speaking from the country where the September 11 terrorist attacks were incubated, Mr Obama suggested  America had come full circle.''",115,131,come full circle,1,1,2
3PA41K45VN5JZ6KC12D83IQXZDO7PB,"Speaking from the country where the September 11 terrorist attacks were incubated, Mr Obama suggested  America had come full circle.''",120,131,full circle,1,2,3
3PA41K45VN5JZ6KC12D83IQXZDO7PB,"One year ago, from a base here in Afghanistan, our troops launched the operation that killed Osama bin Laden,'' he said. ''",58,66,launched,5,1,6
3PA41K45VN5JZ6KC12D83IQXZDO7PB,"One year ago, from a base here in Afghanistan, our troops launched the operation that killed Osama bin Laden,'' he said. ''",58,80,launched the operation,1,0,1
3PA41K45VN5JZ6KC12D83IQXZDO7PB,"One year ago, from a base here in Afghanistan, our troops launched the operation that killed Osama bin Laden,'' he said. ''",71,80,operation,3,2,5
3PA41K45VN5JZ6KC12D83IQXZDO7PB,"One year ago, from a base here in Afghanistan, our troops launched the operation that killed Osama bin Laden,'' he said. ''",71,92,operation that killed,0,1,1
3JVP4ZJHDPTD09XO382FF6FY5LNI0A,"Al Qaeda is still there.	1	9	Al Qaeda	1	0	1
3JVP4ZJHDPTD09XO382FF6FY5LNI0A	We do feel we are prevailing in this with our Afghan partners, he said.",18,28,prevailing,10,10,20
3JVP4ZJHDPTD09XO382FF6FY5LNI0A,"We do feel we are prevailing in this with our Afghan partners,"" he said.",46,52,Afghan,1,0,1
3JVP4ZJHDPTD09XO382FF6FY5LNI0A,"We cannot be in a position of taking on ourselves bringing perfection to Afghanistan.	19	30	position of	1	0	1
3JVP4ZJHDPTD09XO382FF6FY5LNI0A	We cannot be in a position of taking on ourselves bringing perfection to Afghanistan.",51,70,bringing perfection,1,0,1
3JVP4ZJHDPTD09XO382FF6FY5LNI0A,"We cannot be in a position of taking on ourselves bringing perfection to Afghanistan.	60	70	perfection	4	2	6
3JVP4ZJHDPTD09XO382FF6FY5LNI0A	We cannot be in a position of taking on ourselves bringing perfection to Afghanistan.",74,85,Afghanistan,1,0,1
3JVP4ZJHDPTD09XO382FF6FY5LNI0A,"That has to be left to Afghans.""",15,30,left to Afghans,0,1,1
3JVP4ZJHDPTD09XO382FF6FY5LNI0A,"That has to be left to Afghans.""",23,30,Afghans,1,0,1
3JVP4ZJHDPTD09XO382FF6FY5LNI0A,But Crocker said there would be no repeat of the 1990s when a withdrawal of Western backers in the wake of the Soviet withdrawal unleashed a vicious civil war out of which the Taliban and al Qaeda support bases arose.,4,11,Crocker,1,0,1
3JVP4ZJHDPTD09XO382FF6FY5LNI0A,But Crocker said there would be no repeat of the 1990s when a withdrawal of Western backers in the wake of the Soviet withdrawal unleashed a vicious civil war out of which the Taliban and al Qaeda support bases arose.,62,72,withdrawal,3,4,7
3JVP4ZJHDPTD09XO382FF6FY5LNI0A,But Crocker said there would be no repeat of the 1990s when a withdrawal of Western backers in the wake of the Soviet withdrawal unleashed a vicious civil war out of which the Taliban and al Qaeda support bases arose.,76,91,Western backers,1,2,3
3JVP4ZJHDPTD09XO382FF6FY5LNI0A,But Crocker said there would be no repeat of the 1990s when a withdrawal of Western backers in the wake of the Soviet withdrawal unleashed a vicious civil war out of which the Taliban and al Qaeda support bases arose.,84,91,backers,3,2,5
3JVP4ZJHDPTD09XO382FF6FY5LNI0A,But Crocker said there would be no repeat of the 1990s when a withdrawal of Western backers in the wake of the Soviet withdrawal unleashed a vicious civil war out of which the Taliban and al Qaeda support bases arose.,92,106,in the wake of,0,1,1
3JVP4ZJHDPTD09XO382FF6FY5LNI0A,But Crocker said there would be no repeat of the 1990s when a withdrawal of Western backers in the wake of the Soviet withdrawal unleashed a vicious civil war out of which the Taliban and al Qaeda support bases arose.,99,103,wake,1,0,1
3JVP4ZJHDPTD09XO382FF6FY5LNI0A,But Crocker said there would be no repeat of the 1990s when a withdrawal of Western backers in the wake of the Soviet withdrawal unleashed a vicious civil war out of which the Taliban and al Qaeda support bases arose.,111,128,Soviet withdrawal,1,0,1
3JVP4ZJHDPTD09XO382FF6FY5LNI0A,But Crocker said there would be no repeat of the 1990s when a withdrawal of Western backers in the wake of the Soviet withdrawal unleashed a vicious civil war out of which the Taliban and al Qaeda support bases arose.,118,128,withdrawal,0,2,2
3JVP4ZJHDPTD09XO382FF6FY5LNI0A,But Crocker said there would be no repeat of the 1990s when a withdrawal of Western backers in the wake of the Soviet withdrawal unleashed a vicious civil war out of which the Taliban and al Qaeda support bases arose.,118,138,withdrawal unleashed,0,2,2
3JVP4ZJHDPTD09XO382FF6FY5LNI0A,But Crocker said there would be no repeat of the 1990s when a withdrawal of Western backers in the wake of the Soviet withdrawal unleashed a vicious civil war out of which the Taliban and al Qaeda support bases arose.,129,138,unleashed,7,10,17
3JVP4ZJHDPTD09XO382FF6FY5LNI0A,But Crocker said there would be no repeat of the 1990s when a withdrawal of Western backers in the wake of the Soviet withdrawal unleashed a vicious civil war out of which the Taliban and al Qaeda support bases arose.,139,158,a vicious civil war,0,1,1
3JVP4ZJHDPTD09XO382FF6FY5LNI0A,But Crocker said there would be no repeat of the 1990s when a withdrawal of Western backers in the wake of the Soviet withdrawal unleashed a vicious civil war out of which the Taliban and al Qaeda support bases arose.,141,148,vicious,6,8,14
3JVP4ZJHDPTD09XO382FF6FY5LNI0A,But Crocker said there would be no repeat of the 1990s when a withdrawal of Western backers in the wake of the Soviet withdrawal unleashed a vicious civil war out of which the Taliban and al Qaeda support bases arose.,141,158,vicious civil war,2,0,2
3JVP4ZJHDPTD09XO382FF6FY5LNI0A,But Crocker said there would be no repeat of the 1990s when a withdrawal of Western backers in the wake of the Soviet withdrawal unleashed a vicious civil war out of which the Taliban and al Qaeda support bases arose.,159,171,out of which,1,0,1
3JVP4ZJHDPTD09XO382FF6FY5LNI0A,But Crocker said there would be no repeat of the 1990s when a withdrawal of Western backers in the wake of the Soviet withdrawal unleashed a vicious civil war out of which the Taliban and al Qaeda support bases arose.,176,183,Taliban,1,0,1
3JVP4ZJHDPTD09XO382FF6FY5LNI0A,But Crocker said there would be no repeat of the 1990s when a withdrawal of Western backers in the wake of the Soviet withdrawal unleashed a vicious civil war out of which the Taliban and al Qaeda support bases arose.,188,196,al Qaeda,1,0,1
3JVP4ZJHDPTD09XO382FF6FY5LNI0A,But Crocker said there would be no repeat of the 1990s when a withdrawal of Western backers in the wake of the Soviet withdrawal unleashed a vicious civil war out of which the Taliban and al Qaeda support bases arose.,197,210,support bases,0,1,1
3JVP4ZJHDPTD09XO382FF6FY5LNI0A,But Crocker said there would be no repeat of the 1990s when a withdrawal of Western backers in the wake of the Soviet withdrawal unleashed a vicious civil war out of which the Taliban and al Qaeda support bases arose.,211,216,arose,4,3,7
3JVP4ZJHDPTD09XO382FF6FY5LNI0A,"Taliban bombers attacked a heavily fortified guesthouse used by Westerners in Kabul on Wednesday, announcing the start of their annual in defiance of calls from visiting US President Barack Obama that the war was ending.",27,44,heavily fortified,1,1,2
3JVP4ZJHDPTD09XO382FF6FY5LNI0A,"Taliban bombers attacked a heavily fortified guesthouse used by Westerners in Kabul on Wednesday, announcing the start of their annual in defiance of calls from visiting US President Barack Obama that the war was ending.",27,55,heavily fortified guesthouse,1,0,1
3JVP4ZJHDPTD09XO382FF6FY5LNI0A,"Taliban bombers attacked a heavily fortified guesthouse used by Westerners in Kabul on Wednesday, announcing the start of their annual in defiance of calls from visiting US President Barack Obama that the war was ending.",35,44,fortified,10,9,19
3JVP4ZJHDPTD09XO382FF6FY5LNI0A,"Taliban bombers attacked a heavily fortified guesthouse used by Westerners in Kabul on Wednesday, announcing the start of their annual in defiance of calls from visiting US President Barack Obama that the war was ending.",35,55,fortified guesthouse,1,0,1
3JVP4ZJHDPTD09XO382FF6FY5LNI0A,"Taliban bombers attacked a heavily fortified guesthouse used by Westerners in Kabul on Wednesday, announcing the start of their annual in defiance of calls from visiting US President Barack Obama that the war was ending.",45,55,guesthouse,0,1,1
3JVP4ZJHDPTD09XO382FF6FY5LNI0A,"Taliban bombers attacked a heavily fortified guesthouse used by Westerners in Kabul on Wednesday, announcing the start of their annual in defiance of calls from visiting US President Barack Obama that the war was ending.",98,108,announcing,2,2,4
3JVP4ZJHDPTD09XO382FF6FY5LNI0A,"Taliban bombers attacked a heavily fortified guesthouse used by Westerners in Kabul on Wednesday, announcing the start of their annual in defiance of calls from visiting US President Barack Obama that the war was ending.",128,134,annual,1,0,1
3JVP4ZJHDPTD09XO382FF6FY5LNI0A,"Taliban bombers attacked a heavily fortified guesthouse used by Westerners in Kabul on Wednesday, announcing the start of their annual in defiance of calls from visiting US President Barack Obama that the war was ending.",128,146,annual in defiance,1,0,1
3JVP4ZJHDPTD09XO382FF6FY5LNI0A,"Taliban bombers attacked a heavily fortified guesthouse used by Westerners in Kabul on Wednesday, announcing the start of their annual in defiance of calls from visiting US President Barack Obama that the war was ending.",135,146,in defiance,1,1,2
3JVP4ZJHDPTD09XO382FF6FY5LNI0A,"Taliban bombers attacked a heavily fortified guesthouse used by Westerners in Kabul on Wednesday, announcing the start of their annual in defiance of calls from visiting US President Barack Obama that the war was ending.",135,155,in defiance of calls,1,0,1
3JVP4ZJHDPTD09XO382FF6FY5LNI0A,"Taliban bombers attacked a heavily fortified guesthouse used by Westerners in Kabul on Wednesday, announcing the start of their annual in defiance of calls from visiting US President Barack Obama that the war was ending.",138,146,defiance,10,9,19
3JVP4ZJHDPTD09XO382FF6FY5LNI0A,"Taliban bombers attacked a heavily fortified guesthouse used by Westerners in Kabul on Wednesday, announcing the start of their annual in defiance of calls from visiting US President Barack Obama that the war was ending.",183,195,Barack Obama,1,0,1
3JVP4ZJHDPTD09XO382FF6FY5LNI0A,"Seven people were killed after attackers in burqas detonated a suicide car bomb and clashed with guards at the ""Green Village"" complex of guesthouses used by the European Union, the United Nations and aid groups, officials said.",44,50,burqas,5,2,7
3JVP4ZJHDPTD09XO382FF6FY5LNI0A,"Seven people were killed after attackers in burqas detonated a suicide car bomb and clashed with guards at the ""Green Village"" complex of guesthouses used by the European Union, the United Nations and aid groups, officials said.",44,60,burqas detonated,3,0,3
3JVP4ZJHDPTD09XO382FF6FY5LNI0A,"Seven people were killed after attackers in burqas detonated a suicide car bomb and clashed with guards at the ""Green Village"" complex of guesthouses used by the European Union, the United Nations and aid groups, officials said.",51,60,detonated,6,6,12
3JVP4ZJHDPTD09XO382FF6FY5LNI0A,"Seven people were killed after attackers in burqas detonated a suicide car bomb and clashed with guards at the ""Green Village"" complex of guesthouses used by the European Union, the United Nations and aid groups, officials said.",63,70,suicide,0,1,1
3JVP4ZJHDPTD09XO382FF6FY5LNI0A,"Seven people were killed after attackers in burqas detonated a suicide car bomb and clashed with guards at the ""Green Village"" complex of guesthouses used by the European Union, the United Nations and aid groups, officials said.",63,79,suicide car bomb,1,0,1
3JVP4ZJHDPTD09XO382FF6FY5LNI0A,"Seven people were killed after attackers in burqas detonated a suicide car bomb and clashed with guards at the ""Green Village"" complex of guesthouses used by the European Union, the United Nations and aid groups, officials said.",84,91,clashed,2,4,6
3JVP4ZJHDPTD09XO382FF6FY5LNI0A,"Seven people were killed after attackers in burqas detonated a suicide car bomb and clashed with guards at the ""Green Village"" complex of guesthouses used by the European Union, the United Nations and aid groups, officials said.",127,134,complex,2,0,2
3JVP4ZJHDPTD09XO382FF6FY5LNI0A,"Seven people were killed after attackers in burqas detonated a suicide car bomb and clashed with guards at the ""Green Village"" complex of guesthouses used by the European Union, the United Nations and aid groups, officials said.",138,149,guesthouses,2,1,3
3JVP4ZJHDPTD09XO382FF6FY5LNI0A,"Seven people were killed after attackers in burqas detonated a suicide car bomb and clashed with guards at the ""Green Village"" complex of guesthouses used by the European Union, the United Nations and aid groups, officials said.",201,211,aid groups,1,0,1
3JVP4ZJHDPTD09XO382FF6FY5LNI0A,"Seven people were killed after attackers in burqas detonated a suicide car bomb and clashed with guards at the ""Green Village"" complex of guesthouses used by the European Union, the United Nations and aid groups, officials said.",213,222,officials,2,0,2
39O0SQZVJN84BJ0REUHX8DQC1W07RU,He also dismissed allegations of corruption among his United Russia party members.,8,17,dismissed,5,1,6
39O0SQZVJN84BJ0REUHX8DQC1W07RU,He also dismissed allegations of corruption among his United Russia party members.,8,29,dismissed allegations,3,1,4
39O0SQZVJN84BJ0REUHX8DQC1W07RU,He also dismissed allegations of corruption among his United Russia party members.,18,29,allegations,10,10,20
39O0SQZVJN84BJ0REUHX8DQC1W07RU,He also dismissed allegations of corruption among his United Russia party members.,18,43,allegations of corruption,3,0,3
39O0SQZVJN84BJ0REUHX8DQC1W07RU,He also dismissed allegations of corruption among his United Russia party members.,33,43,corruption,8,5,13
39O0SQZVJN84BJ0REUHX8DQC1W07RU,He also dismissed allegations of corruption among his United Russia party members.,54,73,United Russia party,1,0,1
39O0SQZVJN84BJ0REUHX8DQC1W07RU,"A Philippine warship was in a standoff with Chinese surveillance ships Wednesday in disputed waters of the Spratly Islands, Philippine officials said.",13,20,warship,1,0,1
39O0SQZVJN84BJ0REUHX8DQC1W07RU,"A Philippine warship was in a standoff with Chinese surveillance ships Wednesday in disputed waters of the Spratly Islands, Philippine officials said.",30,38,standoff,5,10,15
39O0SQZVJN84BJ0REUHX8DQC1W07RU,"A Philippine warship was in a standoff with Chinese surveillance ships Wednesday in disputed waters of the Spratly Islands, Philippine officials said.",52,64,surveillance,10,7,17
39O0SQZVJN84BJ0REUHX8DQC1W07RU,"A Philippine warship was in a standoff with Chinese surveillance ships Wednesday in disputed waters of the Spratly Islands, Philippine officials said.",52,70,surveillance ships,2,1,3
39O0SQZVJN84BJ0REUHX8DQC1W07RU,"A Philippine warship was in a standoff with Chinese surveillance ships Wednesday in disputed waters of the Spratly Islands, Philippine officials said.",84,92,disputed,6,3,9
39O0SQZVJN84BJ0REUHX8DQC1W07RU,"A Philippine warship was in a standoff with Chinese surveillance ships Wednesday in disputed waters of the Spratly Islands, Philippine officials said.",84,99,disputed waters,0,4,4
39O0SQZVJN84BJ0REUHX8DQC1W07RU,"A Philippine warship was in a standoff with Chinese surveillance ships Wednesday in disputed waters of the Spratly Islands, Philippine officials said.",107,122,Spratly Islands,1,0,1
39O0SQZVJN84BJ0REUHX8DQC1W07RU,"The Philippine Foreign Affairs Department said the situation developed Tuesday when the Chinese surveillance ships placed themselves between the Philippine patrol boat BRP Gregorio del Pilar and several Chinese fishing boats, GMA News reported The face-off was playing out near Scarborough, or Panatag, Shoal, which both the Philippines and China claim.",51,60,situation,0,1,1
39O0SQZVJN84BJ0REUHX8DQC1W07RU,"The Philippine Foreign Affairs Department said the situation developed Tuesday when the Chinese surveillance ships placed themselves between the Philippine patrol boat BRP Gregorio del Pilar and several Chinese fishing boats, GMA News reported The face-off was playing out near Scarborough, or Panatag, Shoal, which both the Philippines and China claim.",61,70,developed,0,1,1
39O0SQZVJN84BJ0REUHX8DQC1W07RU,"The Philippine Foreign Affairs Department said the situation developed Tuesday when the Chinese surveillance ships placed themselves between the Philippine patrol boat BRP Gregorio del Pilar and several Chinese fishing boats, GMA News reported The face-off was playing out near Scarborough, or Panatag, Shoal, which both the Philippines and China claim.",96,108,surveillance,5,2,7
39O0SQZVJN84BJ0REUHX8DQC1W07RU,"The Philippine Foreign Affairs Department said the situation developed Tuesday when the Chinese surveillance ships placed themselves between the Philippine patrol boat BRP Gregorio del Pilar and several Chinese fishing boats, GMA News reported The face-off was playing out near Scarborough, or Panatag, Shoal, which both the Philippines and China claim.",96,114,surveillance ships,0,1,1
39O0SQZVJN84BJ0REUHX8DQC1W07RU,"The Philippine Foreign Affairs Department said the situation developed Tuesday when the Chinese surveillance ships placed themselves between the Philippine patrol boat BRP Gregorio del Pilar and several Chinese fishing boats, GMA News reported The face-off was playing out near Scarborough, or Panatag, Shoal, which both the Philippines and China claim.",156,162,patrol,1,1,2
39O0SQZVJN84BJ0REUHX8DQC1W07RU,"The Philippine Foreign Affairs Department said the situation developed Tuesday when the Chinese surveillance ships placed themselves between the Philippine patrol boat BRP Gregorio del Pilar and several Chinese fishing boats, GMA News reported The face-off was playing out near Scarborough, or Panatag, Shoal, which both the Philippines and China claim.",156,167,patrol boat,0,1,1
39O0SQZVJN84BJ0REUHX8DQC1W07RU,"The Philippine Foreign Affairs Department said the situation developed Tuesday when the Chinese surveillance ships placed themselves between the Philippine patrol boat BRP Gregorio del Pilar and several Chinese fishing boats, GMA News reported The face-off was playing out near Scarborough, or Panatag, Shoal, which both the Philippines and China claim.",248,256,face-off,5,6,11
39O0SQZVJN84BJ0REUHX8DQC1W07RU,"The Philippine Foreign Affairs Department said the situation developed Tuesday when the Chinese surveillance ships placed themselves between the Philippine patrol boat BRP Gregorio del Pilar and several Chinese fishing boats, GMA News reported The face-off was playing out near Scarborough, or Panatag, Shoal, which both the Philippines and China claim.",261,272,playing out,1,0,1
39O0SQZVJN84BJ0REUHX8DQC1W07RU,"The Philippine Foreign Affairs Department said the situation developed Tuesday when the Chinese surveillance ships placed themselves between the Philippine patrol boat BRP Gregorio del Pilar and several Chinese fishing boats, GMA News reported The face-off was playing out near Scarborough, or Panatag, Shoal, which both the Philippines and China claim.",303,308,Shoal,1,0,1
39O0SQZVJN84BJ0REUHX8DQC1W07RU,"Foreign Affairs Secretary Albert del Rosario was seeking a diplomatic solution with Chinese Ambassador Ma Keqing, the TV network said.",49,56,seeking,0,1,1
39O0SQZVJN84BJ0REUHX8DQC1W07RU,"Foreign Affairs Secretary Albert del Rosario was seeking a diplomatic solution with Chinese Ambassador Ma Keqing, the TV network said.",59,69,diplomatic,5,5,10
39O0SQZVJN84BJ0REUHX8DQC1W07RU,"Foreign Affairs Secretary Albert del Rosario was seeking a diplomatic solution with Chinese Ambassador Ma Keqing, the TV network said.",59,78,diplomatic solution,3,3,6
39O0SQZVJN84BJ0REUHX8DQC1W07RU,"Foreign Affairs Secretary Albert del Rosario was seeking a diplomatic solution with Chinese Ambassador Ma Keqing, the TV network said.",92,102,Ambassador,1,0,1
39O0SQZVJN84BJ0REUHX8DQC1W07RU,The Chinese Embassy said it had received a report that a dozen Chinese fishing boats had taken refuge in a lagoon of Huangyan Island to escape foul weather when the Philippine gunboat blocked the lagoon entrance and sent 12 Philippine soldiers to harass the Chinese fishermen.,32,40,received,0,1,1
39O0SQZVJN84BJ0REUHX8DQC1W07RU,The Chinese Embassy said it had received a report that a dozen Chinese fishing boats had taken refuge in a lagoon of Huangyan Island to escape foul weather when the Philippine gunboat blocked the lagoon entrance and sent 12 Philippine soldiers to harass the Chinese fishermen.,89,101,taken refuge,2,0,2
39O0SQZVJN84BJ0REUHX8DQC1W07RU,The Chinese Embassy said it had received a report that a dozen Chinese fishing boats had taken refuge in a lagoon of Huangyan Island to escape foul weather when the Philippine gunboat blocked the lagoon entrance and sent 12 Philippine soldiers to harass the Chinese fishermen.,95,101,refuge,7,5,12
39O0SQZVJN84BJ0REUHX8DQC1W07RU,The Chinese Embassy said it had received a report that a dozen Chinese fishing boats had taken refuge in a lagoon of Huangyan Island to escape foul weather when the Philippine gunboat blocked the lagoon entrance and sent 12 Philippine soldiers to harass the Chinese fishermen.,107,113,lagoon,5,4,9
39O0SQZVJN84BJ0REUHX8DQC1W07RU,The Chinese Embassy said it had received a report that a dozen Chinese fishing boats had taken refuge in a lagoon of Huangyan Island to escape foul weather when the Philippine gunboat blocked the lagoon entrance and sent 12 Philippine soldiers to harass the Chinese fishermen.,136,142,escape,0,2,2
39O0SQZVJN84BJ0REUHX8DQC1W07RU,The Chinese Embassy said it had received a report that a dozen Chinese fishing boats had taken refuge in a lagoon of Huangyan Island to escape foul weather when the Philippine gunboat blocked the lagoon entrance and sent 12 Philippine soldiers to harass the Chinese fishermen.,143,147,foul,0,2,2
39O0SQZVJN84BJ0REUHX8DQC1W07RU,The Chinese Embassy said it had received a report that a dozen Chinese fishing boats had taken refuge in a lagoon of Huangyan Island to escape foul weather when the Philippine gunboat blocked the lagoon entrance and sent 12 Philippine soldiers to harass the Chinese fishermen.,143,155,foul weather,2,3,5
39O0SQZVJN84BJ0REUHX8DQC1W07RU,The Chinese Embassy said it had received a report that a dozen Chinese fishing boats had taken refuge in a lagoon of Huangyan Island to escape foul weather when the Philippine gunboat blocked the lagoon entrance and sent 12 Philippine soldiers to harass the Chinese fishermen.,176,183,gunboat,1,1,2
39O0SQZVJN84BJ0REUHX8DQC1W07RU,The Chinese Embassy said it had received a report that a dozen Chinese fishing boats had taken refuge in a lagoon of Huangyan Island to escape foul weather when the Philippine gunboat blocked the lagoon entrance and sent 12 Philippine soldiers to harass the Chinese fishermen.,247,253,harass,6,9,15
3MQKOF1EE2PP0OIN41UPV48PE9FDW2,"However, Olli Rehn, the EU's monetary affairs chief, said the European Commission has full confidence in the determination of the Spanish government to meet the fiscal targets.",9,18,Olli Rehn,1,0,1
3MQKOF1EE2PP0OIN41UPV48PE9FDW2,"However, Olli Rehn, the EU's monetary affairs chief, said the European Commission has full confidence in the determination of the Spanish government to meet the fiscal targets.",24,50,EUs monetary affairs chief,1,0,1
3MQKOF1EE2PP0OIN41UPV48PE9FDW2,"However, Olli Rehn, the EU's monetary affairs chief, said the European Commission has full confidence in the determination of the Spanish government to meet the fiscal targets.",29,37,monetary,5,3,8
3MQKOF1EE2PP0OIN41UPV48PE9FDW2,"However, Olli Rehn, the EU's monetary affairs chief, said the European Commission has full confidence in the determination of the Spanish government to meet the fiscal targets.",29,45,monetary affairs,3,4,7
3MQKOF1EE2PP0OIN41UPV48PE9FDW2,"However, Olli Rehn, the EU's monetary affairs chief, said the European Commission has full confidence in the determination of the Spanish government to meet the fiscal targets.",29,51,monetary affairs chief,2,0,2
3MQKOF1EE2PP0OIN41UPV48PE9FDW2,"However, Olli Rehn, the EU's monetary affairs chief, said the European Commission has full confidence in the determination of the Spanish government to meet the fiscal targets.",71,81,Commission,0,1,1
3MQKOF1EE2PP0OIN41UPV48PE9FDW2,"However, Olli Rehn, the EU's monetary affairs chief, said the European Commission has full confidence in the determination of the Spanish government to meet the fiscal targets.",91,101,confidence,3,3,6
3MQKOF1EE2PP0OIN41UPV48PE9FDW2,"However, Olli Rehn, the EU's monetary affairs chief, said the European Commission has full confidence in the determination of the Spanish government to meet the fiscal targets.",109,122,determination,7,4,11
3MQKOF1EE2PP0OIN41UPV48PE9FDW2,"However, Olli Rehn, the EU's monetary affairs chief, said the European Commission has full confidence in the determination of the Spanish government to meet the fiscal targets.",161,167,fiscal,5,7,12
3MQKOF1EE2PP0OIN41UPV48PE9FDW2,"However, Olli Rehn, the EU's monetary affairs chief, said the European Commission has full confidence in the determination of the Spanish government to meet the fiscal targets.",161,175,fiscal targets,7,3,10
3MQKOF1EE2PP0OIN41UPV48PE9FDW2,"However, Olli Rehn, the EU's monetary affairs chief, said the European Commission has full confidence in the determination of the Spanish government to meet the fiscal targets.",168,175,targets,1,0,1
3MQKOF1EE2PP0OIN41UPV48PE9FDW2,He said that the key to restoring confidence and growth for Spain was to tackle the immediate fiscal and financial challenges with full determination.,24,33,restoring,4,2,6
3MQKOF1EE2PP0OIN41UPV48PE9FDW2,He said that the key to restoring confidence and growth for Spain was to tackle the immediate fiscal and financial challenges with full determination.,24,44,restoring confidence,0,1,1
3MQKOF1EE2PP0OIN41UPV48PE9FDW2,He said that the key to restoring confidence and growth for Spain was to tackle the immediate fiscal and financial challenges with full determination.,24,55,restoring confidence and growth,1,0,1
3MQKOF1EE2PP0OIN41UPV48PE9FDW2,He said that the key to restoring confidence and growth for Spain was to tackle the immediate fiscal and financial challenges with full determination.,49,55,growth,0,1,1
3MQKOF1EE2PP0OIN41UPV48PE9FDW2,He said that the key to restoring confidence and growth for Spain was to tackle the immediate fiscal and financial challenges with full determination.,73,79,tackle,2,7,9
3MQKOF1EE2PP0OIN41UPV48PE9FDW2,He said that the key to restoring confidence and growth for Spain was to tackle the immediate fiscal and financial challenges with full determination.,94,100,fiscal,7,2,9
3MQKOF1EE2PP0OIN41UPV48PE9FDW2,He said that the key to restoring confidence and growth for Spain was to tackle the immediate fiscal and financial challenges with full determination.,94,125,fiscal and financial challenges,1,1,2
3MQKOF1EE2PP0OIN41UPV48PE9FDW2,He said that the key to restoring confidence and growth for Spain was to tackle the immediate fiscal and financial challenges with full determination.,105,114,financial,1,0,1
3MQKOF1EE2PP0OIN41UPV48PE9FDW2,He said that the key to restoring confidence and growth for Spain was to tackle the immediate fiscal and financial challenges with full determination.,115,125,challenges,0,1,1
3MQKOF1EE2PP0OIN41UPV48PE9FDW2,He said that the key to restoring confidence and growth for Spain was to tackle the immediate fiscal and financial challenges with full determination.,136,149,determination,1,1,2
3MQKOF1EE2PP0OIN41UPV48PE9FDW2,"The government in Spain has announced a new set of financial reforms, particularly aimed at cleaning up the country's banking system, which is saddled with bad loans.",28,37,announced,0,1,1
3MQKOF1EE2PP0OIN41UPV48PE9FDW2,"The government in Spain has announced a new set of financial reforms, particularly aimed at cleaning up the country's banking system, which is saddled with bad loans.",51,68,financial reforms,6,1,7
3MQKOF1EE2PP0OIN41UPV48PE9FDW2,"The government in Spain has announced a new set of financial reforms, particularly aimed at cleaning up the country's banking system, which is saddled with bad loans.",61,68,reforms,2,3,5
3MQKOF1EE2PP0OIN41UPV48PE9FDW2,"The government in Spain has announced a new set of financial reforms, particularly aimed at cleaning up the country's banking system, which is saddled with bad loans.",70,82,particularly,1,1,2
3MQKOF1EE2PP0OIN41UPV48PE9FDW2,"The government in Spain has announced a new set of financial reforms, particularly aimed at cleaning up the country's banking system, which is saddled with bad loans.",83,88,aimed,0,1,1
3MQKOF1EE2PP0OIN41UPV48PE9FDW2,"The government in Spain has announced a new set of financial reforms, particularly aimed at cleaning up the country's banking system, which is saddled with bad loans.",143,150,saddled,10,10,20
3MQKOF1EE2PP0OIN41UPV48PE9FDW2,"The government in Spain has announced a new set of financial reforms, particularly aimed at cleaning up the country's banking system, which is saddled with bad loans.",143,165,saddled with bad loans,1,0,1
3MQKOF1EE2PP0OIN41UPV48PE9FDW2,"The government in Spain has announced a new set of financial reforms, particularly aimed at cleaning up the country's banking system, which is saddled with bad loans.",156,165,bad loans,0,1,1
3MQKOF1EE2PP0OIN41UPV48PE9FDW2,It approved measures forcing banks to set aside a new 30bn euro ($39bn) financial cushion on top of 54bn euros ordered in February as insurance against bad loans on property.,3,11,approved,1,0,1
3MQKOF1EE2PP0OIN41UPV48PE9FDW2,It approved measures forcing banks to set aside a new 30bn euro ($39bn) financial cushion on top of 54bn euros ordered in February as insurance against bad loans on property.,12,20,measures,2,1,3
3MQKOF1EE2PP0OIN41UPV48PE9FDW2,It approved measures forcing banks to set aside a new 30bn euro ($39bn) financial cushion on top of 54bn euros ordered in February as insurance against bad loans on property.,38,47,set aside,0,1,1
3MQKOF1EE2PP0OIN41UPV48PE9FDW2,It approved measures forcing banks to set aside a new 30bn euro ($39bn) financial cushion on top of 54bn euros ordered in February as insurance against bad loans on property.,42,47,aside,0,1,1
3MQKOF1EE2PP0OIN41UPV48PE9FDW2,It approved measures forcing banks to set aside a new 30bn euro ($39bn) financial cushion on top of 54bn euros ordered in February as insurance against bad loans on property.,72,89,financial cushion,8,2,10
3MQKOF1EE2PP0OIN41UPV48PE9FDW2,It approved measures forcing banks to set aside a new 30bn euro ($39bn) financial cushion on top of 54bn euros ordered in February as insurance against bad loans on property.,82,89,cushion,1,3,4
3MQKOF1EE2PP0OIN41UPV48PE9FDW2,It approved measures forcing banks to set aside a new 30bn euro ($39bn) financial cushion on top of 54bn euros ordered in February as insurance against bad loans on property.,152,161,bad loans,1,0,1
3MQKOF1EE2PP0OIN41UPV48PE9FDW2,The new rules also require banks to separate property assets from their balance sheets.,36,44,separate,1,0,1
3MQKOF1EE2PP0OIN41UPV48PE9FDW2,The new rules also require banks to separate property assets from their balance sheets.,45,60,property assets,2,1,3
3MQKOF1EE2PP0OIN41UPV48PE9FDW2,The new rules also require banks to separate property assets from their balance sheets.,54,60,assets,5,2,7
3MQKOF1EE2PP0OIN41UPV48PE9FDW2,The new rules also require banks to separate property assets from their balance sheets.,72,86,balance sheets,7,2,9
36GJS3V78VR66OSFZSCICZHEP5MGJK,"As a result, with the recession, so many people were left unable to pay for their mortgages, and the banks are left to deal with the after-effects, she said.",23,32,recession,10,10,20
36GJS3V78VR66OSFZSCICZHEP5MGJK,"As a result, with the recession, so many people were left unable to pay for their mortgages, and the banks are left to deal with the after-effects, she said.",59,65,unable,0,1,1
36GJS3V78VR66OSFZSCICZHEP5MGJK,"As a result, with the recession, so many people were left unable to pay for their mortgages, and the banks are left to deal with the after-effects, she said.",83,92,mortgages,10,10,20
36GJS3V78VR66OSFZSCICZHEP5MGJK,"As a result, with the recession, so many people were left unable to pay for their mortgages, and the banks are left to deal with the after-effects, she said.",134,147,after-effects,9,4,13
36GJS3V78VR66OSFZSCICZHEP5MGJK,"A resident of Madrid told Al Jazeera: ""It's not the fault of the people who bought their homes with mortgages that they might not have been able to afford.",2,10,resident,1,2,3
36GJS3V78VR66OSFZSCICZHEP5MGJK,"A resident of Madrid told Al Jazeera: ""It's not the fault of the people who bought their homes with mortgages that they might not have been able to afford.",52,57,fault,0,1,1
36GJS3V78VR66OSFZSCICZHEP5MGJK,"A resident of Madrid told Al Jazeera: ""It's not the fault of the people who bought their homes with mortgages that they might not have been able to afford.",76,82,bought,0,1,1
36GJS3V78VR66OSFZSCICZHEP5MGJK,"A resident of Madrid told Al Jazeera: ""It's not the fault of the people who bought their homes with mortgages that they might not have been able to afford.",100,109,mortgages,5,2,7
36GJS3V78VR66OSFZSCICZHEP5MGJK,"A resident of Madrid told Al Jazeera: ""It's not the fault of the people who bought their homes with mortgages that they might not have been able to afford.",148,154,afford,2,5,7
36GJS3V78VR66OSFZSCICZHEP5MGJK,"It's the fault of the politicians and those making bad lending decisions with our economy, Shrinking eurozone The developments come amid the release by the EU of new figures confirming that the eurozone will shrink 0.3 per cent in 2012.",23,34,politicians,3,0,3
36GJS3V78VR66OSFZSCICZHEP5MGJK,"It's the fault of the politicians and those making bad lending decisions with our economy, Shrinking eurozone The developments come amid the release by the EU of new figures confirming that the eurozone will shrink 0.3 per cent in 2012.",52,73,bad lending decisions,2,1,3
36GJS3V78VR66OSFZSCICZHEP5MGJK,"It's the fault of the politicians and those making bad lending decisions with our economy, Shrinking eurozone The developments come amid the release by the EU of new figures confirming that the eurozone will shrink 0.3 per cent in 2012.",56,63,lending,1,5,6
36GJS3V78VR66OSFZSCICZHEP5MGJK,"It's the fault of the politicians and those making bad lending decisions with our economy, Shrinking eurozone The developments come amid the release by the EU of new figures confirming that the eurozone will shrink 0.3 per cent in 2012.",56,73,lending decisions,0,1,1
36GJS3V78VR66OSFZSCICZHEP5MGJK,"It's the fault of the politicians and those making bad lending decisions with our economy, Shrinking eurozone The developments come amid the release by the EU of new figures confirming that the eurozone will shrink 0.3 per cent in 2012.",64,73,decisions,0,1,1
36GJS3V78VR66OSFZSCICZHEP5MGJK,"It's the fault of the politicians and those making bad lending decisions with our economy, Shrinking eurozone The developments come amid the release by the EU of new figures confirming that the eurozone will shrink 0.3 per cent in 2012.",83,90,economy,3,1,4
36GJS3V78VR66OSFZSCICZHEP5MGJK,"It's the fault of the politicians and those making bad lending decisions with our economy, Shrinking eurozone The developments come amid the release by the EU of new figures confirming that the eurozone will shrink 0.3 per cent in 2012.",93,102,Shrinking,2,3,5
36GJS3V78VR66OSFZSCICZHEP5MGJK,"It's the fault of the politicians and those making bad lending decisions with our economy, Shrinking eurozone The developments come amid the release by the EU of new figures confirming that the eurozone will shrink 0.3 per cent in 2012.",93,111,Shrinking eurozone,0,1,1
36GJS3V78VR66OSFZSCICZHEP5MGJK,"It's the fault of the politicians and those making bad lending decisions with our economy, Shrinking eurozone The developments come amid the release by the EU of new figures confirming that the eurozone will shrink 0.3 per cent in 2012.",103,111,eurozone,8,1,9
36GJS3V78VR66OSFZSCICZHEP5MGJK,"It's the fault of the politicians and those making bad lending decisions with our economy, Shrinking eurozone The developments come amid the release by the EU of new figures confirming that the eurozone will shrink 0.3 per cent in 2012.",116,128,developments,2,2,4
36GJS3V78VR66OSFZSCICZHEP5MGJK,"It's the fault of the politicians and those making bad lending decisions with our economy, Shrinking eurozone The developments come amid the release by the EU of new figures confirming that the eurozone will shrink 0.3 per cent in 2012.",134,138,amid,5,5,10
36GJS3V78VR66OSFZSCICZHEP5MGJK,"It's the fault of the politicians and those making bad lending decisions with our economy, Shrinking eurozone The developments come amid the release by the EU of new figures confirming that the eurozone will shrink 0.3 per cent in 2012.",164,175,new figures,1,0,1
36GJS3V78VR66OSFZSCICZHEP5MGJK,"It's the fault of the politicians and those making bad lending decisions with our economy, Shrinking eurozone The developments come amid the release by the EU of new figures confirming that the eurozone will shrink 0.3 per cent in 2012.",176,186,confirming,1,2,3
36GJS3V78VR66OSFZSCICZHEP5MGJK,"It's the fault of the politicians and those making bad lending decisions with our economy, Shrinking eurozone The developments come amid the release by the EU of new figures confirming that the eurozone will shrink 0.3 per cent in 2012.",196,204,eurozone,5,0,5
36GJS3V78VR66OSFZSCICZHEP5MGJK,"It's the fault of the politicians and those making bad lending decisions with our economy, Shrinking eurozone The developments come amid the release by the EU of new figures confirming that the eurozone will shrink 0.3 per cent in 2012.",196,216,eurozone will shrink,1,0,1
36GJS3V78VR66OSFZSCICZHEP5MGJK,"It's the fault of the politicians and those making bad lending decisions with our economy, Shrinking eurozone The developments come amid the release by the EU of new figures confirming that the eurozone will shrink 0.3 per cent in 2012.",210,216,shrink,1,2,3
36GJS3V78VR66OSFZSCICZHEP5MGJK,"In Spain, one in four of its workforce is without a job, and the latest prediction from the EU says Spain is going to stay in recession for some time to come.",29,38,workforce,6,2,8
36GJS3V78VR66OSFZSCICZHEP5MGJK,"In Spain, one in four of its workforce is without a job, and the latest prediction from the EU says Spain is going to stay in recession for some time to come.",72,82,prediction,8,4,12
36GJS3V78VR66OSFZSCICZHEP5MGJK,"In Spain, one in four of its workforce is without a job, and the latest prediction from the EU says Spain is going to stay in recession for some time to come.",118,135,stay in recession,1,0,1
36GJS3V78VR66OSFZSCICZHEP5MGJK,"In Spain, one in four of its workforce is without a job, and the latest prediction from the EU says Spain is going to stay in recession for some time to come.",126,135,recession,9,3,12
3LXX8KJXPWA5SPW41ZYDSECDLZ49OZ,"The allegations of election fraud have fired up the opposition, which has long seen its protests crushed and its pleas ignored by the Kremlin-dominated media.",4,15,allegations,10,10,20
3LXX8KJXPWA5SPW41ZYDSECDLZ49OZ,"The allegations of election fraud have fired up the opposition, which has long seen its protests crushed and its pleas ignored by the Kremlin-dominated media.",4,33,allegations of election fraud,1,0,1
3LXX8KJXPWA5SPW41ZYDSECDLZ49OZ,"The allegations of election fraud have fired up the opposition, which has long seen its protests crushed and its pleas ignored by the Kremlin-dominated media.",19,33,election fraud,2,2,4
3LXX8KJXPWA5SPW41ZYDSECDLZ49OZ,"The allegations of election fraud have fired up the opposition, which has long seen its protests crushed and its pleas ignored by the Kremlin-dominated media.",28,33,fraud,1,1,2
3LXX8KJXPWA5SPW41ZYDSECDLZ49OZ,"The allegations of election fraud have fired up the opposition, which has long seen its protests crushed and its pleas ignored by the Kremlin-dominated media.",39,44,fired,0,1,1
3LXX8KJXPWA5SPW41ZYDSECDLZ49OZ,"The allegations of election fraud have fired up the opposition, which has long seen its protests crushed and its pleas ignored by the Kremlin-dominated media.",39,47,fired up,0,1,1
3LXX8KJXPWA5SPW41ZYDSECDLZ49OZ,"The allegations of election fraud have fired up the opposition, which has long seen its protests crushed and its pleas ignored by the Kremlin-dominated media.",52,62,opposition,4,1,5
3LXX8KJXPWA5SPW41ZYDSECDLZ49OZ,"The allegations of election fraud have fired up the opposition, which has long seen its protests crushed and its pleas ignored by the Kremlin-dominated media.",88,104,protests crushed,0,1,1
3LXX8KJXPWA5SPW41ZYDSECDLZ49OZ,"The allegations of election fraud have fired up the opposition, which has long seen its protests crushed and its pleas ignored by the Kremlin-dominated media.",97,104,crushed,0,2,2
3LXX8KJXPWA5SPW41ZYDSECDLZ49OZ,"The allegations of election fraud have fired up the opposition, which has long seen its protests crushed and its pleas ignored by the Kremlin-dominated media.",113,118,pleas,3,6,9
3LXX8KJXPWA5SPW41ZYDSECDLZ49OZ,"The allegations of election fraud have fired up the opposition, which has long seen its protests crushed and its pleas ignored by the Kremlin-dominated media.",119,126,ignored,0,2,2
3LXX8KJXPWA5SPW41ZYDSECDLZ49OZ,"The allegations of election fraud have fired up the opposition, which has long seen its protests crushed and its pleas ignored by the Kremlin-dominated media.",134,151,Kremlin-dominated,6,0,6
3LXX8KJXPWA5SPW41ZYDSECDLZ49OZ,"The allegations of election fraud have fired up the opposition, which has long seen its protests crushed and its pleas ignored by the Kremlin-dominated media.",134,157,Kremlin-dominated media,5,0,5
3LXX8KJXPWA5SPW41ZYDSECDLZ49OZ,"On Facebook, more than 12,000 people signed up to a page announcing an opposition rally for Saturday - and many of them have never taken part in political demonstrations Mariya Boyarintseva, a 24-year-old event manager, told The Associated Press that she has never been to a political rally before but she was going to Saturday's protest.",57,67,announcing,2,0,2
3LXX8KJXPWA5SPW41ZYDSECDLZ49OZ,"On Facebook, more than 12,000 people signed up to a page announcing an opposition rally for Saturday - and many of them have never taken part in political demonstrations Mariya Boyarintseva, a 24-year-old event manager, told The Associated Press that she has never been to a political rally before but she was going to Saturday's protest.",71,81,opposition,4,0,4
3LXX8KJXPWA5SPW41ZYDSECDLZ49OZ,"On Facebook, more than 12,000 people signed up to a page announcing an opposition rally for Saturday - and many of them have never taken part in political demonstrations Mariya Boyarintseva, a 24-year-old event manager, told The Associated Press that she has never been to a political rally before but she was going to Saturday's protest.",71,87,opposition rally,6,0,6
3LXX8KJXPWA5SPW41ZYDSECDLZ49OZ,"On Facebook, more than 12,000 people signed up to a page announcing an opposition rally for Saturday - and many of them have never taken part in political demonstrations Mariya Boyarintseva, a 24-year-old event manager, told The Associated Press that she has never been to a political rally before but she was going to Saturday's protest.",82,87,rally,0,2,2
3LXX8KJXPWA5SPW41ZYDSECDLZ49OZ,"On Facebook, more than 12,000 people signed up to a page announcing an opposition rally for Saturday - and many of them have never taken part in political demonstrations Mariya Boyarintseva, a 24-year-old event manager, told The Associated Press that she has never been to a political rally before but she was going to Saturday's protest.",145,169,political demonstrations,5,2,7
3LXX8KJXPWA5SPW41ZYDSECDLZ49OZ,"On Facebook, more than 12,000 people signed up to a page announcing an opposition rally for Saturday - and many of them have never taken part in political demonstrations Mariya Boyarintseva, a 24-year-old event manager, told The Associated Press that she has never been to a political rally before but she was going to Saturday's protest.",155,169,demonstrations,7,4,11
3LXX8KJXPWA5SPW41ZYDSECDLZ49OZ,"On Facebook, more than 12,000 people signed up to a page announcing an opposition rally for Saturday - and many of them have never taken part in political demonstrations Mariya Boyarintseva, a 24-year-old event manager, told The Associated Press that she has never been to a political rally before but she was going to Saturday's protest.",229,239,Associated,0,1,1
3LXX8KJXPWA5SPW41ZYDSECDLZ49OZ,"On Facebook, more than 12,000 people signed up to a page announcing an opposition rally for Saturday - and many of them have never taken part in political demonstrations Mariya Boyarintseva, a 24-year-old event manager, told The Associated Press that she has never been to a political rally before but she was going to Saturday's protest.",229,245,Associated Press,0,1,1
3LXX8KJXPWA5SPW41ZYDSECDLZ49OZ,"On Facebook, more than 12,000 people signed up to a page announcing an opposition rally for Saturday - and many of them have never taken part in political demonstrations Mariya Boyarintseva, a 24-year-old event manager, told The Associated Press that she has never been to a political rally before but she was going to Saturday's protest.",275,290,political rally,2,0,2
3LXX8KJXPWA5SPW41ZYDSECDLZ49OZ,"On Facebook, more than 12,000 people signed up to a page announcing an opposition rally for Saturday - and many of them have never taken part in political demonstrations Mariya Boyarintseva, a 24-year-old event manager, told The Associated Press that she has never been to a political rally before but she was going to Saturday's protest.",285,290,rally,0,2,2
3LXX8KJXPWA5SPW41ZYDSECDLZ49OZ,"On Facebook, more than 12,000 people signed up to a page announcing an opposition rally for Saturday - and many of them have never taken part in political demonstrations Mariya Boyarintseva, a 24-year-old event manager, told The Associated Press that she has never been to a political rally before but she was going to Saturday's protest.",330,337,protest,0,1,1
3LXX8KJXPWA5SPW41ZYDSECDLZ49OZ,"Boyarintseva said she didn't go to rallies Monday or Tuesday in Moscow - which ended with clashes with police and hundreds detained - because ""it felt a bit scary.""",35,42,rallies,2,2,4
3LXX8KJXPWA5SPW41ZYDSECDLZ49OZ,"Boyarintseva said she didn't go to rallies Monday or Tuesday in Moscow - which ended with clashes with police and hundreds detained - because ""it felt a bit scary.""",90,97,clashes,3,2,5
3LXX8KJXPWA5SPW41ZYDSECDLZ49OZ,"Boyarintseva said she didn't go to rallies Monday or Tuesday in Moscow - which ended with clashes with police and hundreds detained - because ""it felt a bit scary.""",123,131,detained,10,10,20
3LXX8KJXPWA5SPW41ZYDSECDLZ49OZ,"Boyarintseva said she didn't go to rallies Monday or Tuesday in Moscow - which ended with clashes with police and hundreds detained - because ""it felt a bit scary.""",157,162,scary,1,7,8
3LXX8KJXPWA5SPW41ZYDSECDLZ49OZ,Anti-Putin demonstrators take to streets as preliminary results indicate his United Russia party won less than 50% of votes Thousands of security forces have been patrolling Moscow while helicopters roam the sky amid protests over scandal-hit elections that saw Vladimir Putin's party struggle to keep a majority.,0,10,Anti-Putin,0,1,1
3LXX8KJXPWA5SPW41ZYDSECDLZ49OZ,Anti-Putin demonstrators take to streets as preliminary results indicate his United Russia party won less than 50% of votes Thousands of security forces have been patrolling Moscow while helicopters roam the sky amid protests over scandal-hit elections that saw Vladimir Putin's party struggle to keep a majority.,0,24,Anti-Putin demonstrators,1,0,1
3LXX8KJXPWA5SPW41ZYDSECDLZ49OZ,Anti-Putin demonstrators take to streets as preliminary results indicate his United Russia party won less than 50% of votes Thousands of security forces have been patrolling Moscow while helicopters roam the sky amid protests over scandal-hit elections that saw Vladimir Putin's party struggle to keep a majority.,11,24,demonstrators,8,2,10
3LXX8KJXPWA5SPW41ZYDSECDLZ49OZ,Anti-Putin demonstrators take to streets as preliminary results indicate his United Russia party won less than 50% of votes Thousands of security forces have been patrolling Moscow while helicopters roam the sky amid protests over scandal-hit elections that saw Vladimir Putin's party struggle to keep a majority.,44,55,preliminary,9,5,14
3LXX8KJXPWA5SPW41ZYDSECDLZ49OZ,Anti-Putin demonstrators take to streets as preliminary results indicate his United Russia party won less than 50% of votes Thousands of security forces have been patrolling Moscow while helicopters roam the sky amid protests over scandal-hit elections that saw Vladimir Putin's party struggle to keep a majority.,44,63,preliminary results,3,0,3
3LXX8KJXPWA5SPW41ZYDSECDLZ49OZ,Anti-Putin demonstrators take to streets as preliminary results indicate his United Russia party won less than 50% of votes Thousands of security forces have been patrolling Moscow while helicopters roam the sky amid protests over scandal-hit elections that saw Vladimir Putin's party struggle to keep a majority.,137,152,security forces,2,0,2
3LXX8KJXPWA5SPW41ZYDSECDLZ49OZ,Anti-Putin demonstrators take to streets as preliminary results indicate his United Russia party won less than 50% of votes Thousands of security forces have been patrolling Moscow while helicopters roam the sky amid protests over scandal-hit elections that saw Vladimir Putin's party struggle to keep a majority.,163,173,patrolling,8,6,14
3LXX8KJXPWA5SPW41ZYDSECDLZ49OZ,Anti-Putin demonstrators take to streets as preliminary results indicate his United Russia party won less than 50% of votes Thousands of security forces have been patrolling Moscow while helicopters roam the sky amid protests over scandal-hit elections that saw Vladimir Putin's party struggle to keep a majority.,187,198,helicopters,2,0,2
3LXX8KJXPWA5SPW41ZYDSECDLZ49OZ,Anti-Putin demonstrators take to streets as preliminary results indicate his United Russia party won less than 50% of votes Thousands of security forces have been patrolling Moscow while helicopters roam the sky amid protests over scandal-hit elections that saw Vladimir Putin's party struggle to keep a majority.,199,203,roam,1,1,2
3LXX8KJXPWA5SPW41ZYDSECDLZ49OZ,Anti-Putin demonstrators take to streets as preliminary results indicate his United Russia party won less than 50% of votes Thousands of security forces have been patrolling Moscow while helicopters roam the sky amid protests over scandal-hit elections that saw Vladimir Putin's party struggle to keep a majority.,212,216,amid,4,4,8
3LXX8KJXPWA5SPW41ZYDSECDLZ49OZ,Anti-Putin demonstrators take to streets as preliminary results indicate his United Russia party won less than 50% of votes Thousands of security forces have been patrolling Moscow while helicopters roam the sky amid protests over scandal-hit elections that saw Vladimir Putin's party struggle to keep a majority.,212,225,amid protests,1,1,2
3LXX8KJXPWA5SPW41ZYDSECDLZ49OZ,Anti-Putin demonstrators take to streets as preliminary results indicate his United Russia party won less than 50% of votes Thousands of security forces have been patrolling Moscow while helicopters roam the sky amid protests over scandal-hit elections that saw Vladimir Putin's party struggle to keep a majority.,231,242,scandal-hit,5,3,8
3LXX8KJXPWA5SPW41ZYDSECDLZ49OZ,Anti-Putin demonstrators take to streets as preliminary results indicate his United Russia party won less than 50% of votes Thousands of security forces have been patrolling Moscow while helicopters roam the sky amid protests over scandal-hit elections that saw Vladimir Putin's party struggle to keep a majority.,231,252,scandal-hit elections,2,2,4
3LXX8KJXPWA5SPW41ZYDSECDLZ49OZ,Anti-Putin demonstrators take to streets as preliminary results indicate his United Russia party won less than 50% of votes Thousands of security forces have been patrolling Moscow while helicopters roam the sky amid protests over scandal-hit elections that saw Vladimir Putin's party struggle to keep a majority.,285,293,struggle,0,3,3
3LXX8KJXPWA5SPW41ZYDSECDLZ49OZ,Anti-Putin demonstrators take to streets as preliminary results indicate his United Russia party won less than 50% of votes Thousands of security forces have been patrolling Moscow while helicopters roam the sky amid protests over scandal-hit elections that saw Vladimir Putin's party struggle to keep a majority.,304,312,majority,1,1,2
39KV3A5D188GCY04TJH2YNV8NYJ7SI,Assembly Deputy First Minister Martin McGuinness said he had visited the women's family over the weekend.,0,8,Assembly,2,0,2
39KV3A5D188GCY04TJH2YNV8NYJ7SI,Assembly Deputy First Minister Martin McGuinness said he had visited the women's family over the weekend.,0,15,Assembly Deputy,1,0,1
39KV3A5D188GCY04TJH2YNV8NYJ7SI,Assembly Deputy First Minister Martin McGuinness said he had visited the women's family over the weekend.,0,30,Assembly Deputy First Minister,2,1,3
39KV3A5D188GCY04TJH2YNV8NYJ7SI,Assembly Deputy First Minister Martin McGuinness said he had visited the women's family over the weekend.,22,30,Minister,1,0,1
39KV3A5D188GCY04TJH2YNV8NYJ7SI,Assembly Deputy First Minister Martin McGuinness said he had visited the women's family over the weekend.,61,68,visited,0,1,1
39KV3A5D188GCY04TJH2YNV8NYJ7SI,He said the family was in deep shock and had appealed to the media to respect their privacy.,26,36,deep shock,1,1,2
39KV3A5D188GCY04TJH2YNV8NYJ7SI,He said the family was in deep shock and had appealed to the media to respect their privacy.,31,36,shock,1,0,1
39KV3A5D188GCY04TJH2YNV8NYJ7SI,He said the family was in deep shock and had appealed to the media to respect their privacy.,45,53,appealed,10,7,17
39KV3A5D188GCY04TJH2YNV8NYJ7SI,He said the family was in deep shock and had appealed to the media to respect their privacy.,61,66,media,2,1,3
39KV3A5D188GCY04TJH2YNV8NYJ7SI,He said the family was in deep shock and had appealed to the media to respect their privacy.,70,77,respect,0,1,1
39KV3A5D188GCY04TJH2YNV8NYJ7SI,He said the family was in deep shock and had appealed to the media to respect their privacy.,70,91,respect their privacy,1,0,1
39KV3A5D188GCY04TJH2YNV8NYJ7SI,He said the family was in deep shock and had appealed to the media to respect their privacy.,84,91,privacy,1,1,2
39KV3A5D188GCY04TJH2YNV8NYJ7SI,"This family is clearly deeply shocked and traumatised by what has happened over the weekend, he said.",31,38,shocked,1,1,2
39KV3A5D188GCY04TJH2YNV8NYJ7SI,"This family is clearly deeply shocked and traumatised by what has happened over the weekend, he said.",31,54,shocked and traumatised,2,0,2
39KV3A5D188GCY04TJH2YNV8NYJ7SI,"This family is clearly deeply shocked and traumatised by what has happened over the weekend, he said.",43,54,traumatised,10,10,20
39KV3A5D188GCY04TJH2YNV8NYJ7SI,"I spent some time with the family and offered our support and that of the wider community at this time.	39	46	offered	0	1	1
39KV3A5D188GCY04TJH2YNV8NYJ7SI	I spent some time with the family and offered our support and that of the wider community at this time.",39,58,offered our support,0,1,1
39KV3A5D188GCY04TJH2YNV8NYJ7SI,"I spent some time with the family and offered our support and that of the wider community at this time.	75	80	wider	0	1	1
39KV3A5D188GCY04TJH2YNV8NYJ7SI	I spent some time with the family and offered our support and that of the wider community at this time.",75,90,wider community,3,1,4
39KV3A5D188GCY04TJH2YNV8NYJ7SI,"I spent some time with the family and offered our support and that of the wider community at this time.	81	90	community	1	0	1
39KV3A5D188GCY04TJH2YNV8NYJ7SI	The family have asked me to appeal to the media for privacy as they seek to come to terms with this tragedy in the coming days.""",26,35,to appeal,0,1,1
39KV3A5D188GCY04TJH2YNV8NYJ7SI,The family have asked me to appeal to the media for privacy as they seek to come to terms with this tragedy in the coming days.,29,35,appeal,3,2,5
39KV3A5D188GCY04TJH2YNV8NYJ7SI,The family have asked me to appeal to the media for privacy as they seek to come to terms with this tragedy in the coming days.,29,48,appeal to the media,0,1,1
39KV3A5D188GCY04TJH2YNV8NYJ7SI,The family have asked me to appeal to the media for privacy as they seek to come to terms with this tragedy in the coming days.,43,48,media,1,0,1
39KV3A5D188GCY04TJH2YNV8NYJ7SI,The family have asked me to appeal to the media for privacy as they seek to come to terms with this tragedy in the coming days.,53,60,privacy,1,2,3
39KV3A5D188GCY04TJH2YNV8NYJ7SI,The family have asked me to appeal to the media for privacy as they seek to come to terms with this tragedy in the coming days.,69,73,seek,1,1,2
39KV3A5D188GCY04TJH2YNV8NYJ7SI,The family have asked me to appeal to the media for privacy as they seek to come to terms with this tragedy in the coming days.,85,90,terms,0,1,1
39KV3A5D188GCY04TJH2YNV8NYJ7SI,The family have asked me to appeal to the media for privacy as they seek to come to terms with this tragedy in the coming days.,101,108,tragedy,6,8,14
39KV3A5D188GCY04TJH2YNV8NYJ7SI,Israel's outgoing ambassadoe to Egypt visited Cairo on Sunday for the first time since Israeli diplomats were returned to Israel following an attack on the Israeli embassy by Egyptian protesters two months ago.,9,17,outgoing,2,1,3
39KV3A5D188GCY04TJH2YNV8NYJ7SI,Israel's outgoing ambassadoe to Egypt visited Cairo on Sunday for the first time since Israeli diplomats were returned to Israel following an attack on the Israeli embassy by Egyptian protesters two months ago.,9,28,outgoing ambassadoe,2,1,3
39KV3A5D188GCY04TJH2YNV8NYJ7SI,Israel's outgoing ambassadoe to Egypt visited Cairo on Sunday for the first time since Israeli diplomats were returned to Israel following an attack on the Israeli embassy by Egyptian protesters two months ago.,18,28,ambassadoe,10,3,13
39KV3A5D188GCY04TJH2YNV8NYJ7SI,Israel's outgoing ambassadoe to Egypt visited Cairo on Sunday for the first time since Israeli diplomats were returned to Israel following an attack on the Israeli embassy by Egyptian protesters two months ago.,95,104,diplomats,8,8,16
39KV3A5D188GCY04TJH2YNV8NYJ7SI,Israel's outgoing ambassadoe to Egypt visited Cairo on Sunday for the first time since Israeli diplomats were returned to Israel following an attack on the Israeli embassy by Egyptian protesters two months ago.,164,171,embassy,6,2,8
39KV3A5D188GCY04TJH2YNV8NYJ7SI,Israel's outgoing ambassadoe to Egypt visited Cairo on Sunday for the first time since Israeli diplomats were returned to Israel following an attack on the Israeli embassy by Egyptian protesters two months ago.,184,194,protesters,2,7,9
3BS6ERDL938R693HDJHLXA9CQ7M6DU,"The U.S. president, who is in the midst of a re-election campaign, touted the Navy SEAL raid that killed bin Laden a year ago Wednesday, noting that the operation was launched from a base in Afghanistan.",34,39,midst,7,6,13
3BS6ERDL938R693HDJHLXA9CQ7M6DU,"The U.S. president, who is in the midst of a re-election campaign, touted the Navy SEAL raid that killed bin Laden a year ago Wednesday, noting that the operation was launched from a base in Afghanistan.",34,65,midst of a re-election campaign,1,0,1
3BS6ERDL938R693HDJHLXA9CQ7M6DU,"The U.S. president, who is in the midst of a re-election campaign, touted the Navy SEAL raid that killed bin Laden a year ago Wednesday, noting that the operation was launched from a base in Afghanistan.",45,65,re-election campaign,1,1,2
3BS6ERDL938R693HDJHLXA9CQ7M6DU,"The U.S. president, who is in the midst of a re-election campaign, touted the Navy SEAL raid that killed bin Laden a year ago Wednesday, noting that the operation was launched from a base in Afghanistan.",57,65,campaign,5,2,7
3BS6ERDL938R693HDJHLXA9CQ7M6DU,"The U.S. president, who is in the midst of a re-election campaign, touted the Navy SEAL raid that killed bin Laden a year ago Wednesday, noting that the operation was launched from a base in Afghanistan.",67,73,touted,6,10,16
3BS6ERDL938R693HDJHLXA9CQ7M6DU,"The U.S. president, who is in the midst of a re-election campaign, touted the Navy SEAL raid that killed bin Laden a year ago Wednesday, noting that the operation was launched from a base in Afghanistan.",67,92,touted the Navy SEAL raid,1,0,1
3BS6ERDL938R693HDJHLXA9CQ7M6DU,"The U.S. president, who is in the midst of a re-election campaign, touted the Navy SEAL raid that killed bin Laden a year ago Wednesday, noting that the operation was launched from a base in Afghanistan.",137,143,noting,1,0,1
3BS6ERDL938R693HDJHLXA9CQ7M6DU,"The U.S. president, who is in the midst of a re-election campaign, touted the Navy SEAL raid that killed bin Laden a year ago Wednesday, noting that the operation was launched from a base in Afghanistan.",153,162,operation,3,0,3
3BS6ERDL938R693HDJHLXA9CQ7M6DU,"The U.S. president, who is in the midst of a re-election campaign, touted the Navy SEAL raid that killed bin Laden a year ago Wednesday, noting that the operation was launched from a base in Afghanistan.",167,175,launched,2,3,5
3BS6ERDL938R693HDJHLXA9CQ7M6DU,"He also said that ""the tide has turned"" over the last three years.",19,38,the tide has turned,5,2,7
3BS6ERDL938R693HDJHLXA9CQ7M6DU,"He also said that ""the tide has turned"" over the last three years.",23,27,tide,0,1,1
3BS6ERDL938R693HDJHLXA9CQ7M6DU,"He also said that ""the tide has turned"" over the last three years.",23,38,tide has turned,1,2,3
3BS6ERDL938R693HDJHLXA9CQ7M6DU,"We broke the Taliban's momentum.	4	31	broke the Talibans momentum	1	0	1
3BS6ERDL938R693HDJHLXA9CQ7M6DU	We broke the Taliban's momentum.",14,22,Talibans,1,0,1
3BS6ERDL938R693HDJHLXA9CQ7M6DU,"We broke the Taliban's momentum.	24	32	momentum	9	8	17
3BS6ERDL938R693HDJHLXA9CQ7M6DU	We've built strong Afghan security forces.	19	34	Afghan security	1	0	1
3BS6ERDL938R693HDJHLXA9CQ7M6DU	We've built strong Afghan security forces.	26	34	security	1	0	1
3BS6ERDL938R693HDJHLXA9CQ7M6DU	We've built strong Afghan security forces.	26	41	security forces	0	1	1
3BS6ERDL938R693HDJHLXA9CQ7M6DU	We devastated al-Qaida's leadership, taking out over 20 of their top 30 leaders, he said.",3,13,devastated,10,10,20
3BS6ERDL938R693HDJHLXA9CQ7M6DU,"We devastated al-Qaida's leadership, taking out over 20 of their top 30 leaders,"" he said.",14,23,al-Qaidas,1,0,1
3BS6ERDL938R693HDJHLXA9CQ7M6DU,But the violence that erupted about 90 minutes after his departure was a stark reminder of the difficult task still ahead for Afghan troops as they work to secure their country after U.S. and other foreign troops end their combat mission following nearly a decade at war.,8,16,violence,0,2,2
3BS6ERDL938R693HDJHLXA9CQ7M6DU,But the violence that erupted about 90 minutes after his departure was a stark reminder of the difficult task still ahead for Afghan troops as they work to secure their country after U.S. and other foreign troops end their combat mission following nearly a decade at war.,22,29,erupted,9,9,18
3BS6ERDL938R693HDJHLXA9CQ7M6DU,But the violence that erupted about 90 minutes after his departure was a stark reminder of the difficult task still ahead for Afghan troops as they work to secure their country after U.S. and other foreign troops end their combat mission following nearly a decade at war.,57,66,departure,2,1,3
3BS6ERDL938R693HDJHLXA9CQ7M6DU,But the violence that erupted about 90 minutes after his departure was a stark reminder of the difficult task still ahead for Afghan troops as they work to secure their country after U.S. and other foreign troops end their combat mission following nearly a decade at war.,73,78,stark,4,5,9
3BS6ERDL938R693HDJHLXA9CQ7M6DU,But the violence that erupted about 90 minutes after his departure was a stark reminder of the difficult task still ahead for Afghan troops as they work to secure their country after U.S. and other foreign troops end their combat mission following nearly a decade at war.,73,87,stark reminder,3,6,9
3BS6ERDL938R693HDJHLXA9CQ7M6DU,But the violence that erupted about 90 minutes after his departure was a stark reminder of the difficult task still ahead for Afghan troops as they work to secure their country after U.S. and other foreign troops end their combat mission following nearly a decade at war.,95,104,difficult,1,0,1
3BS6ERDL938R693HDJHLXA9CQ7M6DU,But the violence that erupted about 90 minutes after his departure was a stark reminder of the difficult task still ahead for Afghan troops as they work to secure their country after U.S. and other foreign troops end their combat mission following nearly a decade at war.,95,109,difficult task,0,1,1
3BS6ERDL938R693HDJHLXA9CQ7M6DU,But the violence that erupted about 90 minutes after his departure was a stark reminder of the difficult task still ahead for Afghan troops as they work to secure their country after U.S. and other foreign troops end their combat mission following nearly a decade at war.,126,139,Afghan troops,1,0,1
3BS6ERDL938R693HDJHLXA9CQ7M6DU,But the violence that erupted about 90 minutes after his departure was a stark reminder of the difficult task still ahead for Afghan troops as they work to secure their country after U.S. and other foreign troops end their combat mission following nearly a decade at war.,156,162,secure,1,0,1
3BS6ERDL938R693HDJHLXA9CQ7M6DU,But the violence that erupted about 90 minutes after his departure was a stark reminder of the difficult task still ahead for Afghan troops as they work to secure their country after U.S. and other foreign troops end their combat mission following nearly a decade at war.,198,205,foreign,1,0,1
3BS6ERDL938R693HDJHLXA9CQ7M6DU,But the violence that erupted about 90 minutes after his departure was a stark reminder of the difficult task still ahead for Afghan troops as they work to secure their country after U.S. and other foreign troops end their combat mission following nearly a decade at war.,206,212,troops,0,1,1
3BS6ERDL938R693HDJHLXA9CQ7M6DU,But the violence that erupted about 90 minutes after his departure was a stark reminder of the difficult task still ahead for Afghan troops as they work to secure their country after U.S. and other foreign troops end their combat mission following nearly a decade at war.,223,229,combat,3,1,4
3BS6ERDL938R693HDJHLXA9CQ7M6DU,But the violence that erupted about 90 minutes after his departure was a stark reminder of the difficult task still ahead for Afghan troops as they work to secure their country after U.S. and other foreign troops end their combat mission following nearly a decade at war.,223,237,combat mission,3,5,8
3BS6ERDL938R693HDJHLXA9CQ7M6DU,But the violence that erupted about 90 minutes after his departure was a stark reminder of the difficult task still ahead for Afghan troops as they work to secure their country after U.S. and other foreign troops end their combat mission following nearly a decade at war.,223,247,combat mission following,1,0,1
3BS6ERDL938R693HDJHLXA9CQ7M6DU,But the violence that erupted about 90 minutes after his departure was a stark reminder of the difficult task still ahead for Afghan troops as they work to secure their country after U.S. and other foreign troops end their combat mission following nearly a decade at war.,257,263,decade,3,6,9
341YLJU21I0KWJ02IV6TYU8D2J7I2U,"It does not commit Washington to specific troop or funding levels for Afghanistan, though is meant to signal U.S. foes that despite ending the longest war in U.S. history, Washington intends to ensure Afghanistan does not revert to a haven for terror groups like al-Qaeda.",12,18,commit,3,3,6
341YLJU21I0KWJ02IV6TYU8D2J7I2U,"It does not commit Washington to specific troop or funding levels for Afghanistan, though is meant to signal U.S. foes that despite ending the longest war in U.S. history, Washington intends to ensure Afghanistan does not revert to a haven for terror groups like al-Qaeda.",33,41,specific,1,1,2
341YLJU21I0KWJ02IV6TYU8D2J7I2U,"It does not commit Washington to specific troop or funding levels for Afghanistan, though is meant to signal U.S. foes that despite ending the longest war in U.S. history, Washington intends to ensure Afghanistan does not revert to a haven for terror groups like al-Qaeda.",33,65,specific troop or funding levels,1,0,1
341YLJU21I0KWJ02IV6TYU8D2J7I2U,"It does not commit Washington to specific troop or funding levels for Afghanistan, though is meant to signal U.S. foes that despite ending the longest war in U.S. history, Washington intends to ensure Afghanistan does not revert to a haven for terror groups like al-Qaeda.",51,58,funding,0,2,2
341YLJU21I0KWJ02IV6TYU8D2J7I2U,"It does not commit Washington to specific troop or funding levels for Afghanistan, though is meant to signal U.S. foes that despite ending the longest war in U.S. history, Washington intends to ensure Afghanistan does not revert to a haven for terror groups like al-Qaeda.",51,65,funding levels,2,2,4
341YLJU21I0KWJ02IV6TYU8D2J7I2U,"It does not commit Washington to specific troop or funding levels for Afghanistan, though is meant to signal U.S. foes that despite ending the longest war in U.S. history, Washington intends to ensure Afghanistan does not revert to a haven for terror groups like al-Qaeda.",59,65,levels,1,0,1
341YLJU21I0KWJ02IV6TYU8D2J7I2U,"It does not commit Washington to specific troop or funding levels for Afghanistan, though is meant to signal U.S. foes that despite ending the longest war in U.S. history, Washington intends to ensure Afghanistan does not revert to a haven for terror groups like al-Qaeda.",70,81,Afghanistan,1,0,1
341YLJU21I0KWJ02IV6TYU8D2J7I2U,"It does not commit Washington to specific troop or funding levels for Afghanistan, though is meant to signal U.S. foes that despite ending the longest war in U.S. history, Washington intends to ensure Afghanistan does not revert to a haven for terror groups like al-Qaeda.",93,98,meant,0,1,1
341YLJU21I0KWJ02IV6TYU8D2J7I2U,"It does not commit Washington to specific troop or funding levels for Afghanistan, though is meant to signal U.S. foes that despite ending the longest war in U.S. history, Washington intends to ensure Afghanistan does not revert to a haven for terror groups like al-Qaeda.",93,108,meant to signal,1,0,1
341YLJU21I0KWJ02IV6TYU8D2J7I2U,"It does not commit Washington to specific troop or funding levels for Afghanistan, though is meant to signal U.S. foes that despite ending the longest war in U.S. history, Washington intends to ensure Afghanistan does not revert to a haven for terror groups like al-Qaeda.",102,108,signal,0,1,1
341YLJU21I0KWJ02IV6TYU8D2J7I2U,"It does not commit Washington to specific troop or funding levels for Afghanistan, though is meant to signal U.S. foes that despite ending the longest war in U.S. history, Washington intends to ensure Afghanistan does not revert to a haven for terror groups like al-Qaeda.",109,118,U.S. foes,1,0,1
341YLJU21I0KWJ02IV6TYU8D2J7I2U,"It does not commit Washington to specific troop or funding levels for Afghanistan, though is meant to signal U.S. foes that despite ending the longest war in U.S. history, Washington intends to ensure Afghanistan does not revert to a haven for terror groups like al-Qaeda.",114,118,foes,3,6,9
341YLJU21I0KWJ02IV6TYU8D2J7I2U,"It does not commit Washington to specific troop or funding levels for Afghanistan, though is meant to signal U.S. foes that despite ending the longest war in U.S. history, Washington intends to ensure Afghanistan does not revert to a haven for terror groups like al-Qaeda.",124,131,despite,1,5,6
341YLJU21I0KWJ02IV6TYU8D2J7I2U,"It does not commit Washington to specific troop or funding levels for Afghanistan, though is meant to signal U.S. foes that despite ending the longest war in U.S. history, Washington intends to ensure Afghanistan does not revert to a haven for terror groups like al-Qaeda.",183,190,intends,5,3,8
341YLJU21I0KWJ02IV6TYU8D2J7I2U,"It does not commit Washington to specific troop or funding levels for Afghanistan, though is meant to signal U.S. foes that despite ending the longest war in U.S. history, Washington intends to ensure Afghanistan does not revert to a haven for terror groups like al-Qaeda.",194,200,ensure,2,4,6
341YLJU21I0KWJ02IV6TYU8D2J7I2U,"It does not commit Washington to specific troop or funding levels for Afghanistan, though is meant to signal U.S. foes that despite ending the longest war in U.S. history, Washington intends to ensure Afghanistan does not revert to a haven for terror groups like al-Qaeda.",201,212,Afghanistan,1,0,1
341YLJU21I0KWJ02IV6TYU8D2J7I2U,"It does not commit Washington to specific troop or funding levels for Afghanistan, though is meant to signal U.S. foes that despite ending the longest war in U.S. history, Washington intends to ensure Afghanistan does not revert to a haven for terror groups like al-Qaeda.",222,228,revert,5,6,11
341YLJU21I0KWJ02IV6TYU8D2J7I2U,"It does not commit Washington to specific troop or funding levels for Afghanistan, though is meant to signal U.S. foes that despite ending the longest war in U.S. history, Washington intends to ensure Afghanistan does not revert to a haven for terror groups like al-Qaeda.",222,239,revert to a haven,1,1,2
341YLJU21I0KWJ02IV6TYU8D2J7I2U,"It does not commit Washington to specific troop or funding levels for Afghanistan, though is meant to signal U.S. foes that despite ending the longest war in U.S. history, Washington intends to ensure Afghanistan does not revert to a haven for terror groups like al-Qaeda.",234,239,haven,6,7,13
341YLJU21I0KWJ02IV6TYU8D2J7I2U,"It does not commit Washington to specific troop or funding levels for Afghanistan, though is meant to signal U.S. foes that despite ending the longest war in U.S. history, Washington intends to ensure Afghanistan does not revert to a haven for terror groups like al-Qaeda.",244,250,terror,1,0,1
341YLJU21I0KWJ02IV6TYU8D2J7I2U,"It does not commit Washington to specific troop or funding levels for Afghanistan, though is meant to signal U.S. foes that despite ending the longest war in U.S. history, Washington intends to ensure Afghanistan does not revert to a haven for terror groups like al-Qaeda.",263,271,al-Qaeda,2,0,2
341YLJU21I0KWJ02IV6TYU8D2J7I2U,"But after a war that has cost the lives of nearly 3,000 U.S. and allied troops, maimed tens of thousands more, saw thousands of Afghans killed and cost hundreds of billions of dollars, Afghanistan’s future is deeply uncertain.",25,39,cost the lives,1,0,1
341YLJU21I0KWJ02IV6TYU8D2J7I2U,"But after a war that has cost the lives of nearly 3,000 U.S. and allied troops, maimed tens of thousands more, saw thousands of Afghans killed and cost hundreds of billions of dollars, Afghanistan’s future is deeply uncertain.",65,71,allied,1,4,5
341YLJU21I0KWJ02IV6TYU8D2J7I2U,"But after a war that has cost the lives of nearly 3,000 U.S. and allied troops, maimed tens of thousands more, saw thousands of Afghans killed and cost hundreds of billions of dollars, Afghanistan’s future is deeply uncertain.",65,78,allied troops,1,3,4
341YLJU21I0KWJ02IV6TYU8D2J7I2U,"But after a war that has cost the lives of nearly 3,000 U.S. and allied troops, maimed tens of thousands more, saw thousands of Afghans killed and cost hundreds of billions of dollars, Afghanistan’s future is deeply uncertain.",80,86,maimed,10,10,20
341YLJU21I0KWJ02IV6TYU8D2J7I2U,"But after a war that has cost the lives of nearly 3,000 U.S. and allied troops, maimed tens of thousands more, saw thousands of Afghans killed and cost hundreds of billions of dollars, Afghanistan’s future is deeply uncertain.",80,104,maimed tens of thousands,0,1,1
341YLJU21I0KWJ02IV6TYU8D2J7I2U,"But after a war that has cost the lives of nearly 3,000 U.S. and allied troops, maimed tens of thousands more, saw thousands of Afghans killed and cost hundreds of billions of dollars, Afghanistan’s future is deeply uncertain.",80,109,maimed tens of thousands more,0,1,1
341YLJU21I0KWJ02IV6TYU8D2J7I2U,"But after a war that has cost the lives of nearly 3,000 U.S. and allied troops, maimed tens of thousands more, saw thousands of Afghans killed and cost hundreds of billions of dollars, Afghanistan’s future is deeply uncertain.",128,135,Afghans,1,0,1
341YLJU21I0KWJ02IV6TYU8D2J7I2U,"But after a war that has cost the lives of nearly 3,000 U.S. and allied troops, maimed tens of thousands more, saw thousands of Afghans killed and cost hundreds of billions of dollars, Afghanistan’s future is deeply uncertain.",185,198,Afghanistan’s,1,0,1
341YLJU21I0KWJ02IV6TYU8D2J7I2U,"But after a war that has cost the lives of nearly 3,000 U.S. and allied troops, maimed tens of thousands more, saw thousands of Afghans killed and cost hundreds of billions of dollars, Afghanistan’s future is deeply uncertain.",209,215,deeply,0,1,1
341YLJU21I0KWJ02IV6TYU8D2J7I2U,"But after a war that has cost the lives of nearly 3,000 U.S. and allied troops, maimed tens of thousands more, saw thousands of Afghans killed and cost hundreds of billions of dollars, Afghanistan’s future is deeply uncertain.",209,225,deeply uncertain,0,1,1
341YLJU21I0KWJ02IV6TYU8D2J7I2U,"But after a war that has cost the lives of nearly 3,000 U.S. and allied troops, maimed tens of thousands more, saw thousands of Afghans killed and cost hundreds of billions of dollars, Afghanistan’s future is deeply uncertain.",216,225,uncertain,3,3,6
341YLJU21I0KWJ02IV6TYU8D2J7I2U,"PRESIDENT Barack Obama, speaking to a US television audience  from Bagram Air Base, said he had travelled there to herald a new era in the relationship between the US and Afghanistan, ''a future in which war ends, and a new chapter begins''.",10,16,Barack,1,0,1
341YLJU21I0KWJ02IV6TYU8D2J7I2U,"PRESIDENT Barack Obama, speaking to a US television audience  from Bagram Air Base, said he had travelled there to herald a new era in the relationship between the US and Afghanistan, ''a future in which war ends, and a new chapter begins''.",52,60,audience,2,2,4
341YLJU21I0KWJ02IV6TYU8D2J7I2U,"PRESIDENT Barack Obama, speaking to a US television audience  from Bagram Air Base, said he had travelled there to herald a new era in the relationship between the US and Afghanistan, ''a future in which war ends, and a new chapter begins''.",67,77,Bagram Air,1,0,1
341YLJU21I0KWJ02IV6TYU8D2J7I2U,"PRESIDENT Barack Obama, speaking to a US television audience  from Bagram Air Base, said he had travelled there to herald a new era in the relationship between the US and Afghanistan, ''a future in which war ends, and a new chapter begins''.",112,121,to herald,0,1,1
341YLJU21I0KWJ02IV6TYU8D2J7I2U,"PRESIDENT Barack Obama, speaking to a US television audience  from Bagram Air Base, said he had travelled there to herald a new era in the relationship between the US and Afghanistan, ''a future in which war ends, and a new chapter begins''.",115,121,herald,9,9,18
341YLJU21I0KWJ02IV6TYU8D2J7I2U,"PRESIDENT Barack Obama, speaking to a US television audience  from Bagram Air Base, said he had travelled there to herald a new era in the relationship between the US and Afghanistan, ''a future in which war ends, and a new chapter begins''.",115,131,herald a new era,3,0,3
341YLJU21I0KWJ02IV6TYU8D2J7I2U,"PRESIDENT Barack Obama, speaking to a US television audience  from Bagram Air Base, said he had travelled there to herald a new era in the relationship between the US and Afghanistan, ''a future in which war ends, and a new chapter begins''.",122,131,a new era,1,1,2
341YLJU21I0KWJ02IV6TYU8D2J7I2U,"PRESIDENT Barack Obama, speaking to a US television audience  from Bagram Air Base, said he had travelled there to herald a new era in the relationship between the US and Afghanistan, ''a future in which war ends, and a new chapter begins''.",124,131,new era,0,1,1
341YLJU21I0KWJ02IV6TYU8D2J7I2U,"PRESIDENT Barack Obama, speaking to a US television audience  from Bagram Air Base, said he had travelled there to herald a new era in the relationship between the US and Afghanistan, ''a future in which war ends, and a new chapter begins''.",116,119,era,2,1,3
341YLJU21I0KWJ02IV6TYU8D2J7I2U,"PRESIDENT Barack Obama, speaking to a US television audience  from Bagram Air Base, said he had travelled there to herald a new era in the relationship between the US and Afghanistan, ''a future in which war ends, and a new chapter begins''.",139,151,relationship,2,0,2
389A2A304OJMN6BOBY6T43H3THR0CH,The authorities identified her as Tonya Thomas.,4,15,authorities,7,3,10
389A2A304OJMN6BOBY6T43H3THR0CH,The authorities identified her as Tonya Thomas.,16,26,identified,1,4,5
389A2A304OJMN6BOBY6T43H3THR0CH,"The children were identified as Pebbles Johnson, 17; Jaxs Johnson, 15; Jazlin Johnson, 13; and Joel Johnson, 12.",18,28,identified,4,2,6
389A2A304OJMN6BOBY6T43H3THR0CH,"The children were identified as Pebbles Johnson, 17; Jaxs Johnson, 15; Jazlin Johnson, 13; and Joel Johnson, 12.",32,39,Pebbles,0,1,1
389A2A304OJMN6BOBY6T43H3THR0CH,Lieutenant Goodyear said at a news conference that the authorities had received a 911 call from a neighbor of Ms. Thomas at 4:50 a.m.,0,10,Lieutenant,8,1,9
389A2A304OJMN6BOBY6T43H3THR0CH,Lieutenant Goodyear said at a news conference that the authorities had received a 911 call from a neighbor of Ms. Thomas at 4:50 a.m.,30,45,news conference,2,1,3
389A2A304OJMN6BOBY6T43H3THR0CH,Lieutenant Goodyear said at a news conference that the authorities had received a 911 call from a neighbor of Ms. Thomas at 4:50 a.m.,35,45,conference,3,2,5
389A2A304OJMN6BOBY6T43H3THR0CH,Lieutenant Goodyear said at a news conference that the authorities had received a 911 call from a neighbor of Ms. Thomas at 4:50 a.m.,55,66,authorities,2,0,2
389A2A304OJMN6BOBY6T43H3THR0CH,The neighbor reported having heard gun shots from Ms. Thomas's home followed by a knock on her door.,4,12,neighbor,0,1,1
389A2A304OJMN6BOBY6T43H3THR0CH,The neighbor reported having heard gun shots from Ms. Thomas's home followed by a knock on her door.,13,21,reported,0,1,1
389A2A304OJMN6BOBY6T43H3THR0CH,The neighbor reported having heard gun shots from Ms. Thomas's home followed by a knock on her door.,29,34,heard,0,1,1
389A2A304OJMN6BOBY6T43H3THR0CH,The neighbor reported having heard gun shots from Ms. Thomas's home followed by a knock on her door.,82,87,knock,0,2,2
389A2A304OJMN6BOBY6T43H3THR0CH,The neighbor reported having heard gun shots from Ms. Thomas's home followed by a knock on her door.,82,99,knock on her door,1,0,1
389A2A304OJMN6BOBY6T43H3THR0CH,"The neighbor, whom the authorities have not identified, said that when she opened the door, three of Ms. Thomas' children were on the door step.",23,34,authorities,9,1,10
389A2A304OJMN6BOBY6T43H3THR0CH,"The neighbor, whom the authorities have not identified, said that when she opened the door, three of Ms. Thomas' children were on the door step.",44,54,identified,2,0,2
389A2A304OJMN6BOBY6T43H3THR0CH,"The neighbor, whom the authorities have not identified, said that when she opened the door, three of Ms. Thomas' children were on the door step.",134,143,door step,0,2,2
389A2A304OJMN6BOBY6T43H3THR0CH,"They did appear to be shot, Lieutenant Goodyear said.",10,16,appear,0,4,4
389A2A304OJMN6BOBY6T43H3THR0CH,"They did appear to be shot, Lieutenant Goodyear said.",30,40,Lieutenant,3,0,3
389A2A304OJMN6BOBY6T43H3THR0CH,"They did appear to be shot, Lieutenant Goodyear said.",30,49,Lieutenant Goodyear,0,1,1
389A2A304OJMN6BOBY6T43H3THR0CH,He did not describe the injuries.,11,19,describe,0,4,4
389A2A304OJMN6BOBY6T43H3THR0CH,He did not describe the injuries.,24,32,injuries,2,2,4
389A2A304OJMN6BOBY6T43H3THR0CH,"Moments later, the neighbor said, Ms. Thomas, 33, emerged from her house and called her children to come back home.",0,7,Moments,1,1,2
389A2A304OJMN6BOBY6T43H3THR0CH,"Moments later, the neighbor said, Ms. Thomas, 33, emerged from her house and called her children to come back home.",19,27,neighbor,0,1,1
389A2A304OJMN6BOBY6T43H3THR0CH,"Moments later, the neighbor said, Ms. Thomas, 33, emerged from her house and called her children to come back home.",50,57,emerged,9,10,19
382GHPVPHSSF9UX616IUN33M4GU342,"Goodyear said police previously responded to the Florida ""Space Coast"" home, about 15 miles south of Cape Canaveral, for domestic disturbance calls involving Jaxs Johnson.",0,8,Goodyear,1,0,1
382GHPVPHSSF9UX616IUN33M4GU342,"Goodyear said police previously responded to the Florida ""Space Coast"" home, about 15 miles south of Cape Canaveral, for domestic disturbance calls involving Jaxs Johnson.",21,31,previously,1,1,2
382GHPVPHSSF9UX616IUN33M4GU342,"Goodyear said police previously responded to the Florida ""Space Coast"" home, about 15 miles south of Cape Canaveral, for domestic disturbance calls involving Jaxs Johnson.",21,41,previously responded,1,0,1
382GHPVPHSSF9UX616IUN33M4GU342,"Goodyear said police previously responded to the Florida ""Space Coast"" home, about 15 miles south of Cape Canaveral, for domestic disturbance calls involving Jaxs Johnson.",32,41,responded,0,3,3
382GHPVPHSSF9UX616IUN33M4GU342,"Goodyear said police previously responded to the Florida ""Space Coast"" home, about 15 miles south of Cape Canaveral, for domestic disturbance calls involving Jaxs Johnson.",58,69,Space Coast,1,0,1
382GHPVPHSSF9UX616IUN33M4GU342,"Goodyear said police previously responded to the Florida ""Space Coast"" home, about 15 miles south of Cape Canaveral, for domestic disturbance calls involving Jaxs Johnson.",101,115,Cape Canaveral,1,1,2
382GHPVPHSSF9UX616IUN33M4GU342,"Goodyear said police previously responded to the Florida ""Space Coast"" home, about 15 miles south of Cape Canaveral, for domestic disturbance calls involving Jaxs Johnson.",121,129,domestic,2,2,4
382GHPVPHSSF9UX616IUN33M4GU342,"Goodyear said police previously responded to the Florida ""Space Coast"" home, about 15 miles south of Cape Canaveral, for domestic disturbance calls involving Jaxs Johnson.",121,141,domestic disturbance,7,3,10
382GHPVPHSSF9UX616IUN33M4GU342,"Goodyear said police previously responded to the Florida ""Space Coast"" home, about 15 miles south of Cape Canaveral, for domestic disturbance calls involving Jaxs Johnson.",121,147,domestic disturbance calls,2,0,2
382GHPVPHSSF9UX616IUN33M4GU342,"Goodyear said police previously responded to the Florida ""Space Coast"" home, about 15 miles south of Cape Canaveral, for domestic disturbance calls involving Jaxs Johnson.",130,141,disturbance,4,6,10
382GHPVPHSSF9UX616IUN33M4GU342,"Goodyear said police previously responded to the Florida ""Space Coast"" home, about 15 miles south of Cape Canaveral, for domestic disturbance calls involving Jaxs Johnson.",148,157,involving,0,1,1
382GHPVPHSSF9UX616IUN33M4GU342,"Goodyear said police previously responded to the Florida ""Space Coast"" home, about 15 miles south of Cape Canaveral, for domestic disturbance calls involving Jaxs Johnson.",158,170,Jaxs Johnson,1,0,1
382GHPVPHSSF9UX616IUN33M4GU342,"Goodyear said that of Tuesday afternoon, authorities had no motive for the killings.",41,52,authorities,5,2,7
382GHPVPHSSF9UX616IUN33M4GU342,"Goodyear said that of Tuesday afternoon, authorities had no motive for the killings.",60,66,motive,7,7,14
382GHPVPHSSF9UX616IUN33M4GU342,The Philippines foreign secretary has said he and the Chinese ambassador have agreed to resolve diplomatically a stand-off involving a Philippine warship and two Chinese surveillance vessels in a disputed area of the South China Sea.,16,23,foreign,1,1,2
382GHPVPHSSF9UX616IUN33M4GU342,The Philippines foreign secretary has said he and the Chinese ambassador have agreed to resolve diplomatically a stand-off involving a Philippine warship and two Chinese surveillance vessels in a disputed area of the South China Sea.,16,33,foreign secretary,3,1,4
382GHPVPHSSF9UX616IUN33M4GU342,The Philippines foreign secretary has said he and the Chinese ambassador have agreed to resolve diplomatically a stand-off involving a Philippine warship and two Chinese surveillance vessels in a disputed area of the South China Sea.,54,72,Chinese ambassador,1,0,1
382GHPVPHSSF9UX616IUN33M4GU342,The Philippines foreign secretary has said he and the Chinese ambassador have agreed to resolve diplomatically a stand-off involving a Philippine warship and two Chinese surveillance vessels in a disputed area of the South China Sea.,62,72,ambassador,3,3,6
382GHPVPHSSF9UX616IUN33M4GU342,The Philippines foreign secretary has said he and the Chinese ambassador have agreed to resolve diplomatically a stand-off involving a Philippine warship and two Chinese surveillance vessels in a disputed area of the South China Sea.,88,95,resolve,0,4,4
382GHPVPHSSF9UX616IUN33M4GU342,The Philippines foreign secretary has said he and the Chinese ambassador have agreed to resolve diplomatically a stand-off involving a Philippine warship and two Chinese surveillance vessels in a disputed area of the South China Sea.,88,110,resolve diplomatically,1,2,3
382GHPVPHSSF9UX616IUN33M4GU342,The Philippines foreign secretary has said he and the Chinese ambassador have agreed to resolve diplomatically a stand-off involving a Philippine warship and two Chinese surveillance vessels in a disputed area of the South China Sea.,96,110,diplomatically,6,6,12
382GHPVPHSSF9UX616IUN33M4GU342,The Philippines foreign secretary has said he and the Chinese ambassador have agreed to resolve diplomatically a stand-off involving a Philippine warship and two Chinese surveillance vessels in a disputed area of the South China Sea.,113,122,stand-off,5,10,15
382GHPVPHSSF9UX616IUN33M4GU342,The Philippines foreign secretary has said he and the Chinese ambassador have agreed to resolve diplomatically a stand-off involving a Philippine warship and two Chinese surveillance vessels in a disputed area of the South China Sea.,123,132,involving,0,1,1
382GHPVPHSSF9UX616IUN33M4GU342,The Philippines foreign secretary has said he and the Chinese ambassador have agreed to resolve diplomatically a stand-off involving a Philippine warship and two Chinese surveillance vessels in a disputed area of the South China Sea.,135,153,Philippine warship,1,0,1
382GHPVPHSSF9UX616IUN33M4GU342,The Philippines foreign secretary has said he and the Chinese ambassador have agreed to resolve diplomatically a stand-off involving a Philippine warship and two Chinese surveillance vessels in a disputed area of the South China Sea.,146,153,warship,1,0,1
382GHPVPHSSF9UX616IUN33M4GU342,The Philippines foreign secretary has said he and the Chinese ambassador have agreed to resolve diplomatically a stand-off involving a Philippine warship and two Chinese surveillance vessels in a disputed area of the South China Sea.,162,190,Chinese surveillance vessels,1,0,1
382GHPVPHSSF9UX616IUN33M4GU342,The Philippines foreign secretary has said he and the Chinese ambassador have agreed to resolve diplomatically a stand-off involving a Philippine warship and two Chinese surveillance vessels in a disputed area of the South China Sea.,170,182,surveillance,3,8,11
382GHPVPHSSF9UX616IUN33M4GU342,The Philippines foreign secretary has said he and the Chinese ambassador have agreed to resolve diplomatically a stand-off involving a Philippine warship and two Chinese surveillance vessels in a disputed area of the South China Sea.,170,190,surveillance vessels,5,3,8
382GHPVPHSSF9UX616IUN33M4GU342,The Philippines foreign secretary has said he and the Chinese ambassador have agreed to resolve diplomatically a stand-off involving a Philippine warship and two Chinese surveillance vessels in a disputed area of the South China Sea.,183,190,vessels,2,1,3
382GHPVPHSSF9UX616IUN33M4GU342,The Philippines foreign secretary has said he and the Chinese ambassador have agreed to resolve diplomatically a stand-off involving a Philippine warship and two Chinese surveillance vessels in a disputed area of the South China Sea.,196,204,disputed,5,2,7
382GHPVPHSSF9UX616IUN33M4GU342,The Philippines foreign secretary has said he and the Chinese ambassador have agreed to resolve diplomatically a stand-off involving a Philippine warship and two Chinese surveillance vessels in a disputed area of the South China Sea.,196,209,disputed area,0,3,3
382GHPVPHSSF9UX616IUN33M4GU342,Albert Del Rosario said he met ambassador Ma Keqing and both reaffirmed their governments' positions that the Scarborough Shoal where the ships are facing off was part of their own country's territory.,31,41,ambassador,3,0,3
382GHPVPHSSF9UX616IUN33M4GU342,Albert Del Rosario said he met ambassador Ma Keqing and both reaffirmed their governments' positions that the Scarborough Shoal where the ships are facing off was part of their own country's territory.,45,51,Keqing,0,1,1
382GHPVPHSSF9UX616IUN33M4GU342,Albert Del Rosario said he met ambassador Ma Keqing and both reaffirmed their governments' positions that the Scarborough Shoal where the ships are facing off was part of their own country's territory.,61,71,reaffirmed,9,9,18
382GHPVPHSSF9UX616IUN33M4GU342,Albert Del Rosario said he met ambassador Ma Keqing and both reaffirmed their governments' positions that the Scarborough Shoal where the ships are facing off was part of their own country's territory.,122,127,Shoal,0,2,2
382GHPVPHSSF9UX616IUN33M4GU342,Albert Del Rosario said he met ambassador Ma Keqing and both reaffirmed their governments' positions that the Scarborough Shoal where the ships are facing off was part of their own country's territory.,148,158,facing off,0,3,3
382GHPVPHSSF9UX616IUN33M4GU342,Albert Del Rosario said he met ambassador Ma Keqing and both reaffirmed their governments' positions that the Scarborough Shoal where the ships are facing off was part of their own country's territory.,191,200,territory,1,3,4
382GHPVPHSSF9UX616IUN33M4GU342,"Mr Del Rosario said that despite the impasse, ""we resolved to seek a diplomatic solution to the issue"".",25,32,despite,0,2,2
382GHPVPHSSF9UX616IUN33M4GU342,"Mr Del Rosario said that despite the impasse, ""we resolved to seek a diplomatic solution to the issue"".",37,44,impasse,10,10,20
382GHPVPHSSF9UX616IUN33M4GU342,"Mr Del Rosario said that despite the impasse, ""we resolved to seek a diplomatic solution to the issue"".",62,66,seek,0,1,1
382GHPVPHSSF9UX616IUN33M4GU342,"Mr Del Rosario said that despite the impasse, ""we resolved to seek a diplomatic solution to the issue"".",69,79,diplomatic,4,0,4
382GHPVPHSSF9UX616IUN33M4GU342,"Mr Del Rosario said that despite the impasse, ""we resolved to seek a diplomatic solution to the issue"".",69,88,diplomatic solution,5,0,5
382GHPVPHSSF9UX616IUN33M4GU342,"Mr Del Rosario said that despite the impasse, ""we resolved to seek a diplomatic solution to the issue"".",96,101,issue,0,1,1
3JHB4BPSFKA8D19KGCQHHJ7D00M9Q7,"Our stand since we agreed to acquire Motorola has not changed and we look forward to closing the deal, a Google spokesperson told AFP.",1,10,Our stand,0,1,1
3JHB4BPSFKA8D19KGCQHHJ7D00M9Q7,"Our stand since we agreed to acquire Motorola has not changed and we look forward to closing the deal, a Google spokesperson told AFP.",5,10,stand,0,2,2
3JHB4BPSFKA8D19KGCQHHJ7D00M9Q7,"Our stand since we agreed to acquire Motorola has not changed and we look forward to closing the deal, a Google spokesperson told AFP.",30,37,acquire,9,7,16
3JHB4BPSFKA8D19KGCQHHJ7D00M9Q7,"Our stand since we agreed to acquire Motorola has not changed and we look forward to closing the deal, a Google spokesperson told AFP.",70,85,look forward to,0,1,1
3JHB4BPSFKA8D19KGCQHHJ7D00M9Q7,"Our stand since we agreed to acquire Motorola has not changed and we look forward to closing the deal, a Google spokesperson told AFP.",86,102,closing the deal,2,0,2
3JHB4BPSFKA8D19KGCQHHJ7D00M9Q7,"Our stand since we agreed to acquire Motorola has not changed and we look forward to closing the deal, a Google spokesperson told AFP.",98,102,deal,0,1,1
3JHB4BPSFKA8D19KGCQHHJ7D00M9Q7,"Our stand since we agreed to acquire Motorola has not changed and we look forward to closing the deal, a Google spokesperson told AFP.",114,126,spokesperson,4,6,10
3JHB4BPSFKA8D19KGCQHHJ7D00M9Q7,"Our stand since we agreed to acquire Motorola has not changed and we look forward to closing the deal, a Google spokesperson told AFP.",132,135,AFP,1,0,1
3JHB4BPSFKA8D19KGCQHHJ7D00M9Q7,"Google will acquire 17,000 patents with the purchase of Motorola Mobility and has been strengthening its patent portfolio as the fight for dominance in the booming smartphone and tablet market increasingly involves lawsuits claiming infringement of patented technology.",12,19,acquire,3,2,5
3JHB4BPSFKA8D19KGCQHHJ7D00M9Q7,"Google will acquire 17,000 patents with the purchase of Motorola Mobility and has been strengthening its patent portfolio as the fight for dominance in the booming smartphone and tablet market increasingly involves lawsuits claiming infringement of patented technology.",27,34,patents,9,0,9
3JHB4BPSFKA8D19KGCQHHJ7D00M9Q7,"Google will acquire 17,000 patents with the purchase of Motorola Mobility and has been strengthening its patent portfolio as the fight for dominance in the booming smartphone and tablet market increasingly involves lawsuits claiming infringement of patented technology.",44,52,purchase,1,0,1
3JHB4BPSFKA8D19KGCQHHJ7D00M9Q7,"Google will acquire 17,000 patents with the purchase of Motorola Mobility and has been strengthening its patent portfolio as the fight for dominance in the booming smartphone and tablet market increasingly involves lawsuits claiming infringement of patented technology.",87,100,strengthening,6,4,10
3JHB4BPSFKA8D19KGCQHHJ7D00M9Q7,"Google will acquire 17,000 patents with the purchase of Motorola Mobility and has been strengthening its patent portfolio as the fight for dominance in the booming smartphone and tablet market increasingly involves lawsuits claiming infringement of patented technology.",105,111,patent,1,0,1
3JHB4BPSFKA8D19KGCQHHJ7D00M9Q7,"Google will acquire 17,000 patents with the purchase of Motorola Mobility and has been strengthening its patent portfolio as the fight for dominance in the booming smartphone and tablet market increasingly involves lawsuits claiming infringement of patented technology.",105,121,patent portfolio,9,5,14
3JHB4BPSFKA8D19KGCQHHJ7D00M9Q7,"Google will acquire 17,000 patents with the purchase of Motorola Mobility and has been strengthening its patent portfolio as the fight for dominance in the booming smartphone and tablet market increasingly involves lawsuits claiming infringement of patented technology.",112,121,portfolio,2,3,5
3JHB4BPSFKA8D19KGCQHHJ7D00M9Q7,"Google will acquire 17,000 patents with the purchase of Motorola Mobility and has been strengthening its patent portfolio as the fight for dominance in the booming smartphone and tablet market increasingly involves lawsuits claiming infringement of patented technology.",129,148,fight for dominance,0,1,1
3JHB4BPSFKA8D19KGCQHHJ7D00M9Q7,"Google will acquire 17,000 patents with the purchase of Motorola Mobility and has been strengthening its patent portfolio as the fight for dominance in the booming smartphone and tablet market increasingly involves lawsuits claiming infringement of patented technology.",139,148,dominance,10,4,14
3JHB4BPSFKA8D19KGCQHHJ7D00M9Q7,"Google will acquire 17,000 patents with the purchase of Motorola Mobility and has been strengthening its patent portfolio as the fight for dominance in the booming smartphone and tablet market increasingly involves lawsuits claiming infringement of patented technology.",156,163,booming,3,5,8
3JHB4BPSFKA8D19KGCQHHJ7D00M9Q7,"Google will acquire 17,000 patents with the purchase of Motorola Mobility and has been strengthening its patent portfolio as the fight for dominance in the booming smartphone and tablet market increasingly involves lawsuits claiming infringement of patented technology.",164,174,smartphone,1,0,1
3JHB4BPSFKA8D19KGCQHHJ7D00M9Q7,"Google will acquire 17,000 patents with the purchase of Motorola Mobility and has been strengthening its patent portfolio as the fight for dominance in the booming smartphone and tablet market increasingly involves lawsuits claiming infringement of patented technology.",193,205,increasingly,1,0,1
3JHB4BPSFKA8D19KGCQHHJ7D00M9Q7,"Google will acquire 17,000 patents with the purchase of Motorola Mobility and has been strengthening its patent portfolio as the fight for dominance in the booming smartphone and tablet market increasingly involves lawsuits claiming infringement of patented technology.",215,223,lawsuits,0,3,3
3JHB4BPSFKA8D19KGCQHHJ7D00M9Q7,"Google will acquire 17,000 patents with the purchase of Motorola Mobility and has been strengthening its patent portfolio as the fight for dominance in the booming smartphone and tablet market increasingly involves lawsuits claiming infringement of patented technology.",233,245,infringement,10,10,20
3JHB4BPSFKA8D19KGCQHHJ7D00M9Q7,"Google will acquire 17,000 patents with the purchase of Motorola Mobility and has been strengthening its patent portfolio as the fight for dominance in the booming smartphone and tablet market increasingly involves lawsuits claiming infringement of patented technology.",233,268,infringement of patented technology,1,0,1
3JHB4BPSFKA8D19KGCQHHJ7D00M9Q7,"Google will acquire 17,000 patents with the purchase of Motorola Mobility and has been strengthening its patent portfolio as the fight for dominance in the booming smartphone and tablet market increasingly involves lawsuits claiming infringement of patented technology.",249,257,patented,4,1,5
3JHB4BPSFKA8D19KGCQHHJ7D00M9Q7,"Google will acquire 17,000 patents with the purchase of Motorola Mobility and has been strengthening its patent portfolio as the fight for dominance in the booming smartphone and tablet market increasingly involves lawsuits claiming infringement of patented technology.",249,268,patented technology,5,0,5
3JHB4BPSFKA8D19KGCQHHJ7D00M9Q7,"Google will acquire 17,000 patents with the purchase of Motorola Mobility and has been strengthening its patent portfolio as the fight for dominance in the booming smartphone and tablet market increasingly involves lawsuits claiming infringement of patented technology.",258,268,technology,1,0,1
3JHB4BPSFKA8D19KGCQHHJ7D00M9Q7,"Apple and South Korea's Samsung, whose devices are powered by Google's Android software, are currently involved in lengthy and costly patent fights being waged on several continents.",103,111,involved,0,1,1
3JHB4BPSFKA8D19KGCQHHJ7D00M9Q7,"Apple and South Korea's Samsung, whose devices are powered by Google's Android software, are currently involved in lengthy and costly patent fights being waged on several continents.",115,133,lengthy and costly,0,1,1
3JHB4BPSFKA8D19KGCQHHJ7D00M9Q7,"Apple and South Korea's Samsung, whose devices are powered by Google's Android software, are currently involved in lengthy and costly patent fights being waged on several continents.",134,140,patent,4,1,5
3JHB4BPSFKA8D19KGCQHHJ7D00M9Q7,"Apple and South Korea's Samsung, whose devices are powered by Google's Android software, are currently involved in lengthy and costly patent fights being waged on several continents.",134,147,patent fights,2,2,4
3JHB4BPSFKA8D19KGCQHHJ7D00M9Q7,"Apple and South Korea's Samsung, whose devices are powered by Google's Android software, are currently involved in lengthy and costly patent fights being waged on several continents.",154,159,waged,3,7,10
3JHB4BPSFKA8D19KGCQHHJ7D00M9Q7,"Apple and South Korea's Samsung, whose devices are powered by Google's Android software, are currently involved in lengthy and costly patent fights being waged on several continents.",171,181,continents,2,0,2
3JHB4BPSFKA8D19KGCQHHJ7D00M9Q7,"In announcing the Motorola Mobility acquisition in August, Google chief executive Larry Page said it will ""enable us to better protect Android from anti-competitive threats from Microsoft, Apple and other companies.""",3,13,announcing,1,0,1
3JHB4BPSFKA8D19KGCQHHJ7D00M9Q7,"In announcing the Motorola Mobility acquisition in August, Google chief executive Larry Page said it will ""enable us to better protect Android from anti-competitive threats from Microsoft, Apple and other companies.""",36,47,acquisition,10,8,18
3JHB4BPSFKA8D19KGCQHHJ7D00M9Q7,"In announcing the Motorola Mobility acquisition in August, Google chief executive Larry Page said it will ""enable us to better protect Android from anti-competitive threats from Microsoft, Apple and other companies.""",66,81,chief executive,0,1,1
3JHB4BPSFKA8D19KGCQHHJ7D00M9Q7,"In announcing the Motorola Mobility acquisition in August, Google chief executive Larry Page said it will ""enable us to better protect Android from anti-competitive threats from Microsoft, Apple and other companies.""",72,81,executive,1,0,1
3JHB4BPSFKA8D19KGCQHHJ7D00M9Q7,"In announcing the Motorola Mobility acquisition in August, Google chief executive Larry Page said it will ""enable us to better protect Android from anti-competitive threats from Microsoft, Apple and other companies.""",107,113,enable,1,1,2
3JHB4BPSFKA8D19KGCQHHJ7D00M9Q7,"In announcing the Motorola Mobility acquisition in August, Google chief executive Larry Page said it will ""enable us to better protect Android from anti-competitive threats from Microsoft, Apple and other companies.""",148,164,anti-competitive,7,2,9
3JHB4BPSFKA8D19KGCQHHJ7D00M9Q7,"In announcing the Motorola Mobility acquisition in August, Google chief executive Larry Page said it will ""enable us to better protect Android from anti-competitive threats from Microsoft, Apple and other companies.""",148,172,anti-competitive threats,4,3,7
3S8APUMBJXKUA5Y80GTJWQYPHYGFBT,"WFTV, Orlando, Fla., reported officers saw someone come outside briefly with a gun, before retreating into the house.",15,18,Fla,1,0,1
3S8APUMBJXKUA5Y80GTJWQYPHYGFBT,"WFTV, Orlando, Fla., reported officers saw someone come outside briefly with a gun, before retreating into the house.",21,29,reported,1,0,1
3S8APUMBJXKUA5Y80GTJWQYPHYGFBT,"WFTV, Orlando, Fla., reported officers saw someone come outside briefly with a gun, before retreating into the house.",51,71,come outside briefly,1,0,1
3S8APUMBJXKUA5Y80GTJWQYPHYGFBT,"WFTV, Orlando, Fla., reported officers saw someone come outside briefly with a gun, before retreating into the house.",64,71,briefly,3,4,7
3S8APUMBJXKUA5Y80GTJWQYPHYGFBT,"WFTV, Orlando, Fla., reported officers saw someone come outside briefly with a gun, before retreating into the house.",91,101,retreating,8,10,18
3S8APUMBJXKUA5Y80GTJWQYPHYGFBT,"WFTV, Orlando, Fla., reported officers saw someone come outside briefly with a gun, before retreating into the house.",91,116,retreating into the house,1,0,1
3S8APUMBJXKUA5Y80GTJWQYPHYGFBT,One last shot followed before two SWAT teams were dispatched to enter the home.,14,22,followed,0,1,1
3S8APUMBJXKUA5Y80GTJWQYPHYGFBT,One last shot followed before two SWAT teams were dispatched to enter the home.,34,38,SWAT,1,2,3
3S8APUMBJXKUA5Y80GTJWQYPHYGFBT,One last shot followed before two SWAT teams were dispatched to enter the home.,34,44,SWAT teams,3,3,6
3S8APUMBJXKUA5Y80GTJWQYPHYGFBT,One last shot followed before two SWAT teams were dispatched to enter the home.,50,60,dispatched,9,10,19
3S8APUMBJXKUA5Y80GTJWQYPHYGFBT,"It was there officers found the bodies of Tonya Thomas, 33, Joel Johnson, 12, Jazlin Johnson, 13, and Jaxs Johnson, 15.",78,84,Jazlin,0,1,1
3S8APUMBJXKUA5Y80GTJWQYPHYGFBT,Sheriff's deputies said Thomas appeared to have died from a self-inflicted gunshot wound and apparently shot her four children.,0,7,Sheriff,1,0,1
3S8APUMBJXKUA5Y80GTJWQYPHYGFBT,Sheriff's deputies said Thomas appeared to have died from a self-inflicted gunshot wound and apparently shot her four children.,0,8,Sheriffs,0,1,1
3S8APUMBJXKUA5Y80GTJWQYPHYGFBT,Sheriff's deputies said Thomas appeared to have died from a self-inflicted gunshot wound and apparently shot her four children.,10,18,deputies,2,3,5
3S8APUMBJXKUA5Y80GTJWQYPHYGFBT,Sheriff's deputies said Thomas appeared to have died from a self-inflicted gunshot wound and apparently shot her four children.,31,39,appeared,1,0,1
3S8APUMBJXKUA5Y80GTJWQYPHYGFBT,Sheriff's deputies said Thomas appeared to have died from a self-inflicted gunshot wound and apparently shot her four children.,60,74,self-inflicted,10,10,20
3S8APUMBJXKUA5Y80GTJWQYPHYGFBT,Sheriff's deputies said Thomas appeared to have died from a self-inflicted gunshot wound and apparently shot her four children.,75,82,gunshot,1,0,1
3S8APUMBJXKUA5Y80GTJWQYPHYGFBT,Sheriff's deputies said Thomas appeared to have died from a self-inflicted gunshot wound and apparently shot her four children.,93,103,apparently,5,4,9
3S8APUMBJXKUA5Y80GTJWQYPHYGFBT,WFTV reported Thomas sent a text message to her neighbor around 3 a.m. saying she wanted to be cremated with her children.,28,40,text message,1,1,2
3S8APUMBJXKUA5Y80GTJWQYPHYGFBT,WFTV reported Thomas sent a text message to her neighbor around 3 a.m. saying she wanted to be cremated with her children.,48,56,neighbor,1,0,1
3S8APUMBJXKUA5Y80GTJWQYPHYGFBT,WFTV reported Thomas sent a text message to her neighbor around 3 a.m. saying she wanted to be cremated with her children.,95,103,cremated,10,10,20
3S8APUMBJXKUA5Y80GTJWQYPHYGFBT,"The neighbor, who was asleep, did not see the text message until after shots were heard.",4,12,neighbor,0,2,2
3S8APUMBJXKUA5Y80GTJWQYPHYGFBT,"The neighbor, who was asleep, did not see the text message until after shots were heard.",22,28,asleep,0,1,1
3S8APUMBJXKUA5Y80GTJWQYPHYGFBT,"WKMG-TV, Orlando, Fla., reported police had been called to the home for a domestic disturbance a few weeks ago.",18,21,Fla,1,0,1
3S8APUMBJXKUA5Y80GTJWQYPHYGFBT,"WKMG-TV, Orlando, Fla., reported police had been called to the home for a domestic disturbance a few weeks ago.",24,32,reported,0,1,1
3S8APUMBJXKUA5Y80GTJWQYPHYGFBT,"WKMG-TV, Orlando, Fla., reported police had been called to the home for a domestic disturbance a few weeks ago.",74,82,domestic,1,0,1
3S8APUMBJXKUA5Y80GTJWQYPHYGFBT,"WKMG-TV, Orlando, Fla., reported police had been called to the home for a domestic disturbance a few weeks ago.",74,94,domestic disturbance,10,5,15
3S8APUMBJXKUA5Y80GTJWQYPHYGFBT,"WKMG-TV, Orlando, Fla., reported police had been called to the home for a domestic disturbance a few weeks ago.",83,94,disturbance,1,2,3
3SBX2M1TKDO7GV38ZHUQ0BWXDV5Q4Y,The extra capital will have to be raised by the banks themselves or from government loans for which an interest of 10 percent will be charged.,4,17,extra capital,0,1,1
3SBX2M1TKDO7GV38ZHUQ0BWXDV5Q4Y,The extra capital will have to be raised by the banks themselves or from government loans for which an interest of 10 percent will be charged.,10,17,capital,6,0,6
3SBX2M1TKDO7GV38ZHUQ0BWXDV5Q4Y,The extra capital will have to be raised by the banks themselves or from government loans for which an interest of 10 percent will be charged.,34,40,raised,0,2,2
3SBX2M1TKDO7GV38ZHUQ0BWXDV5Q4Y,The extra capital will have to be raised by the banks themselves or from government loans for which an interest of 10 percent will be charged.,73,83,government,1,0,1
3SBX2M1TKDO7GV38ZHUQ0BWXDV5Q4Y,The extra capital will have to be raised by the banks themselves or from government loans for which an interest of 10 percent will be charged.,73,89,government loans,1,0,1
3SBX2M1TKDO7GV38ZHUQ0BWXDV5Q4Y,The extra capital will have to be raised by the banks themselves or from government loans for which an interest of 10 percent will be charged.,134,141,charged,1,2,3
3SBX2M1TKDO7GV38ZHUQ0BWXDV5Q4Y,"Earlier this year, the government had obliged Spanish banks to find 54 billion euros of extra capital to shield against bad loans.",23,33,government,1,0,1
3SBX2M1TKDO7GV38ZHUQ0BWXDV5Q4Y,"Earlier this year, the government had obliged Spanish banks to find 54 billion euros of extra capital to shield against bad loans.",38,45,obliged,10,10,20
3SBX2M1TKDO7GV38ZHUQ0BWXDV5Q4Y,"Earlier this year, the government had obliged Spanish banks to find 54 billion euros of extra capital to shield against bad loans.",79,84,euros,0,1,1
3SBX2M1TKDO7GV38ZHUQ0BWXDV5Q4Y,"Earlier this year, the government had obliged Spanish banks to find 54 billion euros of extra capital to shield against bad loans.",102,119,to shield against,1,0,1
3SBX2M1TKDO7GV38ZHUQ0BWXDV5Q4Y,"Earlier this year, the government had obliged Spanish banks to find 54 billion euros of extra capital to shield against bad loans.",105,111,shield,5,8,13
3SBX2M1TKDO7GV38ZHUQ0BWXDV5Q4Y,"Earlier this year, the government had obliged Spanish banks to find 54 billion euros of extra capital to shield against bad loans.",105,119,shield against,1,0,1
3SBX2M1TKDO7GV38ZHUQ0BWXDV5Q4Y,"Earlier this year, the government had obliged Spanish banks to find 54 billion euros of extra capital to shield against bad loans.",120,129,bad loans,0,1,1
3SBX2M1TKDO7GV38ZHUQ0BWXDV5Q4Y,De Guindos said the decision had been taken to restore confidence and credibility in Spain's financial system.,20,28,decision,0,1,1
3SBX2M1TKDO7GV38ZHUQ0BWXDV5Q4Y,De Guindos said the decision had been taken to restore confidence and credibility in Spain's financial system.,47,54,restore,3,3,6
3SBX2M1TKDO7GV38ZHUQ0BWXDV5Q4Y,De Guindos said the decision had been taken to restore confidence and credibility in Spain's financial system.,47,65,restore confidence,1,1,2
3SBX2M1TKDO7GV38ZHUQ0BWXDV5Q4Y,De Guindos said the decision had been taken to restore confidence and credibility in Spain's financial system.,55,65,confidence,2,1,3
3SBX2M1TKDO7GV38ZHUQ0BWXDV5Q4Y,De Guindos said the decision had been taken to restore confidence and credibility in Spain's financial system.,70,81,credibility,10,10,20
3SBX2M1TKDO7GV38ZHUQ0BWXDV5Q4Y,De Guindos said the decision had been taken to restore confidence and credibility in Spain's financial system.,93,102,financial,1,1,2
3SBX2M1TKDO7GV38ZHUQ0BWXDV5Q4Y,"The move comes just two days after the government nationalized 45 percent of Bankia, the country's fourth biggest bank.",39,62,government nationalized,1,0,1
3SBX2M1TKDO7GV38ZHUQ0BWXDV5Q4Y,"The move comes just two days after the government nationalized 45 percent of Bankia, the country's fourth biggest bank.",50,62,nationalized,8,3,11
3SBX2M1TKDO7GV38ZHUQ0BWXDV5Q4Y,"At the end of last month, ratings agency Standard and Poor's downgraded a majority of Spain's banks.",26,40,ratings agency,2,1,3
3SBX2M1TKDO7GV38ZHUQ0BWXDV5Q4Y,"At the end of last month, ratings agency Standard and Poor's downgraded a majority of Spain's banks.",41,58,Standard and Poor,1,0,1
3SBX2M1TKDO7GV38ZHUQ0BWXDV5Q4Y,"At the end of last month, ratings agency Standard and Poor's downgraded a majority of Spain's banks.",41,59,Standard and Poors,1,0,1
3SBX2M1TKDO7GV38ZHUQ0BWXDV5Q4Y,"At the end of last month, ratings agency Standard and Poor's downgraded a majority of Spain's banks.",61,71,downgraded,7,10,17
3SBX2M1TKDO7GV38ZHUQ0BWXDV5Q4Y,"At the end of last month, ratings agency Standard and Poor's downgraded a majority of Spain's banks.",74,82,majority,0,1,1
3SBX2M1TKDO7GV38ZHUQ0BWXDV5Q4Y,The government has decided to appoint two independent auditors who will have the task of valuing the real-estate portfolios of the country's banks.,19,26,decided,0,1,1
3SBX2M1TKDO7GV38ZHUQ0BWXDV5Q4Y,The government has decided to appoint two independent auditors who will have the task of valuing the real-estate portfolios of the country's banks.,30,37,appoint,1,1,2
3SBX2M1TKDO7GV38ZHUQ0BWXDV5Q4Y,The government has decided to appoint two independent auditors who will have the task of valuing the real-estate portfolios of the country's banks.,42,62,independent auditors,4,1,5
3SBX2M1TKDO7GV38ZHUQ0BWXDV5Q4Y,The government has decided to appoint two independent auditors who will have the task of valuing the real-estate portfolios of the country's banks.,54,62,auditors,8,4,12
3SBX2M1TKDO7GV38ZHUQ0BWXDV5Q4Y,The government has decided to appoint two independent auditors who will have the task of valuing the real-estate portfolios of the country's banks.,89,96,valuing,2,5,7
3SBX2M1TKDO7GV38ZHUQ0BWXDV5Q4Y,The government has decided to appoint two independent auditors who will have the task of valuing the real-estate portfolios of the country's banks.,101,112,real-estate,0,2,2
3SBX2M1TKDO7GV38ZHUQ0BWXDV5Q4Y,The government has decided to appoint two independent auditors who will have the task of valuing the real-estate portfolios of the country's banks.,101,123,real-estate portfolios,7,1,8
3SBX2M1TKDO7GV38ZHUQ0BWXDV5Q4Y,The government has decided to appoint two independent auditors who will have the task of valuing the real-estate portfolios of the country's banks.,113,123,portfolios,6,9,15
3PR3LXCWSF0SMYAW2QL9BR36W2L9XD,The president flew in secret to sign a long-awaited security compact with Afghanistan.,4,13,president,1,0,1
3PR3LXCWSF0SMYAW2QL9BR36W2L9XD,The president flew in secret to sign a long-awaited security compact with Afghanistan.,14,18,flew,0,2,2
3PR3LXCWSF0SMYAW2QL9BR36W2L9XD,The president flew in secret to sign a long-awaited security compact with Afghanistan.,39,51,long-awaited,3,7,10
3PR3LXCWSF0SMYAW2QL9BR36W2L9XD,The president flew in secret to sign a long-awaited security compact with Afghanistan.,39,68,long-awaited security compact,0,1,1
3PR3LXCWSF0SMYAW2QL9BR36W2L9XD,The president flew in secret to sign a long-awaited security compact with Afghanistan.,52,68,security compact,4,3,7
3PR3LXCWSF0SMYAW2QL9BR36W2L9XD,The president flew in secret to sign a long-awaited security compact with Afghanistan.,61,68,compact,4,4,8
3PR3LXCWSF0SMYAW2QL9BR36W2L9XD,"It was after midnight in Kabul when the signing took place, and 4 a.m. there when Obama addressed Americans in a specially arranged speech at 7:30 p.m. Washington time on network television.",36,47,the signing,0,1,1
3PR3LXCWSF0SMYAW2QL9BR36W2L9XD,"It was after midnight in Kabul when the signing took place, and 4 a.m. there when Obama addressed Americans in a specially arranged speech at 7:30 p.m. Washington time on network television.",40,47,signing,1,0,1
3PR3LXCWSF0SMYAW2QL9BR36W2L9XD,"It was after midnight in Kabul when the signing took place, and 4 a.m. there when Obama addressed Americans in a specially arranged speech at 7:30 p.m. Washington time on network television.",88,97,addressed,2,2,4
3PR3LXCWSF0SMYAW2QL9BR36W2L9XD,"It was after midnight in Kabul when the signing took place, and 4 a.m. there when Obama addressed Americans in a specially arranged speech at 7:30 p.m. Washington time on network television.",113,122,specially,1,0,1
3PR3LXCWSF0SMYAW2QL9BR36W2L9XD,"It was after midnight in Kabul when the signing took place, and 4 a.m. there when Obama addressed Americans in a specially arranged speech at 7:30 p.m. Washington time on network television.",113,131,specially arranged,2,1,3
3PR3LXCWSF0SMYAW2QL9BR36W2L9XD,"It was after midnight in Kabul when the signing took place, and 4 a.m. there when Obama addressed Americans in a specially arranged speech at 7:30 p.m. Washington time on network television.",123,131,arranged,2,4,6
3PR3LXCWSF0SMYAW2QL9BR36W2L9XD,"It was after midnight in Kabul when the signing took place, and 4 a.m. there when Obama addressed Americans in a specially arranged speech at 7:30 p.m. Washington time on network television.",171,189,network television,1,0,1
3PR3LXCWSF0SMYAW2QL9BR36W2L9XD,"It was after midnight in Kabul when the signing took place, and 4 a.m. there when Obama addressed Americans in a specially arranged speech at 7:30 p.m. Washington time on network television.",179,189,television,1,0,1
3PR3LXCWSF0SMYAW2QL9BR36W2L9XD,"My fellow Americans, Obama said from Bagram Air Field, ""we have traveled through more than a decade under the dark cloud of war.",4,10,fellow,0,1,1
3PR3LXCWSF0SMYAW2QL9BR36W2L9XD,"My fellow Americans, Obama said from Bagram Air Field, ""we have traveled through more than a decade under the dark cloud of war.",39,45,Bagram,0,1,1
3PR3LXCWSF0SMYAW2QL9BR36W2L9XD,"My fellow Americans, Obama said from Bagram Air Field, ""we have traveled through more than a decade under the dark cloud of war.",95,101,decade,2,7,9
3PR3LXCWSF0SMYAW2QL9BR36W2L9XD,"My fellow Americans, Obama said from Bagram Air Field, ""we have traveled through more than a decade under the dark cloud of war.",112,122,dark cloud,1,1,2
3PR3LXCWSF0SMYAW2QL9BR36W2L9XD,"My fellow Americans, Obama said from Bagram Air Field, ""we have traveled through more than a decade under the dark cloud of war.",112,129,dark cloud of war,3,1,4
3PR3LXCWSF0SMYAW2QL9BR36W2L9XD,"Yet here, in the predawn darkness of Afghanistan, we can see the light of a new day on the horizon.""",17,24,predawn,7,10,17
3PR3LXCWSF0SMYAW2QL9BR36W2L9XD,"Yet here, in the predawn darkness of Afghanistan, we can see the light of a new day on the horizon.""",17,33,predawn darkness,3,2,5
3PR3LXCWSF0SMYAW2QL9BR36W2L9XD,"Yet here, in the predawn darkness of Afghanistan, we can see the light of a new day on the horizon.""",91,98,horizon,5,7,12
3PR3LXCWSF0SMYAW2QL9BR36W2L9XD,"The backdrop of armored troop carriers matched Obama's message of praise for U.S. forces who fought and died in Afghanistan, but it was an odd fit for what followed — a direct appeal to American optimism and self-interest in an election year.",4,12,backdrop,6,9,15
3PR3LXCWSF0SMYAW2QL9BR36W2L9XD,"The backdrop of armored troop carriers matched Obama's message of praise for U.S. forces who fought and died in Afghanistan, but it was an odd fit for what followed — a direct appeal to American optimism and self-interest in an election year.",16,23,armored,4,7,11
3PR3LXCWSF0SMYAW2QL9BR36W2L9XD,"The backdrop of armored troop carriers matched Obama's message of praise for U.S. forces who fought and died in Afghanistan, but it was an odd fit for what followed — a direct appeal to American optimism and self-interest in an election year.",16,38,armored troop carriers,4,0,4
3PR3LXCWSF0SMYAW2QL9BR36W2L9XD,"The backdrop of armored troop carriers matched Obama's message of praise for U.S. forces who fought and died in Afghanistan, but it was an odd fit for what followed — a direct appeal to American optimism and self-interest in an election year.",24,38,troop carriers,1,0,1
3PR3LXCWSF0SMYAW2QL9BR36W2L9XD,"The backdrop of armored troop carriers matched Obama's message of praise for U.S. forces who fought and died in Afghanistan, but it was an odd fit for what followed — a direct appeal to American optimism and self-interest in an election year.",55,62,message,1,0,1
3PR3LXCWSF0SMYAW2QL9BR36W2L9XD,"The backdrop of armored troop carriers matched Obama's message of praise for U.S. forces who fought and died in Afghanistan, but it was an odd fit for what followed — a direct appeal to American optimism and self-interest in an election year.",66,72,praise,0,1,1
3PR3LXCWSF0SMYAW2QL9BR36W2L9XD,"The backdrop of armored troop carriers matched Obama's message of praise for U.S. forces who fought and died in Afghanistan, but it was an odd fit for what followed — a direct appeal to American optimism and self-interest in an election year.",93,99,fought,0,1,1
3PR3LXCWSF0SMYAW2QL9BR36W2L9XD,"The backdrop of armored troop carriers matched Obama's message of praise for U.S. forces who fought and died in Afghanistan, but it was an odd fit for what followed — a direct appeal to American optimism and self-interest in an election year.",139,142,odd,0,1,1
3PR3LXCWSF0SMYAW2QL9BR36W2L9XD,"The backdrop of armored troop carriers matched Obama's message of praise for U.S. forces who fought and died in Afghanistan, but it was an odd fit for what followed — a direct appeal to American optimism and self-interest in an election year.",139,146,odd fit,3,4,7
3PR3LXCWSF0SMYAW2QL9BR36W2L9XD,"The backdrop of armored troop carriers matched Obama's message of praise for U.S. forces who fought and died in Afghanistan, but it was an odd fit for what followed — a direct appeal to American optimism and self-interest in an election year.",143,146,fit,1,0,1
3PR3LXCWSF0SMYAW2QL9BR36W2L9XD,"The backdrop of armored troop carriers matched Obama's message of praise for U.S. forces who fought and died in Afghanistan, but it was an odd fit for what followed — a direct appeal to American optimism and self-interest in an election year.",169,182,direct appeal,0,1,1
3PR3LXCWSF0SMYAW2QL9BR36W2L9XD,"The backdrop of armored troop carriers matched Obama's message of praise for U.S. forces who fought and died in Afghanistan, but it was an odd fit for what followed — a direct appeal to American optimism and self-interest in an election year.",176,182,appeal,3,2,5
3PR3LXCWSF0SMYAW2QL9BR36W2L9XD,"The backdrop of armored troop carriers matched Obama's message of praise for U.S. forces who fought and died in Afghanistan, but it was an odd fit for what followed — a direct appeal to American optimism and self-interest in an election year.",186,203,American optimism,0,1,1
3PR3LXCWSF0SMYAW2QL9BR36W2L9XD,"The backdrop of armored troop carriers matched Obama's message of praise for U.S. forces who fought and died in Afghanistan, but it was an odd fit for what followed — a direct appeal to American optimism and self-interest in an election year.",195,203,optimism,8,10,18
3PR3LXCWSF0SMYAW2QL9BR36W2L9XD,"The backdrop of armored troop carriers matched Obama's message of praise for U.S. forces who fought and died in Afghanistan, but it was an odd fit for what followed — a direct appeal to American optimism and self-interest in an election year.",208,221,self-interest,5,6,11
3WPCIUYH1A9X87ET9WPE8K1QAFXDTC,"Fighting flared in Tripoli again on Monday, leaving two people dead and nine wounded, a security official told the AFP news agency.",0,15,Fighting flared,1,1,2
3WPCIUYH1A9X87ET9WPE8K1QAFXDTC,"Fighting flared in Tripoli again on Monday, leaving two people dead and nine wounded, a security official told the AFP news agency.",9,15,flared,8,10,18
3WPCIUYH1A9X87ET9WPE8K1QAFXDTC,"Fighting flared in Tripoli again on Monday, leaving two people dead and nine wounded, a security official told the AFP news agency.",19,26,Tripoli,1,0,1
3WPCIUYH1A9X87ET9WPE8K1QAFXDTC,"Fighting flared in Tripoli again on Monday, leaving two people dead and nine wounded, a security official told the AFP news agency.",77,84,wounded,1,1,2
3WPCIUYH1A9X87ET9WPE8K1QAFXDTC,"Fighting flared in Tripoli again on Monday, leaving two people dead and nine wounded, a security official told the AFP news agency.",88,96,security,1,0,1
3WPCIUYH1A9X87ET9WPE8K1QAFXDTC,"Fighting flared in Tripoli again on Monday, leaving two people dead and nine wounded, a security official told the AFP news agency.",115,118,AFP,1,0,1
3WPCIUYH1A9X87ET9WPE8K1QAFXDTC,"France, the eurozone's second largest economy, is headed for a 4.5 percent deficit, the commission said, despite a forecast of slight growth.",12,21,eurozones,5,0,5
3WPCIUYH1A9X87ET9WPE8K1QAFXDTC,"France, the eurozone's second largest economy, is headed for a 4.5 percent deficit, the commission said, despite a forecast of slight growth.",38,45,economy,1,1,2
3WPCIUYH1A9X87ET9WPE8K1QAFXDTC,"France, the eurozone's second largest economy, is headed for a 4.5 percent deficit, the commission said, despite a forecast of slight growth.",75,82,deficit,9,7,16
3WPCIUYH1A9X87ET9WPE8K1QAFXDTC,"France, the eurozone's second largest economy, is headed for a 4.5 percent deficit, the commission said, despite a forecast of slight growth.",88,98,commission,4,1,5
3WPCIUYH1A9X87ET9WPE8K1QAFXDTC,"France, the eurozone's second largest economy, is headed for a 4.5 percent deficit, the commission said, despite a forecast of slight growth.",105,112,despite,0,2,2
3WPCIUYH1A9X87ET9WPE8K1QAFXDTC,"France, the eurozone's second largest economy, is headed for a 4.5 percent deficit, the commission said, despite a forecast of slight growth.",115,123,forecast,4,7,11
3WPCIUYH1A9X87ET9WPE8K1QAFXDTC,"France, the eurozone's second largest economy, is headed for a 4.5 percent deficit, the commission said, despite a forecast of slight growth.",127,133,slight,0,1,1
3WPCIUYH1A9X87ET9WPE8K1QAFXDTC,"The EU forecasts  show that the 17-nation eurozone, which includes Spain, France and powerhouse Germany, will overall only make slow recovery from recession later this year.",4,16,EU forecasts,0,1,1
3WPCIUYH1A9X87ET9WPE8K1QAFXDTC,"The EU forecasts  show that the 17-nation eurozone, which includes Spain, France and powerhouse Germany, will overall only make slow recovery from recession later this year.",7,16,forecasts,0,1,1
3WPCIUYH1A9X87ET9WPE8K1QAFXDTC,"The EU forecasts  show that the 17-nation eurozone, which includes Spain, France and powerhouse Germany, will overall only make slow recovery from recession later this year.",42,50,eurozone,0,1,1
3WPCIUYH1A9X87ET9WPE8K1QAFXDTC,"The EU forecasts  show that the 17-nation eurozone, which includes Spain, France and powerhouse Germany, will overall only make slow recovery from recession later this year.",85,95,powerhouse,5,2,7
3WPCIUYH1A9X87ET9WPE8K1QAFXDTC,"The EU forecasts  show that the 17-nation eurozone, which includes Spain, France and powerhouse Germany, will overall only make slow recovery from recession later this year.",133,141,recovery,0,1,1
3WPCIUYH1A9X87ET9WPE8K1QAFXDTC,"The EU forecasts  show that the 17-nation eurozone, which includes Spain, France and powerhouse Germany, will overall only make slow recovery from recession later this year.",147,156,recession,9,10,19
3WPCIUYH1A9X87ET9WPE8K1QAFXDTC,"EU's economics affairs commissioner Olli Rehn said he was confident that Spain would tackle its ""immediate fiscal and financial challenges with full determination.""",23,35,commissioner,2,1,3
3WPCIUYH1A9X87ET9WPE8K1QAFXDTC,"EU's economics affairs commissioner Olli Rehn said he was confident that Spain would tackle its ""immediate fiscal and financial challenges with full determination.""",36,45,Olli Rehn,1,0,1
3WPCIUYH1A9X87ET9WPE8K1QAFXDTC,"EU's economics affairs commissioner Olli Rehn said he was confident that Spain would tackle its ""immediate fiscal and financial challenges with full determination.""",58,67,confident,1,2,3
3WPCIUYH1A9X87ET9WPE8K1QAFXDTC,"EU's economics affairs commissioner Olli Rehn said he was confident that Spain would tackle its ""immediate fiscal and financial challenges with full determination.""",85,91,tackle,0,7,7
3WPCIUYH1A9X87ET9WPE8K1QAFXDTC,"EU's economics affairs commissioner Olli Rehn said he was confident that Spain would tackle its ""immediate fiscal and financial challenges with full determination.""",97,106,immediate,0,1,1
3WPCIUYH1A9X87ET9WPE8K1QAFXDTC,"EU's economics affairs commissioner Olli Rehn said he was confident that Spain would tackle its ""immediate fiscal and financial challenges with full determination.""",97,113,immediate fiscal,1,0,1
3WPCIUYH1A9X87ET9WPE8K1QAFXDTC,"EU's economics affairs commissioner Olli Rehn said he was confident that Spain would tackle its ""immediate fiscal and financial challenges with full determination.""",97,138,immediate fiscal and financial challenges,1,0,1
3WPCIUYH1A9X87ET9WPE8K1QAFXDTC,"EU's economics affairs commissioner Olli Rehn said he was confident that Spain would tackle its ""immediate fiscal and financial challenges with full determination.""",107,113,fiscal,8,8,16
3WPCIUYH1A9X87ET9WPE8K1QAFXDTC,"EU's economics affairs commissioner Olli Rehn said he was confident that Spain would tackle its ""immediate fiscal and financial challenges with full determination.""",107,138,fiscal and financial challenges,0,1,1
3WPCIUYH1A9X87ET9WPE8K1QAFXDTC,"EU's economics affairs commissioner Olli Rehn said he was confident that Spain would tackle its ""immediate fiscal and financial challenges with full determination.""",118,127,financial,1,1,2
3WPCIUYH1A9X87ET9WPE8K1QAFXDTC,"EU's economics affairs commissioner Olli Rehn said he was confident that Spain would tackle its ""immediate fiscal and financial challenges with full determination.""",128,138,challenges,0,1,1
3WPCIUYH1A9X87ET9WPE8K1QAFXDTC,"EU's economics affairs commissioner Olli Rehn said he was confident that Spain would tackle its ""immediate fiscal and financial challenges with full determination.""",144,162,full determination,2,0,2
3WPCIUYH1A9X87ET9WPE8K1QAFXDTC,"EU's economics affairs commissioner Olli Rehn said he was confident that Spain would tackle its ""immediate fiscal and financial challenges with full determination.""",149,162,determination,5,3,8
3WPCIUYH1A9X87ET9WPE8K1QAFXDTC,"In particular, Rehn said, Spain's regional governments must reign in what he termed ""excessive spending.""",3,13,particular,0,1,1
3WPCIUYH1A9X87ET9WPE8K1QAFXDTC,"In particular, Rehn said, Spain's regional governments must reign in what he termed ""excessive spending.""",60,65,reign,2,5,7
3WPCIUYH1A9X87ET9WPE8K1QAFXDTC,"In particular, Rehn said, Spain's regional governments must reign in what he termed ""excessive spending.""",60,68,reign in,2,2,4
3WPCIUYH1A9X87ET9WPE8K1QAFXDTC,"In particular, Rehn said, Spain's regional governments must reign in what he termed ""excessive spending.""",77,83,termed,0,1,1
3WPCIUYH1A9X87ET9WPE8K1QAFXDTC,"In particular, Rehn said, Spain's regional governments must reign in what he termed ""excessive spending.""",85,94,excessive,4,1,5
3WPCIUYH1A9X87ET9WPE8K1QAFXDTC,"In particular, Rehn said, Spain's regional governments must reign in what he termed ""excessive spending.""",85,103,excessive spending,2,1,3
3WPCIUYH1A9X87ET9WPE8K1QAFXDTC,"KABUL, Afghanistan (AP) — The Taliban struck back less than two hours after President Barack Obama left Afghanistan on Wednesday, targeting a foreigners' housing compound with a suicide car bomb and militants disguised as women in an assault that killed at least seven people.",30,37,Taliban,1,0,1
3WPCIUYH1A9X87ET9WPE8K1QAFXDTC,"KABUL, Afghanistan (AP) — The Taliban struck back less than two hours after President Barack Obama left Afghanistan on Wednesday, targeting a foreigners' housing compound with a suicide car bomb and militants disguised as women in an assault that killed at least seven people.",38,44,struck,0,1,1
3WPCIUYH1A9X87ET9WPE8K1QAFXDTC,"KABUL, Afghanistan (AP) — The Taliban struck back less than two hours after President Barack Obama left Afghanistan on Wednesday, targeting a foreigners' housing compound with a suicide car bomb and militants disguised as women in an assault that killed at least seven people.",38,49,struck back,0,1,1
3WPCIUYH1A9X87ET9WPE8K1QAFXDTC,"KABUL, Afghanistan (AP) — The Taliban struck back less than two hours after President Barack Obama left Afghanistan on Wednesday, targeting a foreigners' housing compound with a suicide car bomb and militants disguised as women in an assault that killed at least seven people.",130,139,targeting,2,1,3
3WPCIUYH1A9X87ET9WPE8K1QAFXDTC,"KABUL, Afghanistan (AP) — The Taliban struck back less than two hours after President Barack Obama left Afghanistan on Wednesday, targeting a foreigners' housing compound with a suicide car bomb and militants disguised as women in an assault that killed at least seven people.",142,152,foreigners,1,0,1
3WPCIUYH1A9X87ET9WPE8K1QAFXDTC,"KABUL, Afghanistan (AP) — The Taliban struck back less than two hours after President Barack Obama left Afghanistan on Wednesday, targeting a foreigners' housing compound with a suicide car bomb and militants disguised as women in an assault that killed at least seven people.",154,170,housing compound,0,1,1
3WPCIUYH1A9X87ET9WPE8K1QAFXDTC,"KABUL, Afghanistan (AP) — The Taliban struck back less than two hours after President Barack Obama left Afghanistan on Wednesday, targeting a foreigners' housing compound with a suicide car bomb and militants disguised as women in an assault that killed at least seven people.",162,170,compound,1,0,1
3WPCIUYH1A9X87ET9WPE8K1QAFXDTC,"KABUL, Afghanistan (AP) — The Taliban struck back less than two hours after President Barack Obama left Afghanistan on Wednesday, targeting a foreigners' housing compound with a suicide car bomb and militants disguised as women in an assault that killed at least seven people.",178,194,suicide car bomb,1,0,1
3WPCIUYH1A9X87ET9WPE8K1QAFXDTC,"KABUL, Afghanistan (AP) — The Taliban struck back less than two hours after President Barack Obama left Afghanistan on Wednesday, targeting a foreigners' housing compound with a suicide car bomb and militants disguised as women in an assault that killed at least seven people.",199,208,militants,3,2,5
3WPCIUYH1A9X87ET9WPE8K1QAFXDTC,"KABUL, Afghanistan (AP) — The Taliban struck back less than two hours after President Barack Obama left Afghanistan on Wednesday, targeting a foreigners' housing compound with a suicide car bomb and militants disguised as women in an assault that killed at least seven people.",199,227,militants disguised as women,1,0,1
3WPCIUYH1A9X87ET9WPE8K1QAFXDTC,"KABUL, Afghanistan (AP) — The Taliban struck back less than two hours after President Barack Obama left Afghanistan on Wednesday, targeting a foreigners' housing compound with a suicide car bomb and militants disguised as women in an assault that killed at least seven people.",209,218,disguised,4,8,12
3WPCIUYH1A9X87ET9WPE8K1QAFXDTC,"KABUL, Afghanistan (AP) — The Taliban struck back less than two hours after President Barack Obama left Afghanistan on Wednesday, targeting a foreigners' housing compound with a suicide car bomb and militants disguised as women in an assault that killed at least seven people.",234,241,assault,2,4,6
35F6NGNVM8KHRYDJIJMS8SRUPHX7T7,"Egyptian protesters broke into the Israeli Embassy in September, dumping hundreds of documents out of its windows after a day of demonstrations.",9,19,protesters,4,6,10
35F6NGNVM8KHRYDJIJMS8SRUPHX7T7,"Egyptian protesters broke into the Israeli Embassy in September, dumping hundreds of documents out of its windows after a day of demonstrations.",20,25,broke,0,1,1
35F6NGNVM8KHRYDJIJMS8SRUPHX7T7,"Egyptian protesters broke into the Israeli Embassy in September, dumping hundreds of documents out of its windows after a day of demonstrations.",35,50,Israeli Embassy,2,0,2
35F6NGNVM8KHRYDJIJMS8SRUPHX7T7,"Egyptian protesters broke into the Israeli Embassy in September, dumping hundreds of documents out of its windows after a day of demonstrations.",43,50,Embassy,5,0,5
35F6NGNVM8KHRYDJIJMS8SRUPHX7T7,"Egyptian protesters broke into the Israeli Embassy in September, dumping hundreds of documents out of its windows after a day of demonstrations.",65,72,dumping,2,9,11
35F6NGNVM8KHRYDJIJMS8SRUPHX7T7,"Egyptian protesters broke into the Israeli Embassy in September, dumping hundreds of documents out of its windows after a day of demonstrations.",65,94,dumping hundreds of documents,1,0,1
35F6NGNVM8KHRYDJIJMS8SRUPHX7T7,"Egyptian protesters broke into the Israeli Embassy in September, dumping hundreds of documents out of its windows after a day of demonstrations.",85,94,documents,3,0,3
35F6NGNVM8KHRYDJIJMS8SRUPHX7T7,"Egyptian protesters broke into the Israeli Embassy in September, dumping hundreds of documents out of its windows after a day of demonstrations.",129,143,demonstrations,10,3,13
35F6NGNVM8KHRYDJIJMS8SRUPHX7T7,Protesters used sledge hammers and their bare hands to tear apart the embassy's security wall.,0,10,Protesters,2,0,2
35F6NGNVM8KHRYDJIJMS8SRUPHX7T7,Protesters used sledge hammers and their bare hands to tear apart the embassy's security wall.,16,22,sledge,1,4,5
35F6NGNVM8KHRYDJIJMS8SRUPHX7T7,Protesters used sledge hammers and their bare hands to tear apart the embassy's security wall.,16,30,sledge hammers,6,6,12
35F6NGNVM8KHRYDJIJMS8SRUPHX7T7,Protesters used sledge hammers and their bare hands to tear apart the embassy's security wall.,41,45,bare,1,3,4
35F6NGNVM8KHRYDJIJMS8SRUPHX7T7,Protesters used sledge hammers and their bare hands to tear apart the embassy's security wall.,41,51,bare hands,1,0,1
35F6NGNVM8KHRYDJIJMS8SRUPHX7T7,Protesters used sledge hammers and their bare hands to tear apart the embassy's security wall.,55,59,tear,0,2,2
35F6NGNVM8KHRYDJIJMS8SRUPHX7T7,Protesters used sledge hammers and their bare hands to tear apart the embassy's security wall.,55,65,tear apart,0,1,1
35F6NGNVM8KHRYDJIJMS8SRUPHX7T7,Protesters used sledge hammers and their bare hands to tear apart the embassy's security wall.,70,78,embassys,1,0,1
35F6NGNVM8KHRYDJIJMS8SRUPHX7T7,Protesters used sledge hammers and their bare hands to tear apart the embassy's security wall.,80,93,security wall,2,1,3
35F6NGNVM8KHRYDJIJMS8SRUPHX7T7,Egyptian soldiers guarding the shattered entrance of the Israeli Embassy in Cairo Sunday.,18,26,guarding,0,1,1
35F6NGNVM8KHRYDJIJMS8SRUPHX7T7,Egyptian soldiers guarding the shattered entrance of the Israeli Embassy in Cairo Sunday.,31,40,shattered,8,5,13
35F6NGNVM8KHRYDJIJMS8SRUPHX7T7,Egyptian soldiers guarding the shattered entrance of the Israeli Embassy in Cairo Sunday.,31,49,shattered entrance,3,2,5
35F6NGNVM8KHRYDJIJMS8SRUPHX7T7,Egyptian soldiers guarding the shattered entrance of the Israeli Embassy in Cairo Sunday.,65,72,Embassy,2,0,2
35F6NGNVM8KHRYDJIJMS8SRUPHX7T7,"Three Egyptian civilians were killed and a total of 1,049 injured, including 46 police and military soldiers, during the attack on the embassy, as Egyptian forces confronted the mob.",15,24,civilians,1,2,3
35F6NGNVM8KHRYDJIJMS8SRUPHX7T7,"Three Egyptian civilians were killed and a total of 1,049 injured, including 46 police and military soldiers, during the attack on the embassy, as Egyptian forces confronted the mob.",91,108,military soldiers,1,0,1
35F6NGNVM8KHRYDJIJMS8SRUPHX7T7,"Three Egyptian civilians were killed and a total of 1,049 injured, including 46 police and military soldiers, during the attack on the embassy, as Egyptian forces confronted the mob.",135,142,embassy,1,0,1
35F6NGNVM8KHRYDJIJMS8SRUPHX7T7,"Three Egyptian civilians were killed and a total of 1,049 injured, including 46 police and military soldiers, during the attack on the embassy, as Egyptian forces confronted the mob.",163,173,confronted,9,7,16
35F6NGNVM8KHRYDJIJMS8SRUPHX7T7,"Three Egyptian civilians were killed and a total of 1,049 injured, including 46 police and military soldiers, during the attack on the embassy, as Egyptian forces confronted the mob.",178,181,mob,2,5,7
35F6NGNVM8KHRYDJIJMS8SRUPHX7T7,"Israel's ambassador Yitzhak Levanon, who is due to be replaced as ambassador to Egypt in two weeks, arrived in the country on Sunday for the first time since that attack.",9,19,ambassador,5,0,5
35F6NGNVM8KHRYDJIJMS8SRUPHX7T7,"Israel's ambassador Yitzhak Levanon, who is due to be replaced as ambassador to Egypt in two weeks, arrived in the country on Sunday for the first time since that attack.",9,35,ambassador Yitzhak Levanon,1,0,1
35F6NGNVM8KHRYDJIJMS8SRUPHX7T7,"Israel's ambassador Yitzhak Levanon, who is due to be replaced as ambassador to Egypt in two weeks, arrived in the country on Sunday for the first time since that attack.",54,62,replaced,0,1,1
35F6NGNVM8KHRYDJIJMS8SRUPHX7T7,"Israel's ambassador Yitzhak Levanon, who is due to be replaced as ambassador to Egypt in two weeks, arrived in the country on Sunday for the first time since that attack.",66,76,ambassador,5,0,5
35F6NGNVM8KHRYDJIJMS8SRUPHX7T7,He was planning to stay in Cairo for two days to hold a series of farewell meetings with Egyptian officials and other foreign representative.,66,74,farewell,4,5,9
35F6NGNVM8KHRYDJIJMS8SRUPHX7T7,He was planning to stay in Cairo for two days to hold a series of farewell meetings with Egyptian officials and other foreign representative.,66,83,farewell meetings,6,3,9
35F6NGNVM8KHRYDJIJMS8SRUPHX7T7,He was planning to stay in Cairo for two days to hold a series of farewell meetings with Egyptian officials and other foreign representative.,112,140,other foreign representative,1,0,1
35F6NGNVM8KHRYDJIJMS8SRUPHX7T7,He was planning to stay in Cairo for two days to hold a series of farewell meetings with Egyptian officials and other foreign representative.,118,140,foreign representative,4,0,4
35F6NGNVM8KHRYDJIJMS8SRUPHX7T7,He was planning to stay in Cairo for two days to hold a series of farewell meetings with Egyptian officials and other foreign representative.,126,140,representative,4,2,6
3IJ95K7NDXD2PEJ0EQ4A56YVYPRNGV,"In the latest effort to isolate Syria internationally, European Union foreign ministers agreed fresh sanctions against the country on Monday, the 15th round so far to protest against the repression of dissidents.",14,20,effort,0,2,2
3IJ95K7NDXD2PEJ0EQ4A56YVYPRNGV,"In the latest effort to isolate Syria internationally, European Union foreign ministers agreed fresh sanctions against the country on Monday, the 15th round so far to protest against the repression of dissidents.",24,31,isolate,7,5,12
3IJ95K7NDXD2PEJ0EQ4A56YVYPRNGV,"In the latest effort to isolate Syria internationally, European Union foreign ministers agreed fresh sanctions against the country on Monday, the 15th round so far to protest against the repression of dissidents.",38,53,internationally,2,1,3
3IJ95K7NDXD2PEJ0EQ4A56YVYPRNGV,"In the latest effort to isolate Syria internationally, European Union foreign ministers agreed fresh sanctions against the country on Monday, the 15th round so far to protest against the repression of dissidents.",70,77,foreign,1,0,1
3IJ95K7NDXD2PEJ0EQ4A56YVYPRNGV,"In the latest effort to isolate Syria internationally, European Union foreign ministers agreed fresh sanctions against the country on Monday, the 15th round so far to protest against the repression of dissidents.",78,87,ministers,1,0,1
3IJ95K7NDXD2PEJ0EQ4A56YVYPRNGV,"In the latest effort to isolate Syria internationally, European Union foreign ministers agreed fresh sanctions against the country on Monday, the 15th round so far to protest against the repression of dissidents.",95,110,fresh sanctions,2,1,3
3IJ95K7NDXD2PEJ0EQ4A56YVYPRNGV,"In the latest effort to isolate Syria internationally, European Union foreign ministers agreed fresh sanctions against the country on Monday, the 15th round so far to protest against the repression of dissidents.",101,110,sanctions,8,5,13
3IJ95K7NDXD2PEJ0EQ4A56YVYPRNGV,"In the latest effort to isolate Syria internationally, European Union foreign ministers agreed fresh sanctions against the country on Monday, the 15th round so far to protest against the repression of dissidents.",187,197,repression,6,10,16
3IJ95K7NDXD2PEJ0EQ4A56YVYPRNGV,"In the latest effort to isolate Syria internationally, European Union foreign ministers agreed fresh sanctions against the country on Monday, the 15th round so far to protest against the repression of dissidents.",187,211,repression of dissidents,1,0,1
3IJ95K7NDXD2PEJ0EQ4A56YVYPRNGV,"In the latest effort to isolate Syria internationally, European Union foreign ministers agreed fresh sanctions against the country on Monday, the 15th round so far to protest against the repression of dissidents.",201,211,dissidents,10,10,20
3IJ95K7NDXD2PEJ0EQ4A56YVYPRNGV,"An EU statement issued at a meeting of ministers said they adopted ""sanctions against the Syrian regime"" but gave no details.",6,15,statement,0,1,1
3IJ95K7NDXD2PEJ0EQ4A56YVYPRNGV,"An EU statement issued at a meeting of ministers said they adopted ""sanctions against the Syrian regime"" but gave no details.",16,22,issued,0,1,1
3IJ95K7NDXD2PEJ0EQ4A56YVYPRNGV,"An EU statement issued at a meeting of ministers said they adopted ""sanctions against the Syrian regime"" but gave no details.",59,66,adopted,2,1,3
3IJ95K7NDXD2PEJ0EQ4A56YVYPRNGV,"An EU statement issued at a meeting of ministers said they adopted ""sanctions against the Syrian regime"" but gave no details.",68,77,sanctions,7,0,7
3IJ95K7NDXD2PEJ0EQ4A56YVYPRNGV,"An EU statement issued at a meeting of ministers said they adopted ""sanctions against the Syrian regime"" but gave no details.",97,103,regime,5,3,8
3IJ95K7NDXD2PEJ0EQ4A56YVYPRNGV,"An EU diplomat confirmed, however, that the ministers agreed to impose an assets freeze and visa ban on two firms and three people believed to provide funding for the regime.",3,14,EU diplomat,1,0,1
3IJ95K7NDXD2PEJ0EQ4A56YVYPRNGV,"An EU diplomat confirmed, however, that the ministers agreed to impose an assets freeze and visa ban on two firms and three people believed to provide funding for the regime.",6,14,diplomat,2,2,4
3IJ95K7NDXD2PEJ0EQ4A56YVYPRNGV,"An EU diplomat confirmed, however, that the ministers agreed to impose an assets freeze and visa ban on two firms and three people believed to provide funding for the regime.",15,24,confirmed,0,3,3
3IJ95K7NDXD2PEJ0EQ4A56YVYPRNGV,"An EU diplomat confirmed, however, that the ministers agreed to impose an assets freeze and visa ban on two firms and three people believed to provide funding for the regime.",44,53,ministers,1,0,1
3IJ95K7NDXD2PEJ0EQ4A56YVYPRNGV,"An EU diplomat confirmed, however, that the ministers agreed to impose an assets freeze and visa ban on two firms and three people believed to provide funding for the regime.",64,70,impose,3,2,5
3IJ95K7NDXD2PEJ0EQ4A56YVYPRNGV,"An EU diplomat confirmed, however, that the ministers agreed to impose an assets freeze and visa ban on two firms and three people believed to provide funding for the regime.",74,80,assets,1,0,1
3IJ95K7NDXD2PEJ0EQ4A56YVYPRNGV,"An EU diplomat confirmed, however, that the ministers agreed to impose an assets freeze and visa ban on two firms and three people believed to provide funding for the regime.",74,87,assets freeze,8,4,12
3IJ95K7NDXD2PEJ0EQ4A56YVYPRNGV,"An EU diplomat confirmed, however, that the ministers agreed to impose an assets freeze and visa ban on two firms and three people believed to provide funding for the regime.",81,87,freeze,0,1,1
3IJ95K7NDXD2PEJ0EQ4A56YVYPRNGV,"An EU diplomat confirmed, however, that the ministers agreed to impose an assets freeze and visa ban on two firms and three people believed to provide funding for the regime.",92,96,visa,0,1,1
3IJ95K7NDXD2PEJ0EQ4A56YVYPRNGV,"An EU diplomat confirmed, however, that the ministers agreed to impose an assets freeze and visa ban on two firms and three people believed to provide funding for the regime.",92,100,visa ban,3,1,4
3IJ95K7NDXD2PEJ0EQ4A56YVYPRNGV,"An EU diplomat confirmed, however, that the ministers agreed to impose an assets freeze and visa ban on two firms and three people believed to provide funding for the regime.",151,158,funding,1,1,2
3IJ95K7NDXD2PEJ0EQ4A56YVYPRNGV,"An EU diplomat confirmed, however, that the ministers agreed to impose an assets freeze and visa ban on two firms and three people believed to provide funding for the regime.",167,173,regime,5,0,5
3IJ95K7NDXD2PEJ0EQ4A56YVYPRNGV,"Syria-linked violence has spilled across the border into Lebanon, with five people killed since Saturday during clashes in the northern port city of Tripoli, according to officials.",0,12,Syria-linked,1,1,2
3IJ95K7NDXD2PEJ0EQ4A56YVYPRNGV,"Syria-linked violence has spilled across the border into Lebanon, with five people killed since Saturday during clashes in the northern port city of Tripoli, according to officials.",0,21,Syria-linked violence,1,0,1
3IJ95K7NDXD2PEJ0EQ4A56YVYPRNGV,"Syria-linked violence has spilled across the border into Lebanon, with five people killed since Saturday during clashes in the northern port city of Tripoli, according to officials.",13,21,violence,0,2,2
3IJ95K7NDXD2PEJ0EQ4A56YVYPRNGV,"Syria-linked violence has spilled across the border into Lebanon, with five people killed since Saturday during clashes in the northern port city of Tripoli, according to officials.",26,33,spilled,3,5,8
3IJ95K7NDXD2PEJ0EQ4A56YVYPRNGV,"Syria-linked violence has spilled across the border into Lebanon, with five people killed since Saturday during clashes in the northern port city of Tripoli, according to officials.",45,51,border,1,0,1
3IJ95K7NDXD2PEJ0EQ4A56YVYPRNGV,"Syria-linked violence has spilled across the border into Lebanon, with five people killed since Saturday during clashes in the northern port city of Tripoli, according to officials.",112,119,clashes,3,2,5
3IJ95K7NDXD2PEJ0EQ4A56YVYPRNGV,Gunbattles erupted on Saturday between residents loyal to Syrian President Bashar al-Assad and those supportive of the Syrian opposition.,0,10,Gunbattles,1,1,2
3IJ95K7NDXD2PEJ0EQ4A56YVYPRNGV,Gunbattles erupted on Saturday between residents loyal to Syrian President Bashar al-Assad and those supportive of the Syrian opposition.,11,18,erupted,5,9,14
3IJ95K7NDXD2PEJ0EQ4A56YVYPRNGV,Gunbattles erupted on Saturday between residents loyal to Syrian President Bashar al-Assad and those supportive of the Syrian opposition.,49,54,loyal,0,2,2
3IJ95K7NDXD2PEJ0EQ4A56YVYPRNGV,Gunbattles erupted on Saturday between residents loyal to Syrian President Bashar al-Assad and those supportive of the Syrian opposition.,101,111,supportive,3,3,6
3IJ95K7NDXD2PEJ0EQ4A56YVYPRNGV,Gunbattles erupted on Saturday between residents loyal to Syrian President Bashar al-Assad and those supportive of the Syrian opposition.,126,136,opposition,2,0,2
3AA88CN98P413ZJXBJY0KEOV9QCKYL,"The EU ministers agreed to an assets freeze and visa ban on two firms and three people believed to provide funding for the regime, according to the office of EU foreign policy chief Catherine Ashton.",7,16,ministers,1,0,1
3AA88CN98P413ZJXBJY0KEOV9QCKYL,"The EU ministers agreed to an assets freeze and visa ban on two firms and three people believed to provide funding for the regime, according to the office of EU foreign policy chief Catherine Ashton.",30,36,assets,2,3,5
3AA88CN98P413ZJXBJY0KEOV9QCKYL,"The EU ministers agreed to an assets freeze and visa ban on two firms and three people believed to provide funding for the regime, according to the office of EU foreign policy chief Catherine Ashton.",30,43,assets freeze,7,2,9
3AA88CN98P413ZJXBJY0KEOV9QCKYL,"The EU ministers agreed to an assets freeze and visa ban on two firms and three people believed to provide funding for the regime, according to the office of EU foreign policy chief Catherine Ashton.",30,56,assets freeze and visa ban,0,1,1
3AA88CN98P413ZJXBJY0KEOV9QCKYL,"The EU ministers agreed to an assets freeze and visa ban on two firms and three people believed to provide funding for the regime, according to the office of EU foreign policy chief Catherine Ashton.",37,43,freeze,3,2,5
3AA88CN98P413ZJXBJY0KEOV9QCKYL,"The EU ministers agreed to an assets freeze and visa ban on two firms and three people believed to provide funding for the regime, according to the office of EU foreign policy chief Catherine Ashton.",48,52,visa,0,1,1
3AA88CN98P413ZJXBJY0KEOV9QCKYL,"The EU ministers agreed to an assets freeze and visa ban on two firms and three people believed to provide funding for the regime, according to the office of EU foreign policy chief Catherine Ashton.",48,56,visa ban,4,0,4
3AA88CN98P413ZJXBJY0KEOV9QCKYL,"The EU ministers agreed to an assets freeze and visa ban on two firms and three people believed to provide funding for the regime, according to the office of EU foreign policy chief Catherine Ashton.",53,56,ban,0,2,2
3AA88CN98P413ZJXBJY0KEOV9QCKYL,"The EU ministers agreed to an assets freeze and visa ban on two firms and three people believed to provide funding for the regime, according to the office of EU foreign policy chief Catherine Ashton.",87,95,believed,0,1,1
3AA88CN98P413ZJXBJY0KEOV9QCKYL,"The EU ministers agreed to an assets freeze and visa ban on two firms and three people believed to provide funding for the regime, according to the office of EU foreign policy chief Catherine Ashton.",87,106,believed to provide,1,0,1
3AA88CN98P413ZJXBJY0KEOV9QCKYL,"The EU ministers agreed to an assets freeze and visa ban on two firms and three people believed to provide funding for the regime, according to the office of EU foreign policy chief Catherine Ashton.",107,114,funding,1,1,2
3AA88CN98P413ZJXBJY0KEOV9QCKYL,"The EU ministers agreed to an assets freeze and visa ban on two firms and three people believed to provide funding for the regime, according to the office of EU foreign policy chief Catherine Ashton.",123,129,regime,9,3,12
3AA88CN98P413ZJXBJY0KEOV9QCKYL,"The continuing violence is appalling, Ashton said Monday.",16,24,violence,0,2,2
3AA88CN98P413ZJXBJY0KEOV9QCKYL,"The continuing violence is appalling, Ashton said Monday.",28,37,appalling,10,10,20
3AA88CN98P413ZJXBJY0KEOV9QCKYL,"Inside Syria, regime forces suffered heavy casualties Monday during clashes at Rastan, a city that has been pummeled by government forces, opposition activists said.",14,20,regime,3,0,3
3AA88CN98P413ZJXBJY0KEOV9QCKYL,"Inside Syria, regime forces suffered heavy casualties Monday during clashes at Rastan, a city that has been pummeled by government forces, opposition activists said.",14,27,regime forces,1,2,3
3AA88CN98P413ZJXBJY0KEOV9QCKYL,"Inside Syria, regime forces suffered heavy casualties Monday during clashes at Rastan, a city that has been pummeled by government forces, opposition activists said.",37,53,heavy casualties,2,1,3
3AA88CN98P413ZJXBJY0KEOV9QCKYL,"Inside Syria, regime forces suffered heavy casualties Monday during clashes at Rastan, a city that has been pummeled by government forces, opposition activists said.",43,53,casualties,4,7,11
3AA88CN98P413ZJXBJY0KEOV9QCKYL,"Inside Syria, regime forces suffered heavy casualties Monday during clashes at Rastan, a city that has been pummeled by government forces, opposition activists said.",68,75,clashes,0,3,3
3AA88CN98P413ZJXBJY0KEOV9QCKYL,"Inside Syria, regime forces suffered heavy casualties Monday during clashes at Rastan, a city that has been pummeled by government forces, opposition activists said.",108,116,pummeled,10,10,20
3AA88CN98P413ZJXBJY0KEOV9QCKYL,"Inside Syria, regime forces suffered heavy casualties Monday during clashes at Rastan, a city that has been pummeled by government forces, opposition activists said.",139,159,opposition activists,2,0,2
3AA88CN98P413ZJXBJY0KEOV9QCKYL,"Inside Syria, regime forces suffered heavy casualties Monday during clashes at Rastan, a city that has been pummeled by government forces, opposition activists said.",150,159,activists,1,0,1
3AA88CN98P413ZJXBJY0KEOV9QCKYL,"The Syrian Observatory for Human Rights said it received ""preliminary information that three armored personnel carriers were destroyed and that at least 23 soldiers were killed.""",11,22,Observatory,1,1,2
3AA88CN98P413ZJXBJY0KEOV9QCKYL,"The Syrian Observatory for Human Rights said it received ""preliminary information that three armored personnel carriers were destroyed and that at least 23 soldiers were killed.""",48,56,received,1,1,2
3AA88CN98P413ZJXBJY0KEOV9QCKYL,"The Syrian Observatory for Human Rights said it received ""preliminary information that three armored personnel carriers were destroyed and that at least 23 soldiers were killed.""",58,69,preliminary,10,2,12
3AA88CN98P413ZJXBJY0KEOV9QCKYL,"The Syrian Observatory for Human Rights said it received ""preliminary information that three armored personnel carriers were destroyed and that at least 23 soldiers were killed.""",58,81,preliminary information,3,0,3
3AA88CN98P413ZJXBJY0KEOV9QCKYL,"The Syrian Observatory for Human Rights said it received ""preliminary information that three armored personnel carriers were destroyed and that at least 23 soldiers were killed.""",93,100,armored,4,5,9
3AA88CN98P413ZJXBJY0KEOV9QCKYL,"The Syrian Observatory for Human Rights said it received ""preliminary information that three armored personnel carriers were destroyed and that at least 23 soldiers were killed.""",93,110,armored personnel,0,1,1
3AA88CN98P413ZJXBJY0KEOV9QCKYL,"The Syrian Observatory for Human Rights said it received ""preliminary information that three armored personnel carriers were destroyed and that at least 23 soldiers were killed.""",93,119,armored personnel carriers,4,0,4
3AA88CN98P413ZJXBJY0KEOV9QCKYL,"The Syrian Observatory for Human Rights said it received ""preliminary information that three armored personnel carriers were destroyed and that at least 23 soldiers were killed.""",101,110,personnel,3,0,3
3AA88CN98P413ZJXBJY0KEOV9QCKYL,"The Syrian Observatory for Human Rights said it received ""preliminary information that three armored personnel carriers were destroyed and that at least 23 soldiers were killed.""",111,119,carriers,0,1,1
3AA88CN98P413ZJXBJY0KEOV9QCKYL,"The Syrian Observatory for Human Rights said it received ""preliminary information that three armored personnel carriers were destroyed and that at least 23 soldiers were killed.""",125,134,destroyed,0,1,1
3AA88CN98P413ZJXBJY0KEOV9QCKYL,Medical supplies were running low after more than 60 people were reportedly injured from a barrage of roughly 255 mortar shells that rained on Rastan.,0,16,Medical supplies,0,1,1
3AA88CN98P413ZJXBJY0KEOV9QCKYL,Medical supplies were running low after more than 60 people were reportedly injured from a barrage of roughly 255 mortar shells that rained on Rastan.,22,33,running low,1,0,1
3AA88CN98P413ZJXBJY0KEOV9QCKYL,Medical supplies were running low after more than 60 people were reportedly injured from a barrage of roughly 255 mortar shells that rained on Rastan.,65,75,reportedly,1,0,1
3AA88CN98P413ZJXBJY0KEOV9QCKYL,Medical supplies were running low after more than 60 people were reportedly injured from a barrage of roughly 255 mortar shells that rained on Rastan.,91,98,barrage,8,10,18
3AA88CN98P413ZJXBJY0KEOV9QCKYL,Medical supplies were running low after more than 60 people were reportedly injured from a barrage of roughly 255 mortar shells that rained on Rastan.,102,109,roughly,0,1,1
3AA88CN98P413ZJXBJY0KEOV9QCKYL,Medical supplies were running low after more than 60 people were reportedly injured from a barrage of roughly 255 mortar shells that rained on Rastan.,114,120,mortar,2,2,4
3AA88CN98P413ZJXBJY0KEOV9QCKYL,Medical supplies were running low after more than 60 people were reportedly injured from a barrage of roughly 255 mortar shells that rained on Rastan.,114,127,mortar shells,3,2,5
3AA88CN98P413ZJXBJY0KEOV9QCKYL,Medical supplies were running low after more than 60 people were reportedly injured from a barrage of roughly 255 mortar shells that rained on Rastan.,121,127,shells,0,2,2
3AA88CN98P413ZJXBJY0KEOV9QCKYL,"Elsewhere in Syria, at least four people were killed Monday, including a child struck by random gunfire from the regime's army in Deir Ezzor, said the Local Coordination Committees of Syria, an opposition network.",79,85,struck,1,1,2
3AA88CN98P413ZJXBJY0KEOV9QCKYL,"Elsewhere in Syria, at least four people were killed Monday, including a child struck by random gunfire from the regime's army in Deir Ezzor, said the Local Coordination Committees of Syria, an opposition network.",89,95,random,2,2,4
3AA88CN98P413ZJXBJY0KEOV9QCKYL,"Elsewhere in Syria, at least four people were killed Monday, including a child struck by random gunfire from the regime's army in Deir Ezzor, said the Local Coordination Committees of Syria, an opposition network.",89,103,random gunfire,0,1,1
3AA88CN98P413ZJXBJY0KEOV9QCKYL,"Elsewhere in Syria, at least four people were killed Monday, including a child struck by random gunfire from the regime's army in Deir Ezzor, said the Local Coordination Committees of Syria, an opposition network.",113,120,regimes,1,0,1
3AA88CN98P413ZJXBJY0KEOV9QCKYL,"Elsewhere in Syria, at least four people were killed Monday, including a child struck by random gunfire from the regime's army in Deir Ezzor, said the Local Coordination Committees of Syria, an opposition network.",113,125,regimes army,3,1,4
3AA88CN98P413ZJXBJY0KEOV9QCKYL,"Elsewhere in Syria, at least four people were killed Monday, including a child struck by random gunfire from the regime's army in Deir Ezzor, said the Local Coordination Committees of Syria, an opposition network.",151,180,Local Coordination Committees,1,0,1
3AA88CN98P413ZJXBJY0KEOV9QCKYL,"Elsewhere in Syria, at least four people were killed Monday, including a child struck by random gunfire from the regime's army in Deir Ezzor, said the Local Coordination Committees of Syria, an opposition network.",157,169,Coordination,1,1,2
3AA88CN98P413ZJXBJY0KEOV9QCKYL,"Elsewhere in Syria, at least four people were killed Monday, including a child struck by random gunfire from the regime's army in Deir Ezzor, said the Local Coordination Committees of Syria, an opposition network.",194,204,opposition,3,0,3
3AA88CN98P413ZJXBJY0KEOV9QCKYL,"Elsewhere in Syria, at least four people were killed Monday, including a child struck by random gunfire from the regime's army in Deir Ezzor, said the Local Coordination Committees of Syria, an opposition network.",194,212,opposition network,2,0,2
3I7SHAD35MXDE3NZ9MLGMEW2U8D7MF,"The group has also shown a focus on high profile assaults in Kabul, such as the April 15 coordinated attacks in the capital and eastern Afghanistan.",27,32,focus,0,3,3
3I7SHAD35MXDE3NZ9MLGMEW2U8D7MF,"The group has also shown a focus on high profile assaults in Kabul, such as the April 15 coordinated attacks in the capital and eastern Afghanistan.",36,48,high profile,4,3,7
3I7SHAD35MXDE3NZ9MLGMEW2U8D7MF,"The group has also shown a focus on high profile assaults in Kabul, such as the April 15 coordinated attacks in the capital and eastern Afghanistan.",36,57,high profile assaults,1,2,3
3I7SHAD35MXDE3NZ9MLGMEW2U8D7MF,"The group has also shown a focus on high profile assaults in Kabul, such as the April 15 coordinated attacks in the capital and eastern Afghanistan.",41,48,profile,0,1,1
3I7SHAD35MXDE3NZ9MLGMEW2U8D7MF,"The group has also shown a focus on high profile assaults in Kabul, such as the April 15 coordinated attacks in the capital and eastern Afghanistan.",49,57,assaults,6,6,12
3I7SHAD35MXDE3NZ9MLGMEW2U8D7MF,"The group has also shown a focus on high profile assaults in Kabul, such as the April 15 coordinated attacks in the capital and eastern Afghanistan.",89,100,coordinated,8,4,12
3I7SHAD35MXDE3NZ9MLGMEW2U8D7MF,"The group has also shown a focus on high profile assaults in Kabul, such as the April 15 coordinated attacks in the capital and eastern Afghanistan.",89,108,coordinated attacks,4,1,5
3I7SHAD35MXDE3NZ9MLGMEW2U8D7MF,"The group has also shown a focus on high profile assaults in Kabul, such as the April 15 coordinated attacks in the capital and eastern Afghanistan.",116,123,capital,1,0,1
3I7SHAD35MXDE3NZ9MLGMEW2U8D7MF,"Obama has drawn some flak for making his trip to Afghanistan overnight and leaving at sunrise, which some observers say shows little faith in the security situation here.",10,25,drawn some flak,1,0,1
3I7SHAD35MXDE3NZ9MLGMEW2U8D7MF,"Obama has drawn some flak for making his trip to Afghanistan overnight and leaving at sunrise, which some observers say shows little faith in the security situation here.",21,25,flak,10,10,20
3I7SHAD35MXDE3NZ9MLGMEW2U8D7MF,"Obama has drawn some flak for making his trip to Afghanistan overnight and leaving at sunrise, which some observers say shows little faith in the security situation here.",61,70,overnight,0,2,2
3I7SHAD35MXDE3NZ9MLGMEW2U8D7MF,"Obama has drawn some flak for making his trip to Afghanistan overnight and leaving at sunrise, which some observers say shows little faith in the security situation here.",106,115,observers,3,1,4
3I7SHAD35MXDE3NZ9MLGMEW2U8D7MF,"Obama has drawn some flak for making his trip to Afghanistan overnight and leaving at sunrise, which some observers say shows little faith in the security situation here.",133,138,faith,1,1,2
3I7SHAD35MXDE3NZ9MLGMEW2U8D7MF,"Obama has drawn some flak for making his trip to Afghanistan overnight and leaving at sunrise, which some observers say shows little faith in the security situation here.",146,164,security situation,2,0,2
3I7SHAD35MXDE3NZ9MLGMEW2U8D7MF,"Obama has drawn some flak for making his trip to Afghanistan overnight and leaving at sunrise, which some observers say shows little faith in the security situation here.",155,164,situation,1,1,2
3I7SHAD35MXDE3NZ9MLGMEW2U8D7MF,"Among most Afghans, however, the timing of the trip is of little concern.",55,72,of little concern,1,0,1
3I7SHAD35MXDE3NZ9MLGMEW2U8D7MF,"Among most Afghans, however, the timing of the trip is of little concern.",58,72,little concern,2,1,3
3I7SHAD35MXDE3NZ9MLGMEW2U8D7MF,"Among most Afghans, however, the timing of the trip is of little concern.",65,72,concern,0,3,3
3I7SHAD35MXDE3NZ9MLGMEW2U8D7MF,That Obama made the trip to sign the agreement in person remains the most salient point.,37,46,agreement,1,0,1
3I7SHAD35MXDE3NZ9MLGMEW2U8D7MF,That Obama made the trip to sign the agreement in person remains the most salient point.,74,81,salient,10,7,17
3I7SHAD35MXDE3NZ9MLGMEW2U8D7MF,That Obama made the trip to sign the agreement in person remains the most salient point.,74,87,salient point,2,4,6
3I7SHAD35MXDE3NZ9MLGMEW2U8D7MF,"Many Afghans have been looking for assurance that the US will not abandon the country after 2014, as the international community did for Afghanistan after the Soviet war ended.",35,44,assurance,7,7,14
3I7SHAD35MXDE3NZ9MLGMEW2U8D7MF,"Many Afghans have been looking for assurance that the US will not abandon the country after 2014, as the international community did for Afghanistan after the Soviet war ended.",62,73,not abandon,1,0,1
3I7SHAD35MXDE3NZ9MLGMEW2U8D7MF,"Many Afghans have been looking for assurance that the US will not abandon the country after 2014, as the international community did for Afghanistan after the Soviet war ended.",66,73,abandon,0,9,9
3I7SHAD35MXDE3NZ9MLGMEW2U8D7MF,"Many Afghans have been looking for assurance that the US will not abandon the country after 2014, as the international community did for Afghanistan after the Soviet war ended.",105,118,international,1,0,1
3I7SHAD35MXDE3NZ9MLGMEW2U8D7MF,"Many Afghans have been looking for assurance that the US will not abandon the country after 2014, as the international community did for Afghanistan after the Soviet war ended.",105,128,international community,3,1,4
3I7SHAD35MXDE3NZ9MLGMEW2U8D7MF,"Many Afghans have been looking for assurance that the US will not abandon the country after 2014, as the international community did for Afghanistan after the Soviet war ended.",159,165,Soviet,0,1,1
3I7SHAD35MXDE3NZ9MLGMEW2U8D7MF,"Many Afghans have been looking for assurance that the US will not abandon the country after 2014, as the international community did for Afghanistan after the Soviet war ended.",159,169,Soviet war,1,0,1
3I7SHAD35MXDE3NZ9MLGMEW2U8D7MF,"“We don’t know why they choose such a time, but it doesn’t matter if they signed it in the night time or the day time,” says Rasheed Waziri, a member of the Afghanistan Regional Studies Center.",24,42,choose such a time,1,0,1
3I7SHAD35MXDE3NZ9MLGMEW2U8D7MF,"“We don’t know why they choose such a time, but it doesn’t matter if they signed it in the night time or the day time,” says Rasheed Waziri, a member of the Afghanistan Regional Studies Center.",169,177,Regional,1,0,1
3J9L0X0VDFNDXY56SLPN98PZO139WB,"Google will report to an independent monitor in China on its efforts to comply with terms of the deal approval, according to the website.",25,36,independent,3,2,5
3J9L0X0VDFNDXY56SLPN98PZO139WB,"Google will report to an independent monitor in China on its efforts to comply with terms of the deal approval, according to the website.",25,44,independent monitor,7,1,8
3J9L0X0VDFNDXY56SLPN98PZO139WB,"Google will report to an independent monitor in China on its efforts to comply with terms of the deal approval, according to the website.",37,44,monitor,1,4,5
3J9L0X0VDFNDXY56SLPN98PZO139WB,"Google will report to an independent monitor in China on its efforts to comply with terms of the deal approval, according to the website.",72,78,comply,7,10,17
3J9L0X0VDFNDXY56SLPN98PZO139WB,"Google will report to an independent monitor in China on its efforts to comply with terms of the deal approval, according to the website.",72,83,comply with,0,1,1
3J9L0X0VDFNDXY56SLPN98PZO139WB,"Google will report to an independent monitor in China on its efforts to comply with terms of the deal approval, according to the website.",72,89,comply with terms,0,1,1
3J9L0X0VDFNDXY56SLPN98PZO139WB,"Google will report to an independent monitor in China on its efforts to comply with terms of the deal approval, according to the website.",97,101,deal,0,1,1
3J9L0X0VDFNDXY56SLPN98PZO139WB,"Google will report to an independent monitor in China on its efforts to comply with terms of the deal approval, according to the website.",97,110,deal approval,1,0,1
3J9L0X0VDFNDXY56SLPN98PZO139WB,"Google will report to an independent monitor in China on its efforts to comply with terms of the deal approval, according to the website.",102,110,approval,0,3,3
3J9L0X0VDFNDXY56SLPN98PZO139WB,"Google will report to an independent monitor in China on its efforts to comply with terms of the deal approval, according to the website.",112,121,according,0,1,1
3J9L0X0VDFNDXY56SLPN98PZO139WB,Google fell 3.6 percent to $600.40 yesterday in New York trading.,7,11,fell,0,1,1
3J9L0X0VDFNDXY56SLPN98PZO139WB,Google fell 3.6 percent to $600.40 yesterday in New York trading.,48,65,New York  trading,1,0,1
3J9L0X0VDFNDXY56SLPN98PZO139WB,Google fell 3.6 percent to $600.40 yesterday in New York trading.,57,64,trading,0,1,1
3J9L0X0VDFNDXY56SLPN98PZO139WB,The shares have fallen 7 percent this year.,4,10,shares,2,2,4
3J9L0X0VDFNDXY56SLPN98PZO139WB,Motorola Mobility closed unchanged at $39.20.,9,17,Mobility,0,2,2
3J9L0X0VDFNDXY56SLPN98PZO139WB,Motorola Mobility closed unchanged at $39.20.,18,34,closed unchanged,1,0,1
3J9L0X0VDFNDXY56SLPN98PZO139WB,Motorola Mobility closed unchanged at $39.20.,25,34,unchanged,2,2,4
3J9L0X0VDFNDXY56SLPN98PZO139WB,The stock is up 1 percent year to date.,4,9,stock,1,0,1
3J9L0X0VDFNDXY56SLPN98PZO139WB,The stock is up 1 percent year to date.,26,38,year to date,1,0,1
3J9L0X0VDFNDXY56SLPN98PZO139WB,"After graduating, he returned to the new TechCrunch to as a full-time mobile writer.",6,16,graduating,3,6,9
3J9L0X0VDFNDXY56SLPN98PZO139WB,"After graduating, he returned to the new TechCrunch to as a full-time mobile writer.",41,51,TechCrunch,2,0,2
3J9L0X0VDFNDXY56SLPN98PZO139WB,"After graduating, he returned to the new TechCrunch to as a full-time mobile writer.",70,83,mobile writer,3,3,6
3J9L0X0VDFNDXY56SLPN98PZO139WB,"He counts advertising, running, musical theater,...        → Learn More It's been just over nine months since Google announced their intentions to acquire hardware manufacturer Motorola Mobility for $12.5 billion, and now it seems that the final pieces of the deal have fallen into place.",10,21,advertising,2,0,2
3J9L0X0VDFNDXY56SLPN98PZO139WB,"He counts advertising, running, musical theater,...        → Learn More It's been just over nine months since Google announced their intentions to acquire hardware manufacturer Motorola Mobility for $12.5 billion, and now it seems that the final pieces of the deal have fallen into place.",117,126,announced,2,1,3
3J9L0X0VDFNDXY56SLPN98PZO139WB,"He counts advertising, running, musical theater,...        → Learn More It's been just over nine months since Google announced their intentions to acquire hardware manufacturer Motorola Mobility for $12.5 billion, and now it seems that the final pieces of the deal have fallen into place.",133,143,intentions,6,3,9
3J9L0X0VDFNDXY56SLPN98PZO139WB,"He counts advertising, running, musical theater,...        → Learn More It's been just over nine months since Google announced their intentions to acquire hardware manufacturer Motorola Mobility for $12.5 billion, and now it seems that the final pieces of the deal have fallen into place.",147,154,acquire,10,5,15
3J9L0X0VDFNDXY56SLPN98PZO139WB,"He counts advertising, running, musical theater,...        → Learn More It's been just over nine months since Google announced their intentions to acquire hardware manufacturer Motorola Mobility for $12.5 billion, and now it seems that the final pieces of the deal have fallen into place.",147,176,acquire hardware manufacturer,1,0,1
3J9L0X0VDFNDXY56SLPN98PZO139WB,"He counts advertising, running, musical theater,...        → Learn More It's been just over nine months since Google announced their intentions to acquire hardware manufacturer Motorola Mobility for $12.5 billion, and now it seems that the final pieces of the deal have fallen into place.",155,163,hardware,1,1,2
3J9L0X0VDFNDXY56SLPN98PZO139WB,"He counts advertising, running, musical theater,...        → Learn More It's been just over nine months since Google announced their intentions to acquire hardware manufacturer Motorola Mobility for $12.5 billion, and now it seems that the final pieces of the deal have fallen into place.",155,176,hardware manufacturer,2,0,2
3J9L0X0VDFNDXY56SLPN98PZO139WB,"He counts advertising, running, musical theater,...        → Learn More It's been just over nine months since Google announced their intentions to acquire hardware manufacturer Motorola Mobility for $12.5 billion, and now it seems that the final pieces of the deal have fallen into place.",164,176,manufacturer,3,1,4
3J9L0X0VDFNDXY56SLPN98PZO139WB,"He counts advertising, running, musical theater,...        → Learn More It's been just over nine months since Google announced their intentions to acquire hardware manufacturer Motorola Mobility for $12.5 billion, and now it seems that the final pieces of the deal have fallen into place.",240,252,final pieces,0,1,1
3J9L0X0VDFNDXY56SLPN98PZO139WB,"He counts advertising, running, musical theater,...        → Learn More It's been just over nine months since Google announced their intentions to acquire hardware manufacturer Motorola Mobility for $12.5 billion, and now it seems that the final pieces of the deal have fallen into place.",260,264,deal,0,1,1
3J9L0X0VDFNDXY56SLPN98PZO139WB,"According to a new report from the Associated Press, Chinese officials have finally given the Google-Motorola deal their blessing.",121,129,blessing,4,9,13
3DTJ4WT8BDGYMP1SBJPG0QKSW0NEZG,The victim 32-year-old male was shot in the chest and arm by a lone gunman who approached the car he was sitting in outside a pub on Sarsfield Road in Ballyfermot at 11:10pm.,4,10,victim,3,5,8
3DTJ4WT8BDGYMP1SBJPG0QKSW0NEZG,The victim 32-year-old male was shot in the chest and arm by a lone gunman who approached the car he was sitting in outside a pub on Sarsfield Road in Ballyfermot at 11:10pm.,44,49,chest,0,1,1
3DTJ4WT8BDGYMP1SBJPG0QKSW0NEZG,The victim 32-year-old male was shot in the chest and arm by a lone gunman who approached the car he was sitting in outside a pub on Sarsfield Road in Ballyfermot at 11:10pm.,63,67,lone,2,2,4
3DTJ4WT8BDGYMP1SBJPG0QKSW0NEZG,The victim 32-year-old male was shot in the chest and arm by a lone gunman who approached the car he was sitting in outside a pub on Sarsfield Road in Ballyfermot at 11:10pm.,63,74,lone gunman,3,0,3
3DTJ4WT8BDGYMP1SBJPG0QKSW0NEZG,The victim 32-year-old male was shot in the chest and arm by a lone gunman who approached the car he was sitting in outside a pub on Sarsfield Road in Ballyfermot at 11:10pm.,68,74,gunman,1,1,2
3DTJ4WT8BDGYMP1SBJPG0QKSW0NEZG,The victim 32-year-old male was shot in the chest and arm by a lone gunman who approached the car he was sitting in outside a pub on Sarsfield Road in Ballyfermot at 11:10pm.,79,89,approached,1,3,4
3DTJ4WT8BDGYMP1SBJPG0QKSW0NEZG,The victim 32-year-old male was shot in the chest and arm by a lone gunman who approached the car he was sitting in outside a pub on Sarsfield Road in Ballyfermot at 11:10pm.,126,129,pub,3,3,6
3DTJ4WT8BDGYMP1SBJPG0QKSW0NEZG,The injured man was able to drive his car to Cloverhill Prison where he got help.,4,11,injured,0,2,2
3DTJ4WT8BDGYMP1SBJPG0QKSW0NEZG,The injured man was able to drive his car to Cloverhill Prison where he got help.,56,62,Prison,0,1,1
3DTJ4WT8BDGYMP1SBJPG0QKSW0NEZG,He is being treated at Tallaght  Hospital but his injuries are not thought to be life-threatening.,12,19,treated,1,0,1
3DTJ4WT8BDGYMP1SBJPG0QKSW0NEZG,He is being treated at Tallaght  Hospital but his injuries are not thought to be life-threatening.,81,97,life-threatening,8,10,18
3DTJ4WT8BDGYMP1SBJPG0QKSW0NEZG,Another silver saloon car was found burnt out later.,8,21,silver saloon,1,0,1
3DTJ4WT8BDGYMP1SBJPG0QKSW0NEZG,Another silver saloon car was found burnt out later.,8,25,silver saloon car,1,0,1
3DTJ4WT8BDGYMP1SBJPG0QKSW0NEZG,Another silver saloon car was found burnt out later.,15,21,saloon,3,0,3
3DTJ4WT8BDGYMP1SBJPG0QKSW0NEZG,Another silver saloon car was found burnt out later.,15,25,saloon car,4,1,5
3DTJ4WT8BDGYMP1SBJPG0QKSW0NEZG,Another silver saloon car was found burnt out later.,36,45,burnt out,1,0,1
3DTJ4WT8BDGYMP1SBJPG0QKSW0NEZG,Both vehicles will also be technically examined.,27,38,technically,4,0,4
3DTJ4WT8BDGYMP1SBJPG0QKSW0NEZG,Both vehicles will also be technically examined.,27,47,technically examined,5,2,7
3DTJ4WT8BDGYMP1SBJPG0QKSW0NEZG,Both vehicles will also be technically examined.,39,47,examined,3,1,4
3DTJ4WT8BDGYMP1SBJPG0QKSW0NEZG,Gardaí are asking anyone who was in the Sarsfield   Road area of Ballyfermot or in the Golden Bridge Terrace area to contact them on 01-666-7200.,0,6,Gardaí,0,2,2
3DTJ4WT8BDGYMP1SBJPG0QKSW0NEZG,Gardaí are asking anyone who was in the Sarsfield   Road area of Ballyfermot or in the Golden Bridge Terrace area to contact them on 01-666-7200.,65,76,Ballyfermot,1,0,1
3DTJ4WT8BDGYMP1SBJPG0QKSW0NEZG,Gardaí are asking anyone who was in the Sarsfield   Road area of Ballyfermot or in the Golden Bridge Terrace area to contact them on 01-666-7200.,101,108,Terrace,0,1,1
3DTJ4WT8BDGYMP1SBJPG0QKSW0NEZG,"The Philippine government said Wednesday it agreed with China to diplomatically resolve a tense standoff involving a Philippine warship and two Chinese surveillance vessels in the disputed South China Sea, the most dangerous confrontation between the sides in recent years.",15,25,government,1,0,1
3DTJ4WT8BDGYMP1SBJPG0QKSW0NEZG,"The Philippine government said Wednesday it agreed with China to diplomatically resolve a tense standoff involving a Philippine warship and two Chinese surveillance vessels in the disputed South China Sea, the most dangerous confrontation between the sides in recent years.",65,79,diplomatically,10,3,13
3DTJ4WT8BDGYMP1SBJPG0QKSW0NEZG,"The Philippine government said Wednesday it agreed with China to diplomatically resolve a tense standoff involving a Philippine warship and two Chinese surveillance vessels in the disputed South China Sea, the most dangerous confrontation between the sides in recent years.",65,87,diplomatically resolve,3,4,7
3DTJ4WT8BDGYMP1SBJPG0QKSW0NEZG,"The Philippine government said Wednesday it agreed with China to diplomatically resolve a tense standoff involving a Philippine warship and two Chinese surveillance vessels in the disputed South China Sea, the most dangerous confrontation between the sides in recent years.",80,87,resolve,2,1,3
3DTJ4WT8BDGYMP1SBJPG0QKSW0NEZG,"The Philippine government said Wednesday it agreed with China to diplomatically resolve a tense standoff involving a Philippine warship and two Chinese surveillance vessels in the disputed South China Sea, the most dangerous confrontation between the sides in recent years.",90,104,tense standoff,3,0,3
3DTJ4WT8BDGYMP1SBJPG0QKSW0NEZG,"The Philippine government said Wednesday it agreed with China to diplomatically resolve a tense standoff involving a Philippine warship and two Chinese surveillance vessels in the disputed South China Sea, the most dangerous confrontation between the sides in recent years.",96,104,standoff,5,9,14
3DTJ4WT8BDGYMP1SBJPG0QKSW0NEZG,"The Philippine government said Wednesday it agreed with China to diplomatically resolve a tense standoff involving a Philippine warship and two Chinese surveillance vessels in the disputed South China Sea, the most dangerous confrontation between the sides in recent years.",105,114,involving,1,2,3
3DTJ4WT8BDGYMP1SBJPG0QKSW0NEZG,"The Philippine government said Wednesday it agreed with China to diplomatically resolve a tense standoff involving a Philippine warship and two Chinese surveillance vessels in the disputed South China Sea, the most dangerous confrontation between the sides in recent years.",128,135,warship,1,0,1
3DTJ4WT8BDGYMP1SBJPG0QKSW0NEZG,"The Philippine government said Wednesday it agreed with China to diplomatically resolve a tense standoff involving a Philippine warship and two Chinese surveillance vessels in the disputed South China Sea, the most dangerous confrontation between the sides in recent years.",152,164,surveillance,5,6,11
3DTJ4WT8BDGYMP1SBJPG0QKSW0NEZG,"The Philippine government said Wednesday it agreed with China to diplomatically resolve a tense standoff involving a Philippine warship and two Chinese surveillance vessels in the disputed South China Sea, the most dangerous confrontation between the sides in recent years.",152,172,surveillance vessels,6,1,7
3DTJ4WT8BDGYMP1SBJPG0QKSW0NEZG,"The Philippine government said Wednesday it agreed with China to diplomatically resolve a tense standoff involving a Philippine warship and two Chinese surveillance vessels in the disputed South China Sea, the most dangerous confrontation between the sides in recent years.",165,172,vessels,0,2,2
3DTJ4WT8BDGYMP1SBJPG0QKSW0NEZG,"The Philippine government said Wednesday it agreed with China to diplomatically resolve a tense standoff involving a Philippine warship and two Chinese surveillance vessels in the disputed South China Sea, the most dangerous confrontation between the sides in recent years.",180,188,disputed,5,5,10
3DTJ4WT8BDGYMP1SBJPG0QKSW0NEZG,"The Philippine government said Wednesday it agreed with China to diplomatically resolve a tense standoff involving a Philippine warship and two Chinese surveillance vessels in the disputed South China Sea, the most dangerous confrontation between the sides in recent years.",215,238,dangerous confrontation,2,0,2
3DTJ4WT8BDGYMP1SBJPG0QKSW0NEZG,"The Philippine government said Wednesday it agreed with China to diplomatically resolve a tense standoff involving a Philippine warship and two Chinese surveillance vessels in the disputed South China Sea, the most dangerous confrontation between the sides in recent years.",225,238,confrontation,10,9,19
3WJGKMRWVIAGMQCINAUOJA1MN60DCN,Wash said the family attended services last Sunday but had been absent for a few weeks before that.,21,29,attended,1,0,1
3WJGKMRWVIAGMQCINAUOJA1MN60DCN,Wash said the family attended services last Sunday but had been absent for a few weeks before that.,21,38,attended services,1,0,1
3WJGKMRWVIAGMQCINAUOJA1MN60DCN,Wash said the family attended services last Sunday but had been absent for a few weeks before that.,30,38,services,0,1,1
3WJGKMRWVIAGMQCINAUOJA1MN60DCN,Wash said the family attended services last Sunday but had been absent for a few weeks before that.,55,70,had been absent,0,1,1
3WJGKMRWVIAGMQCINAUOJA1MN60DCN,Wash said the family attended services last Sunday but had been absent for a few weeks before that.,64,70,absent,3,1,4
3WJGKMRWVIAGMQCINAUOJA1MN60DCN,"I don't know what could have happened in the past couple of days, Wash said.",51,65,couple of days,0,1,1
3WJGKMRWVIAGMQCINAUOJA1MN60DCN,It's a tragedy to the church and the community.,8,15,tragedy,10,8,18
3WJGKMRWVIAGMQCINAUOJA1MN60DCN,It's a tragedy to the church and the community.,38,47,community,3,0,3
3WJGKMRWVIAGMQCINAUOJA1MN60DCN,A 21-year-old woman who was seriously injured in a shooting incident in Co Derry yesterday remains in a critical condition at Belfast's Royal Victoria Hospital.,28,45,seriously injured,0,2,2
3WJGKMRWVIAGMQCINAUOJA1MN60DCN,A 21-year-old woman who was seriously injured in a shooting incident in Co Derry yesterday remains in a critical condition at Belfast's Royal Victoria Hospital.,51,59,shooting,1,1,2
3WJGKMRWVIAGMQCINAUOJA1MN60DCN,A 21-year-old woman who was seriously injured in a shooting incident in Co Derry yesterday remains in a critical condition at Belfast's Royal Victoria Hospital.,51,68,shooting incident,2,2,4
3WJGKMRWVIAGMQCINAUOJA1MN60DCN,A 21-year-old woman who was seriously injured in a shooting incident in Co Derry yesterday remains in a critical condition at Belfast's Royal Victoria Hospital.,60,68,incident,1,0,1
3WJGKMRWVIAGMQCINAUOJA1MN60DCN,A 21-year-old woman who was seriously injured in a shooting incident in Co Derry yesterday remains in a critical condition at Belfast's Royal Victoria Hospital.,91,98,remains,0,1,1
3WJGKMRWVIAGMQCINAUOJA1MN60DCN,A 21-year-old woman who was seriously injured in a shooting incident in Co Derry yesterday remains in a critical condition at Belfast's Royal Victoria Hospital.,104,112,critical,5,4,9
3WJGKMRWVIAGMQCINAUOJA1MN60DCN,A 21-year-old woman who was seriously injured in a shooting incident in Co Derry yesterday remains in a critical condition at Belfast's Royal Victoria Hospital.,104,122,critical condition,3,2,5
3WJGKMRWVIAGMQCINAUOJA1MN60DCN,"Her sister, Lauren O'Neill, 18, was killed in the gun attack at a house in William Court, Bellaghy yesterday morning.",50,71,gun attack at a house,1,0,1
3WJGKMRWVIAGMQCINAUOJA1MN60DCN,"A 26-year-old man, who was arrested on suspicion of murder, remains in custody assisting police with their inquiries.",39,48,suspicion,10,6,16
3WJGKMRWVIAGMQCINAUOJA1MN60DCN,"A 26-year-old man, who was arrested on suspicion of murder, remains in custody assisting police with their inquiries.",39,58,suspicion of murder,2,3,5
3WJGKMRWVIAGMQCINAUOJA1MN60DCN,"A 26-year-old man, who was arrested on suspicion of murder, remains in custody assisting police with their inquiries.",68,78,in custody,2,0,2
3WJGKMRWVIAGMQCINAUOJA1MN60DCN,"A 26-year-old man, who was arrested on suspicion of murder, remains in custody assisting police with their inquiries.",71,78,custody,3,3,6
3WJGKMRWVIAGMQCINAUOJA1MN60DCN,"A 26-year-old man, who was arrested on suspicion of murder, remains in custody assisting police with their inquiries.",71,95,custody assisting police,1,0,1
3WJGKMRWVIAGMQCINAUOJA1MN60DCN,"A 26-year-old man, who was arrested on suspicion of murder, remains in custody assisting police with their inquiries.",79,88,assisting,1,2,3
3WJGKMRWVIAGMQCINAUOJA1MN60DCN,"A 26-year-old man, who was arrested on suspicion of murder, remains in custody assisting police with their inquiries.",107,116,inquiries,4,5,9
3WJGKMRWVIAGMQCINAUOJA1MN60DCN,"Police say a man and woman, both aged 28, who were arrested on suspicion of assisting an offender were both released unconditionally last night.",63,72,suspicion,5,2,7
3WJGKMRWVIAGMQCINAUOJA1MN60DCN,"Police say a man and woman, both aged 28, who were arrested on suspicion of assisting an offender were both released unconditionally last night.",63,85,suspicion of assisting,0,1,1
3WJGKMRWVIAGMQCINAUOJA1MN60DCN,"Police say a man and woman, both aged 28, who were arrested on suspicion of assisting an offender were both released unconditionally last night.",63,97,suspicion of assisting an offender,1,0,1
3WJGKMRWVIAGMQCINAUOJA1MN60DCN,"Police say a man and woman, both aged 28, who were arrested on suspicion of assisting an offender were both released unconditionally last night.",76,85,assisting,1,1,2
3WJGKMRWVIAGMQCINAUOJA1MN60DCN,"Police say a man and woman, both aged 28, who were arrested on suspicion of assisting an offender were both released unconditionally last night.",76,97,assisting an offender,1,1,2
3WJGKMRWVIAGMQCINAUOJA1MN60DCN,"Police say a man and woman, both aged 28, who were arrested on suspicion of assisting an offender were both released unconditionally last night.",89,97,offender,4,4,8
3WJGKMRWVIAGMQCINAUOJA1MN60DCN,"Police say a man and woman, both aged 28, who were arrested on suspicion of assisting an offender were both released unconditionally last night.",108,132,released unconditionally,4,1,5
3WJGKMRWVIAGMQCINAUOJA1MN60DCN,"Police say a man and woman, both aged 28, who were arrested on suspicion of assisting an offender were both released unconditionally last night.",117,132,unconditionally,10,5,15
30U1YOGZGAXWT71EKWKOYF548WJDSN,Many defectors from the army comes from Rastan.,6,15,defectors,10,10,20
30U1YOGZGAXWT71EKWKOYF548WJDSN,Many defectors from the army comes from Rastan.,41,47,Rastan,2,2,4
30U1YOGZGAXWT71EKWKOYF548WJDSN,"Syrian authorities say more than 2,500 members of the security forces have been killed since the uprising began in March last year.",7,18,authorities,2,2,4
30U1YOGZGAXWT71EKWKOYF548WJDSN,"Syrian authorities say more than 2,500 members of the security forces have been killed since the uprising began in March last year.",54,69,security forces,3,0,3
30U1YOGZGAXWT71EKWKOYF548WJDSN,"Syrian authorities say more than 2,500 members of the security forces have been killed since the uprising began in March last year.",97,105,uprising,7,10,17
30U1YOGZGAXWT71EKWKOYF548WJDSN,"Opposition activists say more than 9,000 people have been killed.",0,10,Opposition,4,1,5
30U1YOGZGAXWT71EKWKOYF548WJDSN,"Opposition activists say more than 9,000 people have been killed.",0,20,Opposition activists,5,2,7
30U1YOGZGAXWT71EKWKOYF548WJDSN,"Opposition activists say more than 9,000 people have been killed.",11,20,activists,1,3,4
30U1YOGZGAXWT71EKWKOYF548WJDSN,EU sanctions Monday's violence further undermines a UN-backed peace plan that is supposed to bring an end to Syria's deadly crisis.,0,12,EU sanctions,1,0,1
30U1YOGZGAXWT71EKWKOYF548WJDSN,EU sanctions Monday's violence further undermines a UN-backed peace plan that is supposed to bring an end to Syria's deadly crisis.,3,12,sanctions,9,1,10
30U1YOGZGAXWT71EKWKOYF548WJDSN,EU sanctions Monday's violence further undermines a UN-backed peace plan that is supposed to bring an end to Syria's deadly crisis.,39,49,undermines,6,10,16
30U1YOGZGAXWT71EKWKOYF548WJDSN,EU sanctions Monday's violence further undermines a UN-backed peace plan that is supposed to bring an end to Syria's deadly crisis.,52,61,UN-backed,1,0,1
30U1YOGZGAXWT71EKWKOYF548WJDSN,EU sanctions Monday's violence further undermines a UN-backed peace plan that is supposed to bring an end to Syria's deadly crisis.,52,72,UN-backed peace plan,0,1,1
30U1YOGZGAXWT71EKWKOYF548WJDSN,EU sanctions Monday's violence further undermines a UN-backed peace plan that is supposed to bring an end to Syria's deadly crisis.,62,72,peace plan,1,0,1
30U1YOGZGAXWT71EKWKOYF548WJDSN,EU sanctions Monday's violence further undermines a UN-backed peace plan that is supposed to bring an end to Syria's deadly crisis.,81,89,supposed,1,2,3
30U1YOGZGAXWT71EKWKOYF548WJDSN,EU sanctions Monday's violence further undermines a UN-backed peace plan that is supposed to bring an end to Syria's deadly crisis.,117,130,deadly crisis,2,2,4
30U1YOGZGAXWT71EKWKOYF548WJDSN,EU sanctions Monday's violence further undermines a UN-backed peace plan that is supposed to bring an end to Syria's deadly crisis.,124,130,crisis,1,4,5
30U1YOGZGAXWT71EKWKOYF548WJDSN,"A ceasefire that was supposed to begin on April 12 has had only a limited effect, throwing into doubt the rest of the plan that calls for talks between President Bashar al-Assad's government and those seeking to end his rule.",2,11,ceasefire,10,10,20
30U1YOGZGAXWT71EKWKOYF548WJDSN,"A ceasefire that was supposed to begin on April 12 has had only a limited effect, throwing into doubt the rest of the plan that calls for talks between President Bashar al-Assad's government and those seeking to end his rule.",21,29,supposed,0,1,1
30U1YOGZGAXWT71EKWKOYF548WJDSN,"A ceasefire that was supposed to begin on April 12 has had only a limited effect, throwing into doubt the rest of the plan that calls for talks between President Bashar al-Assad's government and those seeking to end his rule.",82,101,throwing into doubt,1,1,2
30U1YOGZGAXWT71EKWKOYF548WJDSN,"A ceasefire that was supposed to begin on April 12 has had only a limited effect, throwing into doubt the rest of the plan that calls for talks between President Bashar al-Assad's government and those seeking to end his rule.",162,178,Bashar al-Assads,1,0,1
30U1YOGZGAXWT71EKWKOYF548WJDSN,"A ceasefire that was supposed to begin on April 12 has had only a limited effect, throwing into doubt the rest of the plan that calls for talks between President Bashar al-Assad's government and those seeking to end his rule.",201,208,seeking,0,2,2
30U1YOGZGAXWT71EKWKOYF548WJDSN,Part of the plan includes the deployment in flashpoint areas of around 300 UN military observers.,30,40,deployment,9,8,17
30U1YOGZGAXWT71EKWKOYF548WJDSN,Part of the plan includes the deployment in flashpoint areas of around 300 UN military observers.,44,54,flashpoint,5,6,11
30U1YOGZGAXWT71EKWKOYF548WJDSN,Part of the plan includes the deployment in flashpoint areas of around 300 UN military observers.,44,60,flashpoint areas,6,4,10
30U1YOGZGAXWT71EKWKOYF548WJDSN,Part of the plan includes the deployment in flashpoint areas of around 300 UN military observers.,75,96,UN military observers,1,0,1
30U1YOGZGAXWT71EKWKOYF548WJDSN,Part of the plan includes the deployment in flashpoint areas of around 300 UN military observers.,78,96,military observers,1,0,1
30U1YOGZGAXWT71EKWKOYF548WJDSN,Part of the plan includes the deployment in flashpoint areas of around 300 UN military observers.,87,96,observers,1,1,2
30U1YOGZGAXWT71EKWKOYF548WJDSN,"By Sunday,189 observers were on the ground, and several more arrived on Monday.",14,23,observers,2,0,2
30U1YOGZGAXWT71EKWKOYF548WJDSN,"By Sunday,189 observers were on the ground, and several more arrived on Monday.",14,42,observers were on the ground,1,0,1
302OLP89DZ8IOJ96303MT9TG233ACI,I believe that ignoring public opinion discredits the authorities and destabilises the situation.,16,24,ignoring,3,4,7
302OLP89DZ8IOJ96303MT9TG233ACI,I believe that ignoring public opinion discredits the authorities and destabilises the situation.,25,39,public opinion,1,0,1
302OLP89DZ8IOJ96303MT9TG233ACI,I believe that ignoring public opinion discredits the authorities and destabilises the situation.,40,50,discredits,10,9,19
302OLP89DZ8IOJ96303MT9TG233ACI,I believe that ignoring public opinion discredits the authorities and destabilises the situation.,40,66,discredits the authorities,1,0,1
302OLP89DZ8IOJ96303MT9TG233ACI,I believe that ignoring public opinion discredits the authorities and destabilises the situation.,55,66,authorities,2,2,4
302OLP89DZ8IOJ96303MT9TG233ACI,I believe that ignoring public opinion discredits the authorities and destabilises the situation.,71,83,destabilises,10,9,19
302OLP89DZ8IOJ96303MT9TG233ACI,I believe that ignoring public opinion discredits the authorities and destabilises the situation.,71,97,destabilises the situation,2,0,2
302OLP89DZ8IOJ96303MT9TG233ACI,I believe that ignoring public opinion discredits the authorities and destabilises the situation.,88,97,situation,1,1,2
302OLP89DZ8IOJ96303MT9TG233ACI,"Gorbachev added that authorities ""must admit that there have been numerous falsifications and ballot stuffing"".",0,9,Gorbachev,0,1,1
302OLP89DZ8IOJ96303MT9TG233ACI,"Gorbachev added that authorities ""must admit that there have been numerous falsifications and ballot stuffing"".",66,74,numerous,1,1,2
302OLP89DZ8IOJ96303MT9TG233ACI,"Gorbachev added that authorities ""must admit that there have been numerous falsifications and ballot stuffing"".",66,89,numerous falsifications,2,2,4
302OLP89DZ8IOJ96303MT9TG233ACI,"Gorbachev added that authorities ""must admit that there have been numerous falsifications and ballot stuffing"".",66,109,numerous falsifications and ballot stuffing,1,0,1
302OLP89DZ8IOJ96303MT9TG233ACI,"Gorbachev added that authorities ""must admit that there have been numerous falsifications and ballot stuffing"".",75,89,falsifications,10,10,20
302OLP89DZ8IOJ96303MT9TG233ACI,"Gorbachev added that authorities ""must admit that there have been numerous falsifications and ballot stuffing"".",94,100,ballot,2,2,4
302OLP89DZ8IOJ96303MT9TG233ACI,"Gorbachev added that authorities ""must admit that there have been numerous falsifications and ballot stuffing"".",94,109,ballot stuffing,6,5,11
302OLP89DZ8IOJ96303MT9TG233ACI,"Gorbachev added that authorities ""must admit that there have been numerous falsifications and ballot stuffing"".",101,109,stuffing,1,4,5
302OLP89DZ8IOJ96303MT9TG233ACI,"Sunday's parliamentary vote suggested Russians are tiring of Putin and his United Russia party, which has dominated all other political forces in the country for a dozen years and earned a reputation for corruption.",9,22,parliamentary,4,3,7
302OLP89DZ8IOJ96303MT9TG233ACI,"Sunday's parliamentary vote suggested Russians are tiring of Putin and his United Russia party, which has dominated all other political forces in the country for a dozen years and earned a reputation for corruption.",9,27,parliamentary vote,1,0,1
302OLP89DZ8IOJ96303MT9TG233ACI,"Sunday's parliamentary vote suggested Russians are tiring of Putin and his United Russia party, which has dominated all other political forces in the country for a dozen years and earned a reputation for corruption.",51,57,tiring,0,3,3
302OLP89DZ8IOJ96303MT9TG233ACI,"Sunday's parliamentary vote suggested Russians are tiring of Putin and his United Russia party, which has dominated all other political forces in the country for a dozen years and earned a reputation for corruption.",51,60,tiring of,1,0,1
302OLP89DZ8IOJ96303MT9TG233ACI,"Sunday's parliamentary vote suggested Russians are tiring of Putin and his United Russia party, which has dominated all other political forces in the country for a dozen years and earned a reputation for corruption.",106,115,dominated,6,5,11
302OLP89DZ8IOJ96303MT9TG233ACI,"Sunday's parliamentary vote suggested Russians are tiring of Putin and his United Russia party, which has dominated all other political forces in the country for a dozen years and earned a reputation for corruption.",126,142,political forces,1,0,1
302OLP89DZ8IOJ96303MT9TG233ACI,"Sunday's parliamentary vote suggested Russians are tiring of Putin and his United Russia party, which has dominated all other political forces in the country for a dozen years and earned a reputation for corruption.",180,186,earned,0,1,1
302OLP89DZ8IOJ96303MT9TG233ACI,"Sunday's parliamentary vote suggested Russians are tiring of Putin and his United Russia party, which has dominated all other political forces in the country for a dozen years and earned a reputation for corruption.",189,199,reputation,2,3,5
302OLP89DZ8IOJ96303MT9TG233ACI,"Sunday's parliamentary vote suggested Russians are tiring of Putin and his United Russia party, which has dominated all other political forces in the country for a dozen years and earned a reputation for corruption.",189,214,reputation for corruption,1,0,1
302OLP89DZ8IOJ96303MT9TG233ACI,"Sunday's parliamentary vote suggested Russians are tiring of Putin and his United Russia party, which has dominated all other political forces in the country for a dozen years and earned a reputation for corruption.",204,214,corruption,7,6,13
302OLP89DZ8IOJ96303MT9TG233ACI,"Putin, meanwhile, officially registered on Wednesday to run for the presidency in March, but the unusually sustained protests of the past two days suggested his drive to retake the job he held from 2000-2008 may not go as smoothly as he had expected.",7,16,meanwhile,0,1,1
302OLP89DZ8IOJ96303MT9TG233ACI,"Putin, meanwhile, officially registered on Wednesday to run for the presidency in March, but the unusually sustained protests of the past two days suggested his drive to retake the job he held from 2000-2008 may not go as smoothly as he had expected.",29,39,registered,0,1,1
302OLP89DZ8IOJ96303MT9TG233ACI,"Putin, meanwhile, officially registered on Wednesday to run for the presidency in March, but the unusually sustained protests of the past two days suggested his drive to retake the job he held from 2000-2008 may not go as smoothly as he had expected.",97,106,unusually,1,0,1
302OLP89DZ8IOJ96303MT9TG233ACI,"Putin, meanwhile, officially registered on Wednesday to run for the presidency in March, but the unusually sustained protests of the past two days suggested his drive to retake the job he held from 2000-2008 may not go as smoothly as he had expected.",97,125,unusually sustained protests,1,0,1
302OLP89DZ8IOJ96303MT9TG233ACI,"Putin, meanwhile, officially registered on Wednesday to run for the presidency in March, but the unusually sustained protests of the past two days suggested his drive to retake the job he held from 2000-2008 may not go as smoothly as he had expected.",107,116,sustained,7,5,12
302OLP89DZ8IOJ96303MT9TG233ACI,"Putin, meanwhile, officially registered on Wednesday to run for the presidency in March, but the unusually sustained protests of the past two days suggested his drive to retake the job he held from 2000-2008 may not go as smoothly as he had expected.",107,125,sustained protests,0,1,1
302OLP89DZ8IOJ96303MT9TG233ACI,"Putin, meanwhile, officially registered on Wednesday to run for the presidency in March, but the unusually sustained protests of the past two days suggested his drive to retake the job he held from 2000-2008 may not go as smoothly as he had expected.",117,125,protests,0,2,2
302OLP89DZ8IOJ96303MT9TG233ACI,"Putin, meanwhile, officially registered on Wednesday to run for the presidency in March, but the unusually sustained protests of the past two days suggested his drive to retake the job he held from 2000-2008 may not go as smoothly as he had expected.",161,166,drive,1,0,1
302OLP89DZ8IOJ96303MT9TG233ACI,"Putin, meanwhile, officially registered on Wednesday to run for the presidency in March, but the unusually sustained protests of the past two days suggested his drive to retake the job he held from 2000-2008 may not go as smoothly as he had expected.",170,176,retake,1,2,3
302OLP89DZ8IOJ96303MT9TG233ACI,"Putin, meanwhile, officially registered on Wednesday to run for the presidency in March, but the unusually sustained protests of the past two days suggested his drive to retake the job he held from 2000-2008 may not go as smoothly as he had expected.",222,230,smoothly,0,3,3
302OLP89DZ8IOJ96303MT9TG233ACI,"More opposition rallies were expected, along with another new pro-Putin gathering in central Moscow.",5,15,opposition,1,0,1
302OLP89DZ8IOJ96303MT9TG233ACI,"More opposition rallies were expected, along with another new pro-Putin gathering in central Moscow.",5,23,opposition rallies,4,0,4
302OLP89DZ8IOJ96303MT9TG233ACI,"More opposition rallies were expected, along with another new pro-Putin gathering in central Moscow.",16,23,rallies,1,4,5
302OLP89DZ8IOJ96303MT9TG233ACI,"More opposition rallies were expected, along with another new pro-Putin gathering in central Moscow.",62,71,pro-Putin,2,0,2
302OLP89DZ8IOJ96303MT9TG233ACI,"More opposition rallies were expected, along with another new pro-Putin gathering in central Moscow.",62,81,pro-Putin gathering,1,0,1
302OLP89DZ8IOJ96303MT9TG233ACI,"More opposition rallies were expected, along with another new pro-Putin gathering in central Moscow.",72,81,gathering,0,2,2
302OLP89DZ8IOJ96303MT9TG233ACI,Ex-Soviet leader Mikhail Gorbachev says Russian authorities must annul the parliamentary vote results and hold a new election.,25,34,Gorbachev,0,1,1
302OLP89DZ8IOJ96303MT9TG233ACI,Ex-Soviet leader Mikhail Gorbachev says Russian authorities must annul the parliamentary vote results and hold a new election.,48,59,authorities,1,2,3
302OLP89DZ8IOJ96303MT9TG233ACI,Ex-Soviet leader Mikhail Gorbachev says Russian authorities must annul the parliamentary vote results and hold a new election.,60,93,must annul the parliamentary vote,1,0,1
302OLP89DZ8IOJ96303MT9TG233ACI,Ex-Soviet leader Mikhail Gorbachev says Russian authorities must annul the parliamentary vote results and hold a new election.,65,70,annul,6,5,11
302OLP89DZ8IOJ96303MT9TG233ACI,Ex-Soviet leader Mikhail Gorbachev says Russian authorities must annul the parliamentary vote results and hold a new election.,75,88,parliamentary,3,1,4
302OLP89DZ8IOJ96303MT9TG233ACI,Ex-Soviet leader Mikhail Gorbachev says Russian authorities must annul the parliamentary vote results and hold a new election.,75,101,parliamentary vote results,1,0,1
302OLP89DZ8IOJ96303MT9TG233ACI,Ex-Soviet leader Mikhail Gorbachev says Russian authorities must annul the parliamentary vote results and hold a new election.,117,125,election,1,0,1
3R0WOCG21MAC8KTI91FODGNSTT4DU3,"More than 12,000 people, the majority of them civilians, have died since the Syrian uprising began in March 2011, according to the watchdog, including more than 900 killed since the April 12 truce.",29,37,majority,0,2,2
3R0WOCG21MAC8KTI91FODGNSTT4DU3,"More than 12,000 people, the majority of them civilians, have died since the Syrian uprising began in March 2011, according to the watchdog, including more than 900 killed since the April 12 truce.",46,55,civilians,5,2,7
3R0WOCG21MAC8KTI91FODGNSTT4DU3,"More than 12,000 people, the majority of them civilians, have died since the Syrian uprising began in March 2011, according to the watchdog, including more than 900 killed since the April 12 truce.",77,92,Syrian uprising,1,0,1
3R0WOCG21MAC8KTI91FODGNSTT4DU3,"More than 12,000 people, the majority of them civilians, have died since the Syrian uprising began in March 2011, according to the watchdog, including more than 900 killed since the April 12 truce.",84,92,uprising,7,3,10
3R0WOCG21MAC8KTI91FODGNSTT4DU3,"More than 12,000 people, the majority of them civilians, have died since the Syrian uprising began in March 2011, according to the watchdog, including more than 900 killed since the April 12 truce.",114,123,according,0,1,1
3R0WOCG21MAC8KTI91FODGNSTT4DU3,"More than 12,000 people, the majority of them civilians, have died since the Syrian uprising began in March 2011, according to the watchdog, including more than 900 killed since the April 12 truce.",131,139,watchdog,9,8,17
3R0WOCG21MAC8KTI91FODGNSTT4DU3,"More than 12,000 people, the majority of them civilians, have died since the Syrian uprising began in March 2011, according to the watchdog, including more than 900 killed since the April 12 truce.",141,150,including,0,1,1
3R0WOCG21MAC8KTI91FODGNSTT4DU3,"More than 12,000 people, the majority of them civilians, have died since the Syrian uprising began in March 2011, according to the watchdog, including more than 900 killed since the April 12 truce.",191,196,truce,1,3,4
3R0WOCG21MAC8KTI91FODGNSTT4DU3,Spanish banks will be forced to set aside extra funds as part of drastic reforms announced by the government to protect the fragile economy.,36,41,aside,0,2,2
3R0WOCG21MAC8KTI91FODGNSTT4DU3,Spanish banks will be forced to set aside extra funds as part of drastic reforms announced by the government to protect the fragile economy.,65,72,drastic,3,4,7
3R0WOCG21MAC8KTI91FODGNSTT4DU3,Spanish banks will be forced to set aside extra funds as part of drastic reforms announced by the government to protect the fragile economy.,65,80,drastic reforms,6,2,8
3R0WOCG21MAC8KTI91FODGNSTT4DU3,Spanish banks will be forced to set aside extra funds as part of drastic reforms announced by the government to protect the fragile economy.,73,80,reforms,1,2,3
3R0WOCG21MAC8KTI91FODGNSTT4DU3,Spanish banks will be forced to set aside extra funds as part of drastic reforms announced by the government to protect the fragile economy.,81,90,announced,1,2,3
3R0WOCG21MAC8KTI91FODGNSTT4DU3,Spanish banks will be forced to set aside extra funds as part of drastic reforms announced by the government to protect the fragile economy.,98,108,government,1,0,1
3R0WOCG21MAC8KTI91FODGNSTT4DU3,Spanish banks will be forced to set aside extra funds as part of drastic reforms announced by the government to protect the fragile economy.,124,131,fragile,6,6,12
3R0WOCG21MAC8KTI91FODGNSTT4DU3,Spanish banks will be forced to set aside extra funds as part of drastic reforms announced by the government to protect the fragile economy.,124,139,fragile economy,5,2,7
3R0WOCG21MAC8KTI91FODGNSTT4DU3,Banks will need to increase their cover on sound property loans from 7% to 30% and separate real estate assets from their balance sheets.,19,27,increase,0,1,1
3R0WOCG21MAC8KTI91FODGNSTT4DU3,Banks will need to increase their cover on sound property loans from 7% to 30% and separate real estate assets from their balance sheets.,43,63,sound property loans,3,1,4
3R0WOCG21MAC8KTI91FODGNSTT4DU3,Banks will need to increase their cover on sound property loans from 7% to 30% and separate real estate assets from their balance sheets.,83,91,separate,0,1,1
3R0WOCG21MAC8KTI91FODGNSTT4DU3,Banks will need to increase their cover on sound property loans from 7% to 30% and separate real estate assets from their balance sheets.,92,110,real estate assets,2,1,3
3R0WOCG21MAC8KTI91FODGNSTT4DU3,Banks will need to increase their cover on sound property loans from 7% to 30% and separate real estate assets from their balance sheets.,104,110,assets,3,2,5
3R0WOCG21MAC8KTI91FODGNSTT4DU3,Banks will need to increase their cover on sound property loans from 7% to 30% and separate real estate assets from their balance sheets.,122,136,balance sheets,4,1,5
3R0WOCG21MAC8KTI91FODGNSTT4DU3,"It is the second banking reform passed by the country's conservative government since it came into power in December, and comes just days after it was forced to part-nationalise Bankia, the country's fourth-largest bank due to the effect of the bursting of the property bubble.",17,31,banking reform,2,0,2
3R0WOCG21MAC8KTI91FODGNSTT4DU3,"It is the second banking reform passed by the country's conservative government since it came into power in December, and comes just days after it was forced to part-nationalise Bankia, the country's fourth-largest bank due to the effect of the bursting of the property bubble.",25,31,reform,1,2,3
3R0WOCG21MAC8KTI91FODGNSTT4DU3,"It is the second banking reform passed by the country's conservative government since it came into power in December, and comes just days after it was forced to part-nationalise Bankia, the country's fourth-largest bank due to the effect of the bursting of the property bubble.",56,68,conservative,8,3,11
3R0WOCG21MAC8KTI91FODGNSTT4DU3,"It is the second banking reform passed by the country's conservative government since it came into power in December, and comes just days after it was forced to part-nationalise Bankia, the country's fourth-largest bank due to the effect of the bursting of the property bubble.",56,79,conservative government,0,1,1
3R0WOCG21MAC8KTI91FODGNSTT4DU3,"It is the second banking reform passed by the country's conservative government since it came into power in December, and comes just days after it was forced to part-nationalise Bankia, the country's fourth-largest bank due to the effect of the bursting of the property bubble.",161,177,part-nationalise,10,3,13
3R0WOCG21MAC8KTI91FODGNSTT4DU3,"It is the second banking reform passed by the country's conservative government since it came into power in December, and comes just days after it was forced to part-nationalise Bankia, the country's fourth-largest bank due to the effect of the bursting of the property bubble.",161,184,part-nationalise Bankia,1,1,2
3R0WOCG21MAC8KTI91FODGNSTT4DU3,"It is the second banking reform passed by the country's conservative government since it came into power in December, and comes just days after it was forced to part-nationalise Bankia, the country's fourth-largest bank due to the effect of the bursting of the property bubble.",245,253,bursting,4,8,12
3R0WOCG21MAC8KTI91FODGNSTT4DU3,"It is the second banking reform passed by the country's conservative government since it came into power in December, and comes just days after it was forced to part-nationalise Bankia, the country's fourth-largest bank due to the effect of the bursting of the property bubble.",261,276,property bubble,6,4,10
3R0WOCG21MAC8KTI91FODGNSTT4DU3,"It is the second banking reform passed by the country's conservative government since it came into power in December, and comes just days after it was forced to part-nationalise Bankia, the country's fourth-largest bank due to the effect of the bursting of the property bubble.",270,276,bubble,0,2,2
33NKDW9FFXJUKWHZEAV0DH4E3OCCXO,"It has been an ongoing problem on our street with them, Hudson said.",13,31,an ongoing problem,1,0,1
33NKDW9FFXJUKWHZEAV0DH4E3OCCXO,"It has been an ongoing problem on our street with them, Hudson said.",16,23,ongoing,7,4,11
33NKDW9FFXJUKWHZEAV0DH4E3OCCXO,"It has been an ongoing problem on our street with them, Hudson said.",16,31,ongoing problem,0,3,3
33NKDW9FFXJUKWHZEAV0DH4E3OCCXO,Goodyear said Jaxs Johnson had recently been arrested on a domestic violence charge.,31,39,recently,0,1,1
33NKDW9FFXJUKWHZEAV0DH4E3OCCXO,Goodyear said Jaxs Johnson had recently been arrested on a domestic violence charge.,45,53,arrested,1,1,2
33NKDW9FFXJUKWHZEAV0DH4E3OCCXO,Goodyear said Jaxs Johnson had recently been arrested on a domestic violence charge.,59,67,domestic,3,1,4
33NKDW9FFXJUKWHZEAV0DH4E3OCCXO,Goodyear said Jaxs Johnson had recently been arrested on a domestic violence charge.,59,76,domestic violence,1,7,8
33NKDW9FFXJUKWHZEAV0DH4E3OCCXO,Goodyear said Jaxs Johnson had recently been arrested on a domestic violence charge.,59,83,domestic violence charge,5,1,6
33NKDW9FFXJUKWHZEAV0DH4E3OCCXO,Goodyear said Jaxs Johnson had recently been arrested on a domestic violence charge.,68,76,violence,0,2,2
33NKDW9FFXJUKWHZEAV0DH4E3OCCXO,Goodyear said Jaxs Johnson had recently been arrested on a domestic violence charge.,77,83,charge,0,1,1
33NKDW9FFXJUKWHZEAV0DH4E3OCCXO,He said he didn't know if the boy had been accused of hitting his mother or causing damage at the house.,43,50,accused,7,5,12
33NKDW9FFXJUKWHZEAV0DH4E3OCCXO,He said he didn't know if the boy had been accused of hitting his mother or causing damage at the house.,43,53,accused of,0,1,1
33NKDW9FFXJUKWHZEAV0DH4E3OCCXO,He said he didn't know if the boy had been accused of hitting his mother or causing damage at the house.,84,90,damage,0,2,2
33NKDW9FFXJUKWHZEAV0DH4E3OCCXO,"A pastor at the church the family attended described it as ""normal stuff.""",2,8,pastor,3,1,4
33NKDW9FFXJUKWHZEAV0DH4E3OCCXO,"A pastor at the church the family attended described it as ""normal stuff.""",34,42,attended,0,2,2
33NKDW9FFXJUKWHZEAV0DH4E3OCCXO,"A pastor at the church the family attended described it as ""normal stuff.""",43,52,described,2,1,3
33NKDW9FFXJUKWHZEAV0DH4E3OCCXO,"A pastor at the church the family attended described it as ""normal stuff.""",60,72,normal stuff,0,5,5
33NKDW9FFXJUKWHZEAV0DH4E3OCCXO,"A pastor at the church the family attended described it as ""normal stuff.""",67,72,stuff,0,2,2
33NKDW9FFXJUKWHZEAV0DH4E3OCCXO,"I think he was punching some walls or something, said Jarvis Wash, pastor of the Real Church in Rockledge, Fla.",16,24,punching,2,7,9
33NKDW9FFXJUKWHZEAV0DH4E3OCCXO,"I think he was punching some walls or something, said Jarvis Wash, pastor of the Real Church in Rockledge, Fla.",16,35,punching some walls,0,1,1
33NKDW9FFXJUKWHZEAV0DH4E3OCCXO,"I think he was punching some walls or something, said Jarvis Wash, pastor of the Real Church in Rockledge, Fla.",98,107,Rockledge,1,0,1
33NKDW9FFXJUKWHZEAV0DH4E3OCCXO,"I think he was punching some walls or something, said Jarvis Wash, pastor of the Real Church in Rockledge, Fla.",109,112,Fla,1,0,1
33NKDW9FFXJUKWHZEAV0DH4E3OCCXO,Wash said the family attended services last Sunday but had been absent for a few weeks before that.,21,29,attended,0,2,2
33NKDW9FFXJUKWHZEAV0DH4E3OCCXO,Wash said the family attended services last Sunday but had been absent for a few weeks before that.,21,38,attended services,2,1,3
33NKDW9FFXJUKWHZEAV0DH4E3OCCXO,Wash said the family attended services last Sunday but had been absent for a few weeks before that.,30,38,services,1,0,1
33NKDW9FFXJUKWHZEAV0DH4E3OCCXO,Wash said the family attended services last Sunday but had been absent for a few weeks before that.,55,70,had been absent,0,1,1
33NKDW9FFXJUKWHZEAV0DH4E3OCCXO,Wash said the family attended services last Sunday but had been absent for a few weeks before that.,64,70,absent,4,1,5
33NKDW9FFXJUKWHZEAV0DH4E3OCCXO,"I don't know what could have happened in the past couple of days, Wash said.",30,38,happened,1,1,2
33NKDW9FFXJUKWHZEAV0DH4E3OCCXO,"I don't know what could have happened in the past couple of days, Wash said.",46,65,past couple of days,0,1,1
33NKDW9FFXJUKWHZEAV0DH4E3OCCXO,It's a tragedy to the church and the community.,8,15,tragedy,10,10,20
33NKDW9FFXJUKWHZEAV0DH4E3OCCXO,It's a tragedy to the church and the community.,38,47,community,1,1,2
3WA2XVDZEMIWYFHH9ES53SRXQJN6EN,Guindos said the European Commission report failed to take account of all austerity measures.,0,7,Guindos,1,0,1
3WA2XVDZEMIWYFHH9ES53SRXQJN6EN,Guindos said the European Commission report failed to take account of all austerity measures.,17,36,European Commission,2,0,2
3WA2XVDZEMIWYFHH9ES53SRXQJN6EN,Guindos said the European Commission report failed to take account of all austerity measures.,26,36,Commission,2,0,2
3WA2XVDZEMIWYFHH9ES53SRXQJN6EN,Guindos said the European Commission report failed to take account of all austerity measures.,54,66,take account,1,0,1
3WA2XVDZEMIWYFHH9ES53SRXQJN6EN,Guindos said the European Commission report failed to take account of all austerity measures.,74,83,austerity,10,7,17
3WA2XVDZEMIWYFHH9ES53SRXQJN6EN,Guindos said the European Commission report failed to take account of all austerity measures.,74,92,austerity measures,5,3,8
3WA2XVDZEMIWYFHH9ES53SRXQJN6EN,"Al Jazeera's Sonia Gallego, reporting from Madrid, said ""with the gravity of the economic situation [in Spain], it is getting increasingly difficult"" for the government to refinance as much of the debt as it can.",66,73,gravity,9,2,11
3WA2XVDZEMIWYFHH9ES53SRXQJN6EN,"Al Jazeera's Sonia Gallego, reporting from Madrid, said ""with the gravity of the economic situation [in Spain], it is getting increasingly difficult"" for the government to refinance as much of the debt as it can.",66,99,gravity of the economic situation,1,1,2
3WA2XVDZEMIWYFHH9ES53SRXQJN6EN,"Al Jazeera's Sonia Gallego, reporting from Madrid, said ""with the gravity of the economic situation [in Spain], it is getting increasingly difficult"" for the government to refinance as much of the debt as it can.",81,89,economic,1,0,1
3WA2XVDZEMIWYFHH9ES53SRXQJN6EN,"Al Jazeera's Sonia Gallego, reporting from Madrid, said ""with the gravity of the economic situation [in Spain], it is getting increasingly difficult"" for the government to refinance as much of the debt as it can.",81,99,economic situation,2,0,2
3WA2XVDZEMIWYFHH9ES53SRXQJN6EN,"Al Jazeera's Sonia Gallego, reporting from Madrid, said ""with the gravity of the economic situation [in Spain], it is getting increasingly difficult"" for the government to refinance as much of the debt as it can.",90,99,situation,0,1,1
3WA2XVDZEMIWYFHH9ES53SRXQJN6EN,"Al Jazeera's Sonia Gallego, reporting from Madrid, said ""with the gravity of the economic situation [in Spain], it is getting increasingly difficult"" for the government to refinance as much of the debt as it can.",126,138,increasingly,1,0,1
3WA2XVDZEMIWYFHH9ES53SRXQJN6EN,"Al Jazeera's Sonia Gallego, reporting from Madrid, said ""with the gravity of the economic situation [in Spain], it is getting increasingly difficult"" for the government to refinance as much of the debt as it can.",126,148,increasingly difficult,0,1,1
3WA2XVDZEMIWYFHH9ES53SRXQJN6EN,"Al Jazeera's Sonia Gallego, reporting from Madrid, said ""with the gravity of the economic situation [in Spain], it is getting increasingly difficult"" for the government to refinance as much of the debt as it can.",158,168,government,1,0,1
3WA2XVDZEMIWYFHH9ES53SRXQJN6EN,"Al Jazeera's Sonia Gallego, reporting from Madrid, said ""with the gravity of the economic situation [in Spain], it is getting increasingly difficult"" for the government to refinance as much of the debt as it can.",172,181,refinance,9,7,16
3WA2XVDZEMIWYFHH9ES53SRXQJN6EN,"Spain's banks were hit by billions of euros of losses after a decade-long property bubble burst in 2008 and concerns about them, and the country's overspending regional governments have fanned fears of a new eurozone debt crisis.",19,22,hit,1,0,1
3WA2XVDZEMIWYFHH9ES53SRXQJN6EN,"Spain's banks were hit by billions of euros of losses after a decade-long property bubble burst in 2008 and concerns about them, and the country's overspending regional governments have fanned fears of a new eurozone debt crisis.",38,43,euros,2,0,2
3WA2XVDZEMIWYFHH9ES53SRXQJN6EN,"Spain's banks were hit by billions of euros of losses after a decade-long property bubble burst in 2008 and concerns about them, and the country's overspending regional governments have fanned fears of a new eurozone debt crisis.",62,73,decade-long,1,4,5
3WA2XVDZEMIWYFHH9ES53SRXQJN6EN,"Spain's banks were hit by billions of euros of losses after a decade-long property bubble burst in 2008 and concerns about them, and the country's overspending regional governments have fanned fears of a new eurozone debt crisis.",62,89,decade-long property bubble,0,2,2
3WA2XVDZEMIWYFHH9ES53SRXQJN6EN,"Spain's banks were hit by billions of euros of losses after a decade-long property bubble burst in 2008 and concerns about them, and the country's overspending regional governments have fanned fears of a new eurozone debt crisis.",74,89,property bubble,4,1,5
3WA2XVDZEMIWYFHH9ES53SRXQJN6EN,"Spain's banks were hit by billions of euros of losses after a decade-long property bubble burst in 2008 and concerns about them, and the country's overspending regional governments have fanned fears of a new eurozone debt crisis.",74,95,property bubble burst,2,1,3
3WA2XVDZEMIWYFHH9ES53SRXQJN6EN,"Spain's banks were hit by billions of euros of losses after a decade-long property bubble burst in 2008 and concerns about them, and the country's overspending regional governments have fanned fears of a new eurozone debt crisis.",83,89,bubble,1,0,1
3WA2XVDZEMIWYFHH9ES53SRXQJN6EN,"Spain's banks were hit by billions of euros of losses after a decade-long property bubble burst in 2008 and concerns about them, and the country's overspending regional governments have fanned fears of a new eurozone debt crisis.",83,95,bubble burst,2,2,4
3WA2XVDZEMIWYFHH9ES53SRXQJN6EN,"Spain's banks were hit by billions of euros of losses after a decade-long property bubble burst in 2008 and concerns about them, and the country's overspending regional governments have fanned fears of a new eurozone debt crisis.",90,95,burst,0,2,2
3WA2XVDZEMIWYFHH9ES53SRXQJN6EN,"Spain's banks were hit by billions of euros of losses after a decade-long property bubble burst in 2008 and concerns about them, and the country's overspending regional governments have fanned fears of a new eurozone debt crisis.",108,116,concerns,1,1,2
3WA2XVDZEMIWYFHH9ES53SRXQJN6EN,"Spain's banks were hit by billions of euros of losses after a decade-long property bubble burst in 2008 and concerns about them, and the country's overspending regional governments have fanned fears of a new eurozone debt crisis.",147,159,overspending,2,6,8
3WA2XVDZEMIWYFHH9ES53SRXQJN6EN,"Spain's banks were hit by billions of euros of losses after a decade-long property bubble burst in 2008 and concerns about them, and the country's overspending regional governments have fanned fears of a new eurozone debt crisis.",160,168,regional,1,0,1
3WA2XVDZEMIWYFHH9ES53SRXQJN6EN,"Spain's banks were hit by billions of euros of losses after a decade-long property bubble burst in 2008 and concerns about them, and the country's overspending regional governments have fanned fears of a new eurozone debt crisis.",186,192,fanned,5,9,14
3WA2XVDZEMIWYFHH9ES53SRXQJN6EN,"Spain's banks were hit by billions of euros of losses after a decade-long property bubble burst in 2008 and concerns about them, and the country's overspending regional governments have fanned fears of a new eurozone debt crisis.",186,198,fanned fears,0,1,1
3WA2XVDZEMIWYFHH9ES53SRXQJN6EN,"Spain's banks were hit by billions of euros of losses after a decade-long property bubble burst in 2008 and concerns about them, and the country's overspending regional governments have fanned fears of a new eurozone debt crisis.",208,216,eurozone,5,0,5
3WA2XVDZEMIWYFHH9ES53SRXQJN6EN,"Spain's banks were hit by billions of euros of losses after a decade-long property bubble burst in 2008 and concerns about them, and the country's overspending regional governments have fanned fears of a new eurozone debt crisis.",208,228,eurozone debt crisis,1,1,2
3WA2XVDZEMIWYFHH9ES53SRXQJN6EN,"Spain's banks were hit by billions of euros of losses after a decade-long property bubble burst in 2008 and concerns about them, and the country's overspending regional governments have fanned fears of a new eurozone debt crisis.",217,228,debt crisis,2,0,2
3WA2XVDZEMIWYFHH9ES53SRXQJN6EN,"Spain's banks were hit by billions of euros of losses after a decade-long property bubble burst in 2008 and concerns about them, and the country's overspending regional governments have fanned fears of a new eurozone debt crisis.",222,228,crisis,1,1,2
3WA2XVDZEMIWYFHH9ES53SRXQJN6EN,"Toxic assets now total 184bn euros, but many fear the hole is even bigger.",0,5,Toxic,1,2,3
3WA2XVDZEMIWYFHH9ES53SRXQJN6EN,"Toxic assets now total 184bn euros, but many fear the hole is even bigger.",0,12,Toxic assets,6,7,13
3WA2XVDZEMIWYFHH9ES53SRXQJN6EN,"Toxic assets now total 184bn euros, but many fear the hole is even bigger.",6,12,assets,1,2,3
3WA2XVDZEMIWYFHH9ES53SRXQJN6EN,"Toxic assets now total 184bn euros, but many fear the hole is even bigger.",45,58,fear the hole,0,1,1
3WA2XVDZEMIWYFHH9ES53SRXQJN6EN,"Toxic assets now total 184bn euros, but many fear the hole is even bigger.",54,58,hole,0,1,1
3WA2XVDZEMIWYFHH9ES53SRXQJN6EN,Successive waves of bank sector clean-ups have failed to convince investors.,0,10,Successive,6,3,9
3WA2XVDZEMIWYFHH9ES53SRXQJN6EN,Successive waves of bank sector clean-ups have failed to convince investors.,0,16,Successive waves,2,3,5
3WA2XVDZEMIWYFHH9ES53SRXQJN6EN,Successive waves of bank sector clean-ups have failed to convince investors.,25,31,sector,2,0,2
3WA2XVDZEMIWYFHH9ES53SRXQJN6EN,Successive waves of bank sector clean-ups have failed to convince investors.,32,41,clean-ups,1,5,6
3WA2XVDZEMIWYFHH9ES53SRXQJN6EN,Successive waves of bank sector clean-ups have failed to convince investors.,57,65,convince,1,2,3
3WA2XVDZEMIWYFHH9ES53SRXQJN6EN,Successive waves of bank sector clean-ups have failed to convince investors.,66,75,investors,1,0,1
3WA2XVDZEMIWYFHH9ES53SRXQJN6EN,Our correspondent said that the toxic assets were a result of the property bubble.,4,17,correspondent,4,1,5
3WA2XVDZEMIWYFHH9ES53SRXQJN6EN,Our correspondent said that the toxic assets were a result of the property bubble.,32,44,toxic assets,5,1,6
3WA2XVDZEMIWYFHH9ES53SRXQJN6EN,Our correspondent said that the toxic assets were a result of the property bubble.,38,44,assets,1,0,1
3WA2XVDZEMIWYFHH9ES53SRXQJN6EN,Our correspondent said that the toxic assets were a result of the property bubble.,66,81,property bubble,6,1,7
3BDORL6HKKEAN0VN5BP8OZIQ163CR1,Republicans warily saluted Obama's war-zone trip but accused him of craven politics nonetheless.,0,26,Republicans warily saluted,0,1,1
3BDORL6HKKEAN0VN5BP8OZIQ163CR1,Republicans warily saluted Obama's war-zone trip but accused him of craven politics nonetheless.,12,18,warily,10,10,20
3BDORL6HKKEAN0VN5BP8OZIQ163CR1,Republicans warily saluted Obama's war-zone trip but accused him of craven politics nonetheless.,12,26,warily saluted,1,0,1
3BDORL6HKKEAN0VN5BP8OZIQ163CR1,Republicans warily saluted Obama's war-zone trip but accused him of craven politics nonetheless.,19,26,saluted,2,0,2
3BDORL6HKKEAN0VN5BP8OZIQ163CR1,Republicans warily saluted Obama's war-zone trip but accused him of craven politics nonetheless.,35,43,war-zone,0,1,1
3BDORL6HKKEAN0VN5BP8OZIQ163CR1,Republicans warily saluted Obama's war-zone trip but accused him of craven politics nonetheless.,35,48,war-zone trip,0,1,1
3BDORL6HKKEAN0VN5BP8OZIQ163CR1,Republicans warily saluted Obama's war-zone trip but accused him of craven politics nonetheless.,53,60,accused,0,5,5
3BDORL6HKKEAN0VN5BP8OZIQ163CR1,Republicans warily saluted Obama's war-zone trip but accused him of craven politics nonetheless.,68,74,craven,10,9,19
3BDORL6HKKEAN0VN5BP8OZIQ163CR1,Republicans warily saluted Obama's war-zone trip but accused him of craven politics nonetheless.,68,83,craven politics,1,2,3
3BDORL6HKKEAN0VN5BP8OZIQ163CR1,Republicans warily saluted Obama's war-zone trip but accused him of craven politics nonetheless.,84,95,nonetheless,5,8,13
3BDORL6HKKEAN0VN5BP8OZIQ163CR1,"Clearly this trip is campaign-related, said Sen. Jim Inhofe, a senior member of the Senate Armed Services Committee.",22,38,campaign-related,4,4,8
3BDORL6HKKEAN0VN5BP8OZIQ163CR1,"This trip to Afghanistan is an attempt to shore up his national security credentials, because he has spent the past three years gutting our military, a reference to tightening defense budgets.",32,39,attempt,0,1,1
3BDORL6HKKEAN0VN5BP8OZIQ163CR1,"This trip to Afghanistan is an attempt to shore up his national security credentials, because he has spent the past three years gutting our military, a reference to tightening defense budgets.",32,51,attempt to shore up,1,0,1
3BDORL6HKKEAN0VN5BP8OZIQ163CR1,"This trip to Afghanistan is an attempt to shore up his national security credentials, because he has spent the past three years gutting our military, a reference to tightening defense budgets.",40,51,to shore up,1,0,1
3BDORL6HKKEAN0VN5BP8OZIQ163CR1,"This trip to Afghanistan is an attempt to shore up his national security credentials, because he has spent the past three years gutting our military, a reference to tightening defense budgets.",43,48,shore,0,2,2
3BDORL6HKKEAN0VN5BP8OZIQ163CR1,"This trip to Afghanistan is an attempt to shore up his national security credentials, because he has spent the past three years gutting our military, a reference to tightening defense budgets.",43,51,shore up,7,3,10
3BDORL6HKKEAN0VN5BP8OZIQ163CR1,"This trip to Afghanistan is an attempt to shore up his national security credentials, because he has spent the past three years gutting our military, a reference to tightening defense budgets.",56,85,national security credentials,2,1,3
3BDORL6HKKEAN0VN5BP8OZIQ163CR1,"This trip to Afghanistan is an attempt to shore up his national security credentials, because he has spent the past three years gutting our military, a reference to tightening defense budgets.",65,85,security credentials,1,0,1
3BDORL6HKKEAN0VN5BP8OZIQ163CR1,"This trip to Afghanistan is an attempt to shore up his national security credentials, because he has spent the past three years gutting our military, a reference to tightening defense budgets.",74,85,credentials,7,5,12
3BDORL6HKKEAN0VN5BP8OZIQ163CR1,"This trip to Afghanistan is an attempt to shore up his national security credentials, because he has spent the past three years gutting our military, a reference to tightening defense budgets.",129,136,gutting,8,7,15
3BDORL6HKKEAN0VN5BP8OZIQ163CR1,"This trip to Afghanistan is an attempt to shore up his national security credentials, because he has spent the past three years gutting our military, a reference to tightening defense budgets.",129,149,gutting our military,1,1,2
3BDORL6HKKEAN0VN5BP8OZIQ163CR1,"This trip to Afghanistan is an attempt to shore up his national security credentials, because he has spent the past three years gutting our military, a reference to tightening defense budgets.",167,177,tightening,1,3,4
3BDORL6HKKEAN0VN5BP8OZIQ163CR1,"This trip to Afghanistan is an attempt to shore up his national security credentials, because he has spent the past three years gutting our military, a reference to tightening defense budgets.",167,193,tightening defense budgets,1,1,2
3BDORL6HKKEAN0VN5BP8OZIQ163CR1,"This trip to Afghanistan is an attempt to shore up his national security credentials, because he has spent the past three years gutting our military, a reference to tightening defense budgets.",178,193,defense budgets,1,0,1
3BDORL6HKKEAN0VN5BP8OZIQ163CR1,"Obama's presumed Republican opponent, Mitt Romney, was in New York accusing the president of politicizing the fleeting unity that came with bin Laden's death.",8,16,presumed,3,5,8
3BDORL6HKKEAN0VN5BP8OZIQ163CR1,"Obama's presumed Republican opponent, Mitt Romney, was in New York accusing the president of politicizing the fleeting unity that came with bin Laden's death.",28,36,opponent,2,0,2
3BDORL6HKKEAN0VN5BP8OZIQ163CR1,"Obama's presumed Republican opponent, Mitt Romney, was in New York accusing the president of politicizing the fleeting unity that came with bin Laden's death.",93,105,politicizing,7,2,9
3BDORL6HKKEAN0VN5BP8OZIQ163CR1,"Obama's presumed Republican opponent, Mitt Romney, was in New York accusing the president of politicizing the fleeting unity that came with bin Laden's death.",93,124,politicizing the fleeting unity,1,1,2
3BDORL6HKKEAN0VN5BP8OZIQ163CR1,"Obama's presumed Republican opponent, Mitt Romney, was in New York accusing the president of politicizing the fleeting unity that came with bin Laden's death.",110,118,fleeting,9,4,13
3BDORL6HKKEAN0VN5BP8OZIQ163CR1,"Obama's presumed Republican opponent, Mitt Romney, was in New York accusing the president of politicizing the fleeting unity that came with bin Laden's death.",110,124,fleeting unity,3,4,7
3BDORL6HKKEAN0VN5BP8OZIQ163CR1,"Stephen Biddle, a defense analyst at the Council on Foreign Relations, said Obama will be hard pressed to convince Afghans or Pakistanis that the United States will remain an effective security partner once most U.S. troops have gone home.",18,33,defense analyst,3,0,3
3BDORL6HKKEAN0VN5BP8OZIQ163CR1,"Stephen Biddle, a defense analyst at the Council on Foreign Relations, said Obama will be hard pressed to convince Afghans or Pakistanis that the United States will remain an effective security partner once most U.S. troops have gone home.",26,33,analyst,2,1,3
3BDORL6HKKEAN0VN5BP8OZIQ163CR1,"Stephen Biddle, a defense analyst at the Council on Foreign Relations, said Obama will be hard pressed to convince Afghans or Pakistanis that the United States will remain an effective security partner once most U.S. troops have gone home.",41,69,Council on Foreign Relations,1,0,1
3BDORL6HKKEAN0VN5BP8OZIQ163CR1,"Stephen Biddle, a defense analyst at the Council on Foreign Relations, said Obama will be hard pressed to convince Afghans or Pakistanis that the United States will remain an effective security partner once most U.S. troops have gone home.",76,114,Obama will be hard pressed to convince,1,0,1
3BDORL6HKKEAN0VN5BP8OZIQ163CR1,"Stephen Biddle, a defense analyst at the Council on Foreign Relations, said Obama will be hard pressed to convince Afghans or Pakistanis that the United States will remain an effective security partner once most U.S. troops have gone home.",90,102,hard pressed,9,1,10
3BDORL6HKKEAN0VN5BP8OZIQ163CR1,"Stephen Biddle, a defense analyst at the Council on Foreign Relations, said Obama will be hard pressed to convince Afghans or Pakistanis that the United States will remain an effective security partner once most U.S. troops have gone home.",106,114,convince,0,1,1
3BDORL6HKKEAN0VN5BP8OZIQ163CR1,"Stephen Biddle, a defense analyst at the Council on Foreign Relations, said Obama will be hard pressed to convince Afghans or Pakistanis that the United States will remain an effective security partner once most U.S. troops have gone home.",175,184,effective,1,0,1
3BDORL6HKKEAN0VN5BP8OZIQ163CR1,"Stephen Biddle, a defense analyst at the Council on Foreign Relations, said Obama will be hard pressed to convince Afghans or Pakistanis that the United States will remain an effective security partner once most U.S. troops have gone home.",185,201,security partner,2,0,2
3Z8UJEJOCZEG603II1EL4BE2PV593A,"Syrian troops shelled a rebel-held town on Monday, sparking intense clashes that sent bloodied victims flooding into hospitals and clinics, activists said.",7,13,troops,0,1,1
3Z8UJEJOCZEG603II1EL4BE2PV593A,"Syrian troops shelled a rebel-held town on Monday, sparking intense clashes that sent bloodied victims flooding into hospitals and clinics, activists said.",14,21,shelled,7,10,17
3Z8UJEJOCZEG603II1EL4BE2PV593A,"Syrian troops shelled a rebel-held town on Monday, sparking intense clashes that sent bloodied victims flooding into hospitals and clinics, activists said.",24,34,rebel-held,5,5,10
3Z8UJEJOCZEG603II1EL4BE2PV593A,"Syrian troops shelled a rebel-held town on Monday, sparking intense clashes that sent bloodied victims flooding into hospitals and clinics, activists said.",51,59,sparking,6,5,11
3Z8UJEJOCZEG603II1EL4BE2PV593A,"Syrian troops shelled a rebel-held town on Monday, sparking intense clashes that sent bloodied victims flooding into hospitals and clinics, activists said.",51,67,sparking intense,0,1,1
3Z8UJEJOCZEG603II1EL4BE2PV593A,"Syrian troops shelled a rebel-held town on Monday, sparking intense clashes that sent bloodied victims flooding into hospitals and clinics, activists said.",51,75,sparking intense clashes,1,2,3
3Z8UJEJOCZEG603II1EL4BE2PV593A,"Syrian troops shelled a rebel-held town on Monday, sparking intense clashes that sent bloodied victims flooding into hospitals and clinics, activists said.",60,67,intense,2,1,3
3Z8UJEJOCZEG603II1EL4BE2PV593A,"Syrian troops shelled a rebel-held town on Monday, sparking intense clashes that sent bloodied victims flooding into hospitals and clinics, activists said.",60,75,intense clashes,1,2,3
3Z8UJEJOCZEG603II1EL4BE2PV593A,"Syrian troops shelled a rebel-held town on Monday, sparking intense clashes that sent bloodied victims flooding into hospitals and clinics, activists said.",86,94,bloodied,4,2,6
3Z8UJEJOCZEG603II1EL4BE2PV593A,"Syrian troops shelled a rebel-held town on Monday, sparking intense clashes that sent bloodied victims flooding into hospitals and clinics, activists said.",86,102,bloodied victims,0,1,1
3Z8UJEJOCZEG603II1EL4BE2PV593A,"Syrian troops shelled a rebel-held town on Monday, sparking intense clashes that sent bloodied victims flooding into hospitals and clinics, activists said.",95,102,victims,0,1,1
3Z8UJEJOCZEG603II1EL4BE2PV593A,"Syrian troops shelled a rebel-held town on Monday, sparking intense clashes that sent bloodied victims flooding into hospitals and clinics, activists said.",103,111,flooding,0,2,2
3Z8UJEJOCZEG603II1EL4BE2PV593A,"Syrian troops shelled a rebel-held town on Monday, sparking intense clashes that sent bloodied victims flooding into hospitals and clinics, activists said.",140,149,activists,5,2,7
3Z8UJEJOCZEG603II1EL4BE2PV593A,"The violence in Rastan, in the restive central Homs province, and elsewhere around the country is eroding an internationally brokered peace plan that many observers see as the last hope to calm the 14-month-old crisis.",4,12,violence,0,3,3
3Z8UJEJOCZEG603II1EL4BE2PV593A,"The violence in Rastan, in the restive central Homs province, and elsewhere around the country is eroding an internationally brokered peace plan that many observers see as the last hope to calm the 14-month-old crisis.",31,38,restive,8,8,16
3Z8UJEJOCZEG603II1EL4BE2PV593A,"The violence in Rastan, in the restive central Homs province, and elsewhere around the country is eroding an internationally brokered peace plan that many observers see as the last hope to calm the 14-month-old crisis.",52,60,province,2,0,2
3Z8UJEJOCZEG603II1EL4BE2PV593A,"The violence in Rastan, in the restive central Homs province, and elsewhere around the country is eroding an internationally brokered peace plan that many observers see as the last hope to calm the 14-month-old crisis.",66,75,elsewhere,0,1,1
3Z8UJEJOCZEG603II1EL4BE2PV593A,"The violence in Rastan, in the restive central Homs province, and elsewhere around the country is eroding an internationally brokered peace plan that many observers see as the last hope to calm the 14-month-old crisis.",98,105,eroding,9,10,19
3Z8UJEJOCZEG603II1EL4BE2PV593A,"The violence in Rastan, in the restive central Homs province, and elsewhere around the country is eroding an internationally brokered peace plan that many observers see as the last hope to calm the 14-month-old crisis.",109,124,internationally,1,0,1
3Z8UJEJOCZEG603II1EL4BE2PV593A,"The violence in Rastan, in the restive central Homs province, and elsewhere around the country is eroding an internationally brokered peace plan that many observers see as the last hope to calm the 14-month-old crisis.",109,133,internationally brokered,1,0,1
3Z8UJEJOCZEG603II1EL4BE2PV593A,"The violence in Rastan, in the restive central Homs province, and elsewhere around the country is eroding an internationally brokered peace plan that many observers see as the last hope to calm the 14-month-old crisis.",109,144,internationally brokered peace plan,1,1,2
3Z8UJEJOCZEG603II1EL4BE2PV593A,"The violence in Rastan, in the restive central Homs province, and elsewhere around the country is eroding an internationally brokered peace plan that many observers see as the last hope to calm the 14-month-old crisis.",125,133,brokered,5,8,13
3Z8UJEJOCZEG603II1EL4BE2PV593A,"The violence in Rastan, in the restive central Homs province, and elsewhere around the country is eroding an internationally brokered peace plan that many observers see as the last hope to calm the 14-month-old crisis.",125,144,brokered peace plan,1,0,1
3Z8UJEJOCZEG603II1EL4BE2PV593A,"The violence in Rastan, in the restive central Homs province, and elsewhere around the country is eroding an internationally brokered peace plan that many observers see as the last hope to calm the 14-month-old crisis.",155,164,observers,0,1,1
3Z8UJEJOCZEG603II1EL4BE2PV593A,"The violence in Rastan, in the restive central Homs province, and elsewhere around the country is eroding an internationally brokered peace plan that many observers see as the last hope to calm the 14-month-old crisis.",211,217,crisis,1,2,3
3Z8UJEJOCZEG603II1EL4BE2PV593A,An amateur video showed a young girl who apparently suffered shrapnel wounds in her thigh undergoing treatment in a makeshift Rastan hospital while screaming in pain.,3,10,amateur,4,5,9
3Z8UJEJOCZEG603II1EL4BE2PV593A,An amateur video showed a young girl who apparently suffered shrapnel wounds in her thigh undergoing treatment in a makeshift Rastan hospital while screaming in pain.,3,16,amateur video,0,1,1
3Z8UJEJOCZEG603II1EL4BE2PV593A,An amateur video showed a young girl who apparently suffered shrapnel wounds in her thigh undergoing treatment in a makeshift Rastan hospital while screaming in pain.,41,51,apparently,0,3,3
3Z8UJEJOCZEG603II1EL4BE2PV593A,An amateur video showed a young girl who apparently suffered shrapnel wounds in her thigh undergoing treatment in a makeshift Rastan hospital while screaming in pain.,52,60,suffered,0,2,2
3Z8UJEJOCZEG603II1EL4BE2PV593A,An amateur video showed a young girl who apparently suffered shrapnel wounds in her thigh undergoing treatment in a makeshift Rastan hospital while screaming in pain.,61,69,shrapnel,10,8,18
3Z8UJEJOCZEG603II1EL4BE2PV593A,An amateur video showed a young girl who apparently suffered shrapnel wounds in her thigh undergoing treatment in a makeshift Rastan hospital while screaming in pain.,61,76,shrapnel wounds,1,4,5
3Z8UJEJOCZEG603II1EL4BE2PV593A,An amateur video showed a young girl who apparently suffered shrapnel wounds in her thigh undergoing treatment in a makeshift Rastan hospital while screaming in pain.,70,76,wounds,1,0,1
3Z8UJEJOCZEG603II1EL4BE2PV593A,An amateur video showed a young girl who apparently suffered shrapnel wounds in her thigh undergoing treatment in a makeshift Rastan hospital while screaming in pain.,90,100,undergoing,1,1,2
3Z8UJEJOCZEG603II1EL4BE2PV593A,An amateur video showed a young girl who apparently suffered shrapnel wounds in her thigh undergoing treatment in a makeshift Rastan hospital while screaming in pain.,116,125,makeshift,8,8,16
3Z8UJEJOCZEG603II1EL4BE2PV593A,An amateur video showed a young girl who apparently suffered shrapnel wounds in her thigh undergoing treatment in a makeshift Rastan hospital while screaming in pain.,148,157,screaming,0,5,5
3Z8UJEJOCZEG603II1EL4BE2PV593A,"Rastan, just north of Homs, has been under rebel control since January.",43,48,rebel,0,4,4
3Z8UJEJOCZEG603II1EL4BE2PV593A,"Rastan, just north of Homs, has been under rebel control since January.",43,56,rebel control,1,1,2
3Z8UJEJOCZEG603II1EL4BE2PV593A,The Britain-based Syrian Observatory for Human Rights and the activist network called the Local Coordination Committees said the latest shelling of Rastan started on Sunday.,25,36,Observatory,1,3,4
3Z8UJEJOCZEG603II1EL4BE2PV593A,The Britain-based Syrian Observatory for Human Rights and the activist network called the Local Coordination Committees said the latest shelling of Rastan started on Sunday.,41,53,Human Rights,1,0,1
3Z8UJEJOCZEG603II1EL4BE2PV593A,The Britain-based Syrian Observatory for Human Rights and the activist network called the Local Coordination Committees said the latest shelling of Rastan started on Sunday.,62,70,activist,3,0,3
3Z8UJEJOCZEG603II1EL4BE2PV593A,The Britain-based Syrian Observatory for Human Rights and the activist network called the Local Coordination Committees said the latest shelling of Rastan started on Sunday.,62,78,activist network,3,1,4
3Z8UJEJOCZEG603II1EL4BE2PV593A,The Britain-based Syrian Observatory for Human Rights and the activist network called the Local Coordination Committees said the latest shelling of Rastan started on Sunday.,96,119,Coordination Committees,1,1,2
3Z8UJEJOCZEG603II1EL4BE2PV593A,The Britain-based Syrian Observatory for Human Rights and the activist network called the Local Coordination Committees said the latest shelling of Rastan started on Sunday.,136,144,shelling,7,2,9
3VEI3XUCZRYTHP4RAGBE8ZHX1Q6PRJ,"Three of the children, at least one already wounded, fled to the home of a neighbor who had been awakened by gunfire, but Thomas immediately called the children back and killed them, sheriff's spokesman Tom Goodyear said.",44,51,wounded,3,4,7
3VEI3XUCZRYTHP4RAGBE8ZHX1Q6PRJ,"Three of the children, at least one already wounded, fled to the home of a neighbor who had been awakened by gunfire, but Thomas immediately called the children back and killed them, sheriff's spokesman Tom Goodyear said.",53,57,fled,1,9,10
3VEI3XUCZRYTHP4RAGBE8ZHX1Q6PRJ,"Three of the children, at least one already wounded, fled to the home of a neighbor who had been awakened by gunfire, but Thomas immediately called the children back and killed them, sheriff's spokesman Tom Goodyear said.",75,83,neighbor,0,1,1
3VEI3XUCZRYTHP4RAGBE8ZHX1Q6PRJ,"Three of the children, at least one already wounded, fled to the home of a neighbor who had been awakened by gunfire, but Thomas immediately called the children back and killed them, sheriff's spokesman Tom Goodyear said.",88,105,had been awakened,0,1,1
3VEI3XUCZRYTHP4RAGBE8ZHX1Q6PRJ,"Three of the children, at least one already wounded, fled to the home of a neighbor who had been awakened by gunfire, but Thomas immediately called the children back and killed them, sheriff's spokesman Tom Goodyear said.",97,105,awakened,4,7,11
3VEI3XUCZRYTHP4RAGBE8ZHX1Q6PRJ,"Three of the children, at least one already wounded, fled to the home of a neighbor who had been awakened by gunfire, but Thomas immediately called the children back and killed them, sheriff's spokesman Tom Goodyear said.",109,116,gunfire,1,1,2
3VEI3XUCZRYTHP4RAGBE8ZHX1Q6PRJ,"Three of the children, at least one already wounded, fled to the home of a neighbor who had been awakened by gunfire, but Thomas immediately called the children back and killed them, sheriff's spokesman Tom Goodyear said.",129,140,immediately,1,1,2
3VEI3XUCZRYTHP4RAGBE8ZHX1Q6PRJ,"Three of the children, at least one already wounded, fled to the home of a neighbor who had been awakened by gunfire, but Thomas immediately called the children back and killed them, sheriff's spokesman Tom Goodyear said.",183,190,sheriff,1,0,1
3VEI3XUCZRYTHP4RAGBE8ZHX1Q6PRJ,"Three of the children, at least one already wounded, fled to the home of a neighbor who had been awakened by gunfire, but Thomas immediately called the children back and killed them, sheriff's spokesman Tom Goodyear said.",183,201,sheriffs spokesman,1,0,1
3VEI3XUCZRYTHP4RAGBE8ZHX1Q6PRJ,"Three of the children, at least one already wounded, fled to the home of a neighbor who had been awakened by gunfire, but Thomas immediately called the children back and killed them, sheriff's spokesman Tom Goodyear said.",193,202,spokesman,4,6,10
3VEI3XUCZRYTHP4RAGBE8ZHX1Q6PRJ,"The neighbor called 911 as they left his home, Goodyear said.",4,12,neighbor,0,1,1
3VEI3XUCZRYTHP4RAGBE8ZHX1Q6PRJ,"See the story at NBC station WESH of Orlando ""She was very calm,"" Goodyear said of the neighbor's report. """,17,28,NBC station,0,1,1
3VEI3XUCZRYTHP4RAGBE8ZHX1Q6PRJ,"See the story at NBC station WESH of Orlando ""She was very calm,"" Goodyear said of the neighbor's report. """,83,103,the neighbors report,1,0,1
3VEI3XUCZRYTHP4RAGBE8ZHX1Q6PRJ,"See the story at NBC station WESH of Orlando ""She was very calm,"" Goodyear said of the neighbor's report. """,87,96,neighbors,0,1,1
3VEI3XUCZRYTHP4RAGBE8ZHX1Q6PRJ,"See the story at NBC station WESH of Orlando ""She was very calm,"" Goodyear said of the neighbor's report. """,87,103,neighbors report,0,1,1
3VEI3XUCZRYTHP4RAGBE8ZHX1Q6PRJ,";She called them back and they walked back to the house.""",31,42,walked back,0,1,1
3VEI3XUCZRYTHP4RAGBE8ZHX1Q6PRJ,"Arriving deputies found one of the children, Pebbles Johnson, 17, lying in the front yard of the Bright Avenue home and spotted a person at the front door, Goodyear said.",0,8,Arriving,1,1,2
3VEI3XUCZRYTHP4RAGBE8ZHX1Q6PRJ,"Arriving deputies found one of the children, Pebbles Johnson, 17, lying in the front yard of the Bright Avenue home and spotted a person at the front door, Goodyear said.",0,17,Arriving deputies,1,1,2
3VEI3XUCZRYTHP4RAGBE8ZHX1Q6PRJ,"Arriving deputies found one of the children, Pebbles Johnson, 17, lying in the front yard of the Bright Avenue home and spotted a person at the front door, Goodyear said.",9,17,deputies,5,4,9
3VEI3XUCZRYTHP4RAGBE8ZHX1Q6PRJ,"Arriving deputies found one of the children, Pebbles Johnson, 17, lying in the front yard of the Bright Avenue home and spotted a person at the front door, Goodyear said.",45,52,Pebbles,0,1,1
3VEI3XUCZRYTHP4RAGBE8ZHX1Q6PRJ,"Arriving deputies found one of the children, Pebbles Johnson, 17, lying in the front yard of the Bright Avenue home and spotted a person at the front door, Goodyear said.",66,71,lying,0,1,1
3VEI3XUCZRYTHP4RAGBE8ZHX1Q6PRJ,"Arriving deputies found one of the children, Pebbles Johnson, 17, lying in the front yard of the Bright Avenue home and spotted a person at the front door, Goodyear said.",79,89,front yard,0,1,1
3VEI3XUCZRYTHP4RAGBE8ZHX1Q6PRJ,"Arriving deputies found one of the children, Pebbles Johnson, 17, lying in the front yard of the Bright Avenue home and spotted a person at the front door, Goodyear said.",120,127,spotted,4,8,12
3VEI3XUCZRYTHP4RAGBE8ZHX1Q6PRJ,"Arriving deputies found one of the children, Pebbles Johnson, 17, lying in the front yard of the Bright Avenue home and spotted a person at the front door, Goodyear said.",120,136,spotted a person,0,1,1
3VEI3XUCZRYTHP4RAGBE8ZHX1Q6PRJ,"The person ducked back inside after seeing deputies, he said.",11,17,ducked,7,9,16
3VEI3XUCZRYTHP4RAGBE8ZHX1Q6PRJ,"The person ducked back inside after seeing deputies, he said.",11,22,ducked back,1,4,5
3VEI3XUCZRYTHP4RAGBE8ZHX1Q6PRJ,"The person ducked back inside after seeing deputies, he said.",11,29,ducked back inside,0,1,1
3VEI3XUCZRYTHP4RAGBE8ZHX1Q6PRJ,"The person ducked back inside after seeing deputies, he said.",43,51,deputies,3,3,6
3VEI3XUCZRYTHP4RAGBE8ZHX1Q6PRJ,The teen was declared dead when she was transferred to an ambulance.,4,8,teen,1,0,1
3VEI3XUCZRYTHP4RAGBE8ZHX1Q6PRJ,The teen was declared dead when she was transferred to an ambulance.,13,21,declared,3,3,6
3VEI3XUCZRYTHP4RAGBE8ZHX1Q6PRJ,The teen was declared dead when she was transferred to an ambulance.,40,51,transferred,6,5,11
3VEI3XUCZRYTHP4RAGBE8ZHX1Q6PRJ,The teen was declared dead when she was transferred to an ambulance.,40,67,transferred to an ambulance,0,1,1
3VEI3XUCZRYTHP4RAGBE8ZHX1Q6PRJ,The teen was declared dead when she was transferred to an ambulance.,58,67,ambulance,3,1,4
35JDMRECC4AYV86NLR1RFJ4MKXQGEZ,"Among the dead were a Shiite imam, Sheikh Abbas al-Laham, who leads the prayers in the Ruqayya mosque in Damascus, a revered place of pilgrimage for many religious Iranians.",22,28,Shiite,0,1,1
35JDMRECC4AYV86NLR1RFJ4MKXQGEZ,"Among the dead were a Shiite imam, Sheikh Abbas al-Laham, who leads the prayers in the Ruqayya mosque in Damascus, a revered place of pilgrimage for many religious Iranians.",22,33,Shiite imam,2,0,2
35JDMRECC4AYV86NLR1RFJ4MKXQGEZ,"Among the dead were a Shiite imam, Sheikh Abbas al-Laham, who leads the prayers in the Ruqayya mosque in Damascus, a revered place of pilgrimage for many religious Iranians.",29,33,imam,2,0,2
35JDMRECC4AYV86NLR1RFJ4MKXQGEZ,"Among the dead were a Shiite imam, Sheikh Abbas al-Laham, who leads the prayers in the Ruqayya mosque in Damascus, a revered place of pilgrimage for many religious Iranians.",35,41,Sheikh,1,0,1
35JDMRECC4AYV86NLR1RFJ4MKXQGEZ,"Among the dead were a Shiite imam, Sheikh Abbas al-Laham, who leads the prayers in the Ruqayya mosque in Damascus, a revered place of pilgrimage for many religious Iranians.",35,56,Sheikh Abbas al-Laham,1,0,1
35JDMRECC4AYV86NLR1RFJ4MKXQGEZ,"Among the dead were a Shiite imam, Sheikh Abbas al-Laham, who leads the prayers in the Ruqayya mosque in Damascus, a revered place of pilgrimage for many religious Iranians.",42,56,Abbas al-Laham,1,0,1
35JDMRECC4AYV86NLR1RFJ4MKXQGEZ,"Among the dead were a Shiite imam, Sheikh Abbas al-Laham, who leads the prayers in the Ruqayya mosque in Damascus, a revered place of pilgrimage for many religious Iranians.",87,94,Ruqayya,1,0,1
35JDMRECC4AYV86NLR1RFJ4MKXQGEZ,"Among the dead were a Shiite imam, Sheikh Abbas al-Laham, who leads the prayers in the Ruqayya mosque in Damascus, a revered place of pilgrimage for many religious Iranians.",87,101,Ruqayya mosque,2,0,2
35JDMRECC4AYV86NLR1RFJ4MKXQGEZ,"Among the dead were a Shiite imam, Sheikh Abbas al-Laham, who leads the prayers in the Ruqayya mosque in Damascus, a revered place of pilgrimage for many religious Iranians.",95,101,mosque,3,0,3
35JDMRECC4AYV86NLR1RFJ4MKXQGEZ,"Among the dead were a Shiite imam, Sheikh Abbas al-Laham, who leads the prayers in the Ruqayya mosque in Damascus, a revered place of pilgrimage for many religious Iranians.",105,113,Damascus,1,0,1
35JDMRECC4AYV86NLR1RFJ4MKXQGEZ,"Among the dead were a Shiite imam, Sheikh Abbas al-Laham, who leads the prayers in the Ruqayya mosque in Damascus, a revered place of pilgrimage for many religious Iranians.",115,130,a revered place,1,0,1
35JDMRECC4AYV86NLR1RFJ4MKXQGEZ,"Among the dead were a Shiite imam, Sheikh Abbas al-Laham, who leads the prayers in the Ruqayya mosque in Damascus, a revered place of pilgrimage for many religious Iranians.",117,124,revered,9,8,17
35JDMRECC4AYV86NLR1RFJ4MKXQGEZ,"Among the dead were a Shiite imam, Sheikh Abbas al-Laham, who leads the prayers in the Ruqayya mosque in Damascus, a revered place of pilgrimage for many religious Iranians.",117,130,revered place,0,1,1
35JDMRECC4AYV86NLR1RFJ4MKXQGEZ,"Among the dead were a Shiite imam, Sheikh Abbas al-Laham, who leads the prayers in the Ruqayya mosque in Damascus, a revered place of pilgrimage for many religious Iranians.",134,144,pilgrimage,10,9,19
35JDMRECC4AYV86NLR1RFJ4MKXQGEZ,"The cleric was assassinated by unidentified gunmen in Damascus, the Observatory said.",4,10,cleric,6,0,6
35JDMRECC4AYV86NLR1RFJ4MKXQGEZ,"The cleric was assassinated by unidentified gunmen in Damascus, the Observatory said.",15,27,assassinated,10,8,18
35JDMRECC4AYV86NLR1RFJ4MKXQGEZ,"The cleric was assassinated by unidentified gunmen in Damascus, the Observatory said.",31,43,unidentified,3,2,5
35JDMRECC4AYV86NLR1RFJ4MKXQGEZ,"The cleric was assassinated by unidentified gunmen in Damascus, the Observatory said.",31,50,unidentified gunmen,0,1,1
35JDMRECC4AYV86NLR1RFJ4MKXQGEZ,"The cleric was assassinated by unidentified gunmen in Damascus, the Observatory said.",44,50,gunmen,1,0,1
35JDMRECC4AYV86NLR1RFJ4MKXQGEZ,"The cleric was assassinated by unidentified gunmen in Damascus, the Observatory said.",68,79,Observatory,1,4,5
35JDMRECC4AYV86NLR1RFJ4MKXQGEZ,"Iran supports the Damascus regime, which since 15 March 2011 has faced an unprecedented popular revolt.",27,33,regime,6,4,10
35JDMRECC4AYV86NLR1RFJ4MKXQGEZ,"Iran supports the Damascus regime, which since 15 March 2011 has faced an unprecedented popular revolt.",74,87,unprecedented,10,8,18
35JDMRECC4AYV86NLR1RFJ4MKXQGEZ,"Iran supports the Damascus regime, which since 15 March 2011 has faced an unprecedented popular revolt.",96,102,revolt,5,7,12
35JDMRECC4AYV86NLR1RFJ4MKXQGEZ,"More than 12,000 people, the majority of them civilians, have died since the Syrian uprising began in March 2011, according to the watchdog, including more than 900 killed since the April 12 truce.",46,55,civilians,3,0,3
35JDMRECC4AYV86NLR1RFJ4MKXQGEZ,"More than 12,000 people, the majority of them civilians, have died since the Syrian uprising began in March 2011, according to the watchdog, including more than 900 killed since the April 12 truce.",77,92,Syrian uprising,1,0,1
35JDMRECC4AYV86NLR1RFJ4MKXQGEZ,"More than 12,000 people, the majority of them civilians, have died since the Syrian uprising began in March 2011, according to the watchdog, including more than 900 killed since the April 12 truce.",84,92,uprising,2,4,6
35JDMRECC4AYV86NLR1RFJ4MKXQGEZ,"More than 12,000 people, the majority of them civilians, have died since the Syrian uprising began in March 2011, according to the watchdog, including more than 900 killed since the April 12 truce.",131,139,watchdog,4,6,10
35JDMRECC4AYV86NLR1RFJ4MKXQGEZ,"More than 12,000 people, the majority of them civilians, have died since the Syrian uprising began in March 2011, according to the watchdog, including more than 900 killed since the April 12 truce.",191,196,truce,0,1,1
35JDMRECC4AYV86NLR1RFJ4MKXQGEZ,European Union foreign ministers agreed Monday to impose fresh sanctions on Syria as a U.N.-backed peace plan -- along with all other diplomatic efforts -- has yet to stop the carnage that mounts every day.,0,14,European Union,1,0,1
35JDMRECC4AYV86NLR1RFJ4MKXQGEZ,European Union foreign ministers agreed Monday to impose fresh sanctions on Syria as a U.N.-backed peace plan -- along with all other diplomatic efforts -- has yet to stop the carnage that mounts every day.,15,32,foreign ministers,1,0,1
35JDMRECC4AYV86NLR1RFJ4MKXQGEZ,European Union foreign ministers agreed Monday to impose fresh sanctions on Syria as a U.N.-backed peace plan -- along with all other diplomatic efforts -- has yet to stop the carnage that mounts every day.,50,56,impose,2,6,8
35JDMRECC4AYV86NLR1RFJ4MKXQGEZ,European Union foreign ministers agreed Monday to impose fresh sanctions on Syria as a U.N.-backed peace plan -- along with all other diplomatic efforts -- has yet to stop the carnage that mounts every day.,50,72,impose fresh sanctions,1,0,1
35JDMRECC4AYV86NLR1RFJ4MKXQGEZ,European Union foreign ministers agreed Monday to impose fresh sanctions on Syria as a U.N.-backed peace plan -- along with all other diplomatic efforts -- has yet to stop the carnage that mounts every day.,57,72,fresh sanctions,2,0,2
35JDMRECC4AYV86NLR1RFJ4MKXQGEZ,European Union foreign ministers agreed Monday to impose fresh sanctions on Syria as a U.N.-backed peace plan -- along with all other diplomatic efforts -- has yet to stop the carnage that mounts every day.,63,72,sanctions,2,5,7
35JDMRECC4AYV86NLR1RFJ4MKXQGEZ,European Union foreign ministers agreed Monday to impose fresh sanctions on Syria as a U.N.-backed peace plan -- along with all other diplomatic efforts -- has yet to stop the carnage that mounts every day.,87,98,U.N.-backed,1,0,1
35JDMRECC4AYV86NLR1RFJ4MKXQGEZ,European Union foreign ministers agreed Monday to impose fresh sanctions on Syria as a U.N.-backed peace plan -- along with all other diplomatic efforts -- has yet to stop the carnage that mounts every day.,87,109,U.N.-backed peace plan,0,1,1
35JDMRECC4AYV86NLR1RFJ4MKXQGEZ,European Union foreign ministers agreed Monday to impose fresh sanctions on Syria as a U.N.-backed peace plan -- along with all other diplomatic efforts -- has yet to stop the carnage that mounts every day.,134,144,diplomatic,4,3,7
35JDMRECC4AYV86NLR1RFJ4MKXQGEZ,European Union foreign ministers agreed Monday to impose fresh sanctions on Syria as a U.N.-backed peace plan -- along with all other diplomatic efforts -- has yet to stop the carnage that mounts every day.,134,152,diplomatic efforts,4,1,5
35JDMRECC4AYV86NLR1RFJ4MKXQGEZ,European Union foreign ministers agreed Monday to impose fresh sanctions on Syria as a U.N.-backed peace plan -- along with all other diplomatic efforts -- has yet to stop the carnage that mounts every day.,176,183,carnage,10,9,19
35JDMRECC4AYV86NLR1RFJ4MKXQGEZ,European Union foreign ministers agreed Monday to impose fresh sanctions on Syria as a U.N.-backed peace plan -- along with all other diplomatic efforts -- has yet to stop the carnage that mounts every day.,189,195,mounts,3,1,4
3TLFH2L6Y9PA5XGDC75XC1AME1B2TM,"He didn't see the text until he woke up this morning, Goodyear said.",19,23,text,0,1,1
3TLFH2L6Y9PA5XGDC75XC1AME1B2TM,"He didn't see the text until he woke up this morning, Goodyear said.",33,40,woke up,0,2,2
3TLFH2L6Y9PA5XGDC75XC1AME1B2TM,"Deputies identified the children as Pebbles Johnson, 17; Jaxs Johnson, 15; Jazlin Johnson, 13; and Joel Johnson, 12.",0,8,Deputies,4,4,8
3TLFH2L6Y9PA5XGDC75XC1AME1B2TM,"Deputies identified the children as Pebbles Johnson, 17; Jaxs Johnson, 15; Jazlin Johnson, 13; and Joel Johnson, 12.",9,19,identified,5,3,8
3TLFH2L6Y9PA5XGDC75XC1AME1B2TM,"Deputies identified the children as Pebbles Johnson, 17; Jaxs Johnson, 15; Jazlin Johnson, 13; and Joel Johnson, 12.",36,43,Pebbles,0,1,1
3TLFH2L6Y9PA5XGDC75XC1AME1B2TM,"The shooting happened in Port St. John, about 24 kilometres west of Cape Canaveral in an area known as the ""Space Coast"" because it is the home of NASA's Kennedy Space Center, the location of numerous famed shuttle launches.",4,12,shooting,0,1,1
3TLFH2L6Y9PA5XGDC75XC1AME1B2TM,"The shooting happened in Port St. John, about 24 kilometres west of Cape Canaveral in an area known as the ""Space Coast"" because it is the home of NASA's Kennedy Space Center, the location of numerous famed shuttle launches.",13,21,happened,0,1,1
3TLFH2L6Y9PA5XGDC75XC1AME1B2TM,"The shooting happened in Port St. John, about 24 kilometres west of Cape Canaveral in an area known as the ""Space Coast"" because it is the home of NASA's Kennedy Space Center, the location of numerous famed shuttle launches.",49,59,kilometres,4,0,4
3TLFH2L6Y9PA5XGDC75XC1AME1B2TM,"The shooting happened in Port St. John, about 24 kilometres west of Cape Canaveral in an area known as the ""Space Coast"" because it is the home of NASA's Kennedy Space Center, the location of numerous famed shuttle launches.",108,119,Space Coast,1,0,1
3TLFH2L6Y9PA5XGDC75XC1AME1B2TM,"The shooting happened in Port St. John, about 24 kilometres west of Cape Canaveral in an area known as the ""Space Coast"" because it is the home of NASA's Kennedy Space Center, the location of numerous famed shuttle launches.",180,188,location,0,1,1
3TLFH2L6Y9PA5XGDC75XC1AME1B2TM,"The shooting happened in Port St. John, about 24 kilometres west of Cape Canaveral in an area known as the ""Space Coast"" because it is the home of NASA's Kennedy Space Center, the location of numerous famed shuttle launches.",192,200,numerous,4,4,8
3TLFH2L6Y9PA5XGDC75XC1AME1B2TM,"The shooting happened in Port St. John, about 24 kilometres west of Cape Canaveral in an area known as the ""Space Coast"" because it is the home of NASA's Kennedy Space Center, the location of numerous famed shuttle launches.",201,206,famed,1,5,6
3TLFH2L6Y9PA5XGDC75XC1AME1B2TM,"The shooting happened in Port St. John, about 24 kilometres west of Cape Canaveral in an area known as the ""Space Coast"" because it is the home of NASA's Kennedy Space Center, the location of numerous famed shuttle launches.",201,223,famed shuttle launches,1,1,2
3TLFH2L6Y9PA5XGDC75XC1AME1B2TM,"The shooting happened in Port St. John, about 24 kilometres west of Cape Canaveral in an area known as the ""Space Coast"" because it is the home of NASA's Kennedy Space Center, the location of numerous famed shuttle launches.",207,214,shuttle,3,3,6
3TLFH2L6Y9PA5XGDC75XC1AME1B2TM,"The shooting happened in Port St. John, about 24 kilometres west of Cape Canaveral in an area known as the ""Space Coast"" because it is the home of NASA's Kennedy Space Center, the location of numerous famed shuttle launches.",207,223,shuttle launches,1,3,4
3TLFH2L6Y9PA5XGDC75XC1AME1B2TM,"The shooting happened in Port St. John, about 24 kilometres west of Cape Canaveral in an area known as the ""Space Coast"" because it is the home of NASA's Kennedy Space Center, the location of numerous famed shuttle launches.",215,223,launches,2,3,5
3TLFH2L6Y9PA5XGDC75XC1AME1B2TM,A spokesman for the Department of Children and Families wouldn't immediately comment on whether the family had a history with the agency.,2,11,spokesman,3,5,8
3TLFH2L6Y9PA5XGDC75XC1AME1B2TM,A spokesman for the Department of Children and Families wouldn't immediately comment on whether the family had a history with the agency.,65,76,immediately,3,2,5
3TLFH2L6Y9PA5XGDC75XC1AME1B2TM,A spokesman for the Department of Children and Families wouldn't immediately comment on whether the family had a history with the agency.,65,84,immediately comment,1,0,1
3TLFH2L6Y9PA5XGDC75XC1AME1B2TM,A spokesman for the Department of Children and Families wouldn't immediately comment on whether the family had a history with the agency.,111,120,a history,1,0,1
3TLFH2L6Y9PA5XGDC75XC1AME1B2TM,A spokesman for the Department of Children and Families wouldn't immediately comment on whether the family had a history with the agency.,113,120,history,0,1,1
3TLFH2L6Y9PA5XGDC75XC1AME1B2TM,A spokesman for the Department of Children and Families wouldn't immediately comment on whether the family had a history with the agency.,130,136,agency,2,0,2
3TLFH2L6Y9PA5XGDC75XC1AME1B2TM,Goodyear said deputies had responded to the house for domestic complaints previously.,14,22,deputies,0,1,1
3TLFH2L6Y9PA5XGDC75XC1AME1B2TM,Goodyear said deputies had responded to the house for domestic complaints previously.,27,36,responded,2,2,4
3TLFH2L6Y9PA5XGDC75XC1AME1B2TM,Goodyear said deputies had responded to the house for domestic complaints previously.,54,62,domestic,2,1,3
3TLFH2L6Y9PA5XGDC75XC1AME1B2TM,Goodyear said deputies had responded to the house for domestic complaints previously.,54,73,domestic complaints,7,5,12
3TLFH2L6Y9PA5XGDC75XC1AME1B2TM,Goodyear said deputies had responded to the house for domestic complaints previously.,63,73,complaints,2,1,3
3TLFH2L6Y9PA5XGDC75XC1AME1B2TM,Goodyear said deputies had responded to the house for domestic complaints previously.,74,84,previously,1,1,2
3TLFH2L6Y9PA5XGDC75XC1AME1B2TM,"Jamie Hudson, whose mother lives two doors down from the family, said the boys in the family were known to shoot BBs at a home across the street and had threatened to set it on fire.",107,116,shoot BBs,0,2,2
3TLFH2L6Y9PA5XGDC75XC1AME1B2TM,"Jamie Hudson, whose mother lives two doors down from the family, said the boys in the family were known to shoot BBs at a home across the street and had threatened to set it on fire.",113,116,BBs,0,1,1
3TLFH2L6Y9PA5XGDC75XC1AME1B2TM,"Jamie Hudson, whose mother lives two doors down from the family, said the boys in the family were known to shoot BBs at a home across the street and had threatened to set it on fire.",153,163,threatened,4,10,14
3TLFH2L6Y9PA5XGDC75XC1AME1B2TM,"Jamie Hudson, whose mother lives two doors down from the family, said the boys in the family were known to shoot BBs at a home across the street and had threatened to set it on fire.",167,181,set it on fire,0,1,1
